,Word,where,Count_ita,Count_other,Total_count
15983,de,0,0,3493,3493
0,,2,203,2678,2881
2607,a,2,199,1685,1884
559,the,2,4,1608,1612
30251,en,0,0,1534,1534
2062,la,2,245,1216,1461
11879,que,0,0,1294,1294
1652,in,2,281,946,1227
2178,of,2,3,1126,1129
2467,wikipedia,2,141,792,933
1279,un,2,259,596,855
1616,and,2,2,846,848
11762,du,0,0,814,814
1228,e,2,375,410,785
2374,to,2,1,754,755
2321,i,2,94,637,731
2406,di,1,679,0,679
2917,le,2,145,472,617
627,o,2,107,502,609
539,l,2,150,438,588
7190,et,0,0,587,587
32112,के,0,0,563,563
17217,is,0,0,552,552
21757,je,0,0,507,507
635,se,2,88,410,498
33901,à,0,0,481,481
31308,att,0,0,438,438
2074,da,2,114,316,430
19091,y,0,0,429,429
24848,det,0,0,423,423
34219,wikipédia,0,0,422,422
3574,d,2,27,383,410
37971,that,0,0,408,408
43984,por,0,0,408,408
43445,des,0,0,406,406
29727,में,0,0,396,396
35595,les,0,0,389,389
18719,och,0,0,387,387
40090,el,0,0,386,386
6777,в,0,0,386,386
1097,you,2,1,363,364
1699,no,2,13,346,359
18977,as,0,0,356,356
38227,for,0,0,353,353
36502,है,0,0,344,344
1291,il,2,226,112,338
38351,para,0,0,337,337
1947,una,2,147,187,334
40579,est,0,0,330,330
2479,che,1,330,0,330
3941,som,0,0,329,329
12105,और,0,0,313,313
36068,em,0,0,313,313
31880,at,0,0,308,308
15982,kan,0,0,303,303
13868,في,0,0,301,301
44629,une,0,0,299,299
19456,и,0,0,298,298
43140,er,0,0,295,295
12205,να,0,0,292,292
867,es,2,1,290,291
23123,är,0,0,285,285
45155,het,0,0,282,282
12185,vous,0,0,271,271
25360,på,0,0,265,265
42521,s,0,0,265,265
30844,um,0,0,263,263
3439,è,1,263,0,263
16807,एक,0,0,262,262
31783,was,0,0,260,260
5003,من,0,0,259,259
39025,om,0,0,258,258
3098,on,2,1,256,257
24311,como,0,0,253,253
28234,você,0,0,252,252
4299,को,0,0,251,251
40819,ou,0,0,247,247
46711,،,0,0,247,247
4267,dans,0,0,246,246
14870,har,0,0,245,245
34447,een,0,0,244,244
41628,कि,0,0,244,244
5863,sie,0,0,240,240
440,si,2,66,172,238
43110,से,0,0,233,233
30785,हैं,0,0,228,228
1946,nature,2,10,218,228
45276,los,0,0,223,223
6774,par,0,0,217,217
1152,non,2,188,25,213
26628,van,0,0,212,212
12627,ನೀವು,0,0,211,211
482,con,2,85,125,210
28346,bir,0,0,210,210
7041,are,0,0,209,209
40934,ve,0,0,209,209
23699,it,0,0,205,205
40011,av,0,0,204,204
26962,jag,0,0,203,203
2233,te,2,19,183,202
28523,ik,0,0,198,198
2144,del,2,83,114,197
15113,आप,0,0,197,197
4694,jeg,0,0,197,197
34954,og,0,0,197,197
3729,do,2,1,196,197
13279,or,0,0,196,196
36168,και,0,0,196,196
6369,den,0,0,195,195
37285,uma,0,0,195,195
2712,per,2,179,15,194
38355,by,0,0,193,193
11139,ich,0,0,192,192
39696,dat,0,0,192,192
46716,med,0,0,191,191
28371,não,0,0,190,190
2967,w,2,1,188,189
27643,की,0,0,188,188
2254,qui,2,13,174,187
566,learning,2,2,181,183
43242,நீங்கள்,0,0,183,183
17071, ·,0,0,182,182
706,me,2,11,169,180
32033,है।,0,0,179,179
22355,что,0,0,176,176
15116,लिए,0,0,173,173
28104,with,0,0,171,171
29579,το,0,0,171,171
43751,pas,0,0,170,170
1660,an,2,1,169,170
18807,أن,0,0,169,169
20171,не,0,0,167,167
39421,pour,0,0,167,167
43509,för,0,0,166,166
28625,विकिपीडिया,0,0,165,165
18648,can,0,0,165,165
2622,su,2,61,104,165
37827,ನಾನು,0,0,162,162
46512,é,0,0,162,162
24217,dig,0,0,161,161
1528,ne,2,21,137,158
18468,का,0,0,157,157
43239,я,0,0,156,156
30995,على,0,0,155,155
33197,så,0,0,155,155
34846,вы,0,0,153,153
919,wikimedia,2,12,141,153
44944,var,0,0,151,151
4494,यह,0,0,150,150
31960,நான்,0,0,150,150
41310,from,0,0,150,150
40310,नहीं,0,0,149,149
29513,be,0,0,149,149
32415,на,0,0,149,149
15305,und,0,0,149,149
33949,articles,0,0,148,148
29442,inte,0,0,148,148
9035,ಮತ್ತು,0,0,147,147
19610,sur,0,0,146,146
3369,lo,2,35,110,145
593,sono,2,144,1,145
25695,have,0,0,145,145
40472,die,0,0,144,144
1953,narcisa,2,14,129,143
47458,las,0,0,142,142
4766,mais,0,0,141,141
11832,ഒരു,0,0,138,138
42227,com,0,0,137,137
1835,ce,2,1,135,136
41276,ويكيبيديا,0,0,136,136
5783,this,0,0,133,133
4093,das,0,0,132,132
2323,come,2,118,14,132
18779,eller,0,0,131,131
42539,это,0,0,131,131
42641,​,0,0,130,130
16195,os,0,0,130,130
38847,son,0,0,127,127
33011,bu,0,0,127,127
14795,till,0,0,127,127
22974,als,0,0,125,125
37594,είναι,0,0,125,125
276,so,2,6,118,124
2429,oh,2,16,108,124
18207,ஒரு,0,0,123,123
11350,നിങ്ങൾ,0,0,121,121
44395,पर,0,0,121,121
25990,which,0,0,121,121
45891,मैं,0,0,120,120
833,ha,2,71,49,120
4559,που,0,0,119,119
25398,ikke,0,0,118,118
1605,data,2,12,105,117
8684,plus,0,0,117,117
26945,niet,0,0,117,117
16031,sobre,0,0,116,116
28265,ഞാൻ,0,0,116,116
449,t,2,4,110,114
12735,eu,0,0,112,112
15374,na,0,0,112,112
22942,not,0,0,110,110
33632,has,0,0,110,110
16987,op,0,0,107,107
21212,για,0,0,107,107
1047,web,2,19,88,107
17794,ist,0,0,106,106
898,machine,2,3,102,105
44457,der,0,0,103,103
32793,comme,0,0,102,102
41641,ಎಂದು,0,0,102,102
19942,está,0,0,102,102
16828,с,0,0,101,101
44314,как,0,0,101,101
42783,au,0,0,100,100
41640,δεν,0,0,100,100
26415,zu,0,0,100,100
14694,ser,0,0,99,99
6970,ما,0,0,96,96
30503,किया,0,0,96,96
28119,nicht,0,0,96,96
12670,कर,0,0,95,95
44293,என்று,0,0,95,95
2195,dire,2,40,54,94
1765,wales,2,7,86,93
15210,हैं।,0,0,93,93
2791, ,2,9,84,93
5738,ότι,0,0,92,92
42226,sont,0,0,91,91
10896,mig,0,0,91,91
2940,wiki,2,16,74,90
15758,over,0,0,90,90
3569,enciclopedia,2,42,47,89
7983,википедии,0,0,89,89
1305,all,2,17,72,89
14941,also,0,0,88,88
38555,ett,0,0,88,88
11964,നിങ്ങൾക്ക്,0,0,88,88
1170,tu,2,20,67,87
171,catch,2,7,80,87
571,al,2,59,28,87
439,significa,2,28,59,87
2092,nel,1,86,0,86
4645,لا,0,0,86,86
708,c,2,17,68,85
16683,सकते,0,0,85,85
37666,been,0,0,84,84
2156,apprendimento,1,84,0,84
1185,sua,2,27,56,83
42964,article,0,0,83,83
37707,σε,0,0,83,83
42149,n,0,0,83,83
19772,إلى,0,0,82,82
39009,met,0,0,81,81
42396,dass,0,0,81,81
1451,foundation,2,6,74,80
21544,avec,0,0,80,80
24734,pode,0,0,80,80
36421,men,0,0,80,80
1888,internet,2,5,75,80
34943,أو,0,0,79,79
7524,til,0,0,79,79
40804,entre,0,0,79,79
3236,era,2,31,48,79
9237,هذا,0,0,78,78
46174,σας,0,0,78,78
26737,ord,0,0,78,78
34483,artigos,0,0,77,77
19078,или,0,0,77,77
30063,if,0,0,77,77
17779,más,0,0,77,77
44260,artículos,0,0,77,77
42220,some,0,0,77,77
5385,such,0,0,76,76
1957,video,2,12,64,76
32700,other,0,0,76,76
45627,zijn,0,0,75,75
37305,από,0,0,75,75
6683,são,0,0,75,75
19952,af,0,0,74,74
18635,its,0,0,74,74
2068,più,1,74,0,74
3139,ai,2,12,61,73
12926,या,0,0,73,73
47282,θα,0,0,73,73
45526,मुझे,0,0,73,73
32191,cette,0,0,73,73
14042,μια,0,0,73,73
1286,m,2,1,72,73
20474,dit,0,0,72,72
18653,जो,0,0,72,72
18877,bien,0,0,72,72
39427,dos,0,0,71,71
9308,με,0,0,71,71
38342,one,0,0,71,71
23322,but,0,0,71,71
34935,भी,0,0,71,71
36006,करने,0,0,70,70
24194,कुछ,0,0,70,70
4262,αυτό,0,0,69,69
40476,este,0,0,68,68
1439,parte,2,18,50,68
2594,terry,2,7,61,68
21357,η,0,0,68,68
42350,more,0,0,67,67
26323,about,0,0,67,67
46657,для,0,0,67,67
22592,foi,0,0,67,67
3512,puoi,1,66,0,66
1421,use,2,2,64,66
1829,dell,2,65,1,66
24354,ने,0,0,66,66
30606,han,0,0,66,66
14665,ты,0,0,65,65
39170,qu,0,0,65,65
13650,wat,0,0,64,64
28,sanger,2,9,55,64
33735,wenn,0,0,64,64
1230,quando,2,34,30,64
17753,गया,0,0,64,64
1895,questo,1,63,0,63
1738,della,1,63,0,63
15411,esta,0,0,63,63
12010,يمكنك,0,0,63,63
5452,her,0,0,62,62
42158,года,0,0,62,62
16460,आपको,0,0,62,62
1055,voci,1,62,0,62
9861,life,0,0,62,62
1683,nupedia,2,7,54,61
780,ma,2,51,10,61
30791,çok,0,0,61,61
37173,were,0,0,61,61
27913,elle,0,0,61,61
27860,için,0,0,60,60
26580,site,0,0,60,60
6721,बहुत,0,0,60,60
2702,alla,2,38,22,60
908,rendezvous,2,8,52,60
41256,എനിക്ക്,0,0,59,59
37463,उपयोग,0,0,59,59
35021,être,0,0,59,59
33962,ഈ,0,0,59,59
2391,mi,2,33,26,59
11309,voor,0,0,59,59
17864,they,0,0,58,58
3516,essere,1,58,0,58
46538,aux,0,0,58,58
24936,vikipedi,0,0,58,58
29572,had,0,0,58,58
16578,mot,0,0,57,57
46947,muito,0,0,57,57
37928,sin,0,0,56,56
32809,he,0,0,56,56
18837,isso,0,0,56,56
39315,если,0,0,56,56
28205,editors,0,0,56,56
5379,रूप,0,0,56,56
43019,andere,0,0,56,56
22277,hvis,0,0,56,56
22027,été,0,0,56,56
3249,jimmy,2,4,52,56
11893,ya,0,0,56,56
18820,அல்லது,0,0,56,56
10726,their,0,0,55,55
17763,ನಿಮಗೆ,0,0,55,55
33179,التي,0,0,55,55
4502,μου,0,0,55,55
22589,betyder,0,0,55,55
13501,fait,0,0,55,55
7089,ze,0,0,55,55
40927,μπορείτε,0,0,55,55
24288,साथ,0,0,55,55
8685,pouvez,0,0,55,55
37939,по,0,0,55,55
7811,like,0,0,54,54
46447,तो,0,0,54,54
43707,из,0,0,54,54
1365,ti,2,44,10,54
4467,sagen,0,0,54,54
1996,suave,2,1,53,54
37278,αν,0,0,54,54
13519,ഇത്,0,0,54,54
11380,о,0,0,54,54
25579,इस,0,0,54,54
425,time,2,1,52,53
29956,say,0,0,53,53
32499,क्या,0,0,53,53
40760,πολύ,0,0,53,53
5137,ή,0,0,53,53
25400,மிகவும்,0,0,53,53
44803,sus,0,0,53,53
12698,था,0,0,53,53
26208,ein,0,0,53,53
3660,software,2,6,47,53
3507,google,2,2,50,52
16653,إذا,0,0,52,52
35229,under,0,0,52,52
29190,there,0,0,52,52
23980,these,0,0,52,52
5725,रहा,0,0,52,52
47205,википедия,0,0,51,51
32302,किसी,0,0,51,51
27574,what,0,0,51,51
11179,लेख,0,0,51,51
20299,word,0,0,50,50
2782,dei,1,50,0,50
598,training,2,2,48,50
15766,we,0,0,50,50
20357,algo,0,0,50,50
326,libre,2,2,48,50
8391,used,0,0,50,50
42560,new,0,0,49,49
39330,της,0,0,49,49
37997,kunt,0,0,49,49
39843,كان,0,0,49,49
37638,так,0,0,49,49
23793,may,0,0,49,49
1948,frase,2,17,32,49
11636,ses,0,0,49,49
40890,example,0,0,49,49
8490,mit,0,0,48,48
13414,ces,0,0,48,48
27689,वह,0,0,48,48
35914,ένα,0,0,48,48
597,information,2,2,46,48
11073,j,0,0,48,48
26907,nu,0,0,48,48
44667,можете,0,0,48,48
3731,war,2,1,47,48
25306,ಅಥವಾ,0,0,48,48
10068,wie,0,0,48,48
42354,शब्द,0,0,48,48
21018,ήταν,0,0,48,48
2028,britannica,2,9,38,47
4325,when,0,0,47,47
34927,vez,0,0,47,47
36042,här,0,0,47,47
30603,അത്,0,0,47,47
44862,vara,0,0,47,47
29754,द्वारा,0,0,47,47
6608,hvad,0,0,47,47
1048,ad,2,43,4,47
36139,than,0,0,47,47
29655,மற்றும்,0,0,47,47
10135,puedes,0,0,47,47
34296,algorithms,0,0,46,46
43879,oder,0,0,46,46
930,encyclopedia,2,1,45,46
26938,aussi,0,0,46,46
3622,ben,2,2,44,46
38382,zo,0,0,46,46
44867,säga,0,0,46,46
38651,part,0,0,45,45
42160,était,0,0,45,45
23481,eine,0,0,45,45
32528,हो,0,0,45,45
46978,number,0,0,45,45
25189,nummer,0,0,45,45
37045,mas,0,0,45,45
18608,número,0,0,45,45
4934,können,0,0,45,45
14696,zeggen,0,0,45,45
32859,tem,0,0,45,45
45227,man,0,0,44,44
36409,artiklar,0,0,44,44
45290,dem,0,0,44,44
5566,earth,0,0,44,44
42106,dizer,0,0,44,44
26963,todo,0,0,44,44
10657,இது,0,0,44,44
24058,från,0,0,43,43
2075,cui,1,43,0,43
29815,इसे,0,0,43,43
12157,к,0,0,43,43
32071,sige,0,0,43,43
45356,τη,0,0,43,43
2666,automatico,1,43,0,43
13333,iyi,0,0,43,43
43247,vad,0,0,43,43
30701,ही,0,0,43,43
43223,encyclopédie,0,0,43,43
18407,page,0,0,43,43
34944,någon,0,0,43,43
15789,ಅದು,0,0,43,43
12433,ನಿಮ್ಮ,0,0,43,43
18131,min,0,0,43,43
20307,heb,0,0,42,42
7127,também,0,0,42,42
239,mellie,2,4,38,42
31410,wikipedias,0,0,42,42
28311,content,0,0,42,42
17603,autres,0,0,42,42
3335,commons,2,4,38,42
35997,version,0,0,42,42
3247,modo,2,31,11,42
36192,сказать,0,0,41,41
12372,τον,0,0,41,41
28752,noget,0,0,41,41
42594,vil,0,0,41,41
24357,tout,0,0,41,41
17409,هذه,0,0,41,41
1045,anche,1,41,0,41
1704,gli,1,41,0,41
33291,usar,0,0,41,41
5658,situation,0,0,41,41
36088,она,0,0,41,41
19452,english,0,0,41,41
41097,ela,0,0,41,41
1402,uso,2,12,28,40
4843,а,0,0,40,40
1486,forma,2,4,36,40
37467,ಈ,0,0,40,40
23560,culture,0,0,40,40
32485,στο,0,0,40,40
17686,ont,0,0,40,40
23140,aprendizaje,0,0,40,40
46480,ذلك,0,0,40,40
23247,"
",0,0,40,40
22291,ನನ್ನ,0,0,40,40
40686,दिया,0,0,40,40
31651,many,0,0,40,40
3362,marian,2,4,36,40
2813,delle,1,40,0,40
6612,only,0,0,40,40
3089,solo,2,18,22,40
28160,re,0,0,39,39
47342,set,0,0,39,39
31747,വളരെ,0,0,39,39
18299,smart,0,0,39,39
27588,τα,0,0,39,39
37704,my,0,0,39,39
19348,editores,0,0,39,39
7833,seu,0,0,39,39
8177,andra,0,0,39,39
22851,habe,0,0,39,39
8696,عن,0,0,39,39
19380,mijn,0,0,39,39
38281,maar,0,0,39,39
1287,molto,1,39,0,39
5749,мне,0,0,39,39
15640,would,0,0,39,39
32841,most,0,0,39,39
15690,было,0,0,38,38
14779,sites,0,0,38,38
892,larry,2,5,33,38
31973,kom,0,0,38,38
39146,എന്റെ,0,0,38,38
14276,कोई,0,0,38,38
1545,ho,2,37,1,38
29282,அது,0,0,38,38
2637,sei,2,29,9,38
22709,இந்த,0,0,38,38
17766,ele,0,0,38,38
985,online,2,7,31,38
37891,την,0,0,38,38
45402,up,0,0,38,38
16563,meget,0,0,38,38
30760,был,0,0,38,38
9511,autre,0,0,38,38
46688,உங்களுக்கு,0,0,38,38
9767,कह,0,0,38,38
31171,any,0,0,38,38
3585,alle,2,17,21,38
1679,vi,2,5,32,37
33514,была,0,0,37,37
27214,എന്ന്,0,0,37,37
35966,door,0,0,37,37
1063,qualcuno,1,37,0,37
20700,alors,0,0,37,37
23521,hun,0,0,37,37
9060,cada,0,0,37,37
12761,nogen,0,0,37,37
30671,mich,0,0,37,37
560,flummox,2,3,34,37
22252,तरह,0,0,36,36
839,science,2,6,30,36
6196,также,0,0,36,36
23209,exemplo,0,0,36,36
3330,mediawiki,2,4,32,36
10880,pero,0,0,36,36
13778,cuando,0,0,36,36
29208,très,0,0,36,36
29051,alguém,0,0,36,36
33636,quelqu,0,0,36,36
32972,alguien,0,0,36,36
32798,जैसे,0,0,36,36
33864,leur,0,0,36,36
2240,hai,1,36,0,36
15443,todos,0,0,36,36
15562,रहे,0,0,36,36
39284,വിക്കിപീഡിയ,0,0,36,36
30908,iemand,0,0,36,36
42721,olika,0,0,36,36
8435,του,0,0,36,36
17881,así,0,0,36,36
28351,water,0,0,36,36
46370,deze,0,0,36,36
18472,ejemplo,0,0,36,36
18873,något,0,0,36,36
25929,human,0,0,36,36
38021,usuarios,0,0,35,35
41591,ತುಂಬಾ,0,0,35,35
9663,woord,0,0,35,35
40508,model,0,0,35,35
9259,project,0,0,35,35
40886,person,0,0,35,35
37876,language,0,0,35,35
947,tempo,2,19,16,35
21294,don,0,0,35,35
218,parola,1,35,0,35
19027,sig,0,0,35,35
22076,então,0,0,35,35
13330,كنت,0,0,35,35
25900,palabra,0,0,35,35
45766,même,0,0,35,35
2214,sa,2,1,34,35
25327,conteúdo,0,0,35,35
34959,अपने,0,0,35,35
327,terrence,2,4,31,35
24123,decir,0,0,35,35
16478,también,0,0,35,35
21520,palavra,0,0,35,35
27639,شخص,0,0,35,35
41103,все,0,0,34,34
40251,how,0,0,34,34
5778,donc,0,0,34,34
2551,vista,2,14,20,34
41592,goed,0,0,34,34
14170,homme,0,0,34,34
28753,your,0,0,34,34
33264,suis,0,0,34,34
45323,edições,0,0,34,34
19466,usuários,0,0,34,34
6947,sens,0,0,34,34
1353,base,2,14,20,34
9071,ça,0,0,34,34
8509,ನನಗೆ,0,0,34,34
21094,into,0,0,34,34
37629,sido,0,0,34,34
21603,von,0,0,34,34
2864,uno,2,17,17,34
26530,ved,0,0,34,34
36253,selon,0,0,34,34
1755,work,2,1,33,34
35942,ಇದು,0,0,34,34
11378,dan,0,0,34,34
44919,vill,0,0,34,34
24859,когда,0,0,33,33
18420,അല്ലെങ്കിൽ,0,0,33,33
23258,mycket,0,0,33,33
23859,mir,0,0,33,33
9979,например,0,0,33,33
37790,apprentissage,0,0,33,33
16267,очень,0,0,33,33
17213,ao,0,0,33,33
10459,aan,0,0,33,33
43358,deux,0,0,33,33
44380,nombre,0,0,33,33
19416,naar,0,0,33,33
34990,ook,0,0,33,33
29750,porque,0,0,33,33
36249,dir,0,0,33,33
22629,phrase,0,0,33,33
13816,सकता,0,0,33,33
5585,artigo,0,0,33,33
9678,lugar,0,0,33,33
7687,between,0,0,33,33
24242,när,0,0,33,33
34260,two,0,0,33,33
28614,även,0,0,33,33
39973,muy,0,0,32,32
10568,أنا,0,0,32,32
19142,peut,0,0,32,32
19307,somebody,0,0,32,32
38783,كانت,0,0,32,32
30808,इसके,0,0,32,32
157,così,1,32,0,32
37519,données,0,0,32,32
37687,faire,0,0,32,32
36902,another,0,0,32,32
10410,अगर,0,0,32,32
21742,бы,0,0,32,32
11765,करते,0,0,32,32
35463,natural,0,0,32,32
35119,means,0,0,32,32
1999,persona,2,11,21,32
20640,går,0,0,32,32
33048,avez,0,0,32,32
6489,auf,0,0,32,32
15362,detta,0,0,32,32
877,due,2,20,12,32
38949,signifie,0,0,32,32
20397,hon,0,0,32,32
5219,bin,0,0,32,32
23267,जा,0,0,32,32
25556,عام,0,0,31,31
22066,fix,0,0,31,31
18911,general,0,0,31,31
259,momento,2,12,19,31
1462,realmente,2,1,30,31
44077,hur,0,0,31,31
7466,will,0,0,31,31
1160,test,2,6,25,31
32353,вам,0,0,31,31
14912,chose,0,0,31,31
38800,bra,0,0,31,31
44296,skulle,0,0,31,31
34282,qualquer,0,0,31,31
18467,статьи,0,0,31,31
2320,dette,2,1,30,31
8737,genom,0,0,31,31
15879,சில,0,0,31,31
10019,etwas,0,0,31,31
30232,exemple,0,0,31,31
2522,quindi,1,31,0,31
10311,dus,0,0,31,31
10862,einen,0,0,31,31
39589,projeto,0,0,31,31
4914,well,0,0,31,31
40640,ο,0,0,31,31
28294,hebt,0,0,31,31
29854,waren,0,0,31,31
40138,often,0,0,31,31
36940,πείτε,0,0,31,31
18210,നിങ്ങളുടെ,0,0,31,31
9704,ordet,0,0,30,30
3609,esempio,1,30,0,30
5946,artículo,0,0,30,30
13687,páginas,0,0,30,30
36789,λέξη,0,0,30,30
12165,partir,0,0,30,30
6079,അതിനാൽ,0,0,30,30
41475,want,0,0,30,30
14382,called,0,0,30,30
22869,لقد,0,0,30,30
22918,bem,0,0,30,30
39018,बारे,0,0,30,30
24110,но,0,0,30,30
41420,статей,0,0,30,30
8639,fue,0,0,30,30
30094,she,0,0,30,30
2547,mobile,2,4,26,30
29117,ಅದನ್ನು,0,0,30,30
28716,هل,0,0,30,30
28364,være,0,0,30,30
2540,lui,2,4,26,30
5659,research,0,0,30,30
41498,contenu,0,0,29,29
4442,estou,0,0,29,29
39083,लेकिन,0,0,29,29
322,loro,1,29,0,29
42423,ediciones,0,0,29,29
35211,он,0,0,29,29
39067,هي,0,0,29,29
21119,उस,0,0,29,29
38232,sorry,0,0,29,29
1363,editor,2,2,27,29
47635,exempel,0,0,29,29
33288,system,0,0,29,29
252,perché,1,29,0,29
44118,puede,0,0,29,29
45975,لم,0,0,29,29
28771,know,0,0,29,29
24941,artificial,0,0,29,29
30194,अधिक,0,0,29,29
15530,free,0,0,29,29
21697,där,0,0,29,29
1692,tipo,2,10,19,29
35063,good,0,0,29,29
8626,fazer,0,0,29,29
47202,чтобы,0,0,29,29
8420,study,0,0,29,29
18931,dich,0,0,29,29
10344,monde,0,0,29,29
27308,gibi,0,0,29,29
40265,who,0,0,29,29
45436,जाता,0,0,29,29
18480,तक,0,0,29,29
5217,आपके,0,0,29,29
263,grande,2,8,21,29
37351,أخرى,0,0,28,28
30058,hier,0,0,28,28
25468,वे,0,0,28,28
7330,tan,0,0,28,28
12999,உங்கள்,0,0,28,28
30899,them,0,0,28,28
9504,مثل,0,0,28,28
19387,हूं,0,0,28,28
22085,σημαίνει,0,0,28,28
43429,которые,0,0,28,28
23357,ainsi,0,0,28,28
42841,apenas,0,0,28,28
23021,images,0,0,28,28
1731,encyclopædia,2,1,27,28
176,problema,2,12,16,28
20769,ಹೇಳಬಹುದು,0,0,28,28
30517,then,0,0,28,28
982,nella,1,28,0,28
28227,ಆದ್ದರಿಂದ,0,0,28,28
3401,tra,1,28,0,28
10238,because,0,0,28,28
624,youtube,2,1,27,28
5836,din,0,0,28,28
6156,haben,0,0,28,28
28410,several,0,0,28,28
3383,casa,2,9,19,28
31647,الذي,0,0,27,27
37494,за,0,0,27,27
15324,betekent,0,0,27,27
28921,στην,0,0,27,27
21438,knowledge,0,0,27,27
27648,eso,0,0,27,27
19867,gå,0,0,27,27
25413,get,0,0,27,27
37529,τι,0,0,27,27
34824,estoy,0,0,27,27
9339,anglais,0,0,27,27
37103,revista,0,0,27,27
901,qualcosa,1,27,0,27
684,posso,2,13,14,27
10579,sich,0,0,27,27
5314,هو,0,0,27,27
27195,அதை,0,0,27,27
27145,يمكن,0,0,27,27
26997,question,0,0,27,27
4719,вас,0,0,27,27
14571,while,0,0,27,27
3723,voce,1,27,0,27
47393,place,0,0,27,27
21049,ಒಂದು,0,0,27,27
34521,sind,0,0,27,27
28843,പറയാൻ,0,0,27,27
32724,åh,0,0,27,27
17641,zou,0,0,27,27
3011,fare,1,27,0,27
689,sistema,2,13,14,27
28770,otros,0,0,27,27
44960,dont,0,0,27,27
14390,меня,0,0,27,27
17417,τόσο,0,0,26,26
529,dati,1,26,0,26
25539,करता,0,0,26,26
16149,än,0,0,26,26
42956,كل,0,0,26,26
37007,very,0,0,26,26
23819,known,0,0,26,26
3816,problem,0,0,26,26
16602,inglés,0,0,26,26
43811,olduğunu,0,0,26,26
20854,amigos,0,0,26,26
47387,aber,0,0,26,26
35653,eles,0,0,26,26
32010,surface,0,0,26,26
24558,mundo,0,0,26,26
19902,für,0,0,26,26
26879,अच्छा,0,0,26,26
24992,ಆದರೆ,0,0,26,26
25833,أنه,0,0,26,26
19765,تم,0,0,26,26
11571,μην,0,0,26,26
14234,τους,0,0,26,26
821,sia,1,26,0,26
46011,seus,0,0,26,26
14055, million,0,0,26,26
25267,έχετε,0,0,26,26
4413,daha,0,0,26,26
21540,जब,0,0,26,26
38687,αλλά,0,0,26,26
10056,быть,0,0,26,26
1333,bene,1,26,0,26
21240,இல்லை,0,0,26,26
32195,είμαι,0,0,26,26
37679,ofta,0,0,25,25
41443,información,0,0,25,25
8868,dessa,0,0,25,25
1044,quanto,2,15,10,25
20838,था।,0,0,25,25
1932,va,2,11,14,25
9020,annat,0,0,25,25
12058,بشكل,0,0,25,25
19319,quelque,0,0,25,25
37801,بعض,0,0,25,25
10009,enciclopédia,0,0,25,25
34624,sätt,0,0,25,25
11464,الإنجليزية,0,0,25,25
30341,कई,0,0,25,25
19262,nous,0,0,25,25
43570,bedeutet,0,0,25,25
20303,uit,0,0,25,25
751,dal,1,25,0,25
505,cosa,2,23,2,25
13935,contenido,0,0,25,25
32460,κάτι,0,0,25,25
24830,ஆனால்,0,0,25,25
13808,werd,0,0,25,25
13791,எனவே,0,0,25,25
5432,കഴിയും,0,0,25,25
8117,wort,0,0,25,25
7303,could,0,0,25,25
6826,something,0,0,25,25
7511,made,0,0,25,25
38625,iets,0,0,25,25
33257,слово,0,0,25,25
43160,அவள்,0,0,25,25
28723,after,0,0,25,25
43736,tous,0,0,25,25
29668,gut,0,0,25,25
37337,sehr,0,0,25,25
15354,both,0,0,25,25
28445,لك,0,0,24,24
2423,tre,2,11,13,24
40771,प्राप्त,0,0,24,24
28026,within,0,0,24,24
19442,process,0,0,24,24
33855,desde,0,0,24,24
46963,found,0,0,24,24
7221,этого,0,0,24,24
39676,automatique,0,0,24,24
11288,notamment,0,0,24,24
37236,alguns,0,0,24,24
35306,esto,0,0,24,24
47785,artikelen,0,0,24,24
36814,अन्य,0,0,24,24
34621,where,0,0,24,24
28706,dag,0,0,24,24
3126,caso,2,7,17,24
2700,world,2,1,23,24
11658,pela,0,0,24,24
41249,users,0,0,24,24
41548,उदाहरण,0,0,24,24
36482,years,0,0,24,24
29799,अंग्रेजी,0,0,24,24
8500,sous,0,0,24,24
29562,ama,0,0,24,24
8883,estar,0,0,24,24
18529,estaba,0,0,24,24
2446,madre,2,12,12,24
47229,у,0,0,24,24
12160,using,0,0,24,24
35162,hem,0,0,24,24
27760,outra,0,0,24,24
41813,diferentes,0,0,24,24
33975,få,0,0,24,24
47329,doen,0,0,24,24
35552,செய்ய,0,0,24,24
3272,stata,1,24,0,24
9336,kommer,0,0,24,24
330,tanto,2,7,17,24
43902,bland,0,0,24,24
6134,efter,0,0,24,24
28324,ಯಾರಾದರೂ,0,0,23,23
2762,utenti,1,23,0,23
10861,sans,0,0,23,23
16445,through,0,0,23,23
1171,hey,2,2,21,23
19052,even,0,0,23,23
34607,later,0,0,23,23
15128,हूँ,0,0,23,23
15099,أي,0,0,23,23
1771,stato,1,23,0,23
28732,ville,0,0,23,23
35735,были,0,0,23,23
45186,kann,0,0,23,23
38699,ಅವರು,0,0,23,23
40086,words,0,0,23,23
35127,including,0,0,23,23
35099,godt,0,0,23,23
27064,podem,0,0,23,23
17757,sem,0,0,23,23
35295,pages,0,0,23,23
1955,disse,2,1,22,23
2384,fatto,1,23,0,23
33678,هناك,0,0,23,23
45572,veya,0,0,23,23
2246,—,2,4,19,23
36332,വിക്കിപീഡിയയിൽ,0,0,23,23
3423,via,2,3,20,23
31621,κάποιος,0,0,23,23
24924,much,0,0,23,23
2331,sempre,2,14,9,23
5491,really,0,0,23,23
535,inglese,1,23,0,23
816,lento,2,4,19,23
7149,tão,0,0,23,23
41484,nej,0,0,23,23
2302,rock,2,1,22,23
33924,votre,0,0,23,23
41556,tiene,0,0,23,23
5418,each,0,0,23,23
34094,också,0,0,23,23
31834,nos,0,0,23,23
23802,gebruiken,0,0,23,23
24312,hoe,0,0,23,23
5621,comment,0,0,23,23
31081,out,0,0,23,23
43994,first,0,0,23,23
26116,meer,0,0,23,23
5771,geen,0,0,23,23
36850,way,0,0,23,23
12081,hij,0,0,22,22
47243,المقالات,0,0,22,22
10878,según,0,0,22,22
28245,использовать,0,0,22,22
25637,utiliser,0,0,22,22
41408,является,0,0,22,22
29895,विकिमीडिया,0,0,22,22
25369,bara,0,0,22,22
2236,dalla,1,22,0,22
47711,काम,0,0,22,22
36724,başka,0,0,22,22
40202,विश्वकोश,0,0,22,22
19763,his,0,0,22,22
19099,alles,0,0,22,22
22349,användare,0,0,22,22
20050,projet,0,0,22,22
38818,ಬಗ್ಗೆ,0,0,22,22
8671,मेरे,0,0,22,22
22419,gnu,0,0,22,22
35787,otra,0,0,22,22
2199,tutto,1,22,0,22
35988,methods,0,0,22,22
29544,people,0,0,22,22
18961,text,0,0,22,22
4572,times,0,0,22,22
7472,ska,0,0,22,22
26061,just,0,0,22,22
29929,வேண்டும்,0,0,22,22
44538,travail,0,0,22,22
45777,то,0,0,22,22
45043,outros,0,0,22,22
28498,kadar,0,0,22,22
32192,थे,0,0,22,22
22319,करना,0,0,22,22
42424,от,0,0,22,22
44003,denne,0,0,22,22
9762,menos,0,0,22,22
9697,edição,0,0,22,22
19490,include,0,0,22,22
599,parole,2,21,1,22
740,quello,1,22,0,22
43277,kannst,0,0,22,22
39051,fantastisk,0,0,22,22
38506,proyecto,0,0,22,22
26466,estava,0,0,22,22
14714,году,0,0,22,22
31588,haar,0,0,22,22
45415,hade,0,0,22,22
3245,university,2,1,21,22
37256,moment,0,0,22,22
3433,nome,2,13,9,22
43603,​​,0,0,22,22
11732,என்ன,0,0,22,22
5616,inteligente,0,0,22,22
46910,शुरू,0,0,22,22
18713,versions,0,0,22,22
17957,quand,0,0,21,21
373,examples,2,1,20,21
4596,utan,0,0,21,21
35128,ver,0,0,21,21
14037,classification,0,0,21,21
13874,നിങ്ങളെ,0,0,21,21
1792,computer,2,5,16,21
37450,gøre,0,0,21,21
7676,mesmo,0,0,21,21
44841,peuvent,0,0,21,21
14226,kun,0,0,21,21
23621,go,0,0,21,21
24020,എന്ന,0,0,21,21
16000,palabras,0,0,21,21
39246,olarak,0,0,21,21
5895,journal,0,0,21,21
47818,hat,0,0,21,21
5999,generally,0,0,21,21
16788,أكثر,0,0,21,21
23759,finns,0,0,21,21
16853,kelime,0,0,21,21
508,gfdl,2,2,19,21
25192,விக்கிப்பீடியா,0,0,21,21
6455,οι,0,0,21,21
36811,تقول,0,0,21,21
46901,verwenden,0,0,21,21
33025,έχω,0,0,21,21
13487,परियोजना,0,0,21,21
17495,reported,0,0,21,21
38902,अपनी,0,0,21,21
23109,என்,0,0,21,21
43907,använda,0,0,21,21
130,nell,1,21,0,21
44290,sources,0,0,21,21
41691,trabalho,0,0,21,21
40420,şey,0,0,21,21
8573,ಅವಳು,0,0,21,21
21852,field,0,0,21,21
41461,heeft,0,0,21,21
43550,being,0,0,21,21
31660,atroz,0,0,21,21
34820,até,0,0,21,21
12003,foram,0,0,21,21
2989,creative,2,2,19,21
21201,хорошо,0,0,21,21
2998,quel,2,13,8,21
34368,environment,0,0,21,21
3875,göra,0,0,21,21
20912,yüzden,0,0,21,21
4909,anlamına,0,0,21,21
47362,hast,0,0,21,21
11286,ನಿಜವಾಗಿಯೂ,0,0,21,21
4924,mer,0,0,21,21
36164,otras,0,0,21,21
19666,related,0,0,21,21
44375,see,0,0,21,21
20701,അവൾ,0,0,21,21
10976,inglês,0,0,21,21
20531,blev,0,0,21,21
20060,ese,0,0,21,21
20095,wirklich,0,0,21,21
12806,sein,0,0,21,21
25799,എന്തെങ്കിലും,0,0,21,21
46288,qué,0,0,21,21
44291,depuis,0,0,21,21
8195,എന്നെ,0,0,21,21
27384,том,0,0,21,21
44295,gerçekten,0,0,21,21
47073,vraiment,0,0,21,21
18729,manera,0,0,20,20
20522,algunas,0,0,20,20
30565,tudo,0,0,20,20
11546,êtes,0,0,20,20
28927,क्योंकि,0,0,20,20
9514,عندما,0,0,20,20
41194,tal,0,0,20,20
35646,également,0,0,20,20
34431,editing,0,0,20,20
24387,είσαι,0,0,20,20
35582,στη,0,0,20,20
37526,changes,0,0,20,20
38548,estado,0,0,20,20
10013,certaines,0,0,20,20
35566,estás,0,0,20,20
10046,भाषा,0,0,20,20
33665,palavras,0,0,20,20
45982,suas,0,0,20,20
19893,weet,0,0,20,20
20545,മറ്റൊരു,0,0,20,20
22360,व्यक्ति,0,0,20,20
2103,systems,2,1,19,20
2347,tutti,1,20,0,20
4712,bias,0,0,20,20
28731,थी,0,0,20,20
546,marion,2,2,18,20
3581,community,2,1,19,20
22032,vezes,0,0,20,20
43808,features,0,0,20,20
17676,rules,0,0,20,20
14561,får,0,0,20,20
3177,importa,2,5,15,20
25240,automático,0,0,20,20
12921,skal,0,0,20,20
16415,mots,0,0,20,20
19101,algorithm,0,0,20,20
38896,going,0,0,20,20
1132,oro,2,12,8,20
965,grazie,1,20,0,20
13433,ആ,0,0,20,20
41371,projets,0,0,20,20
29454,यदि,0,0,20,20
913,edizioni,1,20,0,20
3282,comunità,1,20,0,20
1945,intelligence,2,1,19,20
3680,sul,2,19,1,20
5782,يا,0,0,20,20
15850,jemand,0,0,20,20
16620,её,0,0,19,19
26074,जिसका,0,0,19,19
28302,naturel,0,0,19,19
35449,означает,0,0,19,19
1371,source,2,1,18,19
36240,meu,0,0,19,19
27834,مع,0,0,19,19
16739,based,0,0,19,19
18438,fundación,0,0,19,19
3520,mining,2,7,12,19
37506,moet,0,0,19,19
38519,hay,0,0,19,19
3578,numero,1,19,0,19
45816,गया।,0,0,19,19
4151,others,0,0,19,19
1343,media,2,6,13,19
35952,vie,0,0,19,19
1338,edit,2,1,18,19
333,mio,2,18,1,19
26639,nogle,0,0,19,19
21776,different,0,0,19,19
4277,время,0,0,19,19
33603,எப்படி,0,0,19,19
4731,artikel,0,0,19,19
9859,certain,0,0,19,19
29631,public,0,0,19,19
32581,ligne,0,0,19,19
41891,பற்றி,0,0,19,19
15567,nin,0,0,19,19
7522,engelskspråkiga,0,0,19,19
5123,gör,0,0,19,19
2571,ricerca,1,19,0,19
1872,narcis,2,2,17,19
11939,wir,0,0,19,19
1914,mamma,2,7,12,19
14530,ils,0,0,19,19
41666,obtuse,0,0,19,19
29091,anden,0,0,19,19
11460,give,0,0,19,19
5245,cela,0,0,19,19
8795,पास,0,0,19,19
11392,этом,0,0,19,19
30613,संस्करण,0,0,19,19
30247,personas,0,0,19,19
2106,atroce,2,10,9,19
12973,website,0,0,19,19
33541,நன்றி,0,0,19,19
39380,όταν,0,0,19,19
40087,mor,0,0,19,19
42337,säger,0,0,19,19
766,sms,2,1,18,19
42235,similar,0,0,19,19
47031,comunidade,0,0,19,19
6148,peu,0,0,19,19
15914,tiempo,0,0,19,19
1182,narciso,2,6,13,19
6238,percent,0,0,19,19
6507,particular,0,0,19,19
6572,वास्तव,0,0,19,19
33785,شيء,0,0,19,19
34655,since,0,0,18,18
11146,now,0,0,18,18
26104,нет,0,0,18,18
10360,gaat,0,0,18,18
34644,σαν,0,0,18,18
47397,उन,0,0,18,18
39378,ктото,0,0,18,18
29762,im,0,0,18,18
3002,intelligente,2,13,5,18
36125,without,0,0,18,18
19432,år,0,0,18,18
29963,manier,0,0,18,18
40612,pays,0,0,18,18
26697,आपने,0,0,18,18
2417,cool,2,1,17,18
18994,embora,0,0,18,18
2631,punto,2,11,7,18
46280,يجب,0,0,18,18
1307,altri,1,18,0,18
29210,ಆ,0,0,18,18
10222,அந்த,0,0,18,18
25756,although,0,0,18,18
20538,où,0,0,18,18
8149,ಸ್ಮಾರ್ಟ್,0,0,18,18
5781,bruge,0,0,18,18
2057,melissa,2,2,16,18
5957,através,0,0,18,18
24454,façon,0,0,18,18
23580,said,0,0,18,18
23405,sitio,0,0,18,18
44030,جدًا,0,0,18,18
6958,حقًا,0,0,18,18
37331,могут,0,0,18,18
25177,bent,0,0,18,18
47685,mismo,0,0,18,18
43442,поэтому,0,0,18,18
36533,size,0,0,18,18
8145,पता,0,0,18,18
32086,يعني,0,0,18,18
31010,art,0,0,18,18
2275,degli,1,18,0,18
1598,insieme,1,18,0,18
727,altro,1,18,0,18
8521,york,0,0,18,18
21777,ensemble,0,0,18,18
5216,español,0,0,18,18
25647,millions,0,0,18,18
37715,dois,0,0,18,18
21548,american,0,0,18,18
43563,contributors,0,0,18,18
21053,original,0,0,18,18
9658,എല്ലാ,0,0,18,18
26014,einer,0,0,18,18
20682,large,0,0,18,18
18601,livre,0,0,18,18
24052,take,0,0,18,18
28025,antes,0,0,18,18
18247,सभी,0,0,18,18
17288,они,0,0,18,18
1785,davvero,1,18,0,18
38943,wordt,0,0,18,18
17430,form,0,0,18,18
18109,editions,0,0,18,18
2798,essa,2,5,13,18
4606,vilket,0,0,18,18
17908,गए,0,0,18,18
14392,pelo,0,0,18,18
46986,चाहते,0,0,18,18
16761,arbejde,0,0,18,18
14489,mon,0,0,18,18
2830,progetti,1,18,0,18
35561,ihnen,0,0,18,18
15960,trabajo,0,0,18,18
1698,suo,1,18,0,18
16412,u,0,0,18,18
39301,fois,0,0,18,18
38872,могу,0,0,18,18
27482,algunos,0,0,18,18
14950,его,0,0,18,18
28013,let,0,0,18,18
35682,políticas,0,0,17,17
37976,sedan,0,0,17,17
9054,लेखों,0,0,17,17
45278,datos,0,0,17,17
917,durante,2,4,13,17
3780,million,0,0,17,17
25844,ja,0,0,17,17
454,dall,1,17,0,17
34364,já,0,0,17,17
39721,among,0,0,17,17
9698,vers,0,0,17,17
30949,mucho,0,0,17,17
14622,those,0,0,17,17
1386,input,2,2,15,17
20564,ನಿಮ್ಮನ್ನು,0,0,17,17
28059,ಎಂದರೆ,0,0,17,17
20791,только,0,0,17,17
26082,flummoxed,0,0,17,17
28054,bunu,0,0,17,17
20666,lors,0,0,17,17
20600,சொல்லலாம்,0,0,17,17
30943,various,0,0,17,17
28786,igen,0,0,17,17
4620,எனக்கு,0,0,17,17
34278,however,0,0,17,17
17139,flera,0,0,17,17
47716,κάνει,0,0,17,17
15825,मैंने,0,0,17,17
33023,vida,0,0,17,17
6714,during,0,0,17,17
16686,kunne,0,0,17,17
47754,woorden,0,0,17,17
15827,सबसे,0,0,17,17
4338,есть,0,0,17,17
4336,några,0,0,17,17
15926,τώρα,0,0,17,17
4252,சொல்,0,0,17,17
1557,bbc,2,1,16,17
6024,same,0,0,17,17
16188,pessoa,0,0,17,17
45493,biraz,0,0,17,17
22904,många,0,0,17,17
22845,väldigt,0,0,17,17
3486,vandalismo,2,2,15,17
3544,deve,2,2,15,17
28215,plusieurs,0,0,17,17
25618,echt,0,0,17,17
15007,mãe,0,0,17,17
42740,cualquier,0,0,17,17
34176,eram,0,0,17,17
39584,akıllı,0,0,17,17
3531,–,2,1,16,17
4385,över,0,0,17,17
28680,material,0,0,17,17
857,questa,1,17,0,17
16845,നന്ദി,0,0,17,17
28519,license,0,0,17,17
45349,स्मार्ट,0,0,17,17
41786,इसलिए,0,0,17,17
25551,agora,0,0,17,17
47396,worden,0,0,17,17
26735,idiomas,0,0,17,17
34790,ஸ்மார்ட்,0,0,17,17
29695,يتم,0,0,17,17
4047,बाद,0,0,17,17
26629,lad,0,0,17,17
1336,erano,1,17,0,17
17968,इसका,0,0,17,17
11478,ocean,0,0,17,17
2653,progetto,1,17,0,17
4819,λέξεις,0,0,17,17
44532,models,0,0,17,17
40414,tak,0,0,17,17
29347,existe,0,0,17,17
28947,comunidad,0,0,17,17
30057,estão,0,0,17,17
14197,hej,0,0,17,17
19623,ευχαριστώ,0,0,17,17
35958,என்பது,0,0,17,17
19225,différentes,0,0,17,17
28823,tid,0,0,17,17
2683,sulla,1,17,0,17
34619,كلمة,0,0,17,17
4667,job,0,0,17,17
38575,न,0,0,17,17
16389,இருக்கிறேன்,0,0,17,17
1039,alcuni,1,17,0,17
10966,அவர்,0,0,17,17
35074,vandalism,0,0,17,17
19261,vet,0,0,17,17
8219,değil,0,0,16,16
1278,nota,2,2,14,16
20054,há,0,0,16,16
12897,ഏറ്റവും,0,0,16,16
33981,certains,0,0,16,16
43696,പക്ഷേ,0,0,16,16
25403,chaque,0,0,16,16
1786,fonte,2,10,6,16
15297,ഇപ്പോൾ,0,0,16,16
15451,making,0,0,16,16
7614,låt,0,0,16,16
22578,center,0,0,16,16
47667,того,0,0,16,16
7758,according,0,0,16,16
2255,edizione,1,16,0,16
28615,еще,0,0,16,16
38767,शामिल,0,0,16,16
16954,heel,0,0,16,16
4049,mellan,0,0,16,16
40914,ಹೇಗೆ,0,0,16,16
37399,då,0,0,16,16
3392,lingua,1,16,0,16
16189,ici,0,0,16,16
38643,uns,0,0,16,16
1532,quali,1,16,0,16
16473,होता,0,0,16,16
16079,artikeln,0,0,16,16
33656,mest,0,0,16,16
28976,species,0,0,16,16
33672,january,0,0,16,16
43727,पहले,0,0,16,16
35051,όπως,0,0,16,16
5579,എങ്ങനെ,0,0,16,16
33355,além,0,0,16,16
2088,metodi,1,16,0,16
2671,visto,2,5,11,16
39205,otro,0,0,16,16
27176,hvordan,0,0,16,16
42126,όχι,0,0,16,16
35037,может,0,0,16,16
35509,वाले,0,0,16,16
18659,ahora,0,0,16,16
13224,bij,0,0,16,16
6710,себя,0,0,16,16
42073,ചില,0,0,16,16
6895,eftersom,0,0,16,16
39471,bijvoorbeeld,0,0,16,16
32962,erg,0,0,16,16
1727,vuoi,1,16,0,16
32687,partie,0,0,16,16
45716,right,0,0,16,16
25182,forme,0,0,16,16
28482,γιατί,0,0,16,16
17397,stupendous,0,0,16,16
31822,obtuso,0,0,16,16
38214,antal,0,0,16,16
25992,zin,0,0,16,16
41234,நன்றாக,0,0,16,16
44979,space,0,0,16,16
18430,έχει,0,0,16,16
38924,முடியும்,0,0,16,16
4589,nach,0,0,16,16
30070,ut,0,0,16,16
41129,آسف,0,0,16,16
3886,मुफ्त,0,0,16,16
9958,их,0,0,16,16
31120,ऐसा,0,0,16,16
44390,οπότε,0,0,16,16
193,lavoro,1,16,0,16
37967,σου,0,0,16,16
5166,ir,0,0,16,16
17727,अब,0,0,16,16
26316,god,0,0,16,16
26248,got,0,0,16,16
4106,fick,0,0,16,16
77,cita,2,1,15,16
20504,wäre,0,0,16,16
19852,என்னை,0,0,16,16
678,news,2,1,15,16
26222,बार,0,0,16,16
20152,ഇംഗ്ലീഷ്,0,0,16,16
452,altre,1,16,0,16
20129,mysql,0,0,16,16
30725,ನಾವು,0,0,16,16
431,importante,2,3,13,16
40679,wil,0,0,16,16
43057,tack,0,0,16,16
36468,العمل,0,0,16,16
17181,système,0,0,16,16
25918,texto,0,0,16,16
21563,conception,0,0,16,16
38269,contributeurs,0,0,16,16
28730,puis,0,0,16,16
34238,πρέπει,0,0,16,16
31623,end,0,0,16,16
5174,ആരെങ്കിലും,0,0,16,16
34288,மீண்டும்,0,0,16,16
21404,വിക്കിപീഡിയർ,0,0,16,16
41293,समय,0,0,16,16
8775,غير,0,0,16,16
1034,informazioni,1,16,0,16
3895,μπορώ,0,0,16,16
36255,वाक्यांश,0,0,15,15
2727,bomis,2,2,13,15
2260,lei,2,10,5,15
43705,todas,0,0,15,15
28820,pouco,0,0,15,15
36942,ga,0,0,15,15
34253,mindre,0,0,15,15
44238,كما,0,0,15,15
1886,tua,1,15,0,15
34815,केवल,0,0,15,15
36927,ನನ್ನನ್ನು,0,0,15,15
34538,använder,0,0,15,15
2325,dvd,2,4,11,15
32268,peux,0,0,15,15
44161,utilisé,0,0,15,15
28848,avoir,0,0,15,15
33016,måste,0,0,15,15
29350,العديد,0,0,15,15
31510,bana,0,0,15,15
31438,forms,0,0,15,15
32481,अर्थ,0,0,15,15
31398,wilt,0,0,15,15
27070,αυτή,0,0,15,15
415,create,2,1,14,15
31396,இப்போது,0,0,15,15
29314,الآن,0,0,15,15
26898,mars,0,0,15,15
31248,होती,0,0,15,15
44197,रही,0,0,15,15
33207,gracias,0,0,15,15
27619,before,0,0,15,15
33789,hvor,0,0,15,15
30142,maintenant,0,0,15,15
28260,ένας,0,0,15,15
44017,política,0,0,15,15
474,esse,2,5,10,15
28017,alexa,0,0,15,15
928,molti,1,15,0,15
13347,ಮಾಡಲು,0,0,15,15
42092,andre,0,0,15,15
10630,ലേഖനങ്ങൾ,0,0,15,15
22666,learn,0,0,15,15
1359,poco,2,3,12,15
17008,कैसे,0,0,15,15
10633,ಅದ್ಭುತ,0,0,15,15
20903,»,0,0,15,15
14738,désolé,0,0,15,15
179,principe,2,3,12,15
39108,слова,0,0,15,15
37335,माँ,0,0,15,15
1222,campo,2,10,5,15
6294,qualité,0,0,15,15
16756,keine,0,0,15,15
19566,ter,0,0,15,15
47752,موسوعة,0,0,15,15
6733,artikler,0,0,15,15
41670,start,0,0,15,15
5026,हम,0,0,15,15
10109,supervised,0,0,15,15
679,fin,2,1,14,15
615,secondo,1,15,0,15
38888,vamos,0,0,15,15
11827,அவர்கள்,0,0,15,15
17582,zoals,0,0,15,15
21845,ಏನು,0,0,15,15
852,open,2,1,14,15
46921,frases,0,0,15,15
17788,hacer,0,0,15,15
18720,सब,0,0,15,15
32,ora,1,15,0,15
15461,phrases,0,0,15,15
9986,administradores,0,0,15,15
784,dia,2,1,14,15
2035,nelle,1,15,0,15
19051,morgen,0,0,15,15
43516,tasks,0,0,15,15
46629,estados,0,0,15,15
8686,statistical,0,0,15,15
10963,इसकी,0,0,15,15
23826,einem,0,0,15,15
621,alcune,1,15,0,15
12970,había,0,0,15,15
39807,ella,0,0,15,15
42766,januari,0,0,15,15
47840,networks,0,0,15,15
38245,portal,0,0,15,15
12397,википедию,0,0,15,15
39570,considered,0,0,15,15
37308,lista,0,0,15,15
13678,μπορείς,0,0,15,15
9629,tell,0,0,15,15
46160,conditions,0,0,15,15
783,usare,1,15,0,15
41139,ಧನ್ಯವಾದಗಳು,0,0,15,15
12705,janeiro,0,0,15,15
3654,algoritmi,1,15,0,15
47792,üzgünüm,0,0,15,15
3441,weekend,2,2,13,15
40238,modifications,0,0,15,15
9682,favor,0,0,15,15
10,idea,2,4,11,15
16649,procent,0,0,15,15
39228,omdat,0,0,15,15
16556,sometimes,0,0,15,15
12953,जिसे,0,0,15,15
1384,dopo,1,15,0,15
41247,statistics,0,0,14,14
18428,gelir,0,0,14,14
13092,onde,0,0,14,14
18755,ओह,0,0,14,14
18862,outras,0,0,14,14
1315,usa,2,3,11,14
27132,grandes,0,0,14,14
9034,daar,0,0,14,14
27021,ويكيبيديا،,0,0,14,14
3932,رقم,0,0,14,14
5196,bist,0,0,14,14
8976,måde,0,0,14,14
35284,ماذا,0,0,14,14
26872,geweldig,0,0,14,14
26789,zaman,0,0,14,14
31668,मतलब,0,0,14,14
5179,κάποιον,0,0,14,14
41068,न्यूपीडिया,0,0,14,14
650,dai,1,14,0,14
30750,¿qué,0,0,14,14
16754,ingen,0,0,14,14
4218,oss,0,0,14,14
35528,hecho,0,0,14,14
44952,common,0,0,14,14
30571,மன்னிக்கவும்,0,0,14,14
11411,ta,0,0,14,14
4254,når,0,0,14,14
28316,muitas,0,0,14,14
30520,después,0,0,14,14
4977,annan,0,0,14,14
15261,ಕ್ಷಮಿಸಿ,0,0,14,14
30512,sí,0,0,14,14
11076,helt,0,0,14,14
1864,contenuto,1,14,0,14
30463,veel,0,0,14,14
16970,pueden,0,0,14,14
44409,لذا,0,0,14,14
27561,total,0,0,14,14
40991,last,0,0,14,14
9494,അവർ,0,0,14,14
2394,stati,1,14,0,14
35861,pesquisa,0,0,14,14
31039,более,0,0,14,14
1273,possono,1,14,0,14
10179,dar,0,0,14,14
27824,types,0,0,14,14
17929,θέλετε,0,0,14,14
46526,possible,0,0,14,14
17651,كيف,0,0,14,14
8913,देते,0,0,14,14
10295,hvilket,0,0,14,14
38897,мы,0,0,14,14
4452,अच्छी,0,0,14,14
47441,encyclopedias,0,0,14,14
2979,prima,1,14,0,14
43812,முடியாது,0,0,14,14
899,alto,2,5,9,14
22476,विकी,0,0,14,14
6625,sujet,0,0,14,14
3470,september,2,1,13,14
22860,global,0,0,14,14
6668,popular,0,0,14,14
6675,jetzt,0,0,14,14
1481,hanno,1,14,0,14
22617,hakkında,0,0,14,14
42072,tenho,0,0,14,14
22474,немного,0,0,14,14
13527,siento,0,0,14,14
40452,संस्थान,0,0,14,14
22237,χρησιμοποιήσετε,0,0,14,14
21940,diesem,0,0,14,14
25594,edits,0,0,14,14
32979,யாராவது,0,0,14,14
5479,air,0,0,14,14
32930,make,0,0,14,14
19345,allt,0,0,14,14
47755,help,0,0,14,14
45669,review,0,0,14,14
45663,narcissus,0,0,14,14
1576,sciences,2,1,13,14
24147,après,0,0,14,14
47903,δουλειά,0,0,14,14
24172,puedo,0,0,14,14
45547,point,0,0,14,14
43999,toda,0,0,14,14
23847,analysis,0,0,14,14
5917,أنني,0,0,14,14
43524,editorial,0,0,14,14
3355,altra,1,14,0,14
33453,type,0,0,14,14
23613,problems,0,0,14,14
23587,estudo,0,0,14,14
12935,embargo,0,0,14,14
24562,تكون,0,0,14,14
3400,può,1,14,0,14
33428,ಸಾಧ್ಯವಿಲ್ಲ,0,0,14,14
24819,शब्दों,0,0,14,14
47072,here,0,0,14,14
29669,என்ற,0,0,14,14
7794,ಈಗ,0,0,14,14
7587,zit,0,0,14,14
12491,biases,0,0,14,14
12311,же,0,0,14,14
36234,மற்றொரு,0,0,14,14
39978,feature,0,0,14,14
14058,página,0,0,14,14
36209,stated,0,0,14,14
8199,εδώ,0,0,14,14
47626,ഓ,0,0,14,14
14590,satz,0,0,14,14
8672,किये,0,0,14,14
42835,next,0,0,14,14
34800,temas,0,0,14,14
31701,linguistiques,0,0,14,14
36103,ihre,0,0,14,14
4506,notion,0,0,14,14
1844,invece,1,14,0,14
38252,devam,0,0,14,14
1042,vai,2,5,9,14
11201,continue,0,0,14,14
2572,ci,1,14,0,14
25843,قد,0,0,14,14
32655,essen,0,0,14,14
7198,small,0,0,14,14
3102,fine,2,10,4,14
41897,أنك,0,0,14,14
3639,modello,1,14,0,14
7437,objet,0,0,14,14
25762,undskyld,0,0,14,14
41816,algumas,0,0,14,14
25781,projetos,0,0,14,14
5417,animals,0,0,14,14
5401,fra,0,0,14,14
20422,sonra,0,0,14,14
26046,estupendo,0,0,14,14
12021,december,0,0,13,13
29538,active,0,0,13,13
47343,bread,0,0,13,13
40748,எனது,0,0,13,13
30389,ಅನ್ನು,0,0,13,13
29322,فقط,0,0,13,13
30387,ചെയ്യാൻ,0,0,13,13
42864,vários,0,0,13,13
11839,sendo,0,0,13,13
29736,vídeo,0,0,13,13
11749,källor,0,0,13,13
13013,हूं।,0,0,13,13
11494,pão,0,0,13,13
40039,بالإنجليزية,0,0,13,13
30440,less,0,0,13,13
8161,الكلمة,0,0,13,13
7982,который,0,0,13,13
7599,think,0,0,13,13
44187,misin,0,0,13,13
32426,registrados,0,0,13,13
32490,svenskspråkiga,0,0,13,13
2210,ottuso,1,13,0,13
7257,techniques,0,0,13,13
7112,day,0,0,13,13
7012,olan,0,0,13,13
7002,dock,0,0,13,13
32830,eten,0,0,13,13
6818,സ്മാർട്ട്,0,0,13,13
33231,largest,0,0,13,13
2012,performance,2,3,10,13
33311,disso,0,0,13,13
511,joseph,2,1,12,13
33449,decision,0,0,13,13
6015,nasıl,0,0,13,13
5990,يناير,0,0,13,13
33450,dizendo,0,0,13,13
33493,están,0,0,13,13
8041,comer,0,0,13,13
8194,parce,0,0,13,13
47390,redigeringar,0,0,13,13
8269,über,0,0,13,13
11138,major,0,0,13,13
4954,எனக்குத்,0,0,13,13
30514,voulez,0,0,13,13
10898,upp,0,0,13,13
10812,alt,0,0,13,13
47445,venner,0,0,13,13
30976,exempelvis,0,0,13,13
34342,gaan,0,0,13,13
9352,moeder,0,0,13,13
41317,όλα,0,0,13,13
31640,tüm,0,0,13,13
34316,unidos,0,0,13,13
29228,обучения,0,0,13,13
8933,unsupervised,0,0,13,13
31667,biri,0,0,13,13
34233,diğer,0,0,13,13
41433,άλλο,0,0,13,13
34214,terme,0,0,13,13
31796,maneira,0,0,13,13
34164,siger,0,0,13,13
8388,vänner,0,0,13,13
1925,narcisse,2,1,12,13
38025,pan,0,0,13,13
38362,ಸ್ವಲ್ಪ,0,0,13,13
3793,rather,0,0,13,13
17040,حول,0,0,13,13
20529,matter,0,0,13,13
43673,ledsen,0,0,13,13
39057,access,0,0,13,13
36543,tarafından,0,0,13,13
45742,حتى,0,0,13,13
26088,tarde,0,0,13,13
3930,कार्य,0,0,13,13
393,stesso,1,13,0,13
28357,लाइसेंस,0,0,13,13
36580,próxima,0,0,13,13
22687,مقالة,0,0,13,13
160,casi,2,5,8,13
15978,lite,0,0,13,13
28432,versión,0,0,13,13
15804,wird,0,0,13,13
46752,ihr,0,0,13,13
15725,tellement,0,0,13,13
15528,संख्या,0,0,13,13
1385,gmat,2,1,12,13
15498,ψωμί,0,0,13,13
21929,important,0,0,13,13
4160,номер,0,0,13,13
21888,vidéo,0,0,13,13
2905,spesso,1,13,0,13
2883,enorme,2,5,8,13
37777,modelo,0,0,13,13
204,conoscenza,1,13,0,13
18361,colbert,0,0,13,13
21516,july,0,0,13,13
43137,दो,0,0,13,13
38641,også,0,0,13,13
43551,bazı,0,0,13,13
18587,preocupe,0,0,13,13
27765,comida,0,0,13,13
28135,food,0,0,13,13
216,quale,1,13,0,13
2832,whatsapp,2,1,12,13
17577,sætning,0,0,13,13
1255,everything,2,1,12,13
17305,numéro,0,0,13,13
3611,magazine,2,1,12,13
25632,informatie,0,0,13,13
18883,riktigt,0,0,13,13
40268,inteligentes,0,0,13,13
27386,method,0,0,13,13
2741,extra,2,1,12,13
23415,given,0,0,13,13
13757,estas,0,0,13,13
3234,oltre,1,13,0,13
14256,personne,0,0,13,13
36790,द,0,0,13,13
24222,última,0,0,13,13
45543,ли,0,0,13,13
19318,dieses,0,0,13,13
40050,mère,0,0,13,13
20146,sana,0,0,13,13
40206,παράδειγμα,0,0,13,13
24563,servidores,0,0,13,13
13625,τις,0,0,13,13
38179,varios,0,0,13,13
13240,чем,0,0,13,13
23552,об,0,0,13,13
13451,എന്താണ്,0,0,13,13
13303,eğer,0,0,13,13
19484,bom,0,0,13,13
24768,informations,0,0,13,13
26465,brood,0,0,13,13
46175,merci,0,0,13,13
3034,completamente,2,6,7,13
23096,بين,0,0,13,13
44804,care,0,0,13,13
14989,информации,0,0,13,13
37327,licence,0,0,13,13
39726,därför,0,0,13,13
19390,نيوبيديا,0,0,13,13
26534,gold,0,0,13,13
14674,melhor,0,0,13,13
14626,auch,0,0,13,13
24915,quieres,0,0,13,13
44767,bunun,0,0,13,13
38084,इन,0,0,13,13
14609,amis,0,0,13,13
36127,agudo,0,0,13,13
23779,friends,0,0,13,13
8154,red,0,0,12,12
25878,moi,0,0,12,12
32496,aus,0,0,12,12
3048,pane,1,12,0,12
21209,name,0,0,12,12
8129,enquanto,0,0,12,12
26184,zorgen,0,0,12,12
8000,vinkel,0,0,12,12
20089,जाने,0,0,12,12
3694,email,2,2,10,12
26152,afin,0,0,12,12
7781,sehen,0,0,12,12
32269,étaient,0,0,12,12
21302,long,0,0,12,12
22429,dictionary,0,0,12,12
21389,energy,0,0,12,12
6041,phase,0,0,12,12
2096,pattern,2,7,5,12
23155,वीडियो,0,0,12,12
6271,ചെയ്യുന്നു,0,0,12,12
24775,ठीक,0,0,12,12
6220,souvent,0,0,12,12
33316,gjort,0,0,12,12
5580,mal,0,0,12,12
23543,angle,0,0,12,12
2101,wikipediaorg,2,1,11,12
23639,nom,0,0,12,12
23795,final,0,0,12,12
24306,أنت,0,0,12,12
33475,development,0,0,12,12
3300,proprio,1,12,0,12
45489,पृष्ठ,0,0,12,12
24149,real,0,0,12,12
33263,varit,0,0,12,12
22911,fut,0,0,12,12
7234,beaucoup,0,0,12,12
21848,جيدًا,0,0,12,12
3101,sotto,1,12,0,12
32598,informações,0,0,12,12
7206,saying,0,0,12,12
45302,عبارة,0,0,12,12
7147,généralement,0,0,12,12
25681,مقالات,0,0,12,12
21688,stop,0,0,12,12
32941,ನಂತರ,0,0,12,12
6655,veces,0,0,12,12
6891,എന്നാൽ,0,0,12,12
2276,webby,2,2,10,12
22559,score,0,0,12,12
33187,eksempel,0,0,12,12
22600,सॉफ्टवेयर,0,0,12,12
22734,history,0,0,12,12
33244,видео,0,0,12,12
26247,nada,0,0,12,12
13076,resultado,0,0,12,12
26332,pain,0,0,12,12
4511,മികച്ച,0,0,12,12
29938,للغاية,0,0,12,12
91,tuo,1,12,0,12
11884,dollars,0,0,12,12
29988,समुदाय,0,0,12,12
11808,growth,0,0,12,12
14890,تريد,0,0,12,12
15103,действительно,0,0,12,12
11313,documentation,0,0,12,12
11240,നമ്പർ,0,0,12,12
28705,फिर,0,0,12,12
2733,toefl,2,1,11,12
2487,contenuti,1,12,0,12
44481,trop,0,0,12,12
16305,milhões,0,0,12,12
28332,modèle,0,0,12,12
16479,الكلمات,0,0,12,12
390,libro,2,7,5,12
44557,طريقة,0,0,12,12
95,mentre,1,12,0,12
30724,വിക്കിപീഡിയയിലെ,0,0,12,12
14498,उपयोगकर्ताओं,0,0,12,12
2668,tale,2,8,4,12
4676,created,0,0,12,12
29164,കഴിയുന്ന,0,0,12,12
12938,أفضل,0,0,12,12
29485,под,0,0,12,12
12809,links,0,0,12,12
12740,mother,0,0,12,12
4758,grand,0,0,12,12
29643,другие,0,0,12,12
29054,مما,0,0,12,12
13602,ραντεβού,0,0,12,12
29706,grymt,0,0,12,12
12455,climate,0,0,12,12
28963,потому,0,0,12,12
12322,hommes,0,0,12,12
13877,hayır,0,0,12,12
47242,βίντεο,0,0,12,12
16666,manière,0,0,12,12
28219,tun,0,0,12,12
26376,toutes,0,0,12,12
18485,fragen,0,0,12,12
9324,edición,0,0,12,12
46212,dieser,0,0,12,12
9004,muchas,0,0,12,12
26973,kind,0,0,12,12
19122,cas,0,0,12,12
19125,നിങ്ങളോട്,0,0,12,12
19193,stor,0,0,12,12
26611,algoritmos,0,0,12,12
19450,έτσι,0,0,12,12
8454,atrocious,0,0,12,12
8448,उपलब्ध,0,0,12,12
26434,vais,0,0,12,12
8411,great,0,0,12,12
31846,उन्हें,0,0,12,12
31903,தெரியும்,0,0,12,12
8346,स्रोत,0,0,12,12
8273,सर्वर,0,0,12,12
9335,bidrag,0,0,12,12
9405,obtus,0,0,12,12
17049,nem,0,0,12,12
9466,berätta,0,0,12,12
10547,règles,0,0,12,12
10507,demander,0,0,12,12
46563,normal,0,0,12,12
44965,harika,0,0,12,12
44408,contributions,0,0,12,12
67,ed,1,12,0,12
10189,ll,0,0,12,12
18067,prendre,0,0,12,12
2870,heller,2,1,11,12
18147,നിന്ന്,0,0,12,12
10047,proyectos,0,0,12,12
18324,mejor,0,0,12,12
9962,though,0,0,12,12
9928,കഴിയില്ല,0,0,12,12
9831,should,0,0,12,12
31180,leurs,0,0,12,12
27571,أيضًا,0,0,12,12
24056,مقال,0,0,12,12
42377,जाते,0,0,12,12
24944,gang,0,0,12,12
38677,accuracy,0,0,12,12
38009,ile,0,0,12,12
37911,haciendo,0,0,12,12
36505,होने,0,0,12,12
39540,watch,0,0,12,12
41980,спасибо,0,0,12,12
37846,ಓಹ್,0,0,12,12
36612,encontro,0,0,12,12
883,pronuncia,2,11,1,12
37793,muazzam,0,0,12,12
33714,lakes,0,0,12,12
33727,хотите,0,0,12,12
39411,इंटरनेट,0,0,12,12
39406,lado,0,0,12,12
37673,vrienden,0,0,12,12
1564,international,2,1,11,12
41836,شيئًا,0,0,12,12
38865,concept,0,0,12,12
41320,plants,0,0,12,12
41642,aquí,0,0,12,12
1806,prix,2,1,11,12
37010,تعني,0,0,12,12
37068,avait,0,0,12,12
37131,français,0,0,12,12
39028,twee,0,0,12,12
37174,virkelig,0,0,12,12
848,po,1,12,0,12
34905,facebook,0,0,12,12
35309,tip,0,0,12,12
1271,primo,1,12,0,12
38409,havde,0,0,12,12
35434,zum,0,0,12,12
714,dici,1,12,0,12
41427,mayor,0,0,12,12
1653,consenso,2,2,10,12
36210,dies,0,0,12,12
43639,देने,0,0,12,12
40041,poderia,0,0,12,12
42893,structure,0,0,12,12
38193,gehen,0,0,12,12
33648,sob,0,0,12,12
38156,discussão,0,0,12,12
35512,thank,0,0,12,12
41392,விரும்பினால்,0,0,12,12
42335,теперь,0,0,12,12
34570,tidigare,0,0,12,12
42921,issues,0,0,12,12
36379,güzel,0,0,12,12
929,vale,2,4,8,12
1892,qualche,1,11,0,11
46348,ask,0,0,11,11
17120,एवं,0,0,11,11
46272,देता,0,0,11,11
644,quelle,2,5,6,11
16985,best,0,0,11,11
2480,economist,2,1,10,11
18985,wörter,0,0,11,11
38925,grupo,0,0,11,11
38803,μαζί,0,0,11,11
17710,few,0,0,11,11
1313,melli,2,1,10,11
17746,βικιπαίδεια,0,0,11,11
34542,καλά,0,0,11,11
38410,häpnadsväckande,0,0,11,11
30892,zich,0,0,11,11
4086,ويلز,0,0,11,11
30845,querida,0,0,11,11
38791,dados,0,0,11,11
18809,சொல்ல,0,0,11,11
38457,incrível,0,0,11,11
2404,esempi,1,11,0,11
17972,année,0,0,11,11
4070,him,0,0,11,11
46424,ഉപയോഗിക്കാൻ,0,0,11,11
4211,reference,0,0,11,11
46604,entanto,0,0,11,11
31054,würde,0,0,11,11
34203,perform,0,0,11,11
14596,संस्करणों,0,0,11,11
4518,diese,0,0,11,11
14544,परियोजनाओं,0,0,11,11
14505,network,0,0,11,11
31697,critiques,0,0,11,11
14180,जानकारी,0,0,11,11
14179,results,0,0,11,11
47039,communauté,0,0,11,11
13719,contenidos,0,0,11,11
40098,استخدام,0,0,11,11
31635,mutter,0,0,11,11
31874,interaction,0,0,11,11
13116,mes,0,0,11,11
40281,medan,0,0,11,11
13035,wikipediaartiklar,0,0,11,11
47133,reste,0,0,11,11
32075,ditt,0,0,11,11
44268,யாரோ,0,0,11,11
12502,tres,0,0,11,11
1038,michael,2,1,10,11
39763,realizado,0,0,11,11
15236,predictions,0,0,11,11
16752,ആണ്,0,0,11,11
4298,данных,0,0,11,11
16738,لكن,0,0,11,11
31095,mij,0,0,11,11
34477,várias,0,0,11,11
39255,கொள்ளுங்கள்,0,0,11,11
34471,यहाँ,0,0,11,11
16581,ccbysa,0,0,11,11
1202,suoi,1,11,0,11
2383,anni,1,11,0,11
16233,langues,0,0,11,11
16160,जानते,0,0,11,11
42971,toen,0,0,11,11
16010,είστε,0,0,11,11
46739,toujours,0,0,11,11
46745,april,0,0,11,11
4352,métodos,0,0,11,11
15760,us,0,0,11,11
15730,ಜೌಗು,0,0,11,11
4364,innehåll,0,0,11,11
46760,technology,0,0,11,11
15537,report,0,0,11,11
19014,слов,0,0,11,11
20386,must,0,0,11,11
38290,minutes,0,0,11,11
35325,ولكن,0,0,11,11
25699,nombreux,0,0,11,11
36414,modifier,0,0,11,11
25646,création,0,0,11,11
25645,représentation,0,0,11,11
3121,amici,1,11,0,11
35292,videon,0,0,11,11
36522,además,0,0,11,11
36535,один,0,0,11,11
3152,national,2,1,10,11
28793,around,0,0,11,11
25174,कहा,0,0,11,11
24974,layer,0,0,11,11
24913,எண்,0,0,11,11
28938,மூலம்,0,0,11,11
36763,மேலும்,0,0,11,11
35156,projects,0,0,11,11
36787,permet,0,0,11,11
24611,vragen,0,0,11,11
406,award,2,1,10,11
1764,algoritmo,2,3,8,11
25754,nein,0,0,11,11
38287,researchers,0,0,11,11
1617,output,2,3,8,11
1718,natura,2,6,5,11
35742,siempre,0,0,11,11
35804,உங்களை,0,0,11,11
27555,processus,0,0,11,11
44894,இங்கே,0,0,11,11
35976,सामग्री,0,0,11,11
35983,semana,0,0,11,11
26992,rna,0,0,11,11
1748,nei,1,11,0,11
1671,argomenti,1,11,0,11
26818,detection,0,0,11,11
358,licenza,1,11,0,11
26692,tot,0,0,11,11
26645,φράση,0,0,11,11
28463,aqui,0,0,11,11
28535,hele,0,0,11,11
26111,ago,0,0,11,11
26019,वेल्स,0,0,11,11
26016,şimdi,0,0,11,11
24427,intelligent,0,0,11,11
24255,conversation,0,0,11,11
24239,afschuwelijk,0,0,11,11
2658,support,2,1,10,11
21066,día,0,0,11,11
3721,dispiace,1,11,0,11
20774,रोटी,0,0,11,11
37929,bonne,0,0,11,11
38035,şeyi,0,0,11,11
30112,regression,0,0,11,11
20395,beispiel,0,0,11,11
4828,websites,0,0,11,11
46024,quality,0,0,11,11
20189,approach,0,0,11,11
3794,obrigado,0,0,11,11
1380,processo,2,6,5,11
38052,feito,0,0,11,11
44487,часто,0,0,11,11
30348,view,0,0,11,11
38240,سبيل,0,0,11,11
30360,soit,0,0,11,11
19270,instead,0,0,11,11
43217,internal,0,0,11,11
34804,having,0,0,11,11
34806,social,0,0,11,11
21355,थे।,0,0,11,11
420,mai,2,8,3,11
24049,هنا,0,0,11,11
44665,pedir,0,0,11,11
37162,πεις,0,0,11,11
23574,application,0,0,11,11
23399,did,0,0,11,11
414,qual,2,4,7,11
23287,order,0,0,11,11
23191,வேண்டாம்,0,0,11,11
37635,principal,0,0,11,11
3661,dato,2,8,3,11
29712,sen,0,0,11,11
37654,करें,0,0,11,11
2580,chiedere,1,11,0,11
3587,today,2,1,10,11
21902,cependant,0,0,11,11
21894,cerca,0,0,11,11
21701,samma,0,0,11,11
45884,php,0,0,11,11
12082,உங்களிடம்,0,0,11,11
30954,plaats,0,0,11,11
33840,why,0,0,11,11
32894,críticas,0,0,11,11
40990,avant,0,0,11,11
705,poi,1,11,0,11
2213,volte,1,11,0,11
6143,ഞങ്ങൾ,0,0,11,11
40901,فإن,0,0,11,11
1970,libera,1,11,0,11
40889,class,0,0,11,11
43908,policy,0,0,11,11
8910,ni,0,0,11,11
10990,stump,0,0,11,11
32466,questions,0,0,11,11
6070,nombreuses,0,0,11,11
5995,available,0,0,11,11
8707,тебе,0,0,11,11
5609,मदद,0,0,11,11
2132,association,2,1,10,11
5870,देख,0,0,11,11
5627,países,0,0,11,11
40838,became,0,0,11,11
33075,descartes,0,0,11,11
698,pena,2,3,8,11
32544,three,0,0,11,11
813,giorno,1,11,0,11
32357,altın,0,0,11,11
43903,cuenta,0,0,11,11
6814,zal,0,0,11,11
32740,burada,0,0,11,11
6695,dieu,0,0,11,11
2183,vengono,1,11,0,11
6620,ನಾರ್ಸಿಸಾ,0,0,11,11
6893,atmosphere,0,0,11,11
9615,ശരിക്കും,0,0,11,11
9994,tror,0,0,11,11
10017,πραγματικά,0,0,11,11
41233,कम,0,0,11,11
10080,laten,0,0,11,11
32818,पूरी,0,0,11,11
6293,travers,0,0,11,11
9263,ಬಯಸಿದರೆ,0,0,11,11
9196,written,0,0,11,11
41037,werk,0,0,11,11
33919,ஓ,0,0,11,11
9125,حيث,0,0,11,11
10347,fueron,0,0,11,11
41019,estudio,0,0,11,11
9045,सुस्त,0,0,11,11
11241,viel,0,0,11,11
41162,france,0,0,11,11
33247,വാക്കുകൾ,0,0,11,11
7629,depois,0,0,11,11
11579,nee,0,0,11,11
40619,enligt,0,0,11,11
2241,microsoft,2,2,9,11
7665,πώς,0,0,11,11
40737,കൂടുതൽ,0,0,11,11
7476,परेशान,0,0,11,11
7736,அதாவது,0,0,11,11
11426,usually,0,0,11,11
5354,través,0,0,11,11
11643,sabe,0,0,11,11
19198,mere,0,0,10,10
29523,examen,0,0,10,10
34646,bots,0,0,10,10
603,computing,2,8,2,10
19074,konsensus,0,0,10,10
19045,тебя,0,0,10,10
2616,hg,2,1,9,10
19029,അവൻ,0,0,10,10
44037,laws,0,0,10,10
29263,fonctionnement,0,0,10,10
22079,बात,0,0,10,10
22989,tienes,0,0,10,10
32892,الفيديو,0,0,10,10
3942,nouveaux,0,0,10,10
312,usato,1,10,0,10
9025,almost,0,0,10,10
22919,അങ്ങനെ,0,0,10,10
33351,too,0,0,10,10
46176,cansado,0,0,10,10
3878,body,0,0,10,10
38194,parfois,0,0,10,10
30316,ellos,0,0,10,10
25244,certeza,0,0,10,10
7094,seen,0,0,10,10
24153,ancak,0,0,10,10
2703,sapere,2,9,1,10
34670,ಬ್ರೆಡ್,0,0,10,10
35278,dream,0,0,10,10
44115,langue,0,0,10,10
30777,मूल,0,0,10,10
38549,bon,0,0,10,10
9591,janvier,0,0,10,10
30740,mein,0,0,10,10
7704,स्थिति,0,0,10,10
1813,volta,1,10,0,10
46403,участники,0,0,10,10
18401,toute,0,0,10,10
22843,okay,0,0,10,10
23628,ಅದರ,0,0,10,10
37092,varför,0,0,10,10
9659,program,0,0,10,10
6867,deep,0,0,10,10
18258,étude,0,0,10,10
37119,diz,0,0,10,10
18641,stedet,0,0,10,10
3992,fortælle,0,0,10,10
6935,temps,0,0,10,10
37267,अंत,0,0,10,10
9566,بعد,0,0,10,10
46326,signal,0,0,10,10
29315,«нупедии»,0,0,10,10
41735,licença,0,0,10,10
33376,во,0,0,10,10
2469,neurali,1,10,0,10
3965,раз,0,0,10,10
54,ellie,2,1,9,10
9419,leven,0,0,10,10
24003,تفعل,0,0,10,10
33820,serait,0,0,10,10
7032,जिन्हें,0,0,10,10
7717,bedankt,0,0,10,10
30282,bidragsgivare,0,0,10,10
5212,onder,0,0,10,10
36650,topic,0,0,10,10
45793,الذكية,0,0,10,10
20802,machines,0,0,10,10
24874,بدلاً,0,0,10,10
41488,υπέροχο,0,0,10,10
41510,يكون,0,0,10,10
45463,maioria,0,0,10,10
1825,mondo,1,10,0,10
24729,свою,0,0,10,10
41522,أستطيع,0,0,10,10
37841,വിക്കിപീഡിയയുടെ,0,0,10,10
24683,μητέρα,0,0,10,10
41685,sina,0,0,10,10
43287,own,0,0,10,10
8574,तुम,0,0,10,10
3668,obama,2,1,9,10
34885,covered,0,0,10,10
34748,ऑनलाइन,0,0,10,10
21478,möte,0,0,10,10
7298,الأخرى,0,0,10,10
3645,state,2,5,5,10
2567,usando,2,2,8,10
35101,areas,0,0,10,10
8483,чтото,0,0,10,10
22242,theory,0,0,10,10
1441,frasi,1,10,0,10
37691,fras,0,0,10,10
42578,nur,0,0,10,10
7454,développement,0,0,10,10
876,sé,2,3,7,10
21964,चिंता,0,0,10,10
24436,nécessaire,0,0,10,10
24889,negative,0,0,10,10
7135,உங்களுக்குத்,0,0,10,10
19926,mis,0,0,10,10
44689,outer,0,0,10,10
41683,outro,0,0,10,10
36706,acesso,0,0,10,10
20047,enero,0,0,10,10
24236,istället,0,0,10,10
38070,ud,0,0,10,10
2699,io,1,10,0,10
8922,fontes,0,0,10,10
47692,dank,0,0,10,10
22693,problemas,0,0,10,10
32942,некоторые,0,0,10,10
22467,चाहता,0,0,10,10
41951,flora,0,0,10,10
25087,tengo,0,0,10,10
24241,வேலை,0,0,10,10
7114,deras,0,0,10,10
29184,mim,0,0,10,10
8876,ki,0,0,10,10
30133,خلال,0,0,10,10
41435,search,0,0,10,10
8862,function,0,0,10,10
36743,published,0,0,10,10
6749,versões,0,0,10,10
25,sarebbe,1,10,0,10
44521,ಇಲ್ಲ,0,0,10,10
20586,têm,0,0,10,10
33771,которую,0,0,10,10
35189,humaine,0,0,10,10
2535,reti,1,10,0,10
20634,applications,0,0,10,10
8730,ναρκίσσα,0,0,10,10
8781,تحرير,0,0,10,10
6806,usage,0,0,10,10
39613,living,0,0,10,10
27498,denk,0,0,10,10
34225,wide,0,0,10,10
11168,fondation,0,0,10,10
14573,вместо,0,0,10,10
44186,χρυσό,0,0,10,10
4937,wrote,0,0,10,10
2318,propose,2,1,9,10
27158,verkligen,0,0,10,10
11239,பின்னர்,0,0,10,10
14100,traag,0,0,10,10
27370,november,0,0,10,10
31788,wikidata,0,0,10,10
40792,gemaakt,0,0,10,10
35466,sure,0,0,10,10
31804,etc,0,0,10,10
13638,έξυπνη,0,0,10,10
27014,subject,0,0,10,10
26987,voir,0,0,10,10
14713,υπάρχει,0,0,10,10
1161,italiano,2,5,5,10
15651,rigtig,0,0,10,10
26556,قبل,0,0,10,10
15514,disputas,0,0,10,10
15414,можно,0,0,10,10
31481,استخدامها,0,0,10,10
15360,nouvelle,0,0,10,10
31522,வேறு,0,0,10,10
45109,ക്ഷമിക്കണം,0,0,10,10
15227,l’idée,0,0,10,10
31591,разделов,0,0,10,10
15211,represented,0,0,10,10
33501,inglesa,0,0,10,10
26775,lack,0,0,10,10
42315,tinha,0,0,10,10
35481,geven,0,0,10,10
40779,trouve,0,0,10,10
34409,निर्माण,0,0,10,10
13549,मेरी,0,0,10,10
44984,tog,0,0,10,10
1714,fair,2,2,8,10
2038,ricerche,1,10,0,10
12593,होगा,0,0,10,10
11710,gebruikt,0,0,10,10
34047,inputs,0,0,10,10
2804,seria,2,1,9,10
12359,topics,0,0,10,10
28106,ibland,0,0,10,10
32199,ob,0,0,10,10
40516,നന്നായി,0,0,10,10
98,programming,2,1,9,10
32226,मुख्य,0,0,10,10
47352,waar,0,0,10,10
35698,came,0,0,10,10
27992,मिला,0,0,10,10
43884,ಪದವನ್ನು,0,0,10,10
35557,medical,0,0,10,10
27772,англ,0,0,10,10
5757,premier,0,0,10,10
368,grado,2,9,1,10
40235,neural,0,0,10,10
1079,scientifiche,1,10,0,10
31898,didn,0,0,10,10
13018,vision,0,0,10,10
35814,അടുത്ത,0,0,10,10
27883,ಕೆಲವು,0,0,10,10
40375,guld,0,0,10,10
40377,público,0,0,10,10
31997,casos,0,0,10,10
42807,utilisation,0,0,10,10
5741,πιο,0,0,10,10
2852,termini,1,10,0,10
152,guardian,2,3,7,10
33790,நல்லது,0,0,10,10
31368,engelska,0,0,10,10
6402,internautes,0,0,10,10
33640,مرة,0,0,10,10
17465,можешь,0,0,10,10
16825,pendant,0,0,10,10
10411,இருக்கும்,0,0,10,10
32572,law,0,0,10,10
1900,ciò,1,10,0,10
5578,منذ,0,0,10,10
30961,sætninger,0,0,10,10
17370,communautés,0,0,10,10
10362,दी,0,0,10,10
38926,enkele,0,0,10,10
26009,både,0,0,10,10
36230,millones,0,0,10,10
43063,തന്നെ,0,0,10,10
3042,artificiale,1,10,0,10
39183,møde,0,0,10,10
10021,ഉദാഹരണത്തിന്,0,0,10,10
3049,studio,1,10,0,10
16772,philosophie,0,0,10,10
36128,bort,0,0,10,10
31069,learned,0,0,10,10
42192,erreurs,0,0,10,10
17051,جميع,0,0,10,10
33684,ಬಳಸಬಹುದಾದ,0,0,10,10
10154,सम्बंधित,0,0,10,10
10097,liv,0,0,10,10
16905,accord,0,0,10,10
36377,organisms,0,0,10,10
25969,encore,0,0,10,10
10557,nas,0,0,10,10
43021,लगभग,0,0,10,10
15774,algorithmes,0,0,10,10
40913,raison,0,0,10,10
30810,svenska,0,0,10,10
30833,things,0,0,10,10
46461,vue,0,0,10,10
1885,posto,1,10,0,10
10660,दिन,0,0,10,10
32708,teşekkür,0,0,10,10
38813,ويكي,0,0,10,10
1972,golden,2,1,9,10
16183,imagens,0,0,10,10
16324,பயன்படுத்தக்கூடிய,0,0,10,10
3064,origine,2,3,7,10
2381,pizza,2,1,9,10
41121,முடியுமா,0,0,10,10
6579,izin,0,0,10,10
2428,barack,2,1,9,10
3069,questi,1,9,0,9
1531,sogno,1,9,0,9
5716,ஆம்,0,0,9,9
308,nah,2,1,8,9
27609,vu,0,0,9,9
27697,nästa,0,0,9,9
42362,moins,0,0,9,9
42016,weather,0,0,9,9
42060,σπίτι,0,0,9,9
25751,अवयवों,0,0,9,9
3138,viene,1,9,0,9
1533,server,2,3,6,9
25530,muchos,0,0,9,9
37088,debido,0,0,9,9
5402,நல்ல,0,0,9,9
24060,states,0,0,9,9
7509,ge,0,0,9,9
25897,sea,0,0,9,9
24227,passe,0,0,9,9
23870,थी।,0,0,9,9
36512,தங்க,0,0,9,9
24040,മലയാളം,0,0,9,9
24499,serveurs,0,0,9,9
47881,usado,0,0,9,9
36048,تمامًا,0,0,9,9
47706,stumpf,0,0,9,9
24790,των,0,0,9,9
24812,со,0,0,9,9
25292,имеет,0,0,9,9
7150,zegt,0,0,9,9
5612,yerine,0,0,9,9
2957,android,2,1,8,9
42081,palo,0,0,9,9
25213,तरीका,0,0,9,9
5600,image,0,0,9,9
36198,improve,0,0,9,9
45212,mathematical,0,0,9,9
26651,policyer,0,0,9,9
3014,avere,1,9,0,9
36727,influence,0,0,9,9
6037,home,0,0,9,9
26407,språk,0,0,9,9
748,riviste,1,9,0,9
1581,meno,1,9,0,9
26562,publicados,0,0,9,9
36194,inhoud,0,0,9,9
41922,waarom,0,0,9,9
45347,become,0,0,9,9
24520,humans,0,0,9,9
26096,страниц,0,0,9,9
27532,хлеб,0,0,9,9
36861,ಇಲ್ಲಿ,0,0,9,9
27420,когото,0,0,9,9
3151,sai,2,8,1,9
24442,beste,0,0,9,9
24502,dices,0,0,9,9
7422,maior,0,0,9,9
24516,sueño,0,0,9,9
27273,eran,0,0,9,9
25330,تعرف,0,0,9,9
45059,المحتوى,0,0,9,9
351,vita,1,9,0,9
42393,assim,0,0,9,9
24595,look,0,0,9,9
41877,கட்டுரைகள்,0,0,9,9
24636,goal,0,0,9,9
25390,geben,0,0,9,9
42353,hasta,0,0,9,9
24686,ಯಾವುದೇ,0,0,9,9
23715,creación,0,0,9,9
11991,அற்புதமான,0,0,9,9
23665,gentil,0,0,9,9
39450,designed,0,0,9,9
4242,ليس,0,0,9,9
4246,போல,0,0,9,9
4265,λίγο,0,0,9,9
5024,cümle,0,0,9,9
16441,river,0,0,9,9
16138,bruger,0,0,9,9
4996,meses,0,0,9,9
10722,linux,0,0,9,9
15764,şekilde,0,0,9,9
18291,जाती,0,0,9,9
40887,still,0,0,9,9
4957,ತಿಳಿದಿದೆ,0,0,9,9
39575,ouro,0,0,9,9
46794,sluggish,0,0,9,9
46799,référence,0,0,9,9
15267,ಚಿನ್ನದ,0,0,9,9
15238,beauty,0,0,9,9
11063,författarna,0,0,9,9
16630,anyone,0,0,9,9
39193,juste,0,0,9,9
10320,bajo,0,0,9,9
16786,lieu,0,0,9,9
1274,sue,2,6,3,9
938,logo,2,1,8,9
5096,forskare,0,0,9,9
47510,आवश्यकता,0,0,9,9
5091,typically,0,0,9,9
9849,plant,0,0,9,9
41114,traditional,0,0,9,9
38848,وهذا,0,0,9,9
17645,நாங்கள்,0,0,9,9
9955,sabes,0,0,9,9
38915,ஏதாவது,0,0,9,9
44956,seni,0,0,9,9
43086,ip,0,0,9,9
10093,estos,0,0,9,9
16882,ಯಾರನ್ನಾದರೂ,0,0,9,9
39104,hand,0,0,9,9
16811,section,0,0,9,9
15207,klotter,0,0,9,9
987,copyright,2,3,6,9
15196,interest,0,0,9,9
13441,third,0,0,9,9
42796,vetenskapliga,0,0,9,9
13065,pessoas,0,0,9,9
12994,و,0,0,9,9
40371,average,0,0,9,9
40385,error,0,0,9,9
12842,grausam,0,0,9,9
4738,επίσης,0,0,9,9
12731,kanal,0,0,9,9
12671,этих,0,0,9,9
47163,الرغم,0,0,9,9
12630,anstelle,0,0,9,9
11644,revisão,0,0,9,9
12622,என்றால்,0,0,9,9
12611,quer,0,0,9,9
42858,которое,0,0,9,9
12212,echter,0,0,9,9
4823,الكثير,0,0,9,9
13387,latin,0,0,9,9
40773,sitios,0,0,9,9
39626,comprendre,0,0,9,9
13631,seguro,0,0,9,9
46892,am,0,0,9,9
14907,sicher,0,0,9,9
14757,held,0,0,9,9
11083,rêve,0,0,9,9
39772,weil,0,0,9,9
39782,feliz,0,0,9,9
14603,havia,0,0,9,9
4523,моя,0,0,9,9
14300,able,0,0,9,9
39948,stort,0,0,9,9
11209,بها,0,0,9,9
14167,क्यों,0,0,9,9
40065,aunque,0,0,9,9
13639,fazla,0,0,9,9
40780,organização,0,0,9,9
4630,étatsunis,0,0,9,9
13633,disponible,0,0,9,9
18167,ಏಕೆಂದರೆ,0,0,9,9
18301,werken,0,0,9,9
23634,वेब,0,0,9,9
8356,harvard,0,0,9,9
609,libero,1,9,0,9
275,rete,1,9,0,9
7779,permite,0,0,9,9
22292,ഉള്ള,0,0,9,9
22127,எந்த,0,0,9,9
22107,analyse,0,0,9,9
37663,нарцисса,0,0,9,9
47632,cet,0,0,9,9
8463,créer,0,0,9,9
4016,warum,0,0,9,9
264,fu,1,9,0,9
43301,olmak,0,0,9,9
47619,dess,0,0,9,9
21595,slim,0,0,9,9
21493,universe,0,0,9,9
21457,vertellen,0,0,9,9
8503,jour,0,0,9,9
3662,false,2,1,8,9
1465,quella,1,9,0,9
45723,variables,0,0,9,9
37413,μετά,0,0,9,9
22834,approximately,0,0,9,9
31,già,1,9,0,9
41737,versiones,0,0,9,9
37200,policies,0,0,9,9
37275,ഇല്ല,0,0,9,9
43500,været,0,0,9,9
23304,ದೌರ್ಜನ್ಯ,0,0,9,9
23222,i̇ngilizce,0,0,9,9
23215,smarta,0,0,9,9
23205,addition,0,0,9,9
23182,اليوم,0,0,9,9
23174,fråga,0,0,9,9
37311,fler,0,0,9,9
37338,arbete,0,0,9,9
23016,mina,0,0,9,9
22922,ഇവിടെ,0,0,9,9
45720,pourquoi,0,0,9,9
3480,premio,2,7,2,9
45957,hvorfor,0,0,9,9
3690,cd,2,1,8,9
21088,act,0,0,9,9
19715,человека,0,0,9,9
3866,started,0,0,9,9
19510,ಇನ್ನೊಂದು,0,0,9,9
8999,этот,0,0,9,9
9013,logiciel,0,0,9,9
43222,ओर,0,0,9,9
46182,honom,0,0,9,9
9026,ಹೇಳಲು,0,0,9,9
9140,фраза,0,0,9,9
18950,sonho,0,0,9,9
9327,இருக்க,0,0,9,9
18871,anne,0,0,9,9
9439,persoon,0,0,9,9
18739,lidt,0,0,9,9
18705,date,0,0,9,9
18694,gebruik,0,0,9,9
212,arrabbiato,1,9,0,9
18550,alemán,0,0,9,9
41386,land,0,0,9,9
38090,لديك,0,0,9,9
8664,cases,0,0,9,9
19956,alterações,0,0,9,9
21034,им,0,0,9,9
20971,vraagt,0,0,9,9
20897,kunde,0,0,9,9
20849,கனவு,0,0,9,9
20803,esa,0,0,9,9
20798,fordi,0,0,9,9
8698,yo,0,0,9,9
20587,இருக்கிறது,0,0,9,9
629,factor,2,3,6,9
40586,næste,0,0,9,9
20400,дела,0,0,9,9
38038,importe,0,0,9,9
42621,falta,0,0,9,9
20294,നാർസിസ,0,0,9,9
20259,jemanden,0,0,9,9
20130,languages,0,0,9,9
20113,conocimiento,0,0,9,9
35695,sûr,0,0,9,9
19756,interview,0,0,9,9
33056,tag,0,0,9,9
44471,способ,0,0,9,9
28261,दोस्तों,0,0,9,9
2248,anno,2,8,1,9
33404,manger,0,0,9,9
2115,opera,2,6,3,9
44842,अद्भुत,0,0,9,9
29899,june,0,0,9,9
44072,bueno,0,0,9,9
1749,group,2,1,8,9
28964,personen,0,0,9,9
30462,eat,0,0,9,9
31517,cuya,0,0,9,9
2300,sta,1,9,0,9
33002,करें।,0,0,9,9
28990,better,0,0,9,9
31495,sitt,0,0,9,9
31848,veux,0,0,9,9
29476,devices,0,0,9,9
34867,leren,0,0,9,9
29369,described,0,0,9,9
2181,medio,2,1,8,9
1831,regole,1,9,0,9
28292,رائع,0,0,9,9
1745,seigenthaler,2,2,7,9
28531,μερικές,0,0,9,9
2095,milioni,1,9,0,9
29306,droom,0,0,9,9
30902,ponto,0,0,9,9
31084,ω,0,0,9,9
44840,लगता,0,0,9,9
30913,situación,0,0,9,9
33888,تعديل,0,0,9,9
28325,birçok,0,0,9,9
31770,united,0,0,9,9
31674,لذلك,0,0,9,9
29904,mine,0,0,9,9
2482,modifiche,1,9,0,9
29639,لأي,0,0,9,9
33345,principales,0,0,9,9
31033,aos,0,0,9,9
28233,decline,0,0,9,9
43795,çünkü,0,0,9,9
30404,situação,0,0,9,9
44769,τρόπος,0,0,9,9
34937,ஏன்,0,0,9,9
30050,κάνω,0,0,9,9
2206,ia,2,6,3,9
34387,estupenda,0,0,9,9
34353,إن,0,0,9,9
2610,oxford,2,1,8,9
30354,लोग,0,0,9,9
29522,vou,0,0,9,9
43974,elles,0,0,9,9
28428,άτομο,0,0,9,9
2577,link,2,2,7,9
2453,potrebbe,1,9,0,9
28218,quelques,0,0,9,9
31966,gemacht,0,0,9,9
29549,своей,0,0,9,9
34416,जाना,0,0,9,9
34722,politique,0,0,9,9
33519,especially,0,0,9,9
32375,erstaunlich,0,0,9,9
32609,ked,0,0,9,9
29023,где,0,0,9,9
1843,statistica,1,9,0,9
30082,overspoeld,0,0,9,9
2499,aveva,1,9,0,9
35438,physical,0,0,9,9
12937,senare,0,0,8,8
12253,örneğin,0,0,8,8
36729,नाम,0,0,8,8
12249,dann,0,0,8,8
12226,developed,0,0,8,8
24896,fik,0,0,8,8
22362,programa,0,0,8,8
2282,né,2,7,1,8
4136,coisa,0,0,8,8
1061,problemi,1,8,0,8
35056,उसे,0,0,8,8
28924,asking,0,0,8,8
29141,animal,0,0,8,8
17352,जनवरी,0,0,8,8
24621,möchten,0,0,8,8
46536,mitt,0,0,8,8
24851,año,0,0,8,8
12714,às,0,0,8,8
1894,cultura,2,3,5,8
12805,الشخص,0,0,8,8
4144,change,0,0,8,8
1054,gratuita,2,3,5,8
24722,källa,0,0,8,8
17599,current,0,0,8,8
22428,arbeit,0,0,8,8
29659,tijd,0,0,8,8
30933,genetic,0,0,8,8
12540,ಮೇಲೆ,0,0,8,8
12787,بما,0,0,8,8
24825,ಅವನು,0,0,8,8
12506,relatively,0,0,8,8
24829,ging,0,0,8,8
40457,ಎಂಬ,0,0,8,8
4741,सवाल,0,0,8,8
12833,primeira,0,0,8,8
17680,நர்சிசா,0,0,8,8
323,enciclopedie,1,8,0,8
31883,två,0,0,8,8
24927,विकास,0,0,8,8
11233,société,0,0,8,8
25345,rosenzweig,0,0,8,8
34869,आज,0,0,8,8
4061,referência,0,0,8,8
38728,birisi,0,0,8,8
11423,étant,0,0,8,8
4906,ऑफ़,0,0,8,8
11397,gedaan,0,0,8,8
47358,verschillende,0,0,8,8
40774,ας,0,0,8,8
45817,saber,0,0,8,8
11322,വാചകം,0,0,8,8
1002,sulle,1,8,0,8
11255,smaller,0,0,8,8
34529,tema,0,0,8,8
18264,organización,0,0,8,8
18046,engelstalige,0,0,8,8
18280,traum,0,0,8,8
18281,status,0,0,8,8
2448,rivista,1,8,0,8
2229,alan,2,2,6,8
18360,мать,0,0,8,8
25506,கொடூரமான,0,0,8,8
18368,καλή,0,0,8,8
18369,simple,0,0,8,8
40848,car,0,0,8,8
40883,mientras,0,0,8,8
16140,المنزل,0,0,8,8
35305,mad,0,0,8,8
32489,அதைப்,0,0,8,8
36464,accès,0,0,8,8
11594,प्रकार,0,0,8,8
3163,liste,2,1,7,8
45408,викимедиа,0,0,8,8
25171,которая,0,0,8,8
28893,nog,0,0,8,8
12169,धन्यवाद।,0,0,8,8
17820,verstanden,0,0,8,8
17852,हमेशा,0,0,8,8
40538,без,0,0,8,8
24994,अक्सर,0,0,8,8
25006,ordinateur,0,0,8,8
25009,स्थापना,0,0,8,8
44223,പുതിയ,0,0,8,8
12020,smarte,0,0,8,8
34014,usuário,0,0,8,8
3523,principalmente,2,1,7,8
11946,क्षमा,0,0,8,8
17894,volgende,0,0,8,8
28875,maddeleri,0,0,8,8
18045,geht,0,0,8,8
43748,lige,0,0,8,8
34012,scientific,0,0,8,8
22194,oversvømmet,0,0,8,8
40594,गयी,0,0,8,8
36624,योगदानकर्ता,0,0,8,8
47302,biography,0,0,8,8
11841,  ,0,0,8,8
42821,against,0,0,8,8
25262,diyebilirsin,0,0,8,8
11718,höflich,0,0,8,8
22156,avril,0,0,8,8
25300,التحرير,0,0,8,8
22155,சொற்கள்,0,0,8,8
30805,hög,0,0,8,8
4836,neutral,0,0,8,8
24289,eg,0,0,8,8
30994,business,0,0,8,8
39813,ಮೂಲಕ,0,0,8,8
4419,sammen,0,0,8,8
15298,lucene,0,0,8,8
37206,kanske,0,0,8,8
16319,extinction,0,0,8,8
34320,novos,0,0,8,8
16374,أريد,0,0,8,8
15070,lent,0,0,8,8
39348,ice,0,0,8,8
42958,specific,0,0,8,8
39344,trög,0,0,8,8
39662,amerika,0,0,8,8
39334,buena,0,0,8,8
3378,street,2,1,7,8
44604,cofundador,0,0,8,8
14865,ekmek,0,0,8,8
14850,launched,0,0,8,8
16417,desculpe,0,0,8,8
14803,noch,0,0,8,8
4273,kunnen,0,0,8,8
14766,usemodwiki,0,0,8,8
23735,ello,0,0,8,8
23737,misschien,0,0,8,8
46633,true,0,0,8,8
34435,disponibles,0,0,8,8
14721,сделать,0,0,8,8
39305,represent,0,0,8,8
14631,« nature »,0,0,8,8
2605,mia,1,8,0,8
16496,parmi,0,0,8,8
46818,säker,0,0,8,8
15311,computers,0,0,8,8
4414,θέλω,0,0,8,8
15637,просто,0,0,8,8
16004,ലേഖനം,0,0,8,8
16210,trained,0,0,8,8
42995,ज्यादा,0,0,8,8
42987,ಸಂಖ್ಯೆ,0,0,8,8
46643,case,0,0,8,8
39437,ഉപയോക്താക്കൾ,0,0,8,8
39444,incluindo,0,0,8,8
15886,daily,0,0,8,8
4342,നിങ്ങൾ‌ക്ക്,0,0,8,8
31295,recherche,0,0,8,8
39493,ಏನನ್ನಾದರೂ,0,0,8,8
23025,эти,0,0,8,8
31309,explica,0,0,8,8
15569,voiture,0,0,8,8
15349,trois,0,0,8,8
46780,என்னால்,0,0,8,8
4383,ರೆಂಡೆಜ್ವಸ್,0,0,8,8
39550,onlara,0,0,8,8
23325,bli,0,0,8,8
15462,control,0,0,8,8
15440,laquelle,0,0,8,8
23388,choses,0,0,8,8
16259,kullanabileceğiniz,0,0,8,8
16279,लोगों,0,0,8,8
15369,التعلم,0,0,8,8
39576,swamped,0,0,8,8
15353,lost,0,0,8,8
549,acceso,2,3,5,8
2640,scusa,1,8,0,8
39815,lunch,0,0,8,8
12978,المحررين,0,0,8,8
34963,fuente,0,0,8,8
13779,criticada,0,0,8,8
13731,ಪದ,0,0,8,8
682,senza,1,8,0,8
39068,basic,0,0,8,8
45736,हालाँकि,0,0,8,8
37429,δύο,0,0,8,8
29202,أكبر,0,0,8,8
31809,stora,0,0,8,8
31821,gång,0,0,8,8
34165,past,0,0,8,8
37437,nobrainer,0,0,8,8
2663,ambito,1,8,0,8
13413,प्रवृति,0,0,8,8
36924,unique,0,0,8,8
24303,tut,0,0,8,8
30999,importance,0,0,8,8
47118,будто,0,0,8,8
13253,changed,0,0,8,8
40271,несколько,0,0,8,8
44405,zien,0,0,8,8
17135,hennes,0,0,8,8
17171,أنها,0,0,8,8
47122,самых,0,0,8,8
1558,lenta,2,1,7,8
3266,super,2,1,7,8
17255,आया,0,0,8,8
13045,slimme,0,0,8,8
24449,últimos,0,0,8,8
37527,सहयोग,0,0,8,8
22637,book,0,0,8,8
3303,andare,1,8,0,8
24200,दूसरे,0,0,8,8
24045,klar,0,0,8,8
43861,already,0,0,8,8
465,forte,2,7,1,8
2389,sto,1,8,0,8
14553,செல்ல,0,0,8,8
31688,प्रयोग,0,0,8,8
14448,eens,0,0,8,8
14413,വലിയ,0,0,8,8
23909,εκεί,0,0,8,8
46997,reports,0,0,8,8
22822,ताकि,0,0,8,8
24017,list,0,0,8,8
14365,liberté,0,0,8,8
43868,ويكيميديا,0,0,8,8
16677,cadre,0,0,8,8
43833,¿cómo,0,0,8,8
4568,zeit,0,0,8,8
31742,déjà,0,0,8,8
4224,κάνετε,0,0,8,8
14089,bazen,0,0,8,8
34487,increasing,0,0,8,8
36988,энциклопедии,0,0,8,8
16790,hatte,0,0,8,8
14040,നു,0,0,8,8
44401,بواسطة,0,0,8,8
1543,logic,2,1,7,8
13982,ஆங்கில,0,0,8,8
31018,больше,0,0,8,8
24166,सन्दर्भ,0,0,8,8
36458,citizendium,0,0,8,8
32453,rate,0,0,8,8
10879,εάν,0,0,8,8
41740,secret,0,0,8,8
853,situazione,1,8,0,8
7976,άλλη,0,0,8,8
2558,informatica,2,7,1,8
2941,fosse,2,6,2,8
7786,análisis,0,0,8,8
33147,στον,0,0,8,8
28343,अध्ययन,0,0,8,8
7740,возможность,0,0,8,8
33163,neurons,0,0,8,8
27046,στιγμή,0,0,8,8
33816,bekommen,0,0,8,8
21339,contribuições,0,0,8,8
7686,universidad,0,0,8,8
27084,existen,0,0,8,8
30297,अनुसार,0,0,8,8
19616,legal,0,0,8,8
2004,impact,2,3,5,8
43699,quero,0,0,8,8
27167,month,0,0,8,8
2922,scientifica,1,8,0,8
27171,sais,0,0,8,8
7628,وأنت,0,0,8,8
41781,много,0,0,8,8
7569,здесь,0,0,8,8
33784,contrôle,0,0,8,8
734,school,2,1,7,8
19622,luego,0,0,8,8
27245,gave,0,0,8,8
8077,செய்து,0,0,8,8
41703,सोने,0,0,8,8
43238,mil,0,0,8,8
8467,defined,0,0,8,8
37772,работы,0,0,8,8
2994,confuso,2,2,6,8
33824,septembre,0,0,8,8
36091,muitos,0,0,8,8
36084,tradition,0,0,8,8
21529,amazing,0,0,8,8
19247,banco,0,0,8,8
5266,dites,0,0,8,8
21501,central,0,0,8,8
35426,गाड़ी,0,0,8,8
33068,ее,0,0,8,8
8516,down,0,0,8,8
38264,etmek,0,0,8,8
33100,धन्यवाद,0,0,8,8
8119,coverage,0,0,8,8
29871,early,0,0,8,8
872,male,2,1,7,8
26744,demande,0,0,8,8
1351,cluster,2,2,6,8
8279,κάνεις,0,0,8,8
43230,ഇന്ന്,0,0,8,8
8212,along,0,0,8,8
2118,ogni,1,8,0,8
3663,detto,1,8,0,8
30306,wikimédia,0,0,8,8
21382,nuevo,0,0,8,8
8152,crear,0,0,8,8
8130,numaralı,0,0,8,8
7451,सामान्य,0,0,8,8
2908,chiunque,1,8,0,8
33038,المثال,0,0,8,8
5941,zeker,0,0,8,8
6416,planer,0,0,8,8
30117,edition,0,0,8,8
20406,conjunto,0,0,8,8
20415,всех,0,0,8,8
20493,tais,0,0,8,8
20500,première,0,0,8,8
6164,ξέρετε,0,0,8,8
6089,benim,0,0,8,8
6071,hui,0,0,8,8
42256,ரொட்டி,0,0,8,8
6012,لدي,0,0,8,8
34767,erros,0,0,8,8
5965,modelos,0,0,8,8
5921,لو,0,0,8,8
46021,mange,0,0,8,8
34763,கேட்க,0,0,8,8
33520,always,0,0,8,8
2046,tramite,1,8,0,8
5835,языковых,0,0,8,8
28022,الذين,0,0,8,8
20889,ജോലി,0,0,8,8
43260,washington,0,0,8,8
5631,brot,0,0,8,8
47878,maddelerin,0,0,8,8
47882,denna,0,0,8,8
2033,normalmente,2,2,6,8
20799,inundado,0,0,8,8
5687,cache,0,0,8,8
28250,lass,0,0,8,8
27759,sadece,0,0,8,8
7388,nya,0,0,8,8
6926,മറ്റ്,0,0,8,8
7332,ഉപയോഗിക്കുന്നു,0,0,8,8
19790,loss,0,0,8,8
19982,ಕೆಲಸ,0,0,8,8
7210,ತಾಯಿ,0,0,8,8
20025,എന്നതാണ്,0,0,8,8
7178,lequel,0,0,8,8
27403,തിരുത്തലുകൾ,0,0,8,8
21176,arbeta,0,0,8,8
21151,situatie,0,0,8,8
33380,limited,0,0,8,8
6991,происходит,0,0,8,8
27565,pensar,0,0,8,8
6944,देखा,0,0,8,8
20063,academic,0,0,8,8
563,turing,2,3,5,8
33403,وقت,0,0,8,8
30242,അവളുടെ,0,0,8,8
6844,basis,0,0,8,8
33415,readers,0,0,8,8
6798,grâce,0,0,8,8
796,approccio,1,8,0,8
6681,naam,0,0,8,8
21110,ಒಳ್ಳೆಯದು,0,0,8,8
20188,സ്വയം,0,0,8,8
30211,quiero,0,0,8,8
46047,شكرا,0,0,8,8
27682,vissa,0,0,8,8
20319,worry,0,0,8,8
45,infatti,1,8,0,8
30346,quiser,0,0,8,8
33035,utilisateurs,0,0,8,8
38445,done,0,0,8,8
38439,அடுத்த,0,0,8,8
18793,äta,0,0,8,8
38423,பதிலாக,0,0,8,8
32719,vid,0,0,8,8
26029,делать,0,0,8,8
8712,പദം,0,0,8,8
34575,புதிய,0,0,8,8
33903,لغة,0,0,8,8
9683,update,0,0,8,8
30563,peutêtre,0,0,8,8
18856,él,0,0,8,8
9657,പോലെ,0,0,8,8
9636,area,0,0,8,8
9619,auteur,0,0,8,8
9614,हुए,0,0,8,8
9594,συγνώμη,0,0,8,8
21727,dedos,0,0,8,8
36259,bei,0,0,8,8
41226,första,0,0,8,8
32771,ml,0,0,8,8
9479,ayant,0,0,8,8
18921,സ്വർണ്ണ,0,0,8,8
9394,hans,0,0,8,8
21680,عدد,0,0,8,8
36221,aberta,0,0,8,8
9981,വാക്ക്,0,0,8,8
41089,oceans,0,0,8,8
46216,घर,0,0,8,8
32676,pourrait,0,0,8,8
10741,تقلق,0,0,8,8
44173,λάθος,0,0,8,8
10697,boa,0,0,8,8
30731,introduced,0,0,8,8
18553,cosas,0,0,8,8
10636,constante,0,0,8,8
1975,fonti,1,8,0,8
29803,term,0,0,8,8
32531,regions,0,0,8,8
10552,lang,0,0,8,8
43562,voluntários,0,0,8,8
10551,servers,0,0,8,8
25760,objetivo,0,0,8,8
32537,ecosystem,0,0,8,8
25768,सच,0,0,8,8
35353,enlaces,0,0,8,8
41009,всего,0,0,8,8
36378,minha,0,0,8,8
18626,कहने,0,0,8,8
36364,professor,0,0,8,8
10307,إنه,0,0,8,8
43324,meine,0,0,8,8
21842,present,0,0,8,8
41083,behavior,0,0,8,8
38496,विशेष,0,0,8,8
26242,top,0,0,8,8
36309,صفحة,0,0,8,8
19156,variations,0,0,8,8
33841,leid,0,0,8,8
33869,hause,0,0,8,8
19013,plans,0,0,8,8
32876,таких,0,0,8,8
1325,gran,2,2,6,8
47549,хочу,0,0,8,8
32908,federal,0,0,8,8
9253,ക്യാച്ച്,0,0,8,8
41355,العبارة,0,0,8,8
36176,estce,0,0,8,8
38323,будет,0,0,8,8
32904,μπορεί,0,0,8,8
46208,области,0,0,8,8
18999,universidade,0,0,8,8
33828,trafic,0,0,8,8
38343,fri,0,0,8,8
9100,εντάξει,0,0,8,8
9135,andrew,0,0,8,8
30676,يوم,0,0,7,7
18166,collaborative,0,0,7,7
44490,wikipedians,0,0,7,7
1853,presenti,1,7,0,7
30135,به,0,0,7,7
16290,drie,0,0,7,7
17277,andet,0,0,7,7
18647,unido,0,0,7,7
38262,விக்கிப்பீடியாவின்,0,0,7,7
43182,alltid,0,0,7,7
17595,джимми,0,0,7,7
46433,far,0,0,7,7
39375,إنشاء,0,0,7,7
16306,society,0,0,7,7
30144,seulement,0,0,7,7
20246,oficial,0,0,7,7
31192,значит,0,0,7,7
46190,reino,0,0,7,7
17188,ihrer,0,0,7,7
30212,avaient,0,0,7,7
17174,meeting,0,0,7,7
38744,calidad,0,0,7,7
18703,rien,0,0,7,7
18087,الخاصة,0,0,7,7
20151,environ,0,0,7,7
18195,cause,0,0,7,7
1396,quasi,1,7,0,7
17593,ವ್ಯಕ್ತಿಯನ್ನು,0,0,7,7
1878,guida,1,7,0,7
17351,используется,0,0,7,7
31225,обучение,0,0,7,7
20784,années,0,0,7,7
43127,began,0,0,7,7
43125,два,0,0,7,7
20737,började,0,0,7,7
19236,ولا,0,0,7,7
20704,dezembro,0,0,7,7
4018,representation,0,0,7,7
18418,നല്ല,0,0,7,7
19180,libres,0,0,7,7
17408,fall,0,0,7,7
31217,diskussioner,0,0,7,7
19239,शादी,0,0,7,7
38273,decirle,0,0,7,7
30982,acadêmicos,0,0,7,7
2449,prestazioni,1,7,0,7
34734,compte,0,0,7,7
16237,अत्याचारी,0,0,7,7
18561,pergunta,0,0,7,7
44455,gode,0,0,7,7
633,interesse,2,2,5,7
38029,pris,0,0,7,7
38340,verwirrt,0,0,7,7
1258,difficile,2,1,6,7
20123,effort,0,0,7,7
18737,सपना,0,0,7,7
18073,ανησυχείτε,0,0,7,7
39040,συγγνώμη,0,0,7,7
17032,neden,0,0,7,7
17906,καλό,0,0,7,7
31008,disputes,0,0,7,7
19487,doing,0,0,7,7
31110,february,0,0,7,7
16632,podría,0,0,7,7
19621,الخبز,0,0,7,7
2395,possa,2,3,4,7
19554,mensagem,0,0,7,7
43035,وهو,0,0,7,7
16981,find,0,0,7,7
3957,сша,0,0,7,7
30856,жизни,0,0,7,7
39134,விரும்புகிறேன்,0,0,7,7
16762,innehållet,0,0,7,7
18858,students,0,0,7,7
19607,jeu,0,0,7,7
19562,zwei,0,0,7,7
34576,tatlı,0,0,7,7
17700,presque,0,0,7,7
2478,ottenuto,1,7,0,7
34586,до,0,0,7,7
19005,स्थान,0,0,7,7
4104,comscore,0,0,7,7
43174,scholarpedia,0,0,7,7
16900,cruel,0,0,7,7
4193,observations,0,0,7,7
17769,ಟೆರ್ರಿ,0,0,7,7
19579,nature »,0,0,7,7
34678,table,0,0,7,7
43196,ಪದಗಳು,0,0,7,7
16416,சதுப்பு,0,0,7,7
16616,serie,0,0,7,7
38859,വേഡ്,0,0,7,7
38228,சொல்லுங்கள்,0,0,7,7
1265,varie,2,6,1,7
3974,språkversioner,0,0,7,7
2414,negativo,2,3,4,7
18750,boos,0,0,7,7
46568,फाउंडेशन,0,0,7,7
18761,criticized,0,0,7,7
20056,जीवन,0,0,7,7
1374,queste,1,7,0,7
18773,सुंदर,0,0,7,7
43845,fonds,0,0,7,7
16495,donde,0,0,7,7
38081,знаю,0,0,7,7
38790,materials,0,0,7,7
30244,جيد,0,0,7,7
30927,permettent,0,0,7,7
17673,عمل,0,0,7,7
16498,sorgen,0,0,7,7
18815,случае,0,0,7,7
20018,ocasiones,0,0,7,7
16522,использования,0,0,7,7
43030,ensuite,0,0,7,7
34522,ber,0,0,7,7
16561,target,0,0,7,7
19963,meinen,0,0,7,7
3825,makes,0,0,7,7
19949,знаете,0,0,7,7
207,ipotesi,1,7,0,7
44372,ihm,0,0,7,7
46603,drøm,0,0,7,7
31251,carruagem,0,0,7,7
32846,led,0,0,7,7
41390,अमेरिकी,0,0,7,7
8984,tiden,0,0,7,7
41372,once,0,0,7,7
9065,riktlinjer,0,0,7,7
9116,умное,0,0,7,7
2161,intelligenti,1,7,0,7
47539,weißt,0,0,7,7
42649,बना,0,0,7,7
32832,revisión,0,0,7,7
9328,ಹೆಚ್ಚು,0,0,7,7
5154,idag,0,0,7,7
42708,лучше,0,0,7,7
924,discipline,2,3,4,7
33899,संचालित,0,0,7,7
33865,bodies,0,0,7,7
8818,सेंगर,0,0,7,7
9470,estilo,0,0,7,7
8579,maak,0,0,7,7
8311,vær,0,0,7,7
8366,développé,0,0,7,7
42532,sätze,0,0,7,7
5294,teşekkürler,0,0,7,7
42581,رائعة,0,0,7,7
8514,sker,0,0,7,7
5263,användas,0,0,7,7
47591,show,0,0,7,7
5262,brød,0,0,7,7
8595,colaboradores,0,0,7,7
8646,bank,0,0,7,7
8673,helemaal,0,0,7,7
42586,pense,0,0,7,7
8736,roll,0,0,7,7
9434,willen,0,0,7,7
9500,ತಿಳಿದಿಲ್ಲ,0,0,7,7
42481,einige,0,0,7,7
5034,καθώς,0,0,7,7
47452,keer,0,0,7,7
47449,जिसमें,0,0,7,7
41045,bang,0,0,7,7
10240,voire,0,0,7,7
41023,முடியவில்லை,0,0,7,7
33941,neste,0,0,7,7
10372,vos,0,0,7,7
47473,möchte,0,0,7,7
10442,fez,0,0,7,7
40959,organization,0,0,7,7
2211,macchina,1,7,0,7
10679,anderen,0,0,7,7
10693,début,0,0,7,7
10856,കാര്യങ്ങൾ,0,0,7,7
10049,approaches,0,0,7,7
33911,sound,0,0,7,7
9554,upset,0,0,7,7
41127,gør,0,0,7,7
32767,talk,0,0,7,7
9582,étudiants,0,0,7,7
32741,positive,0,0,7,7
47535,tels,0,0,7,7
5098,качестве,0,0,7,7
32723,ربما,0,0,7,7
5087,хотя,0,0,7,7
42737,parece,0,0,7,7
32718,lavet,0,0,7,7
5077,linguistique,0,0,7,7
9947,geliyor,0,0,7,7
2188,materiale,2,6,1,7
42711,dine,0,0,7,7
950,negli,1,7,0,7
8280,together,0,0,7,7
8263,donne,0,0,7,7
4974,कहते,0,0,7,7
6538,ಅವರಿಗೆ,0,0,7,7
42157,experience,0,0,7,7
33444,rätt,0,0,7,7
6407,gün,0,0,7,7
6460,φίλους,0,0,7,7
47779,beter,0,0,7,7
788,decisione,1,7,0,7
5544,estivesse,0,0,7,7
42175,búsqueda,0,0,7,7
42135,ಮುಂದಿನ,0,0,7,7
33443,diffusion,0,0,7,7
6596,país,0,0,7,7
42097,जिस,0,0,7,7
6669,consulter,0,0,7,7
6674,работу,0,0,7,7
47786,parler,0,0,7,7
6213,جيدة,0,0,7,7
33427,difícil,0,0,7,7
42331,при,0,0,7,7
5647,donner,0,0,7,7
5690,wikiscanner,0,0,7,7
33559,geral,0,0,7,7
42348,overall,0,0,7,7
5823,aprender,0,0,7,7
5830,particulier,0,0,7,7
33482, billion,0,0,7,7
6169,meus,0,0,7,7
42263,brugere,0,0,7,7
6023,maison,0,0,7,7
5591,टिप्पणी,0,0,7,7
42247,escrito,0,0,7,7
6137,alsof,0,0,7,7
42428,अगली,0,0,7,7
795,temo,2,2,5,7
33419,denken,0,0,7,7
8241,studie,0,0,7,7
8098,കഴിക്കാൻ,0,0,7,7
7662,முறை,0,0,7,7
33798,systemic,0,0,7,7
33221,liquid,0,0,7,7
7822,έξυπνες,0,0,7,7
7867,mannen,0,0,7,7
7935,yolu,0,0,7,7
858,stai,1,7,0,7
7469,mening,0,0,7,7
8153,comparison,0,0,7,7
2116,supervisionato,1,7,0,7
8173,smuk,0,0,7,7
41675,പറഞ്ഞു,0,0,7,7
41645,भाषाओँ,0,0,7,7
868,john,2,1,6,7
7562,virtual,0,0,7,7
33753,चाहिए,0,0,7,7
42045,cual,0,0,7,7
520,intelligenza,1,7,0,7
5490,nieuwe,0,0,7,7
41967,year,0,0,7,7
7027,aardig,0,0,7,7
33369,verbete,0,0,7,7
7101,संपादन,0,0,7,7
5458,deutschland,0,0,7,7
7179,भोजन,0,0,7,7
41848,अधिकांश,0,0,7,7
41937,उनके,0,0,7,7
7215,imagen,0,0,7,7
7254,ζωή,0,0,7,7
33275,जिमी,0,0,7,7
41858,தனது,0,0,7,7
7314,उसकी,0,0,7,7
10885,sparse,0,0,7,7
4968,πάντα,0,0,7,7
16098,publicado,0,0,7,7
39942,associated,0,0,7,7
14051,separate,0,0,7,7
14101,mind,0,0,7,7
14153,result,0,0,7,7
47019,nett,0,0,7,7
14204,therefore,0,0,7,7
31705,aller,0,0,7,7
14236,επόμενη,0,0,7,7
40002,ಕ್ಯಾಚ್,0,0,7,7
14267,போன்ற,0,0,7,7
4551,setembro,0,0,7,7
14312,processes,0,0,7,7
14374,которых,0,0,7,7
14503,detect,0,0,7,7
39864,intelligents,0,0,7,7
47029,following,0,0,7,7
40003,llamada,0,0,7,7
4512,ye,0,0,7,7
34211,dina,0,0,7,7
31872,effect,0,0,7,7
47105,இடத்தில்,0,0,7,7
40178,فظيعة,0,0,7,7
13357,publications,0,0,7,7
13504,científica,0,0,7,7
13624,терри,0,0,7,7
40097,ως,0,0,7,7
123,sito,1,7,0,7
31790,ನುಡಿಗಟ್ಟು,0,0,7,7
470,basato,1,7,0,7
13828,दुनिया,0,0,7,7
13842,lit,0,0,7,7
13853,mise,0,0,7,7
13859,uses,0,0,7,7
14568,likely,0,0,7,7
31670,posibilidad,0,0,7,7
13149,hoek,0,0,7,7
154,ovvero,1,7,0,7
15291,കാരണം,0,0,7,7
4411,obtusa,0,0,7,7
15385,tar,0,0,7,7
31449,liens,0,0,7,7
15501,años,0,0,7,7
31439,produce,0,0,7,7
44361,científicos,0,0,7,7
15230,particulière,0,0,7,7
15868,left,0,0,7,7
39429,αντί,0,0,7,7
31264,சிறந்த,0,0,7,7
46685,danke,0,0,7,7
16049,உன்னை,0,0,7,7
39408,contributeur,0,0,7,7
15240,minutos,0,0,7,7
46860,principes,0,0,7,7
14615,increasingly,0,0,7,7
14759,fundação,0,0,7,7
34263,estàdire,0,0,7,7
39764,êtres,0,0,7,7
14645,começou,0,0,7,7
31665,fácil,0,0,7,7
39756,administrators,0,0,7,7
14750,تعلم,0,0,7,7
46937,பிறகு,0,0,7,7
46873,என்பதை,0,0,7,7
14838,آخر,0,0,7,7
14846,sería,0,0,7,7
39674,task,0,0,7,7
14920,hendes,0,0,7,7
39643,moyens,0,0,7,7
31650,wel,0,0,7,7
13167,qualidade,0,0,7,7
31882,почему,0,0,7,7
44184,मीडिया,0,0,7,7
34003,øjeblik,0,0,7,7
44222,junho,0,0,7,7
11543,dessutom,0,0,7,7
40676,terms,0,0,7,7
11600,encyclopedie,0,0,7,7
11612,programs,0,0,7,7
47354,biological,0,0,7,7
11699,library,0,0,7,7
11458,समीक्षा,0,0,7,7
32279,tenía,0,0,7,7
40616,textos,0,0,7,7
11889,zinnen,0,0,7,7
11897,हुआ,0,0,7,7
11945,l’apprentissage,0,0,7,7
1035,programmazione,1,7,0,7
44217,numbers,0,0,7,7
11453,المقالات،,0,0,7,7
12166,المعلومات,0,0,7,7
11187,collection,0,0,7,7
986,dio,2,3,4,7
2223,carrozza,1,7,0,7
11151,verärgert,0,0,7,7
11155,मुक्त,0,0,7,7
1967,inoltre,1,7,0,7
4942,نهاية,0,0,7,7
11197,ऐसी,0,0,7,7
47368,проекты,0,0,7,7
40803,fortsätt,0,0,7,7
11223,तब,0,0,7,7
1966,stessa,1,7,0,7
40784,siden,0,0,7,7
1964,riconoscimento,1,7,0,7
11335,autor,0,0,7,7
40523,service,0,0,7,7
12174,rapidement,0,0,7,7
13110,mediante,0,0,7,7
40335,യന്ത്രപഠന,0,0,7,7
40409,involves,0,0,7,7
40393,heute,0,0,7,7
12810,opinión,0,0,7,7
12822,vilken,0,0,7,7
12871,நடக்கிறது,0,0,7,7
12969,января,0,0,7,7
40333,pregunta,0,0,7,7
12779,distribution,0,0,7,7
40315,لي,0,0,7,7
40283,εαυτό,0,0,7,7
13083,medida,0,0,7,7
250,fornisce,1,7,0,7
13095,segundo,0,0,7,7
13096,zei,0,0,7,7
4737,ಪದಗಳನ್ನು,0,0,7,7
12765,espèces,0,0,7,7
12175,दोस्त,0,0,7,7
32173,again,0,0,7,7
47218,தெரியாது,0,0,7,7
34045,kvinnor,0,0,7,7
12245,frågar,0,0,7,7
12276,நிச்சயமாக,0,0,7,7
12333,contain,0,0,7,7
12351,estiver,0,0,7,7
12603,ಕನಸು,0,0,7,7
12752,अच्छे,0,0,7,7
32151,rédacteurs,0,0,7,7
32118,engel,0,0,7,7
34058,आगे,0,0,7,7
32073,conhecimento,0,0,7,7
44281,أمي,0,0,7,7
4751,reinforcement,0,0,7,7
1848,qualità,1,7,0,7
2034,voglio,1,7,0,7
25096,seja,0,0,7,7
28565,repetir,0,0,7,7
37184,investigación,0,0,7,7
43771,avezvous,0,0,7,7
579,avanti,1,7,0,7
3382,fantastico,1,7,0,7
26069,وفقًا,0,0,7,7
21444,другой,0,0,7,7
2563,domanda,1,7,0,7
36849,doesn,0,0,7,7
22424,aujourd,0,0,7,7
2844,umm,2,1,6,7
374,delhi,2,1,6,7
43295,مليون,0,0,7,7
1780,controversia,2,2,5,7
36302,लाख,0,0,7,7
21469,amount,0,0,7,7
24047,موعد,0,0,7,7
21494,performing,0,0,7,7
27843,leder,0,0,7,7
27630,provide,0,0,7,7
2633,fase,2,2,5,7
25196,snabbt,0,0,7,7
34830,niveau,0,0,7,7
24369,programas,0,0,7,7
1774,discovery,2,1,6,7
45174,comunicación,0,0,7,7
45827,دائمًا,0,0,7,7
1695,diverse,2,4,3,7
35577,allowing,0,0,7,7
45342,across,0,0,7,7
23435,всегда,0,0,7,7
45953,ദൈനംദിന,0,0,7,7
27400,post,0,0,7,7
23471,stating,0,0,7,7
35273,പറയുന്നു,0,0,7,7
44596,ಉದಾಹರಣೆಗೆ,0,0,7,7
3393,sera,2,1,6,7
43690,مجموعة,0,0,7,7
2710,user,2,1,6,7
25387,لـ,0,0,7,7
27065,laat,0,0,7,7
27908,sistemas,0,0,7,7
27666,الويكي,0,0,7,7
2796,persone,1,7,0,7
23503,altijd,0,0,7,7
37824,weiß,0,0,7,7
27880,ذات,0,0,7,7
25194,further,0,0,7,7
26671,बजाय,0,0,7,7
45037,numérique,0,0,7,7
45035,tree,0,0,7,7
35133,série,0,0,7,7
29852,second,0,0,7,7
24882,mode,0,0,7,7
2688,gennaio,1,7,0,7
29325,одна,0,0,7,7
37421,ഇത്തരം,0,0,7,7
36752,cited,0,0,7,7
37086,contre,0,0,7,7
37675,votación,0,0,7,7
3043,considera,2,2,5,7
3341,autori,1,7,0,7
37077,rapport,0,0,7,7
21820,importantes,0,0,7,7
37435,werden,0,0,7,7
21759,आपकी,0,0,7,7
23878,വളരെയധികം,0,0,7,7
27282,gånger,0,0,7,7
43315,¿por,0,0,7,7
21802,منها,0,0,7,7
23885,sagde,0,0,7,7
24814,meio,0,0,7,7
35847,sejam,0,0,7,7
27762,german,0,0,7,7
24018,três,0,0,7,7
22746,sexual,0,0,7,7
28865,forbløffende,0,0,7,7
45922,сегодня,0,0,7,7
26280,droits,0,0,7,7
3185,settembre,1,7,0,7
26260,engels,0,0,7,7
37748,следующий,0,0,7,7
26253,мама,0,0,7,7
36803,suficiente,0,0,7,7
1757,sistemi,2,6,1,7
23758,टेरी,0,0,7,7
35829,uppslagsverket,0,0,7,7
43422,அழகாக,0,0,7,7
28537,naturels,0,0,7,7
25048,complex,0,0,7,7
24569,utilisée,0,0,7,7
28892,gewoon,0,0,7,7
1812,iphone,2,1,6,7
2569,esperienza,1,7,0,7
37418,kelimeyi,0,0,7,7
35221,idée,0,0,7,7
22330,maddeler,0,0,7,7
44577,carriage,0,0,7,7
23410,mobila,0,0,7,7
24220,escritos,0,0,7,7
25872,proceso,0,0,7,7
24253,उसने,0,0,7,7
3114,allora,1,7,0,7
20987,thus,0,0,7,7
44860,العالم,0,0,7,7
45653,visar,0,0,7,7
22293,mostly,0,0,7,7
36476,أعتقد,0,0,7,7
25876,every,0,0,7,7
37287,quoi,0,0,7,7
21023,spise,0,0,7,7
23157,acordo,0,0,7,7
24260,carruaje,0,0,7,7
2824,angolo,1,7,0,7
3570,analisi,1,7,0,7
2800,tecniche,1,7,0,7
21061,അതിനർത്ഥം,0,0,7,7
43362,bot,0,0,7,7
26891,tener,0,0,7,7
21068,changement,0,0,7,7
45325,बता,0,0,7,7
26429,potential,0,0,7,7
2623,facile,2,5,2,7
22227,freunden,0,0,7,7
20927,jusqu,0,0,7,7
37330,properties,0,0,7,7
37874,γωνία,0,0,7,7
45651,submergé,0,0,7,7
36395,عليها,0,0,7,7
25778,david,0,0,7,7
24245,يمكنني,0,0,7,7
3431,linee,1,7,0,7
1614,forse,1,7,0,7
29965,bare,0,0,7,7
23186,विषय,0,0,7,7
24246,статья,0,0,7,7
35373,первоначально,0,0,7,7
23219,mom,0,0,7,7
43469,μαμά,0,0,7,7
592,vector,2,1,6,7
37284,inom,0,0,7,7
37877,spørger,0,0,7,7
23183,originally,0,0,7,7
43783,håller,0,0,7,7
28090,marca,0,0,7,7
45277,devient,0,0,7,7
25668,எப்போதும்,0,0,7,7
26382,такие,0,0,7,7
25865,résultat,0,0,7,7
26957,händer,0,0,7,7
23314,tekrar,0,0,7,7
21047,tant,0,0,7,7
1497,inductive,2,1,6,7
44850,которой,0,0,7,7
2656,facendo,1,7,0,7
27540,مشروع,0,0,7,7
2557,dove,1,7,0,7
3540,cibo,1,7,0,7
2555,sommerso,1,7,0,7
29928,ಚಿಂತಿಸಬೇಡಿ,0,0,7,7
25962,पहला,0,0,7,7
43581,commercial,0,0,7,7
45334,hela,0,0,7,7
3410,prossima,1,7,0,7
21143,யாரையாவது,0,0,7,7
27008,alguma,0,0,7,7
25466,yok,0,0,7,7
29766,collaboration,0,0,7,7
25493,absence,0,0,7,7
2717,siti,1,7,0,7
3023,piuttosto,1,7,0,7
22977,exist,0,0,7,7
21138,imágenes,0,0,7,7
2765,versione,1,7,0,7
28264,fantastiskt,0,0,7,7
2624,dentro,2,1,6,7
37281,ആരെയെങ്കിലും,0,0,7,7
25438,forfærdeligt,0,0,7,7
24161,नहीं।,0,0,7,7
35934,upon,0,0,7,7
26811,currents,0,0,7,7
42932,opposition,0,0,6,6
29290,pass,0,0,6,6
26438,englishlanguage,0,0,6,6
14347,له,0,0,6,6
4547,статье,0,0,6,6
47049,vivant,0,0,6,6
14466,kişiyi,0,0,6,6
14472,നാർസിസസ്,0,0,6,6
8641,sagst,0,0,6,6
14434,units,0,0,6,6
37070,four,0,0,6,6
26414,നിമിഷം,0,0,6,6
41499,sefere,0,0,6,6
14012,بالفعل,0,0,6,6
26626,máquinas,0,0,6,6
8677,förlåt,0,0,6,6
13899,शायद,0,0,6,6
8897,कल,0,0,6,6
2133,stupendo,1,6,0,6
14315,ger,0,0,6,6
4540,याद,0,0,6,6
9019,beskriver,0,0,6,6
44062,hace,0,0,6,6
33042,frères,0,0,6,6
32991,ejemplos,0,0,6,6
8772,bliver,0,0,6,6
3319,niente,1,6,0,6
44681,hallo,0,0,6,6
41474,krijgt,0,0,6,6
24068,obter,0,0,6,6
24214,impacts,0,0,6,6
40059,gesehen,0,0,6,6
39971,créé,0,0,6,6
45529,இரண்டு,0,0,6,6
39981,nice,0,0,6,6
29279,منك,0,0,6,6
13826,url,0,0,6,6
28479,εκ,0,0,6,6
43519,instance,0,0,6,6
43523,говорите,0,0,6,6
33826,língua,0,0,6,6
32931,домой,0,0,6,6
14068,need,0,0,6,6
14237,existence,0,0,6,6
35375,بطيئة,0,0,6,6
36109,local,0,0,6,6
41382,tochter,0,0,6,6
44,macchine,1,6,0,6
1808,ragazzi,1,6,0,6
47004,specifically,0,0,6,6
28471,помочь,0,0,6,6
32927,visade,0,0,6,6
24116,doğru,0,0,6,6
43602,verwendet,0,0,6,6
8987,பிழைத்திருத்தத்தில்,0,0,6,6
39976,sikker,0,0,6,6
8840,iki,0,0,6,6
4584,française,0,0,6,6
26547,wagen,0,0,6,6
14251,coisas,0,0,6,6
2307,probabilità,1,6,0,6
24135,beni,0,0,6,6
24358,glad,0,0,6,6
14475,prodigieux,0,0,6,6
15325,weinen,0,0,6,6
8242,humaines,0,0,6,6
8247,connaissances,0,0,6,6
15404,жаль,0,0,6,6
15395,എന്നാണ്,0,0,6,6
3407,meglio,1,6,0,6
31482,används,0,0,6,6
46813,europe,0,0,6,6
42529,однако,0,0,6,6
37274,incluso,0,0,6,6
23416,valeur,0,0,6,6
26750,referred,0,0,6,6
23423,partes,0,0,6,6
23459,aider,0,0,6,6
34307,затем,0,0,6,6
45576,virgin,0,0,6,6
15292,supervisado,0,0,6,6
23482,vem,0,0,6,6
34333,друзьями,0,0,6,6
8306,ಏನಾದರೂ,0,0,6,6
5305,είπε,0,0,6,6
45573,vagnen,0,0,6,6
37202,sábado,0,0,6,6
34324,gjorde,0,0,6,6
34323,начала,0,0,6,6
15184,hjælp,0,0,6,6
39598,anses,0,0,6,6
15457,writing,0,0,6,6
39569,successful,0,0,6,6
15474,القول,0,0,6,6
298,successo,1,6,0,6
31290,சாங்கர்,0,0,6,6
26965,obras,0,0,6,6
41704,författare,0,0,6,6
39485,sett,0,0,6,6
8063,yavaş,0,0,6,6
29505,stream,0,0,6,6
8068,prata,0,0,6,6
15763,step,0,0,6,6
39524,maman,0,0,6,6
2951,database,2,2,4,6
15710,conservapedia,0,0,6,6
41697,nourriture,0,0,6,6
45135,só,0,0,6,6
3420,qualsiasi,1,6,0,6
860,miei,1,6,0,6
44358,upprörd,0,0,6,6
45584,φράσεις,0,0,6,6
15597,action,0,0,6,6
15596,optimization,0,0,6,6
28689,harder,0,0,6,6
297,obiettivo,1,6,0,6
36008,рандеву,0,0,6,6
28393,organizations,0,0,6,6
39545,horrible,0,0,6,6
28399,ದಯವಿಟ್ಟು,0,0,6,6
43780,kära,0,0,6,6
15095,blevet,0,0,6,6
47607,vier,0,0,6,6
23836,മന്ദഗതിയിലുള്ള,0,0,6,6
14678,plutôt,0,0,6,6
46969,ಮನೆಗೆ,0,0,6,6
26654,algorithme,0,0,6,6
35391,controversial,0,0,6,6
14650,आपसे,0,0,6,6
26642,wikipedistas,0,0,6,6
31666,الأمر,0,0,6,6
14625,selv,0,0,6,6
8587,científicas,0,0,6,6
8588,конечно,0,0,6,6
23811,позже,0,0,6,6
1666,continuare,1,6,0,6
43613,gik,0,0,6,6
15094,hitta,0,0,6,6
23849,snel,0,0,6,6
39837,ligesom,0,0,6,6
39847,λες,0,0,6,6
36073,kritik,0,0,6,6
43777,six,0,0,6,6
23874,werde,0,0,6,6
14555,hör,0,0,6,6
466,estremamente,1,6,0,6
44342,kelimeler,0,0,6,6
39884,latest,0,0,6,6
33055,सैक्सन,0,0,6,6
14494,biology,0,0,6,6
46964,знаешь,0,0,6,6
39709,criação,0,0,6,6
37126,أفعل,0,0,6,6
14770,سيكون,0,0,6,6
37177,जून,0,0,6,6
15060,daughter,0,0,6,6
15052,πω,0,0,6,6
15047,விரும்பவில்லை,0,0,6,6
15005,bilder,0,0,6,6
1521,clustering,2,2,4,6
14981,träge,0,0,6,6
14958,belki,0,0,6,6
8404,dochter,0,0,6,6
8410,machen,0,0,6,6
4461,दो।,0,0,6,6
41620,ξέρω,0,0,6,6
14925,contribuintes,0,0,6,6
8414,editar,0,0,6,6
2121,quelli,1,6,0,6
39680,методы,0,0,6,6
39700,wilderness,0,0,6,6
26668,продолжайте,0,0,6,6
5283,गलत,0,0,6,6
14845,καθημερινή,0,0,6,6
29198,administratorer,0,0,6,6
8475,indo,0,0,6,6
33084,particularmente,0,0,6,6
2125,elemento,2,1,5,6
8491,freaked,0,0,6,6
42651,brain,0,0,6,6
13087,lassen,0,0,6,6
4632,efforts,0,0,6,6
11629,certaine,0,0,6,6
11623,projektet,0,0,6,6
5088,ángulo,0,0,6,6
36568,इस्तेमाल,0,0,6,6
44825,informatique,0,0,6,6
9845,κάτω,0,0,6,6
40669,redigeras,0,0,6,6
2186,comunque,1,6,0,6
4888,moderne,0,0,6,6
25353,lorsque,0,0,6,6
5081,telefon,0,0,6,6
11515,james,0,0,6,6
11507,críticos,0,0,6,6
36555,അവരുടെ,0,0,6,6
44152,dagelijks,0,0,6,6
25997,ನಿಧಾನಗತಿಯ,0,0,6,6
41113,moyen,0,0,6,6
40772,उपयोगकर्ता,0,0,6,6
1777,consiste,2,2,4,6
47482,இருக்கிறீர்கள்,0,0,6,6
1004,sicuro,1,6,0,6
11384,μόνο,0,0,6,6
28777,αργή,0,0,6,6
11358,alguna,0,0,6,6
1592,interno,2,5,1,6
81,agosto,2,1,5,6
25409,resto,0,0,6,6
32697,differences,0,0,6,6
11628,allemaal,0,0,6,6
9805,portanto,0,0,6,6
11264,excuses,0,0,6,6
35371,formed,0,0,6,6
28888,ise,0,0,6,6
47260,future,0,0,6,6
44141,incroyable,0,0,6,6
11947,decisiones,0,0,6,6
5105,बेहतर,0,0,6,6
40577,obtenu,0,0,6,6
26080,ذكية,0,0,6,6
47294,खेद,0,0,6,6
44759,milhão,0,0,6,6
36647,wikis,0,0,6,6
11851,tekst,0,0,6,6
9691,؛,0,0,6,6
35238,कवर,0,0,6,6
1022,basati,1,6,0,6
47515,مكان,0,0,6,6
32272,contar,0,0,6,6
11800,använde,0,0,6,6
11794,ಯಾವಾಗಲೂ,0,0,6,6
11786,δείτε,0,0,6,6
3060,categoria,2,4,2,6
25252,участников,0,0,6,6
40655,countries,0,0,6,6
35265,πάω,0,0,6,6
11692,ഗണിത,0,0,6,6
11675,λέτε,0,0,6,6
40660,pensée,0,0,6,6
332,errori,1,6,0,6
25423,probabilistic,0,0,6,6
25427,sample,0,0,6,6
40562,resultados,0,0,6,6
36361,извините,0,0,6,6
42741,gpl,0,0,6,6
33984,clusters,0,0,6,6
28725,mehr,0,0,6,6
5042,वर्णन,0,0,6,6
40902,artificielle,0,0,6,6
47405,ಏಕೆ,0,0,6,6
28724,واحد,0,0,6,6
32656,gouden,0,0,6,6
10843,الوقت,0,0,6,6
10816,tinham,0,0,6,6
2198,accordo,1,6,0,6
47418,tradicionais,0,0,6,6
35357,debe,0,0,6,6
35308,ಹೇಳಿ,0,0,6,6
10688,φίλοι,0,0,6,6
43739,mesa,0,0,6,6
70,ok,2,2,4,6
10641,savez,0,0,6,6
28704,alemão,0,0,6,6
3104,teoria,1,6,0,6
10436,ചിലർ,0,0,6,6
47431,simplement,0,0,6,6
3103,volontari,1,6,0,6
1612,propria,1,6,0,6
40981,около,0,0,6,6
10539,ಉತ್ತಮ,0,0,6,6
10470,ಅಂದರೆ,0,0,6,6
10226,dröm,0,0,6,6
10936,factors,0,0,6,6
25436,plats,0,0,6,6
4971,træg,0,0,6,6
25989,такой,0,0,6,6
28762,store,0,0,6,6
11215,required,0,0,6,6
11207,länge,0,0,6,6
2230,computational,2,1,5,6
32423,diskussionssidor,0,0,6,6
32686,técnicas,0,0,6,6
11172,عبر,0,0,6,6
11170,തവണ,0,0,6,6
25496,radio,0,0,6,6
11169,definition,0,0,6,6
25936,views,0,0,6,6
4947,formas,0,0,6,6
44782,процессе,0,0,6,6
40857,conducted,0,0,6,6
42753,уверен,0,0,6,6
5057,génial,0,0,6,6
11072,relacionados,0,0,6,6
25552,yourself,0,0,6,6
36349,poäng,0,0,6,6
11061,musst,0,0,6,6
32673,после,0,0,6,6
11016,мире,0,0,6,6
41084,могли,0,0,6,6
44153,deixeme,0,0,6,6
45309,معلومات,0,0,6,6
10956,soms,0,0,6,6
11994,apache,0,0,6,6
36283,संग्रह,0,0,6,6
31823,ಸಹಾಯ,0,0,6,6
13143,ಕ್ಷಣ,0,0,6,6
13131,visitors,0,0,6,6
45443,argued,0,0,6,6
9165,dispositivos,0,0,6,6
407,cose,1,6,0,6
13102,plan,0,0,6,6
37896,सही,0,0,6,6
9183,rivers,0,0,6,6
41711,recent,0,0,6,6
29165,cobertura,0,0,6,6
9218,évolution,0,0,6,6
13081,discussion,0,0,6,6
13079,produit,0,0,6,6
9236,illustrations,0,0,6,6
1803,pubblicata,1,6,0,6
47546,leben,0,0,6,6
31949,समाचार,0,0,6,6
9239,train,0,0,6,6
43875,linear,0,0,6,6
24490,تغييرات,0,0,6,6
1802,sociale,2,2,4,6
47545,ham,0,0,6,6
2163,figure,2,1,5,6
24535,enkelt,0,0,6,6
24556,flesta,0,0,6,6
41280,प्रयास,0,0,6,6
12896,added,0,0,6,6
12873,demasiado,0,0,6,6
13133,educado,0,0,6,6
24314,ни,0,0,6,6
36798,icke,0,0,6,6
13201,രസകരമായ,0,0,6,6
40104,quais,0,0,6,6
41374,επιδιόρθωση,0,0,6,6
13554,context,0,0,6,6
47059,slowly,0,0,6,6
13525,ऐसे,0,0,6,6
47067,amerikaner,0,0,6,6
9050,ಸಮಯದಲ್ಲಿ,0,0,6,6
40133,comenzó,0,0,6,6
34129,пока,0,0,6,6
13449,matière,0,0,6,6
40167,daran,0,0,6,6
45467,experiencia,0,0,6,6
13408,femmes,0,0,6,6
13390,viendo,0,0,6,6
9062,respectively,0,0,6,6
26366,variety,0,0,6,6
24291,veut,0,0,6,6
9076,ചെയ്യുന്നത്,0,0,6,6
9092,இன்று,0,0,6,6
9105,कभी,0,0,6,6
36906,vandalismos,0,0,6,6
499,fluente,2,3,3,6
318,tom,2,1,5,6
9162,ಚೆನ್ನಾಗಿ,0,0,6,6
1076,troppo,1,6,0,6
3276,collaboratori,1,6,0,6
13220,ಹಾಗೆ,0,0,6,6
9338,tenha,0,0,6,6
590,bysa,2,1,5,6
25050,groups,0,0,6,6
12429,vestido,0,0,6,6
4782,terrible,0,0,6,6
42851,حصلت,0,0,6,6
36265,κατάσταση,0,0,6,6
47209,increase,0,0,6,6
1958,pagina,2,4,2,6
9569,üzerine,0,0,6,6
12342,abril,0,0,6,6
9580,ಮರಿಯನ್,0,0,6,6
12339,είχε,0,0,6,6
42844,வார்த்தையை,0,0,6,6
1041,compiti,1,6,0,6
24876,അനേകം,0,0,6,6
2174,italiana,2,5,1,6
12235,ಕೆಲವೊಮ್ಮೆ,0,0,6,6
28926,please,0,0,6,6
28560,lincoln,0,0,6,6
32207,привет,0,0,6,6
24923,permettant,0,0,6,6
24949,dahaki,0,0,6,6
1633,citata,1,6,0,6
34037,கேட்ச்,0,0,6,6
12159,titled,0,0,6,6
26100,protection,0,0,6,6
5116,frage,0,0,6,6
25035,иногда,0,0,6,6
12041,aantal,0,0,6,6
32255,हूँ।,0,0,6,6
12424,meilleur,0,0,6,6
9543,entries,0,0,6,6
40422,goede,0,0,6,6
12451,terre,0,0,6,6
29005,assunto,0,0,6,6
24615,jam,0,0,6,6
3237,maggior,1,6,0,6
12758,hjem,0,0,6,6
47138,содержания,0,0,6,6
32029,samt,0,0,6,6
26158,φορές,0,0,6,6
24732,issue,0,0,6,6
42710,മറ്റു,0,0,6,6
3228,amo,2,3,3,6
36774,compris,0,0,6,6
26155,lide,0,0,6,6
12661,rule,0,0,6,6
36771,voy,0,0,6,6
47174,quatre,0,0,6,6
28960,करती,0,0,6,6
24803,humains,0,0,6,6
55,accurate,2,1,5,6
47201,enciclopédias,0,0,6,6
12586,completely,0,0,6,6
36765,அம்மா,0,0,6,6
12524,contra,0,0,6,6
24826,पाठ,0,0,6,6
32182,tus,0,0,6,6
9529,യന്ത്രപഠനം,0,0,6,6
9535,ret,0,0,6,6
1050,controllo,1,6,0,6
23202,conoce,0,0,6,6
2117,gentile,1,6,0,6
15896,эта,0,0,6,6
565,neutrale,1,6,0,6
44448,net,0,0,6,6
2066,html,2,1,5,6
2018,wiktionary,2,1,5,6
29807,hjælpe,0,0,6,6
6726,deres,0,0,6,6
210,encarta,2,2,4,6
42061,часть,0,0,6,6
44010,gentage,0,0,6,6
46339,acuerdo,0,0,6,6
38524,större,0,0,6,6
6759,meaning,0,0,6,6
1447,ars,2,1,5,6
21895,needs,0,0,6,6
21906,helst,0,0,6,6
47742,തിരഞ്ഞെടുത്ത,0,0,6,6
18507,filha,0,0,6,6
38633,artiklarnas,0,0,6,6
34540,istiyorsanız,0,0,6,6
3588,programma,2,4,2,6
46369,kendini,0,0,6,6
38645,entrada,0,0,6,6
3586,dunque,1,6,0,6
6851,ederim,0,0,6,6
2579,seconda,1,6,0,6
6865,विध्वंस,0,0,6,6
18344,kommentar,0,0,6,6
18331,αμβλεία,0,0,6,6
6690,personnes,0,0,6,6
2871,imparare,1,6,0,6
18711,editoriais,0,0,6,6
34577,résultats,0,0,6,6
42454,bitte,0,0,6,6
21675,category,0,0,6,6
21677,угол,0,0,6,6
21686,stallman,0,0,6,6
18945,wo,0,0,6,6
34581,أقول,0,0,6,6
383,preoccuparti,1,6,0,6
18897,должны,0,0,6,6
38385,varias,0,0,6,6
18882,línea,0,0,6,6
2863,dispute,2,2,4,6
46276,சாப்பிட,0,0,6,6
37705,upprepa,0,0,6,6
6679,αγγλικά,0,0,6,6
45020,realizada,0,0,6,6
6595,науки,0,0,6,6
21744,വിഷമിക്കേണ്ട,0,0,6,6
21753,utilise,0,0,6,6
42124,grad,0,0,6,6
2065,automaticamente,2,3,3,6
5536,ಇತರ,0,0,6,6
6629,nødt,0,0,6,6
6633,εσάς,0,0,6,6
42455,sim,0,0,6,6
27658,ദിവസം,0,0,6,6
27652,ability,0,0,6,6
18302,déjame,0,0,6,6
4033,؟,0,0,6,6
33276,définition,0,0,6,6
4034,пожалуйста,0,0,6,6
43351,रिपोर्ट,0,0,6,6
30872,yani,0,0,6,6
3550,seguito,1,6,0,6
17812,segunda,0,0,6,6
655,principale,1,6,0,6
17784,beauté,0,0,6,6
46497,acho,0,0,6,6
22278,uw,0,0,6,6
33337,crying,0,0,6,6
46509,chamado,0,0,6,6
17762,இல்,0,0,6,6
33319,gick,0,0,6,6
44012,बिना,0,0,6,6
34518,ಅವಳ,0,0,6,6
38845,ನಾರ್ಸಿಸಸ್,0,0,6,6
17692,corriger,0,0,6,6
22299,cuanto,0,0,6,6
22308,आपका,0,0,6,6
817,wikireader,2,4,2,6
818,particolare,1,6,0,6
2894,oggi,1,6,0,6
17647,yanı,0,0,6,6
46539,randevu,0,0,6,6
22338,வீட்டிற்கு,0,0,6,6
17584,multimedia,0,0,6,6
4124,جيمي,0,0,6,6
37588,gezien,0,0,6,6
423,figlia,1,6,0,6
17867,शानदार,0,0,6,6
27454,obtenir,0,0,6,6
450,narcissa,2,1,5,6
46408,droit,0,0,6,6
44011,sorte,0,0,6,6
35915,وفي,0,0,6,6
18273,colaboración,0,0,6,6
33688,longtemps,0,0,6,6
18263,άλλες,0,0,6,6
35933,celui,0,0,6,6
2617,disponibili,1,6,0,6
1283,fuori,1,6,0,6
47732,plupart,0,0,6,6
22,farlo,1,6,0,6
6976,little,0,0,6,6
22077,günlük,0,0,6,6
7092,sun,0,0,6,6
6996,montre,0,0,6,6
37643,contrast,0,0,6,6
7035,mamá,0,0,6,6
22133,вашей,0,0,6,6
18019,வரை,0,0,6,6
30802,vergeet,0,0,6,6
654,guerra,2,1,5,6
17947,cours,0,0,6,6
22170,göre,0,0,6,6
17909,d’un,0,0,6,6
22179,ஒருவர்,0,0,6,6
37640,ordnung,0,0,6,6
38349,fiabilité,0,0,6,6
44576,amsterdam,0,0,6,6
30465,شخصًا,0,0,6,6
6431,regras,0,0,6,6
37852,onu,0,0,6,6
29946,regarding,0,0,6,6
46052,தொகுப்புக்கள்,0,0,6,6
35758,emploi,0,0,6,6
21073,ദയവായി,0,0,6,6
30209,until,0,0,6,6
21080,level,0,0,6,6
1839,robot,2,1,5,6
37848,fortæller,0,0,6,6
37847,ಜೀವನದಲ್ಲಿ,0,0,6,6
30225,volunteer,0,0,6,6
20137,ரெண்டெஸ்வஸ்,0,0,6,6
42322,mí,0,0,6,6
30237,regler,0,0,6,6
28225,ജനുവരി,0,0,6,6
42316,lih,0,0,6,6
20098,ಬಾರಿ,0,0,6,6
38074,emin,0,0,6,6
5928,turn,0,0,6,6
5940,லாரி,0,0,6,6
29906,चाहिए।,0,0,6,6
38082,increíble,0,0,6,6
19970,allons,0,0,6,6
3822,leuk,0,0,6,6
33509,modern,0,0,6,6
37829,νούμερο,0,0,6,6
42310,दोनों,0,0,6,6
33524,outside,0,0,6,6
35755,buna,0,0,6,6
28222,daniel,0,0,6,6
20663,populaire,0,0,6,6
5680,этим,0,0,6,6
29977,gesagt,0,0,6,6
37883,വീണ്ടും,0,0,6,6
20844,män,0,0,6,6
37912,måske,0,0,6,6
5709,altid,0,0,6,6
20739,deki,0,0,6,6
35657,думаю,0,0,6,6
20735,usan,0,0,6,6
20867,методов,0,0,6,6
1411,buona,1,6,0,6
1400,lavorare,1,6,0,6
33545,rédaction,0,0,6,6
20427,страницы,0,0,6,6
5762,مؤسسة,0,0,6,6
33604,ελεύθερης,0,0,6,6
34721,ortaklaşa,0,0,6,6
33536,herhangi,0,0,6,6
632,pronto,2,1,5,6
38001,looked,0,0,6,6
42407,solar,0,0,6,6
20946,whole,0,0,6,6
20969,grupos,0,0,6,6
20988,comes,0,0,6,6
38033,vanliga,0,0,6,6
43715,majority,0,0,6,6
34686,remember,0,0,6,6
5982,jij,0,0,6,6
42286,ordre,0,0,6,6
27837,quase,0,0,6,6
19473,поскольку,0,0,6,6
37792,നിന്നും,0,0,6,6
776,acuto,1,6,0,6
38222,kære,0,0,6,6
1349,paradigmi,1,6,0,6
19421,fille,0,0,6,6
3655,corso,2,5,1,6
19395,amigo,0,0,6,6
38253,fortsæt,0,0,6,6
6190,n’est,0,0,6,6
29860,generalization,0,0,6,6
1431,motivo,2,1,5,6
46205,hjälpa,0,0,6,6
773,mezzo,1,6,0,6
6239,continents,0,0,6,6
38275,அவளுடைய,0,0,6,6
42446,ಕೇಳಲು,0,0,6,6
1859,soave,1,6,0,6
19194,wall,0,0,6,6
19150,boris,0,0,6,6
46207,entry,0,0,6,6
2849,alta,2,1,5,6
38314,tretikov,0,0,6,6
21570,octobre,0,0,6,6
46210,yine,0,0,6,6
21578,redigera,0,0,6,6
27861,φορά,0,0,6,6
19482,savoir,0,0,6,6
43986,problèmes,0,0,6,6
19646,stomp,0,0,6,6
42280,adams,0,0,6,6
38104,beautiful,0,0,6,6
27925,deste,0,0,6,6
6020,différents,0,0,6,6
19782,needed,0,0,6,6
2036,sbagliato,1,6,0,6
19741,vraag,0,0,6,6
30291,aynı,0,0,6,6
19700,στα,0,0,6,6
42253,eve,0,0,6,6
19658,leitores,0,0,6,6
19647,¿te,0,0,6,6
19638,genial,0,0,6,6
19483,utilizada,0,0,6,6
38146,içinde,0,0,6,6
47813,agit,0,0,6,6
27872,разных,0,0,6,6
46157,jezelf,0,0,6,6
21321,terwijl,0,0,6,6
19582,endast,0,0,6,6
21348,cannot,0,0,6,6
2841,wikiquote,2,1,5,6
42234,individual,0,0,6,6
2503,fai,1,6,0,6
6146,decisions,0,0,6,6
1356,tuttavia,1,6,0,6
17507,message,0,0,6,6
41004,dear,0,0,6,6
4232,difficult,0,0,6,6
16717,okej,0,0,6,6
1746,causa,2,5,1,6
17085,características,0,0,6,6
4307,τότε,0,0,6,6
17089,ನಡೆಯುತ್ತಿದೆ,0,0,6,6
43458,market,0,0,6,6
37475,freunde,0,0,6,6
23151,αυτά,0,0,6,6
45683,predict,0,0,6,6
33781,vandalisme,0,0,6,6
47660,environnement,0,0,6,6
22552,communication,0,0,6,6
39026,créée,0,0,6,6
41767,ларри,0,0,6,6
27202,बीच,0,0,6,6
45757,skarp,0,0,6,6
37468,درجة,0,0,6,6
16696,instances,0,0,6,6
33810,children,0,0,6,6
7667,neutralité,0,0,6,6
43045,själv,0,0,6,6
22550,पसंद,0,0,6,6
22967,haven,0,0,6,6
381,pigro,1,6,0,6
43049,undersökning,0,0,6,6
37403,критики,0,0,6,6
39296,canal,0,0,6,6
7328,ocupado,0,0,6,6
35991,yardım,0,0,6,6
22797,endişelenme,0,0,6,6
17203,labeled,0,0,6,6
4175,mañana,0,0,6,6
23144,غارق,0,0,6,6
35959,comigo,0,0,6,6
16469,culturelle,0,0,6,6
3456,attraverso,1,6,0,6
43026,ಮತ್ತೊಂದು,0,0,6,6
7729,ponds,0,0,6,6
2097,termine,1,6,0,6
42463,അവിടെ,0,0,6,6
7797,nearly,0,0,6,6
39263,characteristic,0,0,6,6
22985,desarrollo,0,0,6,6
44656,snart,0,0,6,6
16910,labels,0,0,6,6
16228,машинного,0,0,6,6
16227,esprit,0,0,6,6
34428,five,0,0,6,6
7452,mach,0,0,6,6
43841,largement,0,0,6,6
17057,willst,0,0,6,6
16224,тем,0,0,6,6
43048,previously,0,0,6,6
16428,да,0,0,6,6
2094,preso,2,4,2,6
47661,values,0,0,6,6
46591,അതിൽ,0,0,6,6
7428,noite,0,0,6,6
45753,sidan,0,0,6,6
46681,videnskabelige,0,0,6,6
41785,frente,0,0,6,6
1192,lavori,1,6,0,6
22874,الطعام,0,0,6,6
43041,tur,0,0,6,6
39300,única,0,0,6,6
22648,describe,0,0,6,6
41830,études,0,0,6,6
22799,huh,0,0,6,6
16634,"है।
",0,0,6,6
16548,capacité,0,0,6,6
7910,اللغات,0,0,6,6
22422,hija,0,0,6,6
37349,œuvre,0,0,6,6
1206,tuoi,1,6,0,6
7228,இருந்தால்,0,0,6,6
30964,olur,0,0,6,6
41905,range,0,0,6,6
31266,begon,0,0,6,6
22841,actions,0,0,6,6
46552,jemandem,0,0,6,6
41757,ever,0,0,6,6
16381,secreto,0,0,6,6
33259,تحصل,0,0,6,6
35956,escreveu,0,0,6,6
31187,grader,0,0,6,6
31075,mettre,0,0,6,6
22406,datum,0,0,6,6
41797,कोण,0,0,6,6
34503,squid,0,0,6,6
17432,auteurs,0,0,6,6
16407,attention,0,0,6,6
175,funzione,1,6,0,6
1684,nuovo,1,6,0,6
22741,danske,0,0,6,6
31136,ίσως,0,0,6,6
15913,realidad,0,0,6,6
2405,dilemma,2,1,5,6
41725,modification,0,0,6,6
22742,между,0,0,6,6
7766,الموسوعة,0,0,6,6
46693,بطريقة,0,0,6,6
33751,उसके,0,0,6,6
29648,खुश,0,0,6,6
43785,बेटी,0,0,6,6
44855,rapports,0,0,6,6
31089,pobre,0,0,6,6
4155,artiklarna,0,0,6,6
16658,стороны,0,0,6,6
7490,eerste,0,0,6,6
22705,experts,0,0,6,6
23168,initially,0,0,6,6
16052,diciendo,0,0,6,6
17231,experter,0,0,6,6
46561,lütfen,0,0,6,6
39022,https,0,0,6,6
27332,ângulo,0,0,6,6
22908,projecten,0,0,6,6
17289,criar,0,0,6,6
7774,trend,0,0,6,6
4236,formal,0,0,6,6
7502,noche,0,0,6,6
22803,éditions,0,0,6,6
17311,egen,0,0,6,6
17335,нарциса,0,0,6,6
22458,fields,0,0,6,6
23179,geld,0,0,6,6
7231,учтивый,0,0,6,6
26773,содержит,0,0,5,5
6066,nouvelles,0,0,5,5
44814,love,0,0,5,5
36342,kiwix,0,0,5,5
9899,зрения,0,0,5,5
9893,presence,0,0,5,5
7734,позволяет,0,0,5,5
35364,सूची,0,0,5,5
8805,increased,0,0,5,5
33465,naquele,0,0,5,5
47506,ಮೆಲ್ಲಿ,0,0,5,5
33642,वाक्य,0,0,5,5
27133,personal,0,0,5,5
42173,серверов,0,0,5,5
8401,मामले,0,0,5,5
8399,root,0,0,5,5
33670,дорогая,0,0,5,5
7663,prince,0,0,5,5
36047,മാറ്റങ്ങൾ,0,0,5,5
41138,ihrem,0,0,5,5
41633,لن,0,0,5,5
35974,minute,0,0,5,5
42219,ट्रेडमार्क,0,0,5,5
9714,lake,0,0,5,5
8372,night,0,0,5,5
9735,correctif,0,0,5,5
9740,δώσω,0,0,5,5
43944,encyclopedieën,0,0,5,5
26728,entendi,0,0,5,5
33110,كثيرًا,0,0,5,5
9750,estrutura,0,0,5,5
41130,geology,0,0,5,5
8350,वेबसाईट,0,0,5,5
36317,πως,0,0,5,5
36045,എന്നീ,0,0,5,5
7671,useful,0,0,5,5
27862,हों,0,0,5,5
43965,ακούγεται,0,0,5,5
36327,korkunç,0,0,5,5
9853,نفسك,0,0,5,5
8281,opinion,0,0,5,5
27047,gesprek,0,0,5,5
33477,requests,0,0,5,5
5933,πραγματικότητα,0,0,5,5
27910,तर्क,0,0,5,5
7874,hora,0,0,5,5
28079,lot,0,0,5,5
36368,ευγενικό,0,0,5,5
8074,conversación,0,0,5,5
45073,गैर,0,0,5,5
28074,reached,0,0,5,5
35440,существует,0,0,5,5
7885,maintain,0,0,5,5
26949,положении,0,0,5,5
8123,onion,0,0,5,5
33568,contigo,0,0,5,5
35729,τρόπο,0,0,5,5
41039,stykke,0,0,5,5
7873,tools,0,0,5,5
45136,dirigido,0,0,5,5
5790,الموقع,0,0,5,5
41041,சொல்வது,0,0,5,5
45151,gars,0,0,5,5
28374,താളുകളിൽ,0,0,5,5
10353,aí,0,0,5,5
33950,பயன்படுத்தும்,0,0,5,5
44997,eines,0,0,5,5
26985,revistas,0,0,5,5
7987,classified,0,0,5,5
36003,principalement,0,0,5,5
28129,അതിനെക്കുറിച്ച്,0,0,5,5
28209,gained,0,0,5,5
35726,चल,0,0,5,5
8044,black,0,0,5,5
8051,autorais,0,0,5,5
25788,sopa,0,0,5,5
10435,ಅತ್ಯಂತ,0,0,5,5
8064,souhaitée,0,0,5,5
7924,yorgun,0,0,5,5
32542,studied,0,0,5,5
7917,القواعد,0,0,5,5
41017,उपयोगी,0,0,5,5
33585,manner,0,0,5,5
10393,कार्यक्रम,0,0,5,5
25825,develop,0,0,5,5
5737,लिखा,0,0,5,5
7857,மேலே,0,0,5,5
7851,francés,0,0,5,5
28389,μας,0,0,5,5
5961,रात,0,0,5,5
35767,mean,0,0,5,5
28627,nouveau,0,0,5,5
5944,müde,0,0,5,5
33635,lembrese,0,0,5,5
43615,services,0,0,5,5
25985,கட்டுரைகளின்,0,0,5,5
33115,explicitly,0,0,5,5
33117,aften,0,0,5,5
27931,المرة,0,0,5,5
41078,समर्थन,0,0,5,5
42730,clear,0,0,5,5
41734,verder,0,0,5,5
45237,ميلي,0,0,5,5
26777,nye,0,0,5,5
27927,ആയിരുന്നു,0,0,5,5
7755,правок,0,0,5,5
27022,rare,0,0,5,5
27023,தொகுப்பாளர்கள்,0,0,5,5
27937,التخريب,0,0,5,5
41728,δω,0,0,5,5
7806,затруднительном,0,0,5,5
42466,ചിലപ്പോൾ,0,0,5,5
5861,должен,0,0,5,5
10184,episode,0,0,5,5
28629,свои,0,0,5,5
45274,chamada,0,0,5,5
47839,apuros,0,0,5,5
32667,मत,0,0,5,5
28010,hors,0,0,5,5
5878,कमी,0,0,5,5
45071,språket,0,0,5,5
8174,vide,0,0,5,5
42325,सूचना,0,0,5,5
25922,ഭാഷകളിൽ,0,0,5,5
41086,ubuntu,0,0,5,5
45270,kwam,0,0,5,5
26833,enorm,0,0,5,5
41090,λήμματα,0,0,5,5
10040,allí,0,0,5,5
6270,bange,0,0,5,5
6475,prêmio,0,0,5,5
27137,rulebased,0,0,5,5
7380,bruges,0,0,5,5
35960,şeyler,0,0,5,5
9163,iş,0,0,5,5
42010,voluntarios,0,0,5,5
26591,работе,0,0,5,5
41841,ಕಾಳಜಿ,0,0,5,5
43573,anderes,0,0,5,5
6994,remaining,0,0,5,5
6998,beder,0,0,5,5
32874,problemet,0,0,5,5
26320,easy,0,0,5,5
28517,olurdu,0,0,5,5
41958,sueco,0,0,5,5
28275,pesquisas,0,0,5,5
26330,يستخدم,0,0,5,5
45188,لأن,0,0,5,5
7037,invés,0,0,5,5
47603,получите,0,0,5,5
33698,എന്നത്,0,0,5,5
47557,جملة,0,0,5,5
6940,länder,0,0,5,5
8608,priori,0,0,5,5
26284,sinto,0,0,5,5
27573,« wikipédia »,0,0,5,5
9274,widely,0,0,5,5
42051,പോയി,0,0,5,5
27620,الصفحات,0,0,5,5
26286,layers,0,0,5,5
6845,histoire,0,0,5,5
9246,μία,0,0,5,5
27240,anthropologies,0,0,5,5
42695,கவலைப்பட,0,0,5,5
6856,ligga,0,0,5,5
35458,деле,0,0,5,5
43708,वर्णित,0,0,5,5
6872,प्रस्तुत,0,0,5,5
35482,cover,0,0,5,5
7408,आश्चर्यजनक,0,0,5,5
26289,succès,0,0,5,5
27304,tillsammans,0,0,5,5
42038,ajudar,0,0,5,5
6906,نيويورك,0,0,5,5
8603,वाला,0,0,5,5
7082,activities,0,0,5,5
43574,siguientes,0,0,5,5
41953,wouldn,0,0,5,5
27325,पाया,0,0,5,5
45208,naast,0,0,5,5
7223,ಇದರರ್ಥ,0,0,5,5
8944,verir,0,0,5,5
42596,πάνω,0,0,5,5
8779,работой,0,0,5,5
26433,раздел,0,0,5,5
7175,भर,0,0,5,5
44068,deus,0,0,5,5
47586,usuario,0,0,5,5
47709,maakt,0,0,5,5
8799,months,0,0,5,5
35941,utilizar,0,0,5,5
26459,responsabilité,0,0,5,5
27398,george,0,0,5,5
44048,പല,0,0,5,5
33749,sugerem,0,0,5,5
8848,رقيق,0,0,5,5
7194,objects,0,0,5,5
27393,mellon,0,0,5,5
8947,claro,0,0,5,5
7141,darwin,0,0,5,5
8957,мой,0,0,5,5
28488,πήρε,0,0,5,5
28469,attrition,0,0,5,5
9041,contrairement,0,0,5,5
47585,principaux,0,0,5,5
26405,träffar,0,0,5,5
9030,ಸ್ನೇಹಿತರೊಂದಿಗೆ,0,0,5,5
27365,οποία,0,0,5,5
27435,send,0,0,5,5
7111,cells,0,0,5,5
33344,whether,0,0,5,5
32928,நினைவில்,0,0,5,5
8721,ಮಾಡುತ್ತಿದ್ದೀರಿ,0,0,5,5
9015,उन्होंने,0,0,5,5
8726,forvirret,0,0,5,5
41893,изображений,0,0,5,5
7120,değişiklikler,0,0,5,5
45198,birini,0,0,5,5
36140,اليومية,0,0,5,5
8982,ομορφιά,0,0,5,5
6825,لست,0,0,5,5
41290,основном,0,0,5,5
35811,അതിശയകരമായ,0,0,5,5
9626,المساهمين,0,0,5,5
6444,passou,0,0,5,5
32743,photos,0,0,5,5
7201,dele,0,0,5,5
6479,كانوا,0,0,5,5
47624,aigu,0,0,5,5
41225,marriage,0,0,5,5
6518,crescimento,0,0,5,5
7609,aldım,0,0,5,5
6531,उपयुक्त,0,0,5,5
27685,alligevel,0,0,5,5
28555,puntos,0,0,5,5
27183,παραδείγματα,0,0,5,5
33094,economic,0,0,5,5
26665,நேரம்,0,0,5,5
27189,trött,0,0,5,5
7567,uniquement,0,0,5,5
8481,feitas,0,0,5,5
45070,कोमन्स,0,0,5,5
27678,shown,0,0,5,5
6434,francesa,0,0,5,5
9628,شكرًا,0,0,5,5
8590,hacerlo,0,0,5,5
43726,før,0,0,5,5
33445,desenvolvimento,0,0,5,5
42447,ano,0,0,5,5
28413,bekend,0,0,5,5
6308,cuál,0,0,5,5
6310,तहत,0,0,5,5
7624,türkiye,0,0,5,5
36288,possuem,0,0,5,5
9673,माध्यम,0,0,5,5
7617,വീഡിയോ,0,0,5,5
47538,office,0,0,5,5
9662,معظم,0,0,5,5
7613,ibm,0,0,5,5
6371,होकर,0,0,5,5
27833,misma,0,0,5,5
27832,повезло,0,0,5,5
41180,zone,0,0,5,5
28563,बताया,0,0,5,5
26099,maio,0,0,5,5
41192,novembro,0,0,5,5
35965,released,0,0,5,5
26140,appropriate,0,0,5,5
47774,weiter,0,0,5,5
41586,eckart,0,0,5,5
9467,dotter,0,0,5,5
8582,utilisant,0,0,5,5
44139,interfaz,0,0,5,5
44119,нужно,0,0,5,5
7508,لويكيبيديا,0,0,5,5
9438,orden,0,0,5,5
26183,அன்றாட,0,0,5,5
9420,этому,0,0,5,5
28538,गुणवत्ता,0,0,5,5
41246,கூறலாம்,0,0,5,5
7495,ämnen,0,0,5,5
26191,encuentran,0,0,5,5
6761,പറയുക,0,0,5,5
26216,ganze,0,0,5,5
41805,tråkigt,0,0,5,5
47733,zag,0,0,5,5
27230,preocupes,0,0,5,5
6796,blive,0,0,5,5
35908,изменения,0,0,5,5
6728,datter,0,0,5,5
41789,வழி,0,0,5,5
28547,recognition,0,0,5,5
6646,truth,0,0,5,5
7546,construction,0,0,5,5
33077,pasar,0,0,5,5
42109,உதாரணமாக,0,0,5,5
7528,बस,0,0,5,5
47612,enough,0,0,5,5
9517,surveillance,0,0,5,5
6642,rüya,0,0,5,5
43564,сентября,0,0,5,5
26662,health,0,0,5,5
42066,geheime,0,0,5,5
27671,πού,0,0,5,5
26660,ಹೇಗಾದರೂ,0,0,5,5
41559,perguntar,0,0,5,5
35892,βικιπαίδειας,0,0,5,5
8558,concerns,0,0,5,5
26658,programme,0,0,5,5
32775,meinem,0,0,5,5
42075,terrestrial,0,0,5,5
42658,കാര്യങ്ങളും,0,0,5,5
20836,went,0,0,5,5
10530,versionen,0,0,5,5
38904,seul,0,0,5,5
17313,peur,0,0,5,5
17317,многие,0,0,5,5
37571,nästan,0,0,5,5
34499,научных,0,0,5,5
34906,baidu,0,0,5,5
38919,sélection,0,0,5,5
34505,حوالي,0,0,5,5
17528,claimed,0,0,5,5
37476,عليك,0,0,5,5
17544,aristote,0,0,5,5
17566,diskussionssidorna,0,0,5,5
17575,divided,0,0,5,5
22367,नीचे,0,0,5,5
43363,environments,0,0,5,5
17644,उसी,0,0,5,5
30916,china,0,0,5,5
22473,skønhed,0,0,5,5
17253,anomaly,0,0,5,5
29783,gyllene,0,0,5,5
45747,بطيئًا,0,0,5,5
16912,leute,0,0,5,5
16914,matrix,0,0,5,5
16946,propre,0,0,5,5
16953,сейчас,0,0,5,5
22633,dado,0,0,5,5
22593,மந்தமான,0,0,5,5
39053,soin,0,0,5,5
17045,सम्पादकीय,0,0,5,5
39023,ήρθε,0,0,5,5
22588,являются,0,0,5,5
45756,connaissance,0,0,5,5
17076,mama,0,0,5,5
17134,selection,0,0,5,5
22527,thanks,0,0,5,5
17204,ಸರಿ,0,0,5,5
17206,hombres,0,0,5,5
17660,словами,0,0,5,5
37619,وأنا,0,0,5,5
43092,стоит,0,0,5,5
18242,rädd,0,0,5,5
18122,هم,0,0,5,5
46434,bloquear,0,0,5,5
18152,उद्देश्य,0,0,5,5
18164,ändå,0,0,5,5
45830,свой,0,0,5,5
22062,adopted,0,0,5,5
43113,тупым,0,0,5,5
38707,siendo,0,0,5,5
17720,escrita,0,0,5,5
30790,emot,0,0,5,5
45848,இருந்தது,0,0,5,5
18270,कहाँ,0,0,5,5
22060,थीं,0,0,5,5
22041,കുറച്ച്,0,0,5,5
18283,мелли,0,0,5,5
18286,καλύτερα,0,0,5,5
22100,αυτός,0,0,5,5
18078,nın,0,0,5,5
22119,ziet,0,0,5,5
30796,hold,0,0,5,5
38843,சொற்றொடரை,0,0,5,5
29694,dacht,0,0,5,5
34891,ifade,0,0,5,5
43822,bedste,0,0,5,5
46505,πρόσβασης,0,0,5,5
44583,composed,0,0,5,5
46462,вами,0,0,5,5
17819,bijna,0,0,5,5
17869,χωρίς,0,0,5,5
46453,ತಪ್ಪು,0,0,5,5
17928,للمحررين,0,0,5,5
34524,sério,0,0,5,5
22146,गयी।,0,0,5,5
18039,bästa,0,0,5,5
44582,herhalen,0,0,5,5
16911,कारण,0,0,5,5
37422,mcpherson,0,0,5,5
34925,φαγητό,0,0,5,5
22982,பொருள்,0,0,5,5
23161,λέει,0,0,5,5
16106,القيام,0,0,5,5
29547,πράγμα,0,0,5,5
39391,തീർച്ചയായും,0,0,5,5
37321,കാണാൻ,0,0,5,5
31206,patrimoine,0,0,5,5
46634,founded,0,0,5,5
22966,jamais,0,0,5,5
37339,remains,0,0,5,5
16327,technique,0,0,5,5
16332,സ്വന്തം,0,0,5,5
16339,simplemente,0,0,5,5
16362,serviço,0,0,5,5
22957,ذلك،,0,0,5,5
45697,उनकी,0,0,5,5
22934,الثاني,0,0,5,5
16078,rédacteur,0,0,5,5
16057,fake,0,0,5,5
16044,practice,0,0,5,5
16034,heldig,0,0,5,5
45645,uppge,0,0,5,5
39511,tard,0,0,5,5
34952,المستخدمين,0,0,5,5
39447,chez,0,0,5,5
15859,små,0,0,5,5
23212,¿puedes,0,0,5,5
15869,tendance,0,0,5,5
15889,huis,0,0,5,5
15901,liten,0,0,5,5
15924,inc,0,0,5,5
42973,فيها,0,0,5,5
15957,domaine,0,0,5,5
39424,points,0,0,5,5
15999,ಸಂಪೂರ್ಣವಾಗಿ,0,0,5,5
31258,வெவ்வேறு,0,0,5,5
44636,funciones,0,0,5,5
16453,ಮಾಡಿದ್ದೇನೆ,0,0,5,5
16870,tales,0,0,5,5
39114,എല്ലാം,0,0,5,5
22796,почти,0,0,5,5
22761,our,0,0,5,5
16745,الأولى,0,0,5,5
16748,bilgi,0,0,5,5
16751,belleza,0,0,5,5
39135,भाग,0,0,5,5
39132,handling,0,0,5,5
39105,किया।,0,0,5,5
37380,schon,0,0,5,5
22737,вопрос,0,0,5,5
16802,நண்பர்கள்,0,0,5,5
46599,gehört,0,0,5,5
16823,بينما,0,0,5,5
31028,इतना,0,0,5,5
16841,questões,0,0,5,5
39089,celle,0,0,5,5
16734,leading,0,0,5,5
39159,emellertid,0,0,5,5
22804,nível,0,0,5,5
31107,γι,0,0,5,5
46631,concerning,0,0,5,5
37402,вандализма,0,0,5,5
45719,focus,0,0,5,5
46626,days,0,0,5,5
16490,अतिरिक्त,0,0,5,5
22849,സ്വപ്നം,0,0,5,5
22848,ಮತ್ತೆ,0,0,5,5
16515,såsom,0,0,5,5
29599,تقديم,0,0,5,5
31148,écriture,0,0,5,5
29610,olmadığını,0,0,5,5
16605,ഉപയോഗിച്ച്,0,0,5,5
29611,രീതിയിൽ,0,0,5,5
31119,معينة,0,0,5,5
22818,explain,0,0,5,5
29781,सकता।,0,0,5,5
38684,traits,0,0,5,5
40971,täglichen,0,0,5,5
30263,might,0,0,5,5
21298,assez,0,0,5,5
46134,पूछ,0,0,5,5
19823,taille,0,0,5,5
38124,μέρα,0,0,5,5
19878,premiers,0,0,5,5
30274,കഴിയുമോ,0,0,5,5
38086,opinions,0,0,5,5
19928,حال,0,0,5,5
19698,bus,0,0,5,5
46094,requires,0,0,5,5
21291,ej,0,0,5,5
46090,meilleure,0,0,5,5
21278,daarom,0,0,5,5
19965,प्रस्ताव,0,0,5,5
21275,ögonblick,0,0,5,5
37839,नए,0,0,5,5
38130,ನಿಮ್ಮೊಂದಿಗೆ,0,0,5,5
38131,representations,0,0,5,5
18336,lois,0,0,5,5
29872,ഉപയോഗിക്കുന്ന,0,0,5,5
19399,disponíveis,0,0,5,5
46181,മരിയൻ,0,0,5,5
30353,chateado,0,0,5,5
19464,другими,0,0,5,5
37791,जबकि,0,0,5,5
45938,agree,0,0,5,5
19479,bayesian,0,0,5,5
30322,ontzagwekkend,0,0,5,5
19656,നല്ലതാണ്,0,0,5,5
29886,britannicas,0,0,5,5
21372,elkaar,0,0,5,5
45939,main,0,0,5,5
21314,moe,0,0,5,5
19617,എനിക്കറിയാം,0,0,5,5
21306,ie,0,0,5,5
19625,travailler,0,0,5,5
20048,exact,0,0,5,5
21152,menar,0,0,5,5
38080,hiçbir,0,0,5,5
20662,random,0,0,5,5
20928,tired,0,0,5,5
20581,गूगल,0,0,5,5
43251,reliable,0,0,5,5
20620,издание,0,0,5,5
20621,samen,0,0,5,5
30052,explique,0,0,5,5
46010,either,0,0,5,5
20676,geralmente,0,0,5,5
38079,ധാരാളം,0,0,5,5
43275,direitos,0,0,5,5
37879,வாழ்க்கையில்,0,0,5,5
20746,polynomial,0,0,5,5
30025,άλλος,0,0,5,5
30020,सहमत,0,0,5,5
29997,genre,0,0,5,5
20814,entschuldigung,0,0,5,5
20941,varje,0,0,5,5
20480,طلب,0,0,5,5
20464,ongoing,0,0,5,5
44503,bewerkers,0,0,5,5
20094,easily,0,0,5,5
20104,tú,0,0,5,5
21117,least,0,0,5,5
44488,responder,0,0,5,5
46078,colère,0,0,5,5
38049,تبدو,0,0,5,5
20236,wieder,0,0,5,5
34720,ತಾಯಿಗೆ,0,0,5,5
20286,novo,0,0,5,5
38048,mı,0,0,5,5
37849,mantenimiento,0,0,5,5
30129,ರಾತ್ರಿ,0,0,5,5
29951,require,0,0,5,5
21028,vardı,0,0,5,5
45974,വിവിധ,0,0,5,5
30363,όνειρο,0,0,5,5
19372,lernen,0,0,5,5
19320,βάλτο,0,0,5,5
30641,príncipe,0,0,5,5
44438,अनुसंधान,0,0,5,5
30683,conversa,0,0,5,5
46328,inicialmente,0,0,5,5
21828,olması,0,0,5,5
18684,لها,0,0,5,5
18689,fatigué,0,0,5,5
18696,virginia,0,0,5,5
38460,lieber,0,0,5,5
18769,ஆண்டு,0,0,5,5
44460,ಬಳಸಬಹುದು,0,0,5,5
21793,റെൻഡെജൂസ്,0,0,5,5
21786,الآخر,0,0,5,5
29823,दलदल,0,0,5,5
18749,أذهب,0,0,5,5
21770,personer,0,0,5,5
21769,besser,0,0,5,5
21885,contains,0,0,5,5
18619,understood,0,0,5,5
21886,kaynak,0,0,5,5
18558,yeni,0,0,5,5
18352,ಸಾಮಾನ್ಯ,0,0,5,5
45870,इसने,0,0,5,5
44410,lead,0,0,5,5
43325,anglophone,0,0,5,5
30781,evidence,0,0,5,5
21943,grupp,0,0,5,5
37665,रखें,0,0,5,5
37671,présentée,0,0,5,5
45877,σήμερα,0,0,5,5
44425,eres,0,0,5,5
38669,guys,0,0,5,5
18482,сайт,0,0,5,5
38599,معك,0,0,5,5
43159,suite,0,0,5,5
18530,oroa,0,0,5,5
45878,şimdiden,0,0,5,5
21768,recursos,0,0,5,5
38274,أحيانًا,0,0,5,5
37724,extremes,0,0,5,5
19050,വ്യക്തിയെ,0,0,5,5
21581,directly,0,0,5,5
34642,engine,0,0,5,5
19092,polar,0,0,5,5
38333,känner,0,0,5,5
21568,endroit,0,0,5,5
38297,sida,0,0,5,5
37725,உங்களுடன்,0,0,5,5
46301,director,0,0,5,5
45909,fem,0,0,5,5
21537,associations,0,0,5,5
29856,الأخيرة,0,0,5,5
30393,संपादित,0,0,5,5
34656,décembre,0,0,5,5
19289,amable,0,0,5,5
19317,исследований,0,0,5,5
44486,distribución,0,0,5,5
21626,pueda,0,0,5,5
21634,chance,0,0,5,5
21649,versie,0,0,5,5
30591,connue,0,0,5,5
18806,metawiki,0,0,5,5
21767,continuer,0,0,5,5
34571,salt,0,0,5,5
43310,تمت,0,0,5,5
21711,initial,0,0,5,5
34862,الذهبي,0,0,5,5
34578,χρησιμοποιώ,0,0,5,5
18900,livro,0,0,5,5
46269,sverige,0,0,5,5
45879,cuales,0,0,5,5
46237,मिलियन,0,0,5,5
30510,fraser,0,0,5,5
21674,eerder,0,0,5,5
21664,уэйлс,0,0,5,5
31310,similarity,0,0,5,5
31355,ಹೇಳಿದರೆ,0,0,5,5
46759,vê,0,0,5,5
28949,القادمة,0,0,5,5
12327,डेटाबेस,0,0,5,5
12340,dorado,0,0,5,5
45416,spørge,0,0,5,5
12379,الآلي,0,0,5,5
43898,vá,0,0,5,5
12438,verbazingwekkend,0,0,5,5
12469,possível,0,0,5,5
12515,söylemek,0,0,5,5
24895,cebuano,0,0,5,5
12528,cinco,0,0,5,5
28952,julho,0,0,5,5
40450,zonder,0,0,5,5
12695,такими,0,0,5,5
47148,yemek,0,0,5,5
12702,ficar,0,0,5,5
45424,significant,0,0,5,5
35188,hafta,0,0,5,5
24919,paid,0,0,5,5
31357,quem,0,0,5,5
40547,pouvezvous,0,0,5,5
25110,потрясающий,0,0,5,5
11956,खाना,0,0,5,5
11971,मेरा,0,0,5,5
11987,falar,0,0,5,5
32262,نفس,0,0,5,5
40570,الشيء,0,0,5,5
12016,ander,0,0,5,5
40544,share,0,0,5,5
24968,dólares,0,0,5,5
40540,errors,0,0,5,5
12078,juin,0,0,5,5
12098,رسالة,0,0,5,5
36713,تلك,0,0,5,5
12119,områden,0,0,5,5
12146,snälla,0,0,5,5
32213,முற்றிலும்,0,0,5,5
12713,lagras,0,0,5,5
12720,ihren,0,0,5,5
34061,entirely,0,0,5,5
24386,systèmes,0,0,5,5
12959,beleza,0,0,5,5
24498,address,0,0,5,5
24457,parts,0,0,5,5
42918,wees,0,0,5,5
34113,كلمات,0,0,5,5
31897,പലപ്പോഴും,0,0,5,5
13082,zie,0,0,5,5
24371,золотого,0,0,5,5
24714,versão,0,0,5,5
13111,hiç,0,0,5,5
29173,αυτές,0,0,5,5
13181,geniş,0,0,5,5
34128,γεια,0,0,5,5
36892,पुस्तक,0,0,5,5
13291,substance,0,0,5,5
13297,vielleicht,0,0,5,5
40352,telif,0,0,5,5
12958,jobb,0,0,5,5
29101,μένα,0,0,5,5
12936,ഇന്ത്യൻ,0,0,5,5
47134,fim,0,0,5,5
43765,കാണുന്നു,0,0,5,5
28982,लायक,0,0,5,5
34108,ಕೆಲಸವನ್ನು,0,0,5,5
12783,richard,0,0,5,5
24587,response,0,0,5,5
36793,built,0,0,5,5
12818,എല്ലായ്പ്പോഴും,0,0,5,5
44710,спросить,0,0,5,5
32024,ಫ್ಲಮ್ಮಾಕ್ಸ್,0,0,5,5
36815,sah,0,0,5,5
34112,controle,0,0,5,5
31999,measure,0,0,5,5
42906,всю,0,0,5,5
43882,फॉर,0,0,5,5
11919,comercial,0,0,5,5
11848,does,0,0,5,5
40610,components,0,0,5,5
33991,ಅವನ,0,0,5,5
36500,patterns,0,0,5,5
10924,female,0,0,5,5
10959,manchmal,0,0,5,5
10962,conocida,0,0,5,5
25559,neutro,0,0,5,5
42748,wanneer,0,0,5,5
10975,डर,0,0,5,5
11007,informação,0,0,5,5
25499,solve,0,0,5,5
11047,தவறு,0,0,5,5
33995,billion,0,0,5,5
43525,информация,0,0,5,5
35296,learns,0,0,5,5
32436,mayoría,0,0,5,5
40851,seninle,0,0,5,5
25516,ξανά,0,0,5,5
10922,unknown,0,0,5,5
10911,сон,0,0,5,5
10893,call,0,0,5,5
47402,अकादमिक,0,0,5,5
10587,nächsten,0,0,5,5
10617,atolado,0,0,5,5
28690,kon,0,0,5,5
10655,vanaf,0,0,5,5
25726,maybe,0,0,5,5
47422,lucky,0,0,5,5
10695,schönheit,0,0,5,5
36436,руки,0,0,5,5
10716,streams,0,0,5,5
32505,historical,0,0,5,5
36449,asked,0,0,5,5
10789,حماية,0,0,5,5
44182,referencia,0,0,5,5
10850,nergis,0,0,5,5
40904,standard,0,0,5,5
25510,वाली,0,0,5,5
11177,allemand,0,0,5,5
11812,ihåg,0,0,5,5
11648,core,0,0,5,5
32294,identité,0,0,5,5
11591,बातचीत,0,0,5,5
28800,ದೈನಂದಿನ,0,0,5,5
11607,events,0,0,5,5
25311,hjälp,0,0,5,5
25307,produced,0,0,5,5
32284,yer,0,0,5,5
25285,meet,0,0,5,5
25439,хочет,0,0,5,5
36577,должна,0,0,5,5
11756,terrain,0,0,5,5
11760,répéter,0,0,5,5
35262,comuns,0,0,5,5
40638,ему,0,0,5,5
11768,spørgsmål,0,0,5,5
11809,mejora,0,0,5,5
11578,blir,0,0,5,5
11568,cómo,0,0,5,5
25358,florida,0,0,5,5
11538,essas,0,0,5,5
32396,continuar,0,0,5,5
32393,someone,0,0,5,5
40793,mismos,0,0,5,5
34001,soir,0,0,5,5
25416,commonly,0,0,5,5
25406,weg,0,0,5,5
32338,difficulté,0,0,5,5
25391,stephen,0,0,5,5
32333,അവരോട്,0,0,5,5
11429,espace,0,0,5,5
11441,lévistrauss,0,0,5,5
36550,fangede,0,0,5,5
40753,goud,0,0,5,5
32323,arbetet,0,0,5,5
11491,vocês,0,0,5,5
13323,சொற்றொடர்,0,0,5,5
47106,occurred,0,0,5,5
40220,பல,0,0,5,5
31653,helfen,0,0,5,5
14810,अलावा,0,0,5,5
23680,ثم,0,0,5,5
29377,hebben,0,0,5,5
14847,സാധാരണ,0,0,5,5
29410,بدأت,0,0,5,5
29421,arquivos,0,0,5,5
14899,بالنسبة,0,0,5,5
39668,restaurant,0,0,5,5
15119,خوادم,0,0,5,5
37136,wurde,0,0,5,5
44350,mieux,0,0,5,5
14943,ainda,0,0,5,5
29440,prins,0,0,5,5
44663,wissen,0,0,5,5
39608,ಓ,0,0,5,5
15108,പോകുന്നു,0,0,5,5
45561,onderzoek,0,0,5,5
23726,завален,0,0,5,5
46956,खुद,0,0,5,5
45555,forskellige,0,0,5,5
39823,philosophy,0,0,5,5
34960,connection,0,0,5,5
37114,beetje,0,0,5,5
14624,siguiente,0,0,5,5
23794,möglichkeit,0,0,5,5
45550,repeat,0,0,5,5
45554,проекта,0,0,5,5
23772,intended,0,0,5,5
14675,söyleyebilirsiniz,0,0,5,5
39715,संपादकों,0,0,5,5
14711,jämfört,0,0,5,5
34284,announced,0,0,5,5
23765,ಪದದ,0,0,5,5
39704,quien,0,0,5,5
43857,ಕೇಳಿದಾಗ,0,0,5,5
39605,പറയാം,0,0,5,5
15193,atlantic,0,0,5,5
14562,الجيد,0,0,5,5
31400,ജീവിതത്തിൽ,0,0,5,5
34375,resources,0,0,5,5
15536,ayrıca,0,0,5,5
31420,prochaine,0,0,5,5
29490,mevcuttur,0,0,5,5
31416,algorithmic,0,0,5,5
15588,effet,0,0,5,5
15598,américains,0,0,5,5
15654,époque,0,0,5,5
29456,correct,0,0,5,5
15670,schön,0,0,5,5
15688,named,0,0,5,5
15707,даже,0,0,5,5
15708,största,0,0,5,5
31382,milieu,0,0,5,5
15711,anonymous,0,0,5,5
15724,இதன்,0,0,5,5
39547,normas,0,0,5,5
23320,évidence,0,0,5,5
15490,rates,0,0,5,5
31447,menudo,0,0,5,5
34322,الإنترنت,0,0,5,5
46834,autonome,0,0,5,5
15235,എണ്ണം,0,0,5,5
31521,licencias,0,0,5,5
15251,दे,0,0,5,5
42960,necesidad,0,0,5,5
42962,rijtuig,0,0,5,5
39577,applied,0,0,5,5
15336,component,0,0,5,5
29486,سأكون,0,0,5,5
23402,ചെയ്യുക,0,0,5,5
15378,talvez,0,0,5,5
31461,autores,0,0,5,5
23397,gange,0,0,5,5
46784,நண்பர்களுடன்,0,0,5,5
23852,http,0,0,5,5
23890,tillförlitlighet,0,0,5,5
24304,inloggade,0,0,5,5
13769,oubliez,0,0,5,5
13686,ಪದಗುಚ್,0,0,5,5
13713,carr,0,0,5,5
13721,yapmak,0,0,5,5
45484,presse,0,0,5,5
36941,após,0,0,5,5
13747,konflikter,0,0,5,5
42926,منه,0,0,5,5
24212,depending,0,0,5,5
24151,όλη,0,0,5,5
40060,receives,0,0,5,5
36952,mois,0,0,5,5
24182,നിങ്ങൾ‌,0,0,5,5
40047,забудьте,0,0,5,5
13869,إنني,0,0,5,5
31772,popularidad,0,0,5,5
40017,donné,0,0,5,5
47050,पल,0,0,5,5
29207,पूछा,0,0,5,5
29201,участниками,0,0,5,5
45478,modos,0,0,5,5
13334,chine,0,0,5,5
13338,lecteurs,0,0,5,5
24295,juillet,0,0,5,5
13360,பெரிய,0,0,5,5
31870,carnegie,0,0,5,5
40142,moeten,0,0,5,5
40139,wiederholen,0,0,5,5
13511,أين,0,0,5,5
40128,सर्च,0,0,5,5
13543,ये,0,0,5,5
34148,εγώ,0,0,5,5
13560,abrumado,0,0,5,5
13593,complexity,0,0,5,5
13598,bouton,0,0,5,5
13612,lange,0,0,5,5
13918,millón,0,0,5,5
36961,சந்திப்பு,0,0,5,5
39885,geography,0,0,5,5
39910,works,0,0,5,5
39938,niets,0,0,5,5
14257,analysera,0,0,5,5
24042,الأساسية,0,0,5,5
44676,critics,0,0,5,5
14308,doit,0,0,5,5
29284,unos,0,0,5,5
23965,innebär,0,0,5,5
39901,καταπληκτική,0,0,5,5
14014,krijgen,0,0,5,5
14420,повседневной,0,0,5,5
14441,træt,0,0,5,5
23896,visual,0,0,5,5
14456,ಎರಡು,0,0,5,5
14457,geluk,0,0,5,5
39900,पार,0,0,5,5
14497,അവന്റെ,0,0,5,5
47015,precisão,0,0,5,5
45538,entradas,0,0,5,5
14228,université,0,0,5,5
39968,sidevisninger,0,0,5,5
14018,vielen,0,0,5,5
14028,இருப்பேன்,0,0,5,5
24129,empresa,0,0,5,5
24128,apart,0,0,5,5
39972,arbeiten,0,0,5,5
14062,ξέρεις,0,0,5,5
14067,நாள்,0,0,5,5
24084,birinin,0,0,5,5
14127,native,0,0,5,5
14155,υπέροχη,0,0,5,5
44335,travaille,0,0,5,5
35017,complètement,0,0,5,5
14178,desconcertado,0,0,5,5
31714,പോകാൻ,0,0,5,5
14189,wikipedianer,0,0,5,5
28194,claim,0,0,5,5
23955,peter,0,0,5,5
3899,அதன்,0,0,5,5
3450,california,2,2,3,5
2483,sui,1,5,0,5
3022,parlare,1,5,0,5
1686,portale,1,5,0,5
5632,biosphere,0,0,5,5
132,vedere,1,5,0,5
2763,affidabilità,1,5,0,5
2530,festival,2,1,4,5
9,testi,1,5,0,5
3309,eh,2,3,2,5
2560,wikibooks,2,1,4,5
3796,debes,0,0,5,5
3781,tillräckligt,0,0,5,5
793,segreto,1,5,0,5
1625,raggiunto,1,5,0,5
56,errore,1,5,0,5
2980,siano,1,5,0,5
4821,exists,0,0,5,5
1032,riferimento,1,5,0,5
26,electronica,2,1,4,5
775,ottieni,1,5,0,5
2185,certo,2,4,1,5
2912,senso,2,4,1,5
3908,καλύτερο,0,0,5,5
4612,جاء,0,0,5,5
167,lingue,1,5,0,5
3207,paideia,2,2,3,5
4858,istiyorum,0,0,5,5
3528,linea,1,5,0,5
2945,fondo,2,3,2,5
4220,إنها,0,0,5,5
4590,kennis,0,0,5,5
1735,gioco,1,5,0,5
1826,mente,2,2,3,5
1072,palude,1,5,0,5
945,pensare,1,5,0,5
2369,pae,2,1,4,5
4986,huilen,0,0,5,5
4441,வார்த்தையின்,0,0,5,5
4435,universal,0,0,5,5
3391,formato,2,1,4,5
3193,line,2,1,4,5
5013,तरीके,0,0,5,5
3648,lentamente,2,3,2,5
3398,applicazioni,1,5,0,5
1217,agli,1,5,0,5
1565,computazionale,1,5,0,5
104,ottimizzazione,1,5,0,5
2988,là,2,1,4,5
2674,offre,2,1,4,5
223,generale,1,5,0,5
2990,idee,2,1,4,5
4872,dizem,0,0,5,5
1388,cyberarts,2,1,4,5
3633,sconcertato,1,5,0,5
923,chiedendo,1,5,0,5
4880,colaborar,0,0,5,5
807,awards,2,1,4,5
4891,محرري,0,0,5,5
518,attività,1,5,0,5
4260,अपना,0,0,5,5
3745,svm,2,2,3,5
1219,apprende,1,5,0,5
1387,dicendo,1,5,0,5
863,clic,2,2,3,5
4421,delar,0,0,5,5
2576,triste,2,1,4,5
2907,wikivoyage,2,1,4,5
931,novembre,2,2,3,5
801,robert,2,2,3,5
3397,william,2,1,4,5
3123,migliori,1,5,0,5
3521,sviluppo,1,5,0,5
5039,description,0,0,5,5
4790,göbl,0,0,5,5
3336,bellezza,1,5,0,5
3082,tutta,1,5,0,5
2559,hard,2,3,2,5
2649,conversazione,1,5,0,5
3798,الإصلاح,0,0,5,5
866,informazione,1,5,0,5
2634,esperti,1,5,0,5
1588,logica,1,5,0,5
1648,messenger,2,1,4,5
4073,innan,0,0,5,5
5383,हर,0,0,5,5
510,interne,2,3,2,5
1390,cara,2,4,1,5
3214,mass,2,1,4,5
4317,veta,0,0,5,5
397,pagine,1,5,0,5
1378,stavi,1,5,0,5
2314,giro,2,4,1,5
246,suoni,1,5,0,5
1816,susningnu,2,1,4,5
905,possibilità,1,5,0,5
2179,verso,1,5,0,5
2679,generalmente,2,4,1,5
3537,wikipediacom,2,1,4,5
541,adesso,1,5,0,5
3075,concetto,1,5,0,5
62,sull,1,5,0,5
1717,mondiale,2,2,3,5
5408,तीन,0,0,5,5
494,ceo,2,1,4,5
4560,thought,0,0,5,5
5180,resulting,0,0,5,5
1541,dice,2,3,2,5
4030,भयानक,0,0,5,5
5140,pares,0,0,5,5
747,stanford,2,1,4,5
283,dna,2,1,4,5
2678,creazione,1,5,0,5
1990,centro,2,1,4,5
1139,lucro,2,1,4,5
823,futuro,2,1,4,5
3419,contrario,2,3,2,5
61,wired,2,1,4,5
350,capito,1,5,0,5
4837,categories,0,0,5,5
2009,grandi,1,5,0,5
3684,note,2,1,4,5
437,revisione,1,5,0,5
2544,survey,2,2,3,5
3506,appuntamento,1,5,0,5
5241,engelse,0,0,5,5
4234,diesen,0,0,5,5
5496,forskarna,0,0,5,5
4334,particulièrement,0,0,5,5
718,economia,2,2,3,5
3253,tedesca,1,5,0,5
4685,वर्तमान,0,0,5,5
1179,stupenda,1,5,0,5
533,chi,1,5,0,5
1644,serio,2,1,4,5
3757,beschikbaar,0,0,5,5
4659,immer,0,0,5,5
3312,metodo,1,5,0,5
5423,തങ്ങളുടെ,0,0,5,5
1903,capo,1,5,0,5
2771,«wikipedia,2,2,3,5
4376,canım,0,0,5,5
1504,mchenry,2,1,4,5
3130,bello,1,5,0,5
3727,mangiare,1,5,0,5
2596,categorie,2,4,1,5
1897,maggio,1,5,0,5
2968,tutte,1,5,0,5
5261,killer,0,0,5,5
125,partire,1,5,0,5
3535,favore,1,5,0,5
3787,ideia,0,0,5,5
2680,generalizzazione,1,5,0,5
2642,digitale,2,2,3,5
716,abbastanza,1,5,0,5
3911,refers,0,0,5,5
5548,egna,0,0,5,5
601,stanco,1,5,0,5
1956,rispondere,1,4,0,4
43263,özgür,0,0,4,4
12124,naziksiniz,0,0,4,4
34625,محرر,0,0,4,4
46731,coined,0,0,4,4
46732,vred,0,0,4,4
25062,παιδιά,0,0,4,4
8697,faible,0,0,4,4
27017,quotidienne,0,0,4,4
38270,tuvo,0,0,4,4
12229,ആഗ്രഹിക്കുന്നുണ്ടോ,0,0,4,4
12143,θυμηθείτε,0,0,4,4
38246,contexte,0,0,4,4
2356,samuel,2,2,2,4
12129,berkman,0,0,4,4
27024,bons,0,0,4,4
35678,formes,0,0,4,4
8669,diversos,0,0,4,4
43347,devoirs,0,0,4,4
32688,σελίδα,0,0,4,4
29448,gibisin,0,0,4,4
29487,पृष्ठों,0,0,4,4
35680,தொந்தரவு,0,0,4,4
43271,heureux,0,0,4,4
44591,इंजन,0,0,4,4
22811,ആഗ്രഹിക്കുന്നു,0,0,4,4
31428,tage,0,0,4,4
7249,francisco,0,0,4,4
25080,boundaries,0,0,4,4
25094,theoretical,0,0,4,4
46767,espèce,0,0,4,4
1344,chiamati,1,4,0,4
12176,excepción,0,0,4,4
7275,würden,0,0,4,4
39371,തെറ്റുകൾ,0,0,4,4
40551,networking,0,0,4,4
39373,பயன்படுத்தலாம்,0,0,4,4
3488,superando,2,2,2,4
40554,katherine,0,0,4,4
20508,sister,0,0,4,4
35232,sinds,0,0,4,4
2184,generali,1,4,0,4
25088,μπορούσα,0,0,4,4
27906,larger,0,0,4,4
25091,mudanças,0,0,4,4
34035,senin,0,0,4,4
17618,empresas,0,0,4,4
29472,certa,0,0,4,4
12173,получаете,0,0,4,4
4801,ಕಡಿಮೆ,0,0,4,4
29451,sociala,0,0,4,4
3764,schwierigen,0,0,4,4
43327,employed,0,0,4,4
20478,ಹೇ,0,0,4,4
43326,tool,0,0,4,4
625,bella,1,4,0,4
7295,errores,0,0,4,4
3770,अमेरिका,0,0,4,4
16003,പ്രവർത്തിക്കുന്ന,0,0,4,4
44598,पारंपरिक,0,0,4,4
7292,horas,0,0,4,4
2939,foto,2,2,2,4
10403,хочешь,0,0,4,4
45749,толку,0,0,4,4
2187,intento,2,1,3,4
1496,pedia,2,3,1,4
4326,w ·,0,0,4,4
27002,बटन,0,0,4,4
40541,praten,0,0,4,4
2180,scritte,1,4,0,4
7282,worth,0,0,4,4
46771,committee,0,0,4,4
29462,нравится,0,0,4,4
20451,catégories,0,0,4,4
44554,french,0,0,4,4
31415,zowel,0,0,4,4
20448,يوجد,0,0,4,4
27866,مجتمع,0,0,4,4
11980,ஜிம்மி,0,0,4,4
1056,wikinfo,2,1,3,4
38202,xixe siècle,0,0,4,4
40423,них,0,0,4,4
46635,lisans,0,0,4,4
32620,ಮಾಡಿದ,0,0,4,4
2272,addestramento,1,4,0,4
27103,ചിലർക്ക്,0,0,4,4
16154,agrupamiento,0,0,4,4
20353,neerlandés,0,0,4,4
11996,подумать,0,0,4,4
7432,fundador,0,0,4,4
7431,sense,0,0,4,4
11998,fundada,0,0,4,4
22875,الأكثر,0,0,4,4
25001,connu,0,0,4,4
1951,film,2,1,3,4
22873,कॉपीराइट,0,0,4,4
40438,chinese,0,0,4,4
20364,fins,0,0,4,4
30957,effective,0,0,4,4
43439,visiteurs,0,0,4,4
35640,അമ്മ,0,0,4,4
43438,विचार,0,0,4,4
27095,إصلاح,0,0,4,4
44528,glück,0,0,4,4
32067,​​​,0,0,4,4
25005,tâche,0,0,4,4
38200,winkel,0,0,4,4
27120,ಸ್ಥಳದಲ್ಲಿ,0,0,4,4
16172,தருகிறேன்,0,0,4,4
40410,genau,0,0,4,4
40397,algemeen,0,0,4,4
7496,tópico,0,0,4,4
46598,ven,0,0,4,4
27139,раздела,0,0,4,4
44502,wasn,0,0,4,4
37460,όσο,0,0,4,4
43494,الأشياء,0,0,4,4
40404,ಬಯಸುತ್ತೇನೆ,0,0,4,4
8604,حياتك,0,0,4,4
43489,aldrig,0,0,4,4
7478,fått,0,0,4,4
43488,creó,0,0,4,4
2928,bayesiana,2,1,3,4
32078,списке,0,0,4,4
17534,dépend,0,0,4,4
40413,اللغة,0,0,4,4
1476,importanti,1,4,0,4
16180,கோபமாக,0,0,4,4
11957,cdrom,0,0,4,4
29373,naturelles,0,0,4,4
34605,editada,0,0,4,4
20326,skapa,0,0,4,4
43478,ranking,0,0,4,4
30973,product,0,0,4,4
32610,término,0,0,4,4
20330,vognen,0,0,4,4
17533,trata,0,0,4,4
46625,beginnen,0,0,4,4
7411,αριθμός,0,0,4,4
5426,أفهم,0,0,4,4
38211,sak,0,0,4,4
37363,الاتصال,0,0,4,4
3479,classe,2,1,3,4
37374,titre,0,0,4,4
19266,എന്തായാലും,0,0,4,4
29491,wants,0,0,4,4
25049,вики,0,0,4,4
12095,japonais,0,0,4,4
43369,permettre,0,0,4,4
16055,höfling,0,0,4,4
7350,títulos,0,0,4,4
7349,انخفاض,0,0,4,4
17586,фонда,0,0,4,4
32683,محتوى,0,0,4,4
37364,dagliga,0,0,4,4
44556,bush,0,0,4,4
20411,originais,0,0,4,4
44558,fout,0,0,4,4
37360,ತನ್ನ,0,0,4,4
44560,happen,0,0,4,4
44563,estimation,0,0,4,4
20438,maher,0,0,4,4
43356,ellas,0,0,4,4
22831,supuesto,0,0,4,4
1345,sarà,1,4,0,4
20443,visas,0,0,4,4
37354,servir,0,0,4,4
7329,mam,0,0,4,4
20446,വാക്കിന്റെ,0,0,4,4
16035,നഷ്ടം,0,0,4,4
3903,карета,0,0,4,4
10439,isto,0,0,4,4
2708,dieci,1,4,0,4
12043,разделе,0,0,4,4
20372,probleem,0,0,4,4
17554,ಯೋಗ್ಯವಾಗಿಲ್ಲ,0,0,4,4
17555,പൂർണ്ണമായും,0,0,4,4
7402,செய்த,0,0,4,4
35644,المقال,0,0,4,4
37405,frequently,0,0,4,4
22862,बताने,0,0,4,4
20380,கூடுதல்,0,0,4,4
20382,любой,0,0,4,4
4128,letterlijk,0,0,4,4
27077,estudantes,0,0,4,4
40459,flórida,0,0,4,4
46673,പകരം,0,0,4,4
30944,विश्वसनीय,0,0,4,4
4818,áreas,0,0,4,4
38219,രണ്ട്,0,0,4,4
10452,videoyu,0,0,4,4
2930,scoperta,1,4,0,4
10451,college,0,0,4,4
34079,énergie,0,0,4,4
43398,சூழ்நிலையில்,0,0,4,4
27063,ಬಳಸಲಾಗುತ್ತದೆ,0,0,4,4
16093,café,0,0,4,4
37385,genoeg,0,0,4,4
29417,books,0,0,4,4
12067,vrouwen,0,0,4,4
10449,développée,0,0,4,4
10441,обычно,0,0,4,4
1507,bancario,2,2,2,4
39252,nothing,0,0,4,4
29492,файлов,0,0,4,4
2162,redattori,1,4,0,4
45658,अनुरोध,0,0,4,4
37122,ways,0,0,4,4
20797,hørt,0,0,4,4
12552,خبراء,0,0,4,4
6978,half,0,0,4,4
6980,téléphone,0,0,4,4
44695,уловка,0,0,4,4
2730,accademici,1,4,0,4
660,dale,2,1,3,4
6986,دراسة,0,0,4,4
25253,исследования,0,0,4,4
44693,بعتني,0,0,4,4
15666,источника,0,0,4,4
43055,بأي,0,0,4,4
33913,élevé,0,0,4,4
46975,vereceğim,0,0,4,4
37120,ನೀಡಲು,0,0,4,4
37118,sollte,0,0,4,4
2450,attivi,1,4,0,4
10228,baan,0,0,4,4
20807,പറയുകയും,0,0,4,4
12565,filosofía,0,0,4,4
20813,understand,0,0,4,4
46984,ονομάζεται,0,0,4,4
3256,ciffolilli,2,1,3,4
20816,sentences,0,0,4,4
37110,solgte,0,0,4,4
12575,damit,0,0,4,4
2599,aumento,2,1,3,4
15618,chacun,0,0,4,4
46993,himlen,0,0,4,4
133,biografia,2,2,2,4
26827,ಯಾಕೆ,0,0,4,4
22768,interactive,0,0,4,4
38328,pasa,0,0,4,4
5230,diriezvous,0,0,4,4
7023,ρίζες,0,0,4,4
20759,आधारित,0,0,4,4
12479,menor,0,0,4,4
31998,بي,0,0,4,4
20756,humanité,0,0,4,4
40750,कहता,0,0,4,4
33928,stället,0,0,4,4
19130,πριν,0,0,4,4
20751,faz,0,0,4,4
45676,क्रिएटिव,0,0,4,4
20747,vendeu,0,0,4,4
28712,recognized,0,0,4,4
4101,antar,0,0,4,4
10256,zeg,0,0,4,4
43076,सितंबर,0,0,4,4
43075,seven,0,0,4,4
43074,instant,0,0,4,4
35793,എന്നോട്,0,0,4,4
4097,раньше,0,0,4,4
38338,lovely,0,0,4,4
20771,الحصول,0,0,4,4
12505,education,0,0,4,4
12508,kwaliteit,0,0,4,4
26831,själva,0,0,4,4
8807,प्रविष्टियों,0,0,4,4
34700,வீடியோவில்,0,0,4,4
12514,citing,0,0,4,4
20776,goda,0,0,4,4
6999,estimated,0,0,4,4
40775,move,0,0,4,4
46994,publié,0,0,4,4
37104,reglas,0,0,4,4
34710,octubre,0,0,4,4
37060,consists,0,0,4,4
10153,مواقع,0,0,4,4
42936,perl,0,0,4,4
23538,английская,0,0,4,4
33877,corrigés,0,0,4,4
15526,culturels,0,0,4,4
39215,popularity,0,0,4,4
6881,chicos,0,0,4,4
43013,selflearning,0,0,4,4
10160,tittade,0,0,4,4
22612,septiembre,0,0,4,4
31954,واحدة,0,0,4,4
39221,dix,0,0,4,4
40880,αξίζει,0,0,4,4
17836,dedicado,0,0,4,4
28031,multicellular,0,0,4,4
42929,institute,0,0,4,4
8873,ranked,0,0,4,4
37046,لطف,0,0,4,4
39210,ಸ್ನೇಹಿತರು,0,0,4,4
35839,मिनट,0,0,4,4
17861,некоторых,0,0,4,4
978,relativamente,2,2,2,4
35172,ஒவ்வொரு,0,0,4,4
28674,complexe,0,0,4,4
40908,citations,0,0,4,4
47063,delen,0,0,4,4
47064,مشكلة,0,0,4,4
29696,δωρεάν,0,0,4,4
40909,nombres,0,0,4,4
40911,kez,0,0,4,4
25336,projekt,0,0,4,4
15540,tijdens,0,0,4,4
15543,مستخدمي,0,0,4,4
40867,identified,0,0,4,4
12615,wrong,0,0,4,4
6943,диск,0,0,4,4
44711,expertos,0,0,4,4
15608,quatro,0,0,4,4
39242,zeer,0,0,4,4
10207,பெற்றேன்,0,0,4,4
10206,сэнгер,0,0,4,4
1787,ufficiale,1,4,0,4
19088,सर्वरों,0,0,4,4
31970,विश्व,0,0,4,4
15591,yarın,0,0,4,4
29658,вклад,0,0,4,4
5227,diciembre,0,0,4,4
26772,совет,0,0,4,4
12614,θέση,0,0,4,4
47016,promover,0,0,4,4
5493,einmal,0,0,4,4
15574,anders,0,0,4,4
2158,creare,1,4,0,4
12628,apparition,0,0,4,4
4087,fredag,0,0,4,4
8847,журналах,0,0,4,4
44725,облажался,0,0,4,4
8849,sum,0,0,4,4
672,cercando,1,4,0,4
37081,colaboração,0,0,4,4
10187,संगठन,0,0,4,4
42967,ध्वनि,0,0,4,4
17828,रोक,0,0,4,4
20875,அவரது,0,0,4,4
19069,ಮೊದಲು,0,0,4,4
27965,särskilt,0,0,4,4
35779,falsas,0,0,4,4
46932,historial,0,0,4,4
1965,enwikipediaorg,2,1,3,4
40629,includes,0,0,4,4
31442,εντελώς,0,0,4,4
45726,editable,0,0,4,4
40624,αυτήν,0,0,4,4
28751,şu,0,0,4,4
37242,исследование,0,0,4,4
43216,ಭಯಾನಕ,0,0,4,4
22725,शांत,0,0,4,4
4340,വേണം,0,0,4,4
30870,inget,0,0,4,4
15893,വീട്ടിലേക്ക്,0,0,4,4
37246,वितरित,0,0,4,4
43221,equinix,0,0,4,4
10342,impossible,0,0,4,4
22730,pedindo,0,0,4,4
24223,outlier,0,0,4,4
34654,പരിഹാരത്തിലാണ്,0,0,4,4
19184,förvirrade,0,0,4,4
46844,ल्युसेन,0,0,4,4
3755,canto,2,3,1,4
33994,சரி,0,0,4,4
25143,vendu,0,0,4,4
20625,activos,0,0,4,4
17678,manmade,0,0,4,4
25145,குறிப்பிட்ட,0,0,4,4
40643,básicas,0,0,4,4
44630,ലഭിച്ചു,0,0,4,4
26916,primero,0,0,4,4
1198,mille,2,3,1,4
20635,başladı,0,0,4,4
7139,nemen,0,0,4,4
29520,fürchte,0,0,4,4
32749,générale,0,0,4,4
20601,nonenglish,0,0,4,4
22748,проблема,0,0,4,4
26958,einfach,0,0,4,4
19215,détectés,0,0,4,4
17642,crianças,0,0,4,4
8703,வேடிக்கையான,0,0,4,4
40587,ensayo,0,0,4,4
20567,хорошая,0,0,4,4
35722,जांच,0,0,4,4
34640,slow,0,0,4,4
38278,ಸಾಕಷ್ಟು,0,0,4,4
30884,mat,0,0,4,4
27921,couldn,0,0,4,4
1862,guide,2,1,3,4
7207,ஏனென்றால்,0,0,4,4
5036,പദ്ധതികൾ,0,0,4,4
43241,usadas,0,0,4,4
45813,мило,0,0,4,4
1512,punteggio,1,4,0,4
34016,outputs,0,0,4,4
12274,ответ,0,0,4,4
45735,guidelines,0,0,4,4
45734,wikipediaartikel,0,0,4,4
12277,criterios,0,0,4,4
40600,closely,0,0,4,4
34015,arkadaşlarımla,0,0,4,4
19195,имя,0,0,4,4
46817,ವೀಡಿಯೊವನ್ನು,0,0,4,4
40608,ciertas,0,0,4,4
17665,determine,0,0,4,4
46820,entrou,0,0,4,4
15897,côté,0,0,4,4
40646,notably,0,0,4,4
20641,función,0,0,4,4
15718,screwed,0,0,4,4
24198,وإذا,0,0,4,4
3915,entschuldigen,0,0,4,4
12416,room,0,0,4,4
37178,अ,0,0,4,4
15780,sprechen,0,0,4,4
19153,aparecer,0,0,4,4
7074,എന്നു,0,0,4,4
20696,котором,0,0,4,4
43183,fyre,0,0,4,4
12404,прежде,0,0,4,4
43146,nós,0,0,4,4
4351,lesquels,0,0,4,4
22703,wikiproject,0,0,4,4
35210,chaîne,0,0,4,4
34675,económico,0,0,4,4
29589,incluyendo,0,0,4,4
12425,प्रभाव,0,0,4,4
10281,mentioned,0,0,4,4
20718,enojado,0,0,4,4
10277,neler,0,0,4,4
12434,worldwide,0,0,4,4
20724,чрезвычайно,0,0,4,4
31463,प्रत्येक,0,0,4,4
27960,exatamente,0,0,4,4
27961,декабре,0,0,4,4
2168,permanente,2,1,3,4
3175,mirror,2,3,1,4
15727,knap,0,0,4,4
289,sembrare,1,4,0,4
17739,ജോലിയിൽ,0,0,4,4
43101,العلمية,0,0,4,4
28715,développer,0,0,4,4
31456,அன்று,0,0,4,4
15793,മുതൽ,0,0,4,4
17719,उनसे,0,0,4,4
28738,charge,0,0,4,4
46868,conocidos,0,0,4,4
37224,livres,0,0,4,4
4787,பகுதி,0,0,4,4
38303,رائعًا,0,0,4,4
37221,temperature,0,0,4,4
25154,conseil,0,0,4,4
7121,सहकर्मी,0,0,4,4
32018,πολλά,0,0,4,4
15834,botón,0,0,4,4
7117,appel,0,0,4,4
29563,mostrou,0,0,4,4
37215,português,0,0,4,4
43177,waarin,0,0,4,4
43176,уже,0,0,4,4
46882,entender,0,0,4,4
3182,publishing,2,1,3,4
29567,правильно,0,0,4,4
17695,devem,0,0,4,4
3302,noi,1,4,0,4
17701,ಮಾರಿದ್ದೀರಿ,0,0,4,4
29570,olumsuz,0,0,4,4
40666,الأسبوع,0,0,4,4
12370,أخشى,0,0,4,4
5465,continued,0,0,4,4
40670,begyndte,0,0,4,4
20673,réalisée,0,0,4,4
43167,imagine,0,0,4,4
26893,sted,0,0,4,4
28734,funcionar,0,0,4,4
15812,खा,0,0,4,4
25127,économie,0,0,4,4
1358,comportamento,2,3,1,4
45814,flere,0,0,4,4
38034,журнала,0,0,4,4
19851,deben,0,0,4,4
17256,flest,0,0,4,4
24432,afraid,0,0,4,4
11248,योजना,0,0,4,4
8013,skriva,0,0,4,4
4202,समर्पित,0,0,4,4
29100,википедии —,0,0,4,4
1389,proprie,1,4,0,4
11242,других,0,0,4,4
17254,lugares,0,0,4,4
4927,получил,0,0,4,4
11238,licensed,0,0,4,4
43985,बौद्धिक,0,0,4,4
1425,spazio,1,4,0,4
16837,tipos,0,0,4,4
31172,fish,0,0,4,4
39935,wikipédias,0,0,4,4
10800,tribunal,0,0,4,4
8001,essentiellement,0,0,4,4
10797,dollar,0,0,4,4
19525,neutralitet,0,0,4,4
4922,использование,0,0,4,4
19866,இனிமையான,0,0,4,4
46240,waard,0,0,4,4
27474,rendre,0,0,4,4
39939,वैसे,0,0,4,4
11269,बुरा,0,0,4,4
31165,publica,0,0,4,4
1884,egli,1,4,0,4
1742,mano,2,2,2,4
43956,αύριο,0,0,4,4
8364,предложение,0,0,4,4
19830,sidorna,0,0,4,4
46251,steeds,0,0,4,4
45990,சென்று,0,0,4,4
46197,ದಿನ,0,0,4,4
11186,उचित,0,0,4,4
11185,تسمح,0,0,4,4
44277,कानून,0,0,4,4
5340,faites,0,0,4,4
19549,അതെ,0,0,4,4
1124,devi,1,4,0,4
34511,عزيزي,0,0,4,4
4196,مستخدم,0,0,4,4
10837,sprogversioner,0,0,4,4
34391,ആവശ്യമാണ്,0,0,4,4
24600,vandalismes,0,0,4,4
39876,kennen,0,0,4,4
4944,gabriel,0,0,4,4
11190,vriend,0,0,4,4
39891,específicas,0,0,4,4
24446,വാൻഡലിസം,0,0,4,4
45985,pontos,0,0,4,4
19811,публикации,0,0,4,4
11198,bedre,0,0,4,4
19815,pantano,0,0,4,4
8047,январе,0,0,4,4
16887,detectar,0,0,4,4
45983,employ,0,0,4,4
24612,looking,0,0,4,4
32340,akademiska,0,0,4,4
24441,broke,0,0,4,4
16868,разными,0,0,4,4
11219,mesaj,0,0,4,4
39917,योगदानकर्ताओं,0,0,4,4
8033,الرئيسية,0,0,4,4
1882,vuole,1,4,0,4
11283,écologie,0,0,4,4
17511,single,0,0,4,4
17318,aquela,0,0,4,4
43896,usada,0,0,4,4
1913,trimestre,2,1,3,4
27433,nonprofit,0,0,4,4
45948,ninguna,0,0,4,4
19934,oluyor,0,0,4,4
37733,eau,0,0,4,4
38066,staat,0,0,4,4
7936,يحدث,0,0,4,4
37737,आदमी,0,0,4,4
11351,internationale,0,0,4,4
4915,ciertos,0,0,4,4
39600,statistik,0,0,4,4
7932,higher,0,0,4,4
11346,meningar,0,0,4,4
11365,haber,0,0,4,4
46302,работает,0,0,4,4
38068,licencia,0,0,4,4
7912,método,0,0,4,4
39991,yapılan,0,0,4,4
11371,പോകണം,0,0,4,4
29158,namn,0,0,4,4
16747,наиболее,0,0,4,4
16742,பல்வேறு,0,0,4,4
10743,enciclopedias,0,0,4,4
46314,trabalhe,0,0,4,4
3413,records,2,1,3,4
3828,மட்டுமே,0,0,4,4
11385,women,0,0,4,4
2893,miglioramento,1,4,0,4
531,spiega,1,4,0,4
11394,frågor,0,0,4,4
27440,στις,0,0,4,4
31147,wochenende,0,0,4,4
34530,notre,0,0,4,4
23308,advocacy,0,0,4,4
43932,diga,0,0,4,4
11310,k,0,0,4,4
29128,bakış,0,0,4,4
23111,வருந்துகிறேன்,0,0,4,4
43933,werkstatt,0,0,4,4
34343,ελεύθερου,0,0,4,4
11300,leitor,0,0,4,4
43914,resolution,0,0,4,4
10773,anyway,0,0,4,4
23115,concern,0,0,4,4
10774,мог,0,0,4,4
43943,watching,0,0,4,4
46258,diye,0,0,4,4
27462,kullanılır,0,0,4,4
24403,início,0,0,4,4
19900,heat,0,0,4,4
29130,publicerar,0,0,4,4
39607,clasificar,0,0,4,4
43927,tycker,0,0,4,4
8397,creado,0,0,4,4
39606,തുടങ്ങിയ,0,0,4,4
11321,ஆண்டின்,0,0,4,4
19910,spelar,0,0,4,4
10763,altından,0,0,4,4
43920,ورائعة,0,0,4,4
5295,algae,0,0,4,4
43915,anos,0,0,4,4
11333,золотой,0,0,4,4
7943,emprego,0,0,4,4
217,bravo,2,2,2,4
37744,küçük,0,0,4,4
5338,budget,0,0,4,4
19788,заявил,0,0,4,4
507,registrati,1,4,0,4
4177,investigation,0,0,4,4
24481,preguntar,0,0,4,4
17052,கட்டற்ற,0,0,4,4
37982,absoluto,0,0,4,4
24533,dicho,0,0,4,4
19603,conseguiu,0,0,4,4
17056,dónde,0,0,4,4
37930,team,0,0,4,4
17066,toi,0,0,4,4
31246,citou,0,0,4,4
17060,benimle,0,0,4,4
32267,código,0,0,4,4
2866,felice,1,4,0,4
17063,إجراء,0,0,4,4
44150,esfuerzo,0,0,4,4
29016,κλαίει,0,0,4,4
17043,simply,0,0,4,4
32277,volontaires,0,0,4,4
44235,μερικά,0,0,4,4
24479,σχεδόν,0,0,4,4
1898,ilp,2,2,2,4
23270,discovering,0,0,4,4
39795,дочь,0,0,4,4
10889,αστείο,0,0,4,4
29022,sucede,0,0,4,4
44117,kelimesinin,0,0,4,4
46109,drei,0,0,4,4
35394,bit,0,0,4,4
37998,héberge,0,0,4,4
44108,impacto,0,0,4,4
19703,nonlinear,0,0,4,4
46114,comité,0,0,4,4
24483,klein,0,0,4,4
34474,просмотра,0,0,4,4
34393,aime,0,0,4,4
23248,pew,0,0,4,4
17105,crítica,0,0,4,4
19636,rapid,0,0,4,4
44206,имеют,0,0,4,4
17112,redan,0,0,4,4
17140,κόρη,0,0,4,4
27640,estraguei,0,0,4,4
1756,cielo,2,2,2,4
8215,follow,0,0,4,4
10949,تحتوي,0,0,4,4
39744,φοβάμαι,0,0,4,4
1758,campi,1,4,0,4
46046,europa,0,0,4,4
34461,obra,0,0,4,4
2370,ward,2,2,2,4
19637,sold,0,0,4,4
27633,multimédia,0,0,4,4
17097,gente,0,0,4,4
8239,akıcı,0,0,4,4
31257,κείμενο,0,0,4,4
17149,ceux,0,0,4,4
39766,fantastiske,0,0,4,4
46070,durum,0,0,4,4
19649,अलग,0,0,4,4
5308,لهم,0,0,4,4
10991,αναστατωμένος,0,0,4,4
17073,شركة,0,0,4,4
35378,event,0,0,4,4
46077,concerned,0,0,4,4
8284,rocks,0,0,4,4
46032,कैच,0,0,4,4
46080,şaşırtıcı,0,0,4,4
10872,ಬಯಸುವುದಿಲ್ಲ,0,0,4,4
17012,defining,0,0,4,4
17010,परिणाम,0,0,4,4
11133,az,0,0,4,4
27694,aprendizagem,0,0,4,4
29062,योगदान,0,0,4,4
4950,child,0,0,4,4
29059,espero,0,0,4,4
504,vandalismi,1,4,0,4
46163,vooral,0,0,4,4
39848,vaak,0,0,4,4
11068,usam,0,0,4,4
8109,gehoord,0,0,4,4
27538,сообщество,0,0,4,4
24577,ссылок,0,0,4,4
46158,underlättar,0,0,4,4
2675,totalmente,2,1,3,4
16955,univers,0,0,4,4
16943,άμαξα,0,0,4,4
31293,reunión,0,0,4,4
46172,ακούσει,0,0,4,4
44044,देना,0,0,4,4
45995,रखता,0,0,4,4
44041,أصدقائي,0,0,4,4
8091,nova,0,0,4,4
45993,olabilir,0,0,4,4
32315,σχέδια,0,0,4,4
1125,pulsante,1,4,0,4
1416,cinque,1,4,0,4
19776,enciclopédica,0,0,4,4
19777,طويل,0,0,4,4
29070,analyses,0,0,4,4
16929,working,0,0,4,4
17219,risk,0,0,4,4
24453,fluent,0,0,4,4
24573,levar,0,0,4,4
11125,തോന്നുന്നു,0,0,4,4
3435,rispetto,1,4,0,4
44075,mee,0,0,4,4
11069,dica,0,0,4,4
23275,yapabilirsin,0,0,4,4
44250,سياسات,0,0,4,4
38005,puissance,0,0,4,4
8315,inquiétez,0,0,4,4
1406,decisioni,1,4,0,4
17000,ordinateurs,0,0,4,4
31229,மகள்,0,0,4,4
46127,logical,0,0,4,4
16997,तीव्र,0,0,4,4
19568,ಎಲ್ಲವೂ,0,0,4,4
4164,جامعة,0,0,4,4
27559,ಕೆಲಸದಲ್ಲಿ,0,0,4,4
16986,san,0,0,4,4
19730,primeros,0,0,4,4
35420,cabo,0,0,4,4
2689,struttura,1,4,0,4
19736,تايمز,0,0,4,4
27551,பெற,0,0,4,4
37878,dios,0,0,4,4
34423,mantener,0,0,4,4
35414,"
पश्चिमी",0,0,4,4
46003,solución,0,0,4,4
35417,dort,0,0,4,4
11115,fingers,0,0,4,4
16969,जगह,0,0,4,4
8124,vardır,0,0,4,4
44060,emotions,0,0,4,4
11120,özellikle,0,0,4,4
37864,δεδομένων,0,0,4,4
19958,ಪ್ರಾರಂಭಿಸಿದಳು,0,0,4,4
11398,facts,0,0,4,4
46321,باللغة,0,0,4,4
19376,റൊട്ടി,0,0,4,4
34585,pop,0,0,4,4
4280,डाल,0,0,4,4
11728,τρία,0,0,4,4
16392,டெர்ரி,0,0,4,4
32519,तुम्हें,0,0,4,4
11722,channel,0,0,4,4
46496,нескольких,0,0,4,4
37557,passieren,0,0,4,4
45858,одно,0,0,4,4
23375,вандализм,0,0,4,4
40244,amplamente,0,0,4,4
44445,greater,0,0,4,4
35572,colaborativa,0,0,4,4
20168,дам,0,0,4,4
32523,الجد,0,0,4,4
46504,  articles,0,0,4,4
24327,ten,0,0,4,4
24893,ആംഗിൾ,0,0,4,4
10588,يبكي,0,0,4,4
17461,छोटे,0,0,4,4
29298,மொழிகளில்,0,0,4,4
17462,reasons,0,0,4,4
5393,elas,0,0,4,4
1077,inglesi,1,4,0,4
40267,χρησιμοποιείται,0,0,4,4
31029,materiais,0,0,4,4
10585,تذكر,0,0,4,4
37540,passed,0,0,4,4
17473,pardon,0,0,4,4
17474,dafür,0,0,4,4
11757,l’anthropologie,0,0,4,4
11709,descobriu,0,0,4,4
20165,வேல்ஸ்,0,0,4,4
45885,privacy,0,0,4,4
11654,மெதுவாக,0,0,4,4
265,pregiudizi,1,4,0,4
40210,occurs,0,0,4,4
8501,миллионов,0,0,4,4
10631,perdido,0,0,4,4
32491,fiabilidad,0,0,4,4
27288,nacht,0,0,4,4
10632,phusis,0,0,4,4
16414,تأخذ,0,0,4,4
32123,πράγματα,0,0,4,4
10640,dynamic,0,0,4,4
10642,frei,0,0,4,4
1935,ricercatori,1,4,0,4
11642,ರಾಕ್,0,0,4,4
44415,predictive,0,0,4,4
17421,cancer,0,0,4,4
38137,divine,0,0,4,4
7675,момент,0,0,4,4
43680,lyser,0,0,4,4
45874,planes,0,0,4,4
24342,يهم,0,0,4,4
46471,yet,0,0,4,4
31048,போமிஸ்,0,0,4,4
7668,места,0,0,4,4
28852,worries,0,0,4,4
39502,korkarım,0,0,4,4
20148,بالمائة,0,0,4,4
11698,sommige,0,0,4,4
28847,difference,0,0,4,4
22972,जिससे,0,0,4,4
2648,consulta,2,1,3,4
16418,cruzados,0,0,4,4
16363,версия,0,0,4,4
46518,ألا,0,0,4,4
43622,கவலையும்,0,0,4,4
40359,clifford,0,0,4,4
29345,scientifiques,0,0,4,4
22924,quadriga,0,0,4,4
16248,skribenter,0,0,4,4
20264,yanlış,0,0,4,4
46575,الصفحة,0,0,4,4
43542,άρχισε,0,0,4,4
22926,doctor,0,0,4,4
34591,dernier,0,0,4,4
37491,मिल,0,0,4,4
2412,dita,1,4,0,4
27179,друзья,0,0,4,4
19331,பிற,0,0,4,4
11861,dynamique,0,0,4,4
40341,dumps,0,0,4,4
45821,εκπληκτικό,0,0,4,4
24300,streek,0,0,4,4
7521,одним,0,0,4,4
46582,historique,0,0,4,4
35603,recentes,0,0,4,4
43529,المشروع,0,0,4,4
3197,redattore,1,4,0,4
10526,badstof,0,0,4,4
40379,கிட்டத்தட்ட,0,0,4,4
34118,uppslagsverk,0,0,4,4
16220,samme,0,0,4,4
27153,सकती,0,0,4,4
27850,ലേഖനങ്ങളുടെ,0,0,4,4
40387,—como,0,0,4,4
34114,tio,0,0,4,4
7503,estabas,0,0,4,4
5411,éventuellement,0,0,4,4
37499,pläne,0,0,4,4
30738,बदल,0,0,4,4
7551,gonna,0,0,4,4
19349,hear,0,0,4,4
7597,denke,0,0,4,4
4859,mayores,0,0,4,4
10570,copy,0,0,4,4
44464,progrès,0,0,4,4
16351,tussen,0,0,4,4
17480,буду,0,0,4,4
24316,создания,0,0,4,4
43605,ಅದ್ಭುತವಾಗಿದೆ,0,0,4,4
45842,frequentemente,0,0,4,4
3205,retrieval,2,1,3,4
3409,denota,2,1,3,4
32093,ferramenta,0,0,4,4
35588,actual,0,0,4,4
40304,давай,0,0,4,4
28829,предложений,0,0,4,4
24935,græde,0,0,4,4
11813,fel,0,0,4,4
32550,fact,0,0,4,4
3203,principi,1,4,0,4
10558,этой,0,0,4,4
43583,चरण,0,0,4,4
34150,لماذا,0,0,4,4
11823,исправлении,0,0,4,4
11826,dakika,0,0,4,4
46547,الذهب,0,0,4,4
16307,लिखे,0,0,4,4
3463,massa,2,1,3,4
8566,británica,0,0,4,4
19342,சொற்களை,0,0,4,4
5016,croyance,0,0,4,4
40177,nerede,0,0,4,4
31056,الأحيان,0,0,4,4
40015,nunca,0,0,4,4
32433,ಇದನ್ನು,0,0,4,4
35516,अनुमति,0,0,4,4
40058,ഭക്ഷണം,0,0,4,4
1922,quotidiana,1,4,0,4
20012,caching,0,0,4,4
7834,numerous,0,0,4,4
31105,kluges,0,0,4,4
27372,relève,0,0,4,4
16670,tyska,0,0,4,4
23056,venligt,0,0,4,4
38087,जिनमें,0,0,4,4
34291,bilgiler,0,0,4,4
32427,sucesso,0,0,4,4
23061,भाग्यशाली,0,0,4,4
46346,fast,0,0,4,4
7829,previous,0,0,4,4
24737,пользователей,0,0,4,4
11479,وتريد,0,0,4,4
40061,अप्रैल,0,0,4,4
19453,moon,0,0,4,4
17347,konnte,0,0,4,4
2396,soluzione,1,4,0,4
46372,existing,0,0,4,4
35524,botão,0,0,4,4
24741,സമയം,0,0,4,4
29205,பிடிக்கவில்லை,0,0,4,4
40067,estaré,0,0,4,4
31092,buluşma,0,0,4,4
7810,d’apprentissage,0,0,4,4
20032,परेशानी,0,0,4,4
7807,однажды,0,0,4,4
32440,يبدو,0,0,4,4
2227,nuove,1,4,0,4
11454,propio,0,0,4,4
20117,सहयोगी,0,0,4,4
2895,contributori,1,4,0,4
27750,örnek,0,0,4,4
24708,temel,0,0,4,4
3267,mitchell,2,3,1,4
37708,junto,0,0,4,4
467,complessità,1,4,0,4
17330,centaines,0,0,4,4
27404,dons,0,0,4,4
16672,настолько,0,0,4,4
10739,problemen,0,0,4,4
37712,غالبًا,0,0,4,4
8421,ചോദിക്കുന്നു,0,0,4,4
7886,متعبًا,0,0,4,4
1377,buon,2,3,1,4
11406,inanılmaz,0,0,4,4
27753,modificaciones,0,0,4,4
11430,lära,0,0,4,4
11432,birlikte,0,0,4,4
537,colto,1,4,0,4
7868,كانون,0,0,4,4
464,ragione,1,4,0,4
27391,कहना,0,0,4,4
44351,incluem,0,0,4,4
24382,universelle,0,0,4,4
19465,ആഗ്രഹിക്കുന്നുവെങ്കിൽ,0,0,4,4
19463,skönhet,0,0,4,4
40046,januar,0,0,4,4
2899,gruppo,1,4,0,4
19990,herzen,0,0,4,4
11447,ನೋಡುತ್ತೀರಿ,0,0,4,4
19461,فقد,0,0,4,4
11452,shows,0,0,4,4
11500,അത്ഭുതകരമായ,0,0,4,4
44368,behöver,0,0,4,4
11502,perto,0,0,4,4
43749,पॉलिश,0,0,4,4
16518,thing,0,0,4,4
32475,altına,0,0,4,4
31066,perguntas,0,0,4,4
16531,नार्सीसा,0,0,4,4
40143,biliyorsun,0,0,4,4
32135,duas,0,0,4,4
456,popolazione,1,4,0,4
34272,latter,0,0,4,4
11575,unutmayın,0,0,4,4
1459,diversi,1,4,0,4
11563,samarbete,0,0,4,4
37621,നല്ലത്,0,0,4,4
46421,நுபீடியா,0,0,4,4
1091,chiamato,1,4,0,4
7728,ναι,0,0,4,4
37607,fail,0,0,4,4
39531,kallas,0,0,4,4
11614,части,0,0,4,4
8485,alright,0,0,4,4
29258,effects,0,0,4,4
7721,إضافة,0,0,4,4
16506,ಹೇಳುತ್ತೀರಿ,0,0,4,4
7719,വർഷം,0,0,4,4
46444,away,0,0,4,4
20106,toe,0,0,4,4
34226,إجراؤها,0,0,4,4
37601,amanhã,0,0,4,4
2364,offline,2,1,3,4
46448,حد,0,0,4,4
39529,رؤية,0,0,4,4
4876,हुई,0,0,4,4
43763,inga,0,0,4,4
16573,ahead,0,0,4,4
2400,feedback,2,1,3,4
31340,clara,0,0,4,4
37652,tipp,0,0,4,4
32153,parle,0,0,4,4
32152,celles,0,0,4,4
31087,domains,0,0,4,4
39557,قواعد,0,0,4,4
29219,button,0,0,4,4
46393,fit,0,0,4,4
23033,correspond,0,0,4,4
43791,engelsk,0,0,4,4
40094,hemen,0,0,4,4
20051,sıra,0,0,4,4
24763,espacio,0,0,4,4
16617,nederlands,0,0,4,4
4243,τελευταία,0,0,4,4
24771,mensaje,0,0,4,4
24783,الزاوية,0,0,4,4
43782,främst,0,0,4,4
11526,съесть,0,0,4,4
39552,€,0,0,4,4
46405,digital,0,0,4,4
32147,соответствии,0,0,4,4
551,critica,1,4,0,4
7769,toch,0,0,4,4
3226,marzo,2,2,2,4
43775,équivalent,0,0,4,4
7765,misstag,0,0,4,4
29231,interprétation,0,0,4,4
16587,verpest,0,0,4,4
44389,hålla,0,0,4,4
16584,tron,0,0,4,4
40915,проблем,0,0,4,4
17124,bekymre,0,0,4,4
44760,natürlich,0,0,4,4
36565,hablar,0,0,4,4
30041,hola,0,0,4,4
36574,ouvir,0,0,4,4
33192,realidade,0,0,4,4
9732,قاموس,0,0,4,4
41459,الإنجليزية،,0,0,4,4
33194,sonu,0,0,4,4
25711,happy,0,0,4,4
30487,éxito,0,0,4,4
763,usati,1,4,0,4
28254,incluir,0,0,4,4
31785,desculpas,0,0,4,4
18256,dicha,0,0,4,4
331,futura,2,2,2,4
23939,νομίζω,0,0,4,4
18261,أوه,0,0,4,4
13724,அவை,0,0,4,4
9209,multiples,0,0,4,4
9716,சரளமாக,0,0,4,4
4638,лет,0,0,4,4
891,precisa,2,1,3,4
14703,radiation,0,0,4,4
33602,fluide,0,0,4,4
3107,darò,1,4,0,4
30475,niveaux,0,0,4,4
28512,guapo,0,0,4,4
14689,σαββατοκύριακο,0,0,4,4
13618,akşam,0,0,4,4
6118,насчет,0,0,4,4
2789,semplicemente,1,4,0,4
25732,परिवर्तन,0,0,4,4
9734,haut,0,0,4,4
36064,hellre,0,0,4,4
47556,hein,0,0,4,4
21554,trabaja,0,0,4,4
45023,recommendation,0,0,4,4
23957,كبيرة,0,0,4,4
38948,fungi,0,0,4,4
2539,versioni,1,4,0,4
18228,gekommen,0,0,4,4
756,statistici,1,4,0,4
42332,prijs,0,0,4,4
33176,extension,0,0,4,4
13528,ಅಲ್ಲಿ,0,0,4,4
22288,παρακαλώ,0,0,4,4
41440,næsten,0,0,4,4
13532,правила,0,0,4,4
13533,annually,0,0,4,4
45419,travaux,0,0,4,4
31592,peine,0,0,4,4
22283,farklı,0,0,4,4
759,potresti,1,4,0,4
14758,plads,0,0,4,4
371,devono,1,4,0,4
30498,relacionado,0,0,4,4
761,latine,2,1,3,4
3549,vocale,2,3,1,4
42314,médias,0,0,4,4
42313,तैयार,0,0,4,4
45412,लग,0,0,4,4
28246,nenhum,0,0,4,4
4641,gott,0,0,4,4
47553,bother,0,0,4,4
3971,gud,0,0,4,4
45060,fantastisch,0,0,4,4
3029,hardware,2,2,2,4
46,li,2,2,2,4
47621,olacağım,0,0,4,4
36093,respeito,0,0,4,4
14623,scientifique,0,0,4,4
6059,बेहद,0,0,4,4
30085,sålde,0,0,4,4
26233,enstaka,0,0,4,4
3982,lektioner,0,0,4,4
25769,spijt,0,0,4,4
28279,രാത്രി,0,0,4,4
34874,værd,0,0,4,4
47630,bonito,0,0,4,4
21650,mudança,0,0,4,4
6047,مصادر,0,0,4,4
33569,எதையாவது,0,0,4,4
38899,atualmente,0,0,4,4
33566,τυχερός,0,0,4,4
9252,വന്നു,0,0,4,4
884,dataset,2,2,2,4
30097,technologie,0,0,4,4
6038,वाणिज्यिक,0,0,4,4
26220,இதை,0,0,4,4
30099,പ്രധാന,0,0,4,4
1600,vero,1,4,0,4
18690,jonathan,0,0,4,4
28287,políticos,0,0,4,4
22219,ongeveer,0,0,4,4
33563,planos,0,0,4,4
42180,aide,0,0,4,4
30443,पुरस्कार,0,0,4,4
13723,incident,0,0,4,4
4503,freund,0,0,4,4
5107,உணவு,0,0,4,4
30472,mår,0,0,4,4
47620,magnifique,0,0,4,4
9710,ಮಾಡಬಹುದು,0,0,4,4
28263,distinction,0,0,4,4
4633,court,0,0,4,4
36547,unten,0,0,4,4
36544,attempt,0,0,4,4
1593,modi,1,4,0,4
2787,pranzo,1,4,0,4
30470,الغرق,0,0,4,4
26256,reinvestment,0,0,4,4
18731,erhalten,0,0,4,4
18730,ಹೆದರುತ್ತೇನೆ,0,0,4,4
30467,ഗുരുതരമായ,0,0,4,4
6095,फर्क,0,0,4,4
13646,style,0,0,4,4
18278,digo,0,0,4,4
5103,minuten,0,0,4,4
18722,typ,0,0,4,4
774,alcun,1,4,0,4
31615,نعم,0,0,4,4
3099,messaggio,1,4,0,4
6080,problemática,0,0,4,4
6077,indicate,0,0,4,4
41,diventare,1,4,0,4
33232,verkocht,0,0,4,4
23711,செய்யப்பட்ட,0,0,4,4
13677,översvämmad,0,0,4,4
22238,ним,0,0,4,4
28278,entendu,0,0,4,4
5592,erreur,0,0,4,4
36608,considéré,0,0,4,4
2794,overfitting,2,1,3,4
33170,कितना,0,0,4,4
18847,såg,0,0,4,4
71,fammi,1,4,0,4
29948,материалы,0,0,4,4
14934,büyük,0,0,4,4
41321,legais,0,0,4,4
13337,sägs,0,0,4,4
9857,ait,0,0,4,4
38525,слишком,0,0,4,4
47427,actually,0,0,4,4
30553,populares,0,0,4,4
36000,told,0,0,4,4
14929,प्रविष्टि,0,0,4,4
69,visualeditor,2,1,3,4
379,domani,1,4,0,4
36001,देखते,0,0,4,4
34821,prize,0,0,4,4
6328,begrepp,0,0,4,4
18830,பார்க்கிறேன்,0,0,4,4
9119,caa,0,0,4,4
21403,insider,0,0,4,4
22356,للحصول,0,0,4,4
36694,tomorrow,0,0,4,4
29958,sikkert,0,0,4,4
3536,formale,1,4,0,4
41338,अलगअलग,0,0,4,4
31826,connected,0,0,4,4
47446,повторить,0,0,4,4
36684,ಬಳಸುವ,0,0,4,4
41340,independent,0,0,4,4
25633,afable,0,0,4,4
9106,ಮಗಳು,0,0,4,4
6352,λυπάμαι,0,0,4,4
13377,graag,0,0,4,4
41319,тупой,0,0,4,4
25602,handsome,0,0,4,4
25605,bättre,0,0,4,4
21360,citando,0,0,4,4
21361,stable,0,0,4,4
21362,ind,0,0,4,4
25606,barn,0,0,4,4
14962,présenter,0,0,4,4
6378,code,0,0,4,4
47406,exemplos,0,0,4,4
47407,wikileaks,0,0,4,4
13301,போகிறீர்கள்,0,0,4,4
9871,komme,0,0,4,4
38514,kvar,0,0,4,4
13306,वेबसाइट,0,0,4,4
5560,एनसाइक्लोपीडिया,0,0,4,4
41305,peer,0,0,4,4
18129,igång,0,0,4,4
45473,inklusive,0,0,4,4
13313,reality,0,0,4,4
24002,avance,0,0,4,4
28566,يقرب,0,0,4,4
23999,लगा,0,0,4,4
2297,stava,1,4,0,4
23998,برنامج,0,0,4,4
23642,estadounidenses,0,0,4,4
6358,இரவு,0,0,4,4
13327,permitir,0,0,4,4
21383,derechos,0,0,4,4
26420,एकमात्र,0,0,4,4
13375,vilka,0,0,4,4
13378,той,0,0,4,4
41422,unless,0,0,4,4
47492,apportées,0,0,4,4
13450,mesure,0,0,4,4
21470,चीज,0,0,4,4
38550,பார்க்க,0,0,4,4
26352,உள்ளன,0,0,4,4
33164,июня,0,0,4,4
37031,organizações,0,0,4,4
9793,முறையில்,0,0,4,4
18795,constituye,0,0,4,4
14813,beyond,0,0,4,4
36032,ديسمبر,0,0,4,4
31581,البيانات,0,0,4,4
6231,bureau,0,0,4,4
5173,allowed,0,0,4,4
36625,زر,0,0,4,4
25684,ವೀಡಿಯೊದಲ್ಲಿ,0,0,4,4
18781,mu,0,0,4,4
42356,studien,0,0,4,4
47514,вместе,0,0,4,4
42355,मान्यता,0,0,4,4
3020,sì,1,4,0,4
14793,polaco,0,0,4,4
9167,സ്വാഗതം,0,0,4,4
1670,consultazione,1,4,0,4
6216,المزيد,0,0,4,4
28539,позвольте,0,0,4,4
47518,gute,0,0,4,4
5572,beck,0,0,4,4
33631,ataques,0,0,4,4
9171,gråta,0,0,4,4
14832,محمل,0,0,4,4
28549,dur,0,0,4,4
36010,back,0,0,4,4
9798,propos,0,0,4,4
18159,बैठक,0,0,4,4
22344,tend,0,0,4,4
41348,razón,0,0,4,4
9828,версии,0,0,4,4
42435,γίνεται,0,0,4,4
13389,glas,0,0,4,4
47461,propia,0,0,4,4
23987,اعتبارًا,0,0,4,4
21433,चलो,0,0,4,4
21434,één,0,0,4,4
18821,motores,0,0,4,4
3658,nuovi,1,4,0,4
42429,mujeres,0,0,4,4
21441,kullanıcılar,0,0,4,4
26383,ήμουν,0,0,4,4
28210,seconde,0,0,4,4
47472,¿no,0,0,4,4
14879,गई,0,0,4,4
30533,intervju,0,0,4,4
6272,jaar,0,0,4,4
29984,فيه,0,0,4,4
35081,दैनिक,0,0,4,4
33150,aumentar,0,0,4,4
26367,यकीन,0,0,4,4
42401,former,0,0,4,4
18808,ό,0,0,4,4
375,basa,2,2,2,4
4473,region,0,0,4,4
47489,paar,0,0,4,4
47648,sådan,0,0,4,4
18306,दृष्टिकोण,0,0,4,4
31840,συμβαίνει,0,0,4,4
18552,сми,0,0,4,4
45193,tam,0,0,4,4
47817,kwamen,0,0,4,4
14320,game,0,0,4,4
344,consiglio,1,4,0,4
18435,ली,0,0,4,4
30228,لدى,0,0,4,4
28363,audience,0,0,4,4
5636,महत्वपूर्ण,0,0,4,4
21913,functions,0,0,4,4
28424,passer,0,0,4,4
45200,vloeiend,0,0,4,4
1646,eravamo,1,4,0,4
5765,désigner,0,0,4,4
30339,först,0,0,4,4
9389,новые,0,0,4,4
22216,института,0,0,4,4
26063,tamamen,0,0,4,4
21921,diverses,0,0,4,4
14034,различные,0,0,4,4
26058,проект,0,0,4,4
14293,venlig,0,0,4,4
18549,particularly,0,0,4,4
30243,välja,0,0,4,4
33363,myspace,0,0,4,4
2059,genere,2,1,3,4
21939,senden,0,0,4,4
2511,matrimonio,2,2,2,4
28419,försökt,0,0,4,4
41944,pântano,0,0,4,4
25940,album,0,0,4,4
36337,focuses,0,0,4,4
18563,riquezas,0,0,4,4
5789,vaut,0,0,4,4
2081,induttiva,1,4,0,4
38827,walsh,0,0,4,4
28441,poor,0,0,4,4
36366,இருந்தார்கள்,0,0,4,4
26103,mío,0,0,4,4
18413,بشأن,0,0,4,4
45294,multiple,0,0,4,4
21866,planet,0,0,4,4
18579,tegen,0,0,4,4
36360,നമുക്ക്,0,0,4,4
21871,translation,0,0,4,4
14370,умных,0,0,4,4
25899,hope,0,0,4,4
4546,åka,0,0,4,4
30358,بذلك,0,0,4,4
41999,ಸಾಧ್ಯವಾಗಲಿಲ್ಲ,0,0,4,4
14354,प्रक्रिया,0,0,4,4
41732,neem,0,0,4,4
33476,φρικτό,0,0,4,4
45185,самым,0,0,4,4
26090,sabor,0,0,4,4
33473,¿puedo,0,0,4,4
41739,argent,0,0,4,4
23787,ಹೌದು,0,0,4,4
33471,took,0,0,4,4
34985,förklarar,0,0,4,4
13992,беспокойтесь,0,0,4,4
1266,andiamo,1,4,0,4
9518,ಭಾವಿಸುತ್ತೇನೆ,0,0,4,4
23791,classifier,0,0,4,4
5641,ಇಂಗ್ಲಿಷ್,0,0,4,4
47848,industrial,0,0,4,4
30328,مركز,0,0,4,4
34969,ней,0,0,4,4
21985,όμορφη,0,0,4,4
5692,preocupada,0,0,4,4
2508,utilizza,1,4,0,4
33420,daglige,0,0,4,4
33387,vermasselt,0,0,4,4
21989,всем,0,0,4,4
2070,nica,2,1,3,4
38781,quoted,0,0,4,4
14120,ceci,0,0,4,4
14122,contributed,0,0,4,4
38776,हाल,0,0,4,4
23831,présente,0,0,4,4
22051,स्वतंत्र,0,0,4,4
47894,font,0,0,4,4
36231,fantastiska,0,0,4,4
36264,μπορούσες,0,0,4,4
26011,vanligt,0,0,4,4
41885,التعديلات,0,0,4,4
41855,चुके,0,0,4,4
14177,noticias,0,0,4,4
47901,статью,0,0,4,4
33395,indicated,0,0,4,4
9443,pesar,0,0,4,4
14171,madde,0,0,4,4
30290,மில்லியன்,0,0,4,4
36238,इसमें,0,0,4,4
5651,überflutet,0,0,4,4
22037,سانجر,0,0,4,4
33397,hypothesis,0,0,4,4
30312,أعرف,0,0,4,4
14217,läsare,0,0,4,4
21945,согласно,0,0,4,4
1642,soft,1,4,0,4
33367,creo,0,0,4,4
5732,самом,0,0,4,4
31710,advance,0,0,4,4
45210,وتيري,0,0,4,4
47852,ಇಂದು,0,0,4,4
36303,bis,0,0,4,4
28416,каждый,0,0,4,4
9486,τίποτα,0,0,4,4
33438,фонд,0,0,4,4
9485,συνομιλία,0,0,4,4
14076,തന്റെ,0,0,4,4
835,dirlo,1,4,0,4
36296,statut,0,0,4,4
47863,extremamente,0,0,4,4
34931,responsible,0,0,4,4
34975,tonto,0,0,4,4
41811,ടെറിയും,0,0,4,4
9477,democrática,0,0,4,4
38795,imod,0,0,4,4
9473,répondre,0,0,4,4
5141,நாம்,0,0,4,4
23808,regional,0,0,4,4
18470,وجهة,0,0,4,4
9418,आसान,0,0,4,4
38782,llegó,0,0,4,4
31702,signification,0,0,4,4
41904,egal,0,0,4,4
21978,धाराप्रवाह,0,0,4,4
38739,resolução,0,0,4,4
13948,clasificación,0,0,4,4
18406,делает,0,0,4,4
25889,keinen,0,0,4,4
38648,όλοι,0,0,4,4
4614,поддерживает,0,0,4,4
18337,hermosa,0,0,4,4
1657,abstract,2,2,2,4
47688,होते,0,0,4,4
18343,position,0,0,4,4
18650,diyebilirsiniz,0,0,4,4
36130,stomverbaasd,0,0,4,4
33278,सुना,0,0,4,4
30418,favorita,0,0,4,4
42127,verb,0,0,4,4
23746,பயப்படுகிறேன்,0,0,4,4
22174,अक्टूबर,0,0,4,4
41606,verkauft,0,0,4,4
9298,rejse,0,0,4,4
45129,بسبب,0,0,4,4
23751,présence,0,0,4,4
36441,près,0,0,4,4
25821,correspondant,0,0,4,4
41621,welke,0,0,4,4
45326,அதற்கு,0,0,4,4
13821,ami,0,0,4,4
13822,நேரங்களில்,0,0,4,4
41626,spanish,0,0,4,4
14496,zones,0,0,4,4
13835,stompe,0,0,4,4
3090,possibili,1,4,0,4
38855,soort,0,0,4,4
1654,compito,1,4,0,4
1651,ragazzo,1,4,0,4
18335,outubro,0,0,4,4
5978,статьях,0,0,4,4
21765,telegram,0,0,4,4
30425,favorit,0,0,4,4
28290,ലേഖനങ്ങളെ,0,0,4,4
31763,brödet,0,0,4,4
21671,diaria,0,0,4,4
13728,laissezmoi,0,0,4,4
47655,especificamente,0,0,4,4
3628,provenienti,1,4,0,4
45359,لأنني,0,0,4,4
22213,gjordes,0,0,4,4
13734,nedan,0,0,4,4
35027,पाठ्य,0,0,4,4
6009,redigering,0,0,4,4
9640,visitas,0,0,4,4
25790,verbe,0,0,4,4
41570,التغييرات,0,0,4,4
41571,verlegenheit,0,0,4,4
41574,possibles,0,0,4,4
18677,nuevas,0,0,4,4
36478,falando,0,0,4,4
36477,إزالة,0,0,4,4
33550,plates,0,0,4,4
47672,πήρα,0,0,4,4
31632,highly,0,0,4,4
18330,coming,0,0,4,4
2756,arte,2,2,2,4
31753,πάει,0,0,4,4
34881,العربة,0,0,4,4
22191,βρίσκεστε,0,0,4,4
13773,मूर्खतापूर्ण,0,0,4,4
18332,solid,0,0,4,4
3994,получила,0,0,4,4
30154,carlos,0,0,4,4
41707,japanese,0,0,4,4
47753,gingen,0,0,4,4
42047,നിങ്ങൾക്കറിയാം,0,0,4,4
4541,ecological,0,0,4,4
47756,ഞാൻ‌,0,0,4,4
806,facilmente,2,2,2,4
33313,réponse,0,0,4,4
18607,வார,0,0,4,4
14406,ಪದವು,0,0,4,4
41694,προτάσεις,0,0,4,4
21824,фразы,0,0,4,4
13921,поводу,0,0,4,4
33490,trovärdighet,0,0,4,4
36390,trabajar,0,0,4,4
42036,arts,0,0,4,4
33320,நர்சிஸஸ்,0,0,4,4
5856,pratique,0,0,4,4
14400,nächste,0,0,4,4
28340,méthodes,0,0,4,4
38834,ശേഷം,0,0,4,4
21837,ans,0,0,4,4
15,falso,2,3,1,4
5850,mann,0,0,4,4
18399,publicidad,0,0,4,4
18400,ராக்,0,0,4,4
9555,caractéristiques,0,0,4,4
36372,länkar,0,0,4,4
26115,possibly,0,0,4,4
9549,entendí,0,0,4,4
38828,side,0,0,4,4
5840,боюсь,0,0,4,4
5876,références,0,0,4,4
45156,moral,0,0,4,4
23,filosofia,2,2,2,4
30383,रखने,0,0,4,4
9596,gender,0,0,4,4
25838,killar,0,0,4,4
36429,உண்மையில்,0,0,4,4
13850,inmiddels,0,0,4,4
1288,biblioteca,2,1,3,4
9588,வருத்தப்பட,0,0,4,4
5912,mistake,0,0,4,4
4605,movement,0,0,4,4
33513,initiative,0,0,4,4
1261,cell,2,1,3,4
23757,huge,0,0,4,4
41663,أقل,0,0,4,4
28330,raised,0,0,4,4
5901,anderer,0,0,4,4
35007,pelos,0,0,4,4
9579,phone,0,0,4,4
13881,άρεσε,0,0,4,4
47738,partido,0,0,4,4
5896,brandchannelcom,0,0,4,4
2491,definizione,1,4,0,4
360,basata,1,4,0,4
31737,labor,0,0,4,4
14431,medios,0,0,4,4
25868,другом,0,0,4,4
34907,period,0,0,4,4
14421,plaît,0,0,4,4
36404,всё,0,0,4,4
42053,weten,0,0,4,4
13901,laatste,0,0,4,4
9088,skrivandet,0,0,4,4
34839,कभीकभी,0,0,4,4
28572,diferente,0,0,4,4
22453,cambio,0,0,4,4
31513,сказал,0,0,4,4
33757,neredeyse,0,0,4,4
34750,flydende,0,0,4,4
311,evitando,2,1,3,4
3707,cuore,1,4,0,4
13091,प्यार,0,0,4,4
39078,américaine,0,0,4,4
36841,ting,0,0,4,4
25498,zusammen,0,0,4,4
15173,जर्मन,0,0,4,4
47140,komt,0,0,4,4
28608,allez,0,0,4,4
38469,aspect,0,0,4,4
22452,vrij,0,0,4,4
21207,evet,0,0,4,4
6550,σημασία,0,0,4,4
35158,imagem,0,0,4,4
40974,senaste,0,0,4,4
29857,फिक्स,0,0,4,4
39160,wütend,0,0,4,4
39076,acontecendo,0,0,4,4
13103,haft,0,0,4,4
47275,ambos,0,0,4,4
45528,navn,0,0,4,4
31537,läser,0,0,4,4
3327,vedi,1,4,0,4
28647,чего,0,0,4,4
35883,programmed,0,0,4,4
25392,hoje,0,0,4,4
39085,cc,0,0,4,4
47149,ofte,0,0,4,4
17937,continuous,0,0,4,4
3686,nata,1,4,0,4
39084,உள்ளது,0,0,4,4
10071,உதவ,0,0,4,4
8927,ഇതുവരെ,0,0,4,4
42669,значения,0,0,4,4
23605,primeiro,0,0,4,4
12850,करे,0,0,4,4
24048,vendiste,0,0,4,4
25480,deseja,0,0,4,4
42830,« le,0,0,4,4
39081,vapor,0,0,4,4
39080,schoonheid,0,0,4,4
45531,primera,0,0,4,4
28610,там,0,0,4,4
5543,enlightenment,0,0,4,4
13080,grec,0,0,4,4
30618,allmänhet,0,0,4,4
26677,slashdot,0,0,4,4
21213,تقوله,0,0,4,4
4734,среди,0,0,4,4
4684,franco,0,0,4,4
1215,arthur,2,2,2,4
22436,deu,0,0,4,4
8912,helpen,0,0,4,4
41169,creation,0,0,4,4
8911,பொதுவான,0,0,4,4
41174,vaya,0,0,4,4
19021,aparecen,0,0,4,4
35869,ange,0,0,4,4
30604,وظيفة,0,0,4,4
36806,heures,0,0,4,4
24096,आम,0,0,4,4
36981,réalise,0,0,4,4
38400,ടെക്സ്റ്റ്,0,0,4,4
41177,ഭയപ്പെടുന്നു,0,0,4,4
17911,quickly,0,0,4,4
44903,paul,0,0,4,4
15127,perçue,0,0,4,4
40957,hetzelfde,0,0,4,4
18905,प्रारंभिक,0,0,4,4
937,indica,2,1,3,4
3710,articolo,1,4,0,4
42628,терренс,0,0,4,4
28143,بخير,0,0,4,4
42633,propios,0,0,4,4
13120,όμορφος,0,0,4,4
29749,أظهرت,0,0,4,4
15402,συνάντηση,0,0,4,4
36830,sommes,0,0,4,4
33836,नशीली,0,0,4,4
13108,plannen,0,0,4,4
4729,времени,0,0,4,4
12815,finalidad,0,0,4,4
5545,chorando,0,0,4,4
6537,prosa,0,0,4,4
9948,guess,0,0,4,4
28602,rond,0,0,4,4
47297,namnet,0,0,4,4
42638,ouverte,0,0,4,4
41159,ಬಟನ್,0,0,4,4
40967,videre,0,0,4,4
29743,المنفرجة,0,0,4,4
13117,citation,0,0,4,4
12812,båda,0,0,4,4
691,derivati,1,4,0,4
6529,distinguished,0,0,4,4
15153,المقالة,0,0,4,4
42822,वाक्यांशों,0,0,4,4
3935,avis,0,0,4,4
35113,içindeyim,0,0,4,4
47179,människor,0,0,4,4
5061,அன்பே,0,0,4,4
8951,gidiyor,0,0,4,4
28638,eux,0,0,4,4
3698,stessi,1,4,0,4
28102,homem,0,0,4,4
47182,liebe,0,0,4,4
26641,फ्लोरिडा,0,0,4,4
41028,appelée,0,0,4,4
38424,точки,0,0,4,4
26616,files,0,0,4,4
10015,debate,0,0,4,4
4423,demain,0,0,4,4
8973,reviews,0,0,4,4
32963,над,0,0,4,4
4709,key,0,0,4,4
10011,treffen,0,0,4,4
25411,spel,0,0,4,4
47225,direito,0,0,4,4
28640,speech,0,0,4,4
12894,degrees,0,0,4,4
31891,आमतौर,0,0,4,4
3137,uomo,1,4,0,4
17958,protocole,0,0,4,4
4713,بالتأكيد,0,0,4,4
18030,angry,0,0,4,4
28092,வண்டியில்,0,0,4,4
4718,ഹേയ്,0,0,4,4
4716,языке,0,0,4,4
26631,совершенно,0,0,4,4
32971,adelante,0,0,4,4
36903,measured,0,0,4,4
12940,orientação,0,0,4,4
1218,ripeterlo,1,4,0,4
47193,"
विकिपीडिया",0,0,4,4
960,positivo,2,1,3,4
42761,സ്വതന്ത്ര,0,0,4,4
21105,sentido,0,0,4,4
28085,creada,0,0,4,4
12945,острый,0,0,4,4
42772,habitat,0,0,4,4
36911,чегото,0,0,4,4
42758,internacional,0,0,4,4
15299,lawrence,0,0,4,4
32968,classique,0,0,4,4
21112,automática,0,0,4,4
34764,ब्रिटेन,0,0,4,4
39126,fsf,0,0,4,4
21115,natuurlijk,0,0,4,4
30685,بأن,0,0,4,4
15276,adam,0,0,4,4
42733,diversas,0,0,4,4
47160,ಮಾಡುವ,0,0,4,4
6716,bleek,0,0,4,4
3150,dello,1,4,0,4
13021,редакторов,0,0,4,4
5070,stilig,0,0,4,4
34753,கணம்,0,0,4,4
21056,geweldige,0,0,4,4
33775,istemek,0,0,4,4
44871,heard,0,0,4,4
3323,tradizionali,1,4,0,4
22520,ತಿನ್ನಲು,0,0,4,4
2982,approcci,1,4,0,4
44856,course,0,0,4,4
15215,vertel,0,0,4,4
10063,होना,0,0,4,4
42683,langsam,0,0,4,4
5541,disagreement,0,0,4,4
6729,κουμπί,0,0,4,4
39151,algum,0,0,4,4
47156,हिस्सा,0,0,4,4
17938,فأنت,0,0,4,4
33770,энциклопедией,0,0,4,4
13051,dessas,0,0,4,4
26586,espere,0,0,4,4
15350,pm,0,0,4,4
21154,sharp,0,0,4,4
17953,anterior,0,0,4,4
709,multilingue,2,1,3,4
8980,protect,0,0,4,4
1551,p,2,2,2,4
15334,lío,0,0,4,4
28116,बाहर,0,0,4,4
41080,big,0,0,4,4
39110,vrije,0,0,4,4
21142,அவர்களிடம்,0,0,4,4
3146,sentito,1,4,0,4
21144,activamente,0,0,4,4
1577,andrea,2,1,3,4
39109,البرنامج,0,0,4,4
42713,मुलाकात,0,0,4,4
25451,expérience,0,0,4,4
305,fortuna,2,2,2,4
42798,värt,0,0,4,4
42800,fram,0,0,4,4
9992,जारी,0,0,4,4
6613,oktober,0,0,4,4
17954,ആരംഭിച്ചു,0,0,4,4
2573,proposta,2,3,1,4
21256,प्रारंभ,0,0,4,4
3131,mantiene,2,1,3,4
15122,encontrados,0,0,4,4
13203,snällt,0,0,4,4
24025,gespräch,0,0,4,4
3713,ecc,1,4,0,4
9059,members,0,0,4,4
9900,aberto,0,0,4,4
38501,vacker,0,0,4,4
9911,doe,0,0,4,4
6465,correction,0,0,4,4
12764,المرتبة,0,0,4,4
15062,überfüllt,0,0,4,4
36776,civil,0,0,4,4
36775,consejo,0,0,4,4
17883,വാക്യം,0,0,4,4
47095,writers,0,0,4,4
40929,långsamt,0,0,4,4
2556,cima,2,1,3,4
30728,भाषाओं,0,0,4,4
21293,kelimenin,0,0,4,4
13196,pedidos,0,0,4,4
37016,arg,0,0,4,4
18079,verstaan,0,0,4,4
15476,enig,0,0,4,4
15079,traffic,0,0,4,4
12768,ചെറിയ,0,0,4,4
6414,situations,0,0,4,4
47099,завтра,0,0,4,4
3004,primi,1,4,0,4
39034,ничего,0,0,4,4
22392,studies,0,0,4,4
44918,genoemd,0,0,4,4
31499,d’autres,0,0,4,4
24021,текст,0,0,4,4
10121,novas,0,0,4,4
47385,ερώτηση,0,0,4,4
34801,realize,0,0,4,4
35856,açı,0,0,4,4
385,sugli,1,4,0,4
26467,लिए।,0,0,4,4
42547,ana,0,0,4,4
9061,obvious,0,0,4,4
34795,تمانع,0,0,4,4
21296,significantly,0,0,4,4
44929,ansiklopedisi,0,0,4,4
22569,первой,0,0,4,4
402,differenti,1,4,0,4
21308,ஜனவரி,0,0,4,4
36762,स्रोतों,0,0,4,4
925,apprendere,1,4,0,4
12744,comparando,0,0,4,4
8890,focused,0,0,4,4
33706,zelf,0,0,4,4
22404,говоря,0,0,4,4
29717,सम्बन्धी,0,0,4,4
47371,médio,0,0,4,4
26476,nehmen,0,0,4,4
30574,गलती,0,0,4,4
8888,fazendo,0,0,4,4
9903,मिलने,0,0,4,4
28667,विश्वसनीयता,0,0,4,4
42896,कौन,0,0,4,4
20959,كبير,0,0,4,4
41245,wwwwikipediacom,0,0,4,4
18085,बनाने,0,0,4,4
9070,sorun,0,0,4,4
25346,texte,0,0,4,4
21297,identify,0,0,4,4
12753,processing,0,0,4,4
13208,lenguas,0,0,4,4
28581,julio,0,0,4,4
15055,sofisticado,0,0,4,4
41252,kijken,0,0,4,4
15039,processos,0,0,4,4
30573,soimême,0,0,4,4
24031,έναν,0,0,4,4
22403,redes,0,0,4,4
20962,«википедии»,0,0,4,4
20961,दिल,0,0,4,4
35106,answer,0,0,4,4
5505,जिसके,0,0,4,4
38493,σίγουρα,0,0,4,4
29917,hoy,0,0,4,4
21350,कैसा,0,0,4,4
25531,रखते,0,0,4,4
6839,englisch,0,0,4,4
18105,cofounder,0,0,4,4
42876,activités,0,0,4,4
21264,функционирование,0,0,4,4
20939,इतिहास,0,0,4,4
26449,ужасное,0,0,4,4
36737,दस,0,0,4,4
6403,letzte,0,0,4,4
23636,viele,0,0,4,4
6401,lentement,0,0,4,4
1566,allo,1,4,0,4
17868,domesday,0,0,4,4
41278,തുടങ്ങി,0,0,4,4
26460,devenue,0,0,4,4
10103,വഴി,0,0,4,4
26693,ಹೋಗಬೇಕು,0,0,4,4
33689,औपचारिक,0,0,4,4
30716,முதலில்,0,0,4,4
12732,reçu,0,0,4,4
47109,изза,0,0,4,4
35169,flytande,0,0,4,4
42869,ൽ,0,0,4,4
42865,mission,0,0,4,4
18898,champ,0,0,4,4
2153,fortunato,1,4,0,4
36791,நினைக்கிறேன்,0,0,4,4
4746,udgivet,0,0,4,4
1840,difficoltà,1,4,0,4
24014,потрясающе,0,0,4,4
30569,الثانية,0,0,4,4
79,suffisso,1,4,0,4
40936,भिन्न,0,0,4,4
35962,besoin,0,0,4,4
45508,ребята,0,0,4,4
26689,وغير,0,0,4,4
918,amministratori,1,4,0,4
35982,கடந்து,0,0,4,4
42530,أعلم,0,0,4,4
37019,comments,0,0,4,4
24105,substantially,0,0,4,4
25586,simonite,0,0,4,4
10119,skicka,0,0,4,4
25532,initiatives,0,0,4,4
1881,wikispecies,2,1,2,3
17306,déclare,0,0,3,3
17955,darte,0,0,3,3
32228,गुप्त,0,0,3,3
17758,ran,0,0,3,3
1855,siete,2,2,1,3
4025,tänka,0,0,3,3
44305,utvecklas,0,0,3,3
39207,три,0,0,3,3
18357,பணிகள்,0,0,3,3
24184,mitten,0,0,3,3
9574,ಮಾಡುವುದು,0,0,3,3
10798,grillini,0,0,3,3
9440,penge,0,0,3,3
44220,fournir,0,0,3,3
34909,νέα,0,0,3,3
39299,πηγαίνετε,0,0,3,3
17734,narcisses,0,0,3,3
31735,realm,0,0,3,3
39601,nimm,0,0,3,3
34910,maddesi,0,0,3,3
17853,manning,0,0,3,3
34692,money,0,0,3,3
32187,يقدم,0,0,3,3
17866,lokalt,0,0,3,3
38760,जाम,0,0,3,3
34515,أيضا,0,0,3,3
10143,समान,0,0,3,3
10156,estes,0,0,3,3
34948,जिम्मी,0,0,3,3
39599,uden,0,0,3,3
27731,tvärtom,0,0,3,3
24185,planeta,0,0,3,3
24500,nphard,0,0,3,3
2317,comitato,1,3,0,3
39202,ortega,0,0,3,3
24411,എത്ര,0,0,3,3
18489,escuchando,0,0,3,3
18491,വിക്കിമീഡിയ,0,0,3,3
5122,योग्य,0,0,3,3
24130,स्वीकार,0,0,3,3
10783,संस्कृति,0,0,3,3
17745,большой,0,0,3,3
10769,assigned,0,0,3,3
2313,alcuna,1,3,0,3
27728,baseada,0,0,3,3
18496,किए,0,0,3,3
18370,kleine,0,0,3,3
44207,कवरेज़,0,0,3,3
18381,список,0,0,3,3
18375,बेच,0,0,3,3
9445,cumartesi,0,0,3,3
10051,передать,0,0,3,3
9587,dedicados,0,0,3,3
17146,istiyorsan,0,0,3,3
44203,hyperlinks,0,0,3,3
39633,conocimientos,0,0,3,3
2280,succede,1,3,0,3
17967,نصية,0,0,3,3
24488,methodes,0,0,3,3
24080,نارسسا,0,0,3,3
27720,underlying,0,0,3,3
34537,மிக்க,0,0,3,3
38841,comunidades,0,0,3,3
34731,orlowski,0,0,3,3
31911,occidentale,0,0,3,3
17737,சொன்னால்,0,0,3,3
18366,ausgeflippt,0,0,3,3
39294,npov,0,0,3,3
34525,artisan,0,0,3,3
3321,spam,2,1,2,3
10917,أستمع,0,0,3,3
2868,maggiore,1,3,0,3
4170,φιλικός,0,0,3,3
39622,ವನ್ನು,0,0,3,3
45137,مزعج,0,0,3,3
1156,articoli,1,3,0,3
469,g,2,1,2,3
10819,appuyant,0,0,3,3
24175,constituent,0,0,3,3
4088,أصدقائك,0,0,3,3
28004,конце,0,0,3,3
28051,şeyin,0,0,3,3
10873,cidessous,0,0,3,3
10116,थोड़ा,0,0,3,3
5133,recomponha,0,0,3,3
17185,संपादक,0,0,3,3
24156,ट्रेफिक,0,0,3,3
28006,कड़ी,0,0,3,3
17891,names,0,0,3,3
17915,своих,0,0,3,3
17797,அமெரிக்கர்கள்,0,0,3,3
45192,école,0,0,3,3
39688,ενοχλεί,0,0,3,3
17729,escala,0,0,3,3
39685,letar,0,0,3,3
4983,eksik,0,0,3,3
28008,مصنوع,0,0,3,3
17796,vyn,0,0,3,3
45187,diária,0,0,3,3
31925,двое,0,0,3,3
44796,стал,0,0,3,3
44244,அதிர்ஷ்டசாலி,0,0,3,3
44270,juridique,0,0,3,3
31978,അതൊരു,0,0,3,3
44701,poursuit,0,0,3,3
18450,toll,0,0,3,3
45184,അല്ലെങ്കിൽ‌,0,0,3,3
32218,pois,0,0,3,3
9487,लागू,0,0,3,3
10110,propuesta,0,0,3,3
1896,ideatori,1,3,0,3
39232,встретиться,0,0,3,3
44777,locais,0,0,3,3
39693,vient,0,0,3,3
17190,neurales,0,0,3,3
9503,fica,0,0,3,3
28057,média,0,0,3,3
4089,सहमति,0,0,3,3
18441,ആളുകൾ,0,0,3,3
10865,d’une,0,0,3,3
45201,americans,0,0,3,3
4078,publicatie,0,0,3,3
27688,πόσο,0,0,3,3
31931,ಆಗಿದೆ,0,0,3,3
1145,scrivono,1,3,0,3
479,raggiungere,1,3,0,3
44251,ലേഖകർ,0,0,3,3
17197,förhand,0,0,3,3
18443,comportements,0,0,3,3
38799,दावा,0,0,3,3
31715,goldene,0,0,3,3
9510,meiner,0,0,3,3
10211,വിലകൾ,0,0,3,3
45196,lørdag,0,0,3,3
44262,anonymt,0,0,3,3
9493,prevent,0,0,3,3
9513,இறுதியில்,0,0,3,3
10095,فضلك,0,0,3,3
10201,week,0,0,3,3
38807,говорить,0,0,3,3
39237,प्रणाली,0,0,3,3
10214,realizan,0,0,3,3
31979,mallar,0,0,3,3
44773,suppose,0,0,3,3
18388,engelske,0,0,3,3
39254,nichts,0,0,3,3
34706,tendens,0,0,3,3
17840,wikipédiens,0,0,3,3
17232,inquiète,0,0,3,3
44810,şaşkın,0,0,3,3
2775,succedendo,1,3,0,3
45166,debajo,0,0,3,3
17235,απλά,0,0,3,3
17237,ಆಹಾರ,0,0,3,3
17239,ನೆನಪಿಡಿ,0,0,3,3
17880,stockholm,0,0,3,3
10163,प्रिय,0,0,3,3
4094,russian,0,0,3,3
4013,πολλές,0,0,3,3
10817,إدخال,0,0,3,3
10162,orthographe,0,0,3,3
2817,presto,1,3,0,3
28339,llorando,0,0,3,3
27711,editörlerin,0,0,3,3
39214,sparsely,0,0,3,3
472,riguardo,1,3,0,3
44816,mundial,0,0,3,3
9565,làbas,0,0,3,3
32225,работать,0,0,3,3
44817,beschreiben,0,0,3,3
24170,utilisateur,0,0,3,3
31989,अवयव,0,0,3,3
27665,asturian,0,0,3,3
18391,σκορ,0,0,3,3
17944,extremely,0,0,3,3
31727,ajouter,0,0,3,3
18405,unit,0,0,3,3
5132,buscar,0,0,3,3
10830,أليس,0,0,3,3
39682,сердцу,0,0,3,3
31720,dingen,0,0,3,3
18422,fundadores,0,0,3,3
5131,campaña,0,0,3,3
44729,അർത്ഥമാക്കുന്നത്,0,0,3,3
44274,receiving,0,0,3,3
17169,gutaussehend,0,0,3,3
39671,شبه,0,0,3,3
31708,ബ്രെഡ്,0,0,3,3
28354,verdad,0,0,3,3
17791,tornar,0,0,3,3
34735,αδελφικά,0,0,3,3
17790,bitten,0,0,3,3
31963,версий,0,0,3,3
44234,encourage,0,0,3,3
24480,नीतियों,0,0,3,3
17924,الخاص,0,0,3,3
17926,வார்த்தையைப்,0,0,3,3
44802,donations,0,0,3,3
18410,जनमत,0,0,3,3
31724,ஆங்கிலத்தில்,0,0,3,3
39226,hayek,0,0,3,3
39710,étonnant,0,0,3,3
24093,فكرة,0,0,3,3
10902,ನಿನ್ನನ್ನು,0,0,3,3
31982,ചെയ്യും,0,0,3,3
32201,mauvais,0,0,3,3
31959,maanden,0,0,3,3
1270,mentalmente,2,1,2,3
28317,travlt,0,0,3,3
32156,ängeln,0,0,3,3
45131,وبالتالي,0,0,3,3
10559,textes,0,0,3,3
45004,عرض,0,0,3,3
17487,वर्ष,0,0,3,3
28224,لحظة,0,0,3,3
38970,الويكيبيديا,0,0,3,3
10556,sorge,0,0,3,3
18200,سيجنثالر,0,0,3,3
38969,estatísticas,0,0,3,3
18205,عند,0,0,3,3
38964,préalablement,0,0,3,3
31862,palácio,0,0,3,3
28229,swedish,0,0,3,3
28230,amélioration,0,0,3,3
9930,लगाने,0,0,3,3
32094,millioner,0,0,3,3
24258,ಹಿಡಿಯಲಿಲ್ಲ,0,0,3,3
34594,contrarié,0,0,3,3
44468,subscribe,0,0,3,3
18063,precisión,0,0,3,3
2846,arrivò,1,3,0,3
28153,знать,0,0,3,3
45002,fortfarande,0,0,3,3
17611,communities,0,0,3,3
18072,numerosas,0,0,3,3
39058,será,0,0,3,3
24309,opiniões,0,0,3,3
9925,fais,0,0,3,3
44483,faktisk,0,0,3,3
39463,mathématiques,0,0,3,3
10407,linda,0,0,3,3
24036,प्रोजेक्ट,0,0,3,3
44480,söylemenin,0,0,3,3
17491,sprog,0,0,3,3
44479,journalism,0,0,3,3
24037,cobertos,0,0,3,3
18188,baike,0,0,3,3
44478,moeras,0,0,3,3
44477,adequada,0,0,3,3
39384,samenwerking,0,0,3,3
18191,puan,0,0,3,3
32096,πάρα,0,0,3,3
39473,सार्वजनिक,0,0,3,3
24335,രജിസ്റ്റർ,0,0,3,3
4048,vaste,0,0,3,3
9944,moved,0,0,3,3
39489,уловил,0,0,3,3
4118,secreta,0,0,3,3
1244,mancanza,1,3,0,3
17449,passiert,0,0,3,3
28142,tras,0,0,3,3
28243,нее,0,0,3,3
18239,critères,0,0,3,3
10370,ശ്രദ്ധിച്ചില്ല,0,0,3,3
2837,quell,1,3,0,3
45040,strongly,0,0,3,3
10601,देखने,0,0,3,3
18245,إلهي,0,0,3,3
39497,sabía,0,0,3,3
17442,aandacht,0,0,3,3
24046,இத்திட்டம்,0,0,3,3
34580,unas,0,0,3,3
44441,graves,0,0,3,3
34852,pull,0,0,3,3
9752,licenças,0,0,3,3
9942,deuxième,0,0,3,3
9753,الحياة,0,0,3,3
2836,piaciuto,1,3,0,3
39066,fears,0,0,3,3
9773,allow,0,0,3,3
9769,आए,0,0,3,3
44462,करेंगे,0,0,3,3
18059,തെറ്റ്,0,0,3,3
38955,rendering,0,0,3,3
39477,juntos,0,0,3,3
24321,போது,0,0,3,3
10384,gelukkig,0,0,3,3
10581,разговоре,0,0,3,3
24323,οποίο,0,0,3,3
1231,occhi,1,3,0,3
23958,रख,0,0,3,3
39070,chanserna,0,0,3,3
10383,κάποιο,0,0,3,3
32039,запрос,0,0,3,3
10541,toutefois,0,0,3,3
31857,regulares,0,0,3,3
10540,слушал,0,0,3,3
10482,таким,0,0,3,3
34612,manual,0,0,3,3
17548,английский,0,0,3,3
380,perplesso,1,3,0,3
9894,λέξης,0,0,3,3
24269,confundir,0,0,3,3
44933,conseguir,0,0,3,3
10478,compostura,0,0,3,3
4121,prêt,0,0,3,3
1184,migliaia,1,3,0,3
44484,tourist,0,0,3,3
44958,inteligencia,0,0,3,3
18088,lockyer,0,0,3,3
39428,resolver,0,0,3,3
17538,réaliser,0,0,3,3
18140,første,0,0,3,3
27865,moyenne,0,0,3,3
9850,решение,0,0,3,3
34825,мечта,0,0,3,3
17587,باسم,0,0,3,3
28187,kein,0,0,3,3
9860,मिडिया,0,0,3,3
18103,línguas,0,0,3,3
31839,venus,0,0,3,3
9877,citações,0,0,3,3
27887,தயவு,0,0,3,3
24277,remainder,0,0,3,3
27886,masse,0,0,3,3
39410,prose,0,0,3,3
10458,العشر,0,0,3,3
18118,scientists,0,0,3,3
5023,αμερικανοί,0,0,3,3
27878,έκανε,0,0,3,3
44549,फ्रेंच,0,0,3,3
39402,όνειρό,0,0,3,3
44939,ബട്ടൺ,0,0,3,3
39020,extremadamente,0,0,3,3
17585,kender,0,0,3,3
44534,remercier,0,0,3,3
39418,behavioral,0,0,3,3
5086,probability,0,0,3,3
4057,നിർദ്ദേശങ്ങൾ,0,0,3,3
10495,membros,0,0,3,3
4053,considerada,0,0,3,3
10523,nedenle,0,0,3,3
9820,encontrar,0,0,3,3
18170,ακριβώς,0,0,3,3
9813,தங்கத்தால்,0,0,3,3
9812,webbläsare,0,0,3,3
32088,φράσης,0,0,3,3
24034,റോക്ക്,0,0,3,3
27846,assistindo,0,0,3,3
9811,longer,0,0,3,3
44989,criador,0,0,3,3
44573,intérieur,0,0,3,3
9804,detección,0,0,3,3
39453,mark,0,0,3,3
18182,wapedia,0,0,3,3
18184,கவனித்துக்,0,0,3,3
1233,potrebbero,1,3,0,3
17606,incapable,0,0,3,3
44982,bastante,0,0,3,3
10412,garçon,0,0,3,3
24290,விரும்புகிறீர்கள்,0,0,3,3
32047,بـ,0,0,3,3
39393,samedi,0,0,3,3
4056,ελεύθερη,0,0,3,3
44511,fortalte,0,0,3,3
9839,consideraba,0,0,3,3
9835,ஏற்கனவே,0,0,3,3
39442,seviyorum,0,0,3,3
31824,планы,0,0,3,3
27897,पकड़ा,0,0,3,3
39392,ಚಿನ್ನದಿಂದ,0,0,3,3
24297,इन्टरनेट,0,0,3,3
28167,nosotros,0,0,3,3
10510,morgon,0,0,3,3
28200,joke,0,0,3,3
433,bibliotecario,2,2,1,3
10519,قائمة,0,0,3,3
44496,दी।,0,0,3,3
44495,пришли,0,0,3,3
39500,καθόλου,0,0,3,3
39359,συμφωνώ,0,0,3,3
9607,sammenlignet,0,0,3,3
44642,blocage,0,0,3,3
1165,anticipo,1,3,0,3
39112,организация,0,0,3,3
17694,عامة,0,0,3,3
3322,america,2,1,2,3
5040,ಈಗಾಗಲೇ,0,0,3,3
44356,интернете,0,0,3,3
10719,போல்,0,0,3,3
9652,scott,0,0,3,3
45099,preguntas,0,0,3,3
9639,разделы,0,0,3,3
10720,opinião,0,0,3,3
31892,الجديد,0,0,3,3
28108,contient,0,0,3,3
1254,settimana,1,3,0,3
17987,ಅದೇ,0,0,3,3
24071,редактирования,0,0,3,3
34665,أنواع,0,0,3,3
34547,خبز,0,0,3,3
9995,بضع,0,0,3,3
9664,skrev,0,0,3,3
24377,रोने,0,0,3,3
27761,தவறுகள்,0,0,3,3
10322,erro,0,0,3,3
9676,dada,0,0,3,3
10700,läsarna,0,0,3,3
18296,preserve,0,0,3,3
39103,व्याख्या,0,0,3,3
34774,rica,0,0,3,3
39107,rockst,0,0,3,3
44367,απασχολημένος,0,0,3,3
34658,board,0,0,3,3
17360,മുഴുവൻ,0,0,3,3
4035,açık,0,0,3,3
45087,chaos,0,0,3,3
17354,usas,0,0,3,3
34659,seule,0,0,3,3
32019,universitaires,0,0,3,3
17693,utilisent,0,0,3,3
39566,komma,0,0,3,3
39574,ನಾಳೆ,0,0,3,3
24381,ಫಿಕ್ಸ್‌ನಲ್ಲಿದ್ದೇನೆ,0,0,3,3
17437,மனதில்,0,0,3,3
45124,fehler,0,0,3,3
39588,zelfs,0,0,3,3
10030,दिया।,0,0,3,3
38876,दौरान,0,0,3,3
28310,विश्वविद्यालय,0,0,3,3
1201,accademica,1,3,0,3
23906,inútil,0,0,3,3
1158,quegli,1,3,0,3
39590,instellingen,0,0,3,3
18350,convencional,0,0,3,3
38883,delas,0,0,3,3
24196,duro,0,0,3,3
24394,οξεία,0,0,3,3
34892,saisi,0,0,3,3
17319,ελεύθερος,0,0,3,3
413,successivamente,1,3,0,3
44664,alleen,0,0,3,3
28091,değmez,0,0,3,3
45130,намного,0,0,3,3
45117,संग्रहण,0,0,3,3
17721,farvel,0,0,3,3
1847,inventata,1,3,0,3
18333,utiles,0,0,3,3
39122,especial,0,0,3,3
9637,marmelade,0,0,3,3
38882,soucis,0,0,3,3
34666,الأم,0,0,3,3
23912,humano,0,0,3,3
24384,effets,0,0,3,3
45110,vond,0,0,3,3
17707,anjo,0,0,3,3
10296,estábamos,0,0,3,3
28304,güzelliği,0,0,3,3
9632,experiência,0,0,3,3
38880,öka,0,0,3,3
39307,tacka,0,0,3,3
5115,تناول,0,0,3,3
34768,προτέρων,0,0,3,3
24393,ഒബ്‌ട്യൂസ്,0,0,3,3
10027,därmed,0,0,3,3
461,ciao,1,3,0,3
38910,tager,0,0,3,3
18010,alstublieft,0,0,3,3
44615,unglaublich,0,0,3,3
10643,conta,0,0,3,3
44416,pairs,0,0,3,3
1832,autore,1,3,0,3
17404,verblüfft,0,0,3,3
39079,relationships,0,0,3,3
4044,ontwikkeling,0,0,3,3
10648,fingre,0,0,3,3
4043,croate,0,0,3,3
27792,apoyo,0,0,3,3
39555,tijdschrift,0,0,3,3
17401,tillgång,0,0,3,3
4068,ಮಾರ್ಗವಾಗಿದೆ,0,0,3,3
32132,candidat,0,0,3,3
44620,petite,0,0,3,3
23936,relevanta,0,0,3,3
9705,reprenant,0,0,3,3
28133,σύντομα,0,0,3,3
455,bisogno,1,3,0,3
45054,χρήματα,0,0,3,3
4067,lijst,0,0,3,3
34860,establecidas,0,0,3,3
10352,الحظ,0,0,3,3
17646,बनाना।,0,0,3,3
39503,ದೊಡ್ಡ,0,0,3,3
34579,avond,0,0,3,3
27811,zamandır,0,0,3,3
18246,близко,0,0,3,3
10618,أعمال,0,0,3,3
34858,bilgilerin,0,0,3,3
44609,vergelijking,0,0,3,3
10355,indépendamment,0,0,3,3
2308,ragionamento,1,3,0,3
39512,erklärt,0,0,3,3
2267,perceptrons,2,1,2,3
39514,τραβήξτε,0,0,3,3
9728,forhånd,0,0,3,3
27802,vinieron,0,0,3,3
3328,ricorda,1,3,0,3
23944,sections,0,0,3,3
34650,principles,0,0,3,3
4140,либо,0,0,3,3
5004,البعض,0,0,3,3
17371,உரையாடலில்,0,0,3,3
10334,episódio,0,0,3,3
28273,geschreven,0,0,3,3
34866,automated,0,0,3,3
3326,russo,2,1,2,3
27770,documents,0,0,3,3
18026,وليس,0,0,3,3
5001,alvo,0,0,3,3
1249,prese,1,3,0,3
32149,takke,0,0,3,3
18284,coolt,0,0,3,3
10692,off,0,0,3,3
44869,peki,0,0,3,3
9983,chino,0,0,3,3
10329,متأكد,0,0,3,3
44628,tidsskrift,0,0,3,3
418,cioè,1,3,0,3
387,stupido,1,3,0,3
44381,данные,0,0,3,3
17376,march,0,0,3,3
31778,स्वतंत्रता,0,0,3,3
28272,« les,0,0,3,3
9965,klagen,0,0,3,3
10335,pidiendo,0,0,3,3
18033,actualmente,0,0,3,3
10666,വചനം,0,0,3,3
1172,«una,2,1,2,3
38920,koets,0,0,3,3
9696,खींचते,0,0,3,3
39542,överbelastad,0,0,3,3
44396,проекте,0,0,3,3
18276,actuellement,0,0,3,3
24364,hyperliens,0,0,3,3
23932,boek,0,0,3,3
9693,majeure,0,0,3,3
27781,قل,0,0,3,3
32140,निश्चित,0,0,3,3
2811,buono,1,3,0,3
38918,outil,0,0,3,3
39050,இருக்கும்போது,0,0,3,3
11855,dejligt,0,0,3,3
44195,ரகசிய,0,0,3,3
42622,hen,0,0,3,3
15087,vår,0,0,3,3
41208,βλέπω,0,0,3,3
13178,пользователи,0,0,3,3
26514,ಹೊಸ,0,0,3,3
25533,acute,0,0,3,3
42602,आलोचकों,0,0,3,3
41193,плакать,0,0,3,3
3128,oggetto,1,3,0,3
33738,seção,0,0,3,3
41187,ನುಡಿಗಟ್ಟುಗಳು,0,0,3,3
25527,dediğini,0,0,3,3
25523,ಅಲ್ಲ,0,0,3,3
13151,synonyme,0,0,3,3
41181,ужасно,0,0,3,3
13147,silver,0,0,3,3
15080,söyleyebileceğin,0,0,3,3
2014,pubblicate,1,3,0,3
41216,låter,0,0,3,3
41237,हों।,0,0,3,3
33080,hören,0,0,3,3
25576,самое,0,0,3,3
13233,grund,0,0,3,3
2126,redazione,1,3,0,3
42559,ثلاثة,0,0,3,3
25567,friend,0,0,3,3
13213,والتي,0,0,3,3
15074,bak,0,0,3,3
26490,remis,0,0,3,3
26495,beschweren,0,0,3,3
15064,kullanmak,0,0,3,3
42582,wusste,0,0,3,3
33062,ಒಟ್ಟಿಗೆ,0,0,3,3
26500,location,0,0,3,3
42620,சிறிய,0,0,3,3
25521,rama,0,0,3,3
26575,मीड़याविकी,0,0,3,3
41173,northern,0,0,3,3
33763,capa,0,0,3,3
942,artificiali,1,3,0,3
26558,erasmus,0,0,3,3
42663,мечты,0,0,3,3
2996,vendita,1,3,0,3
26563,primeiros,0,0,3,3
42670,பெரும்பாலும்,0,0,3,3
26564,yaygın,0,0,3,3
15202,الحقيقة,0,0,3,3
33767,الموسوعة،,0,0,3,3
25475,ner,0,0,3,3
26567,أحدث,0,0,3,3
13055,depends,0,0,3,3
42678,bröd,0,0,3,3
33009,लिखते,0,0,3,3
15186,işi,0,0,3,3
4695,കുറച്ചുകൂടി,0,0,3,3
3134,fame,1,3,0,3
15160,முன்கூட்டியே,0,0,3,3
2136,capire,1,3,0,3
13134,crecimiento,0,0,3,3
3000,genetici,1,3,0,3
13121,próximo,0,0,3,3
15154,mouvement,0,0,3,3
2010,analogamente,1,3,0,3
33027,meddelande,0,0,3,3
3133,portato,1,3,0,3
42645,lsjbot,0,0,3,3
41150,implique,0,0,3,3
33755,wist,0,0,3,3
25500,принимайте,0,0,3,3
4692,लिखी,0,0,3,3
25497,слышали,0,0,3,3
15025,constant,0,0,3,3
33083,entire,0,0,3,3
41258,ನೋಡೋಣ,0,0,3,3
42541,uppmärksamhet,0,0,3,3
26393,ഉള്ളടക്കം,0,0,3,3
3117,emigh,2,2,1,3
4466,aplicación,0,0,3,3
13365,contraire,0,0,3,3
41337,ടിപ്പ്,0,0,3,3
25630,källbeskrivning,0,0,3,3
25629,successfully,0,0,3,3
42458,उच्चारण,0,0,3,3
33124,tek,0,0,3,3
41333,publicação,0,0,3,3
33121,representative,0,0,3,3
4463,கேட்கவில்லை,0,0,3,3
25622,busca,0,0,3,3
13343,betydligt,0,0,3,3
26413,الألمانية,0,0,3,3
33134,ediyorum,0,0,3,3
42439,verdade,0,0,3,3
33139,والمعلوماتية,0,0,3,3
3115,blue,2,1,2,3
25655,cuidar,0,0,3,3
41367,régression,0,0,3,3
4470,confused,0,0,3,3
3017,importanza,1,3,0,3
25649,belle,0,0,3,3
3112,minuto,2,1,2,3
743,routine,2,1,2,3
26385,словам,0,0,3,3
33660,इतने,0,0,3,3
42427,submit,0,0,3,3
741,potrei,1,3,0,3
42430,extent,0,0,3,3
13396,visit,0,0,3,3
41353,voz,0,0,3,3
3012,credo,1,3,0,3
25619,liked,0,0,3,3
4664,respect,0,0,3,3
14996,نمو,0,0,3,3
41294,озадачены,0,0,3,3
42506,boas,0,0,3,3
14973,bekymringer,0,0,3,3
42511,εγκυκλοπαίδεια,0,0,3,3
14986,árboles,0,0,3,3
25591,hébergement,0,0,3,3
922,metà,1,3,0,3
33103,harte,0,0,3,3
41275,grands,0,0,3,3
15006,എന്നിരുന്നാലും,0,0,3,3
3003,propri,1,3,0,3
42537,sons,0,0,3,3
13250,ولكني,0,0,3,3
25583,محيرة,0,0,3,3
13293,wetenschappelijke,0,0,3,3
14961,يقوم,0,0,3,3
2021,americani,1,3,0,3
13319,источник,0,0,3,3
4666,м,0,0,3,3
2119,devo,2,2,1,3
26422,പറഞ്ഞാൽ,0,0,3,3
33673,vegetation,0,0,3,3
26424,privacidade,0,0,3,3
14939,ഇവരെ,0,0,3,3
42487,kullandığım,0,0,3,3
42496,ലഭ്യമായ,0,0,3,3
4459,ante,0,0,3,3
41307,kullanılmaktadır,0,0,3,3
13312,легко,0,0,3,3
26431,kelimesini,0,0,3,3
14952,चीजें,0,0,3,3
42495,വിക്കി,0,0,3,3
15219,نطاق,0,0,3,3
13036,revert,0,0,3,3
32880,querer,0,0,3,3
12747,thème,0,0,3,3
25363,денег,0,0,3,3
42863,सुनहरी,0,0,3,3
2150,primaria,2,2,1,3
40943,volumes,0,0,3,3
12780,offensive,0,0,3,3
26694,प्रश्न,0,0,3,3
26696,magnus,0,0,3,3
15444,durumda,0,0,3,3
25354,estadísticas,0,0,3,3
42883,studenter,0,0,3,3
26703,waarop,0,0,3,3
3159,distribuito,1,3,0,3
32919,rolle,0,0,3,3
4744,débat,0,0,3,3
40925,bloqueios,0,0,3,3
12795,tidskriften,0,0,3,3
42859,nou,0,0,3,3
12801,abonnieren,0,0,3,3
692,narcisismo,2,1,2,3
33829,أكن,0,0,3,3
42840,marque,0,0,3,3
12834,klinkt,0,0,3,3
40977,eyes,0,0,3,3
15398,asombroso,0,0,3,3
40972,saturday,0,0,3,3
4728,приятно,0,0,3,3
25370,नया,0,0,3,3
42850,работал,0,0,3,3
15412,चलने,0,0,3,3
32936,bidrar,0,0,3,3
12808,græder,0,0,3,3
40964,frasen,0,0,3,3
40963,souligne,0,0,3,3
15466,druk,0,0,3,3
42900,प्रशासक,0,0,3,3
4702,उद्धरण,0,0,3,3
15469,समकक्ष,0,0,3,3
33876,cartoon,0,0,3,3
42941,yakışıklı,0,0,3,3
12681,ಅತ್ಯುತ್ತಮ,0,0,3,3
26743,अंग्रेज़ी,0,0,3,3
2970,click,2,1,2,3
40881,requisitos,0,0,3,3
12676,വ്യത്യസ്ത,0,0,3,3
4384,учёными,0,0,3,3
25315,déranger,0,0,3,3
12672,racine,0,0,3,3
40874,climat,0,0,3,3
12656,º,0,0,3,3
12655,используют,0,0,3,3
15551,houdt,0,0,3,3
40866,melhores,0,0,3,3
26739,enseignants,0,0,3,3
33871,mutlu,0,0,3,3
25328,goodbye,0,0,3,3
32906,appearing,0,0,3,3
15471,φάτε,0,0,3,3
33862,первый,0,0,3,3
33863,discusiones,0,0,3,3
15479,ρωτήσετε,0,0,3,3
40916,ozone,0,0,3,3
42910,spreken,0,0,3,3
2973,evoluzione,1,3,0,3
15506,pengar,0,0,3,3
4390,получить,0,0,3,3
40906,devons,0,0,3,3
26733,opgericht,0,0,3,3
15497,necesario,0,0,3,3
15503,negotiation,0,0,3,3
12703,ஆமாம்,0,0,3,3
15386,punktzahl,0,0,3,3
694,parlando,1,3,0,3
12843,firm,0,0,3,3
969,giapponese,1,3,0,3
32986,verte,0,0,3,3
15281,zustimmen,0,0,3,3
703,preprocessing,2,1,2,3
3141,lungo,1,3,0,3
25435,throughout,0,0,3,3
12968,posible,0,0,3,3
32983,cargos,0,0,3,3
41059,आई,0,0,3,3
25433,existem,0,0,3,3
12960,dåligt,0,0,3,3
42752,sousjacente,0,0,3,3
42754,sekund,0,0,3,3
12952,buenos,0,0,3,3
25424,alls,0,0,3,3
15300,θυμωμένος,0,0,3,3
42731,നിങ്ങൾക്കറിയില്ല,0,0,3,3
41069,modellen,0,0,3,3
33787,ones,0,0,3,3
15242,ലേഖനങ്ങളെഴുതുക,0,0,3,3
33776,förvånad,0,0,3,3
42692,inden,0,0,3,3
42698,"
उत्तरी",0,0,3,3
26583,இருந்தார்,0,0,3,3
15239,الإناث,0,0,3,3
952,largo,2,1,2,3
15243,इससे,0,0,3,3
42724,teve,0,0,3,3
4704,apple,0,0,3,3
42709,ലേഖനങ്ങളും,0,0,3,3
15252,modified,0,0,3,3
4705,jongens,0,0,3,3
42719,«un,0,0,3,3
26601,busy,0,0,3,3
12946,offers,0,0,3,3
12944,utilisés,0,0,3,3
26625,expression,0,0,3,3
12864,هؤلاء,0,0,3,3
15352,ಅಳುವುದು,0,0,3,3
33821,düzeltme,0,0,3,3
15358,below,0,0,3,3
4407,talen,0,0,3,3
12872,εμένα,0,0,3,3
2981,guinness,1,3,0,3
26663,ज्ञान,0,0,3,3
15345,conflict,0,0,3,3
15367,eua,0,0,3,3
695,sabato,1,3,0,3
15370,கேட்கிறது,0,0,3,3
15372,mala,0,0,3,3
40993,liberdade,0,0,3,3
42827,wikipediasidor,0,0,3,3
967,comune,1,3,0,3
41011,शिकायत,0,0,3,3
41047,எந்தவொரு,0,0,3,3
42782,فعل,0,0,3,3
42764,ಅನೇಕ,0,0,3,3
42775,ಕುರಿತು,0,0,3,3
33804,operations,0,0,3,3
962,opere,1,3,0,3
41036,bekymret,0,0,3,3
12915,laver,0,0,3,3
41032,überhaupt,0,0,3,3
33809,dérivé,0,0,3,3
42784,पंजीकृत,0,0,3,3
33805,tivesse,0,0,3,3
42786,fyra,0,0,3,3
3144,disciplina,2,2,1,3
15326,выглядела,0,0,3,3
42792,стала,0,0,3,3
13435,е,0,0,3,3
14849,dinero,0,0,3,3
14844,usarse,0,0,3,3
33499,libraries,0,0,3,3
3047,fino,2,2,1,3
855,hegel,2,2,1,3
14395,ತಮ್ಮ,0,0,3,3
42030,devido,0,0,3,3
26117,нам,0,0,3,3
41700,источниках,0,0,3,3
26120,réseaux,0,0,3,3
33491,издания,0,0,3,3
14407,பொத்தானை,0,0,3,3
14412,transform,0,0,3,3
13911,app,0,0,3,3
42049,«вики»,0,0,3,3
33497,schaltfläche,0,0,3,3
13903,recupera,0,0,3,3
26131,അവസാന,0,0,3,3
13936,ഫ്ലമ്മോക്സ്,0,0,3,3
33323,capítulo,0,0,3,3
26112,auktoritativa,0,0,3,3
33478,notability,0,0,3,3
14358,результаты,0,0,3,3
13973,फोन,0,0,3,3
14361,émissions,0,0,3,3
14363,degrés,0,0,3,3
42006,obtuve,0,0,3,3
13960,extérieur,0,0,3,3
4545,aquellos,0,0,3,3
25887,திருகினேன்,0,0,3,3
13956,duitstalige,0,0,3,3
26102,состоянию,0,0,3,3
41717,மிக,0,0,3,3
26106,matérialistes,0,0,3,3
41712,يريد,0,0,3,3
13945,जापानी,0,0,3,3
26133,hört,0,0,3,3
25864,αιχμηρή,0,0,3,3
906,elementi,1,3,0,3
13884,motion,0,0,3,3
33521,حسب,0,0,3,3
4528,مثير,0,0,3,3
33531,aparece,0,0,3,3
14511,miriam,0,0,3,3
41617,ಅಸಮಾಧಾನಗೊಳ್ಳಬೇಡಿ,0,0,3,3
42116,vroeg,0,0,3,3
26172,ஆரம்பித்தாள்,0,0,3,3
33533,samtale,0,0,3,3
33534,लगाया,0,0,3,3
14521,lançado,0,0,3,3
14524,essential,0,0,3,3
14527,vor,0,0,3,3
26178,നിലവിൽ,0,0,3,3
42128,اسم,0,0,3,3
42130,potentially,0,0,3,3
13838,fifth,0,0,3,3
33295,εγχειρήματα,0,0,3,3
22031,முடிவில்,0,0,3,3
41659,panorama,0,0,3,3
13883,கேட்கும்போது,0,0,3,3
26143,passar,0,0,3,3
42071,lyde,0,0,3,3
25857,acquisition,0,0,3,3
14449,álbum,0,0,3,3
41664,समूह,0,0,3,3
14458,nor,0,0,3,3
871,significativo,2,2,1,3
33511,வகையில்,0,0,3,3
4533,vrouw,0,0,3,3
13857,elsker,0,0,3,3
42085,நீ,0,0,3,3
42088,sætningen,0,0,3,3
41643,före,0,0,3,3
2083,lunga,1,3,0,3
41736,αυτούς,0,0,3,3
13987,நுபீடியாவின்,0,0,3,3
14343,statistiques,0,0,3,3
41827,ആർക്കും,0,0,3,3
41910,φρικτή,0,0,3,3
41913,samples,0,0,3,3
26032,autant,0,0,3,3
41821,referências,0,0,3,3
14235,expressions,0,0,3,3
14242,beings,0,0,3,3
14244,weinberger,0,0,3,3
14245,comentario,0,0,3,3
41810,éditions ,0,0,3,3
14082,dez,0,0,3,3
26042,επειδή,0,0,3,3
4556,complexes,0,0,3,3
14262,hvem,0,0,3,3
26047,समायोजित,0,0,3,3
41908,afspraak,0,0,3,3
14223,المتخصصين,0,0,3,3
33423,olá,0,0,3,3
41888,ಸಂಭಾಷಣೆಯಲ್ಲಿ,0,0,3,3
14163,watson,0,0,3,3
25999,buen,0,0,3,3
14156,cœur,0,0,3,3
33401,विकसित,0,0,3,3
14148,challenges,0,0,3,3
41883,ಸುವ್,0,0,3,3
33412,пальцы,0,0,3,3
14215,editör,0,0,3,3
14202,حالة,0,0,3,3
14129,discussões,0,0,3,3
14206,balansen,0,0,3,3
41837,buitengewoon,0,0,3,3
14119,sidor,0,0,3,3
14116,juntamente,0,0,3,3
4582,अनुभव,0,0,3,3
41795,مشاريع,0,0,3,3
14064,brought,0,0,3,3
14327,falsk,0,0,3,3
14316,कॉल,0,0,3,3
14317,additional,0,0,3,3
14319,комментариев,0,0,3,3
33349,conçu,0,0,3,3
25920,النرجسية,0,0,3,3
3080,stavo,1,3,0,3
25917,aviso,0,0,3,3
14019,சவாரி,0,0,3,3
14331,olma,0,0,3,3
14000,décision,0,0,3,3
41987,cultural,0,0,3,3
13994,எனினும்,0,0,3,3
33469, مليون,0,0,3,3
33341,dela,0,0,3,3
3079,prenderlo,1,3,0,3
33460,élus,0,0,3,3
25947,lyssnade,0,0,3,3
26059,ನೀಡಲಿದ್ದೇನೆ,0,0,3,3
25942,compute,0,0,3,3
41945,ouvrages,0,0,3,3
41782,وهم,0,0,3,3
14289,bas,0,0,3,3
41776,मार्क,0,0,3,3
14044,جون,0,0,3,3
812,creati,1,3,0,3
25925,rejeitou,0,0,3,3
14298,fonctions,0,0,3,3
26065,изменений,0,0,3,3
41771,dourado,0,0,3,3
3078,politiche,1,3,0,3
41766,кроме,0,0,3,3
14307,kamen,0,0,3,3
41602,perplexo,0,0,3,3
13793,نص,0,0,3,3
42132,penser,0,0,3,3
33216,मिलता,0,0,3,3
2109,resa,2,1,2,3
14731,mantém,0,0,3,3
14735,contradictoires,0,0,3,3
33190,videoda,0,0,3,3
26300,argue,0,0,3,3
26301,aman,0,0,3,3
14743,elbette,0,0,3,3
42311,λένε,0,0,3,3
42312,écoutais,0,0,3,3
41451,करो।,0,0,3,3
14749,самой,0,0,3,3
42317,recientes,0,0,3,3
42318,âge,0,0,3,3
41444,gardner,0,0,3,3
42323,linterweb,0,0,3,3
26288,റോന്ദേവൂ,0,0,3,3
3026,dolce,1,3,0,3
14722,weer,0,0,3,3
13597,devenu,0,0,3,3
33593,anônimos,0,0,3,3
42251,netflix,0,0,3,3
25728,खुला,0,0,3,3
41480,archives,0,0,3,3
25721,удивительно,0,0,3,3
25719,മാത്രമേ,0,0,3,3
13596,droeg,0,0,3,3
4487,இருப்பதாக,0,0,3,3
14710,estimé,0,0,3,3
42272,biased,0,0,3,3
4490,lieve,0,0,3,3
26276,hjärtat,0,0,3,3
14717,δει,0,0,3,3
33607,allumé,0,0,3,3
41441,libros,0,0,3,3
26313,cambios,0,0,3,3
14762,suggest,0,0,3,3
13471,erstaunliche,0,0,3,3
4478,कपड़े,0,0,3,3
33637,ниже,0,0,3,3
25676,abonnement,0,0,3,3
14807,μιας,0,0,3,3
42368,वहाँ,0,0,3,3
41403,உறுதியாக,0,0,3,3
14815,liées,0,0,3,3
26334,racines,0,0,3,3
13469,fluido,0,0,3,3
42375,ഖേദിക്കുന്നു,0,0,3,3
14816,சொற்றொடர்கள்,0,0,3,3
41397,हार्वर्ड,0,0,3,3
14824,publication,0,0,3,3
33158,écologique,0,0,3,3
26335,digits,0,0,3,3
13484,ജിമ്മി,0,0,3,3
3108,migliorare,1,3,0,3
41425,fallen,0,0,3,3
3109,thomas,2,1,2,3
33624,ഉണ്ട്,0,0,3,3
42340,डिग्री,0,0,3,3
41428,يكن,0,0,3,3
33627,copiar,0,0,3,3
42343,match,0,0,3,3
14782,கடைசி,0,0,3,3
749,mese,1,3,0,3
13505,ನಿಧಾನವಾಗಿ,0,0,3,3
13502,vogn,0,0,3,3
42349,respecto,0,0,3,3
41419,uk,0,0,3,3
14792,pratiques,0,0,3,3
41414,trabalhos,0,0,3,3
888,gradi,1,3,0,3
42244,сэнгером,0,0,3,3
33274,volcanic,0,0,3,3
4631,sumpf,0,0,3,3
14558,scherp,0,0,3,3
26198,trotzdem,0,0,3,3
25797,месте,0,0,3,3
41576,fichier,0,0,3,3
42162,accept,0,0,3,3
14570,еда,0,0,3,3
14576,απόγευμα,0,0,3,3
14577,hak,0,0,3,3
41568,euxmêmes,0,0,3,3
41564,mayo,0,0,3,3
14584,langzaam,0,0,3,3
14586,بنفسك,0,0,3,3
13730,ஒலிக்க,0,0,3,3
4513,запущенным,0,0,3,3
13726,nodig,0,0,3,3
42155,sürümü,0,0,3,3
33265,rend,0,0,3,3
14556,powers,0,0,3,3
41596,ಹೃದಯಕ್ಕೆ,0,0,3,3
13783,محتويات,0,0,3,3
13782,എഴുതുന്ന,0,0,3,3
41597,केन्द्रित,0,0,3,3
42139,शनिवार,0,0,3,3
4615,içeriğini,0,0,3,3
26185,θέλατε,0,0,3,3
41595,ലോഗിൻ,0,0,3,3
787,dovrei,1,3,0,3
14545,völlig,0,0,3,3
33270,général,0,0,3,3
41587,författaren,0,0,3,3
13766,πάμε,0,0,3,3
42146,wikikod,0,0,3,3
33269,origin,0,0,3,3
13725,बिल्कुल,0,0,3,3
41551,yakında,0,0,3,3
42188,condición,0,0,3,3
13647,चार,0,0,3,3
14643,ശനിയാഴ്ച,0,0,3,3
42223,ಪಡೆದಿದ್ದೇನೆ,0,0,3,3
3105,stampate,1,3,0,3
13654,tahmin,0,0,3,3
886,ricordati,1,3,0,3
33222,comptes,0,0,3,3
771,aiutarti,1,3,0,3
14634,vidste,0,0,3,3
14663,pasado,0,0,3,3
41507,ومن,0,0,3,3
25744,seis,0,0,3,3
42239,structural,0,0,3,3
4628,bedanken,0,0,3,3
25743,enklare,0,0,3,3
13665,muestra,0,0,3,3
14632,ويمكن,0,0,3,3
42189,danken,0,0,3,3
26229,ഫ്രഞ്ച്,0,0,3,3
25775,ലാറ്റിൻ,0,0,3,3
42195,yorum,0,0,3,3
33567,explains,0,0,3,3
14611,ജാം,0,0,3,3
26226,américain,0,0,3,3
4507,lärare,0,0,3,3
13693,önce,0,0,3,3
13675,viki,0,0,3,3
26232,خبرة,0,0,3,3
33570,trabalhar,0,0,3,3
4501,केचे,0,0,3,3
33233,rejected,0,0,3,3
42214,hoofdredacteur,0,0,3,3
14630,voorbaat,0,0,3,3
40864,vão,0,0,3,3
15560,driven,0,0,3,3
10945,blandt,0,0,3,3
34286,شيوعًا,0,0,3,3
16604,açıklayan,0,0,3,3
16606,gorillas,0,0,3,3
11528,φυσικά,0,0,3,3
24772,únicos,0,0,3,3
11522,नंबर,0,0,3,3
11520,الحادة,0,0,3,3
34270,ocak,0,0,3,3
43794,afirma,0,0,3,3
545,visione,1,3,0,3
24757,tendencia,0,0,3,3
43796,bör,0,0,3,3
43797,harassment,0,0,3,3
24755,istemiyorum,0,0,3,3
27356,declaró,0,0,3,3
40081,asusté,0,0,3,3
16603,обучающей,0,0,3,3
16597,högst,0,0,3,3
40111,c’estàdire,0,0,3,3
24799,πάρετε,0,0,3,3
11610,него,0,0,3,3
40157,suene,0,0,3,3
16530,attributed,0,0,3,3
43740,نارسيس,0,0,3,3
16551,لديها,0,0,3,3
16553,merhaba,0,0,3,3
32464,согласен,0,0,3,3
24779,ekstra,0,0,3,3
11562,references,0,0,3,3
16568,globorompecabezas,0,0,3,3
16569,dernières,0,0,3,3
3225,usano,1,3,0,3
24786,onun,0,0,3,3
40117,raderas,0,0,3,3
40073,किस,0,0,3,3
43809,ಕೆಳಗೆ,0,0,3,3
39990,träsk,0,0,3,3
11486,computacional,0,0,3,3
16697,مارس,0,0,3,3
27397,lyttede,0,0,3,3
40021,studenterna,0,0,3,3
27402,publikationer,0,0,3,3
11415,पैदा,0,0,3,3
32405,कॉमन्स,0,0,3,3
534,wikisource,2,1,2,3
40020,klingt,0,0,3,3
27406,सामने,0,0,3,3
40000,agradecer,0,0,3,3
1916,vinto,1,3,0,3
11383,entrenamiento,0,0,3,3
11382,onunla,0,0,3,3
2232,verbo,2,1,2,3
11376,reading,0,0,3,3
40034,geographic,0,0,3,3
11434,संशोधन,0,0,3,3
11436,neuron,0,0,3,3
4897,italian,0,0,3,3
24738,يونيو,0,0,3,3
16652,tatsächlich,0,0,3,3
543,copyleft,2,1,2,3
2225,academy,2,1,2,3
11469,prediction,0,0,3,3
16662,μπήκε,0,0,3,3
32425,beschäftigt,0,0,3,3
40035,matematik,0,0,3,3
16673,moteurs,0,0,3,3
40042,हमारे,0,0,3,3
11442,deliver,0,0,3,3
4901,superior,0,0,3,3
16688,माइकल,0,0,3,3
538,piacere,1,3,0,3
11615,mellem,0,0,3,3
34230,созданию,0,0,3,3
27306,occupé,0,0,3,3
43720,floricic,0,0,3,3
11745,akıllıca,0,0,3,3
27239,красив,0,0,3,3
40264,बड़े,0,0,3,3
11738,الأطعمة,0,0,3,3
27243,व्यापक,0,0,3,3
43644,βρίσκεται,0,0,3,3
34171,بدأ,0,0,3,3
34173,face,0,0,3,3
40256,dartmouth,0,0,3,3
40255,கருத்து,0,0,3,3
34177,yes,0,0,3,3
32514,shift,0,0,3,3
40241,try,0,0,3,3
11705,eliminan,0,0,3,3
16421,статистики,0,0,3,3
43636,perdón,0,0,3,3
11748,sanki,0,0,3,3
16373,único,0,0,3,3
11781,каждой,0,0,3,3
43596,automatiskt,0,0,3,3
16334,lycklig,0,0,3,3
11796,எடுத்துக்,0,0,3,3
2204,carne,2,1,2,3
27219,സ്നേഹിക്കുന്നു,0,0,3,3
32541,demandez,0,0,3,3
575,ex,1,3,0,3
11753,jullie,0,0,3,3
2207,concentra,1,3,0,3
16354,செய்யும்,0,0,3,3
27228,l’encontre,0,0,3,3
1073,permette,1,3,0,3
1939,corretta,1,3,0,3
11754,highest,0,0,3,3
34187,ಸಿಹಿ,0,0,3,3
1081,prestito,1,3,0,3
43668,aslında,0,0,3,3
40189,fiche,0,0,3,3
11659,μοίρες,0,0,3,3
43695,بكل,0,0,3,3
24847,mätte,0,0,3,3
27291,foutieve,0,0,3,3
24842,móveis,0,0,3,3
16477,dersin,0,0,3,3
43703,സംസാരിക്കാൻ,0,0,3,3
16450,alias,0,0,3,3
16486,işe,0,0,3,3
27298,följande,0,0,3,3
27300,registered,0,0,3,3
40175,ಉದಾಹರಣೆ,0,0,3,3
43713,trek,0,0,3,3
32482,photographic,0,0,3,3
34198,envoyer,0,0,3,3
43685,शीर्ष,0,0,3,3
11695,negativt,0,0,3,3
16438,gehad,0,0,3,3
11691,toward,0,0,3,3
16434,casamento,0,0,3,3
27267,أشار,0,0,3,3
32504,proposal,0,0,3,3
11686,contribuinte,0,0,3,3
24867,vikipedilerin,0,0,3,3
24866,supervisé,0,0,3,3
40218,growing,0,0,3,3
11680,parecia,0,0,3,3
40222,svårt,0,0,3,3
27275,июле,0,0,3,3
4870,keep,0,0,3,3
27276,ಕ್ಷಮಿಸು,0,0,3,3
2215,vari,1,3,0,3
4217,использую,0,0,3,3
34329,അതിശയകരമാണ്,0,0,3,3
32879,ലേഖനത്തിനു,0,0,3,3
27585,الرجل,0,0,3,3
39818,logiciels,0,0,3,3
39817,norman,0,0,3,3
39816,странице,0,0,3,3
17001,remove,0,0,3,3
27566,विकिसमाचार,0,0,3,3
44096,viewers,0,0,3,3
17007,पाठ्यक्रम,0,0,3,3
27570,sammanhang,0,0,3,3
39808,tadić,0,0,3,3
1133,strettamente,1,3,0,3
39806,ಇದೆ,0,0,3,3
17020,золота,0,0,3,3
44110,fazladan,0,0,3,3
17022,வீடியோ,0,0,3,3
44114,redigerats,0,0,3,3
16993,colaborativos,0,0,3,3
34427,setting,0,0,3,3
44074,ഔട്പുട്ട്,0,0,3,3
16964,утверждал,0,0,3,3
39855,plaindre,0,0,3,3
16942,história,0,0,3,3
44047,sannolikt,0,0,3,3
11140,foiré,0,0,3,3
4949,incorporado,0,0,3,3
27539,apporter,0,0,3,3
16968,நடுவில்,0,0,3,3
39825,october,0,0,3,3
44063,απόψεις,0,0,3,3
44065,bacteria,0,0,3,3
24566,protected,0,0,3,3
11106,receio,0,0,3,3
32301,हिस्से,0,0,3,3
39828,maken,0,0,3,3
44120,individus,0,0,3,3
17034,historia,0,0,3,3
16764,apprend,0,0,3,3
44122,परवाह,0,0,3,3
27616,варенье,0,0,3,3
32258,kendine,0,0,3,3
3254,supporto,1,3,0,3
10984,التخريب،,0,0,3,3
39765,rocker,0,0,3,3
10980,εκπληκτική,0,0,3,3
1136,lì,1,3,0,3
32252,individuele,0,0,3,3
17094,الذكور,0,0,3,3
24510,ഓൺലൈൻ,0,0,3,3
10960,गुस्सा,0,0,3,3
32242,polémica,0,0,3,3
10954,spielt,0,0,3,3
39747,camelcase,0,0,3,3
39745,pesquisadores,0,0,3,3
34450,annesi,0,0,3,3
27611,ಏನೂ,0,0,3,3
39774,घटनाओं,0,0,3,3
11023,நபரை,0,0,3,3
32278,kritiserats,0,0,3,3
44125,ohne,0,0,3,3
11034,dil,0,0,3,3
27591,repetirlo,0,0,3,3
27592,தெரியவில்லை,0,0,3,3
27597,ситуацию,0,0,3,3
4178,deelnemers,0,0,3,3
10999,tells,0,0,3,3
44140,задачи,0,0,3,3
24532,عديدة,0,0,3,3
39781,l’aa,0,0,3,3
17065,சொன்னேன்,0,0,3,3
493,basso,1,3,0,3
24527,كذلك,0,0,3,3
32314,harcèlement,0,0,3,3
16935,சொந்த,0,0,3,3
4945,வாக்கியங்கள்,0,0,3,3
16922,गति,0,0,3,3
24658,ಹೇಳುತ್ತೇನೆ,0,0,3,3
11295,suivent,0,0,3,3
43945,ons,0,0,3,3
1911,interessante,2,1,2,3
32365,उनका,0,0,3,3
39945,प्रकल्प,0,0,3,3
27465,പോലും,0,0,3,3
27466,awesome,0,0,3,3
24649,gentils,0,0,3,3
32362,biais,0,0,3,3
4205,inspired,0,0,3,3
11272,ಸ್ಕೋರ್,0,0,3,3
43962,kelimeden,0,0,3,3
43966,atual,0,0,3,3
16827,പോലുള്ള,0,0,3,3
11298,تعديلات,0,0,3,3
11303,extrêmement,0,0,3,3
32373,प्यारे,0,0,3,3
32380,നോക്കി,0,0,3,3
24681,twitter,0,0,3,3
16766,नीति,0,0,3,3
11354,போகிறேன்,0,0,3,3
11352,advanced,0,0,3,3
27438,மதிப்பெண்,0,0,3,3
524,linguistiche,1,3,0,3
24676,atividades,0,0,3,3
16792,sociétés,0,0,3,3
43916,espécie,0,0,3,3
43921,ಟದ,0,0,3,3
11323,ದೇವರೇ,0,0,3,3
43923,doigts,0,0,3,3
34339,inaccuracies,0,0,3,3
4209,وتقول,0,0,3,3
34355,huvudsak,0,0,3,3
24646,economía,0,0,3,3
16832,образом,0,0,3,3
4936,diferenças,0,0,3,3
16885,nuevos,0,0,3,3
4933,razões,0,0,3,3
2239,matematica,1,3,0,3
34384,seek,0,0,3,3
44015,coordenar,0,0,3,3
11188,amerikanen,0,0,3,3
32328,publiées,0,0,3,3
4932,reverting,0,0,3,3
27514,bede,0,0,3,3
1123,originale,1,3,0,3
16906,ഉപയോക്താക്കൾക്ക്,0,0,3,3
39875,dames,0,0,3,3
32319,предложения,0,0,3,3
34396,टिप,0,0,3,3
32337,cinq,0,0,3,3
39897,ஒருவரை,0,0,3,3
16833,uppfyllelse,0,0,3,3
27488,üben,0,0,3,3
34358,visste,0,0,3,3
2890,associazione,1,3,0,3
43978,vijf,0,0,3,3
11249,नकारात्मक,0,0,3,3
24640,background,0,0,3,3
4926,play,0,0,3,3
11235,literalmente,0,0,3,3
34377,divertida,0,0,3,3
43988,स्थानांतरित,0,0,3,3
16850,κανάλι,0,0,3,3
43991,madrid,0,0,3,3
39919,organisation,0,0,3,3
43996,модели,0,0,3,3
34371,tarafsız,0,0,3,3
34154,ваше,0,0,3,3
16326,आधार,0,0,3,3
16323,intervention,0,0,3,3
15845,sådana,0,0,3,3
15801,पर्याप्त,0,0,3,3
40681,ಹೋಗಿ,0,0,3,3
1013,università,1,3,0,3
33979,clase,0,0,3,3
32782,örnekleri,0,0,3,3
43171,δοκιμάστε,0,0,3,3
43172,പോകുന്നു,0,0,3,3
4348,ei,0,0,3,3
15828,അവൾക്ക്,0,0,3,3
26899,بأنه,0,0,3,3
25160,thèmes,0,0,3,3
12358,முன்பு,0,0,3,3
15837,ವಿಭಿನ್ನ,0,0,3,3
642,terabyte,2,1,2,3
1017,testo,1,3,0,3
26888,considers,0,0,3,3
25178,consequence,0,0,3,3
40691,lição,0,0,3,3
15776,விஷயம்,0,0,3,3
40710,acquis,0,0,3,3
12427,фразу,0,0,3,3
43129,ಕೇಳಿದ್ದೀರಿ,0,0,3,3
4354,posé,0,0,3,3
12422,العلماء,0,0,3,3
15775,speed,0,0,3,3
33965,المثيرة,0,0,3,3
43151,يسمى,0,0,3,3
43138,voraus,0,0,3,3
12409,ton,0,0,3,3
12406,allerede,0,0,3,3
25181,செய்கிறீர்கள்,0,0,3,3
26884,density,0,0,3,3
33971,kovitz,0,0,3,3
40653,oración,0,0,3,3
15847,ನಂಬರ್,0,0,3,3
16320,عملية,0,0,3,3
15854,mag,0,0,3,3
12289,samstag,0,0,3,3
43232,gift,0,0,3,3
34011,ஏதேனும்,0,0,3,3
43235,correspondiente,0,0,3,3
636,ricevuto,1,3,0,3
634,commerciale,2,2,1,3
4335,komen,0,0,3,3
26944,méthode,0,0,3,3
12268,கடவுளே,0,0,3,3
2953,notizie,1,3,0,3
12265,بوابة,0,0,3,3
34020,cumplen,0,0,3,3
12258,observable,0,0,3,3
43252,affirme,0,0,3,3
26951,learner,0,0,3,3
32750,posteriormente,0,0,3,3
32751,lille,0,0,3,3
12298,yoğun,0,0,3,3
1019,usi,1,3,0,3
641,fortemente,2,1,2,3
15857,participation,0,0,3,3
32763,genug,0,0,3,3
32759,считается,0,0,3,3
1018,citate,1,3,0,3
26923,élèves,0,0,3,3
40633,formuleringar,0,0,3,3
43215,வீட்டில்,0,0,3,3
26926,zoveel,0,0,3,3
12315,അവ,0,0,3,3
40630,tijdschriften,0,0,3,3
33998,ಇರುವ,0,0,3,3
12310,ಅದ್ಭುತವಾದ,0,0,3,3
12308,production,0,0,3,3
3178,oppure,1,3,0,3
43121,supplémentaire,0,0,3,3
40722,അധികം,0,0,3,3
43119,systematic,0,0,3,3
15609,usual,0,0,3,3
33900,seit,0,0,3,3
26790,precipitation,0,0,3,3
1983,aperta,1,3,0,3
40825,ينزعج,0,0,3,3
26795,некоторым,0,0,3,3
33909,സ്വതന്ത്രവും,0,0,3,3
15631,cher,0,0,3,3
25269,actúan,0,0,3,3
26801,woman,0,0,3,3
3170,markup,2,2,1,3
12563,बनी,0,0,3,3
15635,ഓരോ,0,0,3,3
32850,southern,0,0,3,3
33914,политики,0,0,3,3
26783,değişiklik,0,0,3,3
26782,άπταιστα,0,0,3,3
12595,सहित,0,0,3,3
42985,gemiddeld,0,0,3,3
671,ultima,1,3,0,3
26761,saknas,0,0,3,3
42977,capable,0,0,3,3
12632,editados,0,0,3,3
12629,internetleverantörer,0,0,3,3
26767,ios,0,0,3,3
25296,മുന്നോട്ട്,0,0,3,3
12596,anything,0,0,3,3
992,premi,1,3,0,3
33891,друг,0,0,3,3
40842,verden,0,0,3,3
15592,criado,0,0,3,3
12600,derfor,0,0,3,3
43002,знал,0,0,3,3
43038,äußerst,0,0,3,3
32845,actividades,0,0,3,3
12547,humain,0,0,3,3
32813,sagt,0,0,3,3
43087,historically,0,0,3,3
1009,poche,1,3,0,3
40752,decisão,0,0,3,3
43093,variable,0,0,3,3
32814,அதைச்,0,0,3,3
33938,utilizado,0,0,3,3
25220,läuft,0,0,3,3
2167,dispositivi,1,3,0,3
32812,licens,0,0,3,3
26850,serem,0,0,3,3
43102,n’a,0,0,3,3
1979,light,2,1,2,3
40729,lisansı,0,0,3,3
43118,innefattar,0,0,3,3
15702,query,0,0,3,3
25229,через,0,0,3,3
25256,две,0,0,3,3
32827,interested,0,0,3,3
15665,catalan,0,0,3,3
4369,ಹೇಳುವ,0,0,3,3
12525,transaction,0,0,3,3
32834,kunna,0,0,3,3
43066,featured,0,0,3,3
12511,gaf,0,0,3,3
25238,ваши,0,0,3,3
4774,давно,0,0,3,3
25236,النرجس,0,0,3,3
40769,программного,0,0,3,3
32823,começar,0,0,3,3
12495,précise,0,0,3,3
12494,despite,0,0,3,3
43077,αναμμένο,0,0,3,3
26952,ಗಾಡಿಯಲ್ಲಿ,0,0,3,3
15927,counterproductive,0,0,3,3
32736,مراجعة,0,0,3,3
40446,esperar,0,0,3,3
43471,вялым,0,0,3,3
34103,gemensam,0,0,3,3
43476,ذلك؟,0,0,3,3
43479,grados,0,0,3,3
11955,கொண்டுள்ளது,0,0,3,3
11950,discover,0,0,3,3
16185,appear,0,0,3,3
40405,अंतिम,0,0,3,3
43491,incomodálo,0,0,3,3
11934,minder,0,0,3,3
32600,ನೀಡುತ್ತೇನೆ,0,0,3,3
4303,obtenez,0,0,3,3
2926,servizio,1,3,0,3
43501,लेने,0,0,3,3
16199,träffa,0,0,3,3
27121,fuentes,0,0,3,3
4832,परीक्षण,0,0,3,3
16169,கொள்க,0,0,3,3
32627,leve,0,0,3,3
12019,возможно,0,0,3,3
4311,моем,0,0,3,3
43433,comparable,0,0,3,3
16142,raíz,0,0,3,3
32631,gece,0,0,3,3
16151,fora,0,0,3,3
43448,alternativas,0,0,3,3
27116,മിക്കവാറും,0,0,3,3
11988,الموضوع,0,0,3,3
40424,γουέιλς,0,0,3,3
27109,haga,0,0,3,3
32618,esteja,0,0,3,3
1057,prova,2,2,1,3
32616,looks,0,0,3,3
27141,included,0,0,3,3
1949,fatti,1,3,0,3
40391,indem,0,0,3,3
34146,«wikipedia»,0,0,3,3
40338,nommée,0,0,3,3
3200,xx,2,1,2,3
16281,निर्मित,0,0,3,3
24937,επιτρέψτε,0,0,3,3
11840,அம்மாவிடம்,0,0,3,3
40326,förekommer,0,0,3,3
24928,miljoner,0,0,3,3
24945,hambre,0,0,3,3
16303,evolved,0,0,3,3
43579,provient,0,0,3,3
27205,getan,0,0,3,3
43584,каждого,0,0,3,3
11818,mutually,0,0,3,3
43588,объясняет,0,0,3,3
38756,langsomt,0,0,3,3
32567,όνομα,0,0,3,3
16209,الإطلاق,0,0,3,3
1066,costruzione,1,3,0,3
4302,themselves,0,0,3,3
32590,básicos,0,0,3,3
24976,belangrijk,0,0,3,3
16215,ترخيص,0,0,3,3
32582,entered,0,0,3,3
24971,वृत्तचित्र,0,0,3,3
43532,italien,0,0,3,3
40345,والدتها,0,0,3,3
24965,ampla,0,0,3,3
11885,décisions,0,0,3,3
27168,raise,0,0,3,3
43541,கொண்ட,0,0,3,3
2920,intende,1,3,0,3
16258,vanavond,0,0,3,3
40445,م,0,0,3,3
12022,скажите,0,0,3,3
12246,administratörerna,0,0,3,3
2929,nello,1,3,0,3
25089,escuela,0,0,3,3
26984,sad,0,0,3,3
40558,stören,0,0,3,3
32712,creating,0,0,3,3
15984,അവരെ,0,0,3,3
25082,ಮಾರ್ಗವೆಂದರೆ,0,0,3,3
15988,sweet,0,0,3,3
1031,distribuzione,1,3,0,3
2942,accuratezza,1,3,0,3
32702,renderização,0,0,3,3
27006,analytique,0,0,3,3
16005,acquérir,0,0,3,3
16006,ήδη,0,0,3,3
32694,kategorier,0,0,3,3
16015,ಬಹುಶಃ,0,0,3,3
15964,ángel,0,0,3,3
12206,whatever,0,0,3,3
12207,carefully,0,0,3,3
40568,ιδέα,0,0,3,3
32735,nsa,0,0,3,3
15931,desarrollar,0,0,3,3
12240,الويكي،,0,0,3,3
15946,substantiv,0,0,3,3
15952,பதிவு,0,0,3,3
40569,επαναλάβετε,0,0,3,3
32726,pollution,0,0,3,3
26976,صحيفة,0,0,3,3
15956,क्षेत्र,0,0,3,3
43278,सुनिश्चित,0,0,3,3
43279,hemmelige,0,0,3,3
12213,ejercicio,0,0,3,3
26974,nasılsın,0,0,3,3
12209,manières,0,0,3,3
16018,décontenancé,0,0,3,3
25064,utilizadas,0,0,3,3
40521,array,0,0,3,3
12048,justo,0,0,3,3
27053,மேற்பட்ட,0,0,3,3
16084,composition,0,0,3,3
32666,autour,0,0,3,3
12065,intonation,0,0,3,3
34080,صفحات,0,0,3,3
16099,jou,0,0,3,3
34084,занят,0,0,3,3
40481,dijo,0,0,3,3
16113,görs,0,0,3,3
12036,bald,0,0,3,3
32645,keek,0,0,3,3
16119,construção,0,0,3,3
1052,miglior,1,3,0,3
25014,eliminación,0,0,3,3
43384,நிலத்தில்,0,0,3,3
43381,experto,0,0,3,3
16028,боже,0,0,3,3
12110,underrepresented,0,0,3,3
4320,मल्टीमीडिया,0,0,3,3
27029,piece,0,0,3,3
40513,vanligaste,0,0,3,3
12116,dinge,0,0,3,3
12113,enmwikipediaorg,0,0,3,3
32685,diskussion,0,0,3,3
43359,inspirados,0,0,3,3
3191,knowledgebased,2,2,1,3
12107,содержимое,0,0,3,3
12106,prensa,0,0,3,3
16050,plateforme,0,0,3,3
610,originali,1,3,0,3
16062,bygger,0,0,3,3
16070,ஆகிய,0,0,3,3
28395,ampliar,0,0,3,3
26000,снова,0,0,3,3
28397,aussehen,0,0,3,3
47269,spiel,0,0,3,3
1754,breiman,2,1,2,3
29844,locales,0,0,3,3
21192,klingen,0,0,3,3
29847,kızı,0,0,3,3
29848,utvalda,0,0,3,3
47278,identification,0,0,3,3
8244,bunlar,0,0,3,3
28987,derece,0,0,3,3
6559,لإزعاجك,0,0,3,3
22455,ಕೊನೆಯ,0,0,3,3
6555,somme,0,0,3,3
31259,heilman,0,0,3,3
30624,gostaria,0,0,3,3
23246,grundare,0,0,3,3
8250,കാണും,0,0,3,3
30621,thématique,0,0,3,3
6547,προσπάθεια,0,0,3,3
19629,récemment,0,0,3,3
36833,améliorer,0,0,3,3
37964,பார்த்துக்,0,0,3,3
22448,annonce,0,0,3,3
31265,almindelige,0,0,3,3
92,cunningham,2,2,1,3
5312,daumen,0,0,3,3
47295,заранее,0,0,3,3
28994,bile,0,0,3,3
47268,പേര്,0,0,3,3
5311,கற்றுக்,0,0,3,3
8230,pequeña,0,0,3,3
19681,instalación,0,0,3,3
30640,surtout,0,0,3,3
6593,जरुरत,0,0,3,3
19678,особенно,0,0,3,3
36862,serious,0,0,3,3
31244,skillnader,0,0,3,3
5319,låta,0,0,3,3
19675,age,0,0,3,3
35389,showed,0,0,3,3
21172,السبت,0,0,3,3
22468,liefste,0,0,3,3
3524,milione,1,3,0,3
30635,redo,0,0,3,3
5318,chacune,0,0,3,3
8213,शीर्षक,0,0,3,3
46081,हाँ,0,0,3,3
35381,nå,0,0,3,3
23235,manske,0,0,3,3
36854,sollten,0,0,3,3
8220,explosion,0,0,3,3
23237,participação,0,0,3,3
31249,pessoal,0,0,3,3
21184,biomass,0,0,3,3
28998,americanos,0,0,3,3
47267,ίδρυμα,0,0,3,3
23254,står,0,0,3,3
21221,weight,0,0,3,3
36773,λογισμικού,0,0,3,3
2470,provenienza,1,3,0,3
21276,ouvindo,0,0,3,3
35347,propias,0,0,3,3
35346,rey,0,0,3,3
45999,développe,0,0,3,3
38013,chris,0,0,3,3
45998,donnée,0,0,3,3
23285,visa,0,0,3,3
19555,ojos,0,0,3,3
8342,özür,0,0,3,3
2690,pochi,1,3,0,3
19547,tanrım,0,0,3,3
88,presupposto,1,3,0,3
35340,духе,0,0,3,3
21281,catégorie,0,0,3,3
8352,ವರ್ಡ್,0,0,3,3
21284,cabida,0,0,3,3
19539,sine,0,0,3,3
248,significativa,2,1,2,3
8359,fully,0,0,3,3
1685,molte,1,3,0,3
6469,senere,0,0,3,3
38030,contents,0,0,3,3
21289,soru,0,0,3,3
22413,newspaper,0,0,3,3
31299,kabul,0,0,3,3
6485,commencé,0,0,3,3
46009,afirmou,0,0,3,3
19618,nio,0,0,3,3
8319,procesos,0,0,3,3
28972,narcissism,0,0,3,3
21224,entendeu,0,0,3,3
6526,abend,0,0,3,3
1397,affermato,1,3,0,3
35369,voorbeelden,0,0,3,3
31275,ecology,0,0,3,3
5309,vind,0,0,3,3
8282,mensen,0,0,3,3
1395,mie,1,3,0,3
35367,biotic,0,0,3,3
28962,değilim,0,0,3,3
21235,generate,0,0,3,3
30609,termo,0,0,3,3
29874,phénomènes,0,0,3,3
21241,característica,0,0,3,3
19596,φαγητά,0,0,3,3
21248,ಧನ್ಯವಾದ,0,0,3,3
31285,amounts,0,0,3,3
36802,sitting,0,0,3,3
8304,bugün,0,0,3,3
21259,செல்லலாம்,0,0,3,3
6495,गणित,0,0,3,3
19577,seres,0,0,3,3
1393,esiste,1,3,0,3
30593,भ्रमित,0,0,3,3
23221,periódico,0,0,3,3
2464,pubblicazione,1,3,0,3
31238,ona,0,0,3,3
6689,одном,0,0,3,3
35904,ethical,0,0,3,3
5523,recuerda,0,0,3,3
19813,bilmiyorum,0,0,3,3
228,stasera,1,3,0,3
37818,collected,0,0,3,3
46203,value,0,0,3,3
2379,probabilistico,1,3,0,3
22500,feita,0,0,3,3
19808,என்னவென்றால்,0,0,3,3
6676,atmospheric,0,0,3,3
23153,oorspronkelijke,0,0,3,3
47196,प्रयुक्त,0,0,3,3
47200,officielle,0,0,3,3
8067,قام,0,0,3,3
46192,opfyldelse,0,0,3,3
1423,bradley,2,1,2,3
47203,responsáveis,0,0,3,3
37828,भेज,0,0,3,3
8071,verklaart,0,0,3,3
21102,പറയാനുള്ള,0,0,3,3
2463,prendi,1,3,0,3
21108,speciellt,0,0,3,3
36898,forget,0,0,3,3
30667,ശൈലികൾ,0,0,3,3
21114,sump,0,0,3,3
22506,നൽകും,0,0,3,3
19825,existencia,0,0,3,3
31237,മാർഗ്ഗം,0,0,3,3
47185,hiérarchie,0,0,3,3
47164,തുടർന്ന്,0,0,3,3
35457,चैनल,0,0,3,3
21058,ಬದಲು,0,0,3,3
23129,mooi,0,0,3,3
8002,gefragt,0,0,3,3
19858,आसानी,0,0,3,3
23130,build,0,0,3,3
19850,വെബ്,0,0,3,3
46230,lördag,0,0,3,3
30687,maten,0,0,3,3
37794,мое,0,0,3,3
37795,vocabulaire,0,0,3,3
36928,television,0,0,3,3
23136,roughly,0,0,3,3
29098,actes,0,0,3,3
35450,திருமணம்,0,0,3,3
6704,говорил,0,0,3,3
47176,answers,0,0,3,3
21074,located,0,0,3,3
36920,besökare,0,0,3,3
8032,suggested,0,0,3,3
47178,تيري,0,0,3,3
36919,arruiné,0,0,3,3
35902,distintas,0,0,3,3
8035,kvalitet,0,0,3,3
22493,концу,0,0,3,3
29802,американцы,0,0,3,3
23170,piada,0,0,3,3
6650,чувствую,0,0,3,3
21140,verbetes,0,0,3,3
37887,exibido,0,0,3,3
6621,zaterdag,0,0,3,3
19724,insanların,0,0,3,3
35403,πλημμυρίσει,0,0,3,3
21150,lema,0,0,3,3
23207,вот,0,0,3,3
46121,पहुँच,0,0,3,3
37902,reveal,0,0,3,3
35925,പ്രിയപ്പെട്ട,0,0,3,3
3522,argomento,1,3,0,3
37904,gama,0,0,3,3
8163,härter,0,0,3,3
36869,l’enseignement,0,0,3,3
29027,тоже,0,0,3,3
46115,color,0,0,3,3
19704,αργά,0,0,3,3
21160,distingue,0,0,3,3
8172,opposite,0,0,3,3
2677,aperto,1,3,0,3
1404,contributi,1,3,0,3
6600,animales,0,0,3,3
36863,selvfølgelig,0,0,3,3
37919,فوق,0,0,3,3
21167,bununla,0,0,3,3
46135,davon,0,0,3,3
47233,paintings,0,0,3,3
29040,മനോഹരമായ,0,0,3,3
35421,résoudre,0,0,3,3
23171,speaker,0,0,3,3
100,zona,2,2,1,3
23173,estudos,0,0,3,3
8093,मूर्ख,0,0,3,3
1414,hoiberg,2,1,2,3
31205,special,0,0,3,3
46170,ذهبية,0,0,3,3
36890,يعمل,0,0,3,3
37854,είχα,0,0,3,3
21123,skett,0,0,3,3
46166,понял,0,0,3,3
19762,استمر,0,0,3,3
37882,biográficos,0,0,3,3
2575,costo,1,3,0,3
6639,cheer,0,0,3,3
8115,zero,0,0,3,3
29810,capacités,0,0,3,3
31213,machst,0,0,3,3
23184,вопросу,0,0,3,3
5533,edebilir,0,0,3,3
46148,möjligt,0,0,3,3
29048,पाठक,0,0,3,3
35418,விட,0,0,3,3
29046,acımasız,0,0,3,3
8370,прямо,0,0,3,3
36772,degree,0,0,3,3
46244,प्रेरित,0,0,3,3
45822,móvel,0,0,3,3
19325,εξαιρετικά,0,0,3,3
19324,économiques,0,0,3,3
3406,prove,2,1,2,3
36669,विशेषज्ञ,0,0,3,3
36018,birine,0,0,3,3
23400,olmayan,0,0,3,3
3405,smartphone,2,1,2,3
6281,सुन,0,0,3,3
45811,यूट्यूब,0,0,3,3
21446,dichotomie,0,0,3,3
8599,взаимодействия,0,0,3,3
36019,இருக்கிறார்,0,0,3,3
47474,தங்கள்,0,0,3,3
1779,solamente,2,1,2,3
22332,साईट,0,0,3,3
8606,herramientas,0,0,3,3
21453,ഉപയോഗിക്കാം,0,0,3,3
36659,सुंदरता,0,0,3,3
3901,extended,0,0,3,3
35258,കഠിനാധ്വാനം,0,0,3,3
38198,wollen,0,0,3,3
30528,hacker,0,0,3,3
8613,aparte,0,0,3,3
45803,símbolos,0,0,3,3
28807,sabia,0,0,3,3
6289,مشاكل,0,0,3,3
36674,anında,0,0,3,3
8621,प्रतिपादन,0,0,3,3
29972,ഡിഗ്രിയിൽ,0,0,3,3
8538,لديه,0,0,3,3
21406,utrymme,0,0,3,3
8539,وداعًا,0,0,3,3
35279,dominante,0,0,3,3
8543,estávamos,0,0,3,3
36687,items,0,0,3,3
8546,பிரமாதமானது,0,0,3,3
45847,volonté,0,0,3,3
38161,которым,0,0,3,3
8550,females,0,0,3,3
19355,störa,0,0,3,3
5563,agriculture,0,0,3,3
5271,«нупедия»,0,0,3,3
19347,εκείνη,0,0,3,3
19346,readership,0,0,3,3
45834,जुलाई,0,0,3,3
47451,förstå,0,0,3,3
22348,говоришь,0,0,3,3
8569,strength,0,0,3,3
6302,ನಿರರ್ಗಳವಾಗಿ,0,0,3,3
8575,bonjour,0,0,3,3
47457,später,0,0,3,3
19330,jantar,0,0,3,3
8580,frygtelig,0,0,3,3
21428,करो,0,0,3,3
45798,நாளை,0,0,3,3
45797,sino,0,0,3,3
1571,risposta,1,3,0,3
8667,دخلت,0,0,3,3
19245,ವಾರಾಂತ್ಯದಲ್ಲಿ,0,0,3,3
8674,devenir,0,0,3,3
22309,задач,0,0,3,3
38255,drawn,0,0,3,3
35233,automatically,0,0,3,3
8683,l’algorithme,0,0,3,3
30516,natureza,0,0,3,3
30515,marcas,0,0,3,3
3651,presente,2,1,2,3
278,venuto,1,3,0,3
3650,sembrava,1,3,0,3
23450,بحاجة,0,0,3,3
47511,pond,0,0,3,3
5571,σίγουρος,0,0,3,3
6218,universitaire,0,0,3,3
19221,advertising,0,0,3,3
45748,orolig,0,0,3,3
6209,sidste,0,0,3,3
23457,ಎಲ್ಲಾ,0,0,3,3
1335,varietà,1,3,0,3
19211,seinen,0,0,3,3
36609,représentations,0,0,3,3
36607,subset,0,0,3,3
36050,estudiantes,0,0,3,3
36605,желание,0,0,3,3
36636,نظام,0,0,3,3
8665,दिए,0,0,3,3
23413,يطلب,0,0,3,3
6241,நீண்ட,0,0,3,3
3402,scritta,1,3,0,3
273,proprietà,1,3,0,3
36651,कार्यों,0,0,3,3
23417,abone,0,0,3,3
8632,lucrativos,0,0,3,3
1354,semi,1,3,0,3
29994,fréquemment,0,0,3,3
8634,ക്ഷമിക്കൂ,0,0,3,3
29995,صغيرة,0,0,3,3
8638,episódios,0,0,3,3
5256,hadi,0,0,3,3
31402,lång,0,0,3,3
35251,vingers,0,0,3,3
36648,എനിക്കറിയില്ല,0,0,3,3
6250,سوف,0,0,3,3
21471,basin,0,0,3,3
1348,caratteristica,1,3,0,3
47497,थीं।,0,0,3,3
6246,нейросети,0,0,3,3
19260,μυστική,0,0,3,3
19258,databases,0,0,3,3
6244,falsa,0,0,3,3
35243,bisschen,0,0,3,3
23437,innehåller,0,0,3,3
31413,jan,0,0,3,3
23380,ಹೋಗೋಣ,0,0,3,3
38152,revisões,0,0,3,3
28841,ماريان,0,0,3,3
36753,ഓൺ‌ലൈൻ,0,0,3,3
35320,fritt,0,0,3,3
3870,anunció,0,0,3,3
31322,chorar,0,0,3,3
22394,dinheiro,0,0,3,3
29925,aucune,0,0,3,3
28905,pornographic,0,0,3,3
6415,skrivs,0,0,3,3
23326,lag,0,0,3,3
6413,propósito,0,0,3,3
8428,importancia,0,0,3,3
6411,κοίταξε,0,0,3,3
22387,люди,0,0,3,3
8434,interesses,0,0,3,3
45930,fort,0,0,3,3
29931,doce,0,0,3,3
23335,distributed,0,0,3,3
22384,गए।,0,0,3,3
36735,صحيح,0,0,3,3
45921,woher,0,0,3,3
1766,globale,2,1,2,3
38096,currently,0,0,3,3
6397,havalı,0,0,3,3
8453,давайте,0,0,3,3
6394,saker,0,0,3,3
47399,மட்டும்,0,0,3,3
6424,கொடூரமானது,0,0,3,3
36754,الصوت,0,0,3,3
36699,globally,0,0,3,3
6428,வந்தது,0,0,3,3
31302,बनाती,0,0,3,3
6452,машинное,0,0,3,3
31303,disputed,0,0,3,3
8376,combatir,0,0,3,3
22409,encyklopædi,0,0,3,3
6449,barnpornografi,0,0,3,3
30578,knew,0,0,3,3
35333,eliminar,0,0,3,3
6447,grundades,0,0,3,3
8386,originalmente,0,0,3,3
38047,gäller,0,0,3,3
3674,incredibile,1,3,0,3
5298,откуда,0,0,3,3
47366,περιεχομένου,0,0,3,3
19509,रास्ता,0,0,3,3
29918,hombre,0,0,3,3
19506,doet,0,0,3,3
45958,listen,0,0,3,3
8395,gek,0,0,3,3
6435,ಒಳ್ಳೆಯ,0,0,3,3
253,perdita,1,3,0,3
23309,അടുത്തേക്ക്,0,0,3,3
47378,ánimo,0,0,3,3
38060,pesquisador,0,0,3,3
8405,ಎಲ್ಲಿದ್ದೇವೆ,0,0,3,3
8462,observaciones,0,0,3,3
19436,contas,0,0,3,3
31342,idé,0,0,3,3
5284,afbeeldingen,0,0,3,3
23366,schrecklich,0,0,3,3
1582,insulto,2,1,2,3
266,pubblica,1,3,0,3
2549,x,2,1,2,3
8505,sesgo,0,0,3,3
8506,permission,0,0,3,3
31362,comentário,0,0,3,3
47425,taget,0,0,3,3
19391,género,0,0,3,3
267,carta,2,2,1,3
29950,அல்ல,0,0,3,3
47428,negativ,0,0,3,3
45869,നിന്നാണ്,0,0,3,3
38138,pontuação,0,0,3,3
5273,ещё,0,0,3,3
6337,banklån,0,0,3,3
19388,भूगोल,0,0,3,3
6332,встречи,0,0,3,3
47435,encuentro,0,0,3,3
45864,moves,0,0,3,3
6329,believed,0,0,3,3
23373,traitement,0,0,3,3
38149,பிஸியாக,0,0,3,3
38151,nok,0,0,3,3
6327,—y,0,0,3,3
3888,verá,0,0,3,3
1364,stesse,1,3,0,3
6354,άντρας,0,0,3,3
23351,kendi,0,0,3,3
28878,faktiskt,0,0,3,3
6385,memory,0,0,3,3
19433,viewed,0,0,3,3
6380,பயனர்,0,0,3,3
28876,siz,0,0,3,3
36720,множество,0,0,3,3
23346,grundläggande,0,0,3,3
47408,robotskapade,0,0,3,3
19430,granskning,0,0,3,3
21370,कोलबर्ट,0,0,3,3
19425,citizen,0,0,3,3
6368,место,0,0,3,3
1675,randy,1,3,0,3
30558,الويب,0,0,3,3
22368,entrées,0,0,3,3
23353,unseen,0,0,3,3
23355,θέλει,0,0,3,3
38119,പൊതുവേ,0,0,3,3
19412,அவற்றின்,0,0,3,3
38121,ಮಾತ್ರ,0,0,3,3
8494,fortsätta,0,0,3,3
6361,host,0,0,3,3
28858,economics,0,0,3,3
47417,εξηγεί,0,0,3,3
29767,ol,0,0,3,3
47159,تقريبًا,0,0,3,3
6199,yi,0,0,3,3
7492,torna,0,0,3,3
3746,centinaia,1,3,0,3
7498,ótimo,0,0,3,3
46596,reconnaître,0,0,3,3
30828,kjole,0,0,3,3
7072,refer,0,0,3,3
20714,olhos,0,0,3,3
7510,κουρασμένοι,0,0,3,3
29590,täcka,0,0,3,3
37175,lyder,0,0,3,3
7514,возьми,0,0,3,3
1519,tali,1,3,0,3
46915,पड़ता,0,0,3,3
35604,environnementaux,0,0,3,3
20721,पोशाक,0,0,3,3
35602,forklarer,0,0,3,3
20726,provided,0,0,3,3
30993,αυτόν,0,0,3,3
2415,circa,2,2,1,3
29598,minnesota,0,0,3,3
30817,हे,0,0,3,3
46571,vilja,0,0,3,3
1470,yongle,2,1,2,3
20255,رفاق,0,0,3,3
35778,prática,0,0,3,3
37498,éthique,0,0,3,3
7493,большинство,0,0,3,3
35609,требует,0,0,3,3
22679,métaphysique,0,0,3,3
46902,luisterde,0,0,3,3
35630,sırasında,0,0,3,3
35628,ഏത്,0,0,3,3
35627,spécifiques,0,0,3,3
22711,científico,0,0,3,3
7459,dedicada,0,0,3,3
35625,voyez,0,0,3,3
20328,φαινόταν,0,0,3,3
20678,contribuer,0,0,3,3
30836,мои,0,0,3,3
46618,modificar,0,0,3,3
37444,кнопку,0,0,3,3
20314,husk,0,0,3,3
37456,сайта,0,0,3,3
37457,älskar,0,0,3,3
7090,annulations,0,0,3,3
5468,apparaît,0,0,3,3
30834,dress,0,0,3,3
7480,ಮುಂದೆ,0,0,3,3
20691,gruwelijke,0,0,3,3
20304,freedom,0,0,3,3
3785,название,0,0,3,3
46898,oldukça,0,0,3,3
35613,ಮುಂದುವರಿಯಿರಿ,0,0,3,3
37191,fejl,0,0,3,3
20295,gråter,0,0,3,3
7044,материалов,0,0,3,3
37503,कृपया,0,0,3,3
20179,skrivna,0,0,3,3
29311,ruim,0,0,3,3
37531,cambió,0,0,3,3
20207,ಅವರ,0,0,3,3
22951,kocaman,0,0,3,3
29308,august,0,0,3,3
22659,doivent,0,0,3,3
31024,pleurer,0,0,3,3
37534,aktualitet,0,0,3,3
20782,நுபீடியாவிற்கு,0,0,3,3
3738,brand,2,1,2,3
7596,potencialmente,0,0,3,3
7598,security,0,0,3,3
20201,கீழே,0,0,3,3
35796,идти,0,0,3,3
7602,paniqué,0,0,3,3
46516,automatisch,0,0,3,3
7604,ämnet,0,0,3,3
20199,прав,0,0,3,3
46971,repetidas,0,0,3,3
7608,μαρία,0,0,3,3
7611,nadat,0,0,3,3
20792,بطلاقة,0,0,3,3
1525,identifica,2,2,1,3
20794,midt,0,0,3,3
46973,enviarle,0,0,3,3
37124,stoor,0,0,3,3
35583,എന്നോട്,0,0,3,3
20777,அடிக்கடி,0,0,3,3
35781,malgré,0,0,3,3
46962,organisatie,0,0,3,3
22671,abaixo,0,0,3,3
7028,अलविदा,0,0,3,3
20241,ಮಾಡುತ್ತೀರಿ,0,0,3,3
5474,brug,0,0,3,3
22931,الأول,0,0,3,3
30803,könntest,0,0,3,3
30801,ഒബ്ട്യൂസ്,0,0,3,3
20234,feet,0,0,3,3
7021,равно,0,0,3,3
46544,vinklat,0,0,3,3
46542,φάω,0,0,3,3
20764,threshold,0,0,3,3
29620,passive,0,0,3,3
37516,изображения,0,0,3,3
37140,sigan,0,0,3,3
30798,ഇതാണ്,0,0,3,3
29624,अधिकार,0,0,3,3
20220,используются,0,0,3,3
37521,вялый,0,0,3,3
7008,основе,0,0,3,3
31020,üzerinde,0,0,3,3
46957,présent,0,0,3,3
46958,advertisements,0,0,3,3
20773,mener,0,0,3,3
7001,अत्याचार,0,0,3,3
7453,متطوعين,0,0,3,3
46628,scorpions,0,0,3,3
20668,dinlemiyordum,0,0,3,3
46726,obtener,0,0,3,3
20578,noyau,0,0,3,3
7312,usados,0,0,3,3
29446,classement,0,0,3,3
46723,reviewed,0,0,3,3
5446,لإنشاء,0,0,3,3
20458,खोज,0,0,3,3
29507,جدية,0,0,3,3
3491,necessariamente,2,2,1,3
46809,கொள்ள,0,0,3,3
20449,cofondateur,0,0,3,3
159,turista,2,1,2,3
7192,maj,0,0,3,3
161,canale,1,3,0,3
30925,characteristics,0,0,3,3
29512,artık,0,0,3,3
20434,सप्ताहांत,0,0,3,3
29433,थक,0,0,3,3
20596,объектами,0,0,3,3
7346,ήρθατε,0,0,3,3
20598,ഒപ്പം,0,0,3,3
37367,hårdare,0,0,3,3
29516,परीक्षा,0,0,3,3
30873,ganhou,0,0,3,3
2425,incomplete,2,1,2,3
37369,express,0,0,3,3
5445,zuilen,0,0,3,3
20466,normalt,0,0,3,3
37434,semelhante,0,0,3,3
37342,खराब,0,0,3,3
7252,baixos,0,0,3,3
7253,sista,0,0,3,3
20528,மதிய,0,0,3,3
22781,بالإضافة,0,0,3,3
20525,другое,0,0,3,3
29478,investigadores,0,0,3,3
46763,pegar,0,0,3,3
29480,несмотря,0,0,3,3
20535,laisse,0,0,3,3
37290,للجدل,0,0,3,3
22773,aquellas,0,0,3,3
35694,verifiability,0,0,3,3
22770,μήνυμα,0,0,3,3
46749,estarei,0,0,3,3
46747,мнения,0,0,3,3
37322,dünya,0,0,3,3
35716,άσε,0,0,3,3
20570,söyle,0,0,3,3
30885,അധിക,0,0,3,3
7293,asturias,0,0,3,3
20572,बच्चे,0,0,3,3
20477,verktyg,0,0,3,3
5434,знаний,0,0,3,3
20472,позднее,0,0,3,3
20577,verbaasd,0,0,3,3
20421,klinken,0,0,3,3
2615,conseguenza,1,3,0,3
46831,ideas,0,0,3,3
20607,സുഹൃത്തുക്കളുമായി,0,0,3,3
29400,provenant,0,0,3,3
29399,buscador,0,0,3,3
7409,décrire,0,0,3,3
7410,skriver,0,0,3,3
46655,tecnología,0,0,3,3
30955,portent,0,0,3,3
46874,visat,0,0,3,3
1484,piangere,1,3,0,3
46648,свидание,0,0,3,3
3471,latina,2,1,2,3
20359,ಯೋಜನೆಗಳನ್ನು,0,0,3,3
30962,användning,0,0,3,3
1482,usarlo,2,1,2,3
20355,encyclopédies,0,0,3,3
7433,middle,0,0,3,3
37213,तुलना,0,0,3,3
37426,suffer,0,0,3,3
7108,longterm,0,0,3,3
3750,principio,2,2,1,3
22881,ailleurs,0,0,3,3
35633,lastige,0,0,3,3
22885,வேலையில்,0,0,3,3
168,contro,1,3,0,3
7447,hungrig,0,0,3,3
22887,ವ್ಯಕ್ತಿ,0,0,3,3
29402,marais,0,0,3,3
3473,maniera,1,3,0,3
37400,menées,0,0,3,3
7155,aqueles,0,0,3,3
35662,conmigo,0,0,3,3
30869,градусов,0,0,3,3
29422,couverture,0,0,3,3
35738,மேல்,0,0,3,3
7161,kontroversiella,0,0,3,3
20617,πουλήσατε,0,0,3,3
20405,nivel,0,0,3,3
7369,miljoen,0,0,3,3
30864,signals,0,0,3,3
29535,व्यस्त,0,0,3,3
35656,servere,0,0,3,3
46683,примеры,0,0,3,3
7393,incluye,0,0,3,3
29536,சிறிது,0,0,3,3
35655,журналов,0,0,3,3
46679,करके,0,0,3,3
46677,ആവശ്യപ്പെടുന്നു,0,0,3,3
46676,glaciers,0,0,3,3
7381,сообщение,0,0,3,3
7384,record,0,0,3,3
37391,системы,0,0,3,3
37392,dereceden,0,0,3,3
7137,elke,0,0,3,3
37227,pornografia,0,0,3,3
22962,edwin,0,0,3,3
37121,திறந்த,0,0,3,3
37773,folk,0,0,3,3
29722,capaz,0,0,3,3
46333,ವಿದಾಯ,0,0,3,3
47100,αγαπητέ,0,0,3,3
5356,puisje,0,0,3,3
6800,adicional,0,0,3,3
7875,ενός,0,0,3,3
46330,पूछने,0,0,3,3
211,luogo,1,3,0,3
46327,utilización,0,0,3,3
213,chiamata,1,3,0,3
37710,tenderar,0,0,3,3
5355,καταπληκτικό,0,0,3,3
7887,αργότερα,0,0,3,3
36993,sunulmaktadır,0,0,3,3
35495,स्क्वीड,0,0,3,3
46320,وقد,0,0,3,3
7892,rubis,0,0,3,3
6791,toc,0,0,3,3
19957,cour,0,0,3,3
19953,சற்று,0,0,3,3
35490,primordial,0,0,3,3
7897,pasando,0,0,3,3
31125,criticou,0,0,3,3
2667,soldi,1,3,0,3
7903,επιπλέον,0,0,3,3
22558,olduğu,0,0,3,3
35858,syfte,0,0,3,3
20963,valt,0,0,3,3
20992,продали,0,0,3,3
35504,mathématique,0,0,3,3
35840,النهاية,0,0,3,3
37658,फ़्रिसियाई,0,0,3,3
6854,ursprung,0,0,3,3
20917,விரைவில்,0,0,3,3
7817,humanos,0,0,3,3
20026,विकिबुक्स,0,0,3,3
23045,ஒன்று,0,0,3,3
22585,ofensivo,0,0,3,3
29197,hablando,0,0,3,3
37030,पूछते,0,0,3,3
22579,additionally,0,0,3,3
46356,എന്തിനാണ്,0,0,3,3
37677,geldi,0,0,3,3
2589,copie,2,1,2,3
37682,ಮುಂಚಿತವಾಗಿ,0,0,3,3
29181,ಸೌಂದರ್ಯವನ್ನು,0,0,3,3
7850,nam,0,0,3,3
37686,« la,0,0,3,3
31115,perguntando,0,0,3,3
1737,angelo,1,3,0,3
1540,mangiarlo,1,3,0,3
6823,καρδιά,0,0,3,3
37690,surtei,0,0,3,3
19988,чемнибудь,0,0,3,3
22568,وصلت,0,0,3,3
36984,characters,0,0,3,3
6778,أربعة,0,0,3,3
6973,ഡാറ്റ,0,0,3,3
35477,умные,0,0,3,3
46270,hello,0,0,3,3
30699,üç,0,0,3,3
7960,frecuentemente,0,0,3,3
7961,apparence,0,0,3,3
7964,विकिस्रोत,0,0,3,3
37760,chercheurs,0,0,3,3
47147,തമ്മിൽ,0,0,3,3
46263,relação,0,0,3,3
21031,teste,0,0,3,3
19891,atroces,0,0,3,3
29758,entrevista,0,0,3,3
6741,servidor,0,0,3,3
29123,savoirs,0,0,3,3
19888,jay,0,0,3,3
6740,hé,0,0,3,3
35882,фраз,0,0,3,3
22531,reuters,0,0,3,3
37767,rede,0,0,3,3
21043,оно,0,0,3,3
2672,pubblicazioni,1,3,0,3
36944,tráfego,0,0,3,3
3518,chiedi,1,3,0,3
19879,topla,0,0,3,3
5348,officiel,0,0,3,3
29116,contribution,0,0,3,3
47144,écrire,0,0,3,3
36958,received,0,0,3,3
3829,authors,0,0,3,3
46277,studenten,0,0,3,3
46303,мотивации,0,0,3,3
214,tedesco,1,3,0,3
21003,declaraciones,0,0,3,3
46300,kanaal,0,0,3,3
22549,esos,0,0,3,3
21007,വിവരങ്ങൾ,0,0,3,3
37730,follows,0,0,3,3
19936,computadoras,0,0,3,3
19929,junio,0,0,3,3
37736,meest,0,0,3,3
21012,канал,0,0,3,3
31144,ഇതിനകം,0,0,3,3
36966,infantil,0,0,3,3
29143,μέρος,0,0,3,3
31146,συνηθισμένο,0,0,3,3
29746,प्रसिद्ध,0,0,3,3
37740,alternative,0,0,3,3
36964,oui,0,0,3,3
21019,लाभ,0,0,3,3
21020,incluant,0,0,3,3
2586,herring,2,2,1,3
7944,നാളെ,0,0,3,3
19914,welcome,0,0,3,3
19913,slate,0,0,3,3
22539,lektion,0,0,3,3
37656,uppgifter,0,0,3,3
47062,tillgänglig,0,0,3,3
29212,comunes,0,0,3,3
31047,oxygen,0,0,3,3
29274,sert,0,0,3,3
37096,குழப்பமான,0,0,3,3
31049,сообществе,0,0,3,3
35559,lå,0,0,3,3
37581,கடினமாக,0,0,3,3
46464,scherpe,0,0,3,3
7683,ಪರೀಕ್ಷೆಯಲ್ಲಿ,0,0,3,3
20837,सवार,0,0,3,3
37584,composé,0,0,3,3
1707,poiché,1,3,0,3
35815,buy,0,0,3,3
20840,सितम्बर,0,0,3,3
37586,ತೆಗೆದುಕೊಳ್ಳಬೇಡಿ,0,0,3,3
7690,beau,0,0,3,3
7691,possui,0,0,3,3
37589,desk,0,0,3,3
7696,marché,0,0,3,3
47014,konversationen,0,0,3,3
3726,jordan,2,2,1,3
7700,presenta,0,0,3,3
7701,публикаций,0,0,3,3
31055,ess,0,0,3,3
5380,angel,0,0,3,3
47023,telles,0,0,3,3
7718,films,0,0,3,3
1732,strumento,1,3,0,3
46474,onze,0,0,3,3
35526,ಪ್ರಿಯ,0,0,3,3
20144,high,0,0,3,3
46976,ανησυχείς,0,0,3,3
31034,кто,0,0,3,3
7630,robots,0,0,3,3
31036,mondial,0,0,3,3
31037,område,0,0,3,3
1526,modelli,1,3,0,3
20805,ficou,0,0,3,3
37115,étais,0,0,3,3
20172,confiáveis,0,0,3,3
129,nessun,1,3,0,3
46493,prazer,0,0,3,3
29289,aceso,0,0,3,3
22645,escrever,0,0,3,3
22968,vän,0,0,3,3
20164,tittar,0,0,3,3
6954,громадно,0,0,3,3
7652,machinaal,0,0,3,3
35808,venu,0,0,3,3
46482,richtig,0,0,3,3
20154,πειράζει,0,0,3,3
6945,contained,0,0,3,3
37567,présentes,0,0,3,3
5389,المثال،,0,0,3,3
20827,sizin,0,0,3,3
5387,lohnt,0,0,3,3
3805,ஏய்,0,0,3,3
46441,jaffe,0,0,3,3
20101,ಮಾಡಿ,0,0,3,3
35822,ann,0,0,3,3
29233,forskning,0,0,3,3
23018,observed,0,0,3,3
20895,representing,0,0,3,3
46411,உதாரணம்,0,0,3,3
35535,доступны,0,0,3,3
37630,порядке,0,0,3,3
5371,ihn,0,0,3,3
20068,besøgt,0,0,3,3
37632,herramienta,0,0,3,3
202,esperimento,1,3,0,3
47055,συμβουλή,0,0,3,3
46406,fossil,0,0,3,3
37050,gerne,0,0,3,3
7776,сделали,0,0,3,3
30745,बन,0,0,3,3
23027,горит,0,0,3,3
35530,tidsskriftet,0,0,3,3
20906,escribir,0,0,3,3
35838,lançou,0,0,3,3
23032,bunların,0,0,3,3
7793,organisations,0,0,3,3
20044,вечером,0,0,3,3
20041,upptagen,0,0,3,3
7801,أصدقاؤك,0,0,3,3
20913,exemples,0,0,3,3
29236,круто,0,0,3,3
35832,zacht,0,0,3,3
31074,devenues,0,0,3,3
30755,swamp,0,0,3,3
6908,endereços,0,0,3,3
29253,ಅಮೆರಿಕನ್ನರು,0,0,3,3
47030,oraciones,0,0,3,3
37609,dilde,0,0,3,3
22624,കഴിഞ്ഞില്ല,0,0,3,3
3807,лучший,0,0,3,3
29249,போலவே,0,0,3,3
5375,perspektiv,0,0,3,3
35827,вещи,0,0,3,3
29248,വാക്കുകളും,0,0,3,3
29246,arbeitet,0,0,3,3
2401,numerosi,1,3,0,3
46419,उससे,0,0,3,3
20882,выходные,0,0,3,3
37616,wap,0,0,3,3
29680,employé,0,0,3,3
20883,redigeringskrig,0,0,3,3
20884,conteúdos,0,0,3,3
29683,utöver,0,0,3,3
23012,doğruluğu,0,0,3,3
35540,شعبية,0,0,3,3
7748,للتخريب,0,0,3,3
20077,waardoor,0,0,3,3
7752,dra,0,0,3,3
19204,alemã,0,0,3,3
5301,forskningspublikationer,0,0,3,3
19202,ஆச்சரியமாக,0,0,3,3
5947,wikiwand,0,0,3,3
21751,सोचना,0,0,3,3
45513,മാത്രം,0,0,3,3
36439,अमेरिकन,0,0,3,3
36138,यात्रा,0,0,3,3
18901,gekomen,0,0,3,3
5938,collective,0,0,3,3
5937,elegidos,0,0,3,3
5935,yapamam,0,0,3,3
35109,klage,0,0,3,3
18891,essayez,0,0,3,3
35108,similarly,0,0,3,3
18886,പദമാണ്,0,0,3,3
30409,hellere,0,0,3,3
9057,விக்கிப்பீடியாவில்,0,0,3,3
31554,determinados,0,0,3,3
1304,utente,1,3,0,3
30407,निर्माता,0,0,3,3
28586,जवाब,0,0,3,3
28585,rahatsız,0,0,3,3
18915,criança,0,0,3,3
30143,ardından,0,0,3,3
3952,tienen,0,0,3,3
9027,наличие,0,0,3,3
8995,contenant,0,0,3,3
23595,taken,0,0,3,3
22185,अनुरोधों,0,0,3,3
9001,അതിന്റെ,0,0,3,3
29,paura,1,3,0,3
5204,full,0,0,3,3
45539,obstante,0,0,3,3
9006,கொஞ்சம்,0,0,3,3
18932,ಬಯಸುತ್ತೀರಿ,0,0,3,3
5956,déplacer,0,0,3,3
5954,grammatik,0,0,3,3
5953,लोकप्रिय,0,0,3,3
45534,νάρκισσος,0,0,3,3
5952,मेहनत,0,0,3,3
21746,chamados,0,0,3,3
28606,flawed,0,0,3,3
31543,يؤدي,0,0,3,3
36443,перед,0,0,3,3
45519,criteria,0,0,3,3
28583,أستخدمها,0,0,3,3
1796,unicamente,1,3,0,3
47689,φαίνεται,0,0,3,3
45465,ಬಳಿಗೆ,0,0,3,3
18829,torno,0,0,3,3
45460,rencontrer,0,0,3,3
45459,مصدر,0,0,3,3
47743,kernel,0,0,3,3
47745,اجتماع,0,0,3,3
38538,सफलता,0,0,3,3
45455,adaptation,0,0,3,3
31571,daarmee,0,0,3,3
3960,στείλω,0,0,3,3
45453,semelhantes,0,0,3,3
5882,veracidad,0,0,3,3
21810,என்னிடம்,0,0,3,3
18819,exakt,0,0,3,3
18817,skaffa,0,0,3,3
5620,العام,0,0,3,3
23658,reconnaissance,0,0,3,3
21814,posição,0,0,3,3
23662,эту,0,0,3,3
22143,implicitly,0,0,3,3
35085,gens,0,0,3,3
30170,réduire,0,0,3,3
18870,مني,0,0,3,3
47734,مرحباً,0,0,3,3
18865,दोपहर,0,0,3,3
45483,kväll,0,0,3,3
1797,totale,1,3,0,3
3955,miyim,0,0,3,3
18861,estimates,0,0,3,3
36147,βιβλίο,0,0,3,3
3559,ascoltando,1,3,0,3
31563,culturais,0,0,3,3
1611,studi,1,3,0,3
5184,américa,0,0,3,3
45474,escreve,0,0,3,3
21790,извиниться,0,0,3,3
28567,gerçek,0,0,3,3
36413,स्कूल्स,0,0,3,3
23640,notions,0,0,3,3
9102,தானியங்கிகள்,0,0,3,3
9104,geometri,0,0,3,3
2742,opinioni,1,3,0,3
20,brockhaus,2,2,1,3
35131,graphic,0,0,3,3
47686,ontmoeten,0,0,3,3
21621,suggère,0,0,3,3
8891,английском,0,0,3,3
36094,sentence,0,0,3,3
19036,muhammad,0,0,3,3
30453,θεέ,0,0,3,3
6052,ஒன்றை,0,0,3,3
8899,पोर्टल,0,0,3,3
8900,लेरी,0,0,3,3
8901,levou,0,0,3,3
21651,собственном,0,0,3,3
30095,ίδιο,0,0,3,3
21653,brown,0,0,3,3
45603,titan,0,0,3,3
45602,narrow,0,0,3,3
36099,cité,0,0,3,3
22222,concurso,0,0,3,3
19020,значение,0,0,3,3
23554,japonesa,0,0,3,3
30444,решений,0,0,3,3
38402,உங்களைப்,0,0,3,3
6030,understanding,0,0,3,3
21643,ചിത്രങ്ങൾ,0,0,3,3
6064,دقائق,0,0,3,3
31511,emner,0,0,3,3
31500,abierta,0,0,3,3
6086,chefredaktör,0,0,3,3
21623,auktoritet,0,0,3,3
6084,jimbo,0,0,3,3
36526,bibliothèque,0,0,3,3
45626,ಹೆಚ್ಚುವರಿ,0,0,3,3
28677,ഉദാഹരണങ്ങൾ,0,0,3,3
23537,subsets,0,0,3,3
28676,onto,0,0,3,3
47610,πρόβλημα,0,0,3,3
8871,covers,0,0,3,3
8872,serai,0,0,3,3
8874,hende,0,0,3,3
2346,creando,2,1,2,3
19046,konu,0,0,3,3
45616,μυαλό,0,0,3,3
8881,വിഷമിക്കേണ്ടതില്ല,0,0,3,3
30081,sexuellt,0,0,3,3
22234,hårdere,0,0,3,3
19042,биологии,0,0,3,3
38406,பேச,0,0,3,3
8923,फिल्मों,0,0,3,3
18949,बैंक,0,0,3,3
18978,wahr,0,0,3,3
38430,αλλιώς,0,0,3,3
45565,jogo,0,0,3,3
45564,माफ,0,0,3,3
23575,सहायता,0,0,3,3
21706,ilegal,0,0,3,3
38435,selvom,0,0,3,3
45559,ωραία,0,0,3,3
21710,dulce,0,0,3,3
8972,fevereiro,0,0,3,3
47675,المحادثة,0,0,3,3
22193,encyklopedi,0,0,3,3
18960,सीखने,0,0,3,3
35140,മുമ്പ്,0,0,3,3
31529,διόρθωση,0,0,3,3
31530,lecteur,0,0,3,3
35138,revelou,0,0,3,3
18951,söyleyebilir,0,0,3,3
21726,gelip,0,0,3,3
5972,بالطبع,0,0,3,3
28635,മെല്ലിയും,0,0,3,3
36484,participar,0,0,3,3
19009,evaluation,0,0,3,3
23571,الاشتراك,0,0,3,3
30104,candidato,0,0,3,3
30441,فقدت,0,0,3,3
30108,மரியன்,0,0,3,3
30439,put,0,0,3,3
28649,appareil,0,0,3,3
3386,scopo,1,3,0,3
5214,рядом,0,0,3,3
30111,antemano,0,0,3,3
3936,løsning,0,0,3,3
3627,quattro,1,3,0,3
30437,நான்கு,0,0,3,3
8939,секретный,0,0,3,3
38419,graden,0,0,3,3
18991,nicholas,0,0,3,3
299,pratici,1,3,0,3
28639,üzülmemesini,0,0,3,3
8949,propres,0,0,3,3
18982,expert,0,0,3,3
6004,ஒருவருக்கு,0,0,3,3
30381,verbluffend,0,0,3,3
5868,sets,0,0,3,3
38554,latitude,0,0,3,3
18621,won,0,0,3,3
30255,sujets,0,0,3,3
18616,κανόνες,0,0,3,3
18611,دعني,0,0,3,3
31659,день,0,0,3,3
21956,anúncios,0,0,3,3
21959,molestarte,0,0,3,3
18609,stationära,0,0,3,3
18604,claims,0,0,3,3
21963,neuronas,0,0,3,3
47865,referendo,0,0,3,3
9342,anderson,0,0,3,3
34999,deine,0,0,3,3
18595,другим,0,0,3,3
30259,अभ्यास,0,0,3,3
30321,træk,0,0,3,3
23774,naturalisme,0,0,3,3
18592,общего,0,0,3,3
23782,سمعت,0,0,3,3
30262,possessed,0,0,3,3
38680,xkcd,0,0,3,3
23761,alma,0,0,3,3
28437,llorar,0,0,3,3
30326,reiß,0,0,3,3
9294,heart,0,0,3,3
23745,beim,0,0,3,3
38662,வகையானது,0,0,3,3
31644,थोड़ी,0,0,3,3
38663,categorías,0,0,3,3
45328,gebeurt,0,0,3,3
18638,traditionele,0,0,3,3
21944,filmer,0,0,3,3
9307,видели,0,0,3,3
23752,horizontal,0,0,3,3
9311,abierto,0,0,3,3
31652,தோழர்களே,0,0,3,3
9313,இருப்பது,0,0,3,3
36211,bloggar,0,0,3,3
9314,wikinews,0,0,3,3
35011,கேட்டால்,0,0,3,3
45319,evaluated,0,0,3,3
47851,dicen,0,0,3,3
35010,espaces,0,0,3,3
21971,ко,0,0,3,3
18577,लिया,0,0,3,3
21826,corpus,0,0,3,3
9400,attribution,0,0,3,3
18542,überrascht,0,0,3,3
28414,σκληρότερα,0,0,3,3
22002,effekt,0,0,3,3
9407,جديدة,0,0,3,3
18539,ήμασταν,0,0,3,3
9412,beide,0,0,3,3
5669,संस्थापक,0,0,3,3
9417,appuie,0,0,3,3
36256,لهذا,0,0,3,3
3576,ehi,1,3,0,3
5147,betydelse,0,0,3,3
18524,lhe,0,0,3,3
28405,external,0,0,3,3
18523,الجديدة,0,0,3,3
36247,primary,0,0,3,3
18514,sequences,0,0,3,3
1810,venduto,1,3,0,3
34962,grote,0,0,3,3
2767,rende,2,2,1,3
38727,activity,0,0,3,3
18547,नरसीसा,0,0,3,3
28435,மெல்லி,0,0,3,3
45266,சொன்னது,0,0,3,3
30319,أحدهم,0,0,3,3
2324,famoso,2,1,2,3
18573,tex,0,0,3,3
30267,mobiltelefoner,0,0,3,3
3575,notte,1,3,0,3
21979,കയറി,0,0,3,3
30310,klaga,0,0,3,3
36278,phuein,0,0,3,3
345,norma,2,2,1,3
346,speciale,2,1,2,3
21992,எல்லா,0,0,3,3
38722,cientistas,0,0,3,3
5684,любом,0,0,3,3
30279,arkadaşlarınız,0,0,3,3
31676,हमें,0,0,3,3
18551,தமிழ்,0,0,3,3
9392,elde,0,0,3,3
45268,ouvert,0,0,3,3
9396,desafios,0,0,3,3
3990,archaea,0,0,3,3
5747,permanence,0,0,3,3
3989,വിവാഹം,0,0,3,3
1297,considerata,1,3,0,3
18763,ήθελα,0,0,3,3
21865,അമേരിക്കക്കാർ,0,0,3,3
18762,لديهم,0,0,3,3
35059,يستحق,0,0,3,3
23687,vinden,0,0,3,3
31597,bibliotecarios,0,0,3,3
23688,planets,0,0,3,3
9194,मन,0,0,3,3
36182,trevliga,0,0,3,3
22111,termos,0,0,3,3
28520,subjects,0,0,3,3
36354,النظر,0,0,3,3
45405,assise,0,0,3,3
36353,lätt,0,0,3,3
9201,μέση,0,0,3,3
9202,relativement,0,0,3,3
5814,branches,0,0,3,3
45401,ഭാഷയിൽ,0,0,3,3
21879,continuación,0,0,3,3
2493,schekman,1,3,0,3
18770,biliyorum,0,0,3,3
18656,ajouts,0,0,3,3
18771,sequence,0,0,3,3
38556,akzeptiere,0,0,3,3
5858,அதிக,0,0,3,3
21830,விற்றீர்கள்,0,0,3,3
38557,facilement,0,0,3,3
9157,volgens,0,0,3,3
22132,रोना,0,0,3,3
1798,educato,1,3,0,3
1649,repository,2,2,1,3
31583,مجلة,0,0,3,3
22125,gizli,0,0,3,3
45429,ihop,0,0,3,3
47780,geef,0,0,3,3
5839,parti,0,0,3,3
3596,società,1,3,0,3
28536,सम्पादन,0,0,3,3
5625,تأكل,0,0,3,3
9175,graus,0,0,3,3
5626,karar,0,0,3,3
36370,ولم,0,0,3,3
18743,जहाँ,0,0,3,3
22109,söka,0,0,3,3
18741,ക്രൂരമായ,0,0,3,3
45395,طريق,0,0,3,3
2515,radice,1,3,0,3
5767,bed,0,0,3,3
36196,खुले,0,0,3,3
36326,ഒക്കെ,0,0,3,3
38635,direkt,0,0,3,3
47832,serves,0,0,3,3
31628,filtros,0,0,3,3
9266,düzelme,0,0,3,3
9267,deles,0,0,3,3
45353,വിരലുകൾ,0,0,3,3
23732,ஒன்றாக,0,0,3,3
36199,आ,0,0,3,3
23736,replaced,0,0,3,3
9277,voice,0,0,3,3
18666,ترى,0,0,3,3
38646,£,0,0,3,3
30333,കുറഞ്ഞ,0,0,3,3
35020,fio,0,0,3,3
9287,hjertet,0,0,3,3
38632,зависимость,0,0,3,3
22097,καλός,0,0,3,3
23722,hemliga,0,0,3,3
21893,licentie,0,0,3,3
9215,αρκετά,0,0,3,3
21883,reason,0,0,3,3
36348,المتحدة,0,0,3,3
28509,desigual,0,0,3,3
5805,blague,0,0,3,3
5803,कुल,0,0,3,3
21889,henne,0,0,3,3
45385,உரை,0,0,3,3
5796,provides,0,0,3,3
18695,old,0,0,3,3
30349,considérés,0,0,3,3
35040,semble,0,0,3,3
30345,रखा,0,0,3,3
21901,soon,0,0,3,3
5784,fome,0,0,3,3
5634,modeling,0,0,3,3
9247,réunion,0,0,3,3
5780,mídia,0,0,3,3
35180,geweest,0,0,3,3
30898,статус,0,0,3,3
6121,λάβετε,0,0,3,3
23477,जर्नल,0,0,3,3
23505,ontving,0,0,3,3
6099,sjov,0,0,3,3
23504,keskin,0,0,3,3
45691,ലേഖനങ്ങളിൽ,0,0,3,3
38336,beschrijven,0,0,3,3
22264,tipset,0,0,3,3
8773,suerte,0,0,3,3
38366,steadily,0,0,3,3
2721,penso,2,2,1,3
45717,ettiğim,0,0,3,3
21549,aquele,0,0,3,3
45690,approche,0,0,3,3
1594,comuni,1,3,0,3
47550,engineering,0,0,3,3
36588,وكان,0,0,3,3
23488,representa,0,0,3,3
36534,commun,0,0,3,3
47532,allezy,0,0,3,3
2533,chiesto,1,3,0,3
23480,ποια,0,0,3,3
45674,conduit,0,0,3,3
28698,απλώς,0,0,3,3
6194,التقاء,0,0,3,3
19109,kenmerken,0,0,3,3
23468,δάχτυλα,0,0,3,3
38312,पूरे,0,0,3,3
47533,intéresse,0,0,3,3
23476,listening,0,0,3,3
23474,जिसने,0,0,3,3
30479,casar,0,0,3,3
38283,consecuencia,0,0,3,3
8798,ಯಾರಿಗಾದರೂ,0,0,3,3
36538,relation,0,0,3,3
38361,reach,0,0,3,3
30049,эй,0,0,3,3
45701,добросовестного,0,0,3,3
6177,uzun,0,0,3,3
3912,ಅಪ್ರಸ್ತುತವಾಗುತ್ತದೆ,0,0,3,3
3640,rilevanti,1,3,0,3
30469,skriven,0,0,3,3
8715,puntuación,0,0,3,3
19183,ur,0,0,3,3
45633,dårligt,0,0,3,3
36557,όσα,0,0,3,3
8738,encompasses,0,0,3,3
36058,ببطء,0,0,3,3
45695,planète,0,0,3,3
47579,vandaag,0,0,3,3
19186,minuter,0,0,3,3
6124,الولايات,0,0,3,3
8816,unlabeled,0,0,3,3
21615,amateur,0,0,3,3
19119,عما,0,0,3,3
47596,eletrônico,0,0,3,3
47574,sagte,0,0,3,3
30476,roy,0,0,3,3
36587,எப்படியும்,0,0,3,3
6136,இருந்தபோது,0,0,3,3
38317,لأنك,0,0,3,3
6167,básicamente,0,0,3,3
19082,publicar,0,0,3,3
8825,feitos,0,0,3,3
19100,fragt,0,0,3,3
38282,never,0,0,3,3
8827,gramática,0,0,3,3
6170,البداية,0,0,3,3
6109,فهي,0,0,3,3
45684,दोहरान,0,0,3,3
19137,«фаза,0,0,3,3
1665,abilità,1,3,0,3
22265,actifs,0,0,3,3
2720,veloce,1,3,0,3
2538,trattati,1,3,0,3
3920,trees,0,0,3,3
45638,ಕೇಳುತ್ತೀರಿ,0,0,3,3
23475,ആരോടെങ്കിലും,0,0,3,3
31450,wireless,0,0,3,3
8821,juan,0,0,3,3
19145,செல்லுங்கள்,0,0,3,3
36062,മാർഗമാണ്,0,0,3,3
36076,universel,0,0,3,3
1595,temporale,1,3,0,3
8746,शब्दकोष,0,0,3,3
25266,हुआ।,0,0,2,2
14339,lägga,0,0,2,2
40830,خاطئة,0,0,2,2
1982,automatica,1,2,0,2
41756,يتضمن,0,0,2,2
21551,édition,0,0,2,2
14740,gevraagd,0,0,2,2
41755,ответить,0,0,2,2
14338,istediğin,0,0,2,2
41758,ಖಚಿತವಾಗಿ,0,0,2,2
20828,vandalizm,0,0,2,2
41742,koordinering,0,0,2,2
25659,ന്,0,0,2,2
36656,culturel,0,0,2,2
33652,वर्तनी,0,0,2,2
25261,interesantes,0,0,2,2
14854,попробуйте,0,0,2,2
25260,cualquiera,0,0,2,2
15644,blodget,0,0,2,2
15625,விளையாடுகிறீர்கள்,0,0,2,2
21904,المهام,0,0,2,2
1647,allenamento,1,2,0,2
15626,choisis,0,0,2,2
15636,प्रतिष्ठा,0,0,2,2
33653,running,0,0,2,2
37102,كمشروع,0,0,2,2
20819,സമവാക്യം,0,0,2,2
14741,dualisme,0,0,2,2
25270,befinden,0,0,2,2
36022,مرتبطة,0,0,2,2
15615,conferences,0,0,2,2
36340,сетей,0,0,2,2
25279,volunteers,0,0,2,2
33466,أثناء,0,0,2,2
20815,dog,0,0,2,2
36339,forstod,0,0,2,2
14332,kritikerna,0,0,2,2
25913,globo,0,0,2,2
40818,الآراء,0,0,2,2
1984,rubini,1,2,0,2
994,previsioni,1,2,0,2
37105,फ्री,0,0,2,2
21907,påverkas,0,0,2,2
22102,الحلم,0,0,2,2
25910,mentalt,0,0,2,2
36189,read,0,0,2,2
15624,scoring,0,0,2,2
25658,animese,0,0,2,2
41750,co,0,0,2,2
22650,explanation,0,0,2,2
22101,комуто,0,0,2,2
41454,نفسها,0,0,2,2
3732,modificate,1,2,0,2
41765,inscrição,0,0,2,2
22275,términos,0,0,2,2
37138,planlar,0,0,2,2
36201,trendline,0,0,2,2
3584,messo,1,2,0,2
22087,الإبداعي,0,0,2,2
20772,स्पीकर,0,0,2,2
907,coronation,2,1,1,2
1005,sostentamento,1,2,0,2
36027,lancer,0,0,2,2
37137,petit,0,0,2,2
1523,iniziò,1,2,0,2
1003,valutare,1,2,0,2
41774,പ്രിയേ,0,0,2,2
14296,πιθανούς,0,0,2,2
22660,telefoon,0,0,2,2
36321,complémentarité,0,0,2,2
14297,riches,0,0,2,2
15683,resource,0,0,2,2
22091,grecs,0,0,2,2
25237,semaine,0,0,2,2
14843,milliards,0,0,2,2
22326,consequência,0,0,2,2
25235,icon,0,0,2,2
14835,അതായത്,0,0,2,2
1008,autorità,1,2,0,2
15700,skarpt,0,0,2,2
3077,predizioni,1,2,0,2
36202,presión,0,0,2,2
33931,occident,0,0,2,2
22665,prédominance,0,0,2,2
40764,تحب,0,0,2,2
21931,trying,0,0,2,2
21465,vs,0,0,2,2
14839,привело,0,0,2,2
41385,supongo,0,0,2,2
20766,λειτουργία,0,0,2,2
41775,décimo,0,0,2,2
20767,وتعني,0,0,2,2
3740,pari,1,2,0,2
25232,medmindre,0,0,2,2
3174,potevo,1,2,0,2
15681,vital,0,0,2,2
41378,स्वादिष्ट,0,0,2,2
15660,prevención,0,0,2,2
21914,рамках,0,0,2,2
3737,dizionario,1,2,0,2
14311,olumlu,0,0,2,2
41453,ചെയ്യുന്ന,0,0,2,2
25254,ಯಾವುದು,0,0,2,2
25255,tartışmalar,0,0,2,2
22095,nederländska,0,0,2,2
15653,éditée,0,0,2,2
25257,ideal,0,0,2,2
14313,ändringar,0,0,2,2
40801,drowning,0,0,2,2
15650,படிப்பினைகளை,0,0,2,2
36331,pública,0,0,2,2
996,pensavo,1,2,0,2
40805,τούτου,0,0,2,2
21910,inscription,0,0,2,2
15645,الموسوعات,0,0,2,2
20790,ಪುಸ್ತಕವನ್ನು,0,0,2,2
998,occupa,2,1,1,2
40778,vivants,0,0,2,2
37101,fines,0,0,2,2
36325,घटना,0,0,2,2
25241,يتحقق,0,0,2,2
40783,ചോദിച്ചപ്പോൾ,0,0,2,2
14746,illustrer,0,0,2,2
37132,wetland,0,0,2,2
33455,profond,0,0,2,2
21458,первое,0,0,2,2
15674,army,0,0,2,2
999,terziaria,1,2,0,2
4553,deveria,0,0,2,2
14745,dirigida,0,0,2,2
21916,rich,0,0,2,2
4472,இருந்தன,0,0,2,2
40787,असाइनमेंट,0,0,2,2
40788,ഫ്ലംമോക്സ്,0,0,2,2
41379,externes,0,0,2,2
20786,bäst,0,0,2,2
36187,capables,0,0,2,2
25748,ordenou,0,0,2,2
21891,esqueça,0,0,2,2
37100,paysbas,0,0,2,2
14375,ήθελε,0,0,2,2
41720,disciplinas,0,0,2,2
21861,puedan,0,0,2,2
1706,almeno,1,2,0,2
15529,विवाह,0,0,2,2
21442,duim,0,0,2,2
21860,журнале,0,0,2,2
25894,annexes,0,0,2,2
22118,strong,0,0,2,2
1621,hawaiano,1,2,0,2
22608,παίρνετε,0,0,2,2
37061,incorporam,0,0,2,2
22606,weekenden,0,0,2,2
15527,معًا,0,0,2,2
41716,anímate,0,0,2,2
36671,parvient,0,0,2,2
21565,आदि,0,0,2,2
22604,philosophes,0,0,2,2
33878,നടത്തുന്നു,0,0,2,2
36573,sécurité,0,0,2,2
14732,professeur,0,0,2,2
1622,autonomamente,1,2,0,2
15545,cuma,0,0,2,2
22618,criada,0,0,2,2
3505,rappresentazione,1,2,0,2
1623,qualcos,1,2,0,2
22615,lien,0,0,2,2
3165,paradigma,2,1,1,2
15548,रंग,0,0,2,2
25309,stiftelsen,0,0,2,2
41457,abuse,0,0,2,2
15544,نوفمبر,0,0,2,2
25314,viewpoints,0,0,2,2
20880,djur,0,0,2,2
40872,ആരംഭിച്ച,0,0,2,2
41356,universalis,0,0,2,2
15539,проектов,0,0,2,2
14371,banklening,0,0,2,2
3164,formalmente,2,1,1,2
25312,veja,0,0,2,2
33880,വഴികൾ,0,0,2,2
37055,रहती,0,0,2,2
25319,aanstaande,0,0,2,2
21853,ಬಂದರು,0,0,2,2
25642,последние,0,0,2,2
3161,vieni,1,2,0,2
15504,habertürk,0,0,2,2
22596,lärt,0,0,2,2
15502,ಸರಿಯಾದ,0,0,2,2
36383,تكراره,0,0,2,2
25333,kiggede,0,0,2,2
4389,anomalies,0,0,2,2
25883,factually,0,0,2,2
22594,rode,0,0,2,2
22130,responsabilidad,0,0,2,2
33611,पॉइंट,0,0,2,2
25710,aplicaciones,0,0,2,2
21834,assist,0,0,2,2
25334,idéologie,0,0,2,2
41698,மாற்றப்பட்டது,0,0,2,2
33867,ടെറി,0,0,2,2
15492,jusqu’à,0,0,2,2
22591,enfermedades,0,0,2,2
22597,политик,0,0,2,2
36169,функции,0,0,2,2
14387,géographiques,0,0,2,2
21850,പദാവലി,0,0,2,2
22603,kaum,0,0,2,2
21435,संशोधित,0,0,2,2
984,cervello,1,2,0,2
15518,أشعر,0,0,2,2
14886,பெருமை,0,0,2,2
21851,herinde,0,0,2,2
983,passo,2,1,1,2
41706,ഘടകങ്ങളാണ്,0,0,2,2
40891,ناجحًا,0,0,2,2
21566,συναντήσω,0,0,2,2
40892,шутка,0,0,2,2
22122,ಸ್ವರ್ಗ,0,0,2,2
40895,soyez,0,0,2,2
21431,omhoog,0,0,2,2
25326,دعنا,0,0,2,2
20905,appears,0,0,2,2
25329,containing,0,0,2,2
14887,earlier,0,0,2,2
37075,agradecendo,0,0,2,2
36663,swartz,0,0,2,2
3166,accedere,1,2,0,2
15586,இன்னும்,0,0,2,2
15593,primárias,0,0,2,2
20842,أولئك,0,0,2,2
25901,classificada,0,0,2,2
20843,ಹೆಲ್ಲರ್,0,0,2,2
20845,negócios,0,0,2,2
41365,منهم,0,0,2,2
14869,dagen,0,0,2,2
25289,أما,0,0,2,2
22634,ಮರೆಯಬೇಡಿ,0,0,2,2
40839,weinig,0,0,2,2
40847,ತಿಳಿದಿತ್ತು,0,0,2,2
20848,ടെറൻസ്,0,0,2,2
21556,ocorreu,0,0,2,2
25650,джозефом,0,0,2,2
14872,amorality,0,0,2,2
20850,hämtar,0,0,2,2
20852,usted,0,0,2,2
41729,begge,0,0,2,2
15594,выпущен,0,0,2,2
41731,honger,0,0,2,2
849,consente,1,2,0,2
41455,செல்வது,0,0,2,2
41370,editorinchief,0,0,2,2
40832,skriv,0,0,2,2
20831,описывают,0,0,2,2
15605,विकि,0,0,2,2
3593,prestigio,2,1,1,2
14739,доступ,0,0,2,2
25284,sayfa,0,0,2,2
21887,teknolojileri,0,0,2,2
36347,valid,0,0,2,2
14355,trægt,0,0,2,2
25654,factualmente,0,0,2,2
33613,protists,0,0,2,2
3730,piace,1,2,0,2
14864,informou,0,0,2,2
33644,inclusão,0,0,2,2
40837,секунду,0,0,2,2
15599,क्षमता,0,0,2,2
36184,സാധിക്കുന്നു,0,0,2,2
15580,ഒന്നും,0,0,2,2
20853,χρόνο,0,0,2,2
15554,άγγελο,0,0,2,2
25898,sampled,0,0,2,2
15563,सोच,0,0,2,2
25648,ബാങ്ക്,0,0,2,2
15561,बढ़ने,0,0,2,2
22333,reforço,0,0,2,2
22110,expansion,0,0,2,2
41358,الآخرين,0,0,2,2
37082,собираетесь,0,0,2,2
20865,önemli,0,0,2,2
15559,progression,0,0,2,2
20862,broadest,0,0,2,2
15558,readily,0,0,2,2
25304,lives,0,0,2,2
21875,standards,0,0,2,2
22625,الحالات,0,0,2,2
36575,latines,0,0,2,2
22622,squared,0,0,2,2
21562,വിഡ്,0,0,2,2
14880,extraction,0,0,2,2
25302,vrijwilligers,0,0,2,2
15565,സമവാക്യത്തിലെ,0,0,2,2
40854,tentando,0,0,2,2
15571,ಸಭೆಗೆ,0,0,2,2
40855,outsiders,0,0,2,2
3725,prenditi,1,2,0,2
36021,செய்யப்,0,0,2,2
14362,الأصل،,0,0,2,2
33886,பார்க்கிறீர்கள்,0,0,2,2
25299,सदस्यता,0,0,2,2
37089,l’accès,0,0,2,2
22630,acercó,0,0,2,2
3504,ambiguità,1,2,0,2
41727,الشكوى,0,0,2,2
35820,मतदान,0,0,2,2
15570,moteur,0,0,2,2
15568,शब्दावली,0,0,2,2
14873,beginning,0,0,2,2
20861,herkesin,0,0,2,2
14736,tectonic,0,0,2,2
4379,पदार्थ,0,0,2,2
25301,bijdragen,0,0,2,2
36350,سوى,0,0,2,2
37158,harmful,0,0,2,2
20760,avsedd,0,0,2,2
36273,plek,0,0,2,2
14207,волнуйтесь,0,0,2,2
40615,sætte,0,0,2,2
14209,físico,0,0,2,2
25130,felaktigt,0,0,2,2
15887,igår,0,0,2,2
36274,flowing,0,0,2,2
40620,διαφωνώ,0,0,2,2
22303,शुरुआत,0,0,2,2
20608,episodes,0,0,2,2
25133,néerlandais,0,0,2,2
20609,ställe,0,0,2,2
36623,достаточно,0,0,2,2
14211,स्कोर,0,0,2,2
20614,pédagogique,0,0,2,2
20615,suivants ,0,0,2,2
40625,reverte,0,0,2,2
41415,விவரிக்கிறார்கள்,0,0,2,2
36226,تعال,0,0,2,2
22304,εσείς,0,0,2,2
20606,بأس,0,0,2,2
20603,σάββατο,0,0,2,2
40656,bildning,0,0,2,2
41437,kelimeleri,0,0,2,2
22301,बह,0,0,2,2
20593,വിവരങ്ങളും,0,0,2,2
1962,istanze,1,2,0,2
36619,pocos,0,0,2,2
20594,குறிப்பிடலாம்,0,0,2,2
15905,founder,0,0,2,2
41434,«нравится»,0,0,2,2
25122,möller,0,0,2,2
3649,ministro,2,1,1,2
4337,rays,0,0,2,2
41418,ಅವು,0,0,2,2
829,letteralmente,1,2,0,2
35734,gerade,0,0,2,2
41417,diagnosis,0,0,2,2
1023,pubblicare,1,2,0,2
20602,leva,0,0,2,2
36271,fini,0,0,2,2
36621,இருப்பினும்,0,0,2,2
41839,ndesanjo,0,0,2,2
22731,критикуют,0,0,2,2
41412,soar,0,0,2,2
25138,ಲ್ಯಾಟಿನ್,0,0,2,2
36601,autoridades,0,0,2,2
3754,tono,2,1,1,2
21981,kapsamlı,0,0,2,2
22289,ತಮಾಷೆ,0,0,2,2
37230,ಸ್ಪೀಕರ್,0,0,2,2
25971,besökta,0,0,2,2
37228,vy,0,0,2,2
25149,icône,0,0,2,2
21976,تمييز,0,0,2,2
25151,существуют,0,0,2,2
4347,livet,0,0,2,2
25152,l’écologie,0,0,2,2
14224,sorunlu,0,0,2,2
14225,animé,0,0,2,2
20642,kreeg,0,0,2,2
15846,توجد,0,0,2,2
36287,rédigés,0,0,2,2
37225,eb,0,0,2,2
20644,sunmaktadır,0,0,2,2
40654,cubrirme,0,0,2,2
33992,coberto,0,0,2,2
20633,illustration,0,0,2,2
22727,répandue,0,0,2,2
25144,vertelde,0,0,2,2
25683,എഴുതുവാനും,0,0,2,2
830,computazione,1,2,0,2
25682,offer,0,0,2,2
33621,slet,0,0,2,2
4345,visible,0,0,2,2
37234,matin,0,0,2,2
14764,semanal,0,0,2,2
20626,فظيع,0,0,2,2
37233,detinha,0,0,2,2
36282,μπορούσε,0,0,2,2
37232,noviembre,0,0,2,2
36280,helg,0,0,2,2
21986,alltså,0,0,2,2
20629,happening,0,0,2,2
40641,lending,0,0,2,2
15862,yeux,0,0,2,2
20630,oceanic,0,0,2,2
20631,നിന്നു,0,0,2,2
14201,ಬಂದಿದ್ದೀರಿ,0,0,2,2
1961,percentuale,1,2,0,2
20591,понравилось,0,0,2,2
35717,dein,0,0,2,2
1637,garantire,1,2,0,2
41865,halen,0,0,2,2
25097,свободной,0,0,2,2
34030,третье,0,0,2,2
25099,pauvre,0,0,2,2
20550,βικιβιβλία,0,0,2,2
40574,غالباً,0,0,2,2
25101,soldater,0,0,2,2
14174,abordagem,0,0,2,2
1028,osservare,1,2,0,2
41863,reclamar,0,0,2,2
37282,доступными,0,0,2,2
41423,freitag,0,0,2,2
22767,bobo,0,0,2,2
40580,مشغول,0,0,2,2
37276,hieronder,0,0,2,2
40582,opgaver,0,0,2,2
15933,mittagessen,0,0,2,2
34022,voix,0,0,2,2
15950,hypothetical,0,0,2,2
37288,وصف,0,0,2,2
15951,hagas,0,0,2,2
4331,തുടരാൻ,0,0,2,2
36244,bevor,0,0,2,2
14774,കേരളത്തിനുള്ളിൽ,0,0,2,2
4574,derakhshan,0,0,2,2
36052,darle,0,0,2,2
20530,пора,0,0,2,2
25692,wikipédia ,0,0,2,2
22035,सो,0,0,2,2
40566,sterk,0,0,2,2
22779,couvrir,0,0,2,2
22039,லத்தீன்,0,0,2,2
41867,ഓർമ്മിക്കുക,0,0,2,2
36053,convey,0,0,2,2
22778,dudas,0,0,2,2
35706,telle,0,0,2,2
20537,متجاوزة,0,0,2,2
37293,റൊട്ടിയും,0,0,2,2
20539,realiza,0,0,2,2
25998,sitzen,0,0,2,2
36254,resolve,0,0,2,2
22757,federated,0,0,2,2
20590,الجزء,0,0,2,2
1026,mette,1,2,0,2
41856,coleção,0,0,2,2
34018,मंडल,0,0,2,2
14785,potentiel,0,0,2,2
37259,estuviera,0,0,2,2
3760,locomotion,0,0,2,2
33407,rise,0,0,2,2
22012,augmentation,0,0,2,2
41853,herself,0,0,2,2
14188,വിളിക്കുന്നു,0,0,2,2
22747,kam,0,0,2,2
36614,ಕಣ್ಣುಗಳು,0,0,2,2
14193,धीमे,0,0,2,2
36262,disponen,0,0,2,2
35727,dedican,0,0,2,2
828,tendono,1,2,0,2
20589,επαναλάβει,0,0,2,2
1634,parlamento,2,1,1,2
22005,coordinated,0,0,2,2
25980,correo,0,0,2,2
36258,poucas,0,0,2,2
40596,ചോദിക്കാൻ,0,0,2,2
33406,móvil,0,0,2,2
40589,récompense,0,0,2,2
22756,sourire,0,0,2,2
14176,confiabilidade,0,0,2,2
34021,aussprache,0,0,2,2
21512,absolutamente,0,0,2,2
35724,tıpkı,0,0,2,2
21510,dare,0,0,2,2
21508,değişikliklerin,0,0,2,2
22751,unser,0,0,2,2
40590,πρόγραμμα,0,0,2,2
33405,michel,0,0,2,2
40591,específicos,0,0,2,2
22750,repositorio,0,0,2,2
14784,voordat,0,0,2,2
22042,വാരാന്ത്യത്തിൽ,0,0,2,2
40593,സഹായിക്കാൻ,0,0,2,2
15921,lacking,0,0,2,2
15919,малых,0,0,2,2
25112,المبالغة,0,0,2,2
20645,déterminant,0,0,2,2
36599,ganzen,0,0,2,2
15703,வந்தேன்,0,0,2,2
3643,desiderato,1,2,0,2
2063,dominio,2,1,1,2
14826,besten,0,0,2,2
40709,सफल,0,0,2,2
14827,significado,0,0,2,2
1520,liberi,1,2,0,2
40712,ancient,0,0,2,2
33447,suche,0,0,2,2
33957,dichas,0,0,2,2
25198,gett,0,0,2,2
37171,rolig,0,0,2,2
25199,varnish,0,0,2,2
33954,உண்மையிலேயே,0,0,2,2
15753,görünüyordu,0,0,2,2
21946,ഉത്തരവും,0,0,2,2
15752,प्रावधान,0,0,2,2
15751,dedicated,0,0,2,2
22688,സ്കോർ‌,0,0,2,2
904,nostro,1,2,0,2
35777,வழியாகும்,0,0,2,2
14825,милю,0,0,2,2
40703,حادة,0,0,2,2
20646,சொல்வதற்கான,0,0,2,2
20715,теме,0,0,2,2
3541,dalle,1,2,0,2
33969,explicit,0,0,2,2
15786,ന്റെ,0,0,2,2
36304,свободы,0,0,2,2
41393,விரும்புகிறீர்களா,0,0,2,2
14822,ഉദാഹരണത്തിൽ,0,0,2,2
15784,finesser,0,0,2,2
40697,നടത്താൻ,0,0,2,2
15782,universidades,0,0,2,2
33967,சந்திக்க,0,0,2,2
41793,اليابانية,0,0,2,2
37183,fließend,0,0,2,2
1518,finire,1,2,0,2
15779,வணக்கம்,0,0,2,2
35771,voyage,0,0,2,2
20713,தேவை,0,0,2,2
14823,nature ,0,0,2,2
40701,pronunciation,0,0,2,2
14273,கேட்கலாம்,0,0,2,2
14829,intellectuelle,0,0,2,2
15748,hazards,0,0,2,2
1978,inutile,2,1,1,2
2060,immagini,1,2,0,2
40744,​​om,0,0,2,2
37160,രേഖകൾ,0,0,2,2
41447,каждая,0,0,2,2
25641,confus,0,0,2,2
20741,mens,0,0,2,2
36206,ആദ്യം,0,0,2,2
20744,conectado,0,0,2,2
25937,allá,0,0,2,2
37148,मेजबानी,0,0,2,2
20754,reciben,0,0,2,2
35788,insertion,0,0,2,2
40754,tabii,0,0,2,2
36204,déconcertés,0,0,2,2
21547,secteur,0,0,2,2
40756,بنسبة,0,0,2,2
841,collegate,1,2,0,2
25227,antiquité,0,0,2,2
3641,commento,1,2,0,2
25228,അതായത്‌,0,0,2,2
15721,sturen,0,0,2,2
21942,observant,0,0,2,2
22680,தெரியுமா,0,0,2,2
22075,цели,0,0,2,2
25209,ಸಂಧಿಸಲು,0,0,2,2
15739,प्रतिबंधित,0,0,2,2
15738,cultlike,0,0,2,2
15736,mereço,0,0,2,2
40734,بعمل,0,0,2,2
40735,الوصول,0,0,2,2
15731,ഹലോ,0,0,2,2
22683,aurait,0,0,2,2
33643,interessado,0,0,2,2
25217,computador,0,0,2,2
14831,demandé,0,0,2,2
33942,занимались,0,0,2,2
40738,kontroversielle,0,0,2,2
22681,actos,0,0,2,2
40739,تعرض,0,0,2,2
20734,wikilivros,0,0,2,2
25216,commented,0,0,2,2
22323,expansión,0,0,2,2
35760,boundary,0,0,2,2
2026,unici,1,2,0,2
14268,libertés,0,0,2,2
834,credibilità,1,2,0,2
37214,использоваться,0,0,2,2
22285,تخلق,0,0,2,2
25965,microfilm,0,0,2,2
40665,записи,0,0,2,2
37212,بكثير,0,0,2,2
36289,लेकर,0,0,2,2
22063,balance,0,0,2,2
35748,princípios,0,0,2,2
37210,requiere,0,0,2,2
20665,സ്വതന്ത്രവിജ്ഞാനകോശത്തിന്റെ,0,0,2,2
14238,προτάσεων,0,0,2,2
41817,ಆಗಿ,0,0,2,2
21533,رأيك,0,0,2,2
36292,eleições,0,0,2,2
41402,sistêmico,0,0,2,2
20667,कोशिश,0,0,2,2
25162,symbolic,0,0,2,2
33638,ergens,0,0,2,2
22317,zorg,0,0,2,2
36038,रिचर्ड,0,0,2,2
41822,falsely,0,0,2,2
20657,risque,0,0,2,2
36597,saiba,0,0,2,2
36039,experimento,0,0,2,2
3573,raggiunse,1,2,0,2
20648,vilar,0,0,2,2
22723,fingrar,0,0,2,2
37220,видеть,0,0,2,2
36629,اعتني,0,0,2,2
41826,toegekend,0,0,2,2
25155,evolves,0,0,2,2
22721,الإسبانية,0,0,2,2
15832,mediawikiservern,0,0,2,2
25157,respirar,0,0,2,2
33426,correctement,0,0,2,2
22287,unregistered,0,0,2,2
21972,permanecer,0,0,2,2
3542,legge,1,2,0,2
20655,erkek,0,0,2,2
21530,promedio,0,0,2,2
2069,fornito,1,2,0,2
41398,balança,0,0,2,2
15821,samtalen,0,0,2,2
21953,سحرية,0,0,2,2
15820,редактировать,0,0,2,2
21475,عكس,0,0,2,2
40687,حسنًا,0,0,2,2
21539,langsommere,0,0,2,2
41445,molesto,0,0,2,2
25956,बनाई,0,0,2,2
21955,apoio,0,0,2,2
15796,ಬೇರೆ,0,0,2,2
20685,ವಿವರಿಸುತ್ತಾರೆ,0,0,2,2
15794,إمكانية,0,0,2,2
20686,fångade,0,0,2,2
20688,ஆய்வின்,0,0,2,2
36643,απαντήσετε,0,0,2,2
14264,स्टालमेन,0,0,2,2
15791,أحلامه,0,0,2,2
25950,environmental,0,0,2,2
37192,oorsprong,0,0,2,2
25671,aura,0,0,2,2
33442,gelijk,0,0,2,2
22070,feeling,0,0,2,2
20684,σίγουροι,0,0,2,2
40682,pornográficos,0,0,2,2
22708,étymologiquement,0,0,2,2
25168,şikayet,0,0,2,2
1973,ciascuna,1,2,0,2
37203,distincts,0,0,2,2
33980,തരാമോ,0,0,2,2
14247,lachen,0,0,2,2
21966,nätverk,0,0,2,2
36057,biographies,0,0,2,2
36641,restaurante,0,0,2,2
15816,चट्टान,0,0,2,2
36294,permiso,0,0,2,2
40680,श्रेणी,0,0,2,2
33434,ഉറപ്പില്ല,0,0,2,2
41808,परिणामस्वरूप,0,0,2,2
14255,perception,0,0,2,2
22067,мариан,0,0,2,2
36031,sommaren,0,0,2,2
37201,citoyens,0,0,2,2
40678,bildirin,0,0,2,2
3496,servono,1,2,0,2
3637,consolidata,1,2,0,2
22345,καλοί,0,0,2,2
1650,probabilistici,1,2,0,2
3624,contribuito,1,2,0,2
25482,tropenmuseum,0,0,2,2
4516,intensifique,0,0,2,2
25484,எரிகிறது,0,0,2,2
41128,മികച്ചതായിരിക്കും,0,0,2,2
14569,ലേഖനങ്ങളെഴുതിയ,0,0,2,2
41500,biosphère,0,0,2,2
21690,vietnamita,0,0,2,2
25485,assouline et,0,0,2,2
14672,രഹസ്യ,0,0,2,2
41306,bigipedia,0,0,2,2
21689,смог,0,0,2,2
21189,yerime,0,0,2,2
21373,sofistikerad,0,0,2,2
41132,openness,0,0,2,2
36848,мальчик,0,0,2,2
36111, млн,0,0,2,2
36846,darauf,0,0,2,2
25490,delete,0,0,2,2
41137,sluta,0,0,2,2
4436,அடிப்படையிலும்,0,0,2,2
15198,considérablement,0,0,2,2
22369,νόστιμα,0,0,2,2
33591,nadie,0,0,2,2
3533,attualità,1,2,0,2
21175,டிகிரிக்கு,0,0,2,2
25478,வைக்க,0,0,2,2
36479,drømme,0,0,2,2
36856,z,0,0,2,2
22201,durumu,0,0,2,2
33551,स्वर,0,0,2,2
14677,மாற,0,0,2,2
25479,прекрасно,0,0,2,2
41575,vir,0,0,2,2
22465,shopping,0,0,2,2
22255,தயாராக,0,0,2,2
21694,تناوله,0,0,2,2
22254,ലേഖനത്തിന്,0,0,2,2
22253,sueños,0,0,2,2
36114,ثمانية,0,0,2,2
36853,experiente,0,0,2,2
21183,kopiera,0,0,2,2
1694,presentare,1,2,0,2
41304,تعتقد,0,0,2,2
41582,குறிக்கோளை,0,0,2,2
21681,lämpligt,0,0,2,2
25505,الجامعات,0,0,2,2
25742,встреча,0,0,2,2
36542,вообще,0,0,2,2
41154,wortel,0,0,2,2
36722,نيتشر,0,0,2,2
22447,அம்மாவாக,0,0,2,2
15158,worried,0,0,2,2
22446,kesinlikle,0,0,2,2
22445,pequeños,0,0,2,2
36824,idén,0,0,2,2
22217,صلاحيات,0,0,2,2
22218,ogen,0,0,2,2
36823,ಆಶ್ಚರ್ಯಕರವಾಗಿ,0,0,2,2
1601,libertà,1,2,0,2
36723,sofistike,0,0,2,2
21225,worte,0,0,2,2
14965,python,0,0,2,2
14591,publicaties,0,0,2,2
21227,biblioteket,0,0,2,2
15164,leçons,0,0,2,2
41561,procuram,0,0,2,2
25504,ഇഷ്ടപ്പെടുന്നു,0,0,2,2
21368,korta,0,0,2,2
21195,menade,0,0,2,2
14578,huset,0,0,2,2
3666,umano,1,2,0,2
36844,vidt,0,0,2,2
3625,dicono,1,2,0,2
3132,fece,1,2,0,2
21204,ground,0,0,2,2
41565,tien,0,0,2,2
22251,remonter,0,0,2,2
36832,citar,0,0,2,2
22211,виду,0,0,2,2
14956,visitado,0,0,2,2
41302,deleted,0,0,2,2
15167,wysiwyg,0,0,2,2
21601,birkaç,0,0,2,2
21672,l’environnement,0,0,2,2
25786,passait,0,0,2,2
14671,കമ്പ്യൂട്ടർ,0,0,2,2
22469,rüyaydı,0,0,2,2
21171,salida,0,0,2,2
41505,संस्था,0,0,2,2
41093,viaje,0,0,2,2
25453,necesariamente,0,0,2,2
33782,februar,0,0,2,2
35923,минут,0,0,2,2
36461,dinner,0,0,2,2
35924,fifty,0,0,2,2
33674,والآن,0,0,2,2
21724,долларов,0,0,2,2
21723,புகார்,0,0,2,2
21721,beslutning,0,0,2,2
4427,garden,0,0,2,2
1606,ciascuno,1,2,0,2
41594,சரியாகப்,0,0,2,2
22190,हास्य,0,0,2,2
2042,regalo,2,1,1,2
25458,surpassing,0,0,2,2
14685,έπιασα,0,0,2,2
21157,लगी,0,0,2,2
33676,أنشأ,0,0,2,2
22192,algún,0,0,2,2
36875,slutet,0,0,2,2
2006,sviluppate,1,2,0,2
955,pdf,2,1,1,2
3689,avvenimenti,1,2,0,2
14539,editam,0,0,2,2
22480,ತಿರುಗಿಸಿದೆ,0,0,2,2
957,piangendo,1,2,0,2
36711,tummen,0,0,2,2
15259,beror,0,0,2,2
2005,utile,2,1,1,2
36460,relativt,0,0,2,2
36878,verdi,0,0,2,2
41081,фильм,0,0,2,2
36876,edemezsiniz,0,0,2,2
25450,المتطوعين,0,0,2,2
15254,hadden,0,0,2,2
21381,нов,0,0,2,2
15253,crescente,0,0,2,2
4426,തോന്നുന്നതിനുള്ള,0,0,2,2
41489,английской,0,0,2,2
25616,banning,0,0,2,2
21145,شكك,0,0,2,2
21158,பயன்படுத்தக்கூடாது,0,0,2,2
878,dì,1,2,0,2
41116,சமீபத்திய,0,0,2,2
41312,errado,0,0,2,2
22256,regels,0,0,2,2
21168,brilhantes,0,0,2,2
14552,appropriately,0,0,2,2
21594,winkels,0,0,2,2
21709,durant,0,0,2,2
880,interessato,1,2,0,2
3092,backgammon,1,2,0,2
33769,apprendre,0,0,2,2
33768,domaines,0,0,2,2
4433,ಯಾವುದನ್ನಾದರೂ,0,0,2,2
25474,डूब,0,0,2,2
14948,ഏതെങ്കിലും,0,0,2,2
21378,بشخص,0,0,2,2
1555,libri,1,2,0,2
15209,அனைவரும்,0,0,2,2
21705,acuñado,0,0,2,2
36118,label,0,0,2,2
21702,locuteurs,0,0,2,2
3620,continuò,1,2,0,2
41111,batmak,0,0,2,2
41110,bad,0,0,2,2
916,universalmente,2,1,1,2
21162,സുഹൃത്തുക്കൾ,0,0,2,2
41094,feel,0,0,2,2
25459,indexação,0,0,2,2
41096,stimuli,0,0,2,2
25460,ελέγξετε,0,0,2,2
41098,forum,0,0,2,2
41588,مثال,0,0,2,2
4432,completo,0,0,2,2
22471,rank,0,0,2,2
25465,apprenez,0,0,2,2
41109,procedentes,0,0,2,2
36866,ευγενικά,0,0,2,2
36864,pageviews,0,0,2,2
36469,rigor,0,0,2,2
21380,गुमनाम,0,0,2,2
2008,norme,1,2,0,2
21379,libertine,0,0,2,2
22195,рендеринга,0,0,2,2
21591,derivadas,0,0,2,2
15150,quantidade,0,0,2,2
21229,"
मिन",0,0,2,2
35920,print,0,0,2,2
15032,exchange,0,0,2,2
36734,கொடுக்க,0,0,2,2
36521,precies,0,0,2,2
41231,प्रशासकों,0,0,2,2
41534,работала,0,0,2,2
22407,propensos,0,0,2,2
33713,«я,0,0,2,2
25565,konfliktlösning,0,0,2,2
15046,व्यवस्थित,0,0,2,2
41239,نظر,0,0,2,2
21633,കഴിയില്ലെന്ന്,0,0,2,2
41282,व्यक्तिगत,0,0,2,2
41243,equipe,0,0,2,2
21632,myntades,0,0,2,2
14992,implies,0,0,2,2
36523,stone,0,0,2,2
1662,passato,1,2,0,2
15037,student,0,0,2,2
926,conosciuta,1,2,0,2
33575,पत्रिका,0,0,2,2
41285,tendemos,0,0,2,2
1682,protette,1,2,0,2
41508,savaşı,0,0,2,2
15068,तुमसे,0,0,2,2
21285,ну,0,0,2,2
4449,இணைய,0,0,2,2
36780,xviie siècle,0,0,2,2
41539,വ്യക്തമായ,0,0,2,2
41538,الربع,0,0,2,2
25597,redigeringarna,0,0,2,2
36778,noticiário,0,0,2,2
15069,öğrenmeye,0,0,2,2
21644,ermee,0,0,2,2
33716,உழைப்பது,0,0,2,2
41221,diseño,0,0,2,2
21345,aprobación,0,0,2,2
22414,الأمثلة,0,0,2,2
22232,verification,0,0,2,2
14983,periódicos,0,0,2,2
33571,தன்னை,0,0,2,2
21640,мелисса,0,0,2,2
33718,instruktioner,0,0,2,2
21311,മാറ്റി,0,0,2,2
21312,resultaat,0,0,2,2
33687,geschenk,0,0,2,2
14661,tendem,0,0,2,2
35977,symptoms,0,0,2,2
36528,βικινέα,0,0,2,2
4499,ಸಮಯದವರೆಗೆ,0,0,2,2
15018,voitures,0,0,2,2
33700,الفيلم,0,0,2,2
21326,nöje,0,0,2,2
21328,качество,0,0,2,2
22386,ഭയാനകമായ,0,0,2,2
41521,recebe,0,0,2,2
14647,gamla,0,0,2,2
15012,voorzichtig,0,0,2,2
15002,ocho,0,0,2,2
41266,точности,0,0,2,2
25585,गोल्डन,0,0,2,2
36745,loves,0,0,2,2
25588,പ്രൈമറി,0,0,2,2
33583,mention,0,0,2,2
33584,चलता,0,0,2,2
4454,yapacak,0,0,2,2
25758,l’influence,0,0,2,2
25746,nommé,0,0,2,2
41257,bezeichnen,0,0,2,2
21627,إم,0,0,2,2
33705,الحرة,0,0,2,2
21628,रहना,0,0,2,2
41530,مجال,0,0,2,2
41528,ακούσετε,0,0,2,2
41277,अग्रसर,0,0,2,2
14659,ξεχάσετε,0,0,2,2
22402,വിജ്ഞാനകോശത്തിന്റെ,0,0,2,2
22385,lila,0,0,2,2
33704,विश्वकोशों,0,0,2,2
21620,yasseri,0,0,2,2
21316,اكتشاف,0,0,2,2
41526,വീഡിയോയിൽ,0,0,2,2
15026,rubiner,0,0,2,2
36739,conséquence,0,0,2,2
21317,kdd,0,0,2,2
41272,damas,0,0,2,2
35973,tijdje,0,0,2,2
15023,pedi,0,0,2,2
14619,ഇതിനു,0,0,2,2
3765,പതുക്കെ,0,0,2,2
15148,sofá,0,0,2,2
14969,குறிக்கிறது,0,0,2,2
36808,migrating,0,0,2,2
22431,الحين,0,0,2,2
21665,жизнь,0,0,2,2
21249,professores,0,0,2,2
21250,foco,0,0,2,2
21251,включён,0,0,2,2
41179,bankkredit,0,0,2,2
3526,esso,1,2,0,2
25777,امرأة,0,0,2,2
1659,philip,2,1,1,2
35955,വാക്യങ്ങൾ‌,0,0,2,2
22427,agence,0,0,2,2
22248,bewegen,0,0,2,2
25525,derovre,0,0,2,2
1688,esattamente,1,2,0,2
25776,centros,0,0,2,2
36794,kallade,0,0,2,2
25528,telefone,0,0,2,2
14605,correcteur,0,0,2,2
25520,руководства,0,0,2,2
15132,idiot,0,0,2,2
1690,scuola,1,2,0,2
25782,следующую,0,0,2,2
41163,régulièrement,0,0,2,2
14967,simbolizando,0,0,2,2
15144,лицензиями,0,0,2,2
14592,acte,0,0,2,2
15143,reflection,0,0,2,2
25515,telling,0,0,2,2
41558,حل,0,0,2,2
21233,لفترة,0,0,2,2
41168,ves,0,0,2,2
15134,बताता,0,0,2,2
36816,അൽപ്പം,0,0,2,2
14597,थका,0,0,2,2
21358,pratade,0,0,2,2
25780,മാതൃക,0,0,2,2
1561,quest,2,1,1,2
33564,relied,0,0,2,2
1562,amiche,1,2,0,2
14968,consensus,0,0,2,2
21269,investigators,0,0,2,2
4443,använt,0,0,2,2
41217,humaine »,0,0,2,2
41190,sorprendente,0,0,2,2
22418,дополнительный,0,0,2,2
15090,cuentas,0,0,2,2
36537,unidas,0,0,2,2
3679,accessibile,1,2,0,2
36783,branch,0,0,2,2
14614,لأنه,0,0,2,2
25543,انتظر,0,0,2,2
21648,spinoza,0,0,2,2
25544,obscenas,0,0,2,2
15084,windows,0,0,2,2
25547,representatives,0,0,2,2
21647,etou,0,0,2,2
25770,revanche,0,0,2,2
14977,ಸಣ್ಣ,0,0,2,2
21280,διαφορετικά,0,0,2,2
25548,fondateurs,0,0,2,2
41291,விக்கி,0,0,2,2
36095,distintos,0,0,2,2
3096,aree,1,2,0,2
41205,ومدى,0,0,2,2
41204,manuals,0,0,2,2
15096,gagne,0,0,2,2
21656,independence,0,0,2,2
1567,impegnato,1,2,0,2
21659,وكيف,0,0,2,2
35990,tenham,0,0,2,2
15109,അവനോട്,0,0,2,2
22377,contrário,0,0,2,2
1568,temporaneo,1,2,0,2
15107,tratando,0,0,2,2
3669,leo,2,1,1,2
1569,dirmi,1,2,0,2
33685,manipular,0,0,2,2
36726,gegangen,0,0,2,2
4508,सपनों,0,0,2,2
41196,рекламы,0,0,2,2
25534,أمريكي,0,0,2,2
15102,dominate,0,0,2,2
22228,thinking,0,0,2,2
14975,rápidas,0,0,2,2
15098,tilsammen,0,0,2,2
15262,sorduğunda,0,0,2,2
14687,सलाह,0,0,2,2
40910,बदला,0,0,2,2
14905,റൂട്ട്,0,0,2,2
21798,niemand,0,0,2,2
1589,traguardo,1,2,0,2
15416,geçti,0,0,2,2
1992,scoperte,1,2,0,2
20994,κορυφή,0,0,2,2
25862,мужчина,0,0,2,2
3517,grammatica,2,1,1,2
33606,håber,0,0,2,2
36973,مساعدتك,0,0,2,2
1613,marvin,1,2,0,2
21004,represents,0,0,2,2
14439,الجدد,0,0,2,2
33504,पेज,0,0,2,2
14443,സബ്‌സ്‌ക്രൈബ്,0,0,2,2
21419,meerderheid,0,0,2,2
21796,கொடூரமானவை,0,0,2,2
14444,aren,0,0,2,2
21010,systeem,0,0,2,2
41469,comédia,0,0,2,2
21799,relatou,0,0,2,2
40958,regularmente,0,0,2,2
35865,drücken,0,0,2,2
3514,associazioni,1,2,0,2
15433,வழியில்,0,0,2,2
14428,viernes,0,0,2,2
15432,പറയുന്നത്,0,0,2,2
22563,sediments,0,0,2,2
35862,raiva,0,0,2,2
14901,manutenção,0,0,2,2
35864,крупным,0,0,2,2
14433,ಯಾರು,0,0,2,2
36407,μέλι,0,0,2,2
36983,animar,0,0,2,2
14435,commentaire,0,0,2,2
22148,hit,0,0,2,2
40950,वाक्यों,0,0,2,2
14902,steps,0,0,2,2
40953,veio,0,0,2,2
25863,overgenomen,0,0,2,2
40954,القناة,0,0,2,2
33844,oferecido,0,0,2,2
36567,لتكون,0,0,2,2
35877,songs,0,0,2,2
3602,formali,1,2,0,2
33837,विशेषज्ञों,0,0,2,2
40978,installed,0,0,2,2
21409,oraya,0,0,2,2
33831,constitutes,0,0,2,2
35880,interesting,0,0,2,2
971,password,2,1,1,2
41473,literally,0,0,2,2
15388,publicou,0,0,2,2
25851,فارما,0,0,2,2
36955,visitantes,0,0,2,2
21030,interessiert,0,0,2,2
25631,पूरा,0,0,2,2
25384,fortjener,0,0,2,2
36151,свободно,0,0,2,2
25385,ஒருவருக்கொருவர்,0,0,2,2
22154,ഉണ്ടോ,0,0,2,2
14464,padrão,0,0,2,2
22157,മനസ്സിൽ,0,0,2,2
15382,موقفًا,0,0,2,2
25388,dominated,0,0,2,2
21410,consigues,0,0,2,2
22540,машинами,0,0,2,2
33834,responsabilidade,0,0,2,2
36690,groeide,0,0,2,2
36410,median,0,0,2,2
15407,மொழிப்,0,0,2,2
41470,reçus,0,0,2,2
36688,appliqué,0,0,2,2
21794,souligner,0,0,2,2
21016,navnet,0,0,2,2
15405,assurezvous,0,0,2,2
40970,électronique,0,0,2,2
15403,بعيدًا,0,0,2,2
25852,åsikt,0,0,2,2
4488,بالكاد,0,0,2,2
33510,коммерческой,0,0,2,2
15400,جميلة,0,0,2,2
14454,crash,0,0,2,2
35879,weile,0,0,2,2
41661,работа,0,0,2,2
14908,contexto,0,0,2,2
1544,markov,2,1,1,2
40946,усерднее,0,0,2,2
41681,uv,0,0,2,2
14467,ثلث,0,0,2,2
22347,pequena,0,0,2,2
20943,gerek,0,0,2,2
20945,аппроксимации,0,0,2,2
41693,förslag,0,0,2,2
15472,holen,0,0,2,2
14411,мультимедийных,0,0,2,2
33663,pardelà,0,0,2,2
15470,oprette,0,0,2,2
22575,portugués,0,0,2,2
20949,ciclo,0,0,2,2
3116,fondata,1,2,0,2
2023,mesi,1,2,0,2
35854,rico,0,0,2,2
21815,تنزعج,0,0,2,2
21572,cumulative,0,0,2,2
25344,περάσετε,0,0,2,2
21813,λικνίζεις,0,0,2,2
36157,satire,0,0,2,2
37008,ಪಾಠಗಳನ್ನು,0,0,2,2
41688,വിശദീകരിക്കുന്നു,0,0,2,2
40920,ನೋಡಿದ,0,0,2,2
37018,lycka,0,0,2,2
37020,prenez,0,0,2,2
37036,skål,0,0,2,2
21827,واراي,0,0,2,2
21571,geschikt,0,0,2,2
36163,اسمها,0,0,2,2
22590,словом,0,0,2,2
20919,alcanzar,0,0,2,2
40912,sesgos,0,0,2,2
37038,capazes,0,0,2,2
25337,и т п,0,0,2,2
36011,crisis,0,0,2,2
41269,أحبك,0,0,2,2
21822,intrusion,0,0,2,2
15482,narzisse,0,0,2,2
36396,भरोसा,0,0,2,2
22581,க்கும்,0,0,2,2
20933,رسمية,0,0,2,2
36158,baseras,0,0,2,2
37022,السياسات,0,0,2,2
1988,pubblicati,1,2,0,2
21573,interação,0,0,2,2
21811,instituto,0,0,2,2
3157,protein,2,1,1,2
15464,فبراير,0,0,2,2
36683,libre»—,0,0,2,2
36995,culturele,0,0,2,2
3560,mobili,1,2,0,2
33851,pronunciación,0,0,2,2
36405,mathematics,0,0,2,2
21575,κόρης,0,0,2,2
36406,தோற்றம்,0,0,2,2
20976,dillerdeki,0,0,2,2
14422,экспертных,0,0,2,2
25871,αρχείο,0,0,2,2
36994,existent,0,0,2,2
4397,vrijgegeven,0,0,2,2
14898,mariage,0,0,2,2
14900,interés,0,0,2,2
40942,ವಾಕ್ಯಗಳು,0,0,2,2
20979,बिलकुल,0,0,2,2
25869,studera,0,0,2,2
36992,sept,0,0,2,2
1703,modificare,1,2,0,2
36996,ifadesi,0,0,2,2
36400,josé,0,0,2,2
15447,altered,0,0,2,2
41343,премию,0,0,2,2
37004,yasal,0,0,2,2
33610,bénévoles,0,0,2,2
861,iscrizione,1,2,0,2
15463,ação,0,0,2,2
4393,sereno,0,0,2,2
4539,चुनाव,0,0,2,2
15456,ваш,0,0,2,2
20965,tidig,0,0,2,2
15455,marry,0,0,2,2
15448,फाइलें,0,0,2,2
33856,stumpfe,0,0,2,2
15452,magische,0,0,2,2
37001,trodde,0,0,2,2
37000,associate,0,0,2,2
20970,சிறுவன்,0,0,2,2
36999,kullanmaktadır,0,0,2,2
36997,feifei,0,0,2,2
41465,tabeller,0,0,2,2
33825,devletleri,0,0,2,2
3154,geometria,2,1,1,2
14537,conclusions,0,0,2,2
41607,ideologiskt,0,0,2,2
41043,ningún,0,0,2,2
41046,छात्रों,0,0,2,2
21750,incorporated,0,0,2,2
25722,توقف,0,0,2,2
25819,हैरान,0,0,2,2
21101,cautions,0,0,2,2
25818,acusada,0,0,2,2
21104,विकिताबें,0,0,2,2
22498,switched,0,0,2,2
35909,opdagelser,0,0,2,2
14697,hoovering,0,0,2,2
36899,അറിയാം,0,0,2,2
22363,മുകളിൽ,0,0,2,2
22496,twelve,0,0,2,2
36445,irrelevant,0,0,2,2
25812,illegal,0,0,2,2
33799,transfer,0,0,2,2
3142,interrogativo,1,2,0,2
36705,தலைமையான,0,0,2,2
36904,desarrolló,0,0,2,2
21098,verfijnd,0,0,2,2
41478,अरे,0,0,2,2
15309,ಅಭಿಪ್ರಾಯಗಳು,0,0,2,2
21087,modifying,0,0,2,2
1664,dov,1,2,0,2
33803,constar,0,0,2,2
36910,പ്രസിദ്ധമായ,0,0,2,2
21394,содержание,0,0,2,2
3614,tende,2,1,1,2
41040,وموسوعة,0,0,2,2
21754,globalement,0,0,2,2
21091,telecomunicaciones,0,0,2,2
21097,uitspraak,0,0,2,2
22171,internes,0,0,2,2
1552,scarsa,1,2,0,2
41618,électorale,0,0,2,2
21096,مراقبة,0,0,2,2
14510,مضاء,0,0,2,2
15307,சொல்கிறார்கள்,0,0,2,2
41042,médiatiques,0,0,2,2
14702,destinamse,0,0,2,2
25428,comparou,0,0,2,2
25724,digg,0,0,2,2
25419,altaylı,0,0,2,2
33601,repositório,0,0,2,2
22484,källhänvisningar,0,0,2,2
1607,nodi,1,2,0,2
25440,wikiconcept,0,0,2,2
33793,acciones,0,0,2,2
2043,proposti,1,2,0,2
14532,extrameile,0,0,2,2
14533,τεράστιο,0,0,2,2
33792,trick,0,0,2,2
33542,meta,0,0,2,2
14535,നടത്തി,0,0,2,2
41318,sociales,0,0,2,2
21133,undisclosed,0,0,2,2
21134,appliquer,0,0,2,2
958,linguaggio,1,2,0,2
36074,historien,0,0,2,2
35918,intensifier,0,0,2,2
41070,chère,0,0,2,2
4424,nederland,0,0,2,2
41073,numerosos,0,0,2,2
15278,अर्थशास्त्र,0,0,2,2
3140,dovuto,1,2,0,2
21131,føler,0,0,2,2
25434,трафика,0,0,2,2
21390,نرجس,0,0,2,2
3664,testa,1,2,0,2
15290,längre,0,0,2,2
33796,വിവരം,0,0,2,2
22491,maakte,0,0,2,2
21743,diario,0,0,2,2
14692,answered,0,0,2,2
36134,percepção,0,0,2,2
36708,கட்டுரைகளைக்,0,0,2,2
22486,ഞങ്ങളുടെ,0,0,2,2
21124,ಚಿಂತೆ,0,0,2,2
22176,الموضوعات,0,0,2,2
41603,языковые,0,0,2,2
21126,கட்டுரைகளுடன்,0,0,2,2
35916,crossbar,0,0,2,2
21128,proibir,0,0,2,2
21739,edemem,0,0,2,2
21738,wikiwiki,0,0,2,2
22504,forest,0,0,2,2
15316,irme,0,0,2,2
15376,tusentals,0,0,2,2
41008,രഹസ്യമായി,0,0,2,2
40998,சர்ச்சைக்குரிய,0,0,2,2
15364,രണ്ടു,0,0,2,2
22523,восстановить,0,0,2,2
40999,irmãos,0,0,2,2
21771,എവിടെ,0,0,2,2
3607,collegamenti,1,2,0,2
14480,வாழ்த்துக்கள்,0,0,2,2
1702,salto,2,1,1,2
15361,representar,0,0,2,2
14915,контроля,0,0,2,2
3610,singole,1,2,0,2
21057,огромных,0,0,2,2
15355,गतिविधियों,0,0,2,2
36141,எல்லாம்,0,0,2,2
36563,सुनहरे,0,0,2,2
21059,welk,0,0,2,2
25627,πάρτε,0,0,2,2
25836,politician,0,0,2,2
36932,tone,0,0,2,2
1547,impara,1,2,0,2
25839,atteindre,0,0,2,2
25393,british,0,0,2,2
41650,salades,0,0,2,2
21032,estará,0,0,2,2
25845,ikiniz,0,0,2,2
1674,francese,1,2,0,2
14469,utseende,0,0,2,2
36566,wisdom,0,0,2,2
21778,μαθαίνετε,0,0,2,2
14709,researched,0,0,2,2
36949,அனுப்ப,0,0,2,2
22529,rostros,0,0,2,2
36428,बल्कि,0,0,2,2
40995,χρυσή,0,0,2,2
33626,kullanım,0,0,2,2
3088,singoli,1,2,0,2
3605,conosci,1,2,0,2
36426,хлеба,0,0,2,2
2048,venne,1,2,0,2
14914,विकिक्वोट,0,0,2,2
36700,ഉറപ്പാക്കുക,0,0,2,2
33817,princip,0,0,2,2
36435,funcionava,0,0,2,2
25418,dentre,0,0,2,2
3702,grandioso,1,2,0,2
41629,tráfico,0,0,2,2
15328,क्लिक,0,0,2,2
21397,süß,0,0,2,2
41326,oben,0,0,2,2
2037,tardi,1,2,0,2
41029,projelerinin,0,0,2,2
3613,sofisticato,1,2,0,2
22508,primært,0,0,2,2
41030,κλικ,0,0,2,2
21081,प्रकाशित,0,0,2,2
14927,says,0,0,2,2
15320,മാറി,0,0,2,2
3091,piattaforma,1,2,0,2
35903,சேனலுக்கு,0,0,2,2
21083,न्यासी,0,0,2,2
14705,descrita,0,0,2,2
41033,nybörjare,0,0,2,2
14502,stuk,0,0,2,2
33529,agency,0,0,2,2
14492,devagar,0,0,2,2
25414,دقيقة,0,0,2,2
41632,менее,0,0,2,2
22168,rápido,0,0,2,2
36931,probably,0,0,2,2
22516,bienvenue,0,0,2,2
14919,enda,0,0,2,2
25626,involve,0,0,2,2
14921,comparaison,0,0,2,2
25625,watercourse,0,0,2,2
41012,contratados,0,0,2,2
33813,generates,0,0,2,2
41016,رؤيته,0,0,2,2
33807,sofort,0,0,2,2
2000,perciò,1,2,0,2
21760,precisos,0,0,2,2
36561,удачи,0,0,2,2
14488,remain,0,0,2,2
1550,risoluzione,1,2,0,2
22515,équilibre,0,0,2,2
21072,milieux,0,0,2,2
25831,blij,0,0,2,2
40996,devoted,0,0,2,2
37522,quinto,0,0,2,2
15963,നൽകി,0,0,2,2
24233,presidente,0,0,2,2
3295,hopfield,2,1,1,2
3910,negocio,0,0,2,2
17657,sowohl,0,0,2,2
17656,terrível,0,0,2,2
24237,nationalencyklopedin,0,0,2,2
24238,escrituras,0,0,2,2
19201,desarrollada,0,0,2,2
34645,semanas,0,0,2,2
39356,ചോദിക്കാം,0,0,2,2
17649,"
पिकार्ड",0,0,2,2
17648,രണ്ടുപേരും,0,0,2,2
19209,मित्र,0,0,2,2
23461,الموجود,0,0,2,2
23460,miles,0,0,2,2
19217,المعتاد,0,0,2,2
39362,cebuanospråkiga,0,0,2,2
3290,porterò,1,2,0,2
24247,πείραζε,0,0,2,2
39365,ouvi,0,0,2,2
17635,digamos,0,0,2,2
24248,понимаю,0,0,2,2
34637,ಹೆಚ್ಚಾಗಿ,0,0,2,2
17631,estabelecidos,0,0,2,2
19222,மெதுவான,0,0,2,2
35230,åt,0,0,2,2
17630,terceira,0,0,2,2
17629,நிலைமை,0,0,2,2
1861,sistemici,1,2,0,2
17663,yapalım,0,0,2,2
38023,inondé,0,0,2,2
24231,ಫೋನ್,0,0,2,2
39319,entretient,0,0,2,2
19166,hvilken,0,0,2,2
19167,divin,0,0,2,2
39323,kingdoms,0,0,2,2
19168,yaptığı,0,0,2,2
38302,macs,0,0,2,2
17691,numara,0,0,2,2
23479,അക്യൂട്ട്,0,0,2,2
39326,micro,0,0,2,2
38299,σχεδίου,0,0,2,2
38298,wikification,0,0,2,2
1860,matto,1,2,0,2
39333,русская,0,0,2,2
4110,maturation,0,0,2,2
35216,demuestra,0,0,2,2
17679,profound,0,0,2,2
23470,soldados,0,0,2,2
19187,بهذا,0,0,2,2
38289,يشجع,0,0,2,2
39337,purement,0,0,2,2
24224,devrait,0,0,2,2
17672,ninguém,0,0,2,2
24228,بحلول,0,0,2,2
38288,kalde,0,0,2,2
38286,средства,0,0,2,2
34649,تذهب,0,0,2,2
17666,longue,0,0,2,2
19226,നിർമ്മിച്ച,0,0,2,2
17628,ಬ್ಯಾಂಕ್,0,0,2,2
34636,назван,0,0,2,2
17626,députés,0,0,2,2
39401,تصدر,0,0,2,2
38230,പ്രായം,0,0,2,2
17579,ಮಗಳ,0,0,2,2
1867,produrre,1,2,0,2
4126,pu,0,0,2,2
23428,novamente,0,0,2,2
39405,മുങ്ങുക,0,0,2,2
4127,origins,0,0,2,2
1190,presentate,1,2,0,2
17572,colonized,0,0,2,2
1189,accesso,1,2,0,2
23427,പരിശോധിച്ച്,0,0,2,2
17570,ലേഖനത്തെ,0,0,2,2
19276,geçebilirsin,0,0,2,2
38224,बच्चों,0,0,2,2
23421,soutien,0,0,2,2
17567,shane,0,0,2,2
23420,clearly,0,0,2,2
38215,mulheres,0,0,2,2
17564,kleiner,0,0,2,2
39414,establecer,0,0,2,2
39415,விரைவான,0,0,2,2
17559,നാർസിസ്,0,0,2,2
17557,gehts,0,0,2,2
39417,gorman,0,0,2,2
38210,मूल्यांकन,0,0,2,2
17553,مشاهدة,0,0,2,2
24272,марион,0,0,2,2
35247,eugene,0,0,2,2
38234,açısını,0,0,2,2
38250,ولكنها,0,0,2,2
34635,wacht,0,0,2,2
23452,пример,0,0,2,2
1341,complessa,1,2,0,2
24254,vores,0,0,2,2
17620,जनता,0,0,2,2
1195,singola,1,2,0,2
19231,decisões,0,0,2,2
34633,dependent,0,0,2,2
17615,poder,0,0,2,2
1194,gentili,1,2,0,2
38260,вроде,0,0,2,2
19234,araba,0,0,2,2
24262,श्रेय,0,0,2,2
38237, years,0,0,2,2
39386,betreft,0,0,2,2
19246,introducir,0,0,2,2
38249,domínio,0,0,2,2
24266,संगठनों,0,0,2,2
24267,çapraz,0,0,2,2
23442,political,0,0,2,2
17597,vídeos,0,0,2,2
38244,أراك,0,0,2,2
17594,അർത്ഥമാക്കുന്നു,0,0,2,2
39394,mögen,0,0,2,2
17592,പങ്കാളിത്തത്തിലൂടെ,0,0,2,2
19259,soluções,0,0,2,2
38305,aient,0,0,2,2
19164,στείλετε,0,0,2,2
19163,أدناه,0,0,2,2
17803,holdout,0,0,2,2
1854,responsabile,1,2,0,2
17829,parmaklar,0,0,2,2
23525,pesado,0,0,2,2
23524,അതുപോലെ,0,0,2,2
24141,chosen,0,0,2,2
3389,miglio,1,2,0,2
23520,mantidas,0,0,2,2
17821,krav,0,0,2,2
19080,उच्च,0,0,2,2
38356,tropical,0,0,2,2
17818,fortsätter,0,0,2,2
17817,ಪದಗಳಲ್ಲಿ,0,0,2,2
17816,stötte,0,0,2,2
1319,intero,1,2,0,2
19084,drainage,0,0,2,2
3313,votazione,1,2,0,2
19085,الواقع,0,0,2,2
38354,fångst,0,0,2,2
1320,portata,1,2,0,2
3922,تعتمد,0,0,2,2
3921,series,0,0,2,2
24150,artikelns,0,0,2,2
1321,«non,1,2,0,2
34713,создание,0,0,2,2
19095,கவனிப்புப்,0,0,2,2
39245,groei,0,0,2,2
19096,antisocial,0,0,2,2
1211,classiche,1,2,0,2
24139,trabajando,0,0,2,2
38367,må,0,0,2,2
38378,sens ,0,0,2,2
4084,maurice,0,0,2,2
39206,pourraient,0,0,2,2
23539,blivit,0,0,2,2
39208,bestaan,0,0,2,2
39211,ലേഖനത്തിന്റെ,0,0,2,2
17856,henry,0,0,2,2
39212,inteira,0,0,2,2
17854,مفيدة,0,0,2,2
3927,gelen,0,0,2,2
4085,الثلاثة,0,0,2,2
34724,missing,0,0,2,2
19054,construir,0,0,2,2
38377,वेब्बी,0,0,2,2
17834,collision,0,0,2,2
39217,reducing,0,0,2,2
17846,habilidades,0,0,2,2
17845,condutas,0,0,2,2
39218,besef,0,0,2,2
3314,francia,2,1,1,2
39220,återställa,0,0,2,2
35179,thin,0,0,2,2
34723,ordforråd,0,0,2,2
1852,lanciata,1,2,0,2
35183,σφαίρα,0,0,2,2
19067,personales,0,0,2,2
39225,образ,0,0,2,2
23513,полностью,0,0,2,2
17802,lolicon,0,0,2,2
34667,sage,0,0,2,2
39249,большая,0,0,2,2
39280,ansåg,0,0,2,2
19123,систем,0,0,2,2
1207,diritti,1,2,0,2
24187,الأشهر,0,0,2,2
3390,infrazioni,1,2,0,2
23500,considérer,0,0,2,2
19132,महीनों,0,0,2,2
19134,bloque,0,0,2,2
17743,konuda,0,0,2,2
39291,لدرجة,0,0,2,2
35200,относительно,0,0,2,2
3916,sérieuse,0,0,2,2
35205,ولكنك,0,0,2,2
39298,ರಹಸ್ಯವಾದ,0,0,2,2
23487,لكنها,0,0,2,2
17728,ruimte,0,0,2,2
17725,முனை,0,0,2,2
24199,जलाया,0,0,2,2
19154,ചുവടുവപ്പ്,0,0,2,2
3914,வெள்ளிக்கிழமை,0,0,2,2
19158,ಭವ್ಯವಾದ,0,0,2,2
17718,concluded,0,0,2,2
35213,वेबसाइटों,0,0,2,2
39309,लैटिन,0,0,2,2
17711,दोहराने,0,0,2,2
4105,konuşmak,0,0,2,2
17706,ഉണ്ടെങ്കിൽ,0,0,2,2
34689,ولطيف,0,0,2,2
38334,journaux,0,0,2,2
39278,jornal,0,0,2,2
4092,سأقدم,0,0,2,2
17795,opérateurs,0,0,2,2
38346,قليلاً,0,0,2,2
34707,sag,0,0,2,2
19102,discrètes,0,0,2,2
19103,funktioner,0,0,2,2
19104,लिह,0,0,2,2
23512,bristande,0,0,2,2
19106,обозначения,0,0,2,2
1209,capacità,1,2,0,2
38344,tråkig,0,0,2,2
39257,ukrainien,0,0,2,2
19110,donationer,0,0,2,2
35193,internettet,0,0,2,2
34691,निम्न,0,0,2,2
17781,oficialmente,0,0,2,2
23508,verscheen,0,0,2,2
17776,rekommenderar,0,0,2,2
17775,candidate,0,0,2,2
19114,ನೋಡುತ್ತೇನೆ,0,0,2,2
19115,encontrarse,0,0,2,2
34696,lesquelles,0,0,2,2
34695,påståenden,0,0,2,2
23507,curso,0,0,2,2
34694,минутку,0,0,2,2
24176,görüşürüz,0,0,2,2
38335,helgen,0,0,2,2
34613,trouver,0,0,2,2
39420,role,0,0,2,2
23414,oferecer,0,0,2,2
35318,head,0,0,2,2
17358,என்னவென்று,0,0,2,2
39561,bottom,0,0,2,2
39562,கருத்துக்கள்,0,0,2,2
24374,കുറിച്ചുള്ള,0,0,2,2
34550,மொழிகளிலும்,0,0,2,2
1763,continuo,1,2,0,2
35310,combination,0,0,2,2
24378,tidigt,0,0,2,2
38092,धीमा,0,0,2,2
38089,utvecklade,0,0,2,2
38088,بأكملها,0,0,2,2
23332,eşit,0,0,2,2
39571,வைத்திருக்கிறேன்,0,0,2,2
35313,ações,0,0,2,2
19467,partout,0,0,2,2
19468,dum,0,0,2,2
1373,utili,1,2,0,2
24383,हाथ,0,0,2,2
23328,södertörns,0,0,2,2
34546,ഇല്ലാത്തതിനാൽ,0,0,2,2
17336,оригинальных,0,0,2,2
4145,warte,0,0,2,2
17334,zat,0,0,2,2
3876,expérimentale,0,0,2,2
38077,zichzelf,0,0,2,2
19475,« res,0,0,2,2
24391,gelernt,0,0,2,2
34552,unable,0,0,2,2
1767,conto,1,2,0,2
19444,mobiltelefon,0,0,2,2
39549,rapide,0,0,2,2
17389,unreliable,0,0,2,2
23348,register,0,0,2,2
35303,improved,0,0,2,2
19428,ലേഖനങ്ങളാവാൻ,0,0,2,2
19429,presentar,0,0,2,2
19431,tornouse,0,0,2,2
1169,criticò,1,2,0,2
39546,consultées,0,0,2,2
17379,universitetet,0,0,2,2
24365,μίλι,0,0,2,2
17377,estés,0,0,2,2
24366,armazenadas,0,0,2,2
39551,ಬೆಳಿಗ್ಗೆ,0,0,2,2
19443,evitar,0,0,2,2
4141,christian,0,0,2,2
19434,deposition,0,0,2,2
23345,collectie,0,0,2,2
39553,querido,0,0,2,2
1367,efficiente,1,2,0,2
17367,suivi,0,0,2,2
23344,авторитетных,0,0,2,2
38102,pensais,0,0,2,2
19440,portaal,0,0,2,2
35304,amerikanere,0,0,2,2
23342,होगा।,0,0,2,2
34553,ενοχλητική,0,0,2,2
38075,العملية,0,0,2,2
3872,welchem,0,0,2,2
3271,www,2,1,1,2
3871,paths,0,0,2,2
38043,sofistikeret,0,0,2,2
39631,littérature,0,0,2,2
19520,الليلة؟,0,0,2,2
19521,وجد,0,0,2,2
23299,содержимого,0,0,2,2
1889,machinery,2,1,1,2
1383,collegato,1,2,0,2
17266,आवश्यक,0,0,2,2
38037,profundamente,0,0,2,2
39641,العناء,0,0,2,2
24429,xviie,0,0,2,2
1151,adatte,1,2,0,2
24431,रखें।,0,0,2,2
38036,lagen,0,0,2,2
24433,टु,0,0,2,2
17252,sit,0,0,2,2
19531,видела,0,0,2,2
39648,περιμένατε,0,0,2,2
24434,tantas,0,0,2,2
24435,الآلة,0,0,2,2
23296,прецедентам,0,0,2,2
23295,editorchefe,0,0,2,2
24437,രാവിലെ,0,0,2,2
39656,качества,0,0,2,2
39657,ali,0,0,2,2
17241,körs,0,0,2,2
17236,சரியான,0,0,2,2
4153,encyclopédiques,0,0,2,2
38044,goldenen,0,0,2,2
38046,lente,0,0,2,2
19499,सुबह,0,0,2,2
38069,incluidos,0,0,2,2
39592,prenumerationsknappen,0,0,2,2
39593,ಹೋದರು,0,0,2,2
34539,narzissenhand,0,0,2,2
17314,ആവർത്തിക്കാമോ,0,0,2,2
35321,örneği,0,0,2,2
39597,émancipation,0,0,2,2
4148,esposa,0,0,2,2
24398,regel,0,0,2,2
17309,അടിസ്ഥാനമാക്കി,0,0,2,2
23317,сидела,0,0,2,2
23316,periodistas,0,0,2,2
23310,mısın,0,0,2,2
19514,indse,0,0,2,2
24401,இருக்கலாம்,0,0,2,2
19504,recogen,0,0,2,2
17297,يوليو,0,0,2,2
17294,stegbauer,0,0,2,2
19508,कथित,0,0,2,2
1154,tornare,1,2,0,2
39614,दर्जा,0,0,2,2
35330,hoog,0,0,2,2
34531,الناس,0,0,2,2
24408,allégorique,0,0,2,2
39617,дисков,0,0,2,2
24409,impactfactor,0,0,2,2
39537,فضيًا,0,0,2,2
23352,caractère,0,0,2,2
38205,"
निम्न",0,0,2,2
38168,αόριστος,0,0,2,2
19321,математике,0,0,2,2
19322,objeto,0,0,2,2
1178,bayesiano,1,2,0,2
17508,потрясающе»,0,0,2,2
34603,restrictions,0,0,2,2
17506,മറക്കരുത്,0,0,2,2
19326,областях,0,0,2,2
17504,configuração,0,0,2,2
38183,visitar,0,0,2,2
3280,usata,1,2,0,2
24305,ಭೇಟಿಯಾಗಲು,0,0,2,2
3279,controllate,1,2,0,2
23398,bloqueo,0,0,2,2
19332,നൂപീഡിയ,0,0,2,2
38180,pt,0,0,2,2
17492,الحرية,0,0,2,2
35268,pasó,0,0,2,2
38176,ആൺകുട്ടി,0,0,2,2
34597,essay,0,0,2,2
35269,kaldet,0,0,2,2
35271,объектах,0,0,2,2
19341,limite,0,0,2,2
39465,രൂപത്തിൽ,0,0,2,2
19344,στους,0,0,2,2
3896,أمر,0,0,2,2
39468,निरीक्षण,0,0,2,2
24313,перцептрон,0,0,2,2
35264,vandalizme,0,0,2,2
39448,şaşırdı,0,0,2,2
39446,produktiva,0,0,2,2
38195,الإعجاب,0,0,2,2
39422,ndeki,0,0,2,2
17546,deltagarna,0,0,2,2
39423,credenciais,0,0,2,2
1186,distribuite,1,2,0,2
23412,recommended,0,0,2,2
17540,energética,0,0,2,2
3403,sviluppati,1,2,0,2
39430,zilver,0,0,2,2
38199,ولاري,0,0,2,2
3286,smetti,1,2,0,2
3285,ampia,1,2,0,2
24292,έκανα,0,0,2,2
39439,servicios,0,0,2,2
17515,neutral»,0,0,2,2
3283,insegnante,1,2,0,2
1355,solitamente,1,2,0,2
24296,αντικειμενική,0,0,2,2
17522,improving,0,0,2,2
35260,बेवकूफ़,0,0,2,2
17520,cycle,0,0,2,2
38192,laissé,0,0,2,2
1180,coloro,1,2,0,2
19313,männer,0,0,2,2
35263,ˌwɪkɪˈpiːdiə,0,0,2,2
39445,recorded,0,0,2,2
17516,physique,0,0,2,2
35274,αναθέσεις,0,0,2,2
38167,интересные,0,0,2,2
17396,सब्सक्राइब,0,0,2,2
38166,पीढ़ी,0,0,2,2
1873,discussioni,1,2,0,2
1874,differenza,1,2,0,2
38136,comentou,0,0,2,2
24343,kullansam,0,0,2,2
17423,l’encyclopédie,0,0,2,2
24344,kriterier,0,0,2,2
23367,pronunciando,0,0,2,2
17419,работайте,0,0,2,2
17418,representan,0,0,2,2
39518,seeks,0,0,2,2
17414,എന്നിങ്ങനെ,0,0,2,2
39520,போதுமான,0,0,2,2
39521,ens,0,0,2,2
24348,лицензию,0,0,2,2
1877,dico,1,2,0,2
34569,olup,0,0,2,2
23364,मजाक,0,0,2,2
1772,oggettiva,1,2,0,2
19404,pekar,0,0,2,2
39525,ऋण,0,0,2,2
19405,minutter,0,0,2,2
35293,ister,0,0,2,2
17402,വിക്കിപീഡിയയാണ്,0,0,2,2
3274,proposto,1,2,0,2
38117,stum,0,0,2,2
17399,ettiği,0,0,2,2
38113,एंड,0,0,2,2
39506,manque,0,0,2,2
38139,ಪುನರಾವರ್ತಿಸಲು,0,0,2,2
38141,gärna,0,0,2,2
17459,asignaciones,0,0,2,2
38162,costs,0,0,2,2
19361,grundlæggende,0,0,2,2
39476,மரியான்,0,0,2,2
17475,свободен,0,0,2,2
19363,goals,0,0,2,2
23383,grausame,0,0,2,2
38157,nariz,0,0,2,2
17468,turquie,0,0,2,2
17467,देखें,0,0,2,2
39481,göstermek,0,0,2,2
35282,وسط,0,0,2,2
24325,faim,0,0,2,2
17458,വേണ്ടെന്ന്,0,0,2,2
17440,जड़,0,0,2,2
1869,maggiori,1,2,0,2
17456,dúvida,0,0,2,2
19374,hasn,0,0,2,2
39491,апреле,0,0,2,2
1773,costruita,1,2,0,2
3892,orientée,0,0,2,2
1175,malapena,1,2,0,2
24331,visuais,0,0,2,2
19383,påverkade,0,0,2,2
39498,yanıyor,0,0,2,2
38143,weekly,0,0,2,2
38142,политику,0,0,2,2
1212,critici,2,1,1,2
34727,المواضيع,0,0,2,2
23544,ഇനി,0,0,2,2
4042,arreglar,0,0,2,2
34871,travel,0,0,2,2
38908,വലിയൊരു,0,0,2,2
18697,lire,0,0,2,2
3371,applicati,1,2,0,2
18706,naturligt,0,0,2,2
23713,طوال,0,0,2,2
18709,முயற்சிக்கவும்,0,0,2,2
18289,gjorts,0,0,2,2
1828,andasse,1,2,0,2
38912,смотрите,0,0,2,2
23712,devenant,0,0,2,2
35041,மற்றதைச்,0,0,2,2
4039,typer,0,0,2,2
38609,conflicts,0,0,2,2
38607,gráfico,0,0,2,2
38917,αγόρι,0,0,2,2
35044,recibido,0,0,2,2
18723,knol,0,0,2,2
35047,نحن,0,0,2,2
38602,erkänner,0,0,2,2
18726,historiadores,0,0,2,2
18728,കൊണ്ടാണ്,0,0,2,2
3977,artikels,0,0,2,2
23933,structurale,0,0,2,2
18272,jornalismo,0,0,2,2
35050,raíces,0,0,2,2
34864,posibilidades,0,0,2,2
38905,ذي,0,0,2,2
1295,misura,1,2,0,2
3985,lateinische,0,0,2,2
23727,موقف,0,0,2,2
3368,immediatamente,1,2,0,2
18672,зол,0,0,2,2
18674,olduğunuzu,0,0,2,2
18325,साबित,0,0,2,2
35026,lee,0,0,2,2
38884,lært,0,0,2,2
18322,സ്വർഗ്ഗം,0,0,2,2
18321,plaisir,0,0,2,2
23913,εμφάνιση,0,0,2,2
38886,ಕೋನವು,0,0,2,2
34879,التحقق,0,0,2,2
38890,നാല്,0,0,2,2
1294,aggiunta,1,2,0,2
1251,senti,1,2,0,2
23916,ساهم,0,0,2,2
23917,determinado,0,0,2,2
38895,இல்லாமல்,0,0,2,2
18309,poèmes,0,0,2,2
1253,generalista,1,2,0,2
3987,решения,0,0,2,2
18687,modify,0,0,2,2
18305,atributos,0,0,2,2
35030,rire,0,0,2,2
38898,diário,0,0,2,2
38627,inferencias,0,0,2,2
23922,स्त्रोत,0,0,2,2
38598,enviaré,0,0,2,2
18269,olduğuna,0,0,2,2
18667,иметь,0,0,2,2
1801,gergo,1,2,0,2
38573,ಪರಿಸ್ಥಿತಿ,0,0,2,2
23956,undo,0,0,2,2
18225,hield,0,0,2,2
18775,riparian,0,0,2,2
38951,متفرغ,0,0,2,2
23678,البكاء,0,0,2,2
35066,viés,0,0,2,2
38956,locations,0,0,2,2
38957,wii,0,0,2,2
23962,altavoz,0,0,2,2
1833,recoba,1,2,0,2
3967,yakalama,0,0,2,2
18212,mathématicien,0,0,2,2
34844,verificar,0,0,2,2
38963,जीवनी,0,0,2,2
38567,seasons,0,0,2,2
38565,ссылался,0,0,2,2
18208,neuronaux,0,0,2,2
4051,классических,0,0,2,2
18785,abonneerknop,0,0,2,2
38966,ροκ,0,0,2,2
38558,materiaal,0,0,2,2
18198,പറയാൻ‌,0,0,2,2
38972,revealed,0,0,2,2
4052,ಅಲ್ಲಿಗೆ,0,0,2,2
23970,symbolistes,0,0,2,2
38974,grusom,0,0,2,2
38574,korrekt,0,0,2,2
34850,aprenda,0,0,2,2
18230,noise,0,0,2,2
38933,मेली,0,0,2,2
1245,fenomeno,1,2,0,2
35052,пожаловать,0,0,2,2
18265,الشديد,0,0,2,2
23696,ஏனெனில்,0,0,2,2
18738,journalistes,0,0,2,2
18740,अर्थात,0,0,2,2
18742,mitad,0,0,2,2
38593,grundlegende,0,0,2,2
23940,sustenta,0,0,2,2
38592,landen,0,0,2,2
18746,महल,0,0,2,2
18254,говорит,0,0,2,2
23692,gemakkelijke,0,0,2,2
23952,सीजेनथेलर,0,0,2,2
23945,कुंद,0,0,2,2
18250,dansk,0,0,2,2
18752,voorbeeld,0,0,2,2
18753,καιρό,0,0,2,2
23689,besværlig,0,0,2,2
4046,distribuir,0,0,2,2
38938,summer,0,0,2,2
18760,obtiendrez,0,0,2,2
18237,reis,0,0,2,2
18236,questioned,0,0,2,2
38579,للمساعدة,0,0,2,2
18234,miguel,0,0,2,2
38644,proposed,0,0,2,2
18664,fonction,0,0,2,2
23971,positivt,0,0,2,2
38710,डोमस्डे,0,0,2,2
34932,astuce,0,0,2,2
18452,കേൾക്കുമ്പോൾ,0,0,2,2
18540,portmanteau,0,0,2,2
18546,والزاوية,0,0,2,2
18449,alleges,0,0,2,2
18448,मुश्किल,0,0,2,2
34930,publiceerde,0,0,2,2
23854,área,0,0,2,2
34979,producera,0,0,2,2
34928,saß,0,0,2,2
23797,produto,0,0,2,2
4002,கிடைத்தது,0,0,2,2
23796,encuentre,0,0,2,2
3348,pubblico,1,2,0,2
18436,ಬಹುತೇಕ,0,0,2,2
18557,प्रदर्शित,0,0,2,2
34981,brillantes,0,0,2,2
38718,വിക്കിപീഡിയയെ,0,0,2,2
38808,pegou,0,0,2,2
18562,अस्वीकार,0,0,2,2
38716,logistic,0,0,2,2
38714,sociaux,0,0,2,2
38713,கொண்டிருக்கிறீர்கள்,0,0,2,2
34924,ಹೊರತು,0,0,2,2
38811,poli,0,0,2,2
23862,obviedad,0,0,2,2
34984,επόμενο,0,0,2,2
18454,trace,0,0,2,2
18536,ميليسا,0,0,2,2
18455,платье,0,0,2,2
34941,ലേഖനത്തിൽ,0,0,2,2
18503,abajo,0,0,2,2
18509,indépendante,0,0,2,2
18495,advent,0,0,2,2
34964,chegou,0,0,2,2
1275,osservazioni,1,2,0,2
38748,ിത്തമാണ്,0,0,2,2
23815,ekmekten,0,0,2,2
38745,conclusiones,0,0,2,2
38770,employs,0,0,2,2
23812,γεύμα,0,0,2,2
4009,lá,0,0,2,2
1818,proceedings,2,1,1,2
18473,microorganisms,0,0,2,2
34973,ennuyeux,0,0,2,2
38738,अध्यक्ष,0,0,2,2
38784,soll,0,0,2,2
38786,øve,0,0,2,2
23845,बाप।,0,0,2,2
34936,revertir,0,0,2,2
18528,рассылки,0,0,2,2
18532,ಭಯ,0,0,2,2
1820,abbia,1,2,0,2
23848,deinen,0,0,2,2
38733,långsammare,0,0,2,2
18460,பிரமாதமான,0,0,2,2
38796,تعمل,0,0,2,2
23863,gong,0,0,2,2
18426,wurzel,0,0,2,2
34882,resultat,0,0,2,2
1280,siciliano,2,1,1,2
38683,family,0,0,2,2
18622,autriche,0,0,2,2
1823,icona,1,2,0,2
35008,alcançar,0,0,2,2
18380,operated,0,0,2,2
1263,modifica,1,2,0,2
3366,interpreta,1,2,0,2
38674,εικονίδιο,0,0,2,2
23886,medidas,0,0,2,2
38670,ميزات,0,0,2,2
38849,complexité,0,0,2,2
38851,compétence,0,0,2,2
23888,diez,0,0,2,2
38853,تحريرها,0,0,2,2
35012,plainte,0,0,2,2
34901,math,0,0,2,2
1259,possano,1,2,0,2
34894,τέλος,0,0,2,2
23750,تأثير,0,0,2,2
23748,милая,0,0,2,2
23901,adaptan,0,0,2,2
34886,gustó,0,0,2,2
23743,morning,0,0,2,2
18652,منهم،,0,0,2,2
18339,ചതുപ്പുനിലം,0,0,2,2
18658,بيانات,0,0,2,2
1289,vestito,1,2,0,2
18615,redigere,0,0,2,2
38686,standing,0,0,2,2
18610,итак,0,0,2,2
34995,கேட்டபோது,0,0,2,2
18425,ഇങ്ങനെ,0,0,2,2
34923,λόγους,0,0,2,2
23785,беспокойство,0,0,2,2
18419,würdest,0,0,2,2
38821,partielle,0,0,2,2
34917,ogg,0,0,2,2
23783,κάνοντας,0,0,2,2
18412,دواعي,0,0,2,2
18584,mermelada,0,0,2,2
38826,statuts,0,0,2,2
18586,zitten,0,0,2,2
18590,காணப்படும்,0,0,2,2
18593,güvenilir,0,0,2,2
18390,ægteskab,0,0,2,2
38829,மூன்று,0,0,2,2
18402,حلمًا,0,0,2,2
38830,ابنتي,0,0,2,2
18597,ಐಕಾನ್,0,0,2,2
3363,funzioni,1,2,0,2
18398,τύπο,0,0,2,2
18396,felaktig,0,0,2,2
23875,hareket,0,0,2,2
38833,xviiie siècle,0,0,2,2
18602,ചെയ്യുന്നതും,0,0,2,2
18605,verwijderd,0,0,2,2
18606,stødte,0,0,2,2
18796,digite,0,0,2,2
1298,considerate,1,2,0,2
4082,الشائعة,0,0,2,2
18988,награда,0,0,2,2
23577,strict,0,0,2,2
17990,редактируют,0,0,2,2
18963,skämt,0,0,2,2
38436,fikir,0,0,2,2
39120,famous,0,0,2,2
39123,varied,0,0,2,2
17981,дальнейшем,0,0,2,2
18965,उंगलियों,0,0,2,2
17979,invitation,0,0,2,2
18967,hemskt,0,0,2,2
34765,zetten,0,0,2,2
39129,continues,0,0,2,2
18969,جميعًا,0,0,2,2
38433,указания,0,0,2,2
1220,mettendo,1,2,0,2
18972,doğal,0,0,2,2
34762,بريتانيكا،,0,0,2,2
38427,kızgın,0,0,2,2
39138,ನುಡಿಗಟ್ಟುಗಳನ್ನು,0,0,2,2
17963,förvirrad,0,0,2,2
34760,പോകാം,0,0,2,2
34759,novia,0,0,2,2
18979,escuchado,0,0,2,2
17959,öppet,0,0,2,2
38425,quão,0,0,2,2
18983,modifiées,0,0,2,2
17956,relaciones,0,0,2,2
35141,മുൻ‌കൂട്ടി,0,0,2,2
17991,organizan,0,0,2,2
17992,தனிப்பட்ட,0,0,2,2
23589,dezelfde,0,0,2,2
1793,bel,2,1,1,2
23596,incapazes,0,0,2,2
34781,intonationen,0,0,2,2
39095,mp,0,0,2,2
18018,automatizado,0,0,2,2
18016,மாற்றங்களை,0,0,2,2
34778,सदस्य,0,0,2,2
23594,concevoir,0,0,2,2
18014,όλο,0,0,2,2
35130,உடனடியாக,0,0,2,2
39100,honneur,0,0,2,2
39101,публикует,0,0,2,2
1791,preoccupata,1,2,0,2
39116,खेल,0,0,2,2
3944,कराया,0,0,2,2
35135,ಕನಸಿನ,0,0,2,2
1223,dimensioni,1,2,0,2
3943,sufficiently,0,0,2,2
18001,copier,0,0,2,2
18954,biz,0,0,2,2
34772,जॉन,0,0,2,2
38443,noot,0,0,2,2
39113,parada,0,0,2,2
23581,бесконечно,0,0,2,2
17996,интересно,0,0,2,2
1221,riguarda,1,2,0,2
38422,lanserades,0,0,2,2
18989,objectionable,0,0,2,2
18034,exceptions,0,0,2,2
17948,книгу,0,0,2,2
24104,h,0,0,2,2
3931,ನಾರ್ಸಿಸ್,0,0,2,2
24107,حالات,0,0,2,2
17905,विस्तृत,0,0,2,2
34744,έξω,0,0,2,2
39176,inse,0,0,2,2
39178,recuerde,0,0,2,2
19028,geliştirmesine,0,0,2,2
24111,comerlo,0,0,2,2
17898,onthoud,0,0,2,2
24112,அதனை,0,0,2,2
39186,глаза,0,0,2,2
35163,ട്യൂമറിന്റെ,0,0,2,2
17889,skoja,0,0,2,2
19030,erróneos,0,0,2,2
38394,allemande,0,0,2,2
24118,еды,0,0,2,2
19037,الهندسة,0,0,2,2
1850,soluzioni,1,2,0,2
23547,അറിയപ്പെടുന്ന,0,0,2,2
3317,contesto,1,2,0,2
24124,ορισμένους,0,0,2,2
19039,μεσημεριανό,0,0,2,2
23546,nacimiento,0,0,2,2
39199,homepage,0,0,2,2
39200,مختلفة,0,0,2,2
17870,ಧ್ವನಿಸಲು,0,0,2,2
19025,सूत्रों,0,0,2,2
38399,extrême,0,0,2,2
19022,düzeltmede,0,0,2,2
19008,solaire,0,0,2,2
39147,beleefd,0,0,2,2
39150,سروري,0,0,2,2
18993,molecules,0,0,2,2
38416,eerst,0,0,2,2
19001,semiprotegidos,0,0,2,2
39152,realizar,0,0,2,2
19003,correcting,0,0,2,2
17939,बताते,0,0,2,2
19007,gap,0,0,2,2
17935,waarmee,0,0,2,2
17933,sistémicos,0,0,2,2
39155,esses,0,0,2,2
17930,hjemme,0,0,2,2
24103,लेता,0,0,2,2
39157,reproduction,0,0,2,2
17927,består,0,0,2,2
24095,സ്ഥലം,0,0,2,2
35157,يجري,0,0,2,2
35161,твои,0,0,2,2
34749,party,0,0,2,2
38403,يستخدمها,0,0,2,2
1849,preciso,2,1,1,2
39164,consultée,0,0,2,2
24099,croissance,0,0,2,2
24100,ರೀತಿಯದ್ದಾಗಿದೆ,0,0,2,2
19018,modèles,0,0,2,2
23598,terabytes,0,0,2,2
18933,بشيء,0,0,2,2
18801,pornography,0,0,2,2
24012,traces,0,0,2,2
23655,ρωτάει,0,0,2,2
38999,eventos,0,0,2,2
23990,avais,0,0,2,2
18828,признана,0,0,2,2
18151,നിന്നെ,0,0,2,2
18150,மந்தமாக,0,0,2,2
18149,أخذ,0,0,2,2
18831,californië,0,0,2,2
34823,administrativas,0,0,2,2
23650,എളുപ്പമുള്ള,0,0,2,2
18141,pertinent,0,0,2,2
35090,formuleringen,0,0,2,2
1837,esame,1,2,0,2
18840,राजनीतिज्ञ,0,0,2,2
39008,distribuído,0,0,2,2
38526,próprio,0,0,2,2
1242,venerdì,1,2,0,2
1301,uscì,1,2,0,2
1302,vocabolario,1,2,0,2
38516,influences,0,0,2,2
18134,आंशिक,0,0,2,2
34819,traduction,0,0,2,2
4058,etmenin,0,0,2,2
35097,बैठे,0,0,2,2
34817,consultation,0,0,2,2
1240,amico,1,2,0,2
18119,enquête,0,0,2,2
38998,enseignement,0,0,2,2
38537,jugées,0,0,2,2
38997,uitkomt,0,0,2,2
18175,மாத்திரமே,0,0,2,2
18189,mathrm,0,0,2,2
38551,adresse,0,0,2,2
1299,utilizzato,1,2,0,2
23974,appris,0,0,2,2
23664,математической,0,0,2,2
23975,treated,0,0,2,2
3962,financiamento,0,0,2,2
35080,redactor,0,0,2,2
38981,عدم,0,0,2,2
18178,zengin,0,0,2,2
23979,ഇൻപുട്ട്,0,0,2,2
34834,kim,0,0,2,2
3961,व्यू,0,0,2,2
18825,وإرشادات,0,0,2,2
35084,السياسية,0,0,2,2
34833,weitermachen,0,0,2,2
18173,undervisningen,0,0,2,2
18172,resulted,0,0,2,2
38987,форме,0,0,2,2
18169,vermektedir,0,0,2,2
38988,സഹായി,0,0,2,2
34832,campagne,0,0,2,2
18163,ജൂൺ,0,0,2,2
18822,ato,0,0,2,2
18824,amendement,0,0,2,2
23988,قوله,0,0,2,2
18117,paris,0,0,2,2
3958,ночью,0,0,2,2
18930,overlying,0,0,2,2
23638,comparten,0,0,2,2
39060,सिद्धांत,0,0,2,2
38487,weeds,0,0,2,2
35112,heuristic,0,0,2,2
38485,descending,0,0,2,2
18065,birbirlerinin,0,0,2,2
18064,directions,0,0,2,2
35116,attempts,0,0,2,2
18906,akademik,0,0,2,2
38479,بأكثر,0,0,2,2
18910,aaron,0,0,2,2
38477,виды,0,0,2,2
1229,preferita,1,2,0,2
18056,نصف,0,0,2,2
38476,profesionales,0,0,2,2
23609,medo,0,0,2,2
23608,எங்கிருந்து,0,0,2,2
39072,encarga,0,0,2,2
24044,കാര്യങ്ങൾക്കോ,0,0,2,2
18049,fichas,0,0,2,2
38471,ley,0,0,2,2
18044,personajes,0,0,2,2
35122,relevant,0,0,2,2
18922,jourlà,0,0,2,2
38466,"
डच",0,0,2,2
35123,बनने,0,0,2,2
23603,densité,0,0,2,2
18037,проектом,0,0,2,2
18895,proper,0,0,2,2
18890,relying,0,0,2,2
23622,raffiniert,0,0,2,2
24027,золотая,0,0,2,2
38512,demais,0,0,2,2
18859,والكلمة,0,0,2,2
18111,aim,0,0,2,2
39031,forfærdelige,0,0,2,2
18106,d’algorithmes,0,0,2,2
3334,sarò,1,2,0,2
18866,архитектуры,0,0,2,2
1841,terribile,1,2,0,2
3376,hinton,2,1,1,2
35100,animados,0,0,2,2
23632,eftermiddagen,0,0,2,2
24026,plantar,0,0,2,2
18092,existantes,0,0,2,2
1232,riguardanti,1,2,0,2
3377,corse,2,1,1,2
1842,problematica,1,2,0,2
38498,loan,0,0,2,2
18880,matemáticas,0,0,2,2
41869,الإعلانات,0,0,2,2
18082,चूंकि,0,0,2,2
1234,strumenti,1,2,0,2
4063,öppna,0,0,2,2
3950,totaal,0,0,2,2
38495,thuiskwam,0,0,2,2
39054,здорово,0,0,2,2
39056,préféré,0,0,2,2
23294,yeterli,0,0,2,2
24447,manipulation,0,0,2,2
22783,привести,0,0,2,2
1075,dimenticare,1,2,0,2
37542,situationen,0,0,2,2
37541,ಪಡೆಯುತ್ತೀರಿ,0,0,2,2
16377,accepterar,0,0,2,2
3208,descriveva,1,2,0,2
24897,established,0,0,2,2
1074,ritiene,1,2,0,2
22956,förtydliga,0,0,2,2
20196,söyleyebilirsin,0,0,2,2
24902,достигла,0,0,2,2
24903,hoewel,0,0,2,2
16366,حالك؟,0,0,2,2
40279,produktionssätt,0,0,2,2
4283,forêt,0,0,2,2
24905,ഞങ്ങൾ‌,0,0,2,2
22953,πιάσατε,0,0,2,2
16359,tosh,0,0,2,2
24906,köpa,0,0,2,2
20202,tradicional,0,0,2,2
37535,floras,0,0,2,2
40286,tålmodigt,0,0,2,2
22952,valores,0,0,2,2
16350,tomar,0,0,2,2
16349,cümleyi,0,0,2,2
16348,شهرة,0,0,2,2
34160,moquez,0,0,2,2
16346,uneven,0,0,2,2
40290,reverts,0,0,2,2
20191,الرياضيات,0,0,2,2
20190,റഫറൻസുകൾ,0,0,2,2
39665,മറ്റും,0,0,2,2
3792,ಮೂಲವನ್ನು,0,0,2,2
20156,extensão,0,0,2,2
22973,şanslısın,0,0,2,2
16420,μικρό,0,0,2,2
35570,savaşlarına,0,0,2,2
40237,publishers,0,0,2,2
37558,évidents,0,0,2,2
37554,limites,0,0,2,2
4278,dozen,0,0,2,2
16408,plante,0,0,2,2
34181,erfarne,0,0,2,2
40246,svara,0,0,2,2
16401,வெள்ளி,0,0,2,2
40252,மூழ்கி,0,0,2,2
20173,hızlı,0,0,2,2
20174,números,0,0,2,2
40257,κατά,0,0,2,2
20175,текстов,0,0,2,2
16391,tekniskt,0,0,2,2
35573,அனைத்து,0,0,2,2
16388,patronen,0,0,2,2
16387,portable,0,0,2,2
22964,conventions,0,0,2,2
20180,ഭാഗം,0,0,2,2
40261,galilée,0,0,2,2
1729,atteggiamento,1,2,0,2
35578,μαθήματα,0,0,2,2
37545,dachte,0,0,2,2
16342,almacenamiento,0,0,2,2
16341,yolunda,0,0,2,2
40293,ആയിരിക്കും,0,0,2,2
40294,обсуждаются,0,0,2,2
1070,lamentarti,1,2,0,2
22935,மிகச்சிறந்த,0,0,2,2
16304,representación,0,0,2,2
1726,incontro,1,2,0,2
40319,ದಾಟಿದೆ,0,0,2,2
16300,verificabilidade,0,0,2,2
40322,manden,0,0,2,2
16293,känd,0,0,2,2
37504,changé,0,0,2,2
20243,ajout,0,0,2,2
16291,rift,0,0,2,2
40327,ins,0,0,2,2
20244,ändra,0,0,2,2
16287,الأعمال,0,0,2,2
40330,winter,0,0,2,2
34141,minhas,0,0,2,2
22930,расстраивался,0,0,2,2
24940,miembros,0,0,2,2
40336,taking,0,0,2,2
35596,عشر,0,0,2,2
37500,αριθμό,0,0,2,2
16276,பெறுவீர்கள்,0,0,2,2
34138,ദൈവമേ,0,0,2,2
24943,dünyanın,0,0,2,2
16273,nomes,0,0,2,2
16272,almoço,0,0,2,2
20251,главный,0,0,2,2
16309,sensitive,0,0,2,2
22936,reagle,0,0,2,2
40314,книга,0,0,2,2
40307,κοινές,0,0,2,2
24914,zfs,0,0,2,2
1464,atto,1,2,0,2
16336,varmt,0,0,2,2
40296,острого,0,0,2,2
37528,الجميلة,0,0,2,2
22949,« ont,0,0,2,2
3206,successivi,1,2,0,2
35584,banque,0,0,2,2
40302,വണ്ടിയിൽ,0,0,2,2
38753,tive,0,0,2,2
22943,daglig,0,0,2,2
40306,termed,0,0,2,2
20223,сердца,0,0,2,2
35593,diretrizes,0,0,2,2
16318,enerji,0,0,2,2
34151,faitesle,0,0,2,2
16316,سؤال,0,0,2,2
20224,المسؤولون,0,0,2,2
22941,subsequent,0,0,2,2
1071,casuale,1,2,0,2
16314,kâr,0,0,2,2
37515,anlatıyorlar,0,0,2,2
40312,alterar,0,0,2,2
35590,πάρω,0,0,2,2
20229,acht,0,0,2,2
20230,крупные,0,0,2,2
24875,дня,0,0,2,2
16426,måder,0,0,2,2
37565,vikipedi’ye,0,0,2,2
24816,suisse,0,0,2,2
16557,binden,0,0,2,2
24798,prens,0,0,2,2
23008,εσύ,0,0,2,2
16554,सामान,0,0,2,2
24800,listas,0,0,2,2
23007,savoirfaire,0,0,2,2
20093,antwoord,0,0,2,2
1087,vincolate,1,2,0,2
16545,dedim,0,0,2,2
40146,aprecio,0,0,2,2
24805,reputation,0,0,2,2
34241,implicit,0,0,2,2
16540,envolve,0,0,2,2
40150,статистических,0,0,2,2
40152,சொல்கிறீர்கள்,0,0,2,2
16535,തീരുമാനിക്കപ്പെടുന്നു,0,0,2,2
40154,कृप्या,0,0,2,2
16532,italie,0,0,2,2
16529,ഉദാഹരണമാണ്,0,0,2,2
16527,wünschen,0,0,2,2
20096,ensaio,0,0,2,2
16525,release,0,0,2,2
16524,significados,0,0,2,2
4255,sprekend,0,0,2,2
16521,இணையத்தளத்தில்,0,0,2,2
3223,attivo,1,2,0,2
34235,crescido,0,0,2,2
16558,boğuldum,0,0,2,2
34247,исправления,0,0,2,2
40135,πεινασμένος,0,0,2,2
1928,livello,1,2,0,2
1927,miglia,1,2,0,2
24770,products,0,0,2,2
23026,expressed,0,0,2,2
37637,κοινή,0,0,2,2
23024,editoriales,0,0,2,2
23023,nachrichten,0,0,2,2
20065,முழு,0,0,2,2
20066,estabelecido,0,0,2,2
4245,उच्चतम,0,0,2,2
24774,estadística,0,0,2,2
34261,mundo​,0,0,2,2
16598,சோர்வடையவில்லை,0,0,2,2
34259,autoridad,0,0,2,2
24795,ganó,0,0,2,2
16594,неважно,0,0,2,2
40113,παιδί,0,0,2,2
16586,möten,0,0,2,2
23017,राजकुमार,0,0,2,2
20076,fête,0,0,2,2
40119,உறுதிப்படுத்திக்,0,0,2,2
16575,poucos,0,0,2,2
16571,durgun,0,0,2,2
20078,പെട്ടെന്നുതന്നെ,0,0,2,2
24792,leads,0,0,2,2
40130,βοηθήσω,0,0,2,2
40131,βικιλεξικό,0,0,2,2
20099,discours,0,0,2,2
16513,частности,0,0,2,2
40231,specifika,0,0,2,2
24818,mythes,0,0,2,2
16468,estaban,0,0,2,2
16467,asunto,0,0,2,2
35556,efeitos,0,0,2,2
1733,παιδεία,2,1,1,2
24852,नार्सीसस,0,0,2,2
20131,υπάρχουν,0,0,2,2
16461,زيارة,0,0,2,2
34201,википедией,0,0,2,2
34200,கூர்மையான,0,0,2,2
40211,மின்னஞ்சல்,0,0,2,2
34199,birbirlerine,0,0,2,2
22986,welches,0,0,2,2
24860,vigiadas,0,0,2,2
34193,kişi,0,0,2,2
37579,oficiosas,0,0,2,2
22981,fransa,0,0,2,2
22980,ಯಾವ,0,0,2,2
16442,പ്രശ്നമല്ല,0,0,2,2
4271,’de,0,0,2,2
16439,diversity,0,0,2,2
1463,ottobre,1,2,0,2
24868,clásico,0,0,2,2
35565,deluged,0,0,2,2
37566,exclusivamente,0,0,2,2
40227,मुद्दों,0,0,2,2
16431,معه,0,0,2,2
24871,circulation,0,0,2,2
16474,pouvais,0,0,2,2
20125,dreams,0,0,2,2
37590,thumbs,0,0,2,2
16499,biliyordum,0,0,2,2
3221,austria,2,1,1,2
34231,février,0,0,2,2
35548,leaves,0,0,2,2
40168,एन्साइक्लोपीडिया,0,0,2,2
35549,useless,0,0,2,2
16505,редко,0,0,2,2
23000,böylece,0,0,2,2
16504,härligt,0,0,2,2
20108,financer,0,0,2,2
22998,erzogen,0,0,2,2
22997,pouvoir,0,0,2,2
1933,indicare,1,2,0,2
22996,أحضر,0,0,2,2
3803,redigeringen,0,0,2,2
37597,süredir,0,0,2,2
20118,വിഷയങ്ങൾ,0,0,2,2
1460,ringraziare,1,2,0,2
1085,inserito,1,2,0,2
3218,tavolo,1,2,0,2
34221,essentially,0,0,2,2
40183,வேலையைத்,0,0,2,2
24834,téléchargé,0,0,2,2
22992,κουρασμένος,0,0,2,2
37592,humble,0,0,2,2
35554,uppfattning,0,0,2,2
34213,quiere,0,0,2,2
37496,verrückt,0,0,2,2
37495,சுவையான,0,0,2,2
4293,iedereen,0,0,2,2
20453,известность,0,0,2,2
34068,civilization,0,0,2,2
40493,iniciativa,0,0,2,2
20419,ajudam,0,0,2,2
16061,ausmachen,0,0,2,2
34063,sex,0,0,2,2
22839,വീട്ടിൽ,0,0,2,2
1952,curriculum,2,1,1,2
40501,publicerades,0,0,2,2
40502,independentes,0,0,2,2
20425,technical,0,0,2,2
40503,kæreste,0,0,2,2
37366,alain,0,0,2,2
4318,sektioner,0,0,2,2
35666,kontakt,0,0,2,2
35668,retomar,0,0,2,2
34059,contexts,0,0,2,2
16045,herregud,0,0,2,2
22832,स्वयं,0,0,2,2
20437,intrude,0,0,2,2
25055,nahm,0,0,2,2
1043,tradizionale,1,2,0,2
40509,ಹುಡುಗರಿಗೆ,0,0,2,2
25057,очередь,0,0,2,2
20440,وهي,0,0,2,2
20447,cia,0,0,2,2
20452,faces,0,0,2,2
1040,modellazione,1,2,0,2
25042,gitmeliyim,0,0,2,2
25036,birleşik,0,0,2,2
37378,பார்த்த,0,0,2,2
16092,लाईसेन्स,0,0,2,2
25020,l’opposition,0,0,2,2
16105,خبزًا,0,0,2,2
16104,yapmalıyım,0,0,2,2
40465,مروعًا,0,0,2,2
25022,mandos,0,0,2,2
40468,samman,0,0,2,2
4313,resposta,0,0,2,2
25024,encyclopedic,0,0,2,2
40470,läget,0,0,2,2
20398,colombiano,0,0,2,2
37387,отсутствие,0,0,2,2
22850,странах,0,0,2,2
25029,​​eller,0,0,2,2
34074,πρωί,0,0,2,2
16088,περιγράφουν,0,0,2,2
16087,"
बेलारूसी",0,0,2,2
25030,माणिक,0,0,2,2
16085,நேற்று,0,0,2,2
22846,എവിടെയായിരുന്നുവെന്ന്,0,0,2,2
40477,semblaient,0,0,2,2
25031,enbart,0,0,2,2
34076,увидите,0,0,2,2
35659,saltwater,0,0,2,2
22844,लिंक्स,0,0,2,2
4315,saudiarabien,0,0,2,2
20412,taxa,0,0,2,2
40518,webbsidor,0,0,2,2
20456,ശരിയായ,0,0,2,2
1724,certamente,2,1,1,2
37345,continual,0,0,2,2
22801,quejarme,0,0,2,2
25079,சொற்களைக்,0,0,2,2
37323,पक्ष,0,0,2,2
20496,جذور,0,0,2,2
20498,ஆங்கிலம்,0,0,2,2
35692,പറഞ്ഞത്,0,0,2,2
20501,verlicht,0,0,2,2
37318,enheder,0,0,2,2
4327,stel,0,0,2,2
20503,الحر,0,0,2,2
15980,விஷயங்கள்,0,0,2,2
1960,nuova,1,2,0,2
22793,какой,0,0,2,2
25086,podía,0,0,2,2
34036,krävs,0,0,2,2
22792,mogelijkheden,0,0,2,2
15974,anglaise,0,0,2,2
20511,κάθε,0,0,2,2
37310,προφορά,0,0,2,2
15972,вопросов,0,0,2,2
20514,priorities,0,0,2,2
15971,सकें,0,0,2,2
1502,classificare,1,2,0,2
15969,ಮಾಡಬೇಕೆಂದು,0,0,2,2
22787,അതേ,0,0,2,2
15966,seiner,0,0,2,2
15965,കഴിഞ്ഞ,0,0,2,2
34042,shapiro,0,0,2,2
22802,objectifs,0,0,2,2
20490,formatting,0,0,2,2
35685,மக்கள்,0,0,2,2
22819,பயன்படுத்த,0,0,2,2
25065,economista,0,0,2,2
16022,языкового,0,0,2,2
16021,وشكك,0,0,2,2
40526,olmanın,0,0,2,2
40527,ταινίες,0,0,2,2
25068,carnegiemellon,0,0,2,2
40530,liée,0,0,2,2
16012,réside,0,0,2,2
40532,κάνουν,0,0,2,2
1722,principali,1,2,0,2
25071,எடுத்துக்காட்டுகள்,0,0,2,2
34046,kullandığı,0,0,2,2
1036,attive,1,2,0,2
16007,kitabı,0,0,2,2
22812,publicações,0,0,2,2
1959,occorrenze,1,2,0,2
22809,അതുകൊണ്ടുതന്നെ,0,0,2,2
16002,midden,0,0,2,2
20481,المسجلين,0,0,2,2
40537,attempted,0,0,2,2
20482,منظمة,0,0,2,2
20484,आइकन,0,0,2,2
4324,separates,0,0,2,2
22806,remplacement,0,0,2,2
22805,अपाचे,0,0,2,2
16109,credit,0,0,2,2
40460,soldier,0,0,2,2
20258,hosted,0,0,2,2
34106,biologie,0,0,2,2
16223,പ്രകൃതി,0,0,2,2
34116,சொன்னாள்,0,0,2,2
40383,escuche,0,0,2,2
16218,см,0,0,2,2
1062,viaggio,1,2,0,2
37477,mijl,0,0,2,2
22917,sade,0,0,2,2
20281,hakkındaki,0,0,2,2
1472,lezioni,1,2,0,2
20284,nativos,0,0,2,2
20285,जिन,0,0,2,2
40389,l’homme,0,0,2,2
35606,grew,0,0,2,2
37472,simples,0,0,2,2
24978,finally,0,0,2,2
40394,considerable,0,0,2,2
40395,financiada,0,0,2,2
37469,потрясающую,0,0,2,2
20291,collaboratif,0,0,2,2
1950,manifesta,1,2,0,2
34107,buscas,0,0,2,2
3468,sorprende,2,1,1,2
37461,decisión,0,0,2,2
40402,मिलेगा,0,0,2,2
24986,diet,0,0,2,2
20305,dissesse,0,0,2,2
35616,vergiss,0,0,2,2
20278,atualização,0,0,2,2
37478,pacientemente,0,0,2,2
40378,perfect,0,0,2,2
16246,учёных,0,0,2,2
40347,руководств,0,0,2,2
40349,tampa,0,0,2,2
40350,varma,0,0,2,2
24950,stoppede,0,0,2,2
37492,للصفحة,0,0,2,2
24951,buscando,0,0,2,2
16252,கலைக்களஞ்சியமாக,0,0,2,2
24956,حلمي,0,0,2,2
37489,lösning,0,0,2,2
40360,révision,0,0,2,2
37488,ചെയ്തിട്ടുണ്ടെങ്കിൽ,0,0,2,2
16247,faveur,0,0,2,2
24957,sesgado,0,0,2,2
3466,informativa,2,1,1,2
35601,skaffe,0,0,2,2
24960,mujer,0,0,2,2
16241,"
azeri",0,0,2,2
34126,décrivent,0,0,2,2
20270,letárgico,0,0,2,2
20271,बोलना,0,0,2,2
37481, millions,0,0,2,2
40372,أسفل,0,0,2,2
34121,uygun,0,0,2,2
20274,suma,0,0,2,2
16231,correio,0,0,2,2
34119,இதுதான்,0,0,2,2
20308,rely,0,0,2,2
20309,baixo,0,0,2,2
20394,generellt,0,0,2,2
24989,தெரியப்படுத்துங்கள்,0,0,2,2
22878,empezar,0,0,2,2
40432,मिलती,0,0,2,2
16150,libertad,0,0,2,2
16148,oefenen,0,0,2,2
35638,iğrençti,0,0,2,2
37412,ചതുപ്പുനിലമാണ്,0,0,2,2
22868,nadruk,0,0,2,2
20371,almak,0,0,2,2
16139,investigação,0,0,2,2
34092,desired,0,0,2,2
25008,merleauponty,0,0,2,2
16134,échecs,0,0,2,2
22866,размещения,0,0,2,2
40447,க்கு,0,0,2,2
16129,نظرًا,0,0,2,2
34089,contou,0,0,2,2
16127,rigdom,0,0,2,2
25012,വരാൻ,0,0,2,2
16125,يكتب,0,0,2,2
16124,criaram,0,0,2,2
20387,exeditor,0,0,2,2
40454,எங்கிருந்தோம்,0,0,2,2
37396,அப்படி,0,0,2,2
20390,vestidos,0,0,2,2
40455,ekmeği,0,0,2,2
35651,понятие,0,0,2,2
40458,εκκαθάρισης,0,0,2,2
40431,rentrer,0,0,2,2
22879,മാസവും,0,0,2,2
24998,enfant,0,0,2,2
34102,comprar,0,0,2,2
1059,linus,2,1,1,2
20310,prøv,0,0,2,2
16186,spin,0,0,2,2
35618,rejste,0,0,2,2
40411,hoppas,0,0,2,2
22899,improves,0,0,2,2
37449,പദമായ,0,0,2,2
1058,importasse,2,1,1,2
37448,إليك,0,0,2,2
16178,जल्दी,0,0,2,2
35624,photographs,0,0,2,2
40415,artificiel,0,0,2,2
40418,presented,0,0,2,2
34098,glem,0,0,2,2
16173,സഹകരണത്തോടെ,0,0,2,2
16171,item,0,0,2,2
40419,भीतर,0,0,2,2
20337,تحدث,0,0,2,2
16168,stumpe,0,0,2,2
1478,porterà,1,2,0,2
16167,ressaisistoi,0,0,2,2
20341,montré,0,0,2,2
22886,attribuer,0,0,2,2
3194,branca,1,2,0,2
20348,الطريقة,0,0,2,2
16159,roc,0,0,2,2
20057,exame,0,0,2,2
34267,während,0,0,2,2
20053,générées,0,0,2,2
37892,frequentes,0,0,2,2
39798,stellen,0,0,2,2
17029,mvs,0,0,2,2
19695,anteriormente,0,0,2,2
1902,canada,2,1,1,2
17027,पेश,0,0,2,2
24545,celleci,0,0,2,2
24548,वर्ग,0,0,2,2
19697,आने,0,0,2,2
19699,cambiar,0,0,2,2
24549,graph,0,0,2,2
17019,сделано,0,0,2,2
37909,edersiniz,0,0,2,2
17017,vanderbilt,0,0,2,2
35398,tyler,0,0,2,2
3427,singolo,1,2,0,2
17011,ανησυχούσε,0,0,2,2
19708,i̇nternet,0,0,2,2
24552,significations,0,0,2,2
4183,kommit,0,0,2,2
39811,വിളിക്കുന്നത്,0,0,2,2
34430,cooperación,0,0,2,2
1904,merito,1,2,0,2
3252,riconosciuta,1,2,0,2
37898,нарцисой,0,0,2,2
37897,gesteld,0,0,2,2
37895,سألك,0,0,2,2
16999,recebendo,0,0,2,2
24543,ഉദാഹരണമായി,0,0,2,2
37913,அனுப்புவேன்,0,0,2,2
23216,eight,0,0,2,2
37926,ordnummer,0,0,2,2
24528,—literalmente—,0,0,2,2
39779,தற்போது,0,0,2,2
19660,भंडार,0,0,2,2
19662,للسؤال,0,0,2,2
34446,kızım,0,0,2,2
37933,flagged,0,0,2,2
37932,kurohin,0,0,2,2
19668,ಪ್ರಿಯನು,0,0,2,2
17059,τέσσερα,0,0,2,2
19672,enfatizar,0,0,2,2
19673,εμπειρία,0,0,2,2
23223,contagens,0,0,2,2
17050,etablerade,0,0,2,2
23217,lusófona,0,0,2,2
4179,описания,0,0,2,2
3422,applicazione,1,2,0,2
17048,fuhr,0,0,2,2
17047,bekæmpe,0,0,2,2
37924,ಸರಿಯಾಗಿ,0,0,2,2
39788,vertelt,0,0,2,2
19683,déterminer,0,0,2,2
37921,hallan,0,0,2,2
4181,يتطلب,0,0,2,2
34438,r,0,0,2,2
37920,gjorda,0,0,2,2
17035,اللجنة,0,0,2,2
37894,siècle,0,0,2,2
39819,bénéficie,0,0,2,2
37943,punkt,0,0,2,2
35406,datadump,0,0,2,2
19759,positivos,0,0,2,2
23180,केंद्र,0,0,2,2
19761,évidentes,0,0,2,2
16951,verward,0,0,2,2
39849,else,0,0,2,2
34410,विनम्र,0,0,2,2
35422,полной,0,0,2,2
35424,verbets,0,0,2,2
4190,mac,0,0,2,2
1752,multimediali,1,2,0,2
34404,പരിചയം,0,0,2,2
23172,സംരംഭത്തിന്റെ,0,0,2,2
19773,فلا,0,0,2,2
39862,förutom,0,0,2,2
1417,nascita,1,2,0,2
34399,sauvagerie,0,0,2,2
16926,dantas,0,0,2,2
16925,matemática,0,0,2,2
16924,सुभाषितों,0,0,2,2
37844,tchèque,0,0,2,2
24594,murat,0,0,2,2
1419,numerose,1,2,0,2
1420,passare,1,2,0,2
34392,systematische,0,0,2,2
35431,vocabulario,0,0,2,2
23163,motsats,0,0,2,2
23162,scharf,0,0,2,2
19758,consulted,0,0,2,2
39846,хорошими,0,0,2,2
23181,official,0,0,2,2
3250,notevole,1,2,0,2
39820,spil,0,0,2,2
16991,αστειεύεσαι,0,0,2,2
23199,ಹುಡುಗ,0,0,2,2
16988,kaldım,0,0,2,2
34425,sunucuları,0,0,2,2
35407,ஒருவேளை,0,0,2,2
4185,ashburn,0,0,2,2
24560,потом,0,0,2,2
23197,lieverd,0,0,2,2
1408,progress,2,1,1,2
16982,فما,0,0,2,2
24561,रिकॉर्ड,0,0,2,2
19732,ನೋಟ,0,0,2,2
3843,ഇഷ്‌ടപ്പെട്ടെങ്കിൽ,0,0,2,2
1409,garanzia,1,2,0,2
19742,principer,0,0,2,2
39831,hepsini,0,0,2,2
37870,gördüğü,0,0,2,2
39834,doré,0,0,2,2
16971,troublesome,0,0,2,2
37869,teléfono,0,0,2,2
35419,ήρθαν,0,0,2,2
34419,logra,0,0,2,2
16963,έφτασε,0,0,2,2
39840,clicando,0,0,2,2
16961,चलाने,0,0,2,2
17068,carga,0,0,2,2
24524,नियंत्रण,0,0,2,2
35435,വിശ്വസിക്കുന്നത്,0,0,2,2
39718,öğle,0,0,2,2
37999,idées,0,0,2,2
17180,eukaryotic,0,0,2,2
19583,सके,0,0,2,2
34481,ernst,0,0,2,2
17178,trevlig,0,0,2,2
34480,seeing,0,0,2,2
39703,fruktansvärt,0,0,2,2
34479,ceremony,0,0,2,2
4166,république,0,0,2,2
34478,تتم,0,0,2,2
37994,pergunto,0,0,2,2
37990,gratis,0,0,2,2
19591,kring,0,0,2,2
17170,missão,0,0,2,2
19595,القائمة,0,0,2,2
19597,samarbetet,0,0,2,2
35363,féliciter,0,0,2,2
19599,ஆற்றல்,0,0,2,2
17166,городе,0,0,2,2
17165,erzählt,0,0,2,2
37984,rechaza,0,0,2,2
39712,hungry,0,0,2,2
37983,ஆடம்பரமான,0,0,2,2
17161,журнал,0,0,2,2
35365,seguir,0,0,2,2
34475,आक्रामक,0,0,2,2
37979,reçel,0,0,2,2
39698,esbozos,0,0,2,2
24471,gouvernement,0,0,2,2
19576,juger,0,0,2,2
17202,piensa,0,0,2,2
34501,universities,0,0,2,2
39669,geeft,0,0,2,2
23288,village,0,0,2,2
19553,achieving,0,0,2,2
3867,περισσότερες,0,0,2,2
17216,extensas,0,0,2,2
39677,publient,0,0,2,2
17208,edited,0,0,2,2
23284,нейросетей,0,0,2,2
19558,banken,0,0,2,2
24462,ερωτήσεις,0,0,2,2
17205,civilisation,0,0,2,2
19561,findings,0,0,2,2
35351,प्यारी,0,0,2,2
17196,γνωρίζετε,0,0,2,2
34486,godkännande,0,0,2,2
19563,விடுங்கள்,0,0,2,2
17194,falls,0,0,2,2
38010,ходе,0,0,2,2
17192,kartor,0,0,2,2
35348,مكبر,0,0,2,2
23279,contó,0,0,2,2
24469,cieux,0,0,2,2
34484,neemt,0,0,2,2
19569,puestos,0,0,2,2
35350,onlar,0,0,2,2
34472,говорю,0,0,2,2
17154,glass,0,0,2,2
17075,gördüğünü,0,0,2,2
17153,μαρμελάδα,0,0,2,2
23245,étionsnous,0,0,2,2
24508,imitation,0,0,2,2
24509,forslag,0,0,2,2
17107,udelukkende,0,0,2,2
24512,comidas,0,0,2,2
23244,elements,0,0,2,2
24514,llevó,0,0,2,2
17100,сомнение,0,0,2,2
34456,papier,0,0,2,2
17098,रो,0,0,2,2
23243,russe,0,0,2,2
39760,दूसरी,0,0,2,2
37954,maiores,0,0,2,2
37953,kvaliteten,0,0,2,2
39761,contrôlant,0,0,2,2
17091,செய்வோம்,0,0,2,2
4172,المؤسس,0,0,2,2
37950,pilares,0,0,2,2
3852,quantrill,0,0,2,2
17084,ζούσε,0,0,2,2
17083,conclusión,0,0,2,2
17082,என்பதால்,0,0,2,2
37947,நிமிடங்களில்,0,0,2,2
39769,தேதி,0,0,2,2
23238,mantêm,0,0,2,2
19651,suivant,0,0,2,2
17078,nações,0,0,2,2
17110,தாய்,0,0,2,2
39750,randevum,0,0,2,2
39749,λέξεων,0,0,2,2
17130,focusing,0,0,2,2
37973,jefferson,0,0,2,2
39720,suggesting,0,0,2,2
17150,веб,0,0,2,2
19614,herkes,0,0,2,2
17147,coloquial,0,0,2,2
39723,söylüyorsunuz,0,0,2,2
34469,energi,0,0,2,2
3859,lançada,0,0,2,2
23255,höre,0,0,2,2
39727,συνεχίσετε,0,0,2,2
24496,особенностью,0,0,2,2
39732,ಹೋಗುವುದು,0,0,2,2
19620,الأصابع,0,0,2,2
19633,ಒಪ್ಪುತ್ತೇನೆ,0,0,2,2
39737,marquée,0,0,2,2
37968,сбит,0,0,2,2
3855,فيما,0,0,2,2
39740,problème,0,0,2,2
24503,permitan,0,0,2,2
17121,preocupaciones,0,0,2,2
23252,décidé,0,0,2,2
24504,tillämpas,0,0,2,2
34460,αμβλύ,0,0,2,2
37962,இதன்மூலம்,0,0,2,2
24506,considering,0,0,2,2
3421,rimangono,1,2,0,2
37833,katılıyorum,0,0,2,2
39877,"
मराठी",0,0,2,2
23031,accepteer,0,0,2,2
19971,ಚಂದಾದಾರ,0,0,2,2
16737,بداية,0,0,2,2
16733,sandheder,0,0,2,2
34319,δουλέψει,0,0,2,2
24697,yaacov,0,0,2,2
24698,inscrit,0,0,2,2
16727,लगते,0,0,2,2
40008,phones,0,0,2,2
24700,لعبتك,0,0,2,2
1107,subì,1,2,0,2
16721,تقدم,0,0,2,2
16719,होगी।,0,0,2,2
16718,altitude,0,0,2,2
35496,siabra,0,0,2,2
1106,direzione,1,2,0,2
16711,origen,0,0,2,2
23077,объявил,0,0,2,2
19964,disciplines,0,0,2,2
24709,दिखती,0,0,2,2
16706,focal,0,0,2,2
40024,लें।,0,0,2,2
16704,encontrou,0,0,2,2
24715,الموجودة,0,0,2,2
1437,cartacee,1,2,0,2
40031,المساهمات,0,0,2,2
40032,φέρω,0,0,2,2
34305,पूरक,0,0,2,2
16693,précédente,0,0,2,2
4225,അടിസ്ഥാനം,0,0,2,2
23086,adopté,0,0,2,2
16740,കാഴ്ചപ്പാട്,0,0,2,2
39986, modifications,0,0,2,2
34335,clicking,0,0,2,2
34334,क़िताबें,0,0,2,2
37739,centenas,0,0,2,2
39982,пятница,0,0,2,2
16768,wikcionário,0,0,2,2
19924,ಹೋಗಲು,0,0,2,2
1739,aspetto,1,2,0,2
16767,ಬೇಕಾದುದನ್ನು,0,0,2,2
19927,obscur,0,0,2,2
16763,शुक्र,0,0,2,2
35487,ultimately,0,0,2,2
34332,utformas,0,0,2,2
16758,χρησιμοποιείτε,0,0,2,2
16741,violación,0,0,2,2
34330,فهمتك,0,0,2,2
35488,hudong,0,0,2,2
23089,semisupervised,0,0,2,2
23088,object,0,0,2,2
1434,cinema,2,1,1,2
16749,fundamental,0,0,2,2
1435,enciclopedici,1,2,0,2
39995,administrativo,0,0,2,2
23087,yaptın,0,0,2,2
39996,obligé,0,0,2,2
37722,konsensusbeslut,0,0,2,2
19947,hiervan,0,0,2,2
1438,legato,1,2,0,2
23073,valor,0,0,2,2
24677,verbal,0,0,2,2
37702,يحررها,0,0,2,2
23053,gav,0,0,2,2
34287,soporte,0,0,2,2
35518,maddesini,0,0,2,2
3819,verrai,0,0,2,2
20019,trouwen,0,0,2,2
35519,reduction,0,0,2,2
35520,manter,0,0,2,2
1452,faccio,1,2,0,2
40063,второй,0,0,2,2
23042,licenses,0,0,2,2
20030,representações,0,0,2,2
40068,quant,0,0,2,2
34279,notícia,0,0,2,2
40077,hayatınızda,0,0,2,2
23041,faut,0,0,2,2
34273,ستة,0,0,2,2
23040,auparavant,0,0,2,2
24754,dépendra,0,0,2,2
20038,closest,0,0,2,2
37651,encyclopaedia,0,0,2,2
34271,seguida,0,0,2,2
37647,steht,0,0,2,2
23034,ووجدوا,0,0,2,2
24760,dibujo,0,0,2,2
20049,classiques,0,0,2,2
40091,prononciation,0,0,2,2
24762,одной,0,0,2,2
23054,begrepen,0,0,2,2
20011,திட்டங்களை,0,0,2,2
1446,telefono,1,2,0,2
16675,builds,0,0,2,2
35500,graphs,0,0,2,2
19975,maximize,0,0,2,2
37700,sophisticated,0,0,2,2
34303,falschen,0,0,2,2
19978,power,0,0,2,2
35503,وتعديل,0,0,2,2
37696,devriez,0,0,2,2
16685,சொற்றொடர்களை,0,0,2,2
19983,месяцы,0,0,2,2
19985,уэйлсу,0,0,2,2
1103,formazione,1,2,0,2
24726,hakkına,0,0,2,2
1443,prevedere,1,2,0,2
16659,senha,0,0,2,2
16671,recognition‏,0,0,2,2
16669,υπέροχα,0,0,2,2
37685,experientes,0,0,2,2
34294,habitats,0,0,2,2
34293,invloed,0,0,2,2
1444,minsky,1,2,0,2
34290,प्रमुख,0,0,2,2
24733,ഓർക്കുക,0,0,2,2
20006,δάνειο,0,0,2,2
1445,pratica,1,2,0,2
20008,cidadão,0,0,2,2
16660,تريده,0,0,2,2
24678,extérieure,0,0,2,2
16774,документальный,0,0,2,2
39878,licensierad,0,0,2,2
35451,vælges,0,0,2,2
37809,climates,0,0,2,2
34378,ചെയ്ത്,0,0,2,2
4199,மதிப்புக்குரியது,0,0,2,2
19826,familiar,0,0,2,2
35445,आहार,0,0,2,2
23143,graphical,0,0,2,2
16865,πληροφορίες,0,0,2,2
39912,voorbeeldzinnen,0,0,2,2
24626,climatiques,0,0,2,2
16859,conocido,0,0,2,2
24629,اللطيف,0,0,2,2
37806,teksten,0,0,2,2
39920,inventé,0,0,2,2
19831,முடிவு,0,0,2,2
16852,മൂന്നാം,0,0,2,2
37805,confirmed,0,0,2,2
35447,tillfälliga,0,0,2,2
24633,दलदली,0,0,2,2
19835,سأرسل,0,0,2,2
19836,dromen,0,0,2,2
23138,produire,0,0,2,2
19843,apply,0,0,2,2
37796,научиться,0,0,2,2
24634,εμφανίζεται,0,0,2,2
24637,idioma,0,0,2,2
34362,abonner,0,0,2,2
19847,betydning,0,0,2,2
34379,fiable,0,0,2,2
24613,protéger,0,0,2,2
39898,encountered,0,0,2,2
16895,ब्रेड,0,0,2,2
24602,ರ,0,0,2,2
39883,välkomna,0,0,2,2
35439,elliot,0,0,2,2
19802,artículos—,0,0,2,2
39886,assessment,0,0,2,2
23154,χθες,0,0,2,2
4197,الأخبار,0,0,2,2
16899,സൗകര്യവും,0,0,2,2
19804,logiciel ,0,0,2,2
37822,நினைப்பீர்களா,0,0,2,2
37821,utformning,0,0,2,2
34388,أخرى،,0,0,2,2
23152,അറിവു,0,0,2,2
37810,kararıyla,0,0,2,2
3444,punti,1,2,0,2
16890,மறக்காதீர்கள்,0,0,2,2
16889,प्रकरणों,0,0,2,2
16888,διαγραφών,0,0,2,2
35441,pudo,0,0,2,2
16886,സ്കൂളിൽ,0,0,2,2
19817,fondé,0,0,2,2
37814,പദങ്ങളുടെ,0,0,2,2
34382,programmés,0,0,2,2
23146,ಸಂಧಿಸುವಿಕೆಯನ್ನು,0,0,2,2
35444,rompecabezas,0,0,2,2
4198,ಕೇಳಿದ್ದೇನೆ,0,0,2,2
16840,disent,0,0,2,2
34360,debated,0,0,2,2
23097,contact,0,0,2,2
1428,sostenuto,1,2,0,2
23112,découvertes,0,0,2,2
24660,μυστικό,0,0,2,2
16800,включая,0,0,2,2
34346,اعتقدت,0,0,2,2
16797,drygt,0,0,2,2
16796,finds,0,0,2,2
34344,объёмом,0,0,2,2
37755,houve,0,0,2,2
16793,opmuntre,0,0,2,2
3832,sidder,0,0,2,2
19905,soutenir,0,0,2,2
39967,इण्टरनेट,0,0,2,2
24670,regardez,0,0,2,2
35476,sylt,0,0,2,2
1433,spagnolo,1,2,0,2
16784,perry,0,0,2,2
19911,первые,0,0,2,2
16783,organisé,0,0,2,2
35478,quantité,0,0,2,2
16781,حولها,0,0,2,2
34337,brutes,0,0,2,2
24674,прикрыть,0,0,2,2
39975,daarna,0,0,2,2
34336,வாங்க,0,0,2,2
19917,rationality,0,0,2,2
37743,κόσμο,0,0,2,2
16775,velkommen,0,0,2,2
39958,quantités,0,0,2,2
35467,battlestar,0,0,2,2
24657,nedenfor,0,0,2,2
39941,тесно,0,0,2,2
34357,mudar,0,0,2,2
37786,كتابة,0,0,2,2
16830,inserted,0,0,2,2
37783,കരുതുക,0,0,2,2
19863,diamanten,0,0,2,2
19868,differentiated,0,0,2,2
3447,donna,2,1,1,2
1430,ultimi,1,2,0,2
4204,सम्बन्ध,0,0,2,2
23122,historiador,0,0,2,2
39940,syftet,0,0,2,2
1432,epoca,1,2,0,2
19877,«por,0,0,2,2
24656,observou,0,0,2,2
34354,ಬಳಸಬಾರದು,0,0,2,2
37770,ചെയ്യാത്ത,0,0,2,2
16819,വിറ്റു,0,0,2,2
39944,analogs,0,0,2,2
19880,கண்கள்,0,0,2,2
19882,daarvoor,0,0,2,2
37766,சிக்கலான,0,0,2,2
24651,mile,0,0,2,2
1117,assume,2,1,1,2
24652,ekstremt,0,0,2,2
19887,carácter,0,0,2,2
39952,tropas,0,0,2,2
30296,கோணம்,0,0,2,2
13841,amerikanska,0,0,2,2
14165,parís,0,0,2,2
9557,αγαπητή,0,0,2,2
31723,wortschatz,0,0,2,2
9544,blockerades,0,0,2,2
28349,سأعطيك,0,0,2,2
45171,nde,0,0,2,2
45170,duración,0,0,2,2
45169,mænd,0,0,2,2
28345,juli,0,0,2,2
9558,مناسب,0,0,2,2
31739,находятся,0,0,2,2
9561,glückspilz,0,0,2,2
31731,incorporating,0,0,2,2
45158,«фонд,0,0,2,2
9570,आशा,0,0,2,2
9573,kendt,0,0,2,2
9578,هاه,0,0,2,2
2777,ted,2,1,1,2
9540,stade,0,0,2,2
45179,acceptées,0,0,2,2
9537,правлю,0,0,2,2
9533,cobriam,0,0,2,2
9495,الجمل,0,0,2,2
28368,ترَ,0,0,2,2
28366,ratings,0,0,2,2
9501,integral,0,0,2,2
9502,interrompre,0,0,2,2
9507,publicación,0,0,2,2
9509,passage,0,0,2,2
45195,berättade,0,0,2,2
45194,hiring,0,0,2,2
9515,μάτια,0,0,2,2
9521,gerelateerd,0,0,2,2
28360,grap,0,0,2,2
45189,stichting,0,0,2,2
31718,വേഗത,0,0,2,2
9530,صديقي,0,0,2,2
45148,daré,0,0,2,2
28328,परस्पर,0,0,2,2
45314,ссылки,0,0,2,2
31760,zugehört,0,0,2,2
28296,мэриан,0,0,2,2
45101,അടിസ്ഥാന,0,0,2,2
9648,समस्या,0,0,2,2
9649,rigorous,0,0,2,2
28295,schelen,0,0,2,2
9653,डिजाइन,0,0,2,2
9654,மேற்கொள்ளப்படும்,0,0,2,2
28288,courantes,0,0,2,2
28326,sensitivity,0,0,2,2
45090,protocol,0,0,2,2
9666,gümüş,0,0,2,2
45088,coup,0,0,2,2
28285,നൽകാൻ,0,0,2,2
31766,incite,0,0,2,2
28281,agradable,0,0,2,2
31769,esforço,0,0,2,2
28301,ഇല്ലാതെ,0,0,2,2
9635,выделенных,0,0,2,2
9631,verilere,0,0,2,2
9630,എന്തുകൊണ്ടാണ്,0,0,2,2
2779,inserire,1,2,0,2
9599,fest,0,0,2,2
9600,அடிப்படை,0,0,2,2
362,limiti,1,2,0,2
9602,हो।,0,0,2,2
9610,открытый,0,0,2,2
2780,ragionamenti,1,2,0,2
28315,समतुल्य,0,0,2,2
45126,സംഭവിക്കുന്നതെന്ന്,0,0,2,2
28312,wellmannered,0,0,2,2
2781,straordinario,1,2,0,2
45119,देशों,0,0,2,2
28308,säg,0,0,2,2
45115,источником,0,0,2,2
9627,abiotic,0,0,2,2
28370,forkerte,0,0,2,2
28376,போன்றவற்றைக்,0,0,2,2
45215,चित्रों,0,0,2,2
9367,വിക്കിപീഡിയക്കായി,0,0,2,2
9351,ഉണ്ടെന്ന്,0,0,2,2
5151,compose,0,0,2,2
9358,собственные,0,0,2,2
343,epic,2,1,1,2
9364,primer,0,0,2,2
28433,cuyas,0,0,2,2
45287,muestras,0,0,2,2
45284,narcissemor,0,0,2,2
45216,उदाहरणों,0,0,2,2
28429,கடன்,0,0,2,2
9373,говорят,0,0,2,2
9374,بوميس,0,0,2,2
28427,lezzetli,0,0,2,2
9378,सवारी,0,0,2,2
9383,probabilité,0,0,2,2
9384,operating,0,0,2,2
9350,тупому,0,0,2,2
45299,boy,0,0,2,2
9348,المستنقع,0,0,2,2
2329,assicurati,1,2,0,2
28451,drives,0,0,2,2
9325,diskuteras,0,0,2,2
9326,أعجبك,0,0,2,2
5158,perteneciente,0,0,2,2
341,controverse,2,1,1,2
9331,geïnteresseerd,0,0,2,2
9332,tried,0,0,2,2
45308,انت,0,0,2,2
5155,فيديو,0,0,2,2
9340,മറ്റൊന്ന്,0,0,2,2
342,tratta,1,2,0,2
9343,analizar,0,0,2,2
9344,meat,0,0,2,2
31664,observar,0,0,2,2
9346,participants,0,0,2,2
45272,utifrån,0,0,2,2
28422,sormanın,0,0,2,2
28421,अखबार,0,0,2,2
28391,recebeu,0,0,2,2
9449,दोहरा,0,0,2,2
9452,hemma,0,0,2,2
9454,interior,0,0,2,2
9457,hautparleur,0,0,2,2
9458,haya,0,0,2,2
45225,κόπο,0,0,2,2
45223,ಚೂಪಾದ,0,0,2,2
9465,klugen,0,0,2,2
28381,citerede,0,0,2,2
5142,relicense,0,0,2,2
9468,pensé,0,0,2,2
9469,reglerna,0,0,2,2
9472,beraber,0,0,2,2
28377,anunciada,0,0,2,2
45217,traitant,0,0,2,2
28390,flux,0,0,2,2
2768,disturbo,1,2,0,2
45267,சனிக்கிழமையன்று,0,0,2,2
9442,« d,0,0,2,2
9395,இருப்பதால்,0,0,2,2
28417,formar,0,0,2,2
9403,verbijsterd,0,0,2,2
45257,contribuyentes,0,0,2,2
9410,ಒಂದೇ,0,0,2,2
9413,donaciones,0,0,2,2
9414,beleuchtet,0,0,2,2
9416,opensolaris,0,0,2,2
28406,സേവനങ്ങൾ,0,0,2,2
45248,последним,0,0,2,2
9428,década,0,0,2,2
9429,ancienne,0,0,2,2
9430,anônimo,0,0,2,2
9431,gelişmesi,0,0,2,2
31693,ಎಳೆಯಿರಿ,0,0,2,2
9677,soi,0,0,2,2
5106,ينتهك,0,0,2,2
9684,utförd,0,0,2,2
31867,provedores,0,0,2,2
28156,marked,0,0,2,2
5078,संकलन,0,0,2,2
9931,pues,0,0,2,2
31860,lärande,0,0,2,2
31861,ಮಿಲಿಯನ್,0,0,2,2
31863,تدل,0,0,2,2
31865,வந்தீர்கள்,0,0,2,2
5076,عنك,0,0,2,2
9873,заслуживаю,0,0,2,2
9950,couch,0,0,2,2
28139,planalto,0,0,2,2
9952,low,0,0,2,2
31871,entscheidung,0,0,2,2
28136,сообщила,0,0,2,2
9956,loslegen,0,0,2,2
44888,ramène,0,0,2,2
44911,latinsk,0,0,2,2
44913,कंप्यूटर,0,0,2,2
28159,write,0,0,2,2
44916,حلمها,0,0,2,2
9876,rejette,0,0,2,2
9882,ಹೆಸರು,0,0,2,2
9884,betekenis,0,0,2,2
9888,болото,0,0,2,2
9889,أغسطس,0,0,2,2
44937,coole,0,0,2,2
9891,некоммерческая,0,0,2,2
28171,cold,0,0,2,2
9897,सकते।,0,0,2,2
9901,ಅಸಮಾಧಾನ,0,0,2,2
28165,ನಾಲ್ಕು,0,0,2,2
31852,violation,0,0,2,2
44924,fjollet,0,0,2,2
28161,nåede,0,0,2,2
44917,тот,0,0,2,2
2810,determinato,1,2,0,2
9960,diseñado,0,0,2,2
9961,strategy,0,0,2,2
28110,βράδυ,0,0,2,2
28107,humanity,0,0,2,2
10016,задачах,0,0,2,2
31895,последнее,0,0,2,2
28103,للكلمة,0,0,2,2
31899,लिनक्स,0,0,2,2
44838,welkom,0,0,2,2
31901,университета,0,0,2,2
31904,própria,0,0,2,2
44832,ലഭിക്കുന്നു,0,0,2,2
31905,beğendiyseniz,0,0,2,2
10037,competition,0,0,2,2
44826,söt,0,0,2,2
31909,أيضاً,0,0,2,2
10044,ಹೊಂದಿದ್ದೇನೆ,0,0,2,2
5062,समानांतर,0,0,2,2
10012,narcissisme,0,0,2,2
31889,ayudar,0,0,2,2
44884,फाउनडेशन,0,0,2,2
44857,cellesci,0,0,2,2
28131,कहना।,0,0,2,2
44881,bloqueio,0,0,2,2
9969,suspect,0,0,2,2
9971,говорили,0,0,2,2
44877,wikihpeedeeə,0,0,2,2
2291,lumaca,1,2,0,2
44868,hayatında,0,0,2,2
9987,retains,0,0,2,2
9988,februari,0,0,2,2
9990,unmatched,0,0,2,2
9991,πήρατε,0,0,2,2
9993,ആരാണ്,0,0,2,2
9996,besked,0,0,2,2
388,teorie,1,2,0,2
28117,bild,0,0,2,2
44946,descola,0,0,2,2
44949,creek,0,0,2,2
9686,увижу,0,0,2,2
45032,java,0,0,2,2
28249,ii,0,0,2,2
5097,esplanada,0,0,2,2
9736,sık,0,0,2,2
28248,språkversionerna,0,0,2,2
2793,distinte,1,2,0,2
28244,vänster,0,0,2,2
9745,geldiğini,0,0,2,2
45031,تسير,0,0,2,2
9869,motvalise,0,0,2,2
28239,mutation,0,0,2,2
45027,كتب,0,0,2,2
31795,olduğumuzu,0,0,2,2
9758,diğerini,0,0,2,2
9759,pediapress,0,0,2,2
45024,schaffen,0,0,2,2
372,primati,1,2,0,2
28251,allvar,0,0,2,2
9729,ಪಠ್ಯವನ್ನು,0,0,2,2
31787,aspectos,0,0,2,2
31786,inteligência,0,0,2,2
9692,perplexes,0,0,2,2
366,sorpresa,1,2,0,2
5102,какоето,0,0,2,2
45067,السرية,0,0,2,2
9703,αμέσως,0,0,2,2
9706,μικρότερη,0,0,2,2
9707,proposée,0,0,2,2
31782,hydrosphere,0,0,2,2
28259,ಇನ್ನೊಂದನ್ನು,0,0,2,2
9715,cooperação,0,0,2,2
45056,moeite,0,0,2,2
45055,preserves,0,0,2,2
9720,corps,0,0,2,2
2309,perspectives,1,2,0,2
28256,أنحاء,0,0,2,2
28232,सुखद,0,0,2,2
45018,imparcialidade,0,0,2,2
45017,sugeriu,0,0,2,2
31816,உருவாக்க,0,0,2,2
9827,временем,0,0,2,2
2301,pollice,1,2,0,2
44972,oldu,0,0,2,2
9836,klockan,0,0,2,2
2808,canzoni,1,2,0,2
44966,அங்கு,0,0,2,2
9844,தயவுசெய்து,0,0,2,2
5085,limitadas,0,0,2,2
44961,കിടക്കുന്ന,0,0,2,2
44959,veía,0,0,2,2
5082,sahiptir,0,0,2,2
28185,права,0,0,2,2
9864,inference,0,0,2,2
382,visibili,1,2,0,2
9868,effectively,0,0,2,2
28206,capteurs,0,0,2,2
44985,onderdeel,0,0,2,2
9770,pandemic,0,0,2,2
9817,समझ,0,0,2,2
9772,значок,0,0,2,2
45013,iedere,0,0,2,2
9778,académico,0,0,2,2
9782,enlace,0,0,2,2
9783,αποτέλεσμα,0,0,2,2
9788,tidsskriftets,0,0,2,2
28220,относить,0,0,2,2
9794,questioning,0,0,2,2
9795,ഫോൺ,0,0,2,2
44995,تستحق,0,0,2,2
44993,ιδρυτή,0,0,2,2
31813,modernes,0,0,2,2
44990,அர்த்தம்,0,0,2,2
31815,menciones,0,0,2,2
9816,рецензирования,0,0,2,2
45313,organized,0,0,2,2
28453,gyldne,0,0,2,2
43804,друзей,0,0,2,2
8857,группы,0,0,2,2
8841,comedy,0,0,2,2
28687,σχόλιο,0,0,2,2
8844,технологического,0,0,2,2
45639,doorgeven,0,0,2,2
8851,കഴിഞ്ഞ്,0,0,2,2
45635,يوفر,0,0,2,2
31492,المواقع,0,0,2,2
45630,पसंदीदा,0,0,2,2
45620,cry,0,0,2,2
2734,starò,1,2,0,2
8860,durch,0,0,2,2
8863,coordination,0,0,2,2
8864,tro,0,0,2,2
45624,базовые,0,0,2,2
5224,« décisions »,0,0,2,2
45623,"
bielorrusso",0,0,2,2
45644,النسخة,0,0,2,2
45647,lidar,0,0,2,2
28694,जैसा,0,0,2,2
293,sebbene,1,2,0,2
5231,climatic,0,0,2,2
8797,διαγραφή,0,0,2,2
28709,νάρκισσα,0,0,2,2
45671,centuries,0,0,2,2
45670,esfera,0,0,2,2
28708,κάνουμε,0,0,2,2
5229,दस्तावेज़,0,0,2,2
2729,significative,1,2,0,2
45661,ganska,0,0,2,2
28700,aktiva,0,0,2,2
5228,binnen,0,0,2,2
45656,communications,0,0,2,2
45654,fikrim,0,0,2,2
8824,न्यूट्रल,0,0,2,2
8826,artiklerne,0,0,2,2
28675,أشتري,0,0,2,2
31496,últimas,0,0,2,2
45317,hago,0,0,2,2
28637,лицо,0,0,2,2
28643,affaires,0,0,2,2
8940,propuso,0,0,2,2
5213,ಬಳಸಿ,0,0,2,2
5211,ಹೇಗೆ,0,0,2,2
8948,alınır,0,0,2,2
8952,personnalités,0,0,2,2
45571,स्वभाव,0,0,2,2
8955,மேற்கொள்ளும்,0,0,2,2
45613,കരയുകയും,0,0,2,2
8956,इन्हें,0,0,2,2
28636,ampliación,0,0,2,2
28634,simplesmente,0,0,2,2
8964,असंख्य,0,0,2,2
2735,impazzito,1,2,0,2
8968,videnskabsfolk,0,0,2,2
8969,syn,0,0,2,2
8935,τρόπους,0,0,2,2
45581,ppt,0,0,2,2
31512,समावेश,0,0,2,2
8924,neue,0,0,2,2
8887,pequeño,0,0,2,2
8892,acadêmicas,0,0,2,2
28666,என,0,0,2,2
31501,процесса,0,0,2,2
28663,oft,0,0,2,2
8898,executando,0,0,2,2
45604,αρνητικό,0,0,2,2
45601,четыре,0,0,2,2
45600,enormt,0,0,2,2
8907,matters,0,0,2,2
8908,identities,0,0,2,2
45599,celuici,0,0,2,2
28661,mágico,0,0,2,2
8915,öppen,0,0,2,2
45590,ಎಷ್ಟು,0,0,2,2
8793,परिष्कृत,0,0,2,2
8791,ಟೆರೆನ್ಸ್,0,0,2,2
31469,movies,0,0,2,2
8660,prontitud,0,0,2,2
31404,другую,0,0,2,2
31407,بمدى,0,0,2,2
8650,καλώς,0,0,2,2
45778,स्वप्न,0,0,2,2
45775,أجمل,0,0,2,2
8657,fique,0,0,2,2
8659,vocabulário,0,0,2,2
8662,bacterial,0,0,2,2
8782,wikiprogramvaran,0,0,2,2
8666,bibliotheek,0,0,2,2
45768,işler,0,0,2,2
277,processi,1,2,0,2
31421,செய்யவில்லை,0,0,2,2
8678,തുടർച്ചയായി,0,0,2,2
8680,annoncerede,0,0,2,2
28773,ನೋಡುವುದಿಲ್ಲ,0,0,2,2
2709,selezione,1,2,0,2
28794,добровольцев,0,0,2,2
28795,dispose,0,0,2,2
2358,confronto,1,2,0,2
45807,printed,0,0,2,2
8610,ഒരുമിച്ച്,0,0,2,2
28808,parodied,0,0,2,2
8612,evening,0,0,2,2
45804,presocratic,0,0,2,2
45802,ಹೇಳುತ್ತಿರುವುದನ್ನು,0,0,2,2
31395,ilk,0,0,2,2
28804,ಒಳ್ಳೆಯದನ್ನು,0,0,2,2
8624,ενεργειακό,0,0,2,2
45795,varies,0,0,2,2
31399,conclusão,0,0,2,2
8631,einfache,0,0,2,2
8633,எங்களுக்கு,0,0,2,2
8635,महसूस,0,0,2,2
8636,explicações,0,0,2,2
31424,சரியாக,0,0,2,2
5246,kommet,0,0,2,2
31425,dû,0,0,2,2
5237,источники,0,0,2,2
8741,بالكامل,0,0,2,2
45715,natuurwetenschappelijk,0,0,2,2
8744,videos,0,0,2,2
8745,поблагодарить,0,0,2,2
31451,നിങ്ങളോടൊപ്പമുണ്ടാകും,0,0,2,2
45710,geometrie,0,0,2,2
8751,webbplats,0,0,2,2
28735,ஆபத்துடைய,0,0,2,2
8758,shape,0,0,2,2
28728,χαρούμενη,0,0,2,2
2724,businessweek,2,1,1,2
8769,мной,0,0,2,2
45693,natuurwetenschappelijke,0,0,2,2
31462,സുഹൃത്ത്,0,0,2,2
8777,நிறைய,0,0,2,2
31448,numera,0,0,2,2
8735,извини,0,0,2,2
8691,pointu,0,0,2,2
28746,ആഗ്രഹിക്കുന്നില്ല,0,0,2,2
28765,प्रोत्साहित,0,0,2,2
5244,ಕೇಳುತ್ತಿಲ್ಲ,0,0,2,2
281,forniscono,1,2,0,2
8699,begränsas,0,0,2,2
28763,ലേഖനങ്ങളുള്ള,0,0,2,2
45744,கட்டுரைகளைத்,0,0,2,2
8705,corporativa,0,0,2,2
8709,субботу,0,0,2,2
45738,erişim,0,0,2,2
8718,administratörer,0,0,2,2
8723,ಹುರಿದುಂಬಿಸಲು,0,0,2,2
45729,மகிழ்ச்சியாக,0,0,2,2
31441,lié,0,0,2,2
31443,ಮದುವೆಯಲ್ಲಿ,0,0,2,2
28747,geçmiş,0,0,2,2
8974,svag,0,0,2,2
31526,банковский,0,0,2,2
45556,перешла,0,0,2,2
9216,века,0,0,2,2
31594,सेंटर,0,0,2,2
328,fornire,1,2,0,2
31596,இல்லையென்றால்,0,0,2,2
9195,visages,0,0,2,2
45407,großartige,0,0,2,2
31602,звучать,0,0,2,2
9204,paradox,0,0,2,2
45393,kararlar,0,0,2,2
5177,falsch,0,0,2,2
28510,അഭിപ്രായം,0,0,2,2
31609,മിനിറ്റിനുള്ളിൽ,0,0,2,2
28506,يقول,0,0,2,2
9224,खुशी,0,0,2,2
45386,imorgon,0,0,2,2
28505,l’histoire,0,0,2,2
45381,sociólogo,0,0,2,2
9185,söylemektir,0,0,2,2
31589,benutze,0,0,2,2
2341,enhanced,1,2,0,2
28534,indígenas,0,0,2,2
9142,वीं,0,0,2,2
31574,essencialmente,0,0,2,2
31575,ويقولون,0,0,2,2
9145,poner,0,0,2,2
45447,eigen,0,0,2,2
9148,другу,0,0,2,2
45445,நபரிடம்,0,0,2,2
45440,adição,0,0,2,2
45439,تلتقط,0,0,2,2
45438,கனவுகளின்,0,0,2,2
45437,namens,0,0,2,2
45433,வெளியிட்டது,0,0,2,2
9164,ಹೋಗುತ್ತಿದ್ದೇನೆ,0,0,2,2
31585,தகவல்கள்,0,0,2,2
9176,ಶನಿವಾರ,0,0,2,2
31614,история,0,0,2,2
45378,продолжить,0,0,2,2
45377,dando,0,0,2,2
45350,recognize,0,0,2,2
45348,تأكد,0,0,2,2
9275,interface,0,0,2,2
9281,परिणामों,0,0,2,2
9282,reise,0,0,2,2
31636,leyendo,0,0,2,2
28473,acerca,0,0,2,2
9288,издан,0,0,2,2
28470,तुमने,0,0,2,2
31642,yardımcı,0,0,2,2
9296,baixas,0,0,2,2
31643,hinanden,0,0,2,2
9299,πλαίσιο,0,0,2,2
31645,தரம்,0,0,2,2
31646,مستوى,0,0,2,2
31648,ಫ್ಲಮ್ಮೋಕ್ಸ್,0,0,2,2
335,riflettere,1,2,0,2
31631,accordent,0,0,2,2
45373,fuera,0,0,2,2
28486,മറ്റെന്തെങ്കിലും,0,0,2,2
5167,beta,0,0,2,2
28496,عشرة,0,0,2,2
45370,largely,0,0,2,2
9243,pakistan,0,0,2,2
9244,ചങ്ങാതിമാരുമായി,0,0,2,2
9245,langsom,0,0,2,2
28495,relationship,0,0,2,2
45368,importaria,0,0,2,2
45367,skolen,0,0,2,2
31622,appellation,0,0,2,2
2338,caro,1,2,0,2
9257,നിഷ്പക്ഷത,0,0,2,2
9258,सैनिकों,0,0,2,2
9260,целях,0,0,2,2
31626,sought,0,0,2,2
9141,deel,0,0,2,2
31573,expand,0,0,2,2
31528,нажав,0,0,2,2
9040,ενδιαφέρει,0,0,2,2
28603,ಮನಸ್ಸಿನಲ್ಲಿ,0,0,2,2
28601,ستحصل,0,0,2,2
28600,faktorer,0,0,2,2
45512,учёные,0,0,2,2
5194,idade,0,0,2,2
9038,administrator,0,0,2,2
9039,sormak,0,0,2,2
28594,πούμε,0,0,2,2
28553,jämföra,0,0,2,2
45506,σημείο,0,0,2,2
45504,понять,0,0,2,2
9047,movimiento,0,0,2,2
9051,hypotheses,0,0,2,2
9053,रखना,0,0,2,2
28588,reorganized,0,0,2,2
9055,decirlo,0,0,2,2
45524,அவர்களின்,0,0,2,2
28607,ابنتها,0,0,2,2
45532,вся,0,0,2,2
31539,ಮರೆಯದಿರಿ,0,0,2,2
5208,assouline,0,0,2,2
8983,conduite,0,0,2,2
5207,الملاك,0,0,2,2
8985,klicka,0,0,2,2
31531,بحثًا,0,0,2,2
28621,atribución,0,0,2,2
8989,retour,0,0,2,2
45545,डोक्युमेंटेशन,0,0,2,2
8996,biodiversité,0,0,2,2
28616,bericht,0,0,2,2
45542,இயங்கி,0,0,2,2
5205,l’utilisation,0,0,2,2
9000,νομίζετε,0,0,2,2
309,debba,1,2,0,2
45536,denominators,0,0,2,2
45498,звучит,0,0,2,2
5189,instructions,0,0,2,2
28584,begin,0,0,2,2
9103,vidéos,0,0,2,2
9107,officiellement,0,0,2,2
9109,acontecem,0,0,2,2
45466,paradoks,0,0,2,2
9111,kinderspiel,0,0,2,2
9114,étiquette,0,0,2,2
9117,ആകർഷണീയമായ,0,0,2,2
28558,своего,0,0,2,2
9123,κομμάτια,0,0,2,2
9124,данный,0,0,2,2
9128,numerators,0,0,2,2
9129,maandenlang,0,0,2,2
9130,success,0,0,2,2
9133,podemos,0,0,2,2
5178,siècles,0,0,2,2
9136,acontecimentos,0,0,2,2
28564,frau,0,0,2,2
45470,krydsede,0,0,2,2
9066,latijnse,0,0,2,2
9099,measures,0,0,2,2
28582,основана,0,0,2,2
5186,anonyma,0,0,2,2
28577,werkt,0,0,2,2
28576,பயன்படுகிறது,0,0,2,2
315,istruzioni,1,2,0,2
9078,bize,0,0,2,2
9079,सोर्बियाई,0,0,2,2
9081,ಕಷ್ಟಪಟ್ಟು,0,0,2,2
9082,dominios,0,0,2,2
31559,ഒരേ,0,0,2,2
45480,request,0,0,2,2
31561,ofrecer,0,0,2,2
28570,oprindeligt,0,0,2,2
9093,χρησιμοποιούν,0,0,2,2
9095,ഇവരുടെ,0,0,2,2
10048,resistance,0,0,2,2
10052,sebep,0,0,2,2
10053,rockt,0,0,2,2
27621,anser,0,0,2,2
32247,ನಿಮಿಷಗಳಲ್ಲಿ,0,0,2,2
10971,gifta,0,0,2,2
32250,πρίγκιπας,0,0,2,2
27628,equilibradas,0,0,2,2
10979,فترة,0,0,2,2
10981,விரும்பினேன்,0,0,2,2
44168,ആവശ്യമായ,0,0,2,2
2876,backpropagation,2,1,1,2
11010,informatiques,0,0,2,2
32259,ಸಮಯ,0,0,2,2
44159,solução,0,0,2,2
27610,concerne,0,0,2,2
11000,weglatingen,0,0,2,2
44154,ehe,0,0,2,2
11005,ರಹಸ್ಯ,0,0,2,2
11006,dün,0,0,2,2
4965,conter,0,0,2,2
27634,paramos,0,0,2,2
4966,யார்,0,0,2,2
4969,последний,0,0,2,2
44202,மெல்லியாக,0,0,2,2
44201,privatisation,0,0,2,2
27651,основные,0,0,2,2
4972,soruyorum,0,0,2,2
10937,livros,0,0,2,2
27649,देखना,0,0,2,2
10939,unesco,0,0,2,2
27647,ಒಪ್ಪುವುದಿಲ್ಲ,0,0,2,2
27646,ilustrativo,0,0,2,2
44191,शेष,0,0,2,2
2873,finché,1,2,0,2
32241,sonhos,0,0,2,2
10952,macha,0,0,2,2
10957,ಮಧ್ಯದಲ್ಲಿದ್ದರೆ,0,0,2,2
10958,അറിയിക്കുക,0,0,2,2
27606,متأكدا,0,0,2,2
27604,видите,0,0,2,2
10054,syntes,0,0,2,2
2884,filtraggio,1,2,0,2
11065,மெலிசா,0,0,2,2
44101,yoktur,0,0,2,2
44100,gérée,0,0,2,2
32289,customer,0,0,2,2
11075,أطول,0,0,2,2
4952,revisions,0,0,2,2
27567,ಕೇಳುತ್ತಿದ್ದಾರೆ,0,0,2,2
44090,açıdır,0,0,2,2
44145,известна,0,0,2,2
44089,fraude,0,0,2,2
2244,nulla,1,2,0,2
44086,assurer,0,0,2,2
32296,احتلت,0,0,2,2
11089,sulten,0,0,2,2
44081,tel,0,0,2,2
27557,rødder,0,0,2,2
44107,divisions,0,0,2,2
11058,suppe,0,0,2,2
11057,fıkra,0,0,2,2
27578,arkadaşınız,0,0,2,2
11014,box,0,0,2,2
32270,φίλο,0,0,2,2
27600,ലാരി,0,0,2,2
44138,derived,0,0,2,2
2249,settore,1,2,0,2
27593,σένα,0,0,2,2
32276,उपस्थित,0,0,2,2
2879,rappresentati,1,2,0,2
11036,ende,0,0,2,2
27586,draußen,0,0,2,2
11041,théoriquement,0,0,2,2
11042,आरोप,0,0,2,2
27584,ومنع,0,0,2,2
4959,ene,0,0,2,2
27582,politik,0,0,2,2
44204,इनमें,0,0,2,2
2869,insiemi,1,2,0,2
4975,научные,0,0,2,2
44292,регистрации,0,0,2,2
32190,ಪಡೆಯಲಿಲ್ಲ,0,0,2,2
44299,स्पेनिश,0,0,2,2
27714,considerado,0,0,2,2
10807,motsvarande,0,0,2,2
10808,commonalities,0,0,2,2
10809,schule,0,0,2,2
44294,آي,0,0,2,2
27710,artists,0,0,2,2
32231,publicamente,0,0,2,2
27708,espère,0,0,2,2
27707,सिर्फ,0,0,2,2
44287,itibarıyla,0,0,2,2
32197,flinke,0,0,2,2
10827,intitulé,0,0,2,2
10828,கவலைப்படுகிறீர்களா,0,0,2,2
10829,निर्धारित,0,0,2,2
10799,propiedad,0,0,2,2
10793,широкий,0,0,2,2
27721,phenomena,0,0,2,2
10790,essenciais,0,0,2,2
32170,indiquer,0,0,2,2
10756,denotar,0,0,2,2
10758,പണം,0,0,2,2
10759,делаешь,0,0,2,2
10764,défaut,0,0,2,2
27734,सवेव,0,0,2,2
44324,contribute,0,0,2,2
32179,montrent,0,0,2,2
10775,desalienta,0,0,2,2
27729,thuis,0,0,2,2
44316,opérateur,0,0,2,2
44313,തിരക്കിലാണ്,0,0,2,2
44312,étymologie,0,0,2,2
10787,способы,0,0,2,2
32185,rights,0,0,2,2
44280,ಅತ್ಯಾಧುನಿಕ,0,0,2,2
44275,أجراها,0,0,2,2
2859,episodio,2,1,1,2
27677,p ,0,0,2,2
44237,skolan,0,0,2,2
44236,bloomberg,0,0,2,2
10892,aquatic,0,0,2,2
10894,τραπέζι,0,0,2,2
44233,horizontale,0,0,2,2
44232,கோணத்திலும்,0,0,2,2
44230,flattening,0,0,2,2
44229,diamanter,0,0,2,2
10901,நேச்சர்,0,0,2,2
32222,desenvolvido,0,0,2,2
27670,ನಮಗೆ,0,0,2,2
2256,identificare,1,2,0,2
27663,verdien,0,0,2,2
27661,öppenhet,0,0,2,2
10919,ultraviolet,0,0,2,2
480,sapevo,1,2,0,2
2865,wikipediani,1,2,0,2
4989,άντρες,0,0,2,2
32217,sonunda,0,0,2,2
10844,மைல்,0,0,2,2
10845,audessus,0,0,2,2
478,marketing,2,1,1,2
44266,déjeuner,0,0,2,2
2258,contengono,1,2,0,2
32208,ಸೌಂದರ್ಯವು,0,0,2,2
4987,الستة,0,0,2,2
10857,faria,0,0,2,2
27686,எல்லாவற்றையும்,0,0,2,2
44256,kommentera,0,0,2,2
10866,grymma,0,0,2,2
44254,privada,0,0,2,2
10876,norte,0,0,2,2
4984,والعمل,0,0,2,2
44246,تشمل,0,0,2,2
44076,remained,0,0,2,2
11100,caused,0,0,2,2
27553,fandt,0,0,2,2
11368,ಕೆಲಸದ,0,0,2,2
32385,அங்கே,0,0,2,2
2892,recenti,1,2,0,2
43899,ligger,0,0,2,2
11359,सुविधा,0,0,2,2
27431,propriedade,0,0,2,2
27430,ήξερα,0,0,2,2
11364,aparência,0,0,2,2
43889,esas,0,0,2,2
43940,impresionante,0,0,2,2
43888,multimídia,0,0,2,2
32392,eet,0,0,2,2
43886,hänger,0,0,2,2
43885,följa,0,0,2,2
27424,courses,0,0,2,2
32395,साथ।,0,0,2,2
4910,جذر,0,0,2,2
32383,smile,0,0,2,2
523,assolutamente,1,2,0,2
32382,vectores,0,0,2,2
11341,singapore,0,0,2,2
32372,anladım,0,0,2,2
11305,crocker,0,0,2,2
2891,soli,1,2,0,2
27453,تلفظ,0,0,2,2
27452,പ്രതീക്ഷിക്കുന്നു,0,0,2,2
27448,فأنا,0,0,2,2
43926,ملاحظة,0,0,2,2
43924,aparición,0,0,2,2
43922,britânica,0,0,2,2
11324,verhoog,0,0,2,2
43918,சொர்க்கம்,0,0,2,2
11331,сначала,0,0,2,2
11334,மதிப்பு,0,0,2,2
4916,الأستاذ,0,0,2,2
43910,रे,0,0,2,2
11387,ويكيبيديا؛,0,0,2,2
27419,départ,0,0,2,2
27418,kelimelerin,0,0,2,2
4900,agi,0,0,2,2
11456,requested,0,0,2,2
2226,complementari,1,2,0,2
43826,naturelle,0,0,2,2
11465,ಮರುದಿನ,0,0,2,2
32432,manipulate,0,0,2,2
27368,ಸುಂದರ,0,0,2,2
27367,перестань,0,0,2,2
27364,düğmesine,0,0,2,2
11483,ontvoering,0,0,2,2
11485,extensión,0,0,2,2
27360,gifte,0,0,2,2
43807,άλλως,0,0,2,2
27359,ages,0,0,2,2
4895,creativity,0,0,2,2
11492,sentindo,0,0,2,2
32422,nela,0,0,2,2
27385,formel,0,0,2,2
532,georg,1,2,0,2
11445,पत्रकारिता,0,0,2,2
11396,reprise,0,0,2,2
27411,सुनें।,0,0,2,2
32402,touch,0,0,2,2
32403,mesma,0,0,2,2
27407,lecciones,0,0,2,2
11408,ställde,0,0,2,2
43862,clasificadores,0,0,2,2
32406,कला,0,0,2,2
11419,jeopardy,0,0,2,2
11424,concernant,0,0,2,2
32411,hel,0,0,2,2
32414,bebida,0,0,2,2
4902,ஆர்வம்,0,0,2,2
43846,ipod,0,0,2,2
11440,egendom”,0,0,2,2
32371,αργό,0,0,2,2
43941,cama,0,0,2,2
501,campioni,1,2,0,2
11164,هائلة,0,0,2,2
506,caratteri,1,2,0,2
11156,gratuito,0,0,2,2
44035,الاقتصاد,0,0,2,2
27526,property,0,0,2,2
11161,açısı,0,0,2,2
27525,verbazingwekkende,0,0,2,2
27524,राय,0,0,2,2
11167,hayalim,0,0,2,2
43942,കൈകാര്യം,0,0,2,2
11173,അല്ല,0,0,2,2
11175,ಅರ್ಹನೆಂದು,0,0,2,2
32325,parfaite,0,0,2,2
11178,доступные,0,0,2,2
44019,quite,0,0,2,2
32329,conduire,0,0,2,2
11189,pelas,0,0,2,2
27529,heter,0,0,2,2
11150,voedsel,0,0,2,2
11149,البريدية,0,0,2,2
11143,അതുകൊണ്ട്,0,0,2,2
11103,hantera,0,0,2,2
44071,fantásticas,0,0,2,2
502,migliore,1,2,0,2
27549,platform,0,0,2,2
27548,രഥത്തിൽ,0,0,2,2
11113,negatief,0,0,2,2
503,inserendo,1,2,0,2
32307,lektionen,0,0,2,2
32308,noemen,0,0,2,2
27541,inspirado,0,0,2,2
11127,exemple ,0,0,2,2
11130,tâches,0,0,2,2
11134,dalga,0,0,2,2
11135,actualiser,0,0,2,2
27535,बढ़ा,0,0,2,2
11191,hjalmarsson,0,0,2,2
11192,تمرير,0,0,2,2
11194,ಮಾರ್ಗಗಳನ್ನು,0,0,2,2
43980,menée,0,0,2,2
519,riprodurre,1,2,0,2
43973,character,0,0,2,2
11257,человек,0,0,2,2
27478,ach,0,0,2,2
2235,letture,1,2,0,2
32358,ಬನ್ನಿ,0,0,2,2
27473,αρχή,0,0,2,2
43963,இதனை,0,0,2,2
27472,intereses,0,0,2,2
11276,klicken,0,0,2,2
32364,«la,0,0,2,2
43952,സാധാരണയായി,0,0,2,2
27464,märkspråk,0,0,2,2
4921,واسعة,0,0,2,2
11293,मील,0,0,2,2
2237,elaborazione,1,2,0,2
11245,الهدف,0,0,2,2
11199,ಸಂಜೆ,0,0,2,2
11229,talking,0,0,2,2
32336,gylden,0,0,2,2
44005,рекламу,0,0,2,2
4931,பிரகாசமான,0,0,2,2
11210,manejo,0,0,2,2
32339,pide,0,0,2,2
27501,slår,0,0,2,2
11213,ಕ್ಲಿಕ್,0,0,2,2
2889,sarei,1,2,0,2
11217,talt,0,0,2,2
27496,ആറ്,0,0,2,2
27494,внимание,0,0,2,2
32345,tenzij,0,0,2,2
11226,l’espèce,0,0,2,2
11227,tomada,0,0,2,2
43992,culto,0,0,2,2
10753,sju,0,0,2,2
27742,connais,0,0,2,2
10751,εγγραφής,0,0,2,2
27953,skiftede,0,0,2,2
10272,रहूँगा,0,0,2,2
44668,expected,0,0,2,2
10275,நினைக்கவில்லை,0,0,2,2
10278,censure,0,0,2,2
10279,λιγότερο,0,0,2,2
10282,plantae,0,0,2,2
32005,définitions,0,0,2,2
10291,besvärlig,0,0,2,2
31974,അവസ്ഥയിൽ,0,0,2,2
44653,إلي,0,0,2,2
32011,αξίζω,0,0,2,2
32012,όνομά,0,0,2,2
32013,« pour,0,0,2,2
27946,anda,0,0,2,2
44647,iria,0,0,2,2
10303,incoming,0,0,2,2
44673,праве,0,0,2,2
10263,quotes,0,0,2,2
10262,большое,0,0,2,2
10260,sal,0,0,2,2
31976,обеспечения,0,0,2,2
10232,σταματήστε,0,0,2,2
10233,letters,0,0,2,2
27983,judío,0,0,2,2
5045,нарцисс,0,0,2,2
10239,يكفي,0,0,2,2
5044,исходя,0,0,2,2
10244,arbitration,0,0,2,2
27978,संभव,0,0,2,2
10249,ബന്ധപ്പെട്ട,0,0,2,2
31991,totalidad,0,0,2,2
44682,γνωρίζω,0,0,2,2
44680,ταξίδι,0,0,2,2
27971,бизнесе,0,0,2,2
10259,عطلة,0,0,2,2
27944,ಕನಸುಗಳ,0,0,2,2
44645,glaube,0,0,2,2
27943,ønske,0,0,2,2
44611,отметил,0,0,2,2
44610,sejt,0,0,2,2
27923,क्रूर,0,0,2,2
27922,संदेश,0,0,2,2
44606,volledig,0,0,2,2
27919,സന്തോഷം,0,0,2,2
32035,birden,0,0,2,2
44601,bonnes,0,0,2,2
44600,assets,0,0,2,2
10371,उनमें,0,0,2,2
44597,الأفضل,0,0,2,2
10374,complain,0,0,2,2
421,stampa,1,2,0,2
27916,കൊള്ളാം,0,0,2,2
10377,believe,0,0,2,2
27915,requer,0,0,2,2
10357,βάσης,0,0,2,2
10349,கூறுகிறீர்கள்,0,0,2,2
32015,ноября,0,0,2,2
5037,val,0,0,2,2
44640,sentados,0,0,2,2
32017,ക്രോധ,0,0,2,2
10314,länk,0,0,2,2
44637,enoje,0,0,2,2
44635,للشك,0,0,2,2
44634,iii,0,0,2,2
44633,sexism,0,0,2,2
10321,protégées,0,0,2,2
32020,dictionnaire,0,0,2,2
44627,diseases,0,0,2,2
32022,yerde,0,0,2,2
44625,decreases,0,0,2,2
10332,запросы,0,0,2,2
10333,tråkiga,0,0,2,2
10340,простое,0,0,2,2
2828,conclusioni,1,2,0,2
10218,കാഴ്ചപ്പാടുകൾ,0,0,2,2
44588,अगस्त,0,0,2,2
10115,بأنها,0,0,2,2
31932,publicitários,0,0,2,2
401,intenzione,1,2,0,2
10105,நினைத்தேன்,0,0,2,2
44779,équipe,0,0,2,2
10112,بحث,0,0,2,2
10113,dizaines,0,0,2,2
10114,positives,0,0,2,2
31938,kurumu,0,0,2,2
44709,viktiga,0,0,2,2
10122,chérie,0,0,2,2
28047,dedica,0,0,2,2
10125,levantadas,0,0,2,2
10126,opener,0,0,2,2
10128,തിരഞ്ഞെടുക്കുന്നു,0,0,2,2
10130,साइट,0,0,2,2
28043,ζητώντας,0,0,2,2
44786,exige,0,0,2,2
44797,wörtern,0,0,2,2
31921,تعليقًا,0,0,2,2
28070,større,0,0,2,2
31912,अभी,0,0,2,2
44819,finales,0,0,2,2
10057,इंटरैक्टिव,0,0,2,2
10058,policyn,0,0,2,2
10059,يخبرك,0,0,2,2
31914,двигаться,0,0,2,2
10065,dealing,0,0,2,2
28078,percebe,0,0,2,2
44812,roots,0,0,2,2
31916,مفرداتك,0,0,2,2
28075,noção,0,0,2,2
44805,larousse,0,0,2,2
10077,privatisé,0,0,2,2
28071,ದಿನಾಂಕವನ್ನು,0,0,2,2
10081,hang,0,0,2,2
5052,cultures,0,0,2,2
10136,önemi,0,0,2,2
31944,какое,0,0,2,2
44742,βιβλιοθήκη,0,0,2,2
2825,interessi,1,2,0,2
10180,effectué,0,0,2,2
28015,yiyeceklere,0,0,2,2
2826,accattivante,1,2,0,2
28007,φίλος,0,0,2,2
28005,खाते,0,0,2,2
44718,médical,0,0,2,2
28001,producir,0,0,2,2
28000,bordet,0,0,2,2
10203,birinden,0,0,2,2
10205,fremsætter,0,0,2,2
10209,കുറിച്ച്,0,0,2,2
44712,fácilmente,0,0,2,2
10212,मेलिंग,0,0,2,2
10215,comparável,0,0,2,2
31958,अविश्वसनीय,0,0,2,2
10171,الجمال,0,0,2,2
28039,springer,0,0,2,2
10170,kullanabileceğin,0,0,2,2
2285,generazione,1,2,0,2
28034,maintenance,0,0,2,2
28033,σωστά,0,0,2,2
10148,criticism,0,0,2,2
10149,पढ़,0,0,2,2
28032,ಸಂದೇಶವನ್ನು,0,0,2,2
28030,பயன்படுத்தப்படுகின்றன,0,0,2,2
31950,größer,0,0,2,2
31952,nuestro,0,0,2,2
44748,facteurs,0,0,2,2
10159,intuición,0,0,2,2
10165,hører,0,0,2,2
28024,καλύψεις,0,0,2,2
44744,ಬಯಸುತ್ತೀರಾ,0,0,2,2
10168,kişinin,0,0,2,2
27911,முழுவதும்,0,0,2,2
10388,استعدت,0,0,2,2
32168,purpose,0,0,2,2
32119,article »,0,0,2,2
446,crossover,2,1,1,2
27814,ಮನಸ್ಸಿಲ್ಲವೇ,0,0,2,2
10613,മലയാളമടക്കം,0,0,2,2
10614,ಸಿಲ್ಲಿ,0,0,2,2
32114,இருவரும்,0,0,2,2
10621,हुह,0,0,2,2
27806,proportion,0,0,2,2
27801,عربة,0,0,2,2
44465,மூலமும்,0,0,2,2
10634,administrador,0,0,2,2
32124,månaden,0,0,2,2
44419,النقر,0,0,2,2
44418,publicly,0,0,2,2
10639,fruto,0,0,2,2
10647,förtjänar,0,0,2,2
44407,словарный,0,0,2,2
2268,mancante,1,2,0,2
27816,επί,0,0,2,2
10608,uppdrag,0,0,2,2
10606,varying,0,0,2,2
10574,annual,0,0,2,2
10575,vendredi,0,0,2,2
442,determinata,1,2,0,2
10580,görüyorum,0,0,2,2
10582,neurones,0,0,2,2
32102,pensei,0,0,2,2
10586,വിലമതിക്കുന്നില്ല,0,0,2,2
444,interrompendo,2,1,1,2
32105,smaragder,0,0,2,2
2853,condivisione,1,2,0,2
10594,svare,0,0,2,2
27820,खाद्य,0,0,2,2
27819,உலகளவில்,0,0,2,2
10602,arabic,0,0,2,2
10605,begynde,0,0,2,2
27788,"

हालाँकि",0,0,2,2
10658,succes,0,0,2,2
44399,குளிர்ச்சியாக,0,0,2,2
10715,εγκυκλοπαίδειας,0,0,2,2
10717,turisten,0,0,2,2
4995,alter,0,0,2,2
27756,മനോഹരമായി,0,0,2,2
44352,ii»,0,0,2,2
32160,ansiklopedi,0,0,2,2
10730,supprimé,0,0,2,2
32162,ചോദ്യം,0,0,2,2
10735,मुझसे,0,0,2,2
44343,faço,0,0,2,2
27748,progressivement,0,0,2,2
4993,redactados,0,0,2,2
32165,ಹೇಳುತ್ತಿದ್ದೀರಿ,0,0,2,2
44338,négative,0,0,2,2
10745,wikier,0,0,2,2
10746,misiniz,0,0,2,2
4997,facility,0,0,2,2
44360,représente,0,0,2,2
32137,perte,0,0,2,2
462,responsabilità,1,2,0,2
27782,metres,0,0,2,2
457,intera,1,2,0,2
32142,ملايين,0,0,2,2
44386,sensibilité,0,0,2,2
10680,zavallı,0,0,2,2
44384,pierre,0,0,2,2
32146,gradiente,0,0,2,2
460,ultime,2,1,1,2
44373,كنا,0,0,2,2
44369,waray,0,0,2,2
10703,aanbieden,0,0,2,2
10704,grappige,0,0,2,2
44366,ενώ,0,0,2,2
44364,relevancia,0,0,2,2
44362,ಬೆರಗುಗೊಳಿಸುವ,0,0,2,2
2848,sporco,1,2,0,2
10566,परिभाषित,0,0,2,2
10389,occasion,0,0,2,2
5027,aufgaben,0,0,2,2
44562,ಪಡೆಯಲು,0,0,2,2
44559,  images,0,0,2,2
10428,النطق,0,0,2,2
10431,കുറച്ചുകാലമായി,0,0,2,2
10433,aimé,0,0,2,2
10434,ಚಿಕಿತ್ಸೆ,0,0,2,2
5028,conjunta,0,0,2,2
10437,مساهمات,0,0,2,2
27839,inherently,0,0,2,2
10440,നിങ്ങൾക്കറിയാമെന്ന്,0,0,2,2
5025,وتمييز,0,0,2,2
10443,дома,0,0,2,2
32053,उत्पन्न,0,0,2,2
44551,läggas,0,0,2,2
44546,éditeurs,0,0,2,2
32057,julie,0,0,2,2
27895,ഏവർക്കും,0,0,2,2
32048,literature,0,0,2,2
44567,egoistisk,0,0,2,2
44568,группа,0,0,2,2
44586,électriques,0,0,2,2
44585,परिवर्तनों,0,0,2,2
10392,ಪ್ರಶ್ನೆಯನ್ನು,0,0,2,2
10394,suggestions,0,0,2,2
424,licenze,1,2,0,2
10399,παρακάτω,0,0,2,2
10400,bırak,0,0,2,2
32042,bittet,0,0,2,2
10402,மாயாஜால,0,0,2,2
32043,raízes,0,0,2,2
32045,بسهولة,0,0,2,2
44575,etmektedir,0,0,2,2
44572,schreiben,0,0,2,2
27899,जुड़ा,0,0,2,2
27898,ανανέωση,0,0,2,2
27881,brugeres,0,0,2,2
10463,स्टीफन,0,0,2,2
10466,suit,0,0,2,2
10515,доступа,0,0,2,2
44498,obtive,0,0,2,2
27849,conduta,0,0,2,2
32087,получает,0,0,2,2
5020,ಸವಾರಿ,0,0,2,2
10532,ತಪ್ಪಾಗಿ,0,0,2,2
436,importava,2,1,1,2
10535,gebracht,0,0,2,2
10536,humilde,0,0,2,2
44485,ഉച്ചാരണം,0,0,2,2
10538,necessarily,0,0,2,2
10542,talte,0,0,2,2
438,motore,1,2,0,2
5018,αντίο,0,0,2,2
10548,фильмов,0,0,2,2
44476,försöker,0,0,2,2
32084,interesante,0,0,2,2
32082,காலத்தில்,0,0,2,2
32063,meinung,0,0,2,2
44506,antielitism,0,0,2,2
44527,nosso,0,0,2,2
10479,παρασκευή,0,0,2,2
44525,വിജ്ഞാനകോശമാണ്,0,0,2,2
44524,ಬೆಳಗಿದೆ,0,0,2,2
10483,தவிர,0,0,2,2
44519,பின்,0,0,2,2
10489,блокировки,0,0,2,2
44517,शिक्षाविद,0,0,2,2
32074,ഇന്ത്യൻഭാഷകളിലും,0,0,2,2
10496,منتصف,0,0,2,2
10497,تغطيني,0,0,2,2
44513,crowds,0,0,2,2
44512,protección,0,0,2,2
10500,duiden,0,0,2,2
10501,خاصة,0,0,2,2
45808,दिसम्बर,0,0,2,2
5259,pools,0,0,2,2
8602,puesto,0,0,2,2
6661,entonces,0,0,2,2
47227,işle,0,0,2,2
6641,excepcionalmente,0,0,2,2
5532,kolay,0,0,2,2
6643,gitmeye,0,0,2,2
47221,pasaron,0,0,2,2
47210,கையை,0,0,2,2
29795,تعرفه,0,0,2,2
6662,κάποια,0,0,2,2
47184,pendentes,0,0,2,2
47204,நேரத்தில்,0,0,2,2
47198,seasonal,0,0,2,2
5526,vandaan,0,0,2,2
5524,rol,0,0,2,2
6687,φύσις,0,0,2,2
47187,länka,0,0,2,2
47186,miljon,0,0,2,2
30659,возможности,0,0,2,2
29812,എളുപ്പത്തിൽ,0,0,2,2
6630,clarke,0,0,2,2
47234,philosophers,0,0,2,2
29831,fanns,0,0,2,2
30643,controversos,0,0,2,2
30644,volledige,0,0,2,2
6602,நிலத்தின்,0,0,2,2
6603,школе,0,0,2,2
29828,credited,0,0,2,2
30645,ശല്യപ്പെടുത്തുന്നതിൽ,0,0,2,2
6606,escola,0,0,2,2
30648,دلالات,0,0,2,2
47247,ब्रांड,0,0,2,2
6614,atrozes,0,0,2,2
47244,எவ்வளவு,0,0,2,2
6618,praktik,0,0,2,2
29816,shachaf,0,0,2,2
47235,ativas,0,0,2,2
6691,думал,0,0,2,2
47183,outperformed,0,0,2,2
29557,ஆரம்பத்தில்,0,0,2,2
109,mettere,1,2,0,2
47145,подождите,0,0,2,2
6748,surpresa,0,0,2,2
29755,സന്ദേശം,0,0,2,2
6754,tour,0,0,2,2
30702,antecipadamente,0,0,2,2
30703,salinity,0,0,2,2
29751,metapedia,0,0,2,2
6762,dynasty,0,0,2,2
6696,ಬುದ್ದಿವಂತನಲ್ಲ,0,0,2,2
47129,ελπίζω,0,0,2,2
6770,sugerencias,0,0,2,2
6772,fördröjs,0,0,2,2
47123,исключительно,0,0,2,2
47119,вашим,0,0,2,2
47116,сне,0,0,2,2
6783,विकिशब्दकोष,0,0,2,2
6744,falsos,0,0,2,2
6743,августа,0,0,2,2
47150,portions,0,0,2,2
29761,आँखें,0,0,2,2
47181,quotations,0,0,2,2
29779,pourraistu,0,0,2,2
6702,αγοράσω,0,0,2,2
29778,latinas,0,0,2,2
29775,bedöms,0,0,2,2
6709,cópia,0,0,2,2
5520,switch,0,0,2,2
29773,موثوق,0,0,2,2
47168,næppe,0,0,2,2
30691,s’intéressent,0,0,2,2
6719,"
इस",0,0,2,2
29768,സ്വാതന്ത്ര്യവും,0,0,2,2
6725,ऊपर,0,0,2,2
5516,ಹೇಗಿದ್ದೀರಿ,0,0,2,2
6734,الحال,0,0,2,2
30642,समूहों,0,0,2,2
30639,kötü,0,0,2,2
6591,உடையில்,0,0,2,2
47347,बल,0,0,2,2
47363,எளிதான,0,0,2,2
84,distribuire,1,2,0,2
2554,ˌwɪkiˈpiːdiə,2,1,1,2
47355,undersökningar,0,0,2,2
5552,eder,0,0,2,2
30587,تهتم,0,0,2,2
47348,vars,0,0,2,2
6471,üzere,0,0,2,2
30638,censura,0,0,2,2
47346,maktspel,0,0,2,2
29897,eigenlijk,0,0,2,2
87,avuto,1,2,0,2
47341,ಕೈ,0,0,2,2
47340,constraint,0,0,2,2
47337,ferais,0,0,2,2
47336,knappt,0,0,2,2
29913,സ്ഥലത്താണ്,0,0,2,2
29914,üye,0,0,2,2
6442,incroyablement,0,0,2,2
47375,பார்த்து,0,0,2,2
76,argento,1,2,0,2
29933,bientôt,0,0,2,2
29932,இதற்காக,0,0,2,2
6405,koruma,0,0,2,2
6406,लिख,0,0,2,2
2552,raramente,2,1,1,2
5557,sattın,0,0,2,2
6417,parks,0,0,2,2
29924,vorm,0,0,2,2
6421,förstod,0,0,2,2
6422,kalifornien,0,0,2,2
47383,அதிர்ஷ்டம்,0,0,2,2
6427,bases,0,0,2,2
47379,motor,0,0,2,2
47377,buenas,0,0,2,2
6483,محتواها,0,0,2,2
5549,विपरीत,0,0,2,2
30594,വേണ്ട,0,0,2,2
47300,hacia,0,0,2,2
29864,translated,0,0,2,2
6536,जाना।,0,0,2,2
6543,dirigentes,0,0,2,2
6545,sinceramente,0,0,2,2
6556,respektive,0,0,2,2
47283,criticado,0,0,2,2
47273,drömmen,0,0,2,2
6570,significativamente,0,0,2,2
6578,schémas,0,0,2,2
5542,പിൻബലത്തോടെ,0,0,2,2
6583,etnologiämnet,0,0,2,2
6584,fichiers,0,0,2,2
6585,private,0,0,2,2
6586,те,0,0,2,2
6588,ശല്യപ്പെടുത്തുന്ന,0,0,2,2
5546,λοιπόν,0,0,2,2
29866,चाहती,0,0,2,2
47330,баз,0,0,2,2
6527,gerekirse,0,0,2,2
89,fronte,1,2,0,2
6493,espanhol,0,0,2,2
29889,πατήσει,0,0,2,2
6496,short,0,0,2,2
30595,ವಹಿಸಲು,0,0,2,2
47326,kampen,0,0,2,2
29887,γρήγορη,0,0,2,2
6500,caractères,0,0,2,2
6502,രാഷ്ട്രീയ,0,0,2,2
30597,corrigilos,0,0,2,2
47322,alexandre,0,0,2,2
47318,سيجنثالر،,0,0,2,2
29877,ಮಾಂತ್ರಿಕ,0,0,2,2
30605,matériel,0,0,2,2
90,controversie,1,2,0,2
47115,إس,0,0,2,2
47114,oito,0,0,2,2
29734,ordinary,0,0,2,2
46952,τζίμι,0,0,2,2
6995,épouser,0,0,2,2
134,lettore,1,2,0,2
6997,массачусетского,0,0,2,2
7000,எது,0,0,2,2
30794,gebied,0,0,2,2
46955,зарегистрированы,0,0,2,2
29625,سهل,0,0,2,2
46951,manufactured,0,0,2,2
29649,нередко,0,0,2,2
30797,выделились,0,0,2,2
46948,telegrama,0,0,2,2
7020,формально,0,0,2,2
7025,hawaiiska,0,0,2,2
46941,vocabulary,0,0,2,2
29615,jongen,0,0,2,2
29614,stored,0,0,2,2
30792,кандидата,0,0,2,2
6992,വരുത്തുന്നതിൽ,0,0,2,2
46970,solicitações,0,0,2,2
6985,abandonné,0,0,2,2
30780,jours,0,0,2,2
6955,ಪ್ರದೇಶದ,0,0,2,2
5484,παρακαλούμε,0,0,2,2
46985,webben,0,0,2,2
6962,sød,0,0,2,2
46983,ώρα,0,0,2,2
46981,consider,0,0,2,2
6966,результате,0,0,2,2
29638,davantage,0,0,2,2
29636,മുൻകൂട്ടി,0,0,2,2
6975,sección,0,0,2,2
5482,طبعة,0,0,2,2
6977,bog,0,0,2,2
6982,कॉमंस,0,0,2,2
6983,मेटा,0,0,2,2
30804,способом,0,0,2,2
7034,എപ്പോഴും,0,0,2,2
30806,fiil,0,0,2,2
7085,मोटापे,0,0,2,2
5467,ക്രൂരമാണ്,0,0,2,2
7093,impose,0,0,2,2
46893,secondary,0,0,2,2
46891,carved,0,0,2,2
7097,favorite,0,0,2,2
7102,ziemlich,0,0,2,2
29571,jornalistas,0,0,2,2
7105,gotta,0,0,2,2
29569,πήγαν,0,0,2,2
29568,beskrev,0,0,2,2
30840,correctly,0,0,2,2
29565,«punto,0,0,2,2
46879,التحدث,0,0,2,2
46877,internas,0,0,2,2
30843,„википедию“,0,0,2,2
7086,इतनी,0,0,2,2
29581,starten,0,0,2,2
5471,моментом,0,0,2,2
7078,alegações,0,0,2,2
30809,ഇപ്പോഴും,0,0,2,2
30811,algoritmes,0,0,2,2
30812,toplantı,0,0,2,2
29601,исследователей,0,0,2,2
30816,désigne,0,0,2,2
46920,स्थित,0,0,2,2
29596,l’a,0,0,2,2
7055,convective,0,0,2,2
46913,रखना।,0,0,2,2
7065,centre,0,0,2,2
7066,имели,0,0,2,2
46908,publicidade,0,0,2,2
30826,vinner,0,0,2,2
7073,curtos,0,0,2,2
7077,pude,0,0,2,2
29646,servent,0,0,2,2
30776,användargränssnitt,0,0,2,2
47112,grow,0,0,2,2
6843,contrôler,0,0,2,2
29715,åren,0,0,2,2
6828,glemmer,0,0,2,2
6829,rädsla,0,0,2,2
29714,υποθέτω,0,0,2,2
47080,judges,0,0,2,2
30730,problemer,0,0,2,2
6840,descrição,0,0,2,2
5502,kardeş,0,0,2,2
30775,textuel,0,0,2,2
29703,долю,0,0,2,2
6849,εκτός,0,0,2,2
29699,habitualmente,0,0,2,2
6858,ಉಚ್ಚಾರಣೆಯನ್ನು,0,0,2,2
6859,heavy,0,0,2,2
6861,മെച്ചപ്പെട്ട,0,0,2,2
47061,otherwise,0,0,2,2
47088,സൗജന്യവും,0,0,2,2
6821,bounds,0,0,2,2
6820,diagnostic,0,0,2,2
29719,seinem,0,0,2,2
6788,വെയിൽ‌സും,0,0,2,2
47110,تهدف,0,0,2,2
47107,இதற்குக்,0,0,2,2
30718,kalla,0,0,2,2
6804,notable,0,0,2,2
6805,названием,0,0,2,2
6807,providers,0,0,2,2
6808,авторском,0,0,2,2
29724,формате,0,0,2,2
29723,compétences,0,0,2,2
6812,hébergeant,0,0,2,2
29721,habla,0,0,2,2
2458,sala,2,1,1,2
47091,أحب,0,0,2,2
6817,esmeraldas,0,0,2,2
6863,nyheden,0,0,2,2
6864,நனவாகும்,0,0,2,2
30743,консенсуса,0,0,2,2
30762,degré,0,0,2,2
6909,borrowed,0,0,2,2
2595,sky,1,2,0,2
6913,reflects,0,0,2,2
29662,accordingly,0,0,2,2
47017,fenômeno,0,0,2,2
6922,பிடித்திருந்தால்,0,0,2,2
126,previsione,1,2,0,2
47009,descreveu,0,0,2,2
47008,estudios,0,0,2,2
29657,ಸಭೆ,0,0,2,2
127,festa,2,1,1,2
30773,क्रिया,0,0,2,2
47002,yankovic,0,0,2,2
6937,cox,0,0,2,2
6939,تفضل,0,0,2,2
2593,beh,1,2,0,2
122,padre,2,1,1,2
5497,ಮೂರು,0,0,2,2
6902,ಬಡ,0,0,2,2
6868,réfléchir,0,0,2,2
30747,സുന്ദരൻ,0,0,2,2
6875,جادل,0,0,2,2
47053,മാർഗങ്ങൾ,0,0,2,2
47052,teacher,0,0,2,2
6878,ride,0,0,2,2
29689,tung,0,0,2,2
29688,elegir,0,0,2,2
30748,bloqueado,0,0,2,2
47047,akademiske,0,0,2,2
30752,ರೀತಿಯಲ್ಲಿ,0,0,2,2
30754,repeatedly,0,0,2,2
30757,കരുതി,0,0,2,2
47034,reuse,0,0,2,2
6900,ανθρώπους,0,0,2,2
2472,ciascun,1,2,0,2
6390,maintained,0,0,2,2
6388,अर्न्तगत,0,0,2,2
30178,المراكز,0,0,2,2
47757,øg,0,0,2,2
5874,عبارات,0,0,2,2
17,greco,1,2,0,2
30180,merezco,0,0,2,2
47748,ಹೇಳಿದರು,0,0,2,2
47747,encontrado,0,0,2,2
5886,بلغة,0,0,2,2
5891,şanslı,0,0,2,2
12,dispiacerebbe,1,2,0,2
2492,«l,1,2,0,2
30174,stört,0,0,2,2
47729,directa,0,0,2,2
30395,katalanska,0,0,2,2
5914,αργός,0,0,2,2
5618,agua,0,0,2,2
30157,stom,0,0,2,2
47758,ejecuta,0,0,2,2
47760,katılmıyorum,0,0,2,2
47761,speaking,0,0,2,2
30378,allonsy,0,0,2,2
5831,базой,0,0,2,2
30366,विज्ञापन,0,0,2,2
30197,crée,0,0,2,2
47778,libre—,0,0,2,2
30371,contextes,0,0,2,2
5846,poderem,0,0,2,2
5848,ಮೆಲಿಸ್ಸಾ,0,0,2,2
5849,लैरी,0,0,2,2
30373,الويب،,0,0,2,2
47772,огромный,0,0,2,2
30374,использовалась,0,0,2,2
47769,செய்தியை,0,0,2,2
47768,orbit,0,0,2,2
47767,إرسال,0,0,2,2
30376,réseau,0,0,2,2
30155,gustaría,0,0,2,2
30408,nobel,0,0,2,2
5929,mahkemesi,0,0,2,2
5977,memória,0,0,2,2
5985,सुझाव,0,0,2,2
5988,ήσουν,0,0,2,2
30431,ρίζα,0,0,2,2
5603,любое,0,0,2,2
30124,kullanıcı,0,0,2,2
5993,zoek,0,0,2,2
30123,தொகுப்புக்களை,0,0,2,2
47670,tonight,0,0,2,2
30432,paradoxe,0,0,2,2
5997,nieuws,0,0,2,2
30121,varandra,0,0,2,2
33,segnale,1,2,0,2
30120,början,0,0,2,2
6002,« wikipedia »,0,0,2,2
6003,விரும்புவதை,0,0,2,2
30127,эффект,0,0,2,2
5975,equatorial,0,0,2,2
47710,செய்தி,0,0,2,2
5974,traité,0,0,2,2
5936,display,0,0,2,2
5939,desacuerdos,0,0,2,2
47704,practices,0,0,2,2
47703,книге,0,0,2,2
47701,récord,0,0,2,2
47700,numarası,0,0,2,2
30415,existentes,0,0,2,2
5950,moderate,0,0,2,2
47694,सुधारने,0,0,2,2
5958,ótima,0,0,2,2
5606,cognitives,0,0,2,2
30419,affiliates,0,0,2,2
5963,repos »,0,0,2,2
5964,rör,0,0,2,2
5966,lessen,0,0,2,2
5628,religieuses,0,0,2,2
5826,nøjagtigt,0,0,2,2
30434,وأن,0,0,2,2
30261,run,0,0,2,2
30314,ശരി,0,0,2,2
5697,опубликованы,0,0,2,2
5698,applicants,0,0,2,2
30315,касается,0,0,2,2
5700,writes,0,0,2,2
30317,κι,0,0,2,2
30264,borde,0,0,2,2
5710,അജ്ഞാത,0,0,2,2
47789,കുഴപ്പമില്ല,0,0,2,2
5711,inicial,0,0,2,2
5714,ليست,0,0,2,2
47862,avhandlingen,0,0,2,2
30257,sakıncası,0,0,2,2
47860,محمية,0,0,2,2
47858,случаях,0,0,2,2
5723,demandes,0,0,2,2
4,venir,2,1,1,2
47884,geleden,0,0,2,2
5686,awarded,0,0,2,2
47889,helhet,0,0,2,2
5654,വായ്പ,0,0,2,2
30293,sos,0,0,2,2
47907,καθυστέρησης,0,0,2,2
30298,محايدة,0,0,2,2
5661,incorpora,0,0,2,2
47898,كيفية,0,0,2,2
5668,موضوع,0,0,2,2
5671,d’aa,0,0,2,2
5672,heißt,0,0,2,2
5673,redor,0,0,2,2
30304,publics,0,0,2,2
47895,«когда,0,0,2,2
30305,daher,0,0,2,2
5678,distinguish,0,0,2,2
2507,crudele,1,2,0,2
47853,motivos,0,0,2,2
5730,edities,0,0,2,2
5734,rostro,0,0,2,2
30226,ചോദിച്ചാൽ,0,0,2,2
47816,participación,0,0,2,2
2497,vedendo,1,2,0,2
5800,pais,0,0,2,2
47802,വിവാഹത്തിൽ,0,0,2,2
5804,mythologie,0,0,2,2
5807,dark,0,0,2,2
47800,ipucu,0,0,2,2
5812,முடியாமல்,0,0,2,2
5813,ब्रिटेनिका,0,0,2,2
5815,உருவாக்கும்,0,0,2,2
2519,ancora,1,2,0,2
5818,википедии»,0,0,2,2
47793,ابتهج,0,0,2,2
30204,لاحقًا,0,0,2,2
5824,kollektivt,0,0,2,2
8,conoscere,1,2,0,2
47820,கட்டுரைகளும்,0,0,2,2
5735,ρωτάτε,0,0,2,2
30229,geléia,0,0,2,2
5739,witz,0,0,2,2
5744,wortels,0,0,2,2
5745,पंजीकरण,0,0,2,2
30245,wp,0,0,2,2
47841,beseffen,0,0,2,2
5752,fortæl,0,0,2,2
30241,exploitation,0,0,2,2
30335,advice,0,0,2,2
2514,bell,2,1,1,2
5760,resumen,0,0,2,2
47830,physician,0,0,2,2
5763,similitud,0,0,2,2
47826,visàvis,0,0,2,2
30231,சிறப்புக்,0,0,2,2
5772,высоко,0,0,2,2
6005,increíblemente,0,0,2,2
30116,entendiste,0,0,2,2
6387,reliability,0,0,2,2
6269,revoir,0,0,2,2
30521,maand,0,0,2,2
29996,λέω,0,0,2,2
6252,பேசிக்கொண்டிருக்கலாம்,0,0,2,2
47494,authoritative,0,0,2,2
47491,atención,0,0,2,2
2542,incrociate,1,2,0,2
30530,terminar,0,0,2,2
47470,συνεχίσουν,0,0,2,2
47526,pnina,0,0,2,2
47469,أجريت,0,0,2,2
6283,personnel,0,0,2,2
29978,சோதனையில்,0,0,2,2
6285,directed,0,0,2,2
2543,albero,1,2,0,2
6290,domain,0,0,2,2
47463,maart,0,0,2,2
6245,شعرت,0,0,2,2
6243,devrais,0,0,2,2
6242,programmes,0,0,2,2
47499,понимаешь,0,0,2,2
47524,estatuto,0,0,2,2
30505,чемто,0,0,2,2
6208,vemos,0,0,2,2
30508,ರಾಜಕುಮಾರ,0,0,2,2
30013,കൂടിക്കാഴ്‌ച,0,0,2,2
6212,propuesto,0,0,2,2
6221,willkommen,0,0,2,2
47512,عزيزتي,0,0,2,2
30513,användbara,0,0,2,2
47508,കളിയാക്കണം,0,0,2,2
30003,suena,0,0,2,2
6235,техас,0,0,2,2
30001,ख्याल,0,0,2,2
30519,مذهل,0,0,2,2
5570,leis,0,0,2,2
63,cura,1,2,0,2
30541,förutsäga,0,0,2,2
29969,просят,0,0,2,2
47419,ertesi,0,0,2,2
6355,collegehumor,0,0,2,2
47416,largescale,0,0,2,2
6362,perhaps,0,0,2,2
29943,νόμιζα,0,0,2,2
47413,consacrée,0,0,2,2
6366,ಇರುತ್ತೇನೆ,0,0,2,2
47410,voluntaria,0,0,2,2
6370,adjö,0,0,2,2
6372,épico,0,0,2,2
6374,போன்றது,0,0,2,2
6379,xxi,0,0,2,2
73,editori,1,2,0,2
6383,kullanabilirsiniz,0,0,2,2
47403,vestir,0,0,2,2
6386,ചേർത്ത്,0,0,2,2
6353,സൗന്ദര്യം,0,0,2,2
6346,ಸೂಚಿಸಲು,0,0,2,2
6301,veräppeln,0,0,2,2
6345,വിജ്ഞാനകോശം,0,0,2,2
29968,май,0,0,2,2
6304,νέες,0,0,2,2
29967,fungerar,0,0,2,2
29966,assis,0,0,2,2
30542,الإصدارات,0,0,2,2
6312,формального,0,0,2,2
47444,begann,0,0,2,2
6316,முந்தைய,0,0,2,2
29960,наукам,0,0,2,2
47439,enjoy,0,0,2,2
6323,интернетпользователей,0,0,2,2
6325,hoffe,0,0,2,2
6326,ರೀತಿ,0,0,2,2
47436,लेते,0,0,2,2
29949,devait,0,0,2,2
47525,etmeye,0,0,2,2
6200,viktigt,0,0,2,2
34,notato,1,2,0,2
2486,profit,2,1,1,2
30080,apresenta,0,0,2,2
47614,वहां,0,0,2,2
6078,interdire,0,0,2,2
6081,remover,0,0,2,2
47608,сильно,0,0,2,2
30075,omkring,0,0,2,2
6088,உம்,0,0,2,2
2485,aggiunto,1,2,0,2
47529,dabei,0,0,2,2
47601,θέματος,0,0,2,2
30466,amenaza,0,0,2,2
6102,presença,0,0,2,2
6103,classifying,0,0,2,2
6104,zoekmachines,0,0,2,2
47594,usarem,0,0,2,2
6106,exactement,0,0,2,2
47617,darüber,0,0,2,2
6068,myntat,0,0,2,2
6061,approches,0,0,2,2
6060,doute,0,0,2,2
47658,énorme,0,0,2,2
2528,chiede,1,2,0,2
6016,graças,0,0,2,2
5595,περισσότερο,0,0,2,2
6025,எல்லோரும்,0,0,2,2
47647,verabschieden,0,0,2,2
6031,പറയുന്നതെന്ന്,0,0,2,2
6040,abarcaba,0,0,2,2
47636,سعيد,0,0,2,2
36,lascia,1,2,0,2
2529,teorici,1,2,0,2
30093,computadores,0,0,2,2
30451,πολλοί,0,0,2,2
6054,elegido,0,0,2,2
30088,ressource,0,0,2,2
6107,hata,0,0,2,2
6108,refiriéndose,0,0,2,2
6111,குறித்து,0,0,2,2
30033,halsiz,0,0,2,2
6171,forbindelse,0,0,2,2
47547,கொடுத்தார்,0,0,2,2
30500,século,0,0,2,2
6178,फैसला,0,0,2,2
47542,disposition,0,0,2,2
30027,environnementale,0,0,2,2
6181,precisam,0,0,2,2
30026,അമ്മയും,0,0,2,2
6184,ಕ್ರೂರ,0,0,2,2
6186,एडम्स,0,0,2,2
30024,பயங்கரமான,0,0,2,2
30501,удаления,0,0,2,2
6189,ചർച്ച,0,0,2,2
47534,practical,0,0,2,2
30021,neurosciences,0,0,2,2
30032,encanta,0,0,2,2
5576,кредит,0,0,2,2
2532,operativa,1,2,0,2
30037,लिये,0,0,2,2
6116,छवि,0,0,2,2
6119,arrasa,0,0,2,2
47587,одного,0,0,2,2
47577,الشخصية,0,0,2,2
6133,portion,0,0,2,2
30483,लेखक,0,0,2,2
47572,сайтом,0,0,2,2
30047,verspreiden,0,0,2,2
47566,supporting,0,0,2,2
5582,gases,0,0,2,2
6147,précédentes,0,0,2,2
5581,« principal »,0,0,2,2
47565,acusação,0,0,2,2
47562,sov,0,0,2,2
5577,βόλτα,0,0,2,2
2438,operato,1,2,0,2
7126,groter,0,0,2,2
8601,césar,0,0,2,2
46149,അയാൾക്ക്,0,0,2,2
2378,tue,2,1,1,2
31207,создан,0,0,2,2
46164,मियां,0,0,2,2
29058,identique,0,0,2,2
8112,yıl,0,0,2,2
46154,acessível,0,0,2,2
46152,comportamientos,0,0,2,2
8127,tengan,0,0,2,2
29037,உடன்படவில்லை,0,0,2,2
8128,indiquant,0,0,2,2
31216,andel,0,0,2,2
31219,failed,0,0,2,2
31220,occasionally,0,0,2,2
8135,neşelen,0,0,2,2
46139,لما,0,0,2,2
46136,recouvre,0,0,2,2
8099,ध्यान,0,0,2,2
29063,permis,0,0,2,2
31204,rod,0,0,2,2
46177,ഇംഗ്ലീഷിൽ,0,0,2,2
46195,सॉरी,0,0,2,2
31194,utgången,0,0,2,2
8065,heiraten,0,0,2,2
8070,acyclic,0,0,2,2
229,pedìa,1,2,0,2
31198,potatoes,0,0,2,2
46186,ദത്തവിവര,0,0,2,2
46185,أشهر,0,0,2,2
8079,vandálicos,0,0,2,2
29071,ஒன்றைப்,0,0,2,2
230,orribile,1,2,0,2
8083,moles,0,0,2,2
29069,mão,0,0,2,2
46179,gerekmez,0,0,2,2
8088,dynamo,0,0,2,2
8142,reconnu,0,0,2,2
2376,giugno,1,2,0,2
30847,കരുതുന്നു,0,0,2,2
31247,discovered,0,0,2,2
46098,انا,0,0,2,2
46095,distribuição,0,0,2,2
5321,gideceksin,0,0,2,2
8200,göndereceğim,0,0,2,2
46089,hermanos,0,0,2,2
8203,ഉയർന്ന,0,0,2,2
8204,pare,0,0,2,2
29006,posted,0,0,2,2
5329,collect,0,0,2,2
29004,பெறவில்லை,0,0,2,2
8210,مشاهدات,0,0,2,2
46082,écrit,0,0,2,2
8217,yazılımı,0,0,2,2
29003,amables,0,0,2,2
8222,arriver,0,0,2,2
8223,attendez,0,0,2,2
46099,أستحق,0,0,2,2
29020,நம்புகிறேன்,0,0,2,2
46105,ആരുടെയെങ്കിലും,0,0,2,2
8181,εύκολη,0,0,2,2
8150,ट्रुथ,0,0,2,2
5326,النزاعات,0,0,2,2
46125,ومنفرجة,0,0,2,2
29030,chateada,0,0,2,2
46122,दानपुण्य,0,0,2,2
46120,بجدية,0,0,2,2
46119,procurando,0,0,2,2
8164,विशाल,0,0,2,2
31232,écoutez,0,0,2,2
46111,ആവർത്തിക്കാൻ,0,0,2,2
46110,ഉള്ളത്,0,0,2,2
5323,préstamo,0,0,2,2
8175,impersonation,0,0,2,2
46107,academics,0,0,2,2
8179,bekymmer,0,0,2,2
8060,participated,0,0,2,2
29080,verdiene,0,0,2,2
46199,प्रकट,0,0,2,2
7949,kaffe,0,0,2,2
46285,beispielsätze,0,0,2,2
7937,efficient,0,0,2,2
29140,मारी,0,0,2,2
2386,faccia,1,2,0,2
29138,savoureux,0,0,2,2
46279,தரத்தைக்,0,0,2,2
46278,المكان,0,0,2,2
31151,trots,0,0,2,2
8056,തുടരുക,0,0,2,2
31154,beslut,0,0,2,2
7959,aktif,0,0,2,2
29125,membro,0,0,2,2
7969,оставить,0,0,2,2
7970,anayasa,0,0,2,2
29122,konanykhin,0,0,2,2
29121,വലിക്കുക,0,0,2,2
46286,φωτεινά,0,0,2,2
7930,douglas,0,0,2,2
7913,higherdimensional,0,0,2,2
29161,кусок,0,0,2,2
7869,cowen,0,0,2,2
7870,പ്രശ്‌നകരമായ,0,0,2,2
7872,संचालन,0,0,2,2
46331,computadora,0,0,2,2
7877,துல்லியத்தன்மை,0,0,2,2
31122,criticadas,0,0,2,2
7882,komm,0,0,2,2
46324,världen,0,0,2,2
46323,inspirée,0,0,2,2
29170,எதுவும்,0,0,2,2
7893,मिलाकर,0,0,2,2
29169,numa,0,0,2,2
7896,constatou,0,0,2,2
31127,അറിയാൻ,0,0,2,2
31128,leende,0,0,2,2
29118,trabaje,0,0,2,2
46252,يدفع,0,0,2,2
7980,விரும்பும்,0,0,2,2
2382,vediamo,1,2,0,2
8027,ಪ್ರೀತಿಸುತ್ತೇನೆ,0,0,2,2
46218,audaz,0,0,2,2
31185,navegar,0,0,2,2
31186,içeriği,0,0,2,2
8038,zouden,0,0,2,2
29087,मिलना,0,0,2,2
2380,personalmente,2,1,1,2
8043,نوع,0,0,2,2
5343,«знания»,0,0,2,2
8045,piezas,0,0,2,2
31190,talep,0,0,2,2
8049,kopf,0,0,2,2
46204,अग्रिम,0,0,2,2
46202,skruvade,0,0,2,2
46200,ответов,0,0,2,2
31181,recueil,0,0,2,2
8021,ungefär,0,0,2,2
31162,soldaten,0,0,2,2
8018,التراجع,0,0,2,2
5346,accommodate,0,0,2,2
46245,ಬೇಕು,0,0,2,2
7991,yollarını,0,0,2,2
46241,διαγραφεί,0,0,2,2
222,ufficiali,1,2,0,2
31170,terra,0,0,2,2
8003,noterat,0,0,2,2
8004,расстраивайтесь,0,0,2,2
8006,diskussionsforum,0,0,2,2
8007,ಒಬ್ಟೂಸ್,0,0,2,2
46232,parlementaire,0,0,2,2
31174,gestion,0,0,2,2
46229,heman,0,0,2,2
31175,सरंचना,0,0,2,2
8017,berbat,0,0,2,2
46072,сетевой,0,0,2,2
31254,anúncio,0,0,2,2
31255,multilingual,0,0,2,2
5280,политика,0,0,2,2
31335,चला,0,0,2,2
31337,varsa,0,0,2,2
258,minuti,1,2,0,2
45898,واسع,0,0,2,2
31351,egoísta,0,0,2,2
28867,മൈൽ,0,0,2,2
28866,figura,0,0,2,2
8484,manipulación,0,0,2,2
45946,everyone,0,0,2,2
45890,leisure,0,0,2,2
28864,دولار,0,0,2,2
45886,bancário,0,0,2,2
8492,gradually,0,0,2,2
2363,impiegato,1,2,0,2
28857,donnent,0,0,2,2
262,marmellata,1,2,0,2
28889,repita,0,0,2,2
31334,concordo,0,0,2,2
8451,общих,0,0,2,2
2695,preoccupa,1,2,0,2
8419,начал,0,0,2,2
45940,തത്ത്വം,0,0,2,2
255,giù,1,2,0,2
45937,"
árabe",0,0,2,2
28904,geri,0,0,2,2
8426,pleasure,0,0,2,2
8429,raiz,0,0,2,2
8431,وبعض,0,0,2,2
28901,essence,0,0,2,2
45932,சொல்கிறேன்,0,0,2,2
8439,queria,0,0,2,2
8440,angst,0,0,2,2
28897,sophistiqué,0,0,2,2
8444,карете,0,0,2,2
45923,flows,0,0,2,2
5277,burden,0,0,2,2
8507,beri,0,0,2,2
31363,यहां,0,0,2,2
45838,осуществлён,0,0,2,2
31379,أمثلة,0,0,2,2
8564,kunst,0,0,2,2
8565,പ്രശ്നമുണ്ടോ,0,0,2,2
45831,पागल,0,0,2,2
5270,لقول,0,0,2,2
31388,verwijderen,0,0,2,2
28816,americana,0,0,2,2
45818,പക്ഷെ,0,0,2,2
28815,പഠനം,0,0,2,2
5264,iğrenç,0,0,2,2
8591,"
norueguês",0,0,2,2
28813,नार्किसा,0,0,2,2
28812,dump,0,0,2,2
8596,subdomain,0,0,2,2
8597,تخبرني,0,0,2,2
31378,« l,0,0,2,2
45839,ವೀಡಿಯೊದ,0,0,2,2
8515,sizi,0,0,2,2
8556,saltet,0,0,2,2
28849,രുചികരമായ,0,0,2,2
8520,naturaliste,0,0,2,2
45865,викимедиа»,0,0,2,2
45861,редакторами,0,0,2,2
31367,iwf,0,0,2,2
8532,добро,0,0,2,2
8533,மாட்டேன்,0,0,2,2
28840,berättar,0,0,2,2
28838,videregive,0,0,2,2
8541,കത്തിക്കാം,0,0,2,2
8545,comprise,0,0,2,2
45846,подбодритесь,0,0,2,2
28834,சோதனை,0,0,2,2
45841,importaría,0,0,2,2
28831,especialmente,0,0,2,2
5290,juego,0,0,2,2
45947,специально,0,0,2,2
8238,växer,0,0,2,2
46019,försökte,0,0,2,2
8293,acomodar,0,0,2,2
28959,connaissez,0,0,2,2
31281,آخرون,0,0,2,2
31282,vejo,0,0,2,2
31283,vrijdag,0,0,2,2
245,antico,1,2,0,2
46020,للمشاركة,0,0,2,2
8301,último,0,0,2,2
45950,silly,0,0,2,2
5306,documentaire,0,0,2,2
8307,littéralement,0,0,2,2
31287,stakkels,0,0,2,2
46014,لأول,0,0,2,2
8310,стоимость,0,0,2,2
8312,mainly,0,0,2,2
8316,filmes,0,0,2,2
46026,insulte,0,0,2,2
31280,நடத்தப்படும்,0,0,2,2
46028,explicó,0,0,2,2
28961,computed,0,0,2,2
5316,obscene,0,0,2,2
5315,должно,0,0,2,2
28988,καλέσετε,0,0,2,2
46059,പദങ്ങൾ,0,0,2,2
8253,деятельности,0,0,2,2
8255,ಸುಂದರವಾಗಿ,0,0,2,2
8257,geração,0,0,2,2
46051,تأسيسها,0,0,2,2
8260,ögon,0,0,2,2
31268,hazırlandım,0,0,2,2
8267,ماريون,0,0,2,2
31271,sociedad,0,0,2,2
28971,desse,0,0,2,2
31272,jättebra,0,0,2,2
46038,غاضبًا,0,0,2,2
8317,daquela,0,0,2,2
247,immagino,1,2,0,2
46008,स्वयंसेवकों,0,0,2,2
28933,formulée,0,0,2,2
8368,emotion,0,0,2,2
251,organizzazione,1,2,0,2
31306,فلوريدا،,0,0,2,2
8379,büyülü,0,0,2,2
28922,rockar,0,0,2,2
2367,diffuse,2,1,1,2
8385,ಸ್ವಾಗತ,0,0,2,2
8390,പരസ്പരബഹുമാനവും,0,0,2,2
5297,надеюсь,0,0,2,2
8393,crédit,0,0,2,2
31314,glömmer,0,0,2,2
8400,المتعلقة,0,0,2,2
45954,ಚಾನಲ್‌ಗೆ,0,0,2,2
254,neurale,1,2,0,2
5293,доступна,0,0,2,2
45977,débattues,0,0,2,2
45979,gobierno,0,0,2,2
8325,கிடைக்குமா,0,0,2,2
28934,ordförråd,0,0,2,2
46004,декабря,0,0,2,2
28946,அனைத்தையும்,0,0,2,2
28945,porte,0,0,2,2
8332,genomfördes,0,0,2,2
45997,τίτλο,0,0,2,2
8339,ready,0,0,2,2
8340,الاستقرائي,0,0,2,2
8343,सदी,0,0,2,2
28939,askerler,0,0,2,2
8348,buraya,0,0,2,2
28936,ökar,0,0,2,2
45984,huske,0,0,2,2
8355,λεξιλόγιό,0,0,2,2
8357,displace,0,0,2,2
28935,ವಿವರಿಸುತ್ತದೆ,0,0,2,2
46334,ചോദിക്കാനുള്ള,0,0,2,2
46335,ameaça,0,0,2,2
7864,клеток,0,0,2,2
7366,പിന്നീട്,0,0,2,2
7353,zenodot,0,0,2,2
29426,صفحاتها,0,0,2,2
46696,भूखा,0,0,2,2
30936,बढ़ाने,0,0,2,2
162,cancellati,1,2,0,2
46692,pedido,0,0,2,2
7362,entreprises,0,0,2,2
46687,சோர்வாக,0,0,2,2
46733,يرجع,0,0,2,2
165,incarichi,1,2,0,2
7375,político,0,0,2,2
29415,लिंक,0,0,2,2
30942,ಇಲ್ಲಿಗೆ,0,0,2,2
46672,cult,0,0,2,2
46669,porém,0,0,2,2
7391,viser,0,0,2,2
7347,ettim,0,0,2,2
7343,estavam,0,0,2,2
7342,letter,0,0,2,2
29434,padrões,0,0,2,2
46730,episch,0,0,2,2
7307,casos—,0,0,2,2
7308,gostou,0,0,2,2
46722,aucun,0,0,2,2
7318,collectively,0,0,2,2
7319,högskola,0,0,2,2
46720,ಹೊಂದಿದೆ,0,0,2,2
7321,discuss,0,0,2,2
29443,assignments,0,0,2,2
46715,hoş,0,0,2,2
5431,പുസ്തകം,0,0,2,2
5430,primarily,0,0,2,2
29439,gegevens,0,0,2,2
7333,éditoriale,0,0,2,2
46710,categorized,0,0,2,2
46667,பயனர்கள்,0,0,2,2
46664,காலமாக,0,0,2,2
29405,smaragden,0,0,2,2
46624,internets,0,0,2,2
46620,confiável,0,0,2,2
46619,സ്ഥലത്ത്,0,0,2,2
46616,proposent,0,0,2,2
30975,cambrian,0,0,2,2
7470,κακό,0,0,2,2
30977,religión,0,0,2,2
5415,الليلة,0,0,2,2
7473,türkçe,0,0,2,2
46612,शब्दकोश,0,0,2,2
30978,englishspeaking,0,0,2,2
29368,mooie,0,0,2,2
46609,pillars,0,0,2,2
29367,racist,0,0,2,2
7481,hazırlanmaktadır,0,0,2,2
46606,उल्लेख,0,0,2,2
29374,ജനകീയ,0,0,2,2
7457,ಇಬ್ಬರು,0,0,2,2
29404,മൂന്ന്,0,0,2,2
30972,drömmar,0,0,2,2
7400,gebeuren,0,0,2,2
7405,ortográficas,0,0,2,2
29395,exactly,0,0,2,2
46649,dominant,0,0,2,2
5425,menace,0,0,2,2
7423,φύγω,0,0,2,2
2420,percettroni,1,2,0,2
7429,holocene,0,0,2,2
7430,приятного,0,0,2,2
7434,crawler,0,0,2,2
7435,macmillan,0,0,2,2
29385,ಎಂದರ್ಥ,0,0,2,2
7440,convirtió,0,0,2,2
169,ascolta,1,2,0,2
7450,hoort,0,0,2,2
7301,tratan,0,0,2,2
7296,goldbrot,0,0,2,2
174,coprirmi,1,2,0,2
30879,mand,0,0,2,2
29514,hänvisar,0,0,2,2
145,criticata,1,2,0,2
146,rappresentare,1,2,0,2
46811,रखाव,0,0,2,2
46810,именно,0,0,2,2
29509,decirles,0,0,2,2
7197,plane,0,0,2,2
7200,യഥാർത്ഥത്തിൽ,0,0,2,2
7294,seas,0,0,2,2
46805,jaarlijkse,0,0,2,2
30880,seine,0,0,2,2
30882,"
we",0,0,2,2
30883,gentille,0,0,2,2
7209,amaçlı,0,0,2,2
29502,महान,0,0,2,2
7212,wikiality,0,0,2,2
29515,स्पष्ट,0,0,2,2
29517,ಸಂತೋಷದ,0,0,2,2
30874,ಹೇಳುತ್ತಾರೆ,0,0,2,2
7172,kurallarına,0,0,2,2
29553,спрашиваю,0,0,2,2
30850,kl,0,0,2,2
29551,παίρνεις,0,0,2,2
30853,reconnues,0,0,2,2
29546,λήμμα,0,0,2,2
46853,تفهم,0,0,2,2
46846,معرفة,0,0,2,2
7153,philosophies,0,0,2,2
29533,പ്രവർത്തിക്കുന്നു,0,0,2,2
30865,பொருட்டல்ல,0,0,2,2
46839,είχαν,0,0,2,2
29531,lære,0,0,2,2
7163,ervan,0,0,2,2
29528,λόγω,0,0,2,2
7169,divers,0,0,2,2
46798,çalışmasını,0,0,2,2
46796,структура,0,0,2,2
29499,മാറ്റം,0,0,2,2
29475,சந்தா,0,0,2,2
153,direttore,1,2,0,2
2432,rallegrati,1,2,0,2
29469,underlätta,0,0,2,2
30903,лучшая,0,0,2,2
46755,iniciado,0,0,2,2
46754,wurzeln,0,0,2,2
7271,suggests,0,0,2,2
46751,afecta,0,0,2,2
29465,ridder,0,0,2,2
29463,cross,0,0,2,2
7279,γίνει,0,0,2,2
7280,ತಾನು,0,0,2,2
30909,creditado,0,0,2,2
2430,dispositivo,2,1,1,2
7290,temperate,0,0,2,2
5436,acha,0,0,2,2
7255,animaux,0,0,2,2
29498,ούτως,0,0,2,2
46766,—«wikipedia,0,0,2,2
7218,dias,0,0,2,2
5442,செய்திருந்தால்,0,0,2,2
29495,ഇതെല്ലാം,0,0,2,2
30889,considerados,0,0,2,2
46786,спрашиваете,0,0,2,2
2621,frank,2,1,1,2
149,verbale,2,1,1,2
7230,सारे,0,0,2,2
7232,rikedomar,0,0,2,2
150,contenenti,1,2,0,2
2434,autorevolezza,1,2,0,2
29483,الجمعة,0,0,2,2
7245,healthcare,0,0,2,2
29477,veelvoorkomende,0,0,2,2
7248,വിക്കിപീഡിയരുടെ,0,0,2,2
46605,examined,0,0,2,2
7487,സംഭാവന,0,0,2,2
7863,entity,0,0,2,2
7723,देखी,0,0,2,2
7702,fouten,0,0,2,2
46452,presentatie,0,0,2,2
46450,daad,0,0,2,2
7714,குழப்பம்,0,0,2,2
7715,lumières,0,0,2,2
7716,arrêt,0,0,2,2
29259,indesejáveis,0,0,2,2
29256,belirtilmeli,0,0,2,2
7653,alabilir,0,0,2,2
7731,نبدأ,0,0,2,2
7738,deserve,0,0,2,2
29245,ಗಾಡಿ,0,0,2,2
29243,enviados,0,0,2,2
29240,diamantes,0,0,2,2
31073,doctrine,0,0,2,2
7751,pertinence,0,0,2,2
7699,autonomes,0,0,2,2
7697,uppnått,0,0,2,2
7693,overrasket,0,0,2,2
46458,இடமில்லை,0,0,2,2
7658,отметку,0,0,2,2
7659,ആധികാരികത,0,0,2,2
46479,يتلقى,0,0,2,2
29280,possess,0,0,2,2
46475,विभिन्न,0,0,2,2
46470,സിസോപ്പുകളേയും,0,0,2,2
7673,bevatte,0,0,2,2
29275,νάρκισα,0,0,2,2
46467,hangisinin,0,0,2,2
7680,واليابانية,0,0,2,2
7684,neveneffect,0,0,2,2
46463,störst,0,0,2,2
29271,técnicos,0,0,2,2
196,stupefacente,1,2,0,2
46460,tomes,0,0,2,2
7757,bokmål,0,0,2,2
7763,πάτε,0,0,2,2
7764,ஜாம்,0,0,2,2
29209,heavens,0,0,2,2
29203,قرار,0,0,2,2
31096,ഇത്തരത്തിൽ,0,0,2,2
46368,nereden,0,0,2,2
46367,becoming,0,0,2,2
7825,« ce,0,0,2,2
7826,मौजूद,0,0,2,2
46355,പരസ്പരം,0,0,2,2
2664,atroci,1,2,0,2
31113,വലിപ്പം,0,0,2,2
46341,digam,0,0,2,2
7855,interesseret,0,0,2,2
5359,зависимости,0,0,2,2
7858,കേട്ടിട്ടുണ്ട്,0,0,2,2
209,sviluppa,1,2,0,2
31118,forkert,0,0,2,2
2655,disponibile,1,2,0,2
5364,stand,0,0,2,2
46410,oye,0,0,2,2
29211,identifié,0,0,2,2
29229,बनाए,0,0,2,2
5370,лицензией,0,0,2,2
7775,ошибка,0,0,2,2
7778,दुर्लभ,0,0,2,2
5369,executive,0,0,2,2
7780,കാഴ്ചപ്പാടുകളും,0,0,2,2
203,radici,1,2,0,2
29222,என்னைப்,0,0,2,2
46394,ஆரம்ப,0,0,2,2
29217,praticamente,0,0,2,2
46388,μέσα,0,0,2,2
2397,voi,1,2,0,2
46385,zittrain,0,0,2,2
29213,ಮಾಡುತ್ತಿದ್ದಳು,0,0,2,2
46383,identifier,0,0,2,2
7656,profesor,0,0,2,2
7651,comenzar,0,0,2,2
46602,посещаемости,0,0,2,2
31005,பணம்,0,0,2,2
7532,sehe,0,0,2,2
46567,afirmaba,0,0,2,2
31001,மேற்கொள்ளப்பட்ட,0,0,2,2
182,guardando,1,2,0,2
46560,könnte,0,0,2,2
7547,época,0,0,2,2
7548,энциклопедического,0,0,2,2
31006,ಜಾಮ್,0,0,2,2
31043,ställning,0,0,2,2
29330,precisamos,0,0,2,2
46556,സാങറും,0,0,2,2
46555,breve,0,0,2,2
29329,kelimesi,0,0,2,2
29328,الأسئلة,0,0,2,2
46549,становятся,0,0,2,2
7563,dejlig,0,0,2,2
46576,llamados,0,0,2,2
7527,dá,0,0,2,2
5406,ತಾಯಿಯನ್ನು,0,0,2,2
29349,origens,0,0,2,2
30981,പുതുതായി,0,0,2,2
30983,suele,0,0,2,2
7494,வண்டி,0,0,2,2
30985,born,0,0,2,2
29359,beskriva,0,0,2,2
30987,bonitos,0,0,2,2
29356,ಉತ್ತಮವಾಗಿ,0,0,2,2
46590,considerar,0,0,2,2
29355,голоден,0,0,2,2
29354,ಹೆಚ್ಚಿನ,0,0,2,2
29353,про,0,0,2,2
7513,قاموا,0,0,2,2
30988,تكن,0,0,2,2
2639,giorni,1,2,0,2
7518,kinds,0,0,2,2
5400,ನಿಧಾನವಾಗಿದೆ,0,0,2,2
7570,கலைக்களஞ்சியத்தின்,0,0,2,2
186,proposte,1,2,0,2
46507,pequenos,0,0,2,2
7622,muita,0,0,2,2
7625,ومع,0,0,2,2
46503,teil,0,0,2,2
2407,rumelhart,2,1,1,2
31035,спрашивает,0,0,2,2
192,organizzate,1,2,0,2
46494,réellement,0,0,2,2
7639,beslissing,0,0,2,2
7640,പ്രശ്നങ്ങളിൽ,0,0,2,2
7641,പറ്റിയെഴുതുന്നു,0,0,2,2
2403,equivalente,2,1,1,2
46490,huylu,0,0,2,2
46489,مستخدمو,0,0,2,2
31041,examiner,0,0,2,2
46485,dazu,0,0,2,2
29297,intelligenten,0,0,2,2
7618,gelden,0,0,2,2
7577,«,0,0,2,2
29300,caché,0,0,2,2
2409,fa,1,2,0,2
31019,sharealike,0,0,2,2
46532,bataklık,0,0,2,2
7583,ക്ഷമ,0,0,2,2
46530,mercado,0,0,2,2
46528,செய்வேன்,0,0,2,2
46525,forvaltere,0,0,2,2
46522,transphobie,0,0,2,2
46520,quatrième,0,0,2,2
7595,सप्ताह,0,0,2,2
46519,removidas,0,0,2,2
7605,consistía,0,0,2,2
46514,சிக்கியிருக்கிறேன்,0,0,2,2
7610,sigue,0,0,2,2
7612,വിദഗ്ദ്ധന്മാർ,0,0,2,2
43805,diffuser,0,0,2,2
3577,negativi,1,2,0,2
42267,научными,0,0,2,2
33081,ग्रस्त,0,0,2,2
42965,bedeutung,0,0,2,2
26454,bancaire,0,0,2,2
12654,mécanisme,0,0,2,2
33262,trolls,0,0,2,2
2093,possibile,1,2,0,2
42150,बंद,0,0,2,2
43421,afortunado,0,0,2,2
13767,nenhuma,0,0,2,2
4616,poetry,0,0,2,2
32642,കൈ,0,0,2,2
42961,útil,0,0,2,2
32884,typical,0,0,2,2
12030,inserção,0,0,2,2
42959,ಪರಿಸ್ಥಿತಿಯಲ್ಲಿ,0,0,2,2
12662,producido,0,0,2,2
42144,passent,0,0,2,2
32641,فظيعًا,0,0,2,2
33087,file,0,0,2,2
12027,øjne,0,0,2,2
42966,ഇതിലൂടെ,0,0,2,2
12650,eruditos,0,0,2,2
2099,composto,1,2,0,2
42970,ಸ್ಥಳವನ್ನು,0,0,2,2
42976,trevligt,0,0,2,2
43408,парень,0,0,2,2
12638,généraliste,0,0,2,2
2100,tecnica,1,2,0,2
42975,बड़ा,0,0,2,2
33093,स्थापित,0,0,2,2
43410,économique,0,0,2,2
26203,dili,0,0,2,2
4618,politikartiklar,0,0,2,2
32647,satın,0,0,2,2
26759,considerou,0,0,2,2
12646,contributor,0,0,2,2
26202,कस्टमनिर्मित,0,0,2,2
43413,lykke,0,0,2,2
12647,فضلك؟,0,0,2,2
42520,examination,0,0,2,2
43414,världens,0,0,2,2
12040,सम्पादक,0,0,2,2
13772,saindo,0,0,2,2
42957,biliyorsunuz,0,0,2,2
730,verificare,1,2,0,2
42133,precis,0,0,2,2
728,raccolta,1,2,0,2
42950,parties,0,0,2,2
42540,ಆಹಾರವನ್ನು,0,0,2,2
42136,colaborativo,0,0,2,2
2124,dicembre,1,2,0,2
13788,experimentos,0,0,2,2
42545,juni,0,0,2,2
26181,western,0,0,2,2
12677,daarnaast,0,0,2,2
32630,டெரன்ஸ்,0,0,2,2
4829,prisons,0,0,2,2
26745,उपयोगिता,0,0,2,2
13796,huilt,0,0,2,2
42943,مصداقية,0,0,2,2
42942,отправить,0,0,2,2
4675,específico,0,0,2,2
12686,باستخدام,0,0,2,2
32622,verici,0,0,2,2
43443,caracol,0,0,2,2
27096,zamanla,0,0,2,2
13774,глупый,0,0,2,2
13781,kimmel,0,0,2,2
13261,pseudonyme,0,0,2,2
26462,uppsatser,0,0,2,2
33085,सर्वोत्तम,0,0,2,2
13254,hidden,0,0,2,2
32636,fiz,0,0,2,2
4824,تسمع,0,0,2,2
42953,tendencias,0,0,2,2
42536,नयी,0,0,2,2
4825,परी,0,0,2,2
13784,കഴിഞ്ഞാൽ,0,0,2,2
43432,medalhas,0,0,2,2
13252,descrevem,0,0,2,2
13248,छोड़,0,0,2,2
12012,espaço,0,0,2,2
32889,насколько,0,0,2,2
4826,незамедлительно,0,0,2,2
42951,नौकरी,0,0,2,2
43440,funded,0,0,2,2
3037,condizione,1,2,0,2
2123,campana,2,1,1,2
26209,préciser,0,0,2,2
32868,इतालवी,0,0,2,2
32865,optimisation,0,0,2,2
12104,publicités,0,0,2,2
43001,प्रदर्शन,0,0,2,2
32681,vermijden,0,0,2,2
778,cena,2,1,1,2
13299,welgemanierd,0,0,2,2
42190,inscrevem,0,0,2,2
27040,तारीख,0,0,2,2
32870,crimson,0,0,2,2
43006,ಶೀಘ್ರದಲ್ಲೇ,0,0,2,2
13709,allows,0,0,2,2
12606,admite,0,0,2,2
13294,خطط,0,0,2,2
13292,bryr,0,0,2,2
43372,المدرسة,0,0,2,2
669,studenti,1,2,0,2
13711,participate,0,0,2,2
42187,قلقة,0,0,2,2
13700,помощью,0,0,2,2
42198,помните,0,0,2,2
12089,mannelijk,0,0,2,2
4813,intervjun,0,0,2,2
13310,диска,0,0,2,2
26432,ആദ്യത്തെ,0,0,2,2
33239,changements,0,0,2,2
12584,başlamak,0,0,2,2
26786,ту,0,0,2,2
13689,noms,0,0,2,2
43354,rêves,0,0,2,2
43011,ocorre,0,0,2,2
32863,எடுத்துக்காட்டு,0,0,2,2
43007,classical,0,0,2,2
13302,देखें।,0,0,2,2
13691,पुस्तकों,0,0,2,2
27030,فيمكنك,0,0,2,2
13692,handlar,0,0,2,2
33242,mache,0,0,2,2
12115,skäl,0,0,2,2
12114,etti,0,0,2,2
27032,incidentes,0,0,2,2
32674,बढ़ें।,0,0,2,2
26442,الأمور؟,0,0,2,2
32652,السماح,0,0,2,2
32657,enof,0,0,2,2
32661,سيرة,0,0,2,2
12620,பெயர்,0,0,2,2
670,consultabili,1,2,0,2
42986,അമ്മയെ,0,0,2,2
12623,σελίδων,0,0,2,2
13737,entier,0,0,2,2
4673,पुर्तगाली,0,0,2,2
42172,ποιος,0,0,2,2
13277,endişelendiğini,0,0,2,2
26211,iniciados,0,0,2,2
4761,تدرك,0,0,2,2
2197,divertente,1,2,0,2
26450,portail,0,0,2,2
26766,செய்ததற்கு,0,0,2,2
13275,constants,0,0,2,2
12053,جائع,0,0,2,2
26764,apps,0,0,2,2
26763,ತೀಕ್ಷ್ಣ,0,0,2,2
781,domande,1,2,0,2
42988,turns,0,0,2,2
13714,independently,0,0,2,2
3036,disposizione,1,2,0,2
42186,τόσα,0,0,2,2
13716,sustaining,0,0,2,2
26443,limité,0,0,2,2
12609,लाइफ,0,0,2,2
4763,സുന്ദരനുമാണ്,0,0,2,2
27048,internos,0,0,2,2
27050,omedelbart,0,0,2,2
43382,ചുമതലയും,0,0,2,2
33252,falun,0,0,2,2
42513,tiende,0,0,2,2
43385,autoridade,0,0,2,2
26213,yeniden,0,0,2,2
42177,raisonné,0,0,2,2
42510,interacting,0,0,2,2
32668,bans,0,0,2,2
12075,déterminé,0,0,2,2
33097,പ്രധാനമായും,0,0,2,2
779,ricchezze,1,2,0,2
12687,журналы,0,0,2,2
27107,registran,0,0,2,2
12123,göndermek,0,0,2,2
42939,जादुई,0,0,2,2
32913,dourada,0,0,2,2
13864,सेना,0,0,2,2
32569,yahoo,0,0,2,2
13865,предоставляет,0,0,2,2
26496,ouviu,0,0,2,2
42077,prüfung,0,0,2,2
27178,rédigé,0,0,2,2
26148,ಹೊಂದಿಲ್ಲ,0,0,2,2
11866,развития,0,0,2,2
4604,kräver,0,0,2,2
12741,οποιαδήποτε,0,0,2,2
11862,müssen,0,0,2,2
43554,partage,0,0,2,2
13871,kaufen,0,0,2,2
2919,attuale,1,2,0,2
12743,വാക്കുകളിൽ,0,0,2,2
724,sviluppato,1,2,0,2
43558,மகிழ்ச்சியான,0,0,2,2
33061,börja,0,0,2,2
11869,kibar,0,0,2,2
11870,எப்படிப்,0,0,2,2
42577,january update,0,0,2,2
42086,ഇതിനർത്ഥം,0,0,2,2
42090,«не,0,0,2,2
32905,dumm,0,0,2,2
42913,templates,0,0,2,2
43535,électroniques,0,0,2,2
42909,அபத்தமானது,0,0,2,2
43536,πύλη,0,0,2,2
26489,acto,0,0,2,2
12734,ಗೊತ್ತು,0,0,2,2
11880,будут,0,0,2,2
13861,прошла,0,0,2,2
42084,முரண்பாடான,0,0,2,2
33299,decirme,0,0,2,2
3045,sviluppare,1,2,0,2
27173,sextafeira,0,0,2,2
27174,weise,0,0,2,2
43546,probeer,0,0,2,2
26151,cuatro,0,0,2,2
42080,convection,0,0,2,2
27185,rent,0,0,2,2
32916,gerekiyor,0,0,2,2
43560,¿quieres,0,0,2,2
26702,sat,0,0,2,2
13890,تاريخ,0,0,2,2
27194,жениться,0,0,2,2
2916,geometry,2,1,1,2
803,dovresti,1,2,0,2
26136,reproduce,0,0,2,2
13186,banka,0,0,2,2
42058,kritiken,0,0,2,2
13895,ഇതിൽ,0,0,2,2
11835,gillade,0,0,2,2
32559,undvika,0,0,2,2
11833,evenwichtig,0,0,2,2
26134,बाप,0,0,2,2
26132,τραπεζικό,0,0,2,2
11831,principais,0,0,2,2
13904,स्कूल,0,0,2,2
26130,hoop,0,0,2,2
11830,opérations,0,0,2,2
2915,sostengono,1,2,0,2
26706,düşünebilirsiniz,0,0,2,2
13187,இயங்கும்,0,0,2,2
11852,russie,0,0,2,2
33058,fransızca,0,0,2,2
4602,wij,0,0,2,2
26713,opiniones,0,0,2,2
42895,wortes,0,0,2,2
12754,djupt,0,0,2,2
2918,permettono,1,2,0,2
42894,அறிமுகப்படுத்தப்பட்டது,0,0,2,2
26711,यू,0,0,2,2
26710,celebrated,0,0,2,2
13880,mailing,0,0,2,2
42062,серверы,0,0,2,2
33308,χρησιμοποιώντας,0,0,2,2
13885,narzissenmutter,0,0,2,2
26139,முதல்,0,0,2,2
27191,confondues,0,0,2,2
42063,bestrijden,0,0,2,2
11844,decided,0,0,2,2
32918,entière,0,0,2,2
42889,holde,0,0,2,2
12724,ಮನುಷ್ಯ,0,0,2,2
797,frequenti,1,2,0,2
26157,думаешь,0,0,2,2
42119,mdp,0,0,2,2
11949,pronúncia,0,0,2,2
4754,muntra,0,0,2,2
43485,дайте,0,0,2,2
43487,അനുമതി,0,0,2,2
11943,உணவைப்,0,0,2,2
13809,benzeri,0,0,2,2
11941,anordnas,0,0,2,2
43490,troede,0,0,2,2
33283,diyebilirim,0,0,2,2
12697,मुफ़्त,0,0,2,2
32601,peuxtu,0,0,2,2
26171,machinelearning,0,0,2,2
13223,miedo,0,0,2,2
43497,deviations,0,0,2,2
42114,común,0,0,2,2
11927,enciclopédico,0,0,2,2
12699,forfærdelig,0,0,2,2
42931,رأي,0,0,2,2
42121,esperanto,0,0,2,2
680,avevano,1,2,0,2
792,proposito,1,2,0,2
11973,définie,0,0,2,2
27113,ഉപയോഗിക്കാൻ‌,0,0,2,2
26474,specialiserade,0,0,2,2
11977,objective,0,0,2,2
42552,запас,0,0,2,2
32614,ತಿಳಿಸಿ,0,0,2,2
13801,κλαίνε,0,0,2,2
26478,комунибудь,0,0,2,2
32895,സംഭാഷണത്തിൽ,0,0,2,2
43468,alacağım,0,0,2,2
32605,conscience,0,0,2,2
12692,एंड्रयू,0,0,2,2
43472,laddade,0,0,2,2
27125,verdrinken,0,0,2,2
26480,acted,0,0,2,2
2200,tony,2,1,1,2
4834,insiders,0,0,2,2
33279,intermédiaire,0,0,2,2
791,contiene,1,2,0,2
33287,ಇತ್ತೀಚಿನ,0,0,2,2
42930,lessons,0,0,2,2
13843,balkon,0,0,2,2
26729,impresa,0,0,2,2
12715,rapporte,0,0,2,2
32902,agradeciendo,0,0,2,2
42920,eksempler,0,0,2,2
42567,inappropriées,0,0,2,2
11901,مقدمًا,0,0,2,2
26730,forces,0,0,2,2
11900,atender,0,0,2,2
2202,piccola,1,2,0,2
4748,publicada,0,0,2,2
794,farai,1,2,0,2
13837,bewerkt,0,0,2,2
43527,biografías,0,0,2,2
42094,संरक्षण,0,0,2,2
4608,tekniken,0,0,2,2
11895,magnífico,0,0,2,2
32579,ifadeler,0,0,2,2
13214,stackars,0,0,2,2
11890,değiştirilmesi,0,0,2,2
2924,strategie,1,2,0,2
33293,нарцис,0,0,2,2
12704,affranchir,0,0,2,2
681,simili,1,2,0,2
42928,satt,0,0,2,2
32594,الرجال,0,0,2,2
42104,surrounding,0,0,2,2
12707,reposant,0,0,2,2
2960,aggiuntive,1,2,0,2
42564,magical,0,0,2,2
12708,incompatibles,0,0,2,2
27149,bidra,0,0,2,2
11914,торговой,0,0,2,2
32586,promovido,0,0,2,2
43514,обычных,0,0,2,2
26486,വ്യക്തിയോട്,0,0,2,2
42101,vois,0,0,2,2
42566,yapamayacağınız,0,0,2,2
11909,interrelated,0,0,2,2
26161,doorgaan,0,0,2,2
42099,الذهاب,0,0,2,2
4749,röra,0,0,2,2
12121,अगले,0,0,2,2
43352,अंतर,0,0,2,2
26129,फ़ाइल,0,0,2,2
33142,préoccupation,0,0,2,2
2172,comprensiva,2,1,1,2
26853,höja,0,0,2,2
42327,metabolism,0,0,2,2
26852,ಬಳಸಲು,0,0,2,2
32770,ಅದೃಷ್ಟದ,0,0,2,2
43103,conhecido,0,0,2,2
13424,ذكرت,0,0,2,2
43192,يفعل,0,0,2,2
42410,إخبار,0,0,2,2
12466,интернета,0,0,2,2
12338,ആകാം,0,0,2,2
4775,reconocimiento,0,0,2,2
43097,estadunidense,0,0,2,2
32765,പെട്ടെന്നു,0,0,2,2
12334,verdens,0,0,2,2
32764,registrerade,0,0,2,2
13419,bromeando,0,0,2,2
26847,gênante,0,0,2,2
26309,kökeni,0,0,2,2
12459,sent,0,0,2,2
43106,أكون,0,0,2,2
12457,famosos,0,0,2,2
42333,добавления,0,0,2,2
26321,discrete,0,0,2,2
13518,изначально,0,0,2,2
26901,philosophique,0,0,2,2
26319,दूसरा,0,0,2,2
13429,faits,0,0,2,2
12357,uenig,0,0,2,2
26858,koordinationsarbete,0,0,2,2
42334,muss,0,0,2,2
12356,conocerte,0,0,2,2
26854,воспитанный,0,0,2,2
13428,entró,0,0,2,2
33175,ನೋಡುತ್ತಿದ್ದೇನೆ,0,0,2,2
12355,حذف,0,0,2,2
13426,ναρκίσσου,0,0,2,2
13526,usaron,0,0,2,2
43181,व्यक्त,0,0,2,2
744,ricevere,1,2,0,2
32774,visitados,0,0,2,2
43200,podrían,0,0,2,2
32761,tornandoa,0,0,2,2
32760,constituyen,0,0,2,2
13559,arise,0,0,2,2
42418,niño,0,0,2,2
640,furono,1,2,0,2
32820,النمو,0,0,2,2
12302,banda,0,0,2,2
13409,schreef,0,0,2,2
26304,materialet,0,0,2,2
26931,связанных,0,0,2,2
42304,mobiele,0,0,2,2
42303,grootste,0,0,2,2
12307,प्राथमिक,0,0,2,2
12299,இருக்கிறீர்களா,0,0,2,2
13406,komplicerad,0,0,2,2
42302,gefallen,0,0,2,2
33189,wikislavia,0,0,2,2
2954,mantengono,1,2,0,2
26296,videonun,0,0,2,2
26294,købe,0,0,2,2
43078,आपत्तिजनक,0,0,2,2
43214,reunião,0,0,2,2
26842,participantes,0,0,2,2
12475,kent,0,0,2,2
43089,سميت,0,0,2,2
26922,മൂന്നു,0,0,2,2
656,realtà,1,2,0,2
12323,seguinte,0,0,2,2
43091,kvalitén,0,0,2,2
43207,dom,0,0,2,2
12321,إصدارات,0,0,2,2
12320,crossed,0,0,2,2
2113,esistono,1,2,0,2
26373,ஃப்ளூமொக்ஸ்,0,0,2,2
4794,horrível,0,0,2,2
13546,udseende,0,0,2,2
13548,അടുത്ത്,0,0,2,2
32757,tarea,0,0,2,2
26374,bryde,0,0,2,2
12314,जल्द,0,0,2,2
12313,θέλεις,0,0,2,2
13412,lancement,0,0,2,2
43088,daarvan,0,0,2,2
42404,evlenmek,0,0,2,2
43173,douce,0,0,2,2
26365,augen,0,0,2,2
26878,geduldig,0,0,2,2
26338,английских,0,0,2,2
43139,fed,0,0,2,2
12431,plágio,0,0,2,2
42367,заболоченного,0,0,2,2
32799,споров,0,0,2,2
26337,playstation,0,0,2,2
647,visitati,1,2,0,2
43141,användarna,0,0,2,2
32794,trabajos,0,0,2,2
26339,கணக்குகள்,0,0,2,2
13445,πράξη,0,0,2,2
26358,uanset,0,0,2,2
13481,audelà,0,0,2,2
4779,mágicos,0,0,2,2
32789,contrat,0,0,2,2
4783,diagram,0,0,2,2
12396,verificabilidad,0,0,2,2
12395,ilustraciones,0,0,2,2
12430,άκουγα,0,0,2,2
33166,الادعاء,0,0,2,2
42361,образуют,0,0,2,2
26344,ചെയ്യാം,0,0,2,2
42387,ಇಷ್ಟಪಟ್ಟರೆ,0,0,2,2
26353,preocupações,0,0,2,2
26355,emails,0,0,2,2
26870,remedies,0,0,2,2
33162,broad,0,0,2,2
26356,étudient,0,0,2,2
13461,بيديا,0,0,2,2
13463,aşağıdaki,0,0,2,2
43131,schleppend,0,0,2,2
13446,നിഷ്പ്രയാസം,0,0,2,2
26343,ícone,0,0,2,2
26342,variation,0,0,2,2
42374,trends,0,0,2,2
26873,populære,0,0,2,2
33165,தவறான,0,0,2,2
26874,இளவரசன்,0,0,2,2
42372,زائر,0,0,2,2
43135,санфранциско,0,0,2,2
26359,لمدة,0,0,2,2
13442,reçoit,0,0,2,2
32805,இனிமேல்,0,0,2,2
12373,विशिष्ट,0,0,2,2
13500,സ്വയംചലിത,0,0,2,2
13437,variantes,0,0,2,2
12375,möta,0,0,2,2
13503,finding,0,0,2,2
754,sottoposta,1,2,0,2
42347,الروسية,0,0,2,2
43168,സാഹചര്യം,0,0,2,2
26327,விளக்குகிறது,0,0,2,2
32779,ಬೆರಳುಗಳನ್ನು,0,0,2,2
43117,hacen,0,0,2,2
13509,ampliamente,0,0,2,2
42400,denn,0,0,2,2
26863,சனவரி,0,0,2,2
12371,языка,0,0,2,2
12447,parliament,0,0,2,2
2956,portali,1,2,0,2
33171,ಅಡಿಯಲ್ಲಿ,0,0,2,2
12366,intellectual,0,0,2,2
12378,”allmän,0,0,2,2
33154,prueba,0,0,2,2
4651,gången,0,0,2,2
43157,وجدت,0,0,2,2
43154,следовательно,0,0,2,2
26868,naturaleza,0,0,2,2
12389,वेबसाईटों,0,0,2,2
3019,proviene,2,1,1,2
42358,достижения,0,0,2,2
26331,ലാഭേച്ഛയില്ലാതെ,0,0,2,2
752,doveva,1,2,0,2
26329,ಹೊಂದಿದ್ದೀರಿ,0,0,2,2
43158,corrigir,0,0,2,2
26362,αναπτύσσεται,0,0,2,2
32802,technologies,0,0,2,2
12386,brittisk,0,0,2,2
12439,ಮೂಲ,0,0,2,2
645,indipendentemente,1,2,0,2
42351,acíclico,0,0,2,2
33155,όλων,0,0,2,2
13498,« apprentissage,0,0,2,2
12443,gnulinux,0,0,2,2
33193,andelen,0,0,2,2
13571,лишнюю,0,0,2,2
26791,şaşkına,0,0,2,2
32824,registrarse,0,0,2,2
43306,hiervoor,0,0,2,2
13353,поражена,0,0,2,2
42462,wikiznanie,0,0,2,2
735,premium,1,2,0,2
33123,natifs,0,0,2,2
43042,منفرجة,0,0,2,2
32844,consultés,0,0,2,2
42231,scrubs,0,0,2,2
33120,ಸುಲಭವಾದ,0,0,2,2
43308,ಅದೃಷ್ಟವಂತರು,0,0,2,2
12554,conhece,0,0,2,2
26808,contienen,0,0,2,2
13345,ertrinken,0,0,2,2
42469,arabanın,0,0,2,2
13341,ഒരിക്കലും,0,0,2,2
43314,छवियों,0,0,2,2
13655,сказали,0,0,2,2
42228,அழகான,0,0,2,2
32703,friday,0,0,2,2
26993,artikelhistoriken,0,0,2,2
13648,colour,0,0,2,2
13354,स्वागत,0,0,2,2
43296,теории,0,0,2,2
43291,informática,0,0,2,2
662,altoparlante,1,2,0,2
12199,band,0,0,2,2
32715,maintains,0,0,2,2
42242,произношение,0,0,2,2
3013,tipi,1,2,0,2
4629,корень,0,0,2,2
26983,الفور,0,0,2,2
26986,londres,0,0,2,2
12544,accessible,0,0,2,2
32713,soient,0,0,2,2
3030,enciclopedicamente,2,1,1,2
26988,togs,0,0,2,2
12189,créateur,0,0,2,2
12188,cicéron,0,0,2,2
32842,aggregated,0,0,2,2
4803,chaotic,0,0,2,2
26991,thanking,0,0,2,2
12559,γλυκιά,0,0,2,2
12167,निर्णय,0,0,2,2
27004,elefante,0,0,2,2
42485,supercontinent,0,0,2,2
12142,പ്രകൃതിയുടെ,0,0,2,2
42484,musun,0,0,2,2
12141,заняться,0,0,2,2
42215,ವಾಕ್ಯಗಳನ್ನು,0,0,2,2
4626,proposa,0,0,2,2
2937,comunemente,1,2,0,2
2936,oggetti,1,2,0,2
43342,alegação,0,0,2,2
33111,udgave,0,0,2,2
13672,francophones,0,0,2,2
2935,settimanale,1,2,0,2
32689,evlilikte,0,0,2,2
2191,fossi,1,2,0,2
13316,acéfalo,0,0,2,2
43350,argumentam,0,0,2,2
3009,solito,1,2,0,2
26430,toegang,0,0,2,2
613,prodotto,1,2,0,2
12144,verilir,0,0,2,2
13671,ரொட்டியை,0,0,2,2
43031,prêmios,0,0,2,2
13667,felipe,0,0,2,2
42225,ആയി,0,0,2,2
12161,filtering,0,0,2,2
26803,बढ़ती,0,0,2,2
26802,framstående,0,0,2,2
4665,ρήμα,0,0,2,2
13663,posee,0,0,2,2
12569,scolaires,0,0,2,2
13666,വിട,0,0,2,2
26421,grandiosa,0,0,2,2
12573,تتبع,0,0,2,2
12154,homens,0,0,2,2
26423,opnieuw,0,0,2,2
27012,تصنيف,0,0,2,2
12571,structures,0,0,2,2
3033,motori,1,2,0,2
32693,வீடியோவின்,0,0,2,2
43334,gratuit,0,0,2,2
43336,தொகுக்க,0,0,2,2
43046,evolution,0,0,2,2
42243,wild,0,0,2,2
12202,gennem,0,0,2,2
42274,सेकंड,0,0,2,2
12269,kentinde,0,0,2,2
26279,magisk,0,0,2,2
33138,fer,0,0,2,2
43245,baseado,0,0,2,2
630,liberamente,1,2,0,2
43248,أصبح,0,0,2,2
12260,wikiversity,0,0,2,2
26948,vested,0,0,2,2
13592,serviços,0,0,2,2
12509,ranging,0,0,2,2
42271,spokesman,0,0,2,2
42440,drüben,0,0,2,2
43059,warten,0,0,2,2
42270,croisés,0,0,2,2
2177,rappresenta,1,2,0,2
12256,glöm,0,0,2,2
12523,tænke,0,0,2,2
13599,referat,0,0,2,2
3028,vasta,1,2,0,2
33201,wer,0,0,2,2
43258,hou,0,0,2,2
26384,repareren,0,0,2,2
43229,dække,0,0,2,2
32745,række,0,0,2,2
43231,venha,0,0,2,2
43233,விக்கிப்பீடியாவிலுள்ள,0,0,2,2
26381,färre,0,0,2,2
12501,äter,0,0,2,2
43071,ilgili,0,0,2,2
33141,klik,0,0,2,2
26942,formatação,0,0,2,2
26282,बोमिस,0,0,2,2
13394,ettiğimi,0,0,2,2
26283,سخيف,0,0,2,2
42281,economy,0,0,2,2
42433,warring,0,0,2,2
12278,journals,0,0,2,2
4772,இணைப்புக்கள்,0,0,2,2
43240,побуждает,0,0,2,2
12271,professionals,0,0,2,2
42269,wachten,0,0,2,2
12247,induction,0,0,2,2
13629,destruction,0,0,2,2
26399,llevando,0,0,2,2
42255,σχετικά,0,0,2,2
32839,ಅದಕ್ಕೆ,0,0,2,2
43268,orada,0,0,2,2
33212,funding,0,0,2,2
26397,leitura,0,0,2,2
12534,फिल्म,0,0,2,2
2947,discutere,1,2,0,2
12535,английским,0,0,2,2
13364,χρήση,0,0,2,2
738,álvaro,1,2,0,2
26401,preparado,0,0,2,2
12222,afscheid,0,0,2,2
26817,ಮಾತನಾಡಲು,0,0,2,2
42456,slaat,0,0,2,2
12538,creencia,0,0,2,2
42248,விரல்களைக்,0,0,2,2
4634,wikipediaanvändare,0,0,2,2
13627,свидетельствуют,0,0,2,2
12234,illustre,0,0,2,2
12531,hittar,0,0,2,2
32998,savais,0,0,2,2
4769,brincando,0,0,2,2
42266,demand,0,0,2,2
13604,således,0,0,2,2
13376,faculdade,0,0,2,2
43261,jeito,0,0,2,2
12242,evde,0,0,2,2
26274,στόλλμαν,0,0,2,2
12241,വിശദീകരിച്ചു,0,0,2,2
2108,valutate,1,2,0,2
12239,pr,0,0,2,2
12530,धीरेधीरे,0,0,2,2
13609,συμβαίνουν,0,0,2,2
13374,langzamer,0,0,2,2
33209,απόφαση,0,0,2,2
26268,источникам,0,0,2,2
42258,ruso,0,0,2,2
33133,minorités,0,0,2,2
26959,levels,0,0,2,2
26267,groundwater,0,0,2,2
27203,bron,0,0,2,2
26350,زوار,0,0,2,2
11647,ordning,0,0,2,2
26666,saiu,0,0,2,2
41979,altofalante,0,0,2,2
26078,ले,0,0,2,2
42825,locked,0,0,2,2
3001,nascosti,1,2,0,2
11696,отправлю,0,0,2,2
14009,пишут,0,0,2,2
14010,junge,0,0,2,2
14005,namen,0,0,2,2
2212,farina,2,1,1,2
11693,имени,0,0,2,2
14102,रखती,0,0,2,2
4869,diseñador,0,0,2,2
12957,healthrelated,0,0,2,2
32949,ruby,0,0,2,2
32978,страница,0,0,2,2
13141,ബ്യൂറോക്രാറ്റുകൾ,0,0,2,2
32506,naquela,0,0,2,2
2143,sogni,1,2,0,2
43757,शोधकर्ताओं,0,0,2,2
11567,ഏതാണ്,0,0,2,2
11700,öva,0,0,2,2
26027,middag,0,0,2,2
42675,لشركة,0,0,2,2
11701,الياقوت,0,0,2,2
26026,geweigerd,0,0,2,2
13058,साइटों,0,0,2,2
2977,usate,1,2,0,2
43758,venido,0,0,2,2
27263,accumulated,0,0,2,2
14108,llevamos,0,0,2,2
12851,frankrike,0,0,2,2
13138,análises,0,0,2,2
11570,cuidadosamente,0,0,2,2
33014,deja,0,0,2,2
32950,lectores,0,0,2,2
14024,ആരോ,0,0,2,2
26533,galactica,0,0,2,2
13135,defesa,0,0,2,2
26033,തർക്കങ്ങൾ,0,0,2,2
32975,notícias,0,0,2,2
14022,पुराने,0,0,2,2
14021,dis,0,0,2,2
32498,موسوعات,0,0,2,2
14095,uppfattningar,0,0,2,2
42671,kopen,0,0,2,2
2904,prendere,1,2,0,2
4593,പാഠങ്ങൾ,0,0,2,2
27277,فهذه,0,0,2,2
33383,когдалибо,0,0,2,2
11681,historian,0,0,2,2
11572,princesa,0,0,2,2
11682,أحد,0,0,2,2
2080,ovviamente,1,2,0,2
12867,expor,0,0,2,2
27271,chamber,0,0,2,2
42817,map,0,0,2,2
13061,kullanıcıların,0,0,2,2
27270,معي,0,0,2,2
42819,портал,0,0,2,2
12861,lágrimas,0,0,2,2
12955,journalist,0,0,2,2
33036,καταλάβατε,0,0,2,2
41975,пройти,0,0,2,2
27266,sentada,0,0,2,2
43754,aprenderá,0,0,2,2
702,altrettante,1,2,0,2
13056,ടീച്ചർ,0,0,2,2
41918,uppnås,0,0,2,2
42613,கணித,0,0,2,2
12832,ಮದುವೆಯಾಗಲು,0,0,2,2
11721,கீழ்,0,0,2,2
43653,redacteuren,0,0,2,2
4727,citados,0,0,2,2
12835,നിരവധി,0,0,2,2
26608,artificiales,0,0,2,2
33338,wikitext,0,0,2,2
41981,engang,0,0,2,2
33388,riken,0,0,2,2
11719,edges,0,0,2,2
13985,celular,0,0,2,2
14118,sender,0,0,2,2
11551,ikväll,0,0,2,2
3065,adattivo,1,2,0,2
43650,παρακολουθείτε,0,0,2,2
27249,gehe,0,0,2,2
26522,ingilizce,0,0,2,2
13981,хотел,0,0,2,2
41997,энциклопедической,0,0,2,2
14124,estimer,0,0,2,2
11730,puisque,0,0,2,2
11731,biçiminde,0,0,2,2
11735,الأمريكيون,0,0,2,2
12830,optimal,0,0,2,2
33334,velopdragen,0,0,2,2
13975,richesses,0,0,2,2
13974,geografia,0,0,2,2
32525,misión,0,0,2,2
12829,التعبير,0,0,2,2
13972,l’étude,0,0,2,2
42002,especialistas,0,0,2,2
27337,ಪ್ರಯತ್ನಿಸಿ,0,0,2,2
42736,despedir,0,0,2,2
13048,tillbaka,0,0,2,2
26524,desarrollado,0,0,2,2
11564,svms,0,0,2,2
11707,patients,0,0,2,2
14003,wildlife,0,0,2,2
42619,shifted,0,0,2,2
42831,verschrikkelijk,0,0,2,2
26670,സ്യൂവ്,0,0,2,2
32510,samareño,0,0,2,2
3056,portland,1,2,0,2
42617,απόψε,0,0,2,2
4867,التالي,0,0,2,2
41903,procédures,0,0,2,2
32459,star,0,0,2,2
26672,bureaucrats,0,0,2,2
4726,переход,0,0,2,2
13054,ಮನೆಯಲ್ಲಿ,0,0,2,2
26021,recharge,0,0,2,2
42836,possam,0,0,2,2
13996,manhã,0,0,2,2
43656,सेक्शन,0,0,2,2
26023,denominativo,0,0,2,2
41988,ഒര്മയുല്ലപ്പം,0,0,2,2
2992,universale,1,2,0,2
32944,ಹೆಸರಿನ,0,0,2,2
33339,état,0,0,2,2
26022,அதனால்,0,0,2,2
42738,referenced,0,0,2,2
13049,வணிக,0,0,2,2
3055,programmi,1,2,0,2
26089,observe,0,0,2,2
11553,sola,0,0,2,2
43746,വർഗ്ഗ,0,0,2,2
11669,rötter,0,0,2,2
11547,المعرضة,0,0,2,2
32484,выглядеть,0,0,2,2
43733,equivocado,0,0,2,2
27297,réel,0,0,2,2
43732,conexión,0,0,2,2
32961,répertoire,0,0,2,2
4585,presentes,0,0,2,2
11634,компанией,0,0,2,2
4691,skärmar,0,0,2,2
41948,ഉള്ളടക്കവും,0,0,2,2
12892,resume,0,0,2,2
11602,exactamente,0,0,2,2
14077,promotion,0,0,2,2
26550,prevalent,0,0,2,2
11630,vakgebieden,0,0,2,2
41932,واستمر,0,0,2,2
14057,ccbysalicentie,0,0,2,2
2999,fanno,1,2,0,2
2137,attenzione,1,2,0,2
567,assoluto,1,2,0,2
12888,tamaño,0,0,2,2
13104,сервер,0,0,2,2
11597,विध्वंसक,0,0,2,2
12917,vandalismprone,0,0,2,2
41931,الماضي,0,0,2,2
41942,astúrias,0,0,2,2
33029,çalışın,0,0,2,2
719,elogiata,1,2,0,2
14052,скоро,0,0,2,2
12918,empréstimo,0,0,2,2
4688,descriptions,0,0,2,2
557,chiamare,1,2,0,2
568,altamente,1,2,0,2
26646,rapidez,0,0,2,2
4723,tages,0,0,2,2
42653,poised,0,0,2,2
43723,медленно,0,0,2,2
33370,th,0,0,2,2
32479,naissance,0,0,2,2
11611,ലാറി,0,0,2,2
11608,conservation,0,0,2,2
14070,இருந்ததால்,0,0,2,2
558,tremendamente,2,1,1,2
2987,servizi,1,2,0,2
14069,parecer,0,0,2,2
26553,വൈകുന്നേരം,0,0,2,2
4693,उसका,0,0,2,2
561,lui»,1,2,0,2
819,minimizzare,1,2,0,2
2906,spero,1,2,0,2
14065,προχωρήστε,0,0,2,2
27307,fire,0,0,2,2
27301,आलोचक,0,0,2,2
42790,كتاب,0,0,2,2
26643,​​je,0,0,2,2
33368,assumptions,0,0,2,2
14061,പോകുന്നത്,0,0,2,2
12901,παιχνίδι,0,0,2,2
12910,approfondir,0,0,2,2
12899,versioner,0,0,2,2
11605,giver,0,0,2,2
43718,الصور,0,0,2,2
43730,rijkdom,0,0,2,2
4722,skruede,0,0,2,2
14073,வேண்டிய,0,0,2,2
32483,pourrais,0,0,2,2
13085,तौर,0,0,2,2
32958,luimême,0,0,2,2
32487,spiser,0,0,2,2
42757,arrangement,0,0,2,2
11588,النصيحة,0,0,2,2
13126,குறைவாக,0,0,2,2
11587,caballero,0,0,2,2
13125,verbessern,0,0,2,2
26066,تلقت,0,0,2,2
700,membri,1,2,0,2
12878,voulait,0,0,2,2
41964,reizen,0,0,2,2
42779,intéressé,0,0,2,2
33017,lucratif,0,0,2,2
26037,الانتظار,0,0,2,2
26633,मांग,0,0,2,2
2983,profondo,1,2,0,2
13073,tidskrifter,0,0,2,2
14086,جدا,0,0,2,2
11661,doctors,0,0,2,2
43692,береги,0,0,2,2
33034,சாரும்,0,0,2,2
12876,ಮಾಡುವುದನ್ನು,0,0,2,2
572,procedura,1,2,0,2
27283,எப்போது,0,0,2,2
2139,andarono,1,2,0,2
13128,buch,0,0,2,2
2216,check,2,1,1,2
26561,μέλισσα,0,0,2,2
27319,verrast,0,0,2,2
13068,रह,0,0,2,2
42809,अदालत,0,0,2,2
2991,white,2,1,1,2
12941,interconnected,0,0,2,2
27321,хорош,0,0,2,2
32953,xbox,0,0,2,2
43741,olmaya,0,0,2,2
33032,asia,0,0,2,2
3061,servire,1,2,0,2
13078,കൂടിക്കാഴ്‌ചയുണ്ട്,0,0,2,2
41949,niye,0,0,2,2
41929,lendemain,0,0,2,2
42640,назвать,0,0,2,2
42802,وتم,0,0,2,2
4874,ಪುನರಾವರ್ತಿಸಬಹುದೇ,0,0,2,2
42778,arias,0,0,2,2
4721,obtienes,0,0,2,2
26541,нем,0,0,2,2
14046,fundamentales,0,0,2,2
11645,वैसा,0,0,2,2
4882,التعليق,0,0,2,2
11646,проекту,0,0,2,2
13113,محظوظ,0,0,2,2
4698,ശരാശരി,0,0,2,2
42777,എങ്കിലും,0,0,2,2
13119,académica,0,0,2,2
26557,لذلك،,0,0,2,2
815,tecnologia,2,1,1,2
13074,сервера,0,0,2,2
27292,predicts,0,0,2,2
26056,أعلى,0,0,2,2
26538,الخبراء,0,0,2,2
32969,ಯೋಚಿಸುವುದಿಲ್ಲ,0,0,2,2
41925,increases,0,0,2,2
11590,beteende,0,0,2,2
2218,diamo,1,2,0,2
42804,comprises,0,0,2,2
41957,síntomas,0,0,2,2
42774,begonnen,0,0,2,2
11652,tecnológicos,0,0,2,2
574,giornalistiche,1,2,0,2
11558,encyclopédie ,0,0,2,2
12905,ಕೇಳಿದರೆ,0,0,2,2
14134,oké,0,0,2,2
43594,bekannt,0,0,2,2
4576,format,0,0,2,2
27351,метавики,0,0,2,2
32546,കാര്യനിർവ്വാഹകർ,0,0,2,2
43781,totalt,0,0,2,2
13168,snigel,0,0,2,2
42861,सोचा,0,0,2,2
14138,τεστ,0,0,2,2
11527,அழகாகவும்,0,0,2,2
43618,قالوا,0,0,2,2
43597,مجرد,0,0,2,2
2993,raccogliere,1,2,0,2
42691,patrones,0,0,2,2
43617,kidding,0,0,2,2
12796,protegidos,0,0,2,2
32545,εξαιτίας,0,0,2,2
41879,ونظر,0,0,2,2
11774,dicionário,0,0,2,2
26515,picked,0,0,2,2
26600,числа,0,0,2,2
2151,meccanismo,1,2,0,2
12995,administrada,0,0,2,2
43788,удалить,0,0,2,2
42872,confiture,0,0,2,2
4739,sujette,0,0,2,2
43612,arreglo,0,0,2,2
13011,الأكادميين,0,0,2,2
12803,балл,0,0,2,2
42699,utilizan,0,0,2,2
13955,indicar,0,0,2,2
11807,vieram,0,0,2,2
11535,принятия,0,0,2,2
11806,intresserad,0,0,2,2
26590,المرور,0,0,2,2
12990,reprennent,0,0,2,2
43625,التعريف,0,0,2,2
27346,allebei,0,0,2,2
11763,அங்கீகரிக்கப்பட்ட,0,0,2,2
26695,विस्तार,0,0,2,2
33051,¿estás,0,0,2,2
26101,ചേർക്കുന്നു,0,0,2,2
27353,അമ്മയോട്,0,0,2,2
826,competenza,1,2,0,2
42605,robe,0,0,2,2
3051,alberi,1,2,0,2
13025,لاروس,0,0,2,2
11531,allerlei,0,0,2,2
33328,siehst,0,0,2,2
32535,trække,0,0,2,2
42604,millet,0,0,2,2
721,condotta,1,2,0,2
14139,lowdimensional,0,0,2,2
4893,sabah,0,0,2,2
42029,övervaka,0,0,2,2
26597,الأنماط,0,0,2,2
12792,देखभाल,0,0,2,2
26594,direct,0,0,2,2
43599,சொற்களஞ்சியத்தை,0,0,2,2
42031,कोष,0,0,2,2
13001,сбудется,0,0,2,2
14144,avisos,0,0,2,2
715,uomini,1,2,0,2
27220,lower,0,0,2,2
13929,меньше,0,0,2,2
2084,sicurezza,1,2,0,2
43600,സമവാക്യത്തിന്റെ,0,0,2,2
12791,perfekt,0,0,2,2
26010,للطلاب,0,0,2,2
578,frances,2,1,1,2
547,partecipazione,1,2,0,2
13926,dining,0,0,2,2
3068,crea,2,1,1,2
11787,чтонибудь,0,0,2,2
42715,agradeço,0,0,2,2
42598,amostra,0,0,2,2
32929,dışında,0,0,2,2
27218,presents,0,0,2,2
13922,reasoning,0,0,2,2
41884,desta,0,0,2,2
42868,abraham,0,0,2,2
42028,സിൽവർ,0,0,2,2
14150,ويكيميديا،,0,0,2,2
43611,തങ്ങൾ,0,0,2,2
26110,publiée,0,0,2,2
548,inferiore,1,2,0,2
13177,അദ്ദേഹം,0,0,2,2
12794,பயன்படுத்தப்படுகிறது,0,0,2,2
11523,σχολείο,0,0,2,2
42867,पूर्वाग्रह,0,0,2,2
33324,виделись,0,0,2,2
14140,i̇letişim,0,0,2,2
11516,இருந்தீர்கள்,0,0,2,2
32993,suédois,0,0,2,2
26598,തീയതി,0,0,2,2
42022,deposited,0,0,2,2
26592,trubbig,0,0,2,2
11780,volumétrie,0,0,2,2
14142,langsamer,0,0,2,2
13171,λεπτά,0,0,2,2
13172,capaces,0,0,2,2
12827,gusta,0,0,2,2
13173,rodando,0,0,2,2
11798,gitmeniz,0,0,2,2
11797,التحكيم,0,0,2,2
32549,presentó,0,0,2,2
26578,νοιάζει,0,0,2,2
32997,मतभेद,0,0,2,2
26005,термин,0,0,2,2
26588,lutter,0,0,2,2
11540,prises,0,0,2,2
12813,praised,0,0,2,2
825,richiede,1,2,0,2
13968,أخذت,0,0,2,2
3066,centrale,2,1,1,2
43587,spot,0,0,2,2
13910,contrato,0,0,2,2
13159,publiceringen,0,0,2,2
42008,ute,0,0,2,2
552,descrivono,1,2,0,2
11816,town,0,0,2,2
42727,áfrica,0,0,2,2
42848,générer,0,0,2,2
11499,ತಂಪಾದ,0,0,2,2
11750,அவருடன்,0,0,2,2
42707,appeler,0,0,2,2
43630,brillants,0,0,2,2
11539,poussé,0,0,2,2
43803,ಖಚಿತಪಡಿಸಿಕೊಳ್ಳಿ,0,0,2,2
32939,fancy,0,0,2,2
11544,ofertas,0,0,2,2
13161,ನಮ್ಮ,0,0,2,2
13183,विश्वविद्यालयों,0,0,2,2
32999,skapas,0,0,2,2
12816,duyduğunuzda,0,0,2,2
4890,prepared,0,0,2,2
13965,constitue,0,0,2,2
11811,gerektiğini,0,0,2,2
27234,describes,0,0,2,2
43589,vise,0,0,2,2
33391,الأيمن,0,0,2,2
26606,arme,0,0,2,2
26002,красота,0,0,2,2
26678,génère,0,0,2,2
14158,настоящее,0,0,2,2
42685,deverá,0,0,2,2
43628,hundred,0,0,2,2
13966,krijg,0,0,2,2
41890,तुंरत,0,0,2,2
27206,பரவாயில்லை,0,0,2,2
11819,ಶಬ್ದಕೋಶವನ್ನು,0,0,2,2
42854,mudou,0,0,2,2
42048,تمزح,0,0,2,2
42852,classify,0,0,2,2
13958,பயன்படுத்தி,0,0,2,2
33008,கட்டுரைகளில்,0,0,2,2
12826,procedimientos,0,0,2,2
43798,случая,0,0,2,2
11506,भूल,0,0,2,2
27232,custommade,0,0,2,2
13039,incidente,0,0,2,2
27209,പ്രശ്നം,0,0,2,2
11742,predominantemente,0,0,2,2
14132,उम्मीदवार,0,0,2,2
32934,desconcertada,0,0,2,2
12989,bioinformatics,0,0,2,2
13970,puisse,0,0,2,2
12980,diretamente,0,0,2,2
32441,opdrachten,0,0,2,2
2209,iniziato,1,2,0,2
42609,accessibles,0,0,2,2
42003,ಡಿಗ್ರಿಗಳಿಗಿಂತ,0,0,2,2
13040,lindo,0,0,2,2
30946,வழங்கி,0,0,1,1
30966,« réseau,0,0,1,1
35650,بدء,0,0,1,1
30895,ತಪ್ಪಿಸುವುದು,0,0,1,1
35714,beland,0,0,1,1
33125,abdecken,0,0,1,1
2422,giunsero,1,1,0,1
35425,விட்டு,0,0,1,1
35652,المتباينة,0,0,1,1
30896,enhance,0,0,1,1
33664,accroître,0,0,1,1
31243,कर्मचारियों,0,0,1,1
31208,symbol,0,0,1,1
33135,φρικιαστικά,0,0,1,1
35429,cinéma,0,0,1,1
35388,φτωχοί,0,0,1,1
31245,കണ്ടെത്താം,0,0,1,1
30888,حوادث,0,0,1,1
30947,capacidade,0,0,1,1
33159,بشأنه,0,0,1,1
35713,ಚತುರನಾಗಿದ್ದನು,0,0,1,1
2141,essendo,1,1,0,1
33646,сложную,0,0,1,1
30948,linguistic,0,0,1,1
35649,اختبار,0,0,1,1
35648,«человеком,0,0,1,1
35423,soyons,0,0,1,1
33645,compartilhados,0,0,1,1
35647,волнуйся,0,0,1,1
30897,—o,0,0,1,1
33003,adhere,0,0,1,1
30967,الحال؟,0,0,1,1
35428,согласиться,0,0,1,1
30891,പ്രശസ്തി,0,0,1,1
35632,ссылкой,0,0,1,1
33157,уроните,0,0,1,1
33128,मरम्मत,0,0,1,1
30890,хранения,0,0,1,1
30953,legt,0,0,1,1
35384,مهتمًا,0,0,1,1
35636,ಜೀವಂತವಾಗಿದ್ದ,0,0,1,1
35642,ಏಕೈಕ,0,0,1,1
33001,daterad,0,0,1,1
35387,ortasındayken,0,0,1,1
31203,kämpade,0,0,1,1
2421,moderatori,1,1,0,1
31201,univers »,0,0,1,1
30945,വിലയിരുത്തി,0,0,1,1
35641,പ്ലേറ്റിൽ,0,0,1,1
35637,mutluyum,0,0,1,1
30963,супе,0,0,1,1
33129,pludselig,0,0,1,1
30960,«викимедиару»,0,0,1,1
31202,grippe,0,0,1,1
33131,énfasis,0,0,1,1
30959,руководителя,0,0,1,1
30956,сосуществовали,0,0,1,1
35385,öğrencilerin,0,0,1,1
33760,fırtınalı,0,0,1,1
35386,இறைச்சி,0,0,1,1
33761,красоты,0,0,1,1
30958,ninetenths,0,0,1,1
33000,तभी,0,0,1,1
35639,aware,0,0,1,1
33127,london,0,0,1,1
35635,supin,0,0,1,1
33018,सवार्त्ज़,0,0,1,1
35709,пятым,0,0,1,1
30950,exclusividade,0,0,1,1
33666,чаще,0,0,1,1
1725,omogenei,1,1,0,1
35707,objectivity,0,0,1,1
33762,फीचर्ड,0,0,1,1
30894,مطعم,0,0,1,1
30893,soruyorsa,0,0,1,1
33130,sunumlar,0,0,1,1
35427,ഞങ്ങളോട്,0,0,1,1
35708,splits,0,0,1,1
30965,teams,0,0,1,1
35712,angives,0,0,1,1
35634,suspected,0,0,1,1
33758,هيا,0,0,1,1
2419,acconsente,1,1,0,1
35645,correta,0,0,1,1
33759,ιανουαρίου,0,0,1,1
33132,sıkıcı,0,0,1,1
30951,insanlar,0,0,1,1
33126,ambicioso,0,0,1,1
35383,отвергла,0,0,1,1
35643,atmen,0,0,1,1
33019,categorieën,0,0,1,1
35711,kritiek,0,0,1,1
35710,कोर्ट,0,0,1,1
33020,liknande,0,0,1,1
30952,любимое,0,0,1,1
33780,യോജിക്കാനാവുന്ന,0,0,1,1
31242,obtenida,0,0,1,1
33010,rubies,0,0,1,1
35705,செய்துகொண்டிருந்தபோது,0,0,1,1
35395,मामलों,0,0,1,1
33651,incentivos,0,0,1,1
33146,mimesis,0,0,1,1
33152,reviewer,0,0,1,1
30923,политике,0,0,1,1
30907,ترتبط,0,0,1,1
31227,éditorial,0,0,1,1
35405,séparée,0,0,1,1
2431,esistenti,1,1,0,1
35690,deltar,0,0,1,1
30922,посещений,0,0,1,1
35689,ünlü,0,0,1,1
35672,contracción,0,0,1,1
35404,ചിന്തിക്കട്ടെ,0,0,1,1
30968,வந்தாள்,0,0,1,1
30921,مليوني,0,0,1,1
30910,السبب،,0,0,1,1
33013,sonsuza,0,0,1,1
31226,farms,0,0,1,1
35671,blijken,0,0,1,1
30911,الحلوة,0,0,1,1
33006,maddelerdir,0,0,1,1
2426,mensili,1,1,0,1
35393,பொருத்தவரை,0,0,1,1
33005,læring,0,0,1,1
30926,மனரீதியாகக்,0,0,1,1
33153,basıma,0,0,1,1
33774,αγαπημένη,0,0,1,1
33145,except,0,0,1,1
35693,prédéterminées,0,0,1,1
31223,alphazero,0,0,1,1
33773,noruego,0,0,1,1
33772,natt,0,0,1,1
31224,حق,0,0,1,1
35669,ഇപ്പോൾ,0,0,1,1
35670,influenciado,0,0,1,1
30906,klasik,0,0,1,1
30924,ആഴ്ചകളോ,0,0,1,1
35691,röd,0,0,1,1
35673,بالخوف,0,0,1,1
35396,ämne,0,0,1,1
33136,funktionieren,0,0,1,1
33007,πάνε,0,0,1,1
30915,தரவரிசையில்,0,0,1,1
30918,editores»,0,0,1,1
33149,spekulerede,0,0,1,1
35681,hurricanes,0,0,1,1
33655,lyckas,0,0,1,1
35683,ko •,0,0,1,1
31230,έρχεστε,0,0,1,1
35684,ಕೆಟ್ಟದು,0,0,1,1
30917,википедистов,0,0,1,1
35401,¿dónde,0,0,1,1
35400,سيتم,0,0,1,1
31231,conquistado,0,0,1,1
33151,överraskat,0,0,1,1
2140,coinvolti,1,1,0,1
2427,cullare,1,1,0,1
35686,περιβάλλουν,0,0,1,1
35399,allvarliga,0,0,1,1
33654,расстроены,0,0,1,1
30919,உற்சாகமாக,0,0,1,1
35688,любому,0,0,1,1
30914,заботиться,0,0,1,1
35674,ಹುಚ್ಚನಂತೆ,0,0,1,1
35402,proposant,0,0,1,1
31228,العربية,0,0,1,1
30912,صديقان,0,0,1,1
35397,ιστό,0,0,1,1
33012,werkwoord,0,0,1,1
33657,réciproque,0,0,1,1
35675,datanamnrymd,0,0,1,1
33148,tachonado,0,0,1,1
35676,korsade,0,0,1,1
31234,அவளைப்,0,0,1,1
35677,universitet,0,0,1,1
2024,mantenga,1,1,0,1
35687,diagrams,0,0,1,1
35679,frontières,0,0,1,1
31233,பார்த்தால்,0,0,1,1
30920,excellent,0,0,1,1
30928,കണക്കാക്കുന്നത്,0,0,1,1
33658,المجالات,0,0,1,1
33144,contacto,0,0,1,1
35703,небесам»,0,0,1,1
30940,richer,0,0,1,1
30939,ಒಬ್ಬ,0,0,1,1
1723,piemontese,1,1,0,1
35702,implicitamente,0,0,1,1
35701,exception,0,0,1,1
35658,habermas,0,0,1,1
2433,avrebbe,1,1,0,1
35700,πολιτική,0,0,1,1
33140,παντρεμένοι,0,0,1,1
33765,cierta,0,0,1,1
35699,الروابط,0,0,1,1
30938,mobiles,0,0,1,1
2377,aggiornate,1,1,0,1
35416,accusation,0,0,1,1
35415,विकिपुस्तक,0,0,1,1
30900,uiteindelijk,0,0,1,1
31239,تطبيق,0,0,1,1
31240,αυτής,0,0,1,1
30941,जरूरतों,0,0,1,1
31235,ಘಟನೆಗಳು,0,0,1,1
33661,exhibir,0,0,1,1
31209,demografie,0,0,1,1
2424,famose,1,1,0,1
31210,demenin,0,0,1,1
33156,brandt,0,0,1,1
31211,primarias,0,0,1,1
31241,मेटाविकी,0,0,1,1
33647,aménageurs,0,0,1,1
31212,desencorajam,0,0,1,1
33764,güzelce,0,0,1,1
35704,എന്നതിനർത്ഥം,0,0,1,1
35654,العالمية,0,0,1,1
31214,konuklar,0,0,1,1
33137,litteratur,0,0,1,1
31215,അതിർത്തി,0,0,1,1
33662,редактор,0,0,1,1
2025,letargiche,1,1,0,1
33779,efectos,0,0,1,1
30937,folder,0,0,1,1
1720,ricco,1,1,0,1
30901,brugt,0,0,1,1
35660,இருந்தோம்,0,0,1,1
31236,synke,0,0,1,1
35408,patatas,0,0,1,1
35665,يصدق,0,0,1,1
35696,rápida,0,0,1,1
1721,mancare,1,1,0,1
30931,eliminando,0,0,1,1
1753,collabora,1,1,0,1
35392,επαναλάβεις,0,0,1,1
30930,типа,0,0,1,1
30929,geest,0,0,1,1
33143,belonging,0,0,1,1
31222,டாலர்களை,0,0,1,1
35667,फाउन्डिंग,0,0,1,1
33766,tome,0,0,1,1
33650,zögernd,0,0,1,1
30904,பொதுவில்,0,0,1,1
30905,executiva,0,0,1,1
30932,confiance,0,0,1,1
35409,νιώθω,0,0,1,1
33004,ഘട്ടമാണിത്,0,0,1,1
35411,motsvarade,0,0,1,1
35661,يتلاعب,0,0,1,1
31218,λατινικές,0,0,1,1
35697,hatam,0,0,1,1
35413,κάστρο,0,0,1,1
30935,غدا,0,0,1,1
33659,verängstigt,0,0,1,1
35412,humannature,0,0,1,1
30934,вкратце,0,0,1,1
31221,åldrar,0,0,1,1
35663,risitas,0,0,1,1
35664,secondes,0,0,1,1
35410,idéologies,0,0,1,1
33015,meşgulüm,0,0,1,1
33777,cortos,0,0,1,1
35390,fate,0,0,1,1
33649,الكتاب,0,0,1,1
33778,nuit,0,0,1,1
33054,rubi,0,0,1,1
30969,أتحدث,0,0,1,1
33709,эпично,0,0,1,1
31139,பதவி,0,0,1,1
31065,പട്ടിണി,0,0,1,1
35484,volontaire,0,0,1,1
35547,médiatisées,0,0,1,1
31064,concentrerait,0,0,1,1
31063,النيويورك,0,0,1,1
35483,لمقطع,0,0,1,1
31062,pragmatic,0,0,1,1
33710,лайк,0,0,1,1
31140,yiyeceğe,0,0,1,1
33071,koffie,0,0,1,1
33072,ಸ್ನೇಹಿತರಿಗೆ,0,0,1,1
33046,tranen,0,0,1,1
35550,exercent,0,0,1,1
33073,കേൾക്കുന്നില്ല,0,0,1,1
31141,недостоверность,0,0,1,1
31142,публикуется,0,0,1,1
31143,apavorante,0,0,1,1
31145,"
लिथुआनियाई",0,0,1,1
31061,görüşmek,0,0,1,1
31060,uppsala,0,0,1,1
31059,arrays,0,0,1,1
31058,cilalı,0,0,1,1
35551,ಸುಂದರವಾಗಿದ್ದೀರಿ,0,0,1,1
31067,разговорная,0,0,1,1
35546,சரியில்லை,0,0,1,1
35485,deportes,0,0,1,1
35545,agreeable,0,0,1,1
35538,ಕರೆಯಲು,0,0,1,1
2131,impiego,1,1,0,1
35539,bristen,0,0,1,1
31129,instructs,0,0,1,1
31130,விக்கித்திட்டம்,0,0,1,1
31072,ترجمة,0,0,1,1
31131,realizados,0,0,1,1
31132,конкурсе,0,0,1,1
31133,australie,0,0,1,1
31134,അമർത്തി,0,0,1,1
31135,interestingness,0,0,1,1
31071,janis,0,0,1,1
31070,крайних,0,0,1,1
35541,tracking,0,0,1,1
2387,citino,1,1,0,1
31137,desearle,0,0,1,1
35486,описанные,0,0,1,1
35542,certos,0,0,1,1
33712,മൂന്നും,0,0,1,1
35543,éclairé,0,0,1,1
31138,مفتوحاً,0,0,1,1
31068,väljs,0,0,1,1
35544,verdrietig,0,0,1,1
33047,tillförlitlig,0,0,1,1
1734,apportare,1,1,0,1
33070,ക്ഷമയോടെ,0,0,1,1
33740,evolvement,0,0,1,1
33082,ಪ್ರವೇಶಿಸಿದರು,0,0,1,1
35563,fréquentés,0,0,1,1
31152,कक्ष,0,0,1,1
31153,högsta,0,0,1,1
35475,മാനസികമായി,0,0,1,1
35564,cero,0,0,1,1
31046,köyde,0,0,1,1
31045,सके।,0,0,1,1
33702,étymologique,0,0,1,1
1730,chiusi,1,1,0,1
35567,أنا؟,0,0,1,1
33701,ônibus,0,0,1,1
33045,glimlachen,0,0,1,1
35474,presidential,0,0,1,1
35473,fahrt,0,0,1,1
31044,boğulabilir,0,0,1,1
31155,частичная,0,0,1,1
33699,عنك؟,0,0,1,1
35472,especificando,0,0,1,1
31156,meşguldün,0,0,1,1
2016,modificata,1,1,0,1
35568,naturally,0,0,1,1
2134,costituirsi,1,1,0,1
35471,impreso,0,0,1,1
35562,operação,0,0,1,1
31150,trägen,0,0,1,1
33739,заинтересованы,0,0,1,1
35560,കാശ്മീർ,0,0,1,1
1740,rispettivo,1,1,0,1
35553,പ്രത്യേകതയാണ്,0,0,1,1
31057,başlatabilirler,0,0,1,1
33708,πούλησες,0,0,1,1
33074,മടിക്കുന്നു,0,0,1,1
33044,ejecutarían,0,0,1,1
33707,daardoor,0,0,1,1
2402,improvvisamente,1,1,0,1
2127,operazioni,1,1,0,1
31053,लड़का,0,0,1,1
31052,uiterlijk,0,0,1,1
33076,norwegian,0,0,1,1
35555,фантастические,0,0,1,1
35480,uppgifterna,0,0,1,1
31051,يخبرني,0,0,1,1
35479,ஒழுங்கமைக்கப்பட்டிருக்கும்,0,0,1,1
33078,அடித்தீர்கள்,0,0,1,1
33043,baktığında,0,0,1,1
35558,atrapado,0,0,1,1
33079,mahvettim,0,0,1,1
31050,വിക്കിപീഡിയർക്കായുള്ള,0,0,1,1
33703,verkozen,0,0,1,1
31149,batalha,0,0,1,1
31126,travelling,0,0,1,1
33069,upphovsrättsdirektivet,0,0,1,1
30970,подкасты,0,0,1,1
35522,weggaf,0,0,1,1
33052,ಪ್ರಯತ್ನಿಸುತ್ತಿದೆ,0,0,1,1
31100,möjlig,0,0,1,1
35517,കൃത്രിമബുദ്ധിയുടെ,0,0,1,1
31099,جئت,0,0,1,1
2129,annegamento,1,1,0,1
2390,sysop,1,1,0,1
2388,approssimazione,1,1,0,1
35502,மீளமைக்கவோ,0,0,1,1
31098,வாரங்கள்,0,0,1,1
33057,piedade,0,0,1,1
35521,niche,0,0,1,1
33730,diskussionen,0,0,1,1
31121,testte,0,0,1,1
35501,atuais,0,0,1,1
31097,മെല്ലെയായിരുന്നു,0,0,1,1
33059,खो,0,0,1,1
33731,العكس,0,0,1,1
35523,operational,0,0,1,1
33060,قصري,0,0,1,1
31094,ഹിക്കുന്നതുപോലെ,0,0,1,1
31093,wikipediaförfattare,0,0,1,1
33050,शाब्दिक,0,0,1,1
33726,النخبوية,0,0,1,1
33732,ஆய்வொன்று,0,0,1,1
31101,lagrar,0,0,1,1
35505,ആവശ്യമില്ലെങ്കിൽ,0,0,1,1
31102,varier,0,0,1,1
31103,adressée,0,0,1,1
35510,"
नाहुआतल",0,0,1,1
31117,അർത്ഥങ്ങൾ,0,0,1,1
31116,philosophical,0,0,1,1
31114,attracting,0,0,1,1
35508,റഫർ,0,0,1,1
33728,ഉണ്ടാവില്ലെന്നർത്ഥം,0,0,1,1
31112,drømte,0,0,1,1
35511,возможную,0,0,1,1
2130,errate,1,1,0,1
1736,naturali,1,1,0,1
35513,genèse,0,0,1,1
31111,prestarme,0,0,1,1
35514,golpes,0,0,1,1
2392,proporre,1,1,0,1
31109,obscurantisme,0,0,1,1
35507,искусствоведческой,0,0,1,1
35506,preferiría,0,0,1,1
31108,marginaux,0,0,1,1
2393,attraversato,1,1,0,1
33053,ಬಗ್ಗೆಯೂ,0,0,1,1
35515,groß,0,0,1,1
31106,ನಾರ್ಸಿಸಿಯ,0,0,1,1
31104,andas,0,0,1,1
33725,—tal,0,0,1,1
31091,nonfree,0,0,1,1
35537,الإلكترونية,0,0,1,1
33067,ಗುದ್ದಾಟ,0,0,1,1
35532,mapa,0,0,1,1
31080,ಮೂವರು,0,0,1,1
33065,медицины,0,0,1,1
33720,долгое,0,0,1,1
33719,собственность,0,0,1,1
35494,şerefe,0,0,1,1
33066,جرب,0,0,1,1
31079,المحددة,0,0,1,1
35493,iyiydim,0,0,1,1
33717,réparées,0,0,1,1
35533,тексты,0,0,1,1
2128,smeraldi,1,1,0,1
33724,olanların,0,0,1,1
31078,تشابك,0,0,1,1
35534,ನಿಧಾನವಾಗಿರುತ್ತದೆ,0,0,1,1
33715,pleasant,0,0,1,1
35492,extractos,0,0,1,1
31124,faller,0,0,1,1
2015,lamenta,1,1,0,1
35536,வரவேற்பு,0,0,1,1
35491,actualizó,0,0,1,1
31077,harmonie,0,0,1,1
35489,എപ്പോൾ,0,0,1,1
31076,ofensiva,0,0,1,1
35531,مئات,0,0,1,1
2399,riportano,1,1,0,1
31082,ജില്ലയെച്ചൊല്ലി,0,0,1,1
31083,നടത്തുവാൻ,0,0,1,1
35499,exemplares,0,0,1,1
35525,έρθει,0,0,1,1
33733,пройдёт,0,0,1,1
35498,allmänhetens,0,0,1,1
33063,atentos,0,0,1,1
33064,permanecessem,0,0,1,1
31090,आलसी,0,0,1,1
33723,costumbres,0,0,1,1
35527,कॉपी,0,0,1,1
33722,историк,0,0,1,1
31088,നേടിയെടുക്കാവുന്നതേയുള്ളൂ,0,0,1,1
33734,tillförda,0,0,1,1
35497,नवंबर,0,0,1,1
35529,लगाती,0,0,1,1
33049,λέγατε,0,0,1,1
2013,distinzioni,1,1,0,1
33721,admiratifs,0,0,1,1
31123,माइक्रो,0,0,1,1
31086,straks,0,0,1,1
31085,ഗുണാങ്കങ്ങൾക്ക്,0,0,1,1
33736,foretrukne,0,0,1,1
33737,annars,0,0,1,1
2398,causando,1,1,0,1
35470,تتخطى,0,0,1,1
35569,apresentassem,0,0,1,1
33697,hatırlayın,0,0,1,1
33752,ಮೇಜಿನ,0,0,1,1
30992,सतत,0,0,1,1
33108,birisinin,0,0,1,1
33729,talihlerin,0,0,1,1
30991,ഉറപ്പുണ്ട്,0,0,1,1
30990,stripfiguren,0,0,1,1
33109,zusätzlichen,0,0,1,1
33750,peticiones,0,0,1,1
31188,человеку,0,0,1,1
31189,acrescentou,0,0,1,1
30989,വിവരിക്കാൻ,0,0,1,1
35443,древней,0,0,1,1
33679,separately,0,0,1,1
33112,aanrijden,0,0,1,1
35442,फ्यूचर,0,0,1,1
2020,ormai,1,1,0,1
2120,naso,1,1,0,1
33677,soruda,0,0,1,1
35605,വിവരണ,0,0,1,1
30986,اجمع,0,0,1,1
33675,acepte,0,0,1,1
35607,الشهير,0,0,1,1
31191,sidans,0,0,1,1
35608,шутку,0,0,1,1
30984,uncultivated,0,0,1,1
35600,ചേർന്നൊരു,0,0,1,1
33107,sur ,0,0,1,1
33030,envergure,0,0,1,1
33031,consultent,0,0,1,1
31003,estornudó,0,0,1,1
35597,traced,0,0,1,1
33106,commencent,0,0,1,1
31002,पोषण,0,0,1,1
33682,mantenido,0,0,1,1
1744,giuria,1,1,0,1
31179,يحالف,0,0,1,1
31000,prenant,0,0,1,1
35598,φέτα,0,0,1,1
33681,എന്നുപറയുക,0,0,1,1
35448,докажете,0,0,1,1
33748,comprovação,0,0,1,1
30998,matemáticos,0,0,1,1
30997,मां,0,0,1,1
31182,فرنسا,0,0,1,1
35446,كشف,0,0,1,1
30996,aktivitet,0,0,1,1
2011,apprenderanno,1,1,0,1
2413,vederla,1,1,0,1
31183,എഴുതാവുന്ന,0,0,1,1
33680,تكشف,0,0,1,1
31184,योजनायें,0,0,1,1
35599,perçues,0,0,1,1
1747,applicata,1,1,0,1
33028,perfeita,0,0,1,1
35571,ಉಡುಗೊರೆಯನ್ನು,0,0,1,1
33022,instaure,0,0,1,1
31197,skylldes,0,0,1,1
35619,exaggerate,0,0,1,1
35433,escargot,0,0,1,1
35620,சரிசெய்தல்,0,0,1,1
33669,நிகழும்,0,0,1,1
2418,piange,1,1,0,1
33668,forlader,0,0,1,1
35621,rédigées,0,0,1,1
35622,¿eh,0,0,1,1
35623,auxquels,0,0,1,1
33122,ഇംഗ്ലീഷ്‌,0,0,1,1
31199,സ്വതന്ത്രവിജ്ഞാനകോശമായി,0,0,1,1
35610,passaram,0,0,1,1
30974,локьером,0,0,1,1
35626,ஆங்கிலச்,0,0,1,1
33667,aniversário,0,0,1,1
35432,writingclarification,0,0,1,1
33021,पीड़ित,0,0,1,1
35629,hospedados,0,0,1,1
33756,överens,0,0,1,1
35430,princesse,0,0,1,1
30971,trente,0,0,1,1
35631,ужасный,0,0,1,1
31200,l’âge,0,0,1,1
33119,vergissen,0,0,1,1
1751,accompagnato,1,1,0,1
35617,камнями,0,0,1,1
35436,kahvenizi,0,0,1,1
2416,lasciato,1,1,0,1
33113,décident,0,0,1,1
33026,hoşsunuz,0,0,1,1
35611,mécaniste,0,0,1,1
35612,ನೋಡದಿದ್ದಾಗ,0,0,1,1
33754,l’accessibilité,0,0,1,1
31193,новых,0,0,1,1
33024,وأريد,0,0,1,1
2138,ampiezza,1,1,0,1
35614,problème »,0,0,1,1
30980,lecun,0,0,1,1
33114,behagelig,0,0,1,1
31195,narzissa,0,0,1,1
1750,strade,1,1,0,1
33116,bâtir,0,0,1,1
31196,mess,0,0,1,1
30979,தொகுக்கப்படக்,0,0,1,1
35615,വ്യക്തിയാണെന്നും,0,0,1,1
2114,cinese,1,1,0,1
33118,père,0,0,1,1
33671,തുമ്മുമ്പോൾ,0,0,1,1
35437,настоянию,0,0,1,1
2022,puntando,1,1,0,1
31178,traversing,0,0,1,1
31004,kredisini,0,0,1,1
33033,награду,0,0,1,1
33693,efecto,0,0,1,1
33741,ತೆಗೆದುಕೊಂಡಿದ್ದೇನೆ,0,0,1,1
35579,للقلق,0,0,1,1
35464,confusions,0,0,1,1
35580,يُعرف,0,0,1,1
33039,bilmiyorsun,0,0,1,1
2135,sezione,1,1,0,1
31031,partisanes »,0,0,1,1
31163,"होगी।
ये",0,0,1,1
31164,casper,0,0,1,1
31030,«научнообразовательный,0,0,1,1
33037,scene,0,0,1,1
35462,आरोन,0,0,1,1
33105,الإنجليزي,0,0,1,1
35461,inheritable,0,0,1,1
2408,soap,1,1,0,1
33692,sulak,0,0,1,1
31027,ಮುಗಿಸಲಿ,0,0,1,1
35581,skratta,0,0,1,1
1728,integrate,1,1,0,1
31166,emulated,0,0,1,1
31026,dispone,0,0,1,1
33691,முயற்சிக்கும்போது,0,0,1,1
33690,गारंटी,0,0,1,1
31167,tokio,0,0,1,1
33092,söylediği,0,0,1,1
33091,descenso,0,0,1,1
35576,πανηγυρίζεις,0,0,1,1
33090,सुसाइड,0,0,1,1
31042,സമ്മതിക്കുകയും,0,0,1,1
35469,spännande,0,0,1,1
31157,темпе,0,0,1,1
31040,மூலத்தைப்,0,0,1,1
31158,الغيرالمسجليين،,0,0,1,1
33086,sprankelende,0,0,1,1
35468,autoritário,0,0,1,1
31159,traditions,0,0,1,1
33696,حرفيًا,0,0,1,1
33041,πες,0,0,1,1
31038,quaisquer,0,0,1,1
33040,ನೀಡಿದ,0,0,1,1
1741,premuto,1,1,0,1
33088,wikiprojects,0,0,1,1
31160,செல்வங்களுக்கு,0,0,1,1
31161,genome,0,0,1,1
33695,canadiennes,0,0,1,1
35465,mall,0,0,1,1
35574,notified,0,0,1,1
33694,propriété,0,0,1,1
33089,advances,0,0,1,1
31032,नमक,0,0,1,1
35575,ekonomi,0,0,1,1
35460,zevkle,0,0,1,1
33095,journalistiques,0,0,1,1
31025,التجارب,0,0,1,1
35454,pregunte,0,0,1,1
33099,sætter,0,0,1,1
31011,марки,0,0,1,1
35591,இருவருமே,0,0,1,1
35592,panslavon,0,0,1,1
35453,والبولندية,0,0,1,1
2410,leggibilità,1,1,0,1
2122,management,1,1,0,1
33745,vermek,0,0,1,1
31009,scaling,0,0,1,1
2411,raggiungendo,1,1,0,1
31173,doğrultusunda,0,0,1,1
35594,هاتفي,0,0,1,1
31007,إداريي,0,0,1,1
2019,revisioni,1,1,0,1
33101,sorgulanabilir,0,0,1,1
35452,சவாரிக்குப்,0,0,1,1
33746,spain,0,0,1,1
31176,"
romeno",0,0,1,1
33747,тупыми,0,0,1,1
33683,otte,0,0,1,1
31177,territorio,0,0,1,1
33102,varken,0,0,1,1
33104,செய்யவே,0,0,1,1
31012,சியர்ஸ்,0,0,1,1
33098,चलना,0,0,1,1
31168,xvi,0,0,1,1
35455,ತಿಳಿದಿದೆಯೆ,0,0,1,1
31023,organisationen,0,0,1,1
35459,തുടക്കത്തിനുശേഷം,0,0,1,1
31022,പതിപ്പുകളുണ്ട്‌,0,0,1,1
2017,provengono,1,1,0,1
31021,descoberta,0,0,1,1
1743,violare,1,1,0,1
31169,confirmé,0,0,1,1
33096,cassés,0,0,1,1
35585,сенсация,0,0,1,1
33742,страницей,0,0,1,1
33743,معرفي,0,0,1,1
35586,dukke,0,0,1,1
35587,producers,0,0,1,1
33686,beperkte,0,0,1,1
35456,ഇന്നുള്ള,0,0,1,1
2385,navigazione,1,1,0,1
31017,återställdes,0,0,1,1
31016,alianza,0,0,1,1
35589,alfabetos,0,0,1,1
33744,aire,0,0,1,1
31015,സംസാരിക്കാം,0,0,1,1
31014,ομαλής,0,0,1,1
31013,complexiteit,0,0,1,1
33711,wiskundehuiswerk,0,0,1,1
34277,பெறப்பட்டது,0,0,1,1
35715,التوالي،,0,0,1,1
36069,டெர்சி,0,0,1,1
36060,رفضتهم,0,0,1,1
36059,நிர்வாகக்,0,0,1,1
33481,rêvais,0,0,1,1
30497,ವಿಭಾಗದಲ್ಲಿ,0,0,1,1
30499,अधीन,0,0,1,1
2053,positivamente,1,1,0,1
33483,പാവം,0,0,1,1
33326,தொகுக்கும்,0,0,1,1
36056,envió,0,0,1,1
33325,stunned,0,0,1,1
36055,المتدلية,0,0,1,1
33484,தொடங்குவதற்கு,0,0,1,1
36054,തെലുഗ്,0,0,1,1
33485,superieur,0,0,1,1
33322,vivía,0,0,1,1
33327,¿estaría,0,0,1,1
36061,παραδοσιακές,0,0,1,1
33480,dégustation,0,0,1,1
30491,работающих,0,0,1,1
36067,relational,0,0,1,1
33479,दर्पण,0,0,1,1
30488,സുഖമായിരിക്കും,0,0,1,1
30489,nació,0,0,1,1
33329,ಉತ್ತಮಗೊಳಿಸುವುದು,0,0,1,1
30490,നാളത്തേക്ക്,0,0,1,1
36066,insistant,0,0,1,1
30496,जाग,0,0,1,1
36065,ചുവടെയുള്ള,0,0,1,1
30492,الأمر،,0,0,1,1
30493,exactitude,0,0,1,1
36063,anerkendt,0,0,1,1
30494,технологии,0,0,1,1
30495,critère,0,0,1,1
33486,desistir,0,0,1,1
30502,udføre,0,0,1,1
33487,düşündü,0,0,1,1
36040,सुझाव।,0,0,1,1
2477,palesemente,1,1,0,1
33317,"
वोलापूक",0,0,1,1
2085,dipenda,1,1,0,1
2476,oscillando,1,1,0,1
33315,preferring,0,0,1,1
36041,divertidas,0,0,1,1
2475,condivide,1,1,0,1
30511,suffisant,0,0,1,1
2052,qualora,1,1,0,1
30518,जिनका,0,0,1,1
33494,sammanfogats,0,0,1,1
33314,tjugonde,0,0,1,1
36037,failures,0,0,1,1
36036,ведётся,0,0,1,1
33318,vacilando,0,0,1,1
2481,eccezionalmente,1,1,0,1
36051,preservando,0,0,1,1
30506,суде,0,0,1,1
30504,finance,0,0,1,1
33488,यूरोपीय,0,0,1,1
33489,edelstenen,0,0,1,1
33321,barnskyddslagstiftning,0,0,1,1
36049,interdisciplinära,0,0,1,1
1667,riescono,1,1,0,1
1668,rivisto,1,1,0,1
30509,rannte,0,0,1,1
30507,recep,0,0,1,1
36046,encorajada,0,0,1,1
1669,seguendo,1,1,0,1
36044,consecuentemente,0,0,1,1
36043,ಬಳಸುತ್ತೀರಿ,0,0,1,1
33492,ஆரம்பிக்கலாம்,0,0,1,1
33330,necesaria—,0,0,1,1
33331,serieus,0,0,1,1
33160,tomando,0,0,1,1
30486,aklınızda,0,0,1,1
33468,sache,0,0,1,1
33343,сладкого,0,0,1,1
30456,البسيط,0,0,1,1
30457,gulches,0,0,1,1
36092,формируемого,0,0,1,1
1661,esaminati,1,1,0,1
36090,उपस्थिति,0,0,1,1
33342,выходной,0,0,1,1
33340,بالإسبانية,0,0,1,1
30458,necessidade,0,0,1,1
36089,agreement,0,0,1,1
30459,αναπνεύσω,0,0,1,1
33470,aiit’s,0,0,1,1
30460,फ़ाइलें,0,0,1,1
36087,générales,0,0,1,1
30455,apresentou,0,0,1,1
30454,trycka,0,0,1,1
33467,администраторы,0,0,1,1
36100,abogaba,0,0,1,1
30446,கூறுகிறார்,0,0,1,1
30447,empregava,0,0,1,1
36102,விதிமுறைகள்,0,0,1,1
30448,ಶೆಲ್ನ,0,0,1,1
36101,വിക്കിപീഡിയകളിലും,0,0,1,1
33464,rösttonen,0,0,1,1
30449,antalet,0,0,1,1
30452,« communauté »,0,0,1,1
36098,incité,0,0,1,1
36097,júri,0,0,1,1
2056,raccolte,1,1,0,1
30450,gönüllülerin,0,0,1,1
36096,stuff,0,0,1,1
2082,sottolineò,1,1,0,1
30461,graphique,0,0,1,1
36086,அகங்காரமான,0,0,1,1
33472,åsikter,0,0,1,1
30481,classés,0,0,1,1
36075,സാധിച്ചു,0,0,1,1
30477,spaß,0,0,1,1
30478,hardnekkiger,0,0,1,1
36072,ಅವನನ್ನು,0,0,1,1
36071,databas,0,0,1,1
30480,contestadas,0,0,1,1
33333,tvivl,0,0,1,1
36077,consequently,0,0,1,1
30482,accepté,0,0,1,1
2054,arrivati,1,1,0,1
30484,ബേക്കർ,0,0,1,1
30485,« passeur »,0,0,1,1
36070,डरा,0,0,1,1
33332,ಸುಸ್ತಾಗಿಲ್ಲ,0,0,1,1
30474,بمحتوى,0,0,1,1
30473,significando,0,0,1,1
36085,ഘട്ടം,0,0,1,1
2055,classificati,1,1,0,1
1663,conferenze,1,1,0,1
36083,والصينية،,0,0,1,1
30464,докладах,0,0,1,1
2484,dietro,1,1,0,1
36082,മാന്യമായി,0,0,1,1
33474,देर,0,0,1,1
36081,للمساهمة,0,0,1,1
30471,بالكسل,0,0,1,1
30468,censeurs,0,0,1,1
36080,ഉപയോഗിച്ചാൽ,0,0,1,1
33336,своем,0,0,1,1
33335,arbetsflöden,0,0,1,1
36079,financiero,0,0,1,1
36078,எஸ்எம்எஸ்,0,0,1,1
36035,beundrende,0,0,1,1
33312,преобразования,0,0,1,1
36034,forgets,0,0,1,1
36033,sänka,0,0,1,1
33517,ഹിച്ചാലും,0,0,1,1
30561,പ്രയത്നത്തിന്,0,0,1,1
33518,eserin,0,0,1,1
30562,بتشجيع,0,0,1,1
35989,narcissmamma,0,0,1,1
1677,tdgammon,1,1,0,1
2473,calmati,1,1,0,1
30564,handy,0,0,1,1
35987,تذكره,0,0,1,1
35986,تجميعها,0,0,1,1
35985,പ്രേരിപ്പിക്കുന്നതെന്താണ്,0,0,1,1
35984,stormachtig,0,0,1,1
33297,ίσχυαν,0,0,1,1
33296,прерываю,0,0,1,1
30566,barbe,0,0,1,1
33298,αγγλόφωνη,0,0,1,1
33516,kindle,0,0,1,1
30560,चलो।,0,0,1,1
2049,entità,1,1,0,1
30555,retirado,0,0,1,1
30556,അവനോടൊപ്പം,0,0,1,1
33301,sprogversion,0,0,1,1
33300,удачного,0,0,1,1
33512,வழங்குகின்றது,0,0,1,1
30557,panne,0,0,1,1
35996,gördüğünüzü,0,0,1,1
1676,saluti,1,1,0,1
33515,ஏற்படுத்தப்பட்டுள்ள,0,0,1,1
35995,interaccionar,0,0,1,1
30559,വരികയാണ്,0,0,1,1
35994,managers,0,0,1,1
35993,continuant,0,0,1,1
35992,mamãe,0,0,1,1
2047,stavano,1,1,0,1
30567,άκουσα,0,0,1,1
1678,chiedo,1,1,0,1
35968,плачет,0,0,1,1
35971,förhållande,0,0,1,1
33526,betona,0,0,1,1
35970,प्रेरणा,0,0,1,1
30577,أخت,0,0,1,1
35969,высокого,0,0,1,1
30579,bidrage,0,0,1,1
35967,rodinia,0,0,1,1
30576,filtres,0,0,1,1
30580,bulunan,0,0,1,1
30581,война,0,0,1,1
30582,ಬಳಲುತ್ತಿದ್ದೇನೆ,0,0,1,1
33292,ലാഭേച്ഛകൂടാതെ,0,0,1,1
2087,posizioni,1,1,0,1
30583,നോക്കുമ്പോൾ,0,0,1,1
33525,وجبة,0,0,1,1
30575,நல்லவர்களாக,0,0,1,1
30568,φανταστικά,0,0,1,1
33523,gosto,0,0,1,1
35981,कदम,0,0,1,1
35980,charges,0,0,1,1
35979,مجانية,0,0,1,1
33522,basins,0,0,1,1
35978,entails,0,0,1,1
33294,verificadas,0,0,1,1
1680,minori,1,1,0,1
2045,barzelletta,1,1,0,1
30570,contextualização,0,0,1,1
2471,bambino,1,1,0,1
35975,പുറത്തുവന്ന്,0,0,1,1
1681,unito,1,1,0,1
35972,صديقك,0,0,1,1
30572,игру»,0,0,1,1
35998,نول,0,0,1,1
35999,inscrever,0,0,1,1
30554,एव्रीथिंग,0,0,1,1
30535,diyorlarsa,0,0,1,1
30529,याहू,0,0,1,1
30531,contribuye,0,0,1,1
30532,estupro,0,0,1,1
30534,romantic,0,0,1,1
36020,лицом,0,0,1,1
33310,التنقيب,0,0,1,1
36017,zamandan,0,0,1,1
36023,самого,0,0,1,1
36016,öğrenelim,0,0,1,1
33500,välmenande,0,0,1,1
2051,cominciò,1,1,0,1
36015,cloche,0,0,1,1
30536,ಸರಿಯೇ,0,0,1,1
36014,industrielle,0,0,1,1
2086,fecero,1,1,0,1
30527,விஷயத்தைச்,0,0,1,1
33502,оставался,0,0,1,1
36029,proliferation,0,0,1,1
2474,ozono,1,1,0,1
33495,colectivamente—,0,0,1,1
33496,mueve,0,0,1,1
33498,നിയമിക്കുന്നത്,0,0,1,1
36030,ötesinde,0,0,1,1
30522,soucies,0,0,1,1
36028,вероятностей,0,0,1,1
30526,disagree,0,0,1,1
30523,إل,0,0,1,1
30524,situé,0,0,1,1
36026,hänvisningar,0,0,1,1
30525,supresores,0,0,1,1
36025,incorrectas,0,0,1,1
36024,موجودة,0,0,1,1
30537,शुक्रवार,0,0,1,1
36013,suivantes,0,0,1,1
33302,لموقع,0,0,1,1
36002,auktoritetsbristen,0,0,1,1
30546,confined,0,0,1,1
33507,காட்டப்படும்,0,0,1,1
30547,assaulting,0,0,1,1
33508,रेवोलुशन,0,0,1,1
36004,adecuada,0,0,1,1
30548,obtenido,0,0,1,1
33304,directe,0,0,1,1
30545,problématiques,0,0,1,1
2050,evidenziato,1,1,0,1
30549,profits,0,0,1,1
30550,ограничений,0,0,1,1
30551,pending,0,0,1,1
30552,« liste,0,0,1,1
33303,catégoriser,0,0,1,1
36005,romains,0,0,1,1
33506,fond ,0,0,1,1
30538,add,0,0,1,1
33505,flour,0,0,1,1
30539,flotte,0,0,1,1
36012,υποδηλώνει,0,0,1,1
30540,wifi,0,0,1,1
33309,علمت,0,0,1,1
33503,போட்டி,0,0,1,1
33307,ಮೇಲಿನ,0,0,1,1
30543,страну,0,0,1,1
1673,proprietaria,1,1,0,1
36009,എഴുതുമ്പോൾ,0,0,1,1
1672,ottimizzare,1,1,0,1
33306,erreichte,0,0,1,1
30544,alternative »,0,0,1,1
36007,ildelugtende,0,0,1,1
33305,باحث,0,0,1,1
30445,വാക്യങ്ങളെയും,0,0,1,1
33346,धमकी,0,0,1,1
33463,energievoorbeeld,0,0,1,1
33375,radiostation,0,0,1,1
33425,وأخذت,0,0,1,1
36193,தும்மும்போது,0,0,1,1
30342,tanta,0,0,1,1
33385,خمس,0,0,1,1
36191,المركز,0,0,1,1
36190,भावना,0,0,1,1
30343,thermal,0,0,1,1
30344,إرباك,0,0,1,1
2498,impatto,1,1,0,1
30347,εγκέφαλό,0,0,1,1
30350,violent,0,0,1,1
30351,ತರಗತಿಯಲ್ಲಿ,0,0,1,1
36188,posicionado,0,0,1,1
30352,رمز,0,0,1,1
2496,cammina,1,1,0,1
2500,piani,1,1,0,1
33386,ολόκληρη,0,0,1,1
33424,geheimnisvolles,0,0,1,1
30336,ഉൾപ്പെടെ,0,0,1,1
33389,связана,0,0,1,1
36205,ميتشيل,0,0,1,1
36203,diego,0,0,1,1
30332,armén,0,0,1,1
36200,nãousuários,0,0,1,1
30334,contrebande,0,0,1,1
1645,svedese,1,1,0,1
30340,प्रभावी,0,0,1,1
36197,البلدان,0,0,1,1
30337,bordssätt,0,0,1,1
33421,accusant,0,0,1,1
30338,likhet,0,0,1,1
36195,biografieën,0,0,1,1
33422,உணவுகளையும்,0,0,1,1
33384,सभा,0,0,1,1
36186,لتشجيع,0,0,1,1
2495,sacco,1,1,0,1
2077,danno,1,1,0,1
33431,плачешь,0,0,1,1
36179,danmark,0,0,1,1
36178,featuring,0,0,1,1
30364,குற்ற,0,0,1,1
33432,أعطت,0,0,1,1
33377,عدداً,0,0,1,1
30365,कोल्बेर्ट,0,0,1,1
36180,"
letão",0,0,1,1
36177,neşelendirmek,0,0,1,1
30367,ലേഖനങ്ങളെഴുതാനും,0,0,1,1
30368,படுக்கை,0,0,1,1
30369,sammanfatta,0,0,1,1
33433,kleidern,0,0,1,1
30370,പണമുണ്ടെന്ന്,0,0,1,1
33430,gemeenschap,0,0,1,1
33378,energidryck,0,0,1,1
33382,опубликовал,0,0,1,1
33429,supervisory,0,0,1,1
30355,polêmica,0,0,1,1
33381,"
तमिल",0,0,1,1
36185,رسالتي,0,0,1,1
30356,cumprem,0,0,1,1
30357,comprobar,0,0,1,1
2067,sguardo,1,1,0,1
30359,गंभीर,0,0,1,1
30362,സാധ്യമാക്കുന്ന,0,0,1,1
2076,sufficientemente,1,1,0,1
2494,registrazione,1,1,0,1
36183,vererek,0,0,1,1
33379,محتوياتها؛,0,0,1,1
30361,изменилась,0,0,1,1
36181,الفضل,0,0,1,1
36207,stemden,0,0,1,1
36208,قائلا,0,0,1,1
33418,kolaydır,0,0,1,1
36228,"
checheno",0,0,1,1
36232,aposentado,0,0,1,1
33402,trillion,0,0,1,1
2073,partecipando,1,1,0,1
1641,significati,1,1,0,1
36229,زالوا,0,0,1,1
2072,svilupparono,1,1,0,1
2504,fermò,1,1,0,1
36233,negotiation»,0,0,1,1
30307,कहे,0,0,1,1
36227,விக்கிப்பீடியாவினது,0,0,1,1
30308,உணவுகள்,0,0,1,1
36225,runoff,0,0,1,1
30309,δηλώσει,0,0,1,1
36224,भगवान,0,0,1,1
33394,françois,0,0,1,1
1640,visti,1,1,0,1
36223,nævner,0,0,1,1
36237,बोक्माल,0,0,1,1
36241,betaalde,0,0,1,1
1639,consegnati,1,1,0,1
33398,educativos,0,0,1,1
36239,trentaine,0,0,1,1
2505,spirito,1,1,0,1
33396,anneme,0,0,1,1
30299,узнаваемы,0,0,1,1
36235,destin ,0,0,1,1
30300,ಖರೀದಿಸಲು,0,0,1,1
30301,auteursrechtelijke,0,0,1,1
30302,turkiets,0,0,1,1
33400,ويشكو,0,0,1,1
36236,yapabilmek,0,0,1,1
30303,vacant,0,0,1,1
30311,perú,0,0,1,1
30313,brydde,0,0,1,1
30331,italienne,0,0,1,1
36213,habilidade,0,0,1,1
30323,ملياري,0,0,1,1
36216,falsehoods,0,0,1,1
36215,dermed,0,0,1,1
30324,τρελό,0,0,1,1
30325,derive,0,0,1,1
36214,occitane,0,0,1,1
33417,എന്തുചെയ്യണമെന്ന്,0,0,1,1
33416,resten,0,0,1,1
36212,ബഹിരാകാശം,0,0,1,1
30327,gevangenen,0,0,1,1
33390,minam,0,0,1,1
30329,журналистов,0,0,1,1
30330,tercüme,0,0,1,1
1643,omogeneizzando,1,1,0,1
33392,wikipediaappar,0,0,1,1
36217,aktad,0,0,1,1
36222,högskolestudier,0,0,1,1
30318,finalmente,0,0,1,1
33408,تحتفظ,0,0,1,1
33409,ridande,0,0,1,1
33410,निकाल,0,0,1,1
2502,costituisca,1,1,0,1
36220,κλήση,0,0,1,1
33411,polish,0,0,1,1
30320,ആവർത്തിക്കണം,0,0,1,1
2071,persino,1,1,0,1
33393,விடைபெற்று,0,0,1,1
36219,intersidéral,0,0,1,1
33413,stap,0,0,1,1
33414,prost,0,0,1,1
36218,changea,0,0,1,1
2501,carriera»,1,1,0,1
36175,starta,0,0,1,1
36174,سطح,0,0,1,1
30442,slave,0,0,1,1
36173,избирательной,0,0,1,1
36126,amador,0,0,1,1
30420,lösta,0,0,1,1
33359,வென்றது,0,0,1,1
30421,interchange,0,0,1,1
30422,interplanetary,0,0,1,1
30423,ഇതിഹാസം,0,0,1,1
33358,поразительная,0,0,1,1
30424,yoksa,0,0,1,1
36124,sorrir,0,0,1,1
36123,"
इलोकानो",0,0,1,1
30426,"
यूक्रेनी",0,0,1,1
36122,പൂന്തോട്ടത്തിൽ,0,0,1,1
30427,சந்திக்கப்,0,0,1,1
30428,предоставлен,0,0,1,1
30429,комментарий,0,0,1,1
1656,pensata,1,1,0,1
1655,denominatore,1,1,0,1
36129,réf,0,0,1,1
36135,thriller,0,0,1,1
33451,undeveloped,0,0,1,1
30413,தொனி,0,0,1,1
33452,ಲೈಬ್ರರಿ,0,0,1,1
30414,версиях,0,0,1,1
36136,விரல்கள்,0,0,1,1
2058,sottoposto,1,1,0,1
30416,högtalaren,0,0,1,1
36131,ಪ್ರಸ್ತಾಪವನ್ನು,0,0,1,1
30417,യാത്രയെക്കുറിച്ചോ,0,0,1,1
33361,வர்த்தக,0,0,1,1
33360,ændrede,0,0,1,1
36133,एनसायक्लोपीडिया,0,0,1,1
33454,புன்னகைத்தனர்,0,0,1,1
36132,addressed,0,0,1,1
33456,dokument,0,0,1,1
33357,licences,0,0,1,1
36121,aral,0,0,1,1
33348,tenga,0,0,1,1
33350,удаляют,0,0,1,1
30435,τεράστια,0,0,1,1
36110,worldcat,0,0,1,1
1658,resisti,1,1,0,1
36108,ಕಳೆದುಕೊಂಡಿದ್ದೇನೆ,0,0,1,1
36107,concreta,0,0,1,1
30436,skönheten,0,0,1,1
33462,χρήσιμο,0,0,1,1
36106,δημοτικότητα,0,0,1,1
33347,संभालते,0,0,1,1
36105,«квадрига»,0,0,1,1
30438,imprima,0,0,1,1
36104,அறியப்பட்டிருந்தாலும்,0,0,1,1
2488,attribuite,1,1,0,1
36112,sudamérica,0,0,1,1
36113,ಹೇಳುವುದು,0,0,1,1
30430,analyserade,0,0,1,1
36117,tafelmanieren,0,0,1,1
33457,followup,0,0,1,1
33458,etmeden,0,0,1,1
36120,victorian,0,0,1,1
36119,ಭ್ರಮನಿರಸನಗೊಂಡಿದ್ದೇನೆ,0,0,1,1
33356,"
वैस्पियाई",0,0,1,1
2079,addestrate,1,1,0,1
33459,διατήρηση,0,0,1,1
33352,olamazsın,0,0,1,1
33354,heterogen,0,0,1,1
33353,تواصل,0,0,1,1
36116,простая,0,0,1,1
33461,materia,0,0,1,1
36115,تذكرها,0,0,1,1
30433,“vikipedi,0,0,1,1
33362,ശക്തി,0,0,1,1
36137,நிராகரித்தாள்,0,0,1,1
30412,lösenord,0,0,1,1
30382,திட்டமாகவும்,0,0,1,1
36161,adaptado,0,0,1,1
36160,bryter,0,0,1,1
36159,levende,0,0,1,1
33439,الوثائقي,0,0,1,1
33371,exploration,0,0,1,1
33440,وإزالة,0,0,1,1
33441,patruljerer,0,0,1,1
36162,ആശങ്കകളൊന്നുമില്ല,0,0,1,1
30384,الساعة,0,0,1,1
30385,aquel,0,0,1,1
36156,contrôles,0,0,1,1
36155,incorporates,0,0,1,1
2064,renda,1,1,0,1
2078,fondi,1,1,0,1
30380,handful,0,0,1,1
30379,ash,0,0,1,1
30388,आंतरिक,0,0,1,1
33435,കീഴിൽ,0,0,1,1
33374,estadounidense,0,0,1,1
36172,விளக்க,0,0,1,1
36171,dağıtılması,0,0,1,1
36170,बुनियादी,0,0,1,1
30372,totalement,0,0,1,1
33373,competir,0,0,1,1
33436,следующих,0,0,1,1
30377,alayım,0,0,1,1
30375,dileyebilirsiniz,0,0,1,1
36167,espantoso,0,0,1,1
36166,generalized,0,0,1,1
36165,வாழ்த்துவதற்கான,0,0,1,1
33372,ತರಬಹುದೇ,0,0,1,1
33437,قهوتك,0,0,1,1
30386,zurückwies,0,0,1,1
33366,författats,0,0,1,1
30411,annesiyle,0,0,1,1
2489,parametri,1,1,0,1
30401,ημέρα,0,0,1,1
36145,checked,0,0,1,1
36144,uyuşuk,0,0,1,1
30402,publiceras,0,0,1,1
30403,apoiados,0,0,1,1
33448,“border,0,0,1,1
36143,doğa,0,0,1,1
36146,хранятся,0,0,1,1
36142,хорошей,0,0,1,1
30405,shakespeare,0,0,1,1
30406,زفافي,0,0,1,1
33365,மென்மையானது,0,0,1,1
33364,созданы,0,0,1,1
30410,currency,0,0,1,1
30400,மாணவர்களுக்கான,0,0,1,1
36148,generalizable,0,0,1,1
30390,princess,0,0,1,1
2061,cosiddetti,1,1,0,1
30391,indhold,0,0,1,1
30392,pressionou,0,0,1,1
2490,fianco,1,1,0,1
36154,genellikle,0,0,1,1
36153,sufixo,0,0,1,1
30394,försök,0,0,1,1
33446,zukam,0,0,1,1
30399,bescheiden,0,0,1,1
36152,echten,0,0,1,1
30396,ಪುನರಾವರ್ತಿಸಬೇಕು,0,0,1,1
36150,provider,0,0,1,1
30397,астрономами,0,0,1,1
30398,разделах,0,0,1,1
36149,población,0,0,1,1
33527,संध्या।,0,0,1,1
33528,пользователя,0,0,1,1
30584,نسخ,0,0,1,1
35783,courant,0,0,1,1
30783,ഏകഗ്രഹമാണ്,0,0,1,1
35806,രസകരമാണ്,0,0,1,1
35805,വിലയില്ല,0,0,1,1
1709,combinata,1,1,0,1
35803,கட்டுரைக்குமான,0,0,1,1
2032,sfrutta,1,1,0,1
30784,अंग्रजी,0,0,1,1
33203,കൊണ്ടിരുന്ന,0,0,1,1
33605,mesela,0,0,1,1
35802,περιλαμβάνουν,0,0,1,1
33202,ಸಾಬೀತುಪಡಿಸದ,0,0,1,1
30786,hemisphere,0,0,1,1
30787,खपत,0,0,1,1
35801,बहक,0,0,1,1
35800,olagligt,0,0,1,1
30782, ×,0,0,1,1
2451,bloccato,1,1,0,1
35807,ವಿವರಿಸಲು,0,0,1,1
35813,garanderen,0,0,1,1
30771,statens,0,0,1,1
35816,pedaço,0,0,1,1
30772,विकिवर्सिटी,0,0,1,1
33206,прошли,0,0,1,1
33205,labs,0,0,1,1
30774,fungerer,0,0,1,1
35812,صحة,0,0,1,1
35809,आटा,0,0,1,1
1708,ricostruire,1,1,0,1
2452,lezione,1,1,0,1
33204,conflits,0,0,1,1
30778,eveneens,0,0,1,1
35810,chegar,0,0,1,1
30779,ಗೆಳೆಯನಿಗೆ,0,0,1,1
30788,l’intégrité,0,0,1,1
33608,indonesië,0,0,1,1
33200,længe,0,0,1,1
33188,misterioso,0,0,1,1
30800,égalitaire,0,0,1,1
35792,τόνο,0,0,1,1
35791,opt,0,0,1,1
2443,linden,1,1,0,1
35790,ಸ್ನೇಹಿತರಾಗಿದ್ದರು,0,0,1,1
35789,« caractère,0,0,1,1
2110,simbolici,1,1,0,1
33191,dries,0,0,1,1
1710,sposarti,1,1,0,1
2442,vanno,1,1,0,1
35786,lingüísticas,0,0,1,1
33186,ഉപയോഗിച്ചിരുന്നു,0,0,1,1
35785,مسؤولين,0,0,1,1
33185,தொங்க,0,0,1,1
30799,വെബ്സൈറ്റ്,0,0,1,1
33612,कमजोर,0,0,1,1
35799,conoces,0,0,1,1
33609,للمعرفة,0,0,1,1
35798,describing,0,0,1,1
35797,விரும்புவதன்,0,0,1,1
30789,ஆண்டுகள்,0,0,1,1
2447,incontrare,1,1,0,1
2445,selezioni,1,1,0,1
35795,εκπληκτικά,0,0,1,1
33199,കശ്മീർ,0,0,1,1
2444,avevi,1,1,0,1
33198,existiam,0,0,1,1
33196,αναβαθμίστε,0,0,1,1
35794,inundación,0,0,1,1
33195,onions,0,0,1,1
30793,സന്നദ്ധ,0,0,1,1
30795,संदेशवाहक,0,0,1,1
33208,للموسوعة,0,0,1,1
30770,ಹೊಡೆದಿದ್ದೀರಿ,0,0,1,1
35817,rød,0,0,1,1
35836,independência,0,0,1,1
30742,ಕೋಪಗೊಂಡಿದ್ದಾರೆ,0,0,1,1
33588,naked,0,0,1,1
33589,patch,0,0,1,1
30744,"
मलयालम",0,0,1,1
35837,ಇಬ್ಬರಿಗೂ,0,0,1,1
30746,stupéfait,0,0,1,1
35835,رسمي,0,0,1,1
33219,गतिविधियाँ,0,0,1,1
33217,красивая,0,0,1,1
33590,couler,0,0,1,1
35834,laundry,0,0,1,1
35833,ഭാഗമായി,0,0,1,1
33592,reçue,0,0,1,1
30749,മാതൃവെബ്‌സൈറ്റിനെക്കാൾ,0,0,1,1
33218,لديهما,0,0,1,1
33220,«символом,0,0,1,1
35831,stunningly,0,0,1,1
35844,गुज़री,0,0,1,1
1705,ricompensa,1,1,0,1
35846,നോക്കാറുണ്ട്,0,0,1,1
30736,videnskabsetik,0,0,1,1
33223,alumnos,0,0,1,1
30737,السيرة,0,0,1,1
35845,прошу,0,0,1,1
35843,eisenberg,0,0,1,1
35841,അവബോധം,0,0,1,1
33587,годы,0,0,1,1
35842,demasia,0,0,1,1
30739,freude,0,0,1,1
2456,sofferto,1,1,0,1
30741,clasificados,0,0,1,1
2107,ficcanaso,1,1,0,1
33215,lees,0,0,1,1
35830,değilseniz,0,0,1,1
30769,aventures,0,0,1,1
30765,சாப்பிடலாமா,0,0,1,1
33211,captaste,0,0,1,1
30763,கொண்டிருந்தீர்கள்,0,0,1,1
33598,പിന്തുണയോടെയാണ്,0,0,1,1
33599,contrasting,0,0,1,1
30764,பிரச்சினையை,0,0,1,1
35821,vikipedist,0,0,1,1
33210,عالمية،,0,0,1,1
35823,cached,0,0,1,1
30766,disclose,0,0,1,1
35819,بالذكر,0,0,1,1
30767,itibaren,0,0,1,1
30768,atmospheres,0,0,1,1
33600,salate,0,0,1,1
35818,flummoxade,0,0,1,1
33213,redactado,0,0,1,1
30761,സൗന്ദര്യത്തെയും,0,0,1,1
2455,wikiquette,1,1,0,1
33596,المكونات,0,0,1,1
30751,sağlar,0,0,1,1
33594,सुस्निंगनु,0,0,1,1
30753,embaucher,0,0,1,1
33595,conferências,0,0,1,1
35828,cares,0,0,1,1
30756,предмету,0,0,1,1
30758,கேட்கிறீர்களா,0,0,1,1
35824,ಸುಂದರವಾಗಿದ್ದರು,0,0,1,1
30759,camada,0,0,1,1
33214,ஆறாவது,0,0,1,1
2454,stesura,1,1,0,1
35826,നുറുങ്ങ്,0,0,1,1
35825,disait,0,0,1,1
33597,deformational,0,0,1,1
35784,gevallen,0,0,1,1
30807,parity,0,0,1,1
33224,статьями,0,0,1,1
35782,الطاقة,0,0,1,1
2436,diventasse,1,1,0,1
30857,partnered,0,0,1,1
30858,സാർവത്രികമായി,0,0,1,1
30859,позволить,0,0,1,1
30860,koştu,0,0,1,1
30861,kaïkavien,0,0,1,1
30862,γελάει,0,0,1,1
30863,koyuyorum,0,0,1,1
2031,villaggio,1,1,0,1
1715,salutarono,1,1,0,1
35741,meinungen,0,0,1,1
35740,relaterede,0,0,1,1
35739,probabilísticas,0,0,1,1
33168,"
croata",0,0,1,1
30866,حقا,0,0,1,1
30855,seid,0,0,1,1
30854,yazıyı,0,0,1,1
35743,consiguió,0,0,1,1
2437,suggerì,1,1,0,1
30841,அண்ணளவாக,0,0,1,1
35747,"
अन्तरभाषिक",0,0,1,1
35746,англоязычный,0,0,1,1
30842,ದೊಡ್ಡದಾದ,0,0,1,1
33629,βιασμού,0,0,1,1
35745,engellendi,0,0,1,1
30846,sendos,0,0,1,1
33169,frivillig,0,0,1,1
35744,giechelde,0,0,1,1
30848,vecka,0,0,1,1
30849,fotorrealista,0,0,1,1
33630,háganme,0,0,1,1
30851,geleerd,0,0,1,1
30852,knight,0,0,1,1
30867,robijnen,0,0,1,1
35737,geçerli,0,0,1,1
35736,இணையத்தளம்,0,0,1,1
2112,napoletano,1,1,0,1
2027,intensificare,1,1,0,1
30881,spitzer,0,0,1,1
1719,collaborativo,1,1,0,1
33641,истинность,0,0,1,1
35725,nyare,0,0,1,1
35723,someten,0,0,1,1
33161,inclining,0,0,1,1
35728,маленький,0,0,1,1
30886,مناقشتهم،,0,0,1,1
35721,ಎತ್ತಿಕೊಳ್ಳಲಾಗಿದೆ,0,0,1,1
35720,suretiyle,0,0,1,1
35719,fechamento,0,0,1,1
35718,ಏನಾಗುತ್ತದೆ,0,0,1,1
30887,slower,0,0,1,1
33639,targeted,0,0,1,1
35730,ಕೋಪಗೊಂಡಿದೆ,0,0,1,1
30868,semantiska,0,0,1,1
2030,separato,1,1,0,1
33633,réelles,0,0,1,1
1716,dizionari,1,1,0,1
30871,தகுதியானவன்,0,0,1,1
2435,tratte,1,1,0,1
33634,levensvatbare,0,0,1,1
30875,ετοιμάστηκα,0,0,1,1
2029,incroci,1,1,0,1
30878,цитируется,0,0,1,1
35733,एली,0,0,1,1
33167,föreställer,0,0,1,1
35732,सरकारी,0,0,1,1
30876,செய்வதைத்,0,0,1,1
30877,tårer,0,0,1,1
35731,distributes,0,0,1,1
33628,adquiridos,0,0,1,1
33172,அறைக்குள்,0,0,1,1
33173,lyse,0,0,1,1
33182,dier,0,0,1,1
30819,autorisations,0,0,1,1
30820,انفتاحًا,0,0,1,1
35772,zullen,0,0,1,1
30821,institutionnalisation,0,0,1,1
30822,serveursquand ,0,0,1,1
30823,свойственна,0,0,1,1
33619,consulting,0,0,1,1
33618,الحقيقة،,0,0,1,1
30824,stärka,0,0,1,1
33181,évoquer,0,0,1,1
30825,erbjuder,0,0,1,1
33620,setze,0,0,1,1
35770,தவிர்ப்பது,0,0,1,1
35769,вонючая,0,0,1,1
35773,litt,0,0,1,1
33183,overalt,0,0,1,1
1711,accontentarsi,1,1,0,1
30814,घोषित,0,0,1,1
33184,कायम,0,0,1,1
2441,istante,1,1,0,1
35780,пообещал,0,0,1,1
33614,combinée,0,0,1,1
2440,tempestata,1,1,0,1
30813,hurtige,0,0,1,1
30815,जड़ी,0,0,1,1
33617,ενήργησα,0,0,1,1
33615,الجاني,0,0,1,1
33616,ತೀವ್ರ,0,0,1,1
30818,företagens,0,0,1,1
35776,ടൂറിസ്റ്റിലോ,0,0,1,1
35775,ಹಸಿದಿದ್ದೇನೆ,0,0,1,1
35774,reshaped,0,0,1,1
35768,वक्ताओं,0,0,1,1
30827,അടുത്തത്‌,0,0,1,1
33174,orageuse,0,0,1,1
35753,அழுவதையும்,0,0,1,1
35756,référant,0,0,1,1
33622,filiations,0,0,1,1
1713,fetta,1,1,0,1
33623,അവയ്ക്ക്,0,0,1,1
30837,custos,0,0,1,1
35754,ελληνόφωνη,0,0,1,1
30838,тест,0,0,1,1
2439,quantitativo,1,1,0,1
35752,النهائية,0,0,1,1
35751,люблю,0,0,1,1
35750,intéressante,0,0,1,1
35749,функциями,0,0,1,1
30839,टायलर,0,0,1,1
33625,स्थानीय,0,0,1,1
30835,consciousness,0,0,1,1
35757,настоящем,0,0,1,1
33180,brudekjole,0,0,1,1
35761,എന്നല്ല,0,0,1,1
35766,прилагающейся,0,0,1,1
35765,κλασικές,0,0,1,1
30829,engelsksproget,0,0,1,1
35764,തലയിൽ,0,0,1,1
35763,സൂചിപ്പിക്കുന്ന,0,0,1,1
35762,நினைத்தாள்,0,0,1,1
2111,gustoso,1,1,0,1
33177,modificam,0,0,1,1
30830,അടുത്തത്,0,0,1,1
33178,suscite,0,0,1,1
30831,ஆச்சரியப்படுகிறீர்கள்,0,0,1,1
30832,ζαμάνια,0,0,1,1
35759,«wiki,0,0,1,1
1712,vado,1,1,0,1
35848,deixa,0,0,1,1
35849,пожаловаться,0,0,1,1
30585,ஓர்,0,0,1,1
30666,ಅಷ್ಟಾಗಿ,0,0,1,1
30634,المنتجين,0,0,1,1
35928,holistique,0,0,1,1
33271,"
चीनी",0,0,1,1
33546,сходных,0,0,1,1
30636,اعتبارا,0,0,1,1
33547,दबाव,0,0,1,1
30637,تخريبًا,0,0,1,1
33548,πατώντας,0,0,1,1
33268,reivindicações,0,0,1,1
33549,உயர்வு,0,0,1,1
33267,çıldırdığımı,0,0,1,1
35927,ചാലക്കുടി,0,0,1,1
33266,exhaustivité,0,0,1,1
2098,addetti,1,1,0,1
35926,pornoactrices,0,0,1,1
30633,unabated,0,0,1,1
33272,பானத்துடன்,0,0,1,1
30632,translator,0,0,1,1
30629,dima,0,0,1,1
35937,balanced,0,0,1,1
30626,demitidos,0,0,1,1
35936,पहुँचायी,0,0,1,1
35935,पन्ना,0,0,1,1
30627,συναντήσει,0,0,1,1
30628,etki,0,0,1,1
30630,λείπει,0,0,1,1
35929,canton,0,0,1,1
1696,ligure,1,1,0,1
33273,wiskundeboek,0,0,1,1
30631,расширений,0,0,1,1
35932,västerländska,0,0,1,1
35931,suivie,0,0,1,1
35930,உண்மையான,0,0,1,1
33261,скажете,0,0,1,1
30646,intelectual,0,0,1,1
30647,kostsamt,0,0,1,1
30661,σοβαρή,0,0,1,1
33556,അനുവാദം,0,0,1,1
35917,निर्देशांक,0,0,1,1
30660,améliorezle,0,0,1,1
33256,webaroo,0,0,1,1
33255,adjusts,0,0,1,1
1697,udito,1,1,0,1
30662,هيلر,0,0,1,1
30658,மெருகூட்டப்பட்டவராகவும்,0,0,1,1
1700,straordinariamente,1,1,0,1
35913,पिला,0,0,1,1
30663,armee,0,0,1,1
35912,story,0,0,1,1
30664,நம்,0,0,1,1
35911,സുഹൃത്തിനോട്,0,0,1,1
33555,ಸುಂದರವಾಗಿದ್ದನು,0,0,1,1
33258,concurrent,0,0,1,1
33260,publicitaireréf,0,0,1,1
30652,சிவப்பு,0,0,1,1
33552,نتائج,0,0,1,1
30649,çeken,0,0,1,1
33553,ಪ್ರಯಾಣಿಸಿತು,0,0,1,1
33554,успех,0,0,1,1
30650,rubíes,0,0,1,1
30651,ആകർഷകവും,0,0,1,1
35922,ಎಲ್ಲ,0,0,1,1
35919,вырастет,0,0,1,1
30653,mi‑,0,0,1,1
30654,небеса,0,0,1,1
30655,vakgebied,0,0,1,1
30656,ganz,0,0,1,1
35921,கொண்டிருந்தது,0,0,1,1
30657,इंटरफ़ेस,0,0,1,1
30625,stipule,0,0,1,1
35938,تشعر,0,0,1,1
33544,നാണ്,0,0,1,1
33538,δυσκολία,0,0,1,1
33535,техническое,0,0,1,1
2044,eventuali,1,1,0,1
33537,huwelijk,0,0,1,1
35957,मेनवल,0,0,1,1
33281,направляются,0,0,1,1
1689,partecipativa,1,1,0,1
30596,stad,0,0,1,1
1687,sostenne,1,1,0,1
33280,semence ,0,0,1,1
35954,സാമാന്യവത്കരണം,0,0,1,1
30598,உதவுவீர்கள்,0,0,1,1
30599,apropriado,0,0,1,1
30600,curation,0,0,1,1
33539,ഫെബ്രുവരിയിൽ‍,0,0,1,1
33282,قليلا,0,0,1,1
30592,нильса,0,0,1,1
30602,ஒருமுறை,0,0,1,1
35964,temario,0,0,1,1
30586,قانون,0,0,1,1
33290,verwechseln,0,0,1,1
33289,رأته,0,0,1,1
2089,altoparlanti,1,1,0,1
33530,त्वरित,0,0,1,1
30588,biblique,0,0,1,1
35963,தினசரி,0,0,1,1
30590,metadata,0,0,1,1
33286,കാമുകിയോ,0,0,1,1
33532,الفارسية,0,0,1,1
30589,categorias,0,0,1,1
33285,låne,0,0,1,1
33284,regardèrent,0,0,1,1
35961,communitywide,0,0,1,1
30601,المتمثل,0,0,1,1
35953,förblir,0,0,1,1
30623,сотен,0,0,1,1
33543,collabore,0,0,1,1
2090,capisco,1,1,0,1
30614,insa,0,0,1,1
1691,riporta,1,1,0,1
30615,еду,0,0,1,1
30616,uk •,0,0,1,1
30617,değiştirdi,0,0,1,1
1693,fiducia,1,1,0,1
33277,account,0,0,1,1
2091,ricordarti,1,1,0,1
30619,avènement,0,0,1,1
30620,şaşkınlık,0,0,1,1
35940,bedenker,0,0,1,1
30622,قواعده,0,0,1,1
35939,തരാം,0,0,1,1
35943,"
bretão",0,0,1,1
35944,لتتعلم,0,0,1,1
2468,lati,1,1,0,1
35949,dejaste,0,0,1,1
35951,ഇസ്രായേൽപാലസ്തീൻ,0,0,1,1
33540,åbent,0,0,1,1
2466,aspetta,1,1,0,1
35950,الفاخرة,0,0,1,1
30607,skall,0,0,1,1
30608,proporcionaron,0,0,1,1
30610,verspreiding,0,0,1,1
35945,φέτος,0,0,1,1
30611,earliest,0,0,1,1
30612,يشمل,0,0,1,1
35948,diyorsunuz,0,0,1,1
35947,неудач,0,0,1,1
35946,narcissushand,0,0,1,1
2465,cancellare,1,1,0,1
30665,образования,0,0,1,1
35910,lanserat,0,0,1,1
30735,ചെയ്തതുമായ,0,0,1,1
30668,rousseau,0,0,1,1
35868,ترغب,0,0,1,1
35867,जानी,0,0,1,1
35866,ആശയക്കുഴപ്പത്തിലാകുന്നത്,0,0,1,1
30713,denuncias,0,0,1,1
33236,концепцию,0,0,1,1
30714,percevait,0,0,1,1
30715,അത്താഴത്തിന്,0,0,1,1
33235,डच,0,0,1,1
33234,كمتمم,0,0,1,1
33572,وأنواع,0,0,1,1
33573,« éducation »,0,0,1,1
35863,réparé,0,0,1,1
33574,جيدا,0,0,1,1
2105,sorridere,1,1,0,1
30717,traducido,0,0,1,1
30712,रैंक,0,0,1,1
35870,критерии,0,0,1,1
35871,keşke,0,0,1,1
30708,awareness,0,0,1,1
33240,ಮಾಡುತ್ತೇನೆಂದರೆ,0,0,1,1
30705,erfgoed,0,0,1,1
30706,λεξικού,0,0,1,1
35876,maravilhoso,0,0,1,1
30707,biaisé,0,0,1,1
35875,للتكرار,0,0,1,1
35874,хотела,0,0,1,1
30711,டெர்ரியைப்,0,0,1,1
35873,മലയാളഭാഷയിൽ,0,0,1,1
35872,censée,0,0,1,1
30709,μπερδεμένοι,0,0,1,1
33238,hemlighet,0,0,1,1
30710,ومثقف,0,0,1,1
33237,سلطات,0,0,1,1
30719,மூலமே,0,0,1,1
30720,cycles,0,0,1,1
30721,основателей,0,0,1,1
33225,kalmaktadır,0,0,1,1
35855,esams,0,0,1,1
33582,விட்டால்,0,0,1,1
35853,ಹಿಟ್ಟು,0,0,1,1
30729,угрожают,0,0,1,1
2039,presuppone,1,1,0,1
35852,seçimler,0,0,1,1
2457,cuocere,1,1,0,1
30727,ചെയ്യാനോ,0,0,1,1
30732,"
प्राचीन",0,0,1,1
30733,aparecían,0,0,1,1
33586,establishes,0,0,1,1
35851,रहें,0,0,1,1
30734,женщина,0,0,1,1
35850,ickeadministratörer,0,0,1,1
33581,hetgeen,0,0,1,1
35857,വെള്ളിയാഴ്ചയാണെങ്കിൽ,0,0,1,1
30722,lock,0,0,1,1
33577,uncertainty,0,0,1,1
30723,ejes,0,0,1,1
35860,översättningar,0,0,1,1
33576,ميدياويكي،,0,0,1,1
2459,seguire,1,1,0,1
33230,pronoun,0,0,1,1
35859,комиксе,0,0,1,1
33229,escritores,0,0,1,1
33226,असाधारण,0,0,1,1
33578,ámbito,0,0,1,1
33579,ordnade,0,0,1,1
33228,प्रभाविकता,0,0,1,1
33227,девушка,0,0,1,1
33580,tv,0,0,1,1
30726,stilmallar,0,0,1,1
35878,законов,0,0,1,1
30704,الويكيبيديات،,0,0,1,1
33241,വേണ്ടത്,0,0,1,1
33251,независимыми,0,0,1,1
30681,wealth,0,0,1,1
30682,suitable,0,0,1,1
2461,lottato,1,1,0,1
2041,chiaro,1,1,0,1
33253,сфера,0,0,1,1
33560,τάξη,0,0,1,1
35901,γνώμη,0,0,1,1
35905,ഒഴിവാക്കുന്നു,0,0,1,1
30684,حالك,0,0,1,1
33561,ಹಿಸಿದಂತೆ,0,0,1,1
33250,beslutsgång,0,0,1,1
35900,сохраняют,0,0,1,1
33562,ييل,0,0,1,1
35899,உணர்த்தியுள்ளது,0,0,1,1
30680,güiquipedia,0,0,1,1
35906,нанять,0,0,1,1
30686,bedömas,0,0,1,1
1701,umana,1,1,0,1
30669,ആയിട്ടും,0,0,1,1
33254,ενδιαφέρουσα,0,0,1,1
30670,பிழைத்திருத்தத்திற்குப்,0,0,1,1
33557,docka,0,0,1,1
30672,நிரல்,0,0,1,1
30673,intervals,0,0,1,1
33558,ασημένιο,0,0,1,1
35907,"
रोमान्श",0,0,1,1
30674,حفلة,0,0,1,1
30675,knol —,0,0,1,1
2462,tenute,1,1,0,1
30677,മെയിൽ,0,0,1,1
30678,प्रक्टिसस,0,0,1,1
30679,கண்டது,0,0,1,1
35898,ई,0,0,1,1
35897,nationalities,0,0,1,1
33243,campanha,0,0,1,1
30698,intonatie,0,0,1,1
35887,पेटेंट,0,0,1,1
2102,orientamenti,1,1,0,1
30697,подобная,0,0,1,1
35886,greenhouse,0,0,1,1
35885,aufhörte,0,0,1,1
35884,startades,0,0,1,1
33246,естественнонаучной,0,0,1,1
30696,अनुवादित,0,0,1,1
33245,போலி,0,0,1,1
2104,cresceva,1,1,0,1
2040,telegiornale,1,1,0,1
30700,ستستخدمها,0,0,1,1
35881,franchi,0,0,1,1
2460,pubbliche,1,1,0,1
35888,защиту,0,0,1,1
30695,результатах,0,0,1,1
33249,விடைபெற,0,0,1,1
35895,மாதம்,0,0,1,1
33248,ऊर्जा,0,0,1,1
35896,телефон,0,0,1,1
30688,ट्रस्ट,0,0,1,1
30689,ध्वजांकित,0,0,1,1
30690,entières,0,0,1,1
33565,நகரும்,0,0,1,1
35894,முக்கியமாகத்,0,0,1,1
30694,chapters,0,0,1,1
30692,होफ्लिंग,0,0,1,1
35893,subcampo,0,0,1,1
30693,alentar,0,0,1,1
35891,cumhuriyeti,0,0,1,1
35890,maladies,0,0,1,1
35889,guldbrödet,0,0,1,1
35382,snegl,0,0,1,1
31385,интернетсправочником,0,0,1,1
35380,burası,0,0,1,1
34641,സ്വതന്ത്രമായ,0,0,1,1
32036,σοβαρά,0,0,1,1
32619,geroepen,0,0,1,1
34639,wijzigen,0,0,1,1
34101,പ്രശ്‌നമില്ല,0,0,1,1
32617,dénonçant,0,0,1,1
32615,υποστηρίζει,0,0,1,1
34638,تشكل,0,0,1,1
32037,"
टारण्टीनो",0,0,1,1
32038,overdrijven,0,0,1,1
32613,derefter,0,0,1,1
32612,juridiska,0,0,1,1
32611,lykønske,0,0,1,1
34634,ವಾಕ್ಯ,0,0,1,1
32040,കണ്ടിട്ട്,0,0,1,1
32041,caltechstudenten,0,0,1,1
32621,சுவாசிக்க,0,0,1,1
34100,ஆச்சரியப்பட்டாள்,0,0,1,1
32649,அல்லவா,0,0,1,1
1863,descrivevano,1,1,0,1
32030,nat,0,0,1,1
32628,langsame,0,0,1,1
34648,tomo,0,0,1,1
32626,जेन्नी,0,0,1,1
34647,privacidad,0,0,1,1
32031,registrar,0,0,1,1
32032,ക്ലസ്റ്ററിംഗിലൂടെ,0,0,1,1
2273,prontamente,1,1,0,1
32625,regresión,0,0,1,1
34097,υψηλότερης,0,0,1,1
32624,நூலகம்,0,0,1,1
32623,कहेगा,0,0,1,1
34643,наш,0,0,1,1
34099,എടുക്കാൻ,0,0,1,1
32034,erzählte,0,0,1,1
32608,диване,0,0,1,1
32607,honderden,0,0,1,1
34632,emerged,0,0,1,1
32606,değiştirmesini,0,0,1,1
32051,அறிவித்தார்,0,0,1,1
32599,പങ്കിടാൻ,0,0,1,1
34109,visuelle,0,0,1,1
1866,guscio,1,1,0,1
2201,ˌwiːkiˈpiːdiə,1,1,0,1
34110,kopiere,0,0,1,1
34620,yazılan,0,0,1,1
32597,instituciones,0,0,1,1
32052,spitz,0,0,1,1
34111,yapmadan,0,0,1,1
32596,ഭാഗവും,0,0,1,1
32595,enten,0,0,1,1
34618,entendrez,0,0,1,1
1944,vede,1,1,0,1
32054,philippines,0,0,1,1
34622,apporté,0,0,1,1
34623,ألست,0,0,1,1
1865,azioni,1,1,0,1
32604,dialetos,0,0,1,1
34104,எடுத்தால்,0,0,1,1
34631,slight,0,0,1,1
32044,digitais,0,0,1,1
34630,одежды,0,0,1,1
34629,"
tártaro",0,0,1,1
34628,കണ്ടെത്തുക,0,0,1,1
32046,journalister,0,0,1,1
32050,inelegant,0,0,1,1
34627,resulte,0,0,1,1
34626,الواضح,0,0,1,1
34105,ويكيبيديا؟,0,0,1,1
32603,sekunde,0,0,1,1
32602,repetición,0,0,1,1
32049,"
basquir",0,0,1,1
2274,rallegrare,1,1,0,1
32028,tutabilmek,0,0,1,1
32027,publicitaire,0,0,1,1
34673,bachelet,0,0,1,1
34679,व्यवधान,0,0,1,1
32643,preservar,0,0,1,1
1856,l’apprendimento,1,1,0,1
34087,« moments,0,0,1,1
32002,ritt,0,0,1,1
34677,schrijfstijl,0,0,1,1
32003,صحتك,0,0,1,1
32004,ಅವಳೊಂದಿಗೆ,0,0,1,1
34676,observada,0,0,1,1
32006,gebiet,0,0,1,1
32007,düğme,0,0,1,1
34088,zulke,0,0,1,1
32008,öneriler,0,0,1,1
32009,كوم,0,0,1,1
2278,utilizzatori,1,1,0,1
34680,océaniques,0,0,1,1
32644,انتقاد,0,0,1,1
32646,प्रतिनिधि,0,0,1,1
34684,ettusen,0,0,1,1
31994,consistem,0,0,1,1
34688,بالنقر,0,0,1,1
34687,डालना।,0,0,1,1
31995,götürürüm,0,0,1,1
34685,vecteurs,0,0,1,1
31996,ˌwɪkɨˈpiːdiə,0,0,1,1
34085,αγωνίστηκε,0,0,1,1
34086,يمرر,0,0,1,1
2279,gestisce,1,1,0,1
34683,hulp,0,0,1,1
32000,ρωτήσει,0,0,1,1
32001,вправе,0,0,1,1
34682,langweilig,0,0,1,1
34681,βάση,0,0,1,1
34674,wishes,0,0,1,1
34672,ബന്ധപ്പെട്ടിരിക്കുന്നു,0,0,1,1
32629,σπόρους,0,0,1,1
34671,திரைப்படங்களுக்குச்,0,0,1,1
34660,defines,0,0,1,1
32632,തീരുമാനിക്കേണ്ടതുണ്ട്,0,0,1,1
34657,बताएंगे,0,0,1,1
1858,stamattina,1,1,0,1
34093,volverse,0,0,1,1
32021,travels,0,0,1,1
34095,redirecionamento,0,0,1,1
34096,ವಿಶೇಷವಾಗಿ,0,0,1,1
32023,enfados,0,0,1,1
2277,autorevole,1,1,0,1
34653,എന്നതുപോലെയല്ല,0,0,1,1
32025,ഉച്ചകഴിഞ്ഞ്,0,0,1,1
34652,பிட்,0,0,1,1
34651,formulerer,0,0,1,1
32026,"
आयमार",0,0,1,1
34661,असफल,0,0,1,1
32633,instalaciones,0,0,1,1
34662,  €,0,0,1,1
34668,provision,0,0,1,1
32640,cooperation,0,0,1,1
32639,simulationbased,0,0,1,1
1857,sentire,1,1,0,1
34669,ಮನೋರಂಜನಾ,0,0,1,1
32638,ശ്രമിക്കുക,0,0,1,1
32014,« sibérien »,0,0,1,1
32637,примере,0,0,1,1
32634,услуга,0,0,1,1
34090,المفضلة,0,0,1,1
32635,surveillés,0,0,1,1
34664,медицинским,0,0,1,1
34091,serez,0,0,1,1
34663,ganado,0,0,1,1
32016,heavily,0,0,1,1
32055,voit,0,0,1,1
32593,وسيمًا,0,0,1,1
32056,الفرعي,0,0,1,1
32115,updating,0,0,1,1
34584,antidühring ,0,0,1,1
32109,कैलिफोर्निया,0,0,1,1
34583,ಮೂಲಗಳನ್ನು,0,0,1,1
34134,noyer,0,0,1,1
34582,മാർച്ച്,0,0,1,1
1870,paesi,1,1,0,1
32110,வீட்டுப்பாடம்,0,0,1,1
32111,wasser,0,0,1,1
34135,bağlamında,0,0,1,1
32568,عليهم,0,0,1,1
34136,ಭಾರೀ,0,0,1,1
34137,குறிக்கப்,0,0,1,1
32566,विधि,0,0,1,1
32565,satisfactory,0,0,1,1
1871,attivamente,1,1,0,1
32108,عربته,0,0,1,1
32107,"
तिब्बती",0,0,1,1
34133,redistribution,0,0,1,1
34131,summary,0,0,1,1
1942,progettare,1,1,0,1
32099,ilícita,0,0,1,1
34590,abendessen,0,0,1,1
34589,frihed,0,0,1,1
32100,löst,0,0,1,1
34130,intet,0,0,1,1
32101,ರಜೆ,0,0,1,1
32106,الإصدارات،,0,0,1,1
34588,paradoxo,0,0,1,1
34132,പോകാനുള്ള,0,0,1,1
34587,uncyclopedia,0,0,1,1
32570,കളികൾ,0,0,1,1
32103,coopératif »,0,0,1,1
32104,sud,0,0,1,1
32113,കാര്യത്തിനിടയിലാണെങ്കിൽ,0,0,1,1
1875,relazioni,1,1,0,1
34592,растущего,0,0,1,1
34574,الجرس,0,0,1,1
34566,derste,0,0,1,1
32561,फंसेंगे,0,0,1,1
32128,किताब,0,0,1,1
32129,confidencialmente,0,0,1,1
32130,internetvrienden,0,0,1,1
32131,بمقدار,0,0,1,1
32560,nysade,0,0,1,1
32133,ಪುನರಾರಂಭಿಸಿ,0,0,1,1
34565,encontramos,0,0,1,1
34564,wikitrust,0,0,1,1
34563,राय।,0,0,1,1
32134,المجموعة,0,0,1,1
34562,lingüística,0,0,1,1
32136,بعمق,0,0,1,1
34561,இவ்விணையப்,0,0,1,1
34567,डालने,0,0,1,1
34568,entorpecen,0,0,1,1
32127,ನೀಡಿ,0,0,1,1
32122,وتوزيع,0,0,1,1
32116,naaktslak,0,0,1,1
32117,compitieron,0,0,1,1
32120,покупать,0,0,1,1
32121,wäsche,0,0,1,1
34573,i̇çeriklerin,0,0,1,1
32564,амстердаме,0,0,1,1
34572,egentligen,0,0,1,1
32126,некоего,0,0,1,1
32563,coração,0,0,1,1
1876,descrizione,1,1,0,1
32562,അടിസ്ഥാനമാക്കിയാണ്,0,0,1,1
32125,администраторам,0,0,1,1
34139,kıkırdıyordu,0,0,1,1
34140,அறிமுகப்படுத்தியது,0,0,1,1
32098,avancement,0,0,1,1
32571,aanstelling,0,0,1,1
32592,ವ್ಯವಹಾರವು,0,0,1,1
32076,schlief,0,0,1,1
34115,വിദ്യാർത്ഥികൾക്കായുള്ള,0,0,1,1
34611,macht,0,0,1,1
34610,ಆಘಾತಕ್ಕೊಳಗಾಗಿದ್ದಳು,0,0,1,1
32070,υπέρμαχο,0,0,1,1
32072,tillsvidare,0,0,1,1
32585,disposent,0,0,1,1
34609,disiez,0,0,1,1
32584,mistaken,0,0,1,1
34608,വീഡിയോയിൽ‌,0,0,1,1
2271,immunitario,1,1,0,1
2270,respingeva,1,1,0,1
34117,உட்கார்ந்திருந்த,0,0,1,1
32583,வரும்,0,0,1,1
1868,complesse,1,1,0,1
34606,आजादी,0,0,1,1
32587,обучению,0,0,1,1
32588,nogensinde,0,0,1,1
32069,جعل,0,0,1,1
32060,κατανοητή,0,0,1,1
32058,kommentarsfält,0,0,1,1
34617,autoconfirmados,0,0,1,1
32059,попали,0,0,1,1
34616,précis,0,0,1,1
34615,professionnelle,0,0,1,1
32591,பொதேரி’,0,0,1,1
34614,sugiriendo,0,0,1,1
32589,controversas,0,0,1,1
32061,المواد,0,0,1,1
32062,estime,0,0,1,1
32064,knepig,0,0,1,1
32065,dénonce,0,0,1,1
32066,поддержанию,0,0,1,1
32068,தகவல்களைக்,0,0,1,1
32580,гдето,0,0,1,1
32077,skiljer,0,0,1,1
32097,kullanabileceğinizi,0,0,1,1
32079,английская —,0,0,1,1
32575,dönüyor,0,0,1,1
34599,conflitantes,0,0,1,1
34598,അതുമായി,0,0,1,1
32090,услышите,0,0,1,1
34127,യാത്ര,0,0,1,1
1943,studiati,1,1,0,1
32574,hermana,0,0,1,1
32573,eliminador,0,0,1,1
34596,entschuldige,0,0,1,1
32091,പേജില്,0,0,1,1
34595,infantiles,0,0,1,1
32092,prestes,0,0,1,1
32095,нуждаются,0,0,1,1
34593,likewise,0,0,1,1
2203,ricca,1,1,0,1
34125,топологий,0,0,1,1
34600,ലഭിച്ചത്,0,0,1,1
34601,живая,0,0,1,1
2269,epico,1,1,0,1
32080,susningal,0,0,1,1
32081,पत्र,0,0,1,1
34120,circumstances,0,0,1,1
32083,версиями,0,0,1,1
32578,phusika,0,0,1,1
32085,பெறுவாள்,0,0,1,1
34604,eric,0,0,1,1
34602,arrastrar,0,0,1,1
32577,مستقل,0,0,1,1
34122,വരാം,0,0,1,1
32089,mercury,0,0,1,1
32576,noter,0,0,1,1
34123,भले,0,0,1,1
34124,devenus,0,0,1,1
32648,droger,0,0,1,1
34690,coutumières,0,0,1,1
1838,rumore,1,1,0,1
34777,encima,0,0,1,1
32707,المستخدم،,0,0,1,1
34776,hegemony,0,0,1,1
32706,கட்டுரையை,0,0,1,1
34775,ಫಲಿತಾಂಶವನ್ನು,0,0,1,1
31884,ಟಿಪ್,0,0,1,1
34773,والدتي,0,0,1,1
32705,pérennité,0,0,1,1
34041,skrive,0,0,1,1
31885,poleret,0,0,1,1
32704,publishes,0,0,1,1
31886,coordenados,0,0,1,1
34043,diğerinin,0,0,1,1
31887,goto,0,0,1,1
31888,saken,0,0,1,1
34044,oliver,0,0,1,1
2289,reati,1,1,0,1
2290,amata,1,1,0,1
31993,تتحرك,0,0,1,1
31881,documentação,0,0,1,1
34787,çalışabilir,0,0,1,1
34786,подчеркнуть,0,0,1,1
34039,yazının,0,0,1,1
34785,opkalder,0,0,1,1
31876,தனித்து,0,0,1,1
34784,boş,0,0,1,1
34783,واحدًا,0,0,1,1
34782,ищете,0,0,1,1
32709,​​geräusch,0,0,1,1
34780,mirada,0,0,1,1
31877,depicted,0,0,1,1
34779,اجتماعية،,0,0,1,1
31878,opmerking,0,0,1,1
31879,diciéndome,0,0,1,1
34040,educativas,0,0,1,1
31890,जयादा,0,0,1,1
32701,kökler,0,0,1,1
34771,результатом,0,0,1,1
34770,ഓപ്റ്റിക്കൽ,0,0,1,1
31907,торговом,0,0,1,1
31908,texter,0,0,1,1
32692,« fin,0,0,1,1
34048,लिखें,0,0,1,1
34049,ക്ലിക്കുചെയ്ത്,0,0,1,1
31910,minde,0,0,1,1
32691,« portail »,0,0,1,1
32690,хороши,0,0,1,1
34758,ترقية,0,0,1,1
34757,ಕಲಿಕೆ,0,0,1,1
34756,demostró,0,0,1,1
34755,ഉപയോഗം,0,0,1,1
34754,स्वाद।,0,0,1,1
34050,entera,0,0,1,1
34051,التقدير,0,0,1,1
31906,argon,0,0,1,1
34761,تراقبها,0,0,1,1
32695,உதவுகிறது,0,0,1,1
31896,ചരിത്രവും,0,0,1,1
31893,bytes,0,0,1,1
32699,kede,0,0,1,1
34769,appelant,0,0,1,1
31894,corrigen,0,0,1,1
32698,الإعلام,0,0,1,1
2189,contempo,1,1,0,1
2288,usino,1,1,0,1
2286,sullo,1,1,0,1
1846,infrastruttura,1,1,0,1
2287,classificazione,1,1,0,1
34766,للتخلص,0,0,1,1
31900,connexions,0,0,1,1
32696,καναπέ,0,0,1,1
31902,inclure,0,0,1,1
31875,olmayın,0,0,1,1
32710,aniden,0,0,1,1
2292,noto,1,1,0,1
34797,தேடு,0,0,1,1
32732,центре,0,0,1,1
32731,spéciale,0,0,1,1
34805,‘பேச்சுப்பக்கம்’,0,0,1,1
32730,مشروب,0,0,1,1
2296,raccontare,1,1,0,1
33399,sarayımda,0,0,1,1
34802,ombads,0,0,1,1
31847,μαντέψουν,0,0,1,1
32729,സ്വപ്നങ്ങളിൽ,0,0,1,1
2295,collaborare,1,1,0,1
31849,துடிக்கிறது,0,0,1,1
32728,opérationnellement,0,0,1,1
34799,urls,0,0,1,1
34798,ranting,0,0,1,1
31850,providence,0,0,1,1
31845,المجهولين،,0,0,1,1
31844,leer,0,0,1,1
34029,rato,0,0,1,1
34028,unevenness,0,0,1,1
34813,जाऊंगा।,0,0,1,1
34027,കടത്തി,0,0,1,1
34812,foutjes,0,0,1,1
31837,дилемма,0,0,1,1
34811,"
अप्रैल",0,0,1,1
31838,questão,0,0,1,1
34810,escándalos,0,0,1,1
31843,conjunctions,0,0,1,1
34809,தாண்டின,0,0,1,1
32733,doté,0,0,1,1
34808,flourish,0,0,1,1
31841,रुकें।,0,0,1,1
31842,جامعيون,0,0,1,1
34807,"
थाई",0,0,1,1
31851,civiques,0,0,1,1
32727,dressed,0,0,1,1
34038,выучите,0,0,1,1
34796,yararlanmasına,0,0,1,1
32716,cut,0,0,1,1
34792,അമിതപ്രാധാന്യമാവാം,0,0,1,1
34791,ലഭ്യമായതിനാൽ,0,0,1,1
31864,முந்தையவை,0,0,1,1
31866,amid,0,0,1,1
1845,nominata,1,1,0,1
31868,düşünmeme,0,0,1,1
34789,تيمز،,0,0,1,1
31869,encyclopedia،,0,0,1,1
32714,disseminação,0,0,1,1
34788,dropped,0,0,1,1
2294,divenuta,1,1,0,1
2293,compatibile,1,1,0,1
32711,repeating,0,0,1,1
31873,кемто,0,0,1,1
32717,vlees,0,0,1,1
34793,επιλογές,0,0,1,1
34794,കേട്ടിരിക്കാം,0,0,1,1
32721,proprietär,0,0,1,1
34031,mélisse,0,0,1,1
31853,tim,0,0,1,1
31854,موضعاً,0,0,1,1
32725,sorters,0,0,1,1
31855,vänta,0,0,1,1
32722,வைத்து,0,0,1,1
34032,சொல்லிலிருந்து,0,0,1,1
2182,doppio,1,1,0,1
31856,wikipediarelated,0,0,1,1
32720,ആരംഭിക്കാനുള്ള,0,0,1,1
34033,βικιεπιστήμιο,0,0,1,1
34034,accueille,0,0,1,1
31858,corrigées,0,0,1,1
31859,கிடைக்கும்படியான,0,0,1,1
31913,parents,0,0,1,1
2190,relazionali,1,1,0,1
31915,φέρεσαι,0,0,1,1
32660,πρακτική,0,0,1,1
34716,χρησιμοποιούμε,0,0,1,1
31967,русскоязычной,0,0,1,1
31968,ωραίο,0,0,1,1
2194,rappresentativa,1,1,0,1
32665,oneerlijke,0,0,1,1
34715,km,0,0,1,1
32664,வர்த்தகம்,0,0,1,1
31969,nude,0,0,1,1
32663,عيون,0,0,1,1
34714,humorista,0,0,1,1
32662,webbserver,0,0,1,1
31971,ആളുണ്ടെന്നർഥം,0,0,1,1
34077,അനുബദ്ധ,0,0,1,1
34712,التقليدية,0,0,1,1
34078,engelen,0,0,1,1
34717,adoro,0,0,1,1
34718,الجنساني,0,0,1,1
2283,perfetto,1,1,0,1
31957,kultur,0,0,1,1
34072,adieux,0,0,1,1
31955,появилось,0,0,1,1
34073,çılgın,0,0,1,1
32670,κανονικό,0,0,1,1
31956,принял,0,0,1,1
1851,siamo,1,1,0,1
2284,complicati,1,1,0,1
34719,centrar,0,0,1,1
31961,مثلك,0,0,1,1
32669,ontmoeting,0,0,1,1
34075,homossexual,0,0,1,1
31962,തിരക്കിലായിരുന്നതിനാൽ,0,0,1,1
31964,poupée,0,0,1,1
31965,terörist,0,0,1,1
34711,africa,0,0,1,1
31972,anciennes,0,0,1,1
34070,könnten,0,0,1,1
32659,ഉപയോഗിക്കും,0,0,1,1
34702,farm,0,0,1,1
34701,മലയാളത്തിലാണ്,0,0,1,1
31985,günümüz,0,0,1,1
31986,interrogación,0,0,1,1
34699,forestation,0,0,1,1
34698,പിടിച്ചില്ലെങ്കിൽ‌,0,0,1,1
34697,kişiye,0,0,1,1
31987,nauruano,0,0,1,1
32650,أسألك,0,0,1,1
31988,emeralds,0,0,1,1
34082,proibições,0,0,1,1
34693,caption,0,0,1,1
31990,ಖಚಿತವಾಗಿದೆಯೆ,0,0,1,1
31992,contratálo,0,0,1,1
34083,സാങ്കേതികവിദ്യയിൽ,0,0,1,1
31984,городах,0,0,1,1
34703,ബുദ്ധിമുട്ടാണെന്നകാര്യം,0,0,1,1
32651,φροντίζετε,0,0,1,1
31977,variadíssimos,0,0,1,1
34709,ال,0,0,1,1
32658,bronnen,0,0,1,1
2281,analitico,1,1,0,1
31975,συνεχίσεις,0,0,1,1
2196,mostrati,1,1,0,1
34708,iso,0,0,1,1
31980,viaf,0,0,1,1
34704,oluşur,0,0,1,1
31981,ಕೇಳುತ್ತಿದ್ದರೆ,0,0,1,1
32654,പ്രവചിക്കുന്ന,0,0,1,1
32653,miraron,0,0,1,1
31983,vivre,0,0,1,1
34705,பக்கக்,0,0,1,1
34081,كيو,0,0,1,1
34071,astra,0,0,1,1
32671,أصابعي,0,0,1,1
34752,സ്വർണ്ണമായും,0,0,1,1
34737,γωνία—αυτή,0,0,1,1
31930,सिस्टम,0,0,1,1
34056,hicieras,0,0,1,1
31933,திட்டத்தை,0,0,1,1
34745,पडेगा,0,0,1,1
31934,convergentes,0,0,1,1
34057,посадить,0,0,1,1
31935,identifique,0,0,1,1
34743,saline,0,0,1,1
31936,engraçado,0,0,1,1
34742,kilometers,0,0,1,1
34741,المربيات,0,0,1,1
34740,amacıyla,0,0,1,1
34739,existido,0,0,1,1
34738,náhuatl,0,0,1,1
1954,observatory,1,1,0,1
31929,adición,0,0,1,1
34746,çalışmalarda,0,0,1,1
31928,erudita,0,0,1,1
31920,trokken,0,0,1,1
34052,കൂടിയ,0,0,1,1
34751,वर्षों,0,0,1,1
31917,debris,0,0,1,1
31918,уме,0,0,1,1
34053,personnalité,0,0,1,1
31919,التصنيف,0,0,1,1
34054,вскоре,0,0,1,1
34747,machine »,0,0,1,1
31922,huvudsakliga,0,0,1,1
34055,sexton,0,0,1,1
31923,befördert,0,0,1,1
31924,необходимых,0,0,1,1
31926,sujetos,0,0,1,1
31927,डिलीट,0,0,1,1
31937,strukturerat,0,0,1,1
32684,actualisation,0,0,1,1
31953,பதிப்புக்களில்,0,0,1,1
34060,corollaire,0,0,1,1
2192,descrizioni,1,1,0,1
31946,comprends,0,0,1,1
31947,البحث،,0,0,1,1
31948,കൊണ്ടുപോകും,0,0,1,1
34064,посмотрели,0,0,1,1
32675,buydu,0,0,1,1
34726,ταπεινή,0,0,1,1
34065,ಕಾರ್ಯನಿರ್ವಹಿಸುತ್ತಿದ್ದರೆ,0,0,1,1
34066,bouleverser,0,0,1,1
34067,oiseau,0,0,1,1
31951,ændre,0,0,1,1
2193,«il,1,1,0,1
34725,"
लिगुरियाई",0,0,1,1
32672,प्रयत्न,0,0,1,1
34069,кэше,0,0,1,1
31945,confirmó,0,0,1,1
34062,φρικάρω,0,0,1,1
32677,осуществляет,0,0,1,1
34732,японии,0,0,1,1
34736,متفاجئة,0,0,1,1
31939,databasdumpar,0,0,1,1
34733,delicados,0,0,1,1
32682,മാതൃകാ,0,0,1,1
31940,söylenmeyecek,0,0,1,1
32680,க்குச்,0,0,1,1
32679,kleid,0,0,1,1
31943,பட்டியல்,0,0,1,1
34730,ولطيفة,0,0,1,1
34729,поле,0,0,1,1
31941,infelizmente,0,0,1,1
31942,etmek”,0,0,1,1
34728,dilden,0,0,1,1
32678,empregam,0,0,1,1
34560,издавался,0,0,1,1
34142,¿pueden,0,0,1,1
34559,καταπληκτικού,0,0,1,1
32477,återge,0,0,1,1
32335,filmlerde,0,0,1,1
2238,telefonata,1,1,0,1
34236,δεύτερο,0,0,1,1
32476,mainstream,0,0,1,1
34381,हटाने,0,0,1,1
34380,infinitamente,0,0,1,1
34237,ertrinke,0,0,1,1
32341,people ,0,0,1,1
34376,موقعًا,0,0,1,1
1908,svolgeva,1,1,0,1
34374,nyheder,0,0,1,1
32474,perdon,0,0,1,1
34373,compléter,0,0,1,1
32342,siyasi,0,0,1,1
34372,محرريها,0,0,1,1
32334,incrustar,0,0,1,1
32332,аналогична,0,0,1,1
34558,redigerare,0,0,1,1
32331,observateurs,0,0,1,1
2242,sconosciute,1,1,0,1
32324,planın,0,0,1,1
34390,வில்லை,0,0,1,1
32326,പ്രാപ്തിയാക്കുകയും,0,0,1,1
34232,ismine,0,0,1,1
32327,alcanzó,0,0,1,1
34389,rapidly,0,0,1,1
1931,pubblicarle»,1,1,0,1
32330,गूढ़,0,0,1,1
34234,stage,0,0,1,1
1907,ripristinare,1,1,0,1
34386,kopyalamasını,0,0,1,1
32478,मॉल,0,0,1,1
34385,labores,0,0,1,1
34383,chef,0,0,1,1
32343,critical,0,0,1,1
34370,മുകളിലുള്ള,0,0,1,1
32473,«википедия»,0,0,1,1
32344,máquina,0,0,1,1
32352,descubrimiento,0,0,1,1
34359,experienced,0,0,1,1
32354,restricciones,0,0,1,1
32471,കാണുന്നില്ലെന്ന്‌,0,0,1,1
34242,relación,0,0,1,1
32355,входного,0,0,1,1
32356,согласия,0,0,1,1
34356,replied,0,0,1,1
32470,الجنود,0,0,1,1
34243,platz,0,0,1,1
32359,للكتب,0,0,1,1
34244,touristiques,0,0,1,1
32469,reborn,0,0,1,1
32360,ಪ್ರಕಾರ,0,0,1,1
32361,participatória,0,0,1,1
32351,nepbeller,0,0,1,1
34361,paródia,0,0,1,1
34240,tridimensional,0,0,1,1
34366,leihen,0,0,1,1
34369,குதித்தால்,0,0,1,1
1909,tagliato,1,1,0,1
1930,dettaglio,1,1,0,1
32472,açıktır,0,0,1,1
34367,തംബ്‌സ്,0,0,1,1
34239,tratava,0,0,1,1
32346,अपरंपरागत,0,0,1,1
32350,woche,0,0,1,1
34365,ingresan,0,0,1,1
32347,specialområden,0,0,1,1
32348,கோடல்கள்,0,0,1,1
32349,κοινά,0,0,1,1
1910,dichiarò,1,1,0,1
34363,ангела,0,0,1,1
32322,ursäkt,0,0,1,1
32321,предвзятость,0,0,1,1
32320,presenterat,0,0,1,1
32306,ahogamiento,0,0,1,1
34216,"
ब्रिटन",0,0,1,1
34217,рассказ,0,0,1,1
34218,intervenant,0,0,1,1
34424,funktion,0,0,1,1
2243,secondaria,1,1,0,1
34422,लेखेजोखे,0,0,1,1
1934,inconsistenze,1,1,0,1
34421,സന്തോഷമുണ്ട്,0,0,1,1
34220,primaires,0,0,1,1
34420,felicitar,0,0,1,1
32486,acordados,0,0,1,1
32303,acordei,0,0,1,1
32304,медленном,0,0,1,1
34418,बढ़ेगा,0,0,1,1
34417,അപ്പപ്പോഴത്തെ,0,0,1,1
34215,удалена,0,0,1,1
32488,количества,0,0,1,1
32300,ettiler,0,0,1,1
34210,juiz,0,0,1,1
2217,negoziabile,1,1,0,1
34429,afogando,0,0,1,1
32291,mover,0,0,1,1
34208,ستعجبك,0,0,1,1
32292,большую,0,0,1,1
34209,بياني,0,0,1,1
32293,davada,0,0,1,1
32299,supervisor,0,0,1,1
1936,educatamente,1,1,0,1
32295,ಹೇಳಿದ್ದು,0,0,1,1
34212,റെയിൽ‌വേ,0,0,1,1
32297,സൂചിപ്പിക്കുന്നു,0,0,1,1
34426,geheim,0,0,1,1
32298,φίλη,0,0,1,1
32305,മെലിസ,0,0,1,1
2219,avvenuto,1,1,0,1
32480,stoppe,0,0,1,1
1905,regolarmente,1,1,0,1
34403,पात्रों,0,0,1,1
34402,википедия —,0,0,1,1
32316,grundtankarna,0,0,1,1
34401,नियम,0,0,1,1
34400,«verificabilidad»​,0,0,1,1
34227,exclusão,0,0,1,1
34228,hemos,0,0,1,1
34398,سيول,0,0,1,1
32317,auténtico,0,0,1,1
2220,biasvariance,1,1,0,1
32318,المتداولة,0,0,1,1
34397,योंगल,0,0,1,1
34229,സമാനമായ,0,0,1,1
34395,contribuant,0,0,1,1
34394,arkadaşlar,0,0,1,1
34405,proved,0,0,1,1
34406,nerviosos,0,0,1,1
34407,ಸಮಸ್ಯೆಯಾಗಿದೆ,0,0,1,1
32310,democráticamente,0,0,1,1
34222,प्रॉजेक्ट्स,0,0,1,1
34415,വഴിയല്ലാതെ,0,0,1,1
34414,ஈரநிலத்தின்,0,0,1,1
34413,γραμμένη,0,0,1,1
32309,concurrents,0,0,1,1
34223,accumulation,0,0,1,1
34412,lander,0,0,1,1
32313,περιλαμβάνει,0,0,1,1
34411,souhaiter,0,0,1,1
32311,يرام,0,0,1,1
34224,harvested,0,0,1,1
1906,attento,1,1,0,1
34408,dyka,0,0,1,1
32312,ക്രൂരവും,0,0,1,1
34245,antonino,0,0,1,1
32363,pkdd,0,0,1,1
32468,idéalement,0,0,1,1
34299,ارجو,0,0,1,1
34308,remark,0,0,1,1
1920,restringere,1,1,0,1
34306,ഗ്രന്ഥങ്ങളെയും,0,0,1,1
32412,الملح،,0,0,1,1
32413,وبسبب,0,0,1,1
32446,ethnocentrique,0,0,1,1
34264,сложных,0,0,1,1
34265,udtalen,0,0,1,1
2228,presunti,1,1,0,1
34304,அழகிய,0,0,1,1
32416,मंदव्यंजित,0,0,1,1
34266,opgevangen,0,0,1,1
34302,noncommercial,0,0,1,1
34301,المتوسط,0,0,1,1
32417,എന്നിവർ,0,0,1,1
34309,doisje,0,0,1,1
34310,gini,0,0,1,1
32410,dezenas,0,0,1,1
32404,waterways,0,0,1,1
34317,encouraging,0,0,1,1
32401,रोजेनजवीग,0,0,1,1
1919,vìchi,1,1,0,1
34315,blogs,0,0,1,1
32448,ಆಬ್ಟ್ಯೂಸ್,0,0,1,1
34314,علمية كتبت,0,0,1,1
34313,общем,0,0,1,1
32409,மயங்கிவிட்டேன்,0,0,1,1
34312,làdessus,0,0,1,1
34311,maskiner,0,0,1,1
32447,implicaba,0,0,1,1
34262,майкл,0,0,1,1
32407,நுபீடியாவிலிருந்து,0,0,1,1
32408,wikificere,0,0,1,1
34300,verblüffend,0,0,1,1
32418,أقرت,0,0,1,1
32399,முறையான,0,0,1,1
34298,« print,0,0,1,1
32442,मुहम्मद,0,0,1,1
32434,कंजर्वापीडिया,0,0,1,1
32435,juxtaposition,0,0,1,1
32437,விடயங்கள்,0,0,1,1
32438,даллас,0,0,1,1
34285,skeletor,0,0,1,1
32439,commune,0,0,1,1
34274,மொழியில்,0,0,1,1
1923,successive,1,1,0,1
34283,κινείσαι,0,0,1,1
1924,sociologicoculturale,1,1,0,1
34281,ειδήμονες,0,0,1,1
34280,உருவாக்கியவரோ,0,0,1,1
34275,познавательной,0,0,1,1
1926,qualunque,1,1,0,1
32443,καταπληκτικά,0,0,1,1
32431,objections,0,0,1,1
34289,கலைக்களஞ்சிய,0,0,1,1
32421,assumed,0,0,1,1
34297,piscaram,0,0,1,1
1921,testimonianza,1,1,0,1
34268,zwaaiden,0,0,1,1
32419,pms •,0,0,1,1
32420,administratörsval,0,0,1,1
34295,ends,0,0,1,1
32445,λήθαργοι,0,0,1,1
32430,groupes,0,0,1,1
32444,मजेदार,0,0,1,1
32424,tómate,0,0,1,1
32428,بمراجعة,0,0,1,1
34292,сторону,0,0,1,1
34269,പങ്കുവയ്ക്കുന്നു,0,0,1,1
32429,premières,0,0,1,1
32400,ಕೊಡುಗೆಗಳನ್ನು,0,0,1,1
32449,trouwjurk,0,0,1,1
32467,данное,0,0,1,1
32457,नॉर्वेजियाई,0,0,1,1
32374,plattformar,0,0,1,1
2234,loghi,1,1,0,1
1912,distribuzioni,1,1,0,1
32462,hurtigt,0,0,1,1
34341,endeavor,0,0,1,1
34340,samarbejde,0,0,1,1
32376,рэнди,0,0,1,1
32461,научной,0,0,1,1
2222,sfoggio»,1,1,0,1
34338,reklamsız,0,0,1,1
32377,ثاني,0,0,1,1
32378,"
estoniano",0,0,1,1
34250,sokpopaccounts,0,0,1,1
32458,cunt,0,0,1,1
32379,androidenheder,0,0,1,1
34249,शिक्षण,0,0,1,1
34248,eurocentric,0,0,1,1
34345,céus,0,0,1,1
32369,count,0,0,1,1
2221,immaginaria,1,1,0,1
32366,அன்றிரவு,0,0,1,1
32367,ഉള്ളവരായതിനാൽ,0,0,1,1
32368,consécutifs,0,0,1,1
34352,ನಕಲಿ,0,0,1,1
34351,തയ്യാറാണ്,0,0,1,1
34350,ಎಲ್ಲಿಗೆ,0,0,1,1
32463,putting,0,0,1,1
32465,ಕಡೆಗೆ,0,0,1,1
34349,طرف,0,0,1,1
32370,питтсбурга,0,0,1,1
34348,luchadores,0,0,1,1
34347,no—,0,0,1,1
34246,കീഴ്‌വഴക്കവും,0,0,1,1
32381,«votaciones»,0,0,1,1
32456,«энциклопедия»,0,0,1,1
34318,innehållsstyrande,0,0,1,1
34251,soulevé,0,0,1,1
34326,കൂട്ടങ്ങളായി,0,0,1,1
34257,പുനർജീവിച്ചു,0,0,1,1
34258,fourniture,0,0,1,1
34325,comply,0,0,1,1
1915,trasferito,1,1,0,1
32452,मुद्दा,0,0,1,1
32394,അവനോട്‌,0,0,1,1
32451,يقوله,0,0,1,1
32450,fortytwo,0,0,1,1
1917,abbigliamento,1,1,0,1
34321,pertencente,0,0,1,1
2231,probabilisticamente,1,1,0,1
1918,energetica,1,1,0,1
32397,нобелевский,0,0,1,1
32398,ουρανούς,0,0,1,1
34256,ووضوحًا,0,0,1,1
34327,alışveriş,0,0,1,1
34328,ज्यामिति,0,0,1,1
32387,προχώρα,0,0,1,1
34252,تنمو,0,0,1,1
1929,nasa,1,1,0,1
32384,സൗന്ദര്യവും,0,0,1,1
34254,കൈമുതലായുണ്ടാവും,0,0,1,1
32386,acessar,0,0,1,1
34255,middenin,0,0,1,1
32455,lyfter,0,0,1,1
32391,ethane,0,0,1,1
34331,fazerem,0,0,1,1
32454,sıktığım,0,0,1,1
32388,открытие,0,0,1,1
32389,തൽക്ഷണം,0,0,1,1
2224,riunione,1,1,0,1
32390,يشعر,0,0,1,1
32290,indépendant,0,0,1,1
34207,kanada,0,0,1,1
34206,benämnda,0,0,1,1
34507,உதவிக்கு,0,0,1,1
34512,ചിലത്,0,0,1,1
32539,maddesinin,0,0,1,1
2263,derivate,1,1,0,1
32538,solicitud,0,0,1,1
34161,inanimate,0,0,1,1
2262,rimanesse,1,1,0,1
34162,честно,0,0,1,1
32193,консультируются,0,0,1,1
34163,portugueselanguage,0,0,1,1
34510,ಮಾಡೋಣ,0,0,1,1
34509,ದಾಟುತ್ತೀರಿ,0,0,1,1
34508,projelerinde,0,0,1,1
32536,எனப்படும்,0,0,1,1
32194,kopyalamaya,0,0,1,1
2261,rapporto,1,1,0,1
32189,tabiki,0,0,1,1
34513,vinculado,0,0,1,1
34514,प्रशंसात्मक,0,0,1,1
1887,caffè,1,1,0,1
34527,красивый,0,0,1,1
34526,اعتذارى,0,0,1,1
32184,bereiken,0,0,1,1
1883,entrò,1,1,0,1
34523,классические,0,0,1,1
34158,yapmanın,0,0,1,1
32540,huiquipedia,0,0,1,1
32188,kleding,0,0,1,1
34520,നല്ലവനായിരുന്നു,0,0,1,1
34159,താൽപ്പര്യമില്ലെങ്കിൽ,0,0,1,1
34519,sindet,0,0,1,1
32186,element,0,0,1,1
34517,ತಾಳ್ಮೆಯಿಂದ,0,0,1,1
34516,mettant,0,0,1,1
32196,طرقها,0,0,1,1
32534,المزهرة,0,0,1,1
32183,edin,0,0,1,1
32198,δουλέψεις,0,0,1,1
34495,отображать,0,0,1,1
34494,conservées,0,0,1,1
34493,തയ്യാറാക്കുന്നത്,0,0,1,1
34492,الوصمي,0,0,1,1
2208,comun,1,1,0,1
34491,بالعلوم,0,0,1,1
32205,bekostnad,0,0,1,1
34166,bibliotekariens,0,0,1,1
34490,amou,0,0,1,1
32206,moeilijker,0,0,1,1
34489,الصينية,0,0,1,1
34167,plataforma,0,0,1,1
34488,vandalizing,0,0,1,1
34168,mistet,0,0,1,1
32209,beresheet,0,0,1,1
34496,सईनपोस्ट,0,0,1,1
32204,ஒழுங்குபடுத்தப்பட்டிருக்கும்,0,0,1,1
34497,أم,0,0,1,1
1891,ingiustamente,1,1,0,1
32533,wiederholt,0,0,1,1
34506,программы,0,0,1,1
1890,trovo,1,1,0,1
34504,cartes,0,0,1,1
2259,processa,1,1,0,1
32532,ലോസ്സ്,0,0,1,1
34502,تعطلت,0,0,1,1
34498,antielitismo,0,0,1,1
32200,hésitant,0,0,1,1
32202,gedachten,0,0,1,1
34500,varierande,0,0,1,1
1893,misurazione,1,1,0,1
1940,uichipedìa,1,1,0,1
32203,sänkts,0,0,1,1
34528,défauts,0,0,1,1
2264,salvati,1,1,0,1
32529,ಕೇಳುತ್ತಿದೆ,0,0,1,1
32551,ಹಣ,0,0,1,1
32555,βαρύ,0,0,1,1
34554,écrits,0,0,1,1
34147,redacción,0,0,1,1
32554,licensor,0,0,1,1
32154,dépassées,0,0,1,1
32553,freuen,0,0,1,1
34551,formam,0,0,1,1
32155,complejidad,0,0,1,1
1941,capace,1,1,0,1
34149,பொருட்படுத்தவில்லை,0,0,1,1
34549,ಪ್ರಕಾಶಮಾನವಾದ,0,0,1,1
32157,манеры,0,0,1,1
32158,"
arménio",0,0,1,1
34548,массовой,0,0,1,1
32552,artificiel ,0,0,1,1
34555,confusas,0,0,1,1
2266,vorrebbe,1,1,0,1
34556,sonraki,0,0,1,1
34143,പറഞ്ഞതായി,0,0,1,1
32138,wovon,0,0,1,1
32139,топология,0,0,1,1
32141,поанглийски,0,0,1,1
32558,πραγματική,0,0,1,1
32143,சந்தேகம்,0,0,1,1
32557,heette,0,0,1,1
32144,rétribution,0,0,1,1
32556,mimics,0,0,1,1
34557,സൈനികർക്കായി,0,0,1,1
34144,conducta,0,0,1,1
32145,scheibe,0,0,1,1
34145,मददगार,0,0,1,1
32148,práticas,0,0,1,1
32150,внешних,0,0,1,1
32159,كائنات,0,0,1,1
32161,hohe,0,0,1,1
2205,calibratura,1,1,0,1
32163,inicio,0,0,1,1
2265,accettabile,1,1,0,1
32174,тупоумный,0,0,1,1
32175,koning,0,0,1,1
34536,investigan,0,0,1,1
34157,أصدق,0,0,1,1
32176,jardim,0,0,1,1
34535,energieksempel,0,0,1,1
32177,مبني,0,0,1,1
32178,പറയാതെ,0,0,1,1
34534,அமைந்துள்ளது,0,0,1,1
34533,وتغيرت,0,0,1,1
34532,bulacağınız,0,0,1,1
32180,rangeringsystem,0,0,1,1
32543,utbildning,0,0,1,1
32181,имеющая,0,0,1,1
34156,وإيلي,0,0,1,1
34155,readable,0,0,1,1
32172,ركضت,0,0,1,1
34152,πρόκειται,0,0,1,1
34545,ബുദ്ധിമുട്ടായിരുന്നു,0,0,1,1
34544,« en,0,0,1,1
32164,αδελφά,0,0,1,1
34543,jornada,0,0,1,1
1879,lavorativa,1,1,0,1
34541,बनायें,0,0,1,1
32548,ಮೆದುಳನ್ನು,0,0,1,1
32171,sobreviveu,0,0,1,1
32166,débats,0,0,1,1
32167,συνειδητοποιείς,0,0,1,1
34153,musste,0,0,1,1
32169,provocó,0,0,1,1
1880,stabilito,1,1,0,1
32547,المظهر,0,0,1,1
32530,gemeten,0,0,1,1
32210,burro,0,0,1,1
34205,அருமையான,0,0,1,1
34194,للتغيير،,0,0,1,1
2252,ripreso,1,1,0,1
32263,отсюда,0,0,1,1
34192,uruguay,0,0,1,1
34448,muhtemelen,0,0,1,1
1901,almanacchi,1,1,0,1
32503,ಟಕ್ಕೆ,0,0,1,1
32264,நபரின்,0,0,1,1
32265,prestigiosas,0,0,1,1
32502,красотой,0,0,1,1
32266,பெரிதுபடுத்த,0,0,1,1
32501,onderzoeken,0,0,1,1
32500,ஒன்றுக்கு,0,0,1,1
34445,kultiviert,0,0,1,1
2251,esaminata,1,1,0,1
34444,tourne,0,0,1,1
34449,levebröd,0,0,1,1
32261,ದಾಸಿಯರು,0,0,1,1
32260,alimentés,0,0,1,1
32254,இன்,0,0,1,1
34188,meteen,0,0,1,1
34455,regroupées,0,0,1,1
34189,omstridte,0,0,1,1
32251,ಕೊಳಕು,0,0,1,1
32253,вызван,0,0,1,1
34454,interativas,0,0,1,1
34453,വിദ്യാ‍ഭ്യാസത്തിന്റെ,0,0,1,1
34451,उम्मीद,0,0,1,1
2253,rallentamento,1,1,0,1
34190,कुत्ते,0,0,1,1
32256,എല്ലായ്‌പ്പോഴും,0,0,1,1
34452,बताती,0,0,1,1
34191,корпораций,0,0,1,1
32257,garantizar,0,0,1,1
2250,contribuzione,1,1,0,1
34195,moldavequoi ,0,0,1,1
32248,ശ്രദ്ധിക്കാൻ,0,0,1,1
32271,multidimensional,0,0,1,1
34434,historietas,0,0,1,1
34433,complementar,0,0,1,1
32282,variant,0,0,1,1
34202,ಶನಿವಾರದಂದು,0,0,1,1
32283,gerenommeerd,0,0,1,1
1937,mandarti,1,1,0,1
32493,söyleyebileceğinizden,0,0,1,1
34432,காணலாம்,0,0,1,1
32492,സ്രോതസ്സിന്റെ,0,0,1,1
2245,ottimali,1,1,0,1
32285,fungera,0,0,1,1
32286,பேண,0,0,1,1
32287,ಚಿಂತಿಸಬೇಡ,0,0,1,1
34204,acervo,0,0,1,1
32288,δυνατής,0,0,1,1
32281,അഭിപ്രായമില്ല,0,0,1,1
32280, millions de fichiers,0,0,1,1
2247,dibattito,1,1,0,1
34442, milliards,0,0,1,1
34196,«список,0,0,1,1
32273,battle,0,0,1,1
32274,പരിചയപ്പെടാം,0,0,1,1
34443,besorgt,0,0,1,1
32275,ಪ್ರಿಯತಮೆಯು,0,0,1,1
34197,ನಿಲ್ಲಿಸಿದ್ದೇವೆ,0,0,1,1
34441,tanımlamalardan,0,0,1,1
32494,olacaktır,0,0,1,1
32497,നാർസിസയും,0,0,1,1
34440,എല്ലാംതന്നെ,0,0,1,1
34439,सुविधाओं,0,0,1,1
34437,فستان,0,0,1,1
32495,اهتمامك,0,0,1,1
34436,شهريًا,0,0,1,1
32249,forth,0,0,1,1
34457,acompanhamento,0,0,1,1
34485,न्यायाधीशों,0,0,1,1
34470,placerade,0,0,1,1
32221,gboard,0,0,1,1
34476,clases,0,0,1,1
32518,ಕೋಣೆಗೆ,0,0,1,1
32223,batido,0,0,1,1
32224,olursa,0,0,1,1
34473,desacuerdo,0,0,1,1
34174,असंगतियों,0,0,1,1
32227,फ़ाइलों,0,0,1,1
34175,malheureux,0,0,1,1
32229,охвату,0,0,1,1
32230,തർക്കം,0,0,1,1
1938,avesse,1,1,0,1
32517,انظرويكيبيدياترجمة,0,0,1,1
1899,dirgli,1,1,0,1
32516,  euros,0,0,1,1
32520,தொகுப்பாளர்களால்,0,0,1,1
34172,сбитых,0,0,1,1
32521,derinlemesine,0,0,1,1
32216,உலகின்,0,0,1,1
32211,utsikt,0,0,1,1
32527,bakışları,0,0,1,1
32212,learning‏,0,0,1,1
2257,statistico,1,1,0,1
32214,perfecte,0,0,1,1
32215,challenged,0,0,1,1
34482,كارلوس,0,0,1,1
32522,praktijk,0,0,1,1
34169,vitória,0,0,1,1
32526,изменила,0,0,1,1
34170,italianos,0,0,1,1
32524,congratulations,0,0,1,1
32219,فالكلمة,0,0,1,1
32220,"
अल्बानियाई",0,0,1,1
32232,بالإصدارات,0,0,1,1
32233,مساهمون,0,0,1,1
34458,ρωτήθηκε,0,0,1,1
32234,sacred,0,0,1,1
32511,décrit,0,0,1,1
32238,fornøjelse,0,0,1,1
32239,fou,0,0,1,1
34184,लागत,0,0,1,1
32240,εκπλαγείτε,0,0,1,1
34185,omissions,0,0,1,1
34186,വായിക്കുന്നു,0,0,1,1
34459,സുഹൃത്തുക്കളായിരുന്നു,0,0,1,1
32243,سعيدًا,0,0,1,1
32509,войну,0,0,1,1
32508,understrege,0,0,1,1
32244,relectures,0,0,1,1
32245,واجهته,0,0,1,1
32507,написанных,0,0,1,1
32246,ഒട്ടും,0,0,1,1
32237,காபியை,0,0,1,1
34183,വിവരങ്ങളിലൂടെ,0,0,1,1
34182,critic,0,0,1,1
34465,നിർത്താൻ,0,0,1,1
34468,gmatı,0,0,1,1
32235,detailed,0,0,1,1
34178,forberedt,0,0,1,1
34179,பங்களிப்பாளர்களுக்கு,0,0,1,1
34467,dilemenin,0,0,1,1
34466,bureaukrater,0,0,1,1
34180,visitante,0,0,1,1
32512,ಕೋಪಗೊಂಡಿದ್ದೇನೆ,0,0,1,1
32515,позицией,0,0,1,1
34464,positif,0,0,1,1
34463,panela,0,0,1,1
32236,بقائمة,0,0,1,1
34462,വിവരങ്ങളെ,0,0,1,1
32513,emploient ,0,0,1,1
34814,satirizou,0,0,1,1
34816,envoyé,0,0,1,1
35379,त्रुटियां,0,0,1,1
32912,широкую,0,0,1,1
31464,സാദ്ധ്യതയുണ്ടാവാറുണ്ട്।,0,0,1,1
31465,intentionnalité,0,0,1,1
35204,دعونا,0,0,1,1
35203,gætter,0,0,1,1
35202,códigos,0,0,1,1
35201,interwikilänkar,0,0,1,1
32911,കൊണ്ട്,0,0,1,1
31466,ακούτε,0,0,1,1
35199,وثقافة,0,0,1,1
31467,centralizam,0,0,1,1
35198,அர்த்தமாகும்,0,0,1,1
31468,innovateurs,0,0,1,1
32910,soportes,0,0,1,1
1989,imprecisioni,1,1,0,1
31470,søster,0,0,1,1
35206,julius,0,0,1,1
35207,ooit,0,0,1,1
2357,prime,1,1,0,1
35208,സ്ലഗ്,0,0,1,1
31452,tardaba,0,0,1,1
31453,paresseux,0,0,1,1
31454,ಉಗುರು,0,0,1,1
33861,ದಣಿದಿದ್ದರೆ,0,0,1,1
31455,telifi,0,0,1,1
35212,uppfyller,0,0,1,1
1784,influenza,1,1,0,1
31457,irmã,0,0,1,1
31458,dørs,0,0,1,1
35209,حيال,0,0,1,1
31459,ದಾಳಿಕೋರರು,0,0,1,1
32915,ഗേറ്റ്സിന്റെ,0,0,1,1
32914,seraitce,0,0,1,1
31460,absolut,0,0,1,1
2350,nacque,1,1,0,1
35197,woordnummer,0,0,1,1
35196,بالإنترنت,0,0,1,1
32909,anglófona,0,0,1,1
31471,”machine,0,0,1,1
2349,«sebbene,1,1,0,1
35190,துரதிர்ஷ்டவசமாக,0,0,1,1
2348,primarie,1,1,0,1
32900,especulou,0,0,1,1
31483,loop,0,0,1,1
31484,confina,0,0,1,1
32899,amnesty,0,0,1,1
1788,wikizionario,1,1,0,1
31485,encendido,0,0,1,1
31486,contemporaine,0,0,1,1
31487,الكامل,0,0,1,1
33868,médiathèque,0,0,1,1
1987,disperse,1,1,0,1
35187,ஹேங்கவுட்,0,0,1,1
35186,« wiki »,0,0,1,1
32901,ಮಲಗಿದ್ದಾಗ,0,0,1,1
35191,mükemmele,0,0,1,1
31480,ಬಸ್,0,0,1,1
31474,നല്ലതാണെങ്കിൽ,0,0,1,1
33866,aussprechen,0,0,1,1
32907,sourced,0,0,1,1
35195,wikipediaversioner,0,0,1,1
31472,gesprochen,0,0,1,1
31473,браках,0,0,1,1
2154,reperibile,1,1,0,1
35194,siembra,0,0,1,1
31479,मानने,0,0,1,1
31475,bakıcısı,0,0,1,1
31476,bedömningen,0,0,1,1
32903,desempeño,0,0,1,1
35192,consultado,0,0,1,1
31477,χαρούμε,0,0,1,1
31478,icono,0,0,1,1
32917,incredible,0,0,1,1
33860,alex,0,0,1,1
2351,sviluppatosi,1,1,0,1
35226,"
ईडो",0,0,1,1
35234,diyebileceğine,0,0,1,1
31422,çıkmasını,0,0,1,1
33849,റിച്ചാർഡ്,0,0,1,1
31423,aanbiedingen,0,0,1,1
33850,സമർപ്പിക്കപ്പെടുന്ന,0,0,1,1
35231,பார்த்ததிலிருந்து,0,0,1,1
31426,şirketi,0,0,1,1
31427,ecologists,0,0,1,1
1782,modalità,1,1,0,1
35228,നടത്തുവാനും,0,0,1,1
31429,നിർമ്മിച്ചിരിക്കുന്നത്,0,0,1,1
2152,ulteriore,1,1,0,1
35227,заботился,0,0,1,1
33852,مقصود,0,0,1,1
33853,needing,0,0,1,1
35235,ದೇಶಕ್ಕೆ,0,0,1,1
35236,organisationer,0,0,1,1
35237,تفكر,0,0,1,1
31414,август,0,0,1,1
33845,turísticas,0,0,1,1
31412,நண்பரிடம்,0,0,1,1
33846,«„википедия“,0,0,1,1
35242,quantity,0,0,1,1
35241,بتلميحات,0,0,1,1
35240,ശ്രദ്ധപുലർത്തുക,0,0,1,1
33847,gåva,0,0,1,1
2355,specifici,1,1,0,1
35239,künt,0,0,1,1
33848,fold,0,0,1,1
31417,grönvall,0,0,1,1
31418,trettonde,0,0,1,1
31419,précédents,0,0,1,1
1781,meritare,1,1,0,1
32926,рад,0,0,1,1
31430,ചേർക്കുന്നതും,0,0,1,1
35214,அமர்த்த,0,0,1,1
35225,efetuou,0,0,1,1
2354,esitante,1,1,0,1
2353,tendenza,1,1,0,1
31440,arayana,0,0,1,1
32921,besproken,0,0,1,1
35218,выборки —,0,0,1,1
32920,intends,0,0,1,1
33857,envers,0,0,1,1
31444,subatomic,0,0,1,1
31445,உற்சாகமான,0,0,1,1
35217,شكرك,0,0,1,1
31446,ಇಲ್ಲದಿದ್ದರೆ,0,0,1,1
35215,renvoyé,0,0,1,1
33858,φιλικό,0,0,1,1
2352,pensava,1,1,0,1
33859,βοήθησέ,0,0,1,1
31437,planten,0,0,1,1
35219,செய்வது,0,0,1,1
33854,succinctes,0,0,1,1
35223,théorise,0,0,1,1
32925,calculated,0,0,1,1
32924,встречаюсь,0,0,1,1
31431,projetados,0,0,1,1
32923,"
नॉर्वेजियाई",0,0,1,1
31432,électricité,0,0,1,1
35224,ar •,0,0,1,1
31433,ವ್ಯಕ್ತಿಯ,0,0,1,1
31436,جوزيف,0,0,1,1
35222,против,0,0,1,1
31434,gedroeg,0,0,1,1
1783,grafica,1,1,0,1
31435,levantou,0,0,1,1
35220,tombé,0,0,1,1
32922,kalbe,0,0,1,1
31488,filtra,0,0,1,1
31489,proposition,0,0,1,1
35185,وقال,0,0,1,1
35121,дискриминантный,0,0,1,1
31534,الخطأ,0,0,1,1
35132,αγκαλιάσει,0,0,1,1
31535,ಹೊಂದಿರುವ,0,0,1,1
32878,bahsetme,0,0,1,1
35129,beyazdır,0,0,1,1
32877,‘இறங்கு,0,0,1,1
33885,متزايد,0,0,1,1
31536,يواجه,0,0,1,1
31538,കഴിയുന്നില്ലെങ്കിൽ,0,0,1,1
1794,efficacemente,1,1,0,1
35126,പാദത്തിൽ,0,0,1,1
35125,நேர்காணலில்,0,0,1,1
35124,"
मंगोलियाई",0,0,1,1
31540,acento,0,0,1,1
31541,തുടങ്ങുന്നത്,0,0,1,1
31533,للقاء,0,0,1,1
35134,المعرفة،,0,0,1,1
31532,आपराधिक,0,0,1,1
32881,çıkaracak,0,0,1,1
2342,affine,1,1,0,1
32883,милой,0,0,1,1
31523,കിടക്ക,0,0,1,1
31524,слушайте,0,0,1,1
35143,nitrogen,0,0,1,1
32882,الروبوت,0,0,1,1
31525,séquences,0,0,1,1
35136,smilede,0,0,1,1
35142,balanceamento,0,0,1,1
31527,செய்திகள்,0,0,1,1
33883,ಕಲಿಕೆಯನ್ನು,0,0,1,1
35139,ಹೊಂದಿಲ್ಲದಿದ್ದರೆ,0,0,1,1
35137,волшебными,0,0,1,1
33884,frågeställningarna,0,0,1,1
31542,licenseനാൽ,0,0,1,1
33887,ಸಾಲವನ್ನು,0,0,1,1
2343,variegata,1,1,0,1
32875,kanunu,0,0,1,1
33892,φυσικό,0,0,1,1
35111,للولايات,0,0,1,1
35110,reaches,0,0,1,1
31550,രചയിതാവില്ല,0,0,1,1
31551,изобретений,0,0,1,1
31552,செய்நிரல்கள்’,0,0,1,1
33893,கோரிக்கைகளை,0,0,1,1
31553,تدريجية,0,0,1,1
32871,तकनीक,0,0,1,1
35107,fuerza,0,0,1,1
32869,inúmeras,0,0,1,1
33894,arkadaşlarınıza,0,0,1,1
32867,britannique,0,0,1,1
35105,новейший,0,0,1,1
31555,ഉൾ‍ക്കൊള്ളുന്നു,0,0,1,1
31549,बीबीसी,0,0,1,1
32872,मान,0,0,1,1
31548,admit,0,0,1,1
35118,solicitação,0,0,1,1
31544,ആകസ്‌മിക,0,0,1,1
35120,compositor,0,0,1,1
1795,sapore,1,1,0,1
31545,discussed,0,0,1,1
1986,includono,1,1,0,1
2159,giornalista,1,1,0,1
31546,kızdırdım,0,0,1,1
32873,ущерб,0,0,1,1
35117,transformer,0,0,1,1
31547,सेल,0,0,1,1
33889,அனுபவத்தைப்,0,0,1,1
33890,impulso,0,0,1,1
35115,накормим,0,0,1,1
35114,cdi,0,0,1,1
35144,barajaron,0,0,1,1
35145,molestia,0,0,1,1
35184,ёсики,0,0,1,1
2157,specifiche,1,1,0,1
33873,вкусной,0,0,1,1
35170,hissediyorsanız,0,0,1,1
31497,финансировании,0,0,1,1
31498,напечатаны,0,0,1,1
35168,gemeinsame,0,0,1,1
33874,individu,0,0,1,1
2155,unione,1,1,0,1
33875,നീങ്ങുക,0,0,1,1
31502,wikimedia​,0,0,1,1
35167,ஒருங்கிணைப்பர்,0,0,1,1
35166,monate,0,0,1,1
35165,людьми»,0,0,1,1
35164,merged,0,0,1,1
31503,topical,0,0,1,1
32893,прошедших,0,0,1,1
35171,плачущий,0,0,1,1
32896,നിങ്ങള്ക്ക്,0,0,1,1
32897,сингапура,0,0,1,1
35178,falsidades,0,0,1,1
32898,ampliada,0,0,1,1
31490,κάνατε,0,0,1,1
31491,зверски,0,0,1,1
35182,फीडर,0,0,1,1
35181,detuvo,0,0,1,1
31493,وتخصصهم,0,0,1,1
35177,ira,0,0,1,1
33872,educativo,0,0,1,1
35176,συνεργατικά,0,0,1,1
35175,constate,0,0,1,1
31494,directives,0,0,1,1
33870,razones,0,0,1,1
35174,desacreditarlo,0,0,1,1
35173,article—have,0,0,1,1
1789,dimentica,1,1,0,1
31504,επανάληψη,0,0,1,1
35146,ಸಂಭವಿಸಿದ,0,0,1,1
31505,خاملة,0,0,1,1
35152,yaşamda,0,0,1,1
31518,ಮೂಲಭೂತ,0,0,1,1
35151,horsligne,0,0,1,1
35150,लोडबेलेंसिंग,0,0,1,1
32888,girdilerin,0,0,1,1
31519,திருத்தங்களைக்,0,0,1,1
35149,अनुभवहीन,0,0,1,1
31520,slid,0,0,1,1
32887,включают,0,0,1,1
35148,தாயைப்,0,0,1,1
32886,παγωτό,0,0,1,1
35147,المال,0,0,1,1
33881,avísame,0,0,1,1
32885,νόημα,0,0,1,1
33882,ഒറിയ,0,0,1,1
35153,metodologia,0,0,1,1
2344,esercito,1,1,0,1
35154,actué,0,0,1,1
35159,грандиозная,0,0,1,1
32891,ഹാംഗ്,0,0,1,1
31506,അതിശയകരമാംവിധം,0,0,1,1
31507,oldum,0,0,1,1
31508,ಬರುತ್ತಾರೆ,0,0,1,1
35160,बोलिये।,0,0,1,1
31509,"
samarês",0,0,1,1
2345,sr,1,1,0,1
35155,λίγα,0,0,1,1
33879,voordeel,0,0,1,1
32890,officiels,0,0,1,1
31514,überwältigt,0,0,1,1
31515,parody,0,0,1,1
31516,अध्याय,0,0,1,1
1790,incorporato,1,1,0,1
31411,kötüsü,0,0,1,1
35244,غداء,0,0,1,1
34026,рыцаря,0,0,1,1
31298,അനാവശ്യ,0,0,1,1
31300,μνηστήρες,0,0,1,1
31301,espéranto,0,0,1,1
31304,olmayı,0,0,1,1
31305,esenciales,0,0,1,1
35336,волшебный,0,0,1,1
35335,നൽകുന്നുണ്ട്‌,0,0,1,1
32970,मीडियन,0,0,1,1
31307,വിഭാഗത്തിൽ,0,0,1,1
35334,спросили,0,0,1,1
2366,diteci,1,1,0,1
2365,aspettare,1,1,0,1
31311,बनायी,0,0,1,1
35332,efectúan,0,0,1,1
35331,latinisé,0,0,1,1
31312,plata,0,0,1,1
2145,stampata,1,1,0,1
32973,editörler,0,0,1,1
35245,mets,0,0,1,1
35337,urval,0,0,1,1
35345,versuche,0,0,1,1
35344,μερικοί,0,0,1,1
31296,ошибке»,0,0,1,1
32977,നിയമങ്ങൾ,0,0,1,1
35343,dificuldade,0,0,1,1
33800,aptalca,0,0,1,1
35342,racional,0,0,1,1
35341,"
vietnamita",0,0,1,1
31297,comprueba,0,0,1,1
32976,uhøfligt,0,0,1,1
35339,ಬರಾಕ್,0,0,1,1
32974,aanstootgevend,0,0,1,1
33801,തോന്നുന്നുവെങ്കിൽ,0,0,1,1
33802,gallego,0,0,1,1
35338,எச்சரிப்பதற்காகவும்,0,0,1,1
35329,بمعلومات,0,0,1,1
31313,médicos,0,0,1,1
31315,marxiste,0,0,1,1
35328,surprised,0,0,1,1
33806,совершила,0,0,1,1
35317,seriøs,0,0,1,1
31324,കണ്ടെത്തുന്ന,0,0,1,1
35316,благодарен,0,0,1,1
33808,dresse,0,0,1,1
31325,zijd,0,0,1,1
2146,sardo,1,1,0,1
35315,മുഴുകിയിരിക്കുന്നു,0,0,1,1
35314,contradictorias,0,0,1,1
31326,поездки,0,0,1,1
31327,revision,0,0,1,1
31328,செய்தீர்கள்,0,0,1,1
35312,ഇന്നലെ,0,0,1,1
33811,wikiversidad,0,0,1,1
31329,länkning,0,0,1,1
35319,സമൂഹമാണ്,0,0,1,1
31323,lucir,0,0,1,1
31321,بدونك,0,0,1,1
31316,hazineni,0,0,1,1
35327,salarié,0,0,1,1
32967,απουσιάζουν,0,0,1,1
35326,yanına,0,0,1,1
1762,darci,1,1,0,1
35324,resumos,0,0,1,1
32966,मणिपुरी,0,0,1,1
35323,nytt,0,0,1,1
31320,الخاطبين,0,0,1,1
35322,wwe,0,0,1,1
31317,ಒಳ್ಳೆಯವರಂತೆ,0,0,1,1
31318,profondément,0,0,1,1
32965,തുടങ്ങിയിട്ടില്ല,0,0,1,1
31319,montant,0,0,1,1
32964,identificação,0,0,1,1
2368,particolari,1,1,0,1
2001,considerando,1,1,0,1
31294,alternates,0,0,1,1
31279,depicting,0,0,1,1
32994,programación,0,0,1,1
35372,indexation,0,0,1,1
2371,macedonia,1,1,0,1
31267,debatidos,0,0,1,1
35370,اتهم,0,0,1,1
31269,монографиями,0,0,1,1
31270,açsın,0,0,1,1
33786,المستخدمة,0,0,1,1
31273,доме,0,0,1,1
32992,٪,0,0,1,1
31274,gekauft,0,0,1,1
35368,الستينيات,0,0,1,1
31276,तुम्हे,0,0,1,1
31277,determinación,0,0,1,1
31278,മൃഗമാണെന്നും,0,0,1,1
31263,probablemente,0,0,1,1
32995,فجأة,0,0,1,1
31262,« liberal »,0,0,1,1
31253,കാണില്ലെന്ന്,0,0,1,1
2375,accanto,1,1,0,1
31250,«спасибо,0,0,1,1
2373,inserimento,1,1,0,1
2007,ognuno,1,1,0,1
31252,"ശാസ്ത്രം ·
geosciences ·
soil",0,0,1,1
35377,hongrois,0,0,1,1
35376,отсеиваются,0,0,1,1
31261,supportée,0,0,1,1
33783,generallyvague,0,0,1,1
35374,contraire ,0,0,1,1
31256,reed,0,0,1,1
2372,ispirato,1,1,0,1
32996,सोचते,0,0,1,1
31260,പെരുമാറ്റവും,0,0,1,1
35366,വെക്കുന്നുണ്ട്,0,0,1,1
1759,pubblicità,1,1,0,1
31292,ഇന്റർനെറ്റുമായി,0,0,1,1
33788,തന്നെയില്ല,0,0,1,1
1761,disturbarti,1,1,0,1
32987,setzen,0,0,1,1
33794,leeft,0,0,1,1
31288,vandaliserat,0,0,1,1
35352,ബോക്സിൽ,0,0,1,1
31289,الإسبانية،,0,0,1,1
32985,nelson,0,0,1,1
32984,disseminálo,0,0,1,1
32982,stewardship,0,0,1,1
32981,ευφυή,0,0,1,1
35349,basmadıysanız,0,0,1,1
31291,फ़्लैमिश,0,0,1,1
33795,clavo,0,0,1,1
32980,invisibles »,0,0,1,1
33797,காத்திருக்கச்,0,0,1,1
35354,historic,0,0,1,1
35355,находящихся,0,0,1,1
31286,nauw,0,0,1,1
35362,nerdy,0,0,1,1
2003,cibi,1,1,0,1
2142,piedi,1,1,0,1
2002,assomigli,1,1,0,1
33791,kandidatexamen,0,0,1,1
32990,stalled,0,0,1,1
32989,एस,0,0,1,1
35361,волочить,0,0,1,1
35356,അതിന്,0,0,1,1
35360,цитировано,0,0,1,1
35359,карету,0,0,1,1
35358,australiskt,0,0,1,1
1760,predittiva,1,1,0,1
32988,la •,0,0,1,1
31284,spammers,0,0,1,1
35311,eenvoudigste,0,0,1,1
31330,habían,0,0,1,1
33812,girlfriend,0,0,1,1
35261,forcément,0,0,1,1
31384,александрийской,0,0,1,1
34276,приписывают,0,0,1,1
31386,coletar,0,0,1,1
31387,toegankelijke,0,0,1,1
32943,escriba,0,0,1,1
35266,പറഞ്ഞുകൊണ്ട്,0,0,1,1
31389,react,0,0,1,1
31390,مسكين,0,0,1,1
2147,cambiò,1,1,0,1
33830,مقطعين,0,0,1,1
31391,ആയതുകൊണ്ട്,0,0,1,1
33832,doter,0,0,1,1
1778,teoretici,1,1,0,1
33833,startede,0,0,1,1
2148,addosso,1,1,0,1
35267,elskede,0,0,1,1
31383,коммерческое,0,0,1,1
2361,critico,1,1,0,1
1994,variante,1,1,0,1
35277,സൂചിപ്പിക്കുന്നതിന്,0,0,1,1
35276,banqueiro,0,0,1,1
35275,இரகசியமாக,0,0,1,1
31376,और।,0,0,1,1
31377,siffran,0,0,1,1
32946,ستنجح,0,0,1,1
33827,sleep,0,0,1,1
35270,complutense,0,0,1,1
1776,diventando,1,1,0,1
32945,независимо,0,0,1,1
1993,obiettività,1,1,0,1
35272,കരയാൻ,0,0,1,1
31380,bought,0,0,1,1
31381,επιμεληθεί,0,0,1,1
31392,identifiées,0,0,1,1
31393,positiv,0,0,1,1
1775,matrimoni,1,1,0,1
33835,bräuchen,0,0,1,1
31403,spisebordet,0,0,1,1
35252,சிக்கியிருப்பதை,0,0,1,1
1991,istanza,1,1,0,1
33842,wijzigingen,0,0,1,1
35250,myxozoa,0,0,1,1
32932,правосудия,0,0,1,1
2149,abbandonato,1,1,0,1
31405,مفيدًا,0,0,1,1
31406,ബന്ധത്തെക്കുറിച്ച്,0,0,1,1
35249,gozar,0,0,1,1
33843,günden,0,0,1,1
35248,baktığım,0,0,1,1
35246,votou,0,0,1,1
31408,манске,0,0,1,1
31409,സംഭാഷണത്തിനിടയിലാണെങ്കിൽ,0,0,1,1
35253,bays,0,0,1,1
31401,incrementa,0,0,1,1
32933,forekommer,0,0,1,1
2360,rappresentato,1,1,0,1
31394,прачечную,0,0,1,1
35259,प्रदान,0,0,1,1
32940,συνεχίσω,0,0,1,1
32938,विर्गील,0,0,1,1
32937,magst,0,0,1,1
35257,délicates,0,0,1,1
33838,subió,0,0,1,1
35254,മഹായുദ്ധസമയത്ത്,0,0,1,1
33839,apprendra,0,0,1,1
31397,بإمكان,0,0,1,1
35256,بيريشيت،,0,0,1,1
2359,correggere,1,1,0,1
35255,zur,0,0,1,1
32935,wikipedian,0,0,1,1
1995,compensi,1,1,0,1
31375,cair,0,0,1,1
31331,الملحوظة،,0,0,1,1
31356,låna,0,0,1,1
31348,இப்போதே,0,0,1,1
31349,nesse,0,0,1,1
32957,شئ,0,0,1,1
31350,ruwe,0,0,1,1
31352,المنفرج,0,0,1,1
35302,followed,0,0,1,1
35301,reçeli,0,0,1,1
31353,ಬಂದಿದ್ದರು,0,0,1,1
32956,ഫാൻസി,0,0,1,1
32955,ചിന്തിക്കുകയായിരുന്നു,0,0,1,1
31354,μύτη,0,0,1,1
35300,nedenini,0,0,1,1
33818,वित्तपोषण,0,0,1,1
35299,rosto,0,0,1,1
33819,prévois,0,0,1,1
31347,okulda,0,0,1,1
31346,فحسب،,0,0,1,1
31345,décrivait,0,0,1,1
33815,blinkade,0,0,1,1
32960,निंदन,0,0,1,1
31332,تملك,0,0,1,1
31333,yapmamanı,0,0,1,1
35307,sosyal,0,0,1,1
33814,noted,0,0,1,1
1768,controverso,1,1,0,1
32959,वर्चुअल,0,0,1,1
31344,konuşmayı,0,0,1,1
31336,altas,0,0,1,1
31338,schleppenden,0,0,1,1
31339,ugly,0,0,1,1
31341,ऑफ,0,0,1,1
1998,cadere,1,1,0,1
31343,viviría,0,0,1,1
35298,énumère,0,0,1,1
35297,готовности,0,0,1,1
31374,contenait,0,0,1,1
1769,utilizzate,1,1,0,1
35287,l’élection,0,0,1,1
31366,prominent,0,0,1,1
35286,questionou,0,0,1,1
35285,ljuset,0,0,1,1
2362,negativamente,1,1,0,1
31369,പരിഗണിക്കുന്നു,0,0,1,1
31370,mauvaise,0,0,1,1
31371,erfahren,0,0,1,1
35283,வருத்தப்படுகிறீர்கள்,0,0,1,1
32948,الادعاءات,0,0,1,1
31372,escucha,0,0,1,1
35281,gelmesidir,0,0,1,1
35280,поисковых,0,0,1,1
31373,باردة,0,0,1,1
32947,الخبرة,0,0,1,1
31365,solapa,0,0,1,1
31364,undergoing,0,0,1,1
32951,soup,0,0,1,1
35291,джеймс,0,0,1,1
1770,sbagli,1,1,0,1
35294,δέκα,0,0,1,1
32954,artificiels,0,0,1,1
1997,modificarli,1,1,0,1
31358,وwikipediaorg,0,0,1,1
31359,обычаями,0,0,1,1
33822,dictionarystyle,0,0,1,1
33823,привилегий,0,0,1,1
31360,demandant,0,0,1,1
35290,fenomenet,0,0,1,1
35289,mordisco,0,0,1,1
35288,profundo,0,0,1,1
32952,übliche,0,0,1,1
31361,rundad,0,0,1,1
35104,tristeza,0,0,1,1
33895,antiguo,0,0,1,1
31556,erbjudande,0,0,1,1
34912,alembert,0,0,1,1
34911,оскорбительное,0,0,1,1
31733,physicien,0,0,1,1
33982,«астероид,0,0,1,1
31734,erop,0,0,1,1
34908,outnyttjade,0,0,1,1
31736,yoludur,0,0,1,1
31738,termijn,0,0,1,1
33983,വെട്ടി,0,0,1,1
1824,dichiarazioni,1,1,0,1
34904,afuera,0,0,1,1
34903,единственным,0,0,1,1
1971,impegnarsi,1,1,0,1
31740,indexing,0,0,1,1
34902,attributionsharealike,0,0,1,1
31741,ritter,0,0,1,1
31732,നന്ദിയുണ്ട്,0,0,1,1
32780,anger,0,0,1,1
35103,istemiyorsa,0,0,1,1
31730,ರುಚಿ,0,0,1,1
34916,étonnante,0,0,1,1
31722,بترتيب,0,0,1,1
34915,jederzeit,0,0,1,1
34914,يحمل,0,0,1,1
31725,ಹೇಳಬಹುದೇ,0,0,1,1
32785,يخطئ,0,0,1,1
31726,использовании,0,0,1,1
33977,uğrayan,0,0,1,1
32784,ووجهات,0,0,1,1
33978,arz •,0,0,1,1
31728,rappelé,0,0,1,1
32783,semiformal,0,0,1,1
32781,القياسي,0,0,1,1
34913, الويكيبيديا,0,0,1,1
31729,låtar,0,0,1,1
31743,aumenta,0,0,1,1
31744,سلسلة,0,0,1,1
31745,truppen,0,0,1,1
32778,ரகசியம்,0,0,1,1
31749,yrkeskategorier,0,0,1,1
1827,bambola,1,1,0,1
34884,جنو,0,0,1,1
33988,പുലർത്തുക,0,0,1,1
31750,potentiële,0,0,1,1
34883,chémoinformatique ,0,0,1,1
32776,उठा,0,0,1,1
31751,d’intuition,0,0,1,1
31752,έλλη,0,0,1,1
2171,linz,1,1,0,1
32773,"
सिन्धी",0,0,1,1
32772,selbst,0,0,1,1
31754,mencione,0,0,1,1
31755,erronées,0,0,1,1
31756,personificação,0,0,1,1
31748,മുതലുള്ള,0,0,1,1
34887,correu,0,0,1,1
34888,taste,0,0,1,1
34896,måneder,0,0,1,1
34900,крупный,0,0,1,1
34899,ensinadas,0,0,1,1
34898,ಮಾಡಲಿದ್ದೀರಿ,0,0,1,1
33985,ശിൽപ്പികൾ,0,0,1,1
34897,मीठा,0,0,1,1
31746,durdurduk,0,0,1,1
34895,higherlevel,0,0,1,1
34889,organizar,0,0,1,1
2312,ottanta,1,1,0,1
34893,equivalent,0,0,1,1
32777,பக்கச்,0,0,1,1
33986,emphasizing,0,0,1,1
34890,formateret,0,0,1,1
33987,biodiésel,0,0,1,1
33976,poll,0,0,1,1
1974,raccoglie,1,1,0,1
34918,തയ്യാറായി,0,0,1,1
33966,burocratas,0,0,1,1
33963,passa,0,0,1,1
34947,gülmeye,0,0,1,1
34946,требуется,0,0,1,1
34945,تكررها,0,0,1,1
1817,professori,1,1,0,1
31699,tegnsætning,0,0,1,1
31700,энергетический,0,0,1,1
34942,klassen,0,0,1,1
33964,mecanismo,0,0,1,1
34940,рода,0,0,1,1
2316,interessate,1,1,0,1
31703,blockering,0,0,1,1
34939,spill,0,0,1,1
32797,deductieve,0,0,1,1
34938,образовался,0,0,1,1
31698,μμ,0,0,1,1
34949,outgassing,0,0,1,1
1976,specializzazione,1,1,0,1
1815,inferenza,1,1,0,1
34958,sonrisas,0,0,1,1
31694,agricoles,0,0,1,1
34957,ಮೂರನೆಯ,0,0,1,1
34956,الإطلاق،,0,0,1,1
2169,voto»,1,1,0,1
34955,സ്യൂട്ടർമാർ,0,0,1,1
34953,shepelyansky,0,0,1,1
31696,жила,0,0,1,1
31695,llegaron,0,0,1,1
33959,noktadayım,0,0,1,1
34951,увидеть,0,0,1,1
34950,adicionou,0,0,1,1
33960,"
sérvio",0,0,1,1
33961,τρομερά,0,0,1,1
1819,vichipedìa,1,1,0,1
32796,கீழாகவும்,0,0,1,1
34919,ஆரம்பமானது,0,0,1,1
32795,shut,0,0,1,1
34926,எசுப்பானிய,0,0,1,1
32788,seguridad,0,0,1,1
32787,bogen,0,0,1,1
1822,interessati,1,1,0,1
31716,penis,0,0,1,1
33972,anteriores,0,0,1,1
32786,east,0,0,1,1
31717,لإصلاحها,0,0,1,1
33973,классе,0,0,1,1
31719,calcular,0,0,1,1
34922,nådde,0,0,1,1
33974,spåddes,0,0,1,1
34921,ഒന്നോ,0,0,1,1
34920,fondations,0,0,1,1
31721,auffahrt,0,0,1,1
1821,amica,1,1,0,1
32790,​​ham,0,0,1,1
31713,återställs,0,0,1,1
31707,regulation,0,0,1,1
31704,parsemé,0,0,1,1
2315,contribuirvi,1,1,0,1
34934,وقف,0,0,1,1
34933,definição,0,0,1,1
31706,methodological,0,0,1,1
33968,paranız,0,0,1,1
31709,introduzido,0,0,1,1
33970,كبد,0,0,1,1
2170,morendo,1,1,0,1
31711,الامور؟,0,0,1,1
32792,vedalaşmadan,0,0,1,1
32791,وتساءلوا,0,0,1,1
31712,чикаго,0,0,1,1
34929,mediawikiprogramvaran,0,0,1,1
31757,terk,0,0,1,1
31758,колберт,0,0,1,1
31759,esthétique,0,0,1,1
32742,شاهد,0,0,1,1
34840,retaining,0,0,1,1
2304,sembravano,1,1,0,1
31805,है।कनाडा,0,0,1,1
2175,rosenblatt,1,1,0,1
31806,ತೊಂದರೆಗೊಳಗಾಗಲು,0,0,1,1
31807,strenge,0,0,1,1
31808,قناتي,0,0,1,1
34838,கடி,0,0,1,1
2303,sole,1,1,0,1
31810,citado,0,0,1,1
34837,anlama,0,0,1,1
31811,electrónica,0,0,1,1
34017,लाल,0,0,1,1
34836,ملابس,0,0,1,1
34835,solicitado,0,0,1,1
31803,находится,0,0,1,1
34013,functioning,0,0,1,1
31802,ಬ್ರೆಡ್ನೊಂದಿಗೆ,0,0,1,1
34010,dick,0,0,1,1
34848,tillstånd,0,0,1,1
31797,ज़रा,0,0,1,1
34009,preferia,0,0,1,1
32746,relative,0,0,1,1
34847,بتعديل,0,0,1,1
34845,meningsverschillen,0,0,1,1
31798,предмета,0,0,1,1
34841,மந்தமாக்குகிறது,0,0,1,1
31799,இக்கட்டுரைகளில்,0,0,1,1
32744,ഗുജറാത്തി,0,0,1,1
34843,நேரத்திலிருந்து,0,0,1,1
31800,സംബന്ധിക്കുന്ന,0,0,1,1
31801,പറ്റുന്നതിൽ,0,0,1,1
34842,dorées,0,0,1,1
31812,drømmemor,0,0,1,1
31814,slösa,0,0,1,1
34008,печатного,0,0,1,1
2176,tesoro,1,1,0,1
34826,بها،,0,0,1,1
31829,gerir,0,0,1,1
1836,usarli,1,1,0,1
31830,searching,0,0,1,1
34822,vur,0,0,1,1
31831,вебсайт,0,0,1,1
32734,doktorerat,0,0,1,1
31832,editálos,0,0,1,1
31833,tief,0,0,1,1
34023,தேவதையாக,0,0,1,1
34024,luidsprekerpictogram,0,0,1,1
34025,نزاع,0,0,1,1
34818,εύκολα,0,0,1,1
31835,തണ്ണീർത്തടമാണ്,0,0,1,1
31836,épurée,0,0,1,1
31828,ഗൗരവമായി,0,0,1,1
32737,nonavian,0,0,1,1
31827,provet,0,0,1,1
31820,illiterate,0,0,1,1
34019,frans,0,0,1,1
31817,requereu,0,0,1,1
31818,workload,0,0,1,1
31819,الأنواع,0,0,1,1
34831,brisé,0,0,1,1
1834,fattibilità,1,1,0,1
34829,kluge,0,0,1,1
31825,വസ്തുതകളും,0,0,1,1
34828,divisão,0,0,1,1
2299,invasi,1,1,0,1
34827,വാരാന്ത്യത്തിലും,0,0,1,1
2298,affermano,1,1,0,1
32739,مقابلات,0,0,1,1
32738,ιστοχώρο,0,0,1,1
34849,abnormal,0,0,1,1
2305,conclude,1,1,0,1
32769,caters,0,0,1,1
31779,subjectives,0,0,1,1
31768,annoncent,0,0,1,1
34872,län,0,0,1,1
32762,semanario,0,0,1,1
34870,​​sneetje,0,0,1,1
2311,leggendo,1,1,0,1
31771,विघटनकारी,0,0,1,1
34868,führen,0,0,1,1
1830,molta,1,1,0,1
2310,emiliano,1,1,0,1
31773,контексте,0,0,1,1
31774,genéticos,0,0,1,1
31775,दोहराना,0,0,1,1
31776,histories,0,0,1,1
31777,एफ़,0,0,1,1
34865,அழுத்தவும்,0,0,1,1
31767,استخدامًا،,0,0,1,1
34873,governing,0,0,1,1
33993,ವರ್ಷ,0,0,1,1
34877,sistem,0,0,1,1
34880,descubierto,0,0,1,1
33989,zelfstandig,0,0,1,1
32768,grades,0,0,1,1
2173,codice,1,1,0,1
33990,άμαξας,0,0,1,1
34878,போக,0,0,1,1
31761,ausgewogenen,0,0,1,1
34875,frais,0,0,1,1
31762,слышать,0,0,1,1
34876,limitée,0,0,1,1
31764,—u,0,0,1,1
32766,ಕಂಡಿದೆ,0,0,1,1
1969,suggerito,1,1,0,1
31765,φοβόμουν,0,0,1,1
32758,डिस्क्स,0,0,1,1
1968,pesante,1,1,0,1
34007,dénotant,0,0,1,1
31780,авторов,0,0,1,1
34855,τηλέφωνο,0,0,1,1
34854,ekonomin,0,0,1,1
34004,trykke,0,0,1,1
34853,bear,0,0,1,1
2306,cancellazione,1,1,0,1
34005,المصنوع,0,0,1,1
31791,suceden,0,0,1,1
31792,തണുത്തത്,0,0,1,1
32752,μάθει,0,0,1,1
34851,ആശംസകൾ,0,0,1,1
32748,تقولها,0,0,1,1
31793,παρά,0,0,1,1
31794,اعترض,0,0,1,1
34006,rectitud,0,0,1,1
32747,épique,0,0,1,1
34856,ചെയ്യാനും,0,0,1,1
31789,изучали,0,0,1,1
32753,يترجموا,0,0,1,1
33999,diversidad,0,0,1,1
33996,legibilidade,0,0,1,1
34863,поставьте,0,0,1,1
31781,لطبيعة,0,0,1,1
33997,ulaşamadı,0,0,1,1
32756,nullius,0,0,1,1
32755,förutsatt,0,0,1,1
34861,கூட,0,0,1,1
1963,garantendo,1,1,0,1
34000,cariño,0,0,1,1
31784,codified,0,0,1,1
34859,ned,0,0,1,1
32754,oneself,0,0,1,1
34002,portales,0,0,1,1
34857,amérindiens,0,0,1,1
1814,professione,1,1,0,1
1811,accade,1,1,0,1
31692,träumen,0,0,1,1
1981,vennero,1,1,0,1
31598,adequação,0,0,1,1
31599,खींच,0,0,1,1
31600,giacomo,0,0,1,1
35057,cliquer,0,0,1,1
1800,velocità,1,1,0,1
31601,ಕಾಣಲು,0,0,1,1
35055,छोटी,0,0,1,1
35054,πιστεύετε,0,0,1,1
33917,нарциссизм,0,0,1,1
33918,لاحقًا،,0,0,1,1
31603,viajou,0,0,1,1
31604,redistribute,0,0,1,1
31605,undertiden,0,0,1,1
31606,unes,0,0,1,1
31607,death,0,0,1,1
32840,lexicografische,0,0,1,1
35058,affect,0,0,1,1
31595,உற்சாகப்படுத்துங்கள்,0,0,1,1
31590,breit,0,0,1,1
35067,new •,0,0,1,1
31586,богатство,0,0,1,1
31587,ಹೇಳಲಾರೆ,0,0,1,1
32843,superprotection,0,0,1,1
35065,അവളുമായി,0,0,1,1
33916,quienes,0,0,1,1
2340,tecnologico,1,1,0,1
2164,sfruttare,1,1,0,1
35064,skrivit,0,0,1,1
1799,nucleare,1,1,0,1
35062,lícita,0,0,1,1
31593,respectueux,0,0,1,1
35061,σταματήσω,0,0,1,1
35060,ತಿಂಗಳುಗಳವರೆಗೆ,0,0,1,1
35053,образовательном,0,0,1,1
31608,ameliorating,0,0,1,1
35068,durable »,0,0,1,1
33920,soppa,0,0,1,1
35039,ಮಾಡಿದರೆ,0,0,1,1
31618,forskningsgrene,0,0,1,1
32836,क्रिमसन,0,0,1,1
32835,δεδομένου,0,0,1,1
35038,bce,0,0,1,1
33925,viewing,0,0,1,1
33926,informationskälla,0,0,1,1
33927,тону,0,0,1,1
1804,inglese –,1,1,0,1
35036,പ്രശ്നമില്ല,0,0,1,1
35035,உலாவியையும்,0,0,1,1
35034,aclu,0,0,1,1
35033,годах,0,0,1,1
35032,എല്ലാവരും,0,0,1,1
32833,τείνει,0,0,1,1
1980,consultata,1,1,0,1
31617,важнейших,0,0,1,1
35042,stockholms,0,0,1,1
31611,общедоступная,0,0,1,1
31610,ίδρυση,0,0,1,1
35049,deems,0,0,1,1
33921,തമാശകളും,0,0,1,1
32838,acadêmica,0,0,1,1
33922,tokens,0,0,1,1
35048,précieuses,0,0,1,1
31612,kontrollerar,0,0,1,1
31616,respectivement,0,0,1,1
31613,آمل,0,0,1,1
35046,درس,0,0,1,1
35045,للعينة,0,0,1,1
32837,acımasızca,0,0,1,1
33923,consultations,0,0,1,1
35043,ilegível,0,0,1,1
33915,quinta,0,0,1,1
31584,செருமானிய,0,0,1,1
31620,hitting,0,0,1,1
31568,संघर्ष,0,0,1,1
35094,vindos,0,0,1,1
35093,ಸಂಪೂರ್ಣ,0,0,1,1
32860,upwards,0,0,1,1
2160,ottenere,1,1,0,1
35092,inspiration,0,0,1,1
32858,hösten,0,0,1,1
35091,باحثون,0,0,1,1
31565,നന്നാക്കുന്നതിലൂടെ,0,0,1,1
35089,clássicas,0,0,1,1
33904,gmt,0,0,1,1
35088,मशीनों,0,0,1,1
35087,redirection,0,0,1,1
35086,الهوية,0,0,1,1
31566,penalidades,0,0,1,1
31567,wikireto,0,0,1,1
33902,retrace,0,0,1,1
35095,glücks,0,0,1,1
32861,inattendues,0,0,1,1
33898,неприятной,0,0,1,1
35102,campus,0,0,1,1
31557,propuestos,0,0,1,1
32866,मैरियन,0,0,1,1
31558,صغيرًا,0,0,1,1
33896,ilgilerini,0,0,1,1
33897,уравновешенный,0,0,1,1
31560,descripción,0,0,1,1
31564,usergenerated,0,0,1,1
35098,misbruik,0,0,1,1
1985,occitano,1,1,0,1
32864,stoten,0,0,1,1
31562,оригинальные,0,0,1,1
32862,நர்சிசாவும்,0,0,1,1
35096,exceptional,0,0,1,1
33905,locale,0,0,1,1
33906,റിപ്പബ്ലിക്ക്,0,0,1,1
35069,implications,0,0,1,1
33907,imprécis,0,0,1,1
31576,concernées,0,0,1,1
35077,டோஃபிள்,0,0,1,1
35076,löpande,0,0,1,1
31577,dominique,0,0,1,1
31578,yaklaşan,0,0,1,1
31579,catastrophe,0,0,1,1
32848,താൽ‌പ്പര്യപ്പെടുന്നെങ്കിൽ‌,0,0,1,1
32847,proposé,0,0,1,1
35075,no»,0,0,1,1
31580,beğenmeyi,0,0,1,1
35073,genoptage,0,0,1,1
35072,temor,0,0,1,1
35071,declining,0,0,1,1
35070,മനുഷ്യന്,0,0,1,1
31582,гарвардской,0,0,1,1
32849,ಶಕ್ತಿಯ,0,0,1,1
33912,социальной,0,0,1,1
35078,कृत्य,0,0,1,1
32854,ограничиваются,0,0,1,1
33908,أمريكا,0,0,1,1
31569,αιτήματα,0,0,1,1
31570,δρόμο,0,0,1,1
32857,dès,0,0,1,1
32856,ഒന്നുമില്ല,0,0,1,1
32855,दिशानिर्देशों,0,0,1,1
31572,congratulating,0,0,1,1
32851,अधिनियम,0,0,1,1
35083,سيبدو,0,0,1,1
32853,dağıtılmasına,0,0,1,1
35082,tensor,0,0,1,1
32852,പാർട്ടിയിൽ,0,0,1,1
33910,tas,0,0,1,1
35079,castle,0,0,1,1
31619,ಸಹಿಸಿಕೊಳ್ಳಿ,0,0,1,1
2339,indirizza,1,1,0,1
31691,disposait,0,0,1,1
1977,manipolano,1,1,0,1
33944,stormfuldt,0,0,1,1
32806,tabağımda,0,0,1,1
34986,supportemoi,0,0,1,1
33945,karşılaştığı,0,0,1,1
31671,dessous,0,0,1,1
31672,ஒருவராக,0,0,1,1
31673,கணக்கொன்று,0,0,1,1
32804,नरसिंह,0,0,1,1
33946,बतलाता,0,0,1,1
34983,ചെറുപെട്ടികളിൽ,0,0,1,1
2322,colloca,1,1,0,1
34982,നിഷ്പക്ഷമായ,0,0,1,1
33947,opmerken,0,0,1,1
31675,bölümünde,0,0,1,1
34980,englobando,0,0,1,1
33943,ссылаясь,0,0,1,1
34987,एल,0,0,1,1
32807,ഏക,0,0,1,1
32808,chatbot,0,0,1,1
34997,göremeyeceğimi,0,0,1,1
34996,chapitre,0,0,1,1
32810,культу»,0,0,1,1
34994,caracteriza,0,0,1,1
34993,d’intentionnalités,0,0,1,1
34992,வேல்ஸையே,0,0,1,1
34991,"
इसी",0,0,1,1
31669,oversvømmelse,0,0,1,1
2328,menzionato,1,1,0,1
1809,nostri,1,1,0,1
34989,солдатам,0,0,1,1
2327,fantasiose,1,1,0,1
2326,personalizzazione,1,1,0,1
34988,анализ,0,0,1,1
33948,reklamer,0,0,1,1
33951,العودة,0,0,1,1
33940,atingir,0,0,1,1
31677,agências,0,0,1,1
31684,സ്വീകരിക്കുക,0,0,1,1
31685,ಅವುಗಳಲ್ಲಿ,0,0,1,1
31686,regimes,0,0,1,1
33955,mismo—​​,0,0,1,1
31687,declínio,0,0,1,1
34968,courbes,0,0,1,1
34967,обращают,0,0,1,1
33956,spécifique,0,0,1,1
34966,mutación,0,0,1,1
2319,cavallo,1,1,0,1
34965,അഴുക്ക്,0,0,1,1
33958,ആവേശത്തിലാണ്,0,0,1,1
31689,skydda,0,0,1,1
31690,திட்டவடிவம்,0,0,1,1
34961,ಹಾಕಿದರೆ,0,0,1,1
31683,slö,0,0,1,1
34970,ಮಾಡಬೇಕಾದದ್ದು,0,0,1,1
34971,متعارضين,0,0,1,1
34976,любыми,0,0,1,1
32803,أرسل,0,0,1,1
33952,comedor,0,0,1,1
31678,ernstige,0,0,1,1
34978,photo,0,0,1,1
34977,последующим,0,0,1,1
31679,अनुमान,0,0,1,1
31680,böyle,0,0,1,1
34972,فازت,0,0,1,1
31681,supervisionar,0,0,1,1
32801,fill,0,0,1,1
34974,வீடியோவுக்கு,0,0,1,1
33953,добрые,0,0,1,1
31682,оперирующий,0,0,1,1
32800,"
dinamarquês",0,0,1,1
34998,ഭാഷയുമായി,0,0,1,1
32811,uppskattar,0,0,1,1
35031,ciberespaço,0,0,1,1
2336,marmellate,1,1,0,1
33929,étapes,0,0,1,1
31633,basada,0,0,1,1
31634,buiten,0,0,1,1
33930,μπόρεσα,0,0,1,1
1805,considerevole,1,1,0,1
2337,lancio,1,1,0,1
35019,ಮಾನಸಿಕವಾಗಿ,0,0,1,1
31637,पाँच,0,0,1,1
32822,உச்சரிக்கிறீர்கள்,0,0,1,1
35018,respondeu,0,0,1,1
33932,പങ്കു,0,0,1,1
1807,alternativa,1,1,0,1
35016,ರಹಸ್ಯವಾಗಿ,0,0,1,1
31638,numéricos,0,0,1,1
31639,ಬಳಸುತ್ತೇವೆ,0,0,1,1
35022,efetivamente,0,0,1,1
32825,поиска,0,0,1,1
35023,‘அண்மைய,0,0,1,1
32829,விரும்புவதாகக்,0,0,1,1
2165,frega,1,1,0,1
32831,"
urdu",0,0,1,1
35029,تتجسد,0,0,1,1
31624,tecavüz,0,0,1,1
35028,gagné,0,0,1,1
2166,inizialmente,1,1,0,1
31625,mesclamse,0,0,1,1
32826,رقيقة,0,0,1,1
32828,правильнее,0,0,1,1
31627,convención,0,0,1,1
35025,consultam,0,0,1,1
31629,quedaría,0,0,1,1
35024,photographique,0,0,1,1
31630,ಹಾಗಾಗಿ,0,0,1,1
32821,பங்களிப்பாளர்களையும்,0,0,1,1
35015,vikipediler,0,0,1,1
35000,जाए।,0,0,1,1
31641,ചെയ്യുന്നതിനെക്കുറിച്ച്,0,0,1,1
35006,otrs,0,0,1,1
33936,حساء,0,0,1,1
31657,ಉಡುಗೆ,0,0,1,1
35005,بنسخ,0,0,1,1
35004,உயர்ந்தது,0,0,1,1
31658,دقة,0,0,1,1
33937,മകളെക്കുറിച്ചും,0,0,1,1
35003,especializados,0,0,1,1
35002,медейко,0,0,1,1
2330,imparassero,1,1,0,1
33939,рыночную,0,0,1,1
35001,феврале,0,0,1,1
31661,deletion,0,0,1,1
31662,ಕೆಟ್ಟದಾಗಿದೆ,0,0,1,1
31663,oprettes,0,0,1,1
33935,يكافئ,0,0,1,1
32815,nécessitant,0,0,1,1
31656,ഗ്നു,0,0,1,1
33933,पूछे,0,0,1,1
32819,أمستردام،,0,0,1,1
35014,ക്ലാസ്സിൽ,0,0,1,1
35013,excessivamente,0,0,1,1
32817,videoya,0,0,1,1
32816,casualidad,0,0,1,1
2335,sapeva,1,1,0,1
31649,conservar,0,0,1,1
33934,«the,0,0,1,1
2334,friulano,1,1,0,1
2333,rimanga,1,1,0,1
2332,adorabile,1,1,0,1
31654,broadly,0,0,1,1
31655,سؤالك,0,0,1,1
35009,ലഭിക്കുമ്പോൾ,0,0,1,1
34803,الخوف,0,0,1,1
5652,periodismo,0,0,1,1
36242,ಹೆಚ್ಚಿಸಿ,0,0,1,1
44026,tirasse,0,0,1,1
44067,adaptable,0,0,1,1
44066,cunhou,0,0,1,1
44064,രേഖീയസമവാക്യമായിരിക്കണോ,0,0,1,1
44061,érasme,0,0,1,1
44059,« wikipédia,0,0,1,1
44058,പരീക്ഷകൾ,0,0,1,1
44057,işaretiyle,0,0,1,1
44056,устарел,0,0,1,1
44055,laissant,0,0,1,1
44054,yapamayacak,0,0,1,1
44053,затоплен,0,0,1,1
44052,அரண்மனையில்,0,0,1,1
44051,медиафайлы,0,0,1,1
44050,llegada,0,0,1,1
44049,"
आलेमैनिक",0,0,1,1
44046,آداب,0,0,1,1
44045,استطلاع,0,0,1,1
44043,ocasionais,0,0,1,1
44042,karmaşa,0,0,1,1
44040,woke,0,0,1,1
44039,merely,0,0,1,1
44038,dérangerait,0,0,1,1
44036,سارت,0,0,1,1
44034,организации,0,0,1,1
44033,inclut,0,0,1,1
44032,பயன்பாட்டுக்கு,0,0,1,1
44031,சலுகைகள்,0,0,1,1
44029,brödbröd,0,0,1,1
44028,ವೀಡಿಯೊ,0,0,1,1
44069,λογισμικό,0,0,1,1
44070,stumpfer,0,0,1,1
44073,ωθεί,0,0,1,1
44097,parentheses,0,0,1,1
44116,boğulma,0,0,1,1
498,ripeta,1,1,0,1
44113,magnetic,0,0,1,1
44112,октябрь,0,0,1,1
44111,ശ്രമിക്കുന്നു,0,0,1,1
44109,നിങ്ങളോടൊപ്പം,0,0,1,1
44106,واضحة,0,0,1,1
44105,ഉച്ചഭക്ഷണത്തിന്,0,0,1,1
44104,calmezvous,0,0,1,1
44103,renforcement,0,0,1,1
44102,griffith,0,0,1,1
44099,tryckta,0,0,1,1
44098,pflanzen,0,0,1,1
44095,шекман,0,0,1,1
500,soprattutto,1,1,0,1
44094,estimate,0,0,1,1
44093,gebruikelijke,0,0,1,1
44092,unterhaltung,0,0,1,1
44091,ചോദിക്കുക,0,0,1,1
44088,allemagne,0,0,1,1
44087,repair,0,0,1,1
44085,apreço,0,0,1,1
44084,commencer,0,0,1,1
44083,adéquat,0,0,1,1
44082,kommentieren,0,0,1,1
44080,religieux,0,0,1,1
44079,അവലംബം,0,0,1,1
44078,अभिवादन,0,0,1,1
44027,sardenberg,0,0,1,1
44025,«лучшую,0,0,1,1
43572,நபர்களாக,0,0,1,1
44024,συστηματική,0,0,1,1
43981,"
तुर्कमैनी",0,0,1,1
43979,முழுமையானது,0,0,1,1
43977,ವಿಶ್ವವಿದ್ಯಾನಿಲಯಕ್ಕೆ,0,0,1,1
43976,«администратора»,0,0,1,1
43975,incidenter,0,0,1,1
43972,cooled,0,0,1,1
43971,உள்ளடக்க,0,0,1,1
43970,presumiblemente,0,0,1,1
43969,σχολιάστε,0,0,1,1
43968,molecular,0,0,1,1
43967,europe »,0,0,1,1
521,correzione,1,1,0,1
43964,கலாச்சார,0,0,1,1
43961,dependência,0,0,1,1
43960,ಕಳುಹಿಸಿದ್ದೀರಿ,0,0,1,1
43959,darunter,0,0,1,1
43958,определённым,0,0,1,1
43957,écriture…,0,0,1,1
43955,முறைமை,0,0,1,1
43954,meewerken,0,0,1,1
43953,இரண்டாம்,0,0,1,1
43951,ಇಂಗ್ಲಿಷ್ನಲ್ಲಿ,0,0,1,1
43950,குழப்பத்தில்,0,0,1,1
43949,sådant,0,0,1,1
43948,политикам,0,0,1,1
43947,സന്ദേശങ്ങളിൽ,0,0,1,1
43946,централизованного,0,0,1,1
522,rimasta,1,1,0,1
43939,bereikbaar,0,0,1,1
43982,¿me,0,0,1,1
43983,الرائحة,0,0,1,1
517,tentativi,1,1,0,1
44007,لتعانق,0,0,1,1
44023,ഹോം,0,0,1,1
44022,jämförelse,0,0,1,1
44021,процесс,0,0,1,1
44020,censure »,0,0,1,1
44018,ഇല്ലെന്നല്ല,0,0,1,1
509,attualmente,1,1,0,1
44016,yakalanma,0,0,1,1
44014,വിക്കിപീഡിയയ്ക്ക്,0,0,1,1
44013,droite,0,0,1,1
512,magari,1,1,0,1
513,nonostante,1,1,0,1
44009,ونرجسية,0,0,1,1
44008,wish,0,0,1,1
44006,результатов,0,0,1,1
43987,tolerance,0,0,1,1
44004,invocadas,0,0,1,1
514,tante,1,1,0,1
44002,أمام,0,0,1,1
44001,относился,0,0,1,1
44000,buurt,0,0,1,1
515,codifica,1,1,0,1
43998,ಸಭೆಯ,0,0,1,1
43997,ലഭിച്ചുവെന്ന്,0,0,1,1
43995,poca,0,0,1,1
516,cosiddette,1,1,0,1
43993,autorisés,0,0,1,1
43990,"
galego",0,0,1,1
43989,картофеля,0,0,1,1
497,controtendenza,1,1,0,1
496,romancio,1,1,0,1
44121,எங்காவது,0,0,1,1
44123,stimme,0,0,1,1
44245,വാക്കിന്,0,0,1,1
44243,اصطناعي,0,0,1,1
44242,καφέ,0,0,1,1
44241,manifeste,0,0,1,1
44240,അത്തരത്തിൽ,0,0,1,1
44239,ενοχλητικής,0,0,1,1
44231,accredited,0,0,1,1
44228,arabasına,0,0,1,1
44227,экспертной,0,0,1,1
44226,വന്ന,0,0,1,1
44225,أخطط,0,0,1,1
44224,seguido,0,0,1,1
481,notorietà,1,1,0,1
483,funzionali,1,1,0,1
44221,अंतरों,0,0,1,1
44219,artículos»,0,0,1,1
44218,kinderen,0,0,1,1
484,carlo,1,1,0,1
44216,لكم,0,0,1,1
44215,frokost,0,0,1,1
44214,nylige,0,0,1,1
44213,польская,0,0,1,1
44212,ഭാഷാസ്വാധീനമുണ്ടാവും,0,0,1,1
44211,μιλήσει,0,0,1,1
44210,समितियां,0,0,1,1
44209,diversiteit,0,0,1,1
44208,الاصطناعي,0,0,1,1
44205,sänkte,0,0,1,1
44200,കഠിനമായ,0,0,1,1
44247,ineffektivt,0,0,1,1
44248,mechanisms,0,0,1,1
44249,"
albanês",0,0,1,1
44276,zout,0,0,1,1
473,«per,1,1,0,1
475,nomi,1,1,0,1
476,donazioni,1,1,0,1
44289,idari,0,0,1,1
44288,لكني,0,0,1,1
44286,öppnades,0,0,1,1
44285,troca,0,0,1,1
44284,учётом,0,0,1,1
44283,disons,0,0,1,1
44282,വിവരിക്കുമ്പോൾ,0,0,1,1
477,transazione,1,1,0,1
44279,haline,0,0,1,1
44278,للإشارة,0,0,1,1
44273,بعدي,0,0,1,1
44252,базу,0,0,1,1
44272,educadamente,0,0,1,1
44271,доставляют,0,0,1,1
44269,globe,0,0,1,1
44267,helpful,0,0,1,1
44265,точек,0,0,1,1
44264,ഗ്രഹങ്ങളിൽ,0,0,1,1
44263,എന്നതിൻറെ,0,0,1,1
44261,hemmelighedsfuldt,0,0,1,1
44259,fewer,0,0,1,1
44258,περιθώριο,0,0,1,1
44257,eserler,0,0,1,1
44255,travail »,0,0,1,1
44253,соберись,0,0,1,1
44199,vandallamalarına,0,0,1,1
44198,லிப்ரேவை,0,0,1,1
485,polinomiale,1,1,0,1
44142,கூறும்போது,0,0,1,1
44160,imprecisas,0,0,1,1
44158,российскую,0,0,1,1
44157,stresses,0,0,1,1
44156,verkeerde,0,0,1,1
44155,présentés,0,0,1,1
492,citiamo,1,1,0,1
44151,hr •,0,0,1,1
44149,வழமையான,0,0,1,1
44148,сомнений,0,0,1,1
44147,ثانية,0,0,1,1
44146,märkspråken,0,0,1,1
44144,proprietário,0,0,1,1
44143,diverge,0,0,1,1
495,discreta,1,1,0,1
44162,dinle,0,0,1,1
44137,"
फ़ैरोई",0,0,1,1
44136,ಸುದ್ದಿಯಲ್ಲಿ,0,0,1,1
44135,அவற்றை,0,0,1,1
44134,ವಾರ,0,0,1,1
44133,технология,0,0,1,1
44132,स्वामित्व,0,0,1,1
44131,baserat,0,0,1,1
44130,suppressions,0,0,1,1
44129,lief,0,0,1,1
44128,rangeret,0,0,1,1
44127,preciosas,0,0,1,1
44126,phd,0,0,1,1
44124,gouvernée,0,0,1,1
491,wikinotizie,1,1,0,1
44163,لمواقع,0,0,1,1
44196,müthiş,0,0,1,1
44180,опубликовали,0,0,1,1
44194,السجون,0,0,1,1
44193,പതാകവാഹക‍,0,0,1,1
44192,ತೊರೆಯುತ್ತಿದ್ದೇನೆ,0,0,1,1
44190,imagination,0,0,1,1
44189,يقارب,0,0,1,1
44188,أعلن,0,0,1,1
486,insalate,1,1,0,1
487,peˈdia,1,1,0,1
44185,årlig,0,0,1,1
488,rese,1,1,0,1
44183,éducation,0,0,1,1
489,biologica,1,1,0,1
44181,straight,0,0,1,1
44179,proyecto​,0,0,1,1
44164,ಮುಳುಗುತ್ತಿದ್ದೇನೆ,0,0,1,1
44178,"
galês",0,0,1,1
44177,استخدامه,0,0,1,1
44176,σήμα,0,0,1,1
44175,minimiza,0,0,1,1
44174,യന്ത്രത്തെ,0,0,1,1
490,manutenzione,1,1,0,1
44172,издаётся,0,0,1,1
44171,salienta,0,0,1,1
44170,milletin,0,0,1,1
44169,sûrement,0,0,1,1
44167,மனிதர்,0,0,1,1
44166,« un,0,0,1,1
44165,ജീവനും,0,0,1,1
43938,أسوأ,0,0,1,1
43937,circuits,0,0,1,1
43936,ಸೆಲ್,0,0,1,1
554,simpatici,1,1,0,1
43700,நடித்த,0,0,1,1
569,coincidere,1,1,0,1
43698,связаны,0,0,1,1
43697,introduzida,0,0,1,1
570,abbonamenti,1,1,0,1
43694,ആദ്യശ്രമം,0,0,1,1
43693,yakalamadığını,0,0,1,1
43691,μοιάζεις,0,0,1,1
43689,новую,0,0,1,1
43688,προσφορά,0,0,1,1
43687,مواضيع,0,0,1,1
43686,மகிழ்ச்சி,0,0,1,1
43684,odası,0,0,1,1
43683,ಆಶ್ಚರ್ಯಪಟ್ಟರು,0,0,1,1
43682,« victimes »,0,0,1,1
43681,ചെയ്യണമെന്ന്,0,0,1,1
43679,en •,0,0,1,1
43678,meteorite,0,0,1,1
43677,البناء,0,0,1,1
43676,पड़ाव,0,0,1,1
43675,agrawal,0,0,1,1
43674,galet,0,0,1,1
573,intitolata,1,1,0,1
43672,лично,0,0,1,1
43671,plaques,0,0,1,1
43670,എന്നറിയുവാൻ,0,0,1,1
43669,opeten,0,0,1,1
43667,ക്യാൻസർ,0,0,1,1
43666,enkyklios,0,0,1,1
43701,transmitir,0,0,1,1
43702,августе,0,0,1,1
43704,സൗകര്യം,0,0,1,1
43728,placozoans—animals,0,0,1,1
555,nascono,1,1,0,1
43747,exnihilo,0,0,1,1
43745,delante,0,0,1,1
43744,κάπως,0,0,1,1
43743,വിഷയത്തെപ്പറ്റി,0,0,1,1
43742,പതിപ്പുകളുണ്ട്,0,0,1,1
556,indipendenti,1,1,0,1
43738,consideration,0,0,1,1
43737,ಪ್ರವಾಹ,0,0,1,1
43735,ആരംഭിക്കാൻ,0,0,1,1
43734,негибко,0,0,1,1
43731,canadá,0,0,1,1
43729,улыбнуться,0,0,1,1
43725,ومعظم,0,0,1,1
43706,grattis,0,0,1,1
43724,ब्रांडचैनलकॉम,0,0,1,1
43722,ingenting,0,0,1,1
43721,tendent,0,0,1,1
43719,изумрудов,0,0,1,1
43717,أندريا,0,0,1,1
43716,കുറിക്കുന്നു,0,0,1,1
562,rigorosamente,1,1,0,1
43714,keken,0,0,1,1
43712,தொடங்கினாள்,0,0,1,1
43711,vueltas,0,0,1,1
43710,affamé,0,0,1,1
43709,bulunma,0,0,1,1
564,aule,1,1,0,1
43665,الإضافة،,0,0,1,1
43664,بالنساء,0,0,1,1
43663,сообщается,0,0,1,1
43595,vänder,0,0,1,1
43619,डिलीवरी,0,0,1,1
43616,adorável,0,0,1,1
43614,reseñados,0,0,1,1
576,applicabili,1,1,0,1
43610,guardaredes,0,0,1,1
43609,ವಿಷಯದಲ್ಲಿ,0,0,1,1
43608,soleil ,0,0,1,1
43607,യൂണികോഡ്,0,0,1,1
43606,procedente,0,0,1,1
43604,विरोधाभास,0,0,1,1
577,renderà,1,1,0,1
43601,gætte,0,0,1,1
43598,görünüyor,0,0,1,1
43593,frontière,0,0,1,1
43621,maestro,0,0,1,1
43592,ವೇಗದಲ್ಲಿರಲು,0,0,1,1
43591,مقارنة,0,0,1,1
43590,fulllength,0,0,1,1
43586,сотрудничество,0,0,1,1
43585,paren,0,0,1,1
43582,ഉറുമ്പുകൂട്ടത്തെ,0,0,1,1
580,riprogrammazione,1,1,0,1
43580,ترفض,0,0,1,1
43578,comienzo,0,0,1,1
43577,भूतपूर्व,0,0,1,1
43576,listade,0,0,1,1
43575,ставились,0,0,1,1
581,affonda,1,1,0,1
43620,सहीसही,0,0,1,1
43623,takes,0,0,1,1
43662,procurála,0,0,1,1
43645,അമ്മയല്ലേ,0,0,1,1
43661,immediately,0,0,1,1
43660,başlıklı,0,0,1,1
43659,piecemeal,0,0,1,1
43658,derslerimi,0,0,1,1
43657,yakalayamadım,0,0,1,1
43655,deneyin,0,0,1,1
43654,cartas,0,0,1,1
43652,своё,0,0,1,1
43651,remuneradas,0,0,1,1
43649,ബരാക്,0,0,1,1
43648,വിവരണം,0,0,1,1
43647,staring,0,0,1,1
43646,cayó,0,0,1,1
43643,المجتمع ,0,0,1,1
43624,origem,0,0,1,1
43642,resurser,0,0,1,1
43641,ഒഴിവാക്കാറുണ്ട്,0,0,1,1
43640,प्रेक्षण,0,0,1,1
43638,ευγενική,0,0,1,1
43637,изложением,0,0,1,1
43635,ziyaretçilerinin,0,0,1,1
43634,πλυντήριο,0,0,1,1
43633,heritage,0,0,1,1
43632,ಅದರೊಂದಿಗೆ,0,0,1,1
43631,അറിയില്ലായിരുന്നു,0,0,1,1
43629,வளர்ச்சிக்கு,0,0,1,1
43627,ideias,0,0,1,1
43626,всемирная,0,0,1,1
43750,ஓடினாள்,0,0,1,1
43752,läsbarhet,0,0,1,1
43935,géologiques,0,0,1,1
43753,stoppade,0,0,1,1
43880,പഴയ,0,0,1,1
43878,enkäten,0,0,1,1
43877,laugh,0,0,1,1
43876,muddled,0,0,1,1
43874,ಮುಳುಗಿಸುತ್ತದೆ,0,0,1,1
43873,lacus,0,0,1,1
43872,flaws,0,0,1,1
43871,വാക്യങ്ങൾ,0,0,1,1
43870,intégralement,0,0,1,1
43869,நிறுத்தம்,0,0,1,1
43867,λειτουργήσει,0,0,1,1
43866,grundas,0,0,1,1
43865,व्यवहार,0,0,1,1
43864,funkelnden,0,0,1,1
43863,éternué,0,0,1,1
43860,σύνταξη,0,0,1,1
43859,irregular​,0,0,1,1
43858,وأحيانًا,0,0,1,1
536,aziendali,1,1,0,1
43856,realizadas,0,0,1,1
43855,tasty,0,0,1,1
43854,signo,0,0,1,1
43853,خطأ,0,0,1,1
43852,giriş,0,0,1,1
43851,شجع,0,0,1,1
43850,"navnet
",0,0,1,1
43849,استيقظت,0,0,1,1
43848,подрывает,0,0,1,1
43847,இதில்,0,0,1,1
43881,amerikalılar,0,0,1,1
530,italia,1,1,0,1
43883,писатель,0,0,1,1
43905,divergem,0,0,1,1
43934,matando,0,0,1,1
43931,honored,0,0,1,1
43930,ακούστε,0,0,1,1
43929,മര്യാദയുള്ള,0,0,1,1
43928,nose,0,0,1,1
43925,العد،,0,0,1,1
43919,reversores,0,0,1,1
43917,आइसक्रीम,0,0,1,1
43913,multicamadas,0,0,1,1
43912,написанный,0,0,1,1
43911,φοβισμένος,0,0,1,1
43909,nachmittags,0,0,1,1
43906,pugilat,0,0,1,1
43904,للتسجيل,0,0,1,1
528,mammifero,1,1,0,1
525,zuppa,1,1,0,1
526,multipli,1,1,0,1
43901,interrumpiendo,0,0,1,1
43900,gjord,0,0,1,1
527,organi,1,1,0,1
43897,digestive,0,0,1,1
43895,θυμάστε,0,0,1,1
43894,décompté,0,0,1,1
43893,weed,0,0,1,1
43892,χρησιμοποιήσεις,0,0,1,1
43891,മുന്നോട്ടുപോകുന്നത്,0,0,1,1
43890,soñaste,0,0,1,1
43887,സ്ഥാനമാണ്,0,0,1,1
43844,improduktivt,0,0,1,1
43843,løb,0,0,1,1
43842,oudengels,0,0,1,1
43773,diferenciación,0,0,1,1
43799,toegankelijk,0,0,1,1
43793,ayuda,0,0,1,1
43792,ಹೊರಟರು,0,0,1,1
43790,μακριά,0,0,1,1
43789,postgresql,0,0,1,1
43787,introducen,0,0,1,1
43786,டிசம்பர்,0,0,1,1
43784,conferencista,0,0,1,1
550,automatiche,1,1,0,1
43779,милыми,0,0,1,1
43778,aggregate,0,0,1,1
43776,viu,0,0,1,1
43774,أوراق,0,0,1,1
43772,பூட்டப்பட்டு,0,0,1,1
43801,concernés,0,0,1,1
43770,كوب,0,0,1,1
43769,ateliers,0,0,1,1
43768,பெயரும்,0,0,1,1
43767,показали,0,0,1,1
43766,персоналом,0,0,1,1
553,predispone,1,1,0,1
43764,गुणधर्मों,0,0,1,1
43762,beneficial,0,0,1,1
43761,reflejo,0,0,1,1
43760,गाँव,0,0,1,1
43759,क्लिफ्फोर्ड,0,0,1,1
43756,participe,0,0,1,1
43755,amostragem,0,0,1,1
43800,eklerler,0,0,1,1
43802,ഏറെയുണ്ടാകുന്നതുകൊണ്ടുള്ള,0,0,1,1
43840,tax”,0,0,1,1
43825,stöd,0,0,1,1
43839,unrelated,0,0,1,1
43838,"
sundanês",0,0,1,1
43837,கிடப்பேன்,0,0,1,1
43836,ಡಾಲರ್,0,0,1,1
43835,téléversement,0,0,1,1
43834,"
संस्कृत",0,0,1,1
540,condiviso,1,1,0,1
43832,авторское,0,0,1,1
43831,abordan,0,0,1,1
43830,criminal,0,0,1,1
43829,conversely,0,0,1,1
43828,weggestuurd,0,0,1,1
43827,يظن,0,0,1,1
43824,пределах,0,0,1,1
43806,рейтинге,0,0,1,1
43823,deliberately,0,0,1,1
43821,അർഹതയുണ്ടെന്ന്,0,0,1,1
43820,qualified,0,0,1,1
43819,ಕಾಮೆಂಟ್,0,0,1,1
43818,शैलीगत,0,0,1,1
43817,നിയമവിരുദ്ധരെ,0,0,1,1
43816,ಪಡೆಯುತ್ತಾರೆ,0,0,1,1
43815,« encyclopédie »,0,0,1,1
43814,prévaut,0,0,1,1
43813,dull,0,0,1,1
542,logici,1,1,0,1
43810,lesson,0,0,1,1
544,precedente,1,1,0,1
471,triplicate,1,1,0,1
44297,കർത്തവ്യം,0,0,1,1
44298,wikipedianerna,0,0,1,1
394,specifica,1,1,0,1
44795,предложил,0,0,1,1
44794,ofrecen,0,0,1,1
44793,slug,0,0,1,1
44792,désignant,0,0,1,1
44791,spirituel,0,0,1,1
44790,അന്ന്,0,0,1,1
44789,yazılmaktadır,0,0,1,1
44788,καθοριστεί,0,0,1,1
44787,suffisamment,0,0,1,1
44785,фламмокс,0,0,1,1
44784,εμπορικό,0,0,1,1
44783,ögonblicket,0,0,1,1
44781,uitgespookt,0,0,1,1
44780,bureaucratic,0,0,1,1
44778,قرية,0,0,1,1
44776,வெளியேறுகிறேன்,0,0,1,1
44775,полезных,0,0,1,1
44774,assistants,0,0,1,1
44772,யோசித்துக்கொண்டிருந்தேன்,0,0,1,1
44771,faça,0,0,1,1
44770,niettemin,0,0,1,1
44768,يتجاوز,0,0,1,1
403,direttamente,1,1,0,1
44766,demokrater,0,0,1,1
44765,मॉडल,0,0,1,1
44764,ബഹുപദമായിരിക്കണോ,0,0,1,1
44763,razão,0,0,1,1
44762,circling,0,0,1,1
44761,informe,0,0,1,1
44798,പത്തുവാചകം,0,0,1,1
44799,goza,0,0,1,1
44800,fiaskoer,0,0,1,1
44823,संतुलित,0,0,1,1
396,stia,1,1,0,1
44839,rempli,0,0,1,1
44837,kızgınım,0,0,1,1
44836,сведений,0,0,1,1
44835,സൂര്യനിൽ,0,0,1,1
44834,posts,0,0,1,1
44833,talloze,0,0,1,1
44831,جعلني,0,0,1,1
44830,avslöjande,0,0,1,1
44829,absorbing,0,0,1,1
44828,двумя,0,0,1,1
44827,വിഷമകരമായ,0,0,1,1
44824,கடைப்பிடிக்கப்படுகிறது,0,0,1,1
44822,ανόητος,0,0,1,1
44801,எப்படியாவது,0,0,1,1
44821,heiß,0,0,1,1
44820,वाशिंगटन,0,0,1,1
44818,eerdere,0,0,1,1
44815,πατάτες,0,0,1,1
398,efficacia,1,1,0,1
44813,mains,0,0,1,1
44811,philosophicalcontent,0,0,1,1
44809,கூட்டு,0,0,1,1
44808,redaktion,0,0,1,1
44807,associée,0,0,1,1
44806,alsjeblieft,0,0,1,1
399,rilevante,1,1,0,1
400,reale,1,1,0,1
404,identificano,1,1,0,1
44758,interventions,0,0,1,1
44757,suscetível,0,0,1,1
44700,पर्ल,0,0,1,1
44717,ಮೂಲವೆಂದರೆ,0,0,1,1
44716,تلميحًا,0,0,1,1
44715,ehud,0,0,1,1
44714,associëren,0,0,1,1
44713,arkadaş,0,0,1,1
405,tirati,1,1,0,1
44708,india,0,0,1,1
44707,सलेक्ट,0,0,1,1
44706,contenues,0,0,1,1
44705,النزاعات،,0,0,1,1
44704,недостатков,0,0,1,1
44703,الممارسة,0,0,1,1
44702,maratones,0,0,1,1
44699,redistribuição,0,0,1,1
44720,рунете —,0,0,1,1
44698,weeks,0,0,1,1
44697,reward,0,0,1,1
44696,признать,0,0,1,1
44694,അനാശാസ്യമായ,0,0,1,1
44692,വാൻഡലിസത്തിന്,0,0,1,1
44691,المشرقة,0,0,1,1
44690,meningsfulla,0,0,1,1
408,quei,1,1,0,1
44688,confondu,0,0,1,1
44687,തകർന്നു,0,0,1,1
44686,şarkılarda,0,0,1,1
44685,révolutions,0,0,1,1
44684,للعربية,0,0,1,1
44719,complementary,0,0,1,1
44721,«мне,0,0,1,1
44756,പ്രിന്റ്,0,0,1,1
44739,ಗಣಿತದ,0,0,1,1
44755,αυξηθεί,0,0,1,1
44754,दलित,0,0,1,1
44753,முயற்சித்தது,0,0,1,1
44752,reduce,0,0,1,1
44751,sécurisées,0,0,1,1
44750,récurrentes,0,0,1,1
44749,खुफिया,0,0,1,1
44747,televisión,0,0,1,1
44746,ζητώ,0,0,1,1
44745,recouverte,0,0,1,1
44743,механизма,0,0,1,1
44741,specialized,0,0,1,1
44740,exam,0,0,1,1
44738,ആന,0,0,1,1
44722,सामी,0,0,1,1
44737,विशेषताएं,0,0,1,1
44736,irgendwo,0,0,1,1
44735,சிறப்புக்கட்டுரைத்,0,0,1,1
44734,gekruist,0,0,1,1
44733,സിദ്ധാന്ത,0,0,1,1
44732,possua,0,0,1,1
44731,объявлено,0,0,1,1
44730,expansions,0,0,1,1
44728,neerleggen,0,0,1,1
44727,финансирование,0,0,1,1
44726,seçkin,0,0,1,1
44724,jupiter,0,0,1,1
44723,humanities,0,0,1,1
395,definito,1,1,0,1
44843,اللغة،,0,0,1,1
409,stupro,1,1,0,1
44844,சந்திப்பிற்கும்,0,0,1,1
44969,smilende,0,0,1,1
44968,engagé,0,0,1,1
44967,kurucularından,0,0,1,1
378,sorridendosi,1,1,0,1
44964,விக்கிப்பீடியாகாம்,0,0,1,1
44963,dışarıdayken,0,0,1,1
44962,получала,0,0,1,1
44957,വിക്കിസമൂഹമെന്നും,0,0,1,1
44955,ಹೇಳಿದ್ದೇನೆಂದರೆ,0,0,1,1
44954,ஏழை,0,0,1,1
44953,dust,0,0,1,1
44951,venezuela,0,0,1,1
44950,söylüyor,0,0,1,1
44948,മേഖലകളിൽ,0,0,1,1
44947,luidspreker,0,0,1,1
44945,νυφικό,0,0,1,1
384,scintillanti,1,1,0,1
44943,малым,0,0,1,1
44942,ಕೇಳಿದ್ದೇವೆ,0,0,1,1
44941,തയ്യാറാക്കിയിട്ടുണ്ട്,0,0,1,1
44940,பயணித்தது,0,0,1,1
44938,ಪದಗಳಿಗಿಂತ,0,0,1,1
44936,behandeld,0,0,1,1
44935,inútiles,0,0,1,1
44934,satisfação,0,0,1,1
44932,massachusetts,0,0,1,1
44931,inexactitudes,0,0,1,1
44930,geluksvogel,0,0,1,1
44928,hughes,0,0,1,1
44970,ಹತ್ತಿರ,0,0,1,1
44971,öyleyse,0,0,1,1
44973,കാഴ്ച,0,0,1,1
44994,«nuestra,0,0,1,1
45011,giydiğim,0,0,1,1
45010,gelassen,0,0,1,1
45009,procuran,0,0,1,1
45008,والسلج,0,0,1,1
45007,jämförbar,0,0,1,1
45006,ஹெல்லரால்,0,0,1,1
45005,رؤيتك,0,0,1,1
45003,reprinted,0,0,1,1
45001,переведённые,0,0,1,1
45000,ചേർക്കാനോ,0,0,1,1
44999,gelin,0,0,1,1
44998,vary,0,0,1,1
44996,diverged,0,0,1,1
44992,संदर्भित,0,0,1,1
44974,அறிந்திருக்க,0,0,1,1
44991,архитектуру,0,0,1,1
44988,pétrole,0,0,1,1
44987,கவலைப்படாதே,0,0,1,1
44986,буквально,0,0,1,1
376,gay,1,1,0,1
44983,نقلاً,0,0,1,1
44981,продавались,0,0,1,1
44980,абсолютно,0,0,1,1
377,nient,1,1,0,1
44978,kina,0,0,1,1
44977,neoproterozoic,0,0,1,1
44976,besat,0,0,1,1
44975,liebes,0,0,1,1
44927,interdisciplinary,0,0,1,1
44926,convenient,0,0,1,1
44925,والتحيزات,0,0,1,1
44861,förutsättning,0,0,1,1
44880,rejecting,0,0,1,1
44879,ಶಿಕ್ಷಕನು,0,0,1,1
44878,comporte,0,0,1,1
44876,ändamålet,0,0,1,1
44875,воздействия,0,0,1,1
44874,ஐகானைக்,0,0,1,1
44873,освещении,0,0,1,1
44872,dol,0,0,1,1
44870,voudrais,0,0,1,1
44866,novel,0,0,1,1
44865,recommendations,0,0,1,1
44864,guider,0,0,1,1
44863,"
मैसिडोनियाई",0,0,1,1
389,decennio,1,1,0,1
44883,ചിന്തിച്ചേക്കാം,0,0,1,1
44859,sjunka,0,0,1,1
44858,категории,0,0,1,1
391,tradizionali»,1,1,0,1
44854,وأنتم,0,0,1,1
44853,klarer,0,0,1,1
44852,खिलाते,0,0,1,1
44851,studentuppsatser,0,0,1,1
392,indicarne,1,1,0,1
44849,‎ˌwɪkiˈpidiə‏,0,0,1,1
44848,document,0,0,1,1
44847,sujeitas,0,0,1,1
44846,nyt,0,0,1,1
44845,designation,0,0,1,1
44882,б,0,0,1,1
44885,правил,0,0,1,1
44923,لطريقة,0,0,1,1
44902,மனிதனும்,0,0,1,1
44922,förändra,0,0,1,1
44921,speak,0,0,1,1
44920,தளங்களுக்கான,0,0,1,1
44915,marquées,0,0,1,1
44914,inapropiadas,0,0,1,1
44912,لجنة,0,0,1,1
44910,asombrada,0,0,1,1
44909,ಗಾಡಿಯೊಂದಿಗೆ,0,0,1,1
44908,exercer,0,0,1,1
44907,impidiendo,0,0,1,1
44906,deeply,0,0,1,1
44905,படித்துக்கொண்டிருக்கிறேன்,0,0,1,1
44904,symbiantelefoner,0,0,1,1
44901,suggérait,0,0,1,1
44886,funnits,0,0,1,1
44900,salientou,0,0,1,1
44899,ചോദിക്കാൻ‌,0,0,1,1
44898,подкреплением,0,0,1,1
44897,प्राणी,0,0,1,1
44896,ಯಶಸ್ವಿಯಾದರೆ,0,0,1,1
44895,aceito,0,0,1,1
386,adaline,1,1,0,1
44893,palais,0,0,1,1
44892,secrètement,0,0,1,1
44891,stattdessen,0,0,1,1
44890,затмившей,0,0,1,1
44889,actionnaire,0,0,1,1
44887,लटकाओ।,0,0,1,1
44683,physicians,0,0,1,1
44679,elogiando,0,0,1,1
44300,താനും,0,0,1,1
44474,الطالب,0,0,1,1
44431,അന്ധാളിച്ച്,0,0,1,1
44430,entendía,0,0,1,1
44429,ontem,0,0,1,1
44428,نقودًا,0,0,1,1
44427,rijksdienst,0,0,1,1
44426,limitamse,0,0,1,1
447,stilistiche,1,1,0,1
44424,الهاتف,0,0,1,1
44423,textbooks,0,0,1,1
44422,vraie,0,0,1,1
44421,stiftelsens,0,0,1,1
44420,ترميز,0,0,1,1
44417,gitmek,0,0,1,1
44414,ഓയെപ്പോലെയാണ്,0,0,1,1
44413,gidiyorsa,0,0,1,1
44412,τρίμηνο,0,0,1,1
44411,poderes,0,0,1,1
448,funzionerà,1,1,0,1
451,seduto,1,1,0,1
453,comportare,1,1,0,1
44406,consultaient,0,0,1,1
44404,десятке,0,0,1,1
44403,സമ്പത്ത്,0,0,1,1
44402,archieven,0,0,1,1
44400,κούκλα,0,0,1,1
44398,بيركمان,0,0,1,1
44397,γεμάτη,0,0,1,1
44394,gesicht,0,0,1,1
44393,genaamd,0,0,1,1
44432,बताएं।,0,0,1,1
44433,metne,0,0,1,1
44434,hacían,0,0,1,1
44453,franskt,0,0,1,1
44472,interglacial,0,0,1,1
441,wikiversità,1,1,0,1
44470,اعتمادًا,0,0,1,1
44469,kaynaklarını,0,0,1,1
44467,يحدق,0,0,1,1
44466,بحجب,0,0,1,1
44463,दोहराए।,0,0,1,1
44461,d’identification »,0,0,1,1
44459,التاريخية,0,0,1,1
44458,года»,0,0,1,1
443,apertamente,1,1,0,1
44456,umgegangen,0,0,1,1
44454,appareils,0,0,1,1
44452,documentary,0,0,1,1
44435,gratuitement,0,0,1,1
44451,nette,0,0,1,1
44450,yaparsın,0,0,1,1
44449,snarare,0,0,1,1
445,economici,1,1,0,1
44447,comic,0,0,1,1
44446,« featured,0,0,1,1
44444,الرقم,0,0,1,1
44443,grandir,0,0,1,1
44442,gözlerimi,0,0,1,1
44440,vérifiabilité,0,0,1,1
44439,permitindo,0,0,1,1
44437,schnecke,0,0,1,1
44436,построения,0,0,1,1
44392,blockeringar,0,0,1,1
44391,inexpertos,0,0,1,1
458,volevamo,1,1,0,1
44320,النص,0,0,1,1
44334,pretty,0,0,1,1
44333,விக்கிப்பீடியாவிற்கும்,0,0,1,1
44332,traditionallycompiled,0,0,1,1
44331,exceeds,0,0,1,1
44330,hellen,0,0,1,1
44329,quarry,0,0,1,1
44328,αντιγράψετε,0,0,1,1
44327,बोरिस,0,0,1,1
44326,kültürde,0,0,1,1
44325,gerechtigd,0,0,1,1
44323,saxão,0,0,1,1
44322,يُنسب,0,0,1,1
44321,समाज,0,0,1,1
44319,टाडिक,0,0,1,1
44336,enyongle,0,0,1,1
44318,hayallerindeki,0,0,1,1
44317,εκείνο,0,0,1,1
44315,செய்வதாகவும்,0,0,1,1
44311,deforestation,0,0,1,1
44310,κοιμόταν,0,0,1,1
44309,vast,0,0,1,1
44308,употребить,0,0,1,1
44307,silinebilir,0,0,1,1
44306,diacrítico,0,0,1,1
44304,сервере,0,0,1,1
44303,sunuş,0,0,1,1
44302,നിങ്ങളെപ്പോലെ,0,0,1,1
44301,söylemesi,0,0,1,1
468,costruendo,1,1,0,1
44337,enciclopédicamente,0,0,1,1
44388,участником,0,0,1,1
44363,pos,0,0,1,1
44387,jurk,0,0,1,1
44385,saw,0,0,1,1
44383,stavningen,0,0,1,1
44382,φτάσω,0,0,1,1
459,dovremmo,1,1,0,1
44379,langue »,0,0,1,1
44378,voted,0,0,1,1
44377,ബുദ്ധിശൂന്യമോ,0,0,1,1
44376,فأخبرني,0,0,1,1
44374,wereld,0,0,1,1
44371,ankam,0,0,1,1
44370,souberem,0,0,1,1
44365,günüyse,0,0,1,1
44359,joueurs,0,0,1,1
44339,ಅರ್ಥಮಾಡಿಕೊಳ್ಳದಿದ್ದರೆ,0,0,1,1
463,evitare,1,1,0,1
44357,теста,0,0,1,1
44355,regards,0,0,1,1
44354,забывают,0,0,1,1
44353,opslagruimte,0,0,1,1
44349,والصحفي,0,0,1,1
44348,определенному,0,0,1,1
44347,செய்யும்படி,0,0,1,1
44346,προετοιμαζόμουν,0,0,1,1
44345,décoder,0,0,1,1
44344,presidentdirecteur,0,0,1,1
44341,الظروف,0,0,1,1
44340,सेबुआनो,0,0,1,1
44473,högt,0,0,1,1
44475,கூர்மையைக்,0,0,1,1
44678,injuste,0,0,1,1
44482,പ്രതിനിധാനം,0,0,1,1
44632,எதிர்,0,0,1,1
44631,оставайтесь,0,0,1,1
44626,manuales,0,0,1,1
44624,nearperfect,0,0,1,1
44623,robes,0,0,1,1
44622,ودفعت,0,0,1,1
44621,utilidad,0,0,1,1
44619,remoção,0,0,1,1
44618,βρείτε,0,0,1,1
44617,എന്നിട്ട്,0,0,1,1
44616,unumerit,0,0,1,1
44614,σκέφτεται,0,0,1,1
44613,ಪದ್ಧತಿಗಳಿಂದ,0,0,1,1
44612,« philosophie,0,0,1,1
44608,постоянные,0,0,1,1
44607,ämnesorienterade,0,0,1,1
44605,πνιγμό,0,0,1,1
419,minimo,1,1,0,1
44603,ken,0,0,1,1
44602,saborosas,0,0,1,1
44599,تطلق,0,0,1,1
44595,دوت,0,0,1,1
44594,издательство,0,0,1,1
44593,ascending,0,0,1,1
44592,непроверенной,0,0,1,1
44590,outre,0,0,1,1
44589,wikienciclopédias,0,0,1,1
44587,tears,0,0,1,1
44584,ಹೊರಡುವ,0,0,1,1
417,scusandosi,1,1,0,1
44638,devastation,0,0,1,1
44639,submergée,0,0,1,1
44660,programadores,0,0,1,1
44677,kontorskonto,0,0,1,1
410,pubblicano,1,1,0,1
44675,reshaping,0,0,1,1
44674,வேண்டத்தகாத,0,0,1,1
44672,asigna,0,0,1,1
44671,grind,0,0,1,1
44670,മലയാളീകരണമാണ്,0,0,1,1
44669,loyal,0,0,1,1
411,«uno,1,1,0,1
44666,civiles,0,0,1,1
412,diversità,1,1,0,1
44662,கொண்டிருப்பதுடன்,0,0,1,1
44661,hør,0,0,1,1
44659,टर्म्स,0,0,1,1
44641,करूँगी,0,0,1,1
44658,ಯೋಚಿಸೋಣ,0,0,1,1
44657,ನಮಸ್ಕಾರ,0,0,1,1
416,progettando,1,1,0,1
44655,forskningsresultat,0,0,1,1
44654,കുട്ടി,0,0,1,1
44652,telaffuzu,0,0,1,1
44651,ತಕ್ಷಣ,0,0,1,1
44650,ಪರೀಕ್ಷೆ,0,0,1,1
44649,ακόλουθοι,0,0,1,1
44648,പുരുഷന്മാർ,0,0,1,1
44646,दोषी,0,0,1,1
44644,inner,0,0,1,1
44643,ഭാഷകളിലും,0,0,1,1
422,conferma,1,1,0,1
44581,sunulmalıdır,0,0,1,1
44580,posent,0,0,1,1
44508,tegenkwam,0,0,1,1
44530,entreolharam,0,0,1,1
44529,основного,0,0,1,1
44526,விக்கிப்பீடியாவை,0,0,1,1
44523,σκεφτείτε,0,0,1,1
44522,geolocation,0,0,1,1
432,politica,1,1,0,1
44520,"
نحن",0,0,1,1
44518,«ты»,0,0,1,1
44516,intégré,0,0,1,1
44515,بإرسال,0,0,1,1
44514,controversée,0,0,1,1
44510,packen,0,0,1,1
44509,verricht,0,0,1,1
44507,قلعة,0,0,1,1
430,lettere,1,1,0,1
44505,lenguaje,0,0,1,1
44504,помогает,0,0,1,1
44501,فحص,0,0,1,1
44500,freely,0,0,1,1
44499,vandalizada,0,0,1,1
44497,alternativ,0,0,1,1
44494,ca,0,0,1,1
44493,टेलीफोन,0,0,1,1
44492,dialogueur,0,0,1,1
44491,ഇക്കാലത്ത്,0,0,1,1
434,pulito,1,1,0,1
44489,ஒப்புக்கொள்ள,0,0,1,1
435,fantastici,1,1,0,1
44531,narcismoeder,0,0,1,1
44533,добавление,0,0,1,1
44579,editassem,0,0,1,1
44553,skarpe,0,0,1,1
44578,débit,0,0,1,1
426,intenzioni,1,1,0,1
427,esplorativa,1,1,0,1
44574,входные,0,0,1,1
44571,elogiou,0,0,1,1
44570,citam,0,0,1,1
44569,с англ,0,0,1,1
44566,кого,0,0,1,1
44565,ανοικτό,0,0,1,1
44564,отношении,0,0,1,1
44561,baja,0,0,1,1
428,nazionali,1,1,0,1
44555,министерств,0,0,1,1
44552,λεωφορείο,0,0,1,1
44535,stupid,0,0,1,1
44550,بملكية,0,0,1,1
44548,hochzeitskleid,0,0,1,1
44547,yüzlerce,0,0,1,1
44545,исправить,0,0,1,1
44544,l’esquisse,0,0,1,1
44543,organization—though,0,0,1,1
44542,символ,0,0,1,1
44541,лицензия,0,0,1,1
44540,التطبيقات,0,0,1,1
44539,odum,0,0,1,1
429,richiamate,1,1,0,1
44537,debates,0,0,1,1
44536,internetsajter,0,0,1,1
582,supera,1,1,0,1
43571,المستخدمون,0,0,1,1
45014,aispecific,0,0,1,1
42568,instantly,0,0,1,1
42606,μαθηματικά,0,0,1,1
42603,acenaram,0,0,1,1
42601,wurden,0,0,1,1
42600,ജീവിതവും,0,0,1,1
42599,thorough,0,0,1,1
42597,പാഴ്‌മെയിലുകളെയും,0,0,1,1
42595,kir,0,0,1,1
722,guardi,1,1,0,1
42593,ilgisizlik,0,0,1,1
42592,warnings,0,0,1,1
42591,d’administration,0,0,1,1
42590,ಅವನಾಗಬಹುದು,0,0,1,1
42589,baisser,0,0,1,1
42588,verifieras,0,0,1,1
42587,நம்ப,0,0,1,1
723,interrompo,1,1,0,1
42585,geomorphology,0,0,1,1
42584,أثبتت,0,0,1,1
42583,fundaram,0,0,1,1
42580,التطبيق,0,0,1,1
42579,fångar,0,0,1,1
725,avvera,1,1,0,1
42576,உள்ளடக்கப்பட்ட,0,0,1,1
42575,تواجه,0,0,1,1
42574,കൊടുക്കാൻ,0,0,1,1
42573,hänt,0,0,1,1
42572,விரும்ப,0,0,1,1
42571,தலையில்,0,0,1,1
42570,പങ്ക്,0,0,1,1
42607,مبدأ,0,0,1,1
42608,kırıldı,0,0,1,1
42610,progresiva,0,0,1,1
42632,aceptados,0,0,1,1
717,contributo,1,1,0,1
42650,गेब्रियल,0,0,1,1
42648,entendre,0,0,1,1
42647,التصدي,0,0,1,1
42646,«сообщество»,0,0,1,1
42644,حلت,0,0,1,1
42643,सबसेट,0,0,1,1
42642,கடுமையான,0,0,1,1
42639,persönlich,0,0,1,1
42637,такова,0,0,1,1
42636,avsedda,0,0,1,1
42635,крайне,0,0,1,1
42634,sensory,0,0,1,1
42631,pedestrian,0,0,1,1
42611,vrijers,0,0,1,1
42630,afastandose,0,0,1,1
42629,definitive,0,0,1,1
42627,wachtwoord,0,0,1,1
42626,cloning,0,0,1,1
42625,enhancements,0,0,1,1
42624,generalizados,0,0,1,1
42623,ortasındasın,0,0,1,1
720,riprendere,1,1,0,1
42618,लाइक,0,0,1,1
42616,árabe,0,0,1,1
42615,et •,0,0,1,1
42614,செல்கிறோம்,0,0,1,1
42612,പ്രവചിക്കുകയാകാം,0,0,1,1
42569,भेजते,0,0,1,1
42565,бедный,0,0,1,1
583,provate,1,1,0,1
42563,திட்டமாகச்,0,0,1,1
42518,shelf,0,0,1,1
42517,inconsistências,0,0,1,1
42516,வங்கிக்கு,0,0,1,1
42515,excuser,0,0,1,1
42514,dieux,0,0,1,1
42512,inductively,0,0,1,1
42509,δέξου,0,0,1,1
42508,വ്യാമോഹിതനാണ്,0,0,1,1
42507,arbcom,0,0,1,1
42505,harina,0,0,1,1
42504,l’action,0,0,1,1
42503,элли,0,0,1,1
42502,приложенийисточник,0,0,1,1
42501,وراء,0,0,1,1
42500,എഴുത്തുകാരുടേയും,0,0,1,1
42499,ತಿಳಿದಿದ್ದರೆ,0,0,1,1
42498,applicables,0,0,1,1
42497,αστεροειδής,0,0,1,1
42494,nadenken,0,0,1,1
42493,فروع,0,0,1,1
42492,perguntoulhe,0,0,1,1
42491,نكتة,0,0,1,1
42490,يشبهونني,0,0,1,1
42489,основателя,0,0,1,1
42488,mini,0,0,1,1
42486,விவரிக்கும்,0,0,1,1
42483,alamaz,0,0,1,1
42482,işlere,0,0,1,1
732,impossibile,1,1,0,1
42519,இவற்றின்,0,0,1,1
731,ifelse,1,1,0,1
42522,angstaanjagenders,0,0,1,1
42546,പിറക്കുന്നു,0,0,1,1
42562,variétés,0,0,1,1
42561,تسأل,0,0,1,1
726,milionesima,1,1,0,1
42558,матч,0,0,1,1
42557,trabajó,0,0,1,1
42556,ಹೆಂಗಸರ,0,0,1,1
42555,आता,0,0,1,1
42554,rettigheder,0,0,1,1
42553,eleitoral,0,0,1,1
42551,പ്രസിദ്ധീകരണാനുമതി,0,0,1,1
42550,ಕಳುಹಿಸಲು,0,0,1,1
42549,ವಾಸ್ತವವಾಗಿ,0,0,1,1
42548,edward,0,0,1,1
42544,مقالاً,0,0,1,1
42523,копиями,0,0,1,1
42543,قفل,0,0,1,1
42542,parabéns,0,0,1,1
42538,redunda,0,0,1,1
42535,сну,0,0,1,1
42534,vriendelijke,0,0,1,1
42533,காப்புரிமைத்,0,0,1,1
729,vederti,1,1,0,1
42531,supposons,0,0,1,1
42528,يوميًا,0,0,1,1
42527,ഞങ്ങൾക്ക്,0,0,1,1
42526,contentious,0,0,1,1
42525,pensantes,0,0,1,1
42524,mahoma,0,0,1,1
42652,coupled,0,0,1,1
42654,விதிகளை,0,0,1,1
42655,featureartikler,0,0,1,1
42656,வரைவிலக்கணம்,0,0,1,1
42795,ആശയമാണെന്ന്,0,0,1,1
42794,வழிகளை,0,0,1,1
42793,onjuist,0,0,1,1
42791,corretos,0,0,1,1
42789,visitou,0,0,1,1
42788,ägna,0,0,1,1
42787,distinct,0,0,1,1
42785,உயர்த்தலாம்,0,0,1,1
699,carino,1,1,0,1
42781,linked,0,0,1,1
42780,கண்ணியமான,0,0,1,1
42776,oförskämt,0,0,1,1
42773,dictate,0,0,1,1
42771,capturing,0,0,1,1
42770,leg,0,0,1,1
42769,smukkeste,0,0,1,1
42768,utestängas,0,0,1,1
42767,estonien,0,0,1,1
42765,восприимчивость,0,0,1,1
42763,referenssystem,0,0,1,1
42762,drin,0,0,1,1
42760,விக்கிமீடியா,0,0,1,1
42759,ficticio,0,0,1,1
42756,влиятельных,0,0,1,1
42755,panel,0,0,1,1
701,razzismo,1,1,0,1
42751,tafel,0,0,1,1
42750,estaría,0,0,1,1
42749,ˌwɪkiˈpiːdiə —,0,0,1,1
697,rimosse,1,1,0,1
42797,tausend,0,0,1,1
42799,"
स्वाहिली",0,0,1,1
42823,görande,0,0,1,1
42843,വിവരിക്കുന്നതിനാലാണ്,0,0,1,1
42842,wending,0,0,1,1
693,rilascia,1,1,0,1
42839,ഫൗണ്ടേഷൻ,0,0,1,1
42838,hypothesized,0,0,1,1
42837,franse,0,0,1,1
42834,مستقرًا,0,0,1,1
42833,¿de,0,0,1,1
42832,wikiwoordenboek,0,0,1,1
42829,ಬಂದಿದೆಯೆಂದರೆ,0,0,1,1
42828,ഒന്നിൽ,0,0,1,1
42826,தீர்வில்,0,0,1,1
42824,erstaunlichste,0,0,1,1
42820,voyages,0,0,1,1
42801,tenido,0,0,1,1
42818,ஆகியவையும்,0,0,1,1
42816,सत्ता,0,0,1,1
42815,deeper,0,0,1,1
42814,décernés,0,0,1,1
42813,запретить,0,0,1,1
42812,voûte,0,0,1,1
42811,oneens,0,0,1,1
42810,studentens,0,0,1,1
42808,rentré,0,0,1,1
696,aspetti,1,1,0,1
42806,soutenue,0,0,1,1
42805,kaybettim,0,0,1,1
42803,കഴിച്ചതിനുശേഷം,0,0,1,1
42747,schönen,0,0,1,1
42746,εκπλήσσει,0,0,1,1
42745,മുങ്ങുന്നു,0,0,1,1
42677,pedirle,0,0,1,1
42696,getirebilir,0,0,1,1
42694,καλύτερη,0,0,1,1
42693,opportunistic,0,0,1,1
42690,éloigner,0,0,1,1
42689,tevens,0,0,1,1
42688,udgaver,0,0,1,1
42687,majoritaire,0,0,1,1
42686,relacione,0,0,1,1
42684,partialité,0,0,1,1
42682,"
स्पेनी",0,0,1,1
42681,കൃത്യമായി,0,0,1,1
42680,genoptager,0,0,1,1
42679,families,0,0,1,1
42676,ಭಾವಿಸಬಹುದು,0,0,1,1
42700,விஷயங்களை,0,0,1,1
42674,ബീഹാറി,0,0,1,1
42673,explaining,0,0,1,1
42672,barnet,0,0,1,1
42668,δίλημμα,0,0,1,1
42667,வகுப்பில்,0,0,1,1
42666,servisleri,0,0,1,1
42665,paradigmático,0,0,1,1
42664,technè,0,0,1,1
42662,financiers,0,0,1,1
42661,rendered,0,0,1,1
42660,implementeringen,0,0,1,1
42659,مقالًا,0,0,1,1
42657,lourde,0,0,1,1
42697,schmieden,0,0,1,1
42701,controversy,0,0,1,1
42744,التراكم,0,0,1,1
42722,какихто,0,0,1,1
42743,escrevem,0,0,1,1
42742,bias–variance,0,0,1,1
704,necessita,1,1,0,1
42739,للتدرب,0,0,1,1
707,intrusi,1,1,0,1
42735,vecteur,0,0,1,1
42734,terem,0,0,1,1
42732,തീരുമാനങ്ങളിലെത്താൻ,0,0,1,1
42729,anima,0,0,1,1
42728,yemeye,0,0,1,1
42726,специалистам,0,0,1,1
42725,kerel,0,0,1,1
42723,foule,0,0,1,1
710,antielitaria,1,1,0,1
42702,notoriedade,0,0,1,1
42720,ஒரே,0,0,1,1
42718,multilingües,0,0,1,1
42717,finish,0,0,1,1
42716,oportunista,0,0,1,1
42714,വിശേഷം,0,0,1,1
42712,autorrevisores,0,0,1,1
711,congratularsi,1,1,0,1
712,motivazione,1,1,0,1
713,parlarne,1,1,0,1
42706,irgendeine,0,0,1,1
42705,significatif,0,0,1,1
42704,dolaylı,0,0,1,1
42703,വിക്കിസമൂഹത്തിന്റെ,0,0,1,1
42480,dildeki,0,0,1,1
42479,ಹೋಗಬಹುದು,0,0,1,1
42478,antologin,0,0,1,1
42292,تمتد,0,0,1,1
42245,ενημερώστε,0,0,1,1
42241,thermohaline,0,0,1,1
42240,ചങ്ങാതിമാർ‌ക്ക്,0,0,1,1
42238,repræsenteret,0,0,1,1
42237,sorarsa,0,0,1,1
42236,plateformes,0,0,1,1
770,lenti,1,1,0,1
42233,εργασία,0,0,1,1
42232,fundado,0,0,1,1
42230,ಅವರಲ್ಲಿ,0,0,1,1
42229,rivulet,0,0,1,1
772,danneggiare,1,1,0,1
42224,días—,0,0,1,1
42222,πει,0,0,1,1
42221,आलू,0,0,1,1
777,affatto,1,1,0,1
42218,بالمحادثة,0,0,1,1
42217,تحولت,0,0,1,1
42216,fotnoter,0,0,1,1
42213,الكريمة,0,0,1,1
42212,அருமையானவை,0,0,1,1
42211,تعيينك,0,0,1,1
42210,draft,0,0,1,1
42209,hızlandı,0,0,1,1
42208,الملكية,0,0,1,1
42207,множественного,0,0,1,1
42206,കട്ടിലിൽ,0,0,1,1
42205,tusind,0,0,1,1
42204,basicamente,0,0,1,1
42246,واجمع,0,0,1,1
769,gpu,1,1,0,1
42249,തുടരുകയാണെങ്കിൽ,0,0,1,1
42275,kalın,0,0,1,1
42290,premiada,0,0,1,1
42289,sustainability,0,0,1,1
42288,തെറ്റാണ്,0,0,1,1
42287,категориям,0,0,1,1
42285,البحث,0,0,1,1
42284,generalize,0,0,1,1
42283,يسمح,0,0,1,1
42282,coin,0,0,1,1
764,nostra,1,1,0,1
42279,அறிவியல்,0,0,1,1
42278,ജോർജ്ജ്,0,0,1,1
42277,kunstmatige,0,0,1,1
42276,отношениях,0,0,1,1
42273,പോലെയുള്ള,0,0,1,1
42250,ಗೆಳೆಯ,0,0,1,1
42268,necesitamos,0,0,1,1
42265,गूगल्स,0,0,1,1
42264,അഥവാ,0,0,1,1
765,precisione,1,1,0,1
42262,скрестив,0,0,1,1
42261,العلوم،,0,0,1,1
42260,digitala,0,0,1,1
42259,mislukkingen,0,0,1,1
42257,دمج,0,0,1,1
767,collaborazione,1,1,0,1
42254,கண்காணிப்பு,0,0,1,1
768,linguaggi,1,1,0,1
42252,protestar,0,0,1,1
42203,flicka,0,0,1,1
42202,நிரூபிக்காவிட்டால்,0,0,1,1
42201,يشتبه,0,0,1,1
42131,groseramente,0,0,1,1
42152,cherchez,0,0,1,1
42151,begrip,0,0,1,1
42148,"
turco",0,0,1,1
42147,solicitan,0,0,1,1
42145,gemas,0,0,1,1
42143,моего,0,0,1,1
42142,imediatamente,0,0,1,1
42141,замечательно,0,0,1,1
42140,heredó,0,0,1,1
42138,bijgewerkt,0,0,1,1
42137,fünf,0,0,1,1
789,miglioramenti,1,1,0,1
42134,ഒരുപോലെ,0,0,1,1
42129,gl •,0,0,1,1
42154,färdade,0,0,1,1
790,preceduta,1,1,0,1
42125,وجودنا,0,0,1,1
42123,accorder,0,0,1,1
42122,تطبقه,0,0,1,1
42120,wikieditáveis,0,0,1,1
42118,boyunca,0,0,1,1
42117,maya,0,0,1,1
42115,വാട്ട്സ്ആപ്പ്,0,0,1,1
42113,बढ़ें,0,0,1,1
42112,последних,0,0,1,1
42111,கட்டுரையொன்றில்,0,0,1,1
42110,beschrieb,0,0,1,1
42108,поставил,0,0,1,1
42153,kunsttalen,0,0,1,1
42156,barrage,0,0,1,1
42200,resorted,0,0,1,1
42176,سيئًا,0,0,1,1
42199,статуса»,0,0,1,1
42197,ಮಾರ್ಗದಲ್ಲಿ,0,0,1,1
42196,நண்பர்களாக,0,0,1,1
42194,возражаете,0,0,1,1
42193,പ്രവർത്തകരെ,0,0,1,1
42191,البذور,0,0,1,1
42185,உடன்படுகிறேன்,0,0,1,1
42184,κέντρο,0,0,1,1
42183,incompletas,0,0,1,1
42182,வழக்கத்தை,0,0,1,1
42181,apesar,0,0,1,1
42179,तीक्ष्ण,0,0,1,1
42178,användarbefogenheter,0,0,1,1
42174,utges,0,0,1,1
786,segretamente,1,1,0,1
42171,надо,0,0,1,1
42170,passing,0,0,1,1
42169,risques,0,0,1,1
42168,controversé,0,0,1,1
42167,cujos,0,0,1,1
42166,orsaken,0,0,1,1
42165,alto،,0,0,1,1
42164,கொடுக்கும்,0,0,1,1
42163,participam,0,0,1,1
42161,കുറവുള്ള,0,0,1,1
782,sottogruppi,1,1,0,1
42159,संघ,0,0,1,1
785,luce,1,1,0,1
42291,hospedada,0,0,1,1
42293,التراكمية,0,0,1,1
42477,wikia,0,0,1,1
42294,frontend,0,0,1,1
42436,sonuca,0,0,1,1
42434,sinais,0,0,1,1
42432,covering,0,0,1,1
42431,"
मिस्री",0,0,1,1
42426,നൽ‌കും,0,0,1,1
42425,neredeydik,0,0,1,1
742,aiuto,1,1,0,1
42422,bråkdel,0,0,1,1
42421,factorization,0,0,1,1
42420,statisticians,0,0,1,1
42419,കിടക്കുകയാണ്,0,0,1,1
42417,зависит,0,0,1,1
42416,generar,0,0,1,1
42415,கைதிகள்,0,0,1,1
42414,gemiddelde,0,0,1,1
42413,रुके,0,0,1,1
42412,ആളുകൾക്ക്,0,0,1,1
42411,βάλετε,0,0,1,1
42409,сообщества —,0,0,1,1
42408,colabora,0,0,1,1
42406,astéroïde,0,0,1,1
42405,deem,0,0,1,1
42403,لتحديد,0,0,1,1
42402,различают,0,0,1,1
42399,dyr,0,0,1,1
42398,пометка,0,0,1,1
42397,assumer,0,0,1,1
745,divenendo,1,1,0,1
42395,plotseling,0,0,1,1
42437,palm,0,0,1,1
42438,பொருளாதாரம்,0,0,1,1
42441,അതിനായി,0,0,1,1
42460,"
silesiano",0,0,1,1
42476,fbi,0,0,1,1
42475,സംവിധാനം,0,0,1,1
42474,gevangenissen,0,0,1,1
42473,ശ്രമങ്ങൾ‍,0,0,1,1
42472,السادس,0,0,1,1
42471,наличием,0,0,1,1
42470,demek,0,0,1,1
42468,tıklanan,0,0,1,1
42467,ஏற்படுத்துவதைத்,0,0,1,1
733,casella,1,1,0,1
42465,தோற்றமளிக்கிறீர்கள்,0,0,1,1
42464,sizable,0,0,1,1
42461,allèrent,0,0,1,1
42459,consideradas,0,0,1,1
42442,അഡ്മിന്മാർ,0,0,1,1
42457,kaliforniya,0,0,1,1
736,succedono,1,1,0,1
737,freddo,1,1,0,1
42453,وشك,0,0,1,1
42452,വായനക്കാർക്കോ,0,0,1,1
42451,مذهلة,0,0,1,1
42450,intragável,0,0,1,1
42449,chapter,0,0,1,1
42448,allégories,0,0,1,1
739,perfezione,1,1,0,1
42445,colocó,0,0,1,1
42444,såvitt,0,0,1,1
42443,blanking,0,0,1,1
42394,başlayalım,0,0,1,1
746,ricercatrice,1,1,0,1
42392,figuras,0,0,1,1
42319,വിജ്ഞാനതൃഷ്ണയുമുള്ള,0,0,1,1
42339,baseados,0,0,1,1
42338,assustados,0,0,1,1
755,ampio,1,1,0,1
42336,sürdürmeye,0,0,1,1
757,carico,1,1,0,1
42330,நர்சிஸாவைப்,0,0,1,1
42329,असहमति,0,0,1,1
42328,loudest,0,0,1,1
42326,ചരിത്രത്തെപ്പറ്റിയും,0,0,1,1
758,accademico,1,1,0,1
42324,eleştirilerine,0,0,1,1
42321,точка,0,0,1,1
42320,—administrador—,0,0,1,1
760,immangiabile,1,1,0,1
42342,μυρωδιά,0,0,1,1
762,divano,1,1,0,1
42309,açıklama,0,0,1,1
42308,editoras,0,0,1,1
42307,cento,0,0,1,1
42306,onderbreken,0,0,1,1
42305,wensen,0,0,1,1
42301,ഇവർക്ക്,0,0,1,1
42300,moulinwiki,0,0,1,1
42299,ಹೇಳು,0,0,1,1
42298,"
panjabi",0,0,1,1
42297,результата,0,0,1,1
42296,интересное,0,0,1,1
42295,следы,0,0,1,1
42341,emplaced,0,0,1,1
42344,"
असमिया",0,0,1,1
42391,qu’une,0,0,1,1
42373,താഴേക്കും,0,0,1,1
42390,singlecelled,0,0,1,1
42389,ماء؟,0,0,1,1
42388,ayúdame,0,0,1,1
42386,وسعد,0,0,1,1
42385,slumpmässigt,0,0,1,1
42384,"
वेल्स",0,0,1,1
42383,сериала,0,0,1,1
42382,പ്രശ്നങ്ങളെ,0,0,1,1
42381,أقرأ,0,0,1,1
42380,zenginlik,0,0,1,1
42379,ಹಳೆಯ,0,0,1,1
42378,അവബോധത്തോടെ,0,0,1,1
42376,сидишь,0,0,1,1
42371,تكنولوجي,0,0,1,1
42345,beatles,0,0,1,1
42370,kullanırlar,0,0,1,1
42369,مهما,0,0,1,1
42366,சார்பற்றது,0,0,1,1
42365,respetar,0,0,1,1
42364,estabeleceu,0,0,1,1
42363,неприятную,0,0,1,1
42360,ரிச்சர்ட்,0,0,1,1
42359,helaas,0,0,1,1
42357,നിരസിച്ചു,0,0,1,1
750,programmare,1,1,0,1
42352,пополните,0,0,1,1
753,aggiungendovi,1,1,0,1
42346,γάμο,0,0,1,1
42845,coexistia,0,0,1,1
42846,gidemezsiniz,0,0,1,1
42847,крупнейшей,0,0,1,1
43402,şahsen,0,0,1,1
43360,machistas,0,0,1,1
612,intraprendere,1,1,0,1
43357,overbrugt,0,0,1,1
43355,ഇപ്രകാരം,0,0,1,1
43353,скотт,0,0,1,1
43349,सोफे,0,0,1,1
43348,tætskrevne,0,0,1,1
43346,تحديدًا,0,0,1,1
43345,وجمل,0,0,1,1
43344,parodies,0,0,1,1
43343,doubt,0,0,1,1
43341,fötterna,0,0,1,1
43340,meritsystem,0,0,1,1
43339,عينة,0,0,1,1
43338,leerproblemen,0,0,1,1
43337,vandt,0,0,1,1
43335,tilbageværende,0,0,1,1
43333,கேளுங்கள்,0,0,1,1
43332,« appels »,0,0,1,1
43331,construire,0,0,1,1
43330,medium,0,0,1,1
43329,gleichnamigen,0,0,1,1
43328,பார்வை,0,0,1,1
614,wikipress,1,1,0,1
616,sottostante,1,1,0,1
43323,ربطها,0,0,1,1
43322,بتأثيره،,0,0,1,1
43321,والمناقشة,0,0,1,1
43320,cites,0,0,1,1
43361,ഇന്റർനെറ്റിൽ,0,0,1,1
611,esisteva,1,1,0,1
43364,régionales,0,0,1,1
43386,адамсом,0,0,1,1
43400,cirkler,0,0,1,1
43399,उत्पादों,0,0,1,1
43397,накоплению,0,0,1,1
43396,كويكب،,0,0,1,1
43395,influyendo,0,0,1,1
43394,осознать,0,0,1,1
43393,ucraniano,0,0,1,1
43392,தொடர்பான,0,0,1,1
43391,ссылку,0,0,1,1
43390,tr •,0,0,1,1
43389,αγαπητοί,0,0,1,1
43388,dondurmaya,0,0,1,1
43387,донизу,0,0,1,1
43383,commentaires,0,0,1,1
43365,приобретала,0,0,1,1
43380,നാമപദമായി,0,0,1,1
43379,velden,0,0,1,1
43378,quién,0,0,1,1
43377,സെപ്റ്റംബർ,0,0,1,1
43376,végétales,0,0,1,1
43375,ಸುಸ್ತಾಗುವುದಿಲ್ಲ,0,0,1,1
43374,डिग,0,0,1,1
43373,dietitian,0,0,1,1
43371,நிலை,0,0,1,1
43370,thésaurus,0,0,1,1
43368,projeye,0,0,1,1
43367,இத்திட்டத்தின்,0,0,1,1
43366,അഞ്ചുമിനിറ്റിനുള്ളിൽ,0,0,1,1
43319,ny,0,0,1,1
43318,keeping,0,0,1,1
43317,بالضبط,0,0,1,1
43257,endowment,0,0,1,1
43276,tanıyorsunuz,0,0,1,1
43274,வழிமுறைகள்,0,0,1,1
43273,backgrounds,0,0,1,1
43272,grubu,0,0,1,1
43270,«подписаться»,0,0,1,1
43269,നായ,0,0,1,1
43267,ಒಪ್ಪಿಕೊಂಡರೆ,0,0,1,1
43266,programmers,0,0,1,1
43265,ಮಾಡುತ್ತಿದ್ದೀಯಾ,0,0,1,1
43264,shooting,0,0,1,1
43262,vorschlag,0,0,1,1
626,sistematico,1,1,0,1
43259,ikisinde,0,0,1,1
43256,कैदियों,0,0,1,1
43280,inéluctablement,0,0,1,1
43255,جمالها,0,0,1,1
43254,narcissen,0,0,1,1
43253,demandantes,0,0,1,1
628,minimizzazione,1,1,0,1
43250,retirer,0,0,1,1
43249,renaissance,0,0,1,1
43246,понравится,0,0,1,1
43244,« à,0,0,1,1
43243,ഇതൊക്കെ,0,0,1,1
631,contare,1,1,0,1
43237,وسأراكم,0,0,1,1
43236,batırdım,0,0,1,1
43234,schönsten,0,0,1,1
623,specialistico,1,1,0,1
43281,кукла,0,0,1,1
43316,переводные,0,0,1,1
43299,estrechamente,0,0,1,1
617,venisse,1,1,0,1
43313,ml •,0,0,1,1
43312,"
चेक",0,0,1,1
43311,recognizing,0,0,1,1
618,rintracciabili,1,1,0,1
43309,nonliving,0,0,1,1
43307,ವಿರೋಧಾತ್ಮಕ,0,0,1,1
43305,ചെയ്യുന്നതിനെ,0,0,1,1
43304,иной,0,0,1,1
43303,выражается,0,0,1,1
43302,إخطاره,0,0,1,1
619,collar,1,1,0,1
43300,ആൾക്കാരെ,0,0,1,1
43298,agreeing,0,0,1,1
43282,weitergab,0,0,1,1
43297,oätligt,0,0,1,1
620,prenderai,1,1,0,1
43294,важную,0,0,1,1
43293,traditionella,0,0,1,1
43292,evrimi,0,0,1,1
43290,يرتدي,0,0,1,1
43289,associé,0,0,1,1
43288,fonctionne,0,0,1,1
622,giornali,1,1,0,1
43286,källförteckningen,0,0,1,1
43285,अन्तरजाल,0,0,1,1
43284,residências,0,0,1,1
43283,unreadable,0,0,1,1
43401,التحريرية,0,0,1,1
43403,aliens”,0,0,1,1
43228,സ്വപ്നമായിരുന്നു,0,0,1,1
43404,subdesarrollados,0,0,1,1
43526,synnerhet,0,0,1,1
589,classifica,1,1,0,1
591,rifiorire,1,1,0,1
594,incompetente,1,1,0,1
43522,şeklinde,0,0,1,1
43521,vogvimageoptionsin,0,0,1,1
43520,सेवानिवृत्त,0,0,1,1
595,informale,1,1,0,1
43518,import,0,0,1,1
43517,inconsistencias​,0,0,1,1
596,usanze,1,1,0,1
43515,olvide,0,0,1,1
43513,reichtum,0,0,1,1
43512,soruyu,0,0,1,1
43511,अधिकारिक,0,0,1,1
43510,ಸಹೋದರಿ,0,0,1,1
600,prolungate,1,1,0,1
43508,desbloqueada,0,0,1,1
43507,турист,0,0,1,1
43506,കാണപ്പെടും,0,0,1,1
43505,améliorez,0,0,1,1
43504,لطلب,0,0,1,1
43503,टाइम,0,0,1,1
43502,பிரிந்து,0,0,1,1
43499,بدوا,0,0,1,1
43498,разделом,0,0,1,1
43496,violés,0,0,1,1
43495,вандализму,0,0,1,1
43493,تعاونياً,0,0,1,1
43528,സഹായിക്കുന്നതിൽ,0,0,1,1
43530,ontworpen,0,0,1,1
43531,kaputt,0,0,1,1
43553,multas,0,0,1,1
43569,normaal,0,0,1,1
43568,நுபீடியாவை,0,0,1,1
43567,அழ,0,0,1,1
43566,تفعل؟,0,0,1,1
43565,கட்டுரைகளை,0,0,1,1
584,stargli,1,1,0,1
585,digitali,1,1,0,1
586,dagli,1,1,0,1
43561,പാടുപെട്ട,0,0,1,1
43559,vicente,0,0,1,1
43557,καταπληκτικός,0,0,1,1
43556,إنترنت,0,0,1,1
43555,meertalige,0,0,1,1
43552,ikisinin,0,0,1,1
43533,ofensivos,0,0,1,1
587,attendibili,1,1,0,1
588,spaventato,1,1,0,1
43549,materializó,0,0,1,1
43548,nature‏,0,0,1,1
43547,cümleye,0,0,1,1
43545,hébergeur,0,0,1,1
43544,ஐபி,0,0,1,1
43543,rituals,0,0,1,1
43540,ಆಶ್ಚರ್ಯಚಕಿತರಾದರು,0,0,1,1
43539,ينسى,0,0,1,1
43538,palacio,0,0,1,1
43537,marcadas,0,0,1,1
43534,locura»,0,0,1,1
43492,kritikere,0,0,1,1
43486,ಹೊಂದಿದ್ದರೆ,0,0,1,1
43484,frankrijk,0,0,1,1
43424,"
साधारण",0,0,1,1
606,appoggia,1,1,0,1
43441,log,0,0,1,1
43437,σκληρή,0,0,1,1
43436,förre,0,0,1,1
43435,ಒಬ್ಬರ,0,0,1,1
43434,английские,0,0,1,1
43431,προσπαθούσε,0,0,1,1
43430,"
usbeque",0,0,1,1
607,sostenuti,1,1,0,1
43428,ಮಾಡಲಿಲ್ಲ,0,0,1,1
43427,ಅವರೆಲ್ಲರನ್ನೂ,0,0,1,1
43426,وحشيًا,0,0,1,1
43425,σχολίων,0,0,1,1
43423,uncommon,0,0,1,1
605,disc,1,1,0,1
608,rapidi,1,1,0,1
43420,штате,0,0,1,1
43419,ιανουάριο,0,0,1,1
43418,beschreef,0,0,1,1
43417,uitwezen,0,0,1,1
43416,ആചരിക്കുന്നു,0,0,1,1
43415,പൊതുവായ,0,0,1,1
43412,تحديداً,0,0,1,1
43411,ഐക്കൺ,0,0,1,1
43409,εγκυκλοπαίδειες,0,0,1,1
43407,rendezvoussmartwort,0,0,1,1
43406,impresiones,0,0,1,1
43405,medelåldern,0,0,1,1
43444,ನಿಷ್ಠುರ,0,0,1,1
43446,corchetes,0,0,1,1
43483,atmosphériques,0,0,1,1
43463,executes,0,0,1,1
43482,verzoeken,0,0,1,1
43481,ഭാഗ്യമെന്ന്,0,0,1,1
43480,എല്ലാവർക്കും,0,0,1,1
43477,ран,0,0,1,1
43475,consorcio,0,0,1,1
43474,افترض,0,0,1,1
43473,min •,0,0,1,1
43470,långsam,0,0,1,1
602,oggettivo,1,1,0,1
43467,ചാനൽ,0,0,1,1
43466,минутный,0,0,1,1
43465,الكبرى,0,0,1,1
43464,கற்பழிப்பு,0,0,1,1
43462,gostasse,0,0,1,1
43447,ώστε,0,0,1,1
43461,belediging,0,0,1,1
43460,ομπάμα,0,0,1,1
43459,feuchtgebiet,0,0,1,1
604,pasticcio,1,1,0,1
43457,sacralisation,0,0,1,1
43456,presently,0,0,1,1
43455,ഉപയോക്താവിനെ,0,0,1,1
43454,вещь,0,0,1,1
43453,stapte,0,0,1,1
43452,новостей,0,0,1,1
43451,modificações,0,0,1,1
43450,dueños,0,0,1,1
43449,overskuelighed,0,0,1,1
637,saggi,1,1,0,1
43227,émergeant,0,0,1,1
42849,الإحصائية,0,0,1,1
43037,davranış,0,0,1,1
42996,concentre,0,0,1,1
42994,weinst,0,0,1,1
42993,placeholder,0,0,1,1
42992,esclareceu,0,0,1,1
42991,ബാങ്കിന്റെ,0,0,1,1
42990,söylediğinizi,0,0,1,1
42989,"
पीड्मॉण्टी",0,0,1,1
42984,dilbert,0,0,1,1
42983,kæmpe,0,0,1,1
42982,المشكلات,0,0,1,1
42981,rastrear,0,0,1,1
42980,കരച്ചിലും,0,0,1,1
42979,periodísticos,0,0,1,1
42978,strip,0,0,1,1
42974,gebrek,0,0,1,1
42972,immatériel ,0,0,1,1
42969,забавный,0,0,1,1
42968,tolkningar,0,0,1,1
673,appreso,1,1,0,1
42963,φάσμα,0,0,1,1
674,rivendicazione,1,1,0,1
675,attualità»,1,1,0,1
676,voluto,1,1,0,1
677,diffamazione,1,1,0,1
42955,المجتمع,0,0,1,1
42954,благодарю,0,0,1,1
42952,"design ·
environmental",0,0,1,1
42949,عادة,0,0,1,1
42948,ಕುಳಿತಿದ್ದಾರೆ,0,0,1,1
42997,सीखें,0,0,1,1
42998,ζητήσω,0,0,1,1
42999,прощание,0,0,1,1
667,risolvibili,1,1,0,1
664,dimmi,1,1,0,1
43034,amusante,0,0,1,1
43033,internet »,0,0,1,1
43032,അവളെ,0,0,1,1
665,paese,1,1,0,1
43029,கற்றலைத்,0,0,1,1
43028,upphov,0,0,1,1
43027,okuyorum,0,0,1,1
666,gestione,1,1,0,1
43025,மறந்துவிடுவார்,0,0,1,1
43024,polarisering,0,0,1,1
43023,വിരോധാഭാസം,0,0,1,1
43022,ശൈലിയും,0,0,1,1
43020,ஒருவகை,0,0,1,1
43000,வாக்கெடுப்பும்,0,0,1,1
668,richieste,1,1,0,1
43018,εγκυκλοπαίδεια»,0,0,1,1
43017,natur,0,0,1,1
43016,idéologique,0,0,1,1
43015,imagina»,0,0,1,1
43014,apparut,0,0,1,1
43012,وربما,0,0,1,1
43010,مبنية,0,0,1,1
43009,formulated,0,0,1,1
43008,ಹುಡುಕುತ್ತಿದ್ದೇವೆ,0,0,1,1
43005,sociobiologie,0,0,1,1
43004,وكذلك,0,0,1,1
43003,തുല്യമായ,0,0,1,1
42947,हमलों,0,0,1,1
42946,veamos,0,0,1,1
42945,постановка,0,0,1,1
42877,utförs,0,0,1,1
42892,voetnoten,0,0,1,1
42891,ವಿನಮ್ರ,0,0,1,1
42890,பைத்தியம்,0,0,1,1
42888,विरले,0,0,1,1
42887,സേവന,0,0,1,1
42886,ചതുപ്പുനിലത്തിന്,0,0,1,1
42885,invoerdata,0,0,1,1
42884,ഉദാഹരണ,0,0,1,1
42882,«получение,0,0,1,1
42881,basado,0,0,1,1
42880,அவற்றில்,0,0,1,1
42879,شديد,0,0,1,1
42878,—enero,0,0,1,1
42875,confiaron,0,0,1,1
42897,administrateur,0,0,1,1
42874,sucinta,0,0,1,1
42873,मेमोरियम,0,0,1,1
42871,செய்கிறேன்,0,0,1,1
42870,поддающимися,0,0,1,1
42866,حين,0,0,1,1
688,preparato,1,1,0,1
42862,¿quién,0,0,1,1
42860,തോന്നുന്ന,0,0,1,1
690,«dati,1,1,0,1
42857,bilgilerden,0,0,1,1
42856,படுக்கையில்,0,0,1,1
42855,ağır,0,0,1,1
42853,grootser,0,0,1,1
687,piangi,1,1,0,1
42898,"
bósnio",0,0,1,1
42944,इमारतों,0,0,1,1
685,respirare,1,1,0,1
42940,عمومًا,0,0,1,1
42938,vurgulamanın,0,0,1,1
42937,دعا,0,0,1,1
42935,bekijkt,0,0,1,1
42934,lett,0,0,1,1
42933,hartstikke,0,0,1,1
42927,πάρουν,0,0,1,1
42925,हाउ,0,0,1,1
42924,تقليدية,0,0,1,1
42923,பத்து,0,0,1,1
42922,düşünün,0,0,1,1
683,tipicamente,1,1,0,1
42919,"
जनवरी",0,0,1,1
42917,அப்பட்டமான,0,0,1,1
42899,gisteren,0,0,1,1
42916,proíbe,0,0,1,1
42915,читателя,0,0,1,1
42914,بلغته,0,0,1,1
42912,गैरविकी,0,0,1,1
42911,مكرسة,0,0,1,1
42908,жёстки,0,0,1,1
42907,city,0,0,1,1
686,normale,1,1,0,1
42905,qualifie,0,0,1,1
42904,ಅವುಗಳನ್ನು,0,0,1,1
42903,رائعا،,0,0,1,1
42902,अंतर्गत,0,0,1,1
42901,contrasted,0,0,1,1
43036,politici,0,0,1,1
43039,betonen,0,0,1,1
43226,करूँगा,0,0,1,1
43040,boon,0,0,1,1
43184,ನಿಲ್ಲಿಸಬಹುದೇ,0,0,1,1
43180,частому,0,0,1,1
43179,مباشرة,0,0,1,1
43178,dialecten,0,0,1,1
43175,interfaces,0,0,1,1
643,occupato,1,1,0,1
43170,acción,0,0,1,1
43169,होनी,0,0,1,1
43166,ശബ്‌ദം,0,0,1,1
43165,unter,0,0,1,1
43164,savunmaktadır,0,0,1,1
43163,конкретным,0,0,1,1
43162,narcisini,0,0,1,1
43161,الأيديولوجية,0,0,1,1
646,mediche,1,1,0,1
43156,ألف,0,0,1,1
43155,assar,0,0,1,1
43153,بالتعب,0,0,1,1
43152,entretanto,0,0,1,1
43150,ನಾಯಿ,0,0,1,1
43149,sentouse,0,0,1,1
43148,dbpedia,0,0,1,1
43147,подмигнули,0,0,1,1
43145,l’entrainement,0,0,1,1
43144,tries,0,0,1,1
43143,والاستنتاجي,0,0,1,1
43142,kretsar,0,0,1,1
648,turbato,1,1,0,1
43136,inconsistencias,0,0,1,1
43185,identifie,0,0,1,1
43186,lentes,0,0,1,1
43187,சொல்லிக்,0,0,1,1
43206,verbose,0,0,1,1
43225,bewijst,0,0,1,1
43224,சொல்வதாகவும்,0,0,1,1
638,letteratura,1,1,0,1
639,permissivo,1,1,0,1
43220,திறமூல,0,0,1,1
43219,предварительной,0,0,1,1
43218,فوجئت,0,0,1,1
43213,guild,0,0,1,1
43212,ಆಶ್ಚರ್ಯ,0,0,1,1
43211,agricultural,0,0,1,1
43210,أعطى,0,0,1,1
43209,culturelles,0,0,1,1
43208,tang,0,0,1,1
43205,поновому»,0,0,1,1
43188,επιτύχει,0,0,1,1
43204,aldığı,0,0,1,1
43203,المتناقضة,0,0,1,1
43202,സംബന്ധിച്ചിടത്തോളം,0,0,1,1
43201,érudition,0,0,1,1
43199,menschen,0,0,1,1
43198,шекмана,0,0,1,1
43197,ಪದಗಳಿವೆ,0,0,1,1
43195,sorprendida,0,0,1,1
43194,mjölstädarna,0,0,1,1
43193,الكيميائية،,0,0,1,1
43191,nachdem,0,0,1,1
43190,conditionnant,0,0,1,1
43189,descobrem,0,0,1,1
43134, بريتانيكا,0,0,1,1
43133,чувство,0,0,1,1
43132,ஒன்றுசேர்ந்து,0,0,1,1
43061,كلاسيكية,0,0,1,1
43081,കണ്ട,0,0,1,1
43080,விரும்புகின்றனர்,0,0,1,1
43079,പിടിച്ചില്ലെന്ന്,0,0,1,1
43073,demography,0,0,1,1
43072,системным,0,0,1,1
43070,способа,0,0,1,1
43069,ضخمة,0,0,1,1
43068,ನಂಬಲು,0,0,1,1
43067,philips,0,0,1,1
43065,поверить,0,0,1,1
43064,ಸಾಗುವುದು,0,0,1,1
658,preferirei,1,1,0,1
43062,എന്താണെന്ന,0,0,1,1
43060,ತಿನ್ನುವ,0,0,1,1
43083,forfærdelse,0,0,1,1
43058,creator,0,0,1,1
659,soggetta,1,1,0,1
43056,множества,0,0,1,1
43054,louco,0,0,1,1
43053,الجنسين،,0,0,1,1
43052,disminuir,0,0,1,1
43051,സ്റ്റാൾമാൻ,0,0,1,1
43050,πιστέψω,0,0,1,1
661,specchio,1,1,0,1
43047,بإصدارات,0,0,1,1
43044,milyonlarca,0,0,1,1
43043,néanmoins,0,0,1,1
663,applausi,1,1,0,1
43082,असमर्थ,0,0,1,1
43084,medlemmarna,0,0,1,1
43130,للغد؟,0,0,1,1
43111,घोंघे,0,0,1,1
43128,implementará,0,0,1,1
649,giudiziarie,1,1,0,1
43126,tekrarlamanız,0,0,1,1
651,trucco,1,1,0,1
43124,särskilda,0,0,1,1
43123,gratuite,0,0,1,1
43122,विश्वास,0,0,1,1
43120,തുടർന്നുള്ള,0,0,1,1
43116,τόπο,0,0,1,1
43115,बच्चा,0,0,1,1
43114,وإصلاحه,0,0,1,1
652,consolidati,1,1,0,1
43112,förvirra,0,0,1,1
653,ringraziarti,1,1,0,1
43085,صباح,0,0,1,1
43109,fließende,0,0,1,1
43108,مستقلة,0,0,1,1
43107,புயல்,0,0,1,1
43105,холодно,0,0,1,1
43104,lowerlevel,0,0,1,1
43100,يصفون,0,0,1,1
43099,semiprotected,0,0,1,1
43098,περιέγραφε,0,0,1,1
43096,разнородными,0,0,1,1
43095,கிளாசிக்கல்,0,0,1,1
43094,വിക്കിപീഡിയകളിൽ,0,0,1,1
43090,ಹ್ಯಾಂಗ್,0,0,1,1
657,opinione,1,1,0,1
45012,ஒருபோதும்,0,0,1,1
45015,insistent,0,0,1,1
42105,சிகிச்சை,0,0,1,1
46906,evaluating,0,0,1,1
46942,மன்னிப்பை,0,0,1,1
46940,справочного,0,0,1,1
46939,objectivement,0,0,1,1
46938,विद्यार्थी,0,0,1,1
137,casualmente,1,1,0,1
46936,verwendeten,0,0,1,1
46935,tidskrift,0,0,1,1
46934,ब्रेकेट,0,0,1,1
46933,asterisco,0,0,1,1
46931,frön,0,0,1,1
46930,передаёт,0,0,1,1
46929,establece,0,0,1,1
46928,graphies,0,0,1,1
46927,flummoxte,0,0,1,1
46926,أتفق,0,0,1,1
46925,исключением,0,0,1,1
46924,приехал,0,0,1,1
46923,automatique »,0,0,1,1
46922,équivaut,0,0,1,1
138,presi,1,1,0,1
46919,மகத்தான,0,0,1,1
46918,ομιλητές,0,0,1,1
46917,ന്നിപ്പറയുന്നത്,0,0,1,1
46916,കാമുകനോ,0,0,1,1
46914,lowhanging,0,0,1,1
46912,കാലിഫോർണിയയിൽ,0,0,1,1
46911,stirrade,0,0,1,1
139,potete,1,1,0,1
46909,sumaban,0,0,1,1
46943,mixture,0,0,1,1
46944,помешал,0,0,1,1
46945,crossbow,0,0,1,1
46974,dördü,0,0,1,1
46996,"
véneto",0,0,1,1
46995,interwiki,0,0,1,1
46992,förekomsten,0,0,1,1
46991,blokkeerde,0,0,1,1
46990,γλώσσα,0,0,1,1
46989,obtengas,0,0,1,1
46988,improbable,0,0,1,1
46987,تمول,0,0,1,1
46982,auktoriteter,0,0,1,1
46980,எடுத்துக்காட்டாக,0,0,1,1
46979,terugkomen,0,0,1,1
131,impone,1,1,0,1
46977,दिखाई,0,0,1,1
46972,helped,0,0,1,1
46946,εβδομάδες,0,0,1,1
46968,dumpen,0,0,1,1
46967,periodista,0,0,1,1
46966,பேசும்,0,0,1,1
46965,l’épistémologie,0,0,1,1
46961,matière « chaque,0,0,1,1
46960,vervangen,0,0,1,1
46959,இன்றுவரை,0,0,1,1
135,boyd,1,1,0,1
46954,செய்துள்ளீர்கள்,0,0,1,1
46953,testing,0,0,1,1
46950,kurslitteraturen,0,0,1,1
46949,местные,0,0,1,1
136,riuscendo,1,1,0,1
46907,ستالمان,0,0,1,1
46905,вкусных,0,0,1,1
46449,ಟಿ,0,0,1,1
46904,rettelse,0,0,1,1
46862,υποτονική,0,0,1,1
46861,gnupedia,0,0,1,1
143,edite,1,1,0,1
46859,अभियान,0,0,1,1
46858,weitere,0,0,1,1
46857,എന്തൊരു,0,0,1,1
46856,förstasidan,0,0,1,1
46855,समन्वित,0,0,1,1
46854,japonês,0,0,1,1
46852,ಅರ್ಥವಾಗಿದೆ,0,0,1,1
46851,لسلوك,0,0,1,1
46850,deputy,0,0,1,1
46849,söylemeyi,0,0,1,1
46848,δάσκαλος,0,0,1,1
46847,​​lange,0,0,1,1
46845,فصاعدًا,0,0,1,1
46843,inspirera,0,0,1,1
46842,içeceği,0,0,1,1
46841,encyclonl,0,0,1,1
46840,reconhecida,0,0,1,1
46838,πολύτιμους,0,0,1,1
46837,स्थानान्तरण,0,0,1,1
46836,ಉತ್ಸುಕರಾಗಿದ್ದೇವೆ,0,0,1,1
46835,ಸ್ಲಗ್,0,0,1,1
144,susan,1,1,0,1
46833,موعدًا,0,0,1,1
46832,australia,0,0,1,1
46830,basculer,0,0,1,1
46829,പൂർവ്വസ്ഥിതിയിലായി,0,0,1,1
46863,geboden,0,0,1,1
46864,oude,0,0,1,1
46865,эмоциях,0,0,1,1
46886,hazlo,0,0,1,1
46903,ചെയ്യാത്തത്,0,0,1,1
140,iwa,1,1,0,1
46900,хорошего,0,0,1,1
46899,moldar,0,0,1,1
46897,evner,0,0,1,1
46896,animistes,0,0,1,1
46895,jeu ,0,0,1,1
46894,nogmaals,0,0,1,1
141,fondatore,1,1,0,1
46890,помахали,0,0,1,1
46889,afijo,0,0,1,1
46888,जानकारीपूर्ण,0,0,1,1
46887,paradigm,0,0,1,1
46885,கொண்டன,0,0,1,1
46866,प्रतिबिंब,0,0,1,1
46884,ദയാലുവാണ്,0,0,1,1
46883,заставил,0,0,1,1
46881,التعديل,0,0,1,1
46880,noisy,0,0,1,1
46878,लगेगी।,0,0,1,1
46876,namorado,0,0,1,1
46875,fóruns,0,0,1,1
142,sonno,1,1,0,1
46872,niveaux ,0,0,1,1
46871,guidant,0,0,1,1
46870,развивается,0,0,1,1
46869,കണ്ടെത്താൻ,0,0,1,1
46867,förstöra,0,0,1,1
128,simbolico,1,1,0,1
46998,"
तागलोग",0,0,1,1
46999,vivantes,0,0,1,1
47000,directrice,0,0,1,1
47130,اقتراحات,0,0,1,1
47128,klaar,0,0,1,1
47127,objets,0,0,1,1
47126,“பிஎச்பி”,0,0,1,1
47125,وتوقيت,0,0,1,1
47124,theme,0,0,1,1
111,difensori,1,1,0,1
47121,ചിത്രീകരണവും,0,0,1,1
47120,ஏறினாள்,0,0,1,1
112,augurare,1,1,0,1
47117,индуктивного,0,0,1,1
47113,доминирующей,0,0,1,1
47111,руководством,0,0,1,1
47108,çalış,0,0,1,1
113,pubblicabili,1,1,0,1
114,buco,1,1,0,1
47104,nonhumains,0,0,1,1
47103,экономика,0,0,1,1
47102,يمثل,0,0,1,1
47101,സൃഷ്ടിക്കും,0,0,1,1
47098,التحقق،,0,0,1,1
47097,ഡോളർ,0,0,1,1
47096,reconocía,0,0,1,1
47094,mottaglig,0,0,1,1
47093,palads,0,0,1,1
47092,oído,0,0,1,1
47090,burocracia,0,0,1,1
47089,construída,0,0,1,1
47087,elogios,0,0,1,1
47131,değiştirilmeye,0,0,1,1
47132,impossibles,0,0,1,1
110,commentando,1,1,0,1
47157,tillfällig,0,0,1,1
105,signore,1,1,0,1
47173,والاستفادة,0,0,1,1
47172,στιλβωμένος,0,0,1,1
47171,personnels,0,0,1,1
47170,ventajas,0,0,1,1
47169,கற்றுக்கொள்ளப்,0,0,1,1
47167,d’accident,0,0,1,1
47166,அறிவுள்ள,0,0,1,1
47165,принца,0,0,1,1
106,fermata,1,1,0,1
47162,consideran,0,0,1,1
47161,taal,0,0,1,1
47158,നമ്മുടെ,0,0,1,1
47155,genders,0,0,1,1
47135,"
क्रोएशियाई",0,0,1,1
47154,patiemment,0,0,1,1
47153,konsumerar,0,0,1,1
47152,påpegede,0,0,1,1
47151,minecraft,0,0,1,1
107,profondamente,1,1,0,1
47146,поездку,0,0,1,1
47143,ipadresser,0,0,1,1
47142,கட்டைவிரலைக்,0,0,1,1
47141,ജീവനക്കാരൻ,0,0,1,1
47139,nase,0,0,1,1
108,entrambi,1,1,0,1
47137,destiné,0,0,1,1
47136,हाइपरलिंक,0,0,1,1
47086,научным,0,0,1,1
47085,tá,0,0,1,1
47084,بعامين،,0,0,1,1
47025,സ്വർണ്ണവണ്ടി,0,0,1,1
47041,constater,0,0,1,1
47040,μαγική,0,0,1,1
121,ampie,1,1,0,1
47038,कैचिंग,0,0,1,1
47037,heyecanlanıyoruz,0,0,1,1
47036,förändras,0,0,1,1
47035,εκπληρώνουν,0,0,1,1
47033,benziyorsun,0,0,1,1
47032,ಮಹಿಳೆ,0,0,1,1
124,gratuiti,1,1,0,1
47028,iddia,0,0,1,1
47027,англоцентризме,0,0,1,1
47026,üzereyseniz,0,0,1,1
47024,ಆರು,0,0,1,1
47043,системную,0,0,1,1
47022,التنسيق,0,0,1,1
47021,நோக்கமற்றது,0,0,1,1
47020,ನಿರ್ಧಾರವಾಗಿದೆ,0,0,1,1
47018,paralela,0,0,1,1
47013,interstellar,0,0,1,1
47012,pourcentages,0,0,1,1
47011,விவரிக்கப்,0,0,1,1
47010,"വിക്കി
",0,0,1,1
47007,formado,0,0,1,1
47006,تكريم,0,0,1,1
47005,ईमानदार,0,0,1,1
47003,خرج,0,0,1,1
47001,engines‏,0,0,1,1
47042,نطقك,0,0,1,1
47044,ലഭിച്ചോ,0,0,1,1
47083,εξέταση,0,0,1,1
47068,الزواج,0,0,1,1
47082,ചതുപ്പിന്റെ,0,0,1,1
47081,مقترحين,0,0,1,1
47079,représentent,0,0,1,1
47078,नीतियां।,0,0,1,1
47077,frikipedia,0,0,1,1
47076,أفادت,0,0,1,1
47075,أمستردام,0,0,1,1
47074,house,0,0,1,1
115,tentativo,1,1,0,1
116,otto,1,1,0,1
47071,erziehen,0,0,1,1
47070,ನೋಡಿದಾಗಿನಿಂದ,0,0,1,1
47069,தெரிந்தால்,0,0,1,1
117,inviato,1,1,0,1
47045,tediosas,0,0,1,1
47066,ನಿಲುಗಡೆ,0,0,1,1
47065,περίπτωσή,0,0,1,1
47060,ನೀವು,0,0,1,1
118,cailliau,1,1,0,1
47058,नकली,0,0,1,1
47057,മാതൃകയെ,0,0,1,1
47056,ajuster,0,0,1,1
47054,воспользуюсь,0,0,1,1
47051,téléchargéesae,0,0,1,1
119,piantare,1,1,0,1
120,spiegano,1,1,0,1
47048,«будущее,0,0,1,1
47046,évidente,0,0,1,1
46828,trae,0,0,1,1
46827,لطيفًا,0,0,1,1
46826,просит,0,0,1,1
46645,entrainement,0,0,1,1
46592,lifeforms,0,0,1,1
180,contribuisce,1,1,0,1
46589,предпочли,0,0,1,1
46588,வாருங்கள்,0,0,1,1
46587,incidents,0,0,1,1
46586,variances,0,0,1,1
46585,dagar,0,0,1,1
46584,ബെൽ,0,0,1,1
46583,rightarrow,0,0,1,1
46581,ഭൂമിക്ക്,0,0,1,1
46580,मिस्सा,0,0,1,1
46579,misinformation,0,0,1,1
46578,habitual,0,0,1,1
46577,ijsje,0,0,1,1
46574,моим,0,0,1,1
46573,bioinformatique,0,0,1,1
46572,asociación,0,0,1,1
46570,يدين,0,0,1,1
46569,tracts,0,0,1,1
181,risorse,1,1,0,1
46566,καλύτερος,0,0,1,1
46565,dessein,0,0,1,1
46564,προσπαθείτε,0,0,1,1
46562,necessário,0,0,1,1
183,finito,1,1,0,1
46559,வாழ்ந்தார்,0,0,1,1
46558,பதிலளிக்குமுகமாக,0,0,1,1
46557,dn,0,0,1,1
46554,sugieren,0,0,1,1
46593,planctu,0,0,1,1
46594,grubun,0,0,1,1
46595,முகத்தில்,0,0,1,1
46623,trem,0,0,1,1
46642,"
tagalo",0,0,1,1
46641,النطاقات,0,0,1,1
46640,fantaisistes,0,0,1,1
46639,анонимными,0,0,1,1
46638,bracket,0,0,1,1
46637,पूछना,0,0,1,1
46636,besorgen,0,0,1,1
46632,dramatica,0,0,1,1
170,famiglie,1,1,0,1
46630,vermuten,0,0,1,1
172,voragine,1,1,0,1
46627,تدين,0,0,1,1
173,scrittura,1,1,0,1
46622,hattest,0,0,1,1
46597,പ്രതിഭാസങ്ങളെയും,0,0,1,1
46621,trazia,0,0,1,1
46617,anımsattıkları”,0,0,1,1
46615,årsförbrukning,0,0,1,1
46614,protista,0,0,1,1
46613,grau,0,0,1,1
46611,aldı,0,0,1,1
46610,സമ്പത്തും,0,0,1,1
46608,ഗെയിമിനെ,0,0,1,1
46607,prepubescent,0,0,1,1
177,appartenere,1,1,0,1
46601,तरीकों,0,0,1,1
46600,conocía,0,0,1,1
178,diamanti,1,1,0,1
46553,basados,0,0,1,1
184,cancellazioni,1,1,0,1
46551,الرائع,0,0,1,1
46477,காலையில்,0,0,1,1
46499,പ്രവൃത്തിയെക്കുറിച്ച്,0,0,1,1
46498,الرهيب,0,0,1,1
46495,construit,0,0,1,1
46492,tillit,0,0,1,1
46491,فرد,0,0,1,1
46488,crop,0,0,1,1
46487,bomis ,0,0,1,1
46486,anonimato,0,0,1,1
46484,зачастую,0,0,1,1
46483,bio,0,0,1,1
46481,തെറ്റിദ്ധരിക്കുന്ന,0,0,1,1
194,costituisce,1,1,0,1
46478,volumen,0,0,1,1
46476,കണ്ണുനീരിന്,0,0,1,1
46501,regrouper ,0,0,1,1
46473,dérangeraitil,0,0,1,1
46472,αξιόπιστης,0,0,1,1
46469,geschäft,0,0,1,1
46468,αποφεύγοντας,0,0,1,1
46466,tendría,0,0,1,1
46465,administrateurs,0,0,1,1
195,piatto,1,1,0,1
46459,træder,0,0,1,1
46457,chics,0,0,1,1
46456,حاد,0,0,1,1
46455,تكاليف,0,0,1,1
46454,நினைக்கிறாய்,0,0,1,1
197,riportata,1,1,0,1
46500,sensiz,0,0,1,1
46502,rediffuser,0,0,1,1
46550,объективно,0,0,1,1
46529,താൾ,0,0,1,1
46548,cloud,0,0,1,1
46546,ಇಲ್ಲದೆ,0,0,1,1
46545,பிரச்சனையும்,0,0,1,1
46543,older,0,0,1,1
46541,വശമാണ്,0,0,1,1
46540,voces,0,0,1,1
185,rimettiti,1,1,0,1
46537,الكتابة,0,0,1,1
187,vogliono,1,1,0,1
46535,பாதுகாக்கப்பட்டுள்ளன,0,0,1,1
46534,hvilke,0,0,1,1
46533,recherchons,0,0,1,1
46531,funktionen,0,0,1,1
46527,politely,0,0,1,1
191,ammetti,1,1,0,1
188,starnutito,1,1,0,1
46524,faisait,0,0,1,1
46523,greetings,0,0,1,1
46521,возражаешь,0,0,1,1
46517,apropriadas,0,0,1,1
46515,कोक,0,0,1,1
46513,controverses,0,0,1,1
189,cambiato,1,1,0,1
46511,عظيم,0,0,1,1
46510,motsvarigheter,0,0,1,1
190,bontà,1,1,0,1
46508,പാർട്ടികളെക്കുറിച്ചുള്ള,0,0,1,1
46506,посещаемость,0,0,1,1
46644,etikettregler,0,0,1,1
46646,കൊണ്ടിരിക്കുന്നു,0,0,1,1
46825,bijeenkomst,0,0,1,1
46647,gekeken,0,0,1,1
46779,écologiques,0,0,1,1
46778,முழுவதுமாகப்,0,0,1,1
46777,αλεύρι,0,0,1,1
46776,συνάντησης,0,0,1,1
46775,perdiendo,0,0,1,1
46774,chats,0,0,1,1
46773,uygulanmak,0,0,1,1
46772,opfundet,0,0,1,1
46770,editarlos,0,0,1,1
46769,ατόμου,0,0,1,1
46768,fui,0,0,1,1
46765,arbres,0,0,1,1
46764,விளைவிக்கக்கூடிய,0,0,1,1
46762,नोल,0,0,1,1
46761,tischmanieren,0,0,1,1
151,gelato,1,1,0,1
46758,froid,0,0,1,1
46757,filtre,0,0,1,1
46756,ഇന്ന്‌,0,0,1,1
46753,plos,0,0,1,1
155,scorsa,1,1,0,1
46750,தாழ்மையானவர்,0,0,1,1
46748,экзамену,0,0,1,1
46746,locomotion‏,0,0,1,1
156,seguirono,1,1,0,1
46744,knopf,0,0,1,1
46743,confrontés,0,0,1,1
46742,chamador,0,0,1,1
46741,പൂർവ്വസ്ഥിതിയിലെത്തുവാൻ,0,0,1,1
46781,отрицательное,0,0,1,1
46782,piadas,0,0,1,1
46783,പാഠത്തിൽ,0,0,1,1
46803,ياهو,0,0,1,1
46824,publicaron,0,0,1,1
46823,ಖಚಿತವಾಗಿದೆ,0,0,1,1
46822,desinformation,0,0,1,1
46821,genommen,0,0,1,1
46819,biggest,0,0,1,1
46816,κοινού,0,0,1,1
46815,தொகுப்பாளர்களின்,0,0,1,1
46814,feinste,0,0,1,1
46812,cruzas,0,0,1,1
46808,undue,0,0,1,1
46807,أمير,0,0,1,1
46806,الإستراتيجية,0,0,1,1
46804,அமர்ந்திருக்கிறார்கள்,0,0,1,1
46802,ситуации,0,0,1,1
46785,റഫറൻസുകളുമായി,0,0,1,1
46801,coexistir,0,0,1,1
46800,constitutionnels,0,0,1,1
147,remunerati,1,1,0,1
46797,സ്വതന്ത്രനാണോ,0,0,1,1
46795,parliez,0,0,1,1
148,vera,1,1,0,1
46793,അറിയപ്പെട്ടിരുന്നെങ്കിലും,0,0,1,1
46792,يقال,0,0,1,1
46791,начинается,0,0,1,1
46790,discernir,0,0,1,1
46789,hará,0,0,1,1
46788,ಹೇಳಬೇಕಾಗಿದೆ,0,0,1,1
46787,qualité »ab,0,0,1,1
46740,இதையெல்லாம்,0,0,1,1
158,tornato,1,1,0,1
46738,गईं।,0,0,1,1
46666,provoqué,0,0,1,1
46689,സംഭവിച്ച,0,0,1,1
163,privilegiate,1,1,0,1
46686,contextualization,0,0,1,1
164,laggiù,1,1,0,1
46684,weint,0,0,1,1
46682,ഇൻപുട്ടുകൾ,0,0,1,1
46680,"
वेल्श",0,0,1,1
46678,അവയിൽ‌,0,0,1,1
46675,alunos,0,0,1,1
46674,hemligt,0,0,1,1
46671,commentant,0,0,1,1
46670,கூர்மையானது,0,0,1,1
46668,custo,0,0,1,1
46665,जीने,0,0,1,1
46691,америке,0,0,1,1
46663,распространение,0,0,1,1
46662,അമ്മയ്‌ക്കായി,0,0,1,1
46661,сильны,0,0,1,1
46660,المغادرة,0,0,1,1
46659,plantera,0,0,1,1
46658,മലയാളത്തിൽ,0,0,1,1
166,condotto,1,1,0,1
46656,जीता,0,0,1,1
46654,εσένα,0,0,1,1
46653,проверку,0,0,1,1
46652,laissemoi,0,0,1,1
46651,sentó,0,0,1,1
46650,atmosphère,0,0,1,1
46690,விடய,0,0,1,1
46694,മികച്ചതുമാണ്,0,0,1,1
46737,проходит,0,0,1,1
46713,rangés,0,0,1,1
46736,içerik,0,0,1,1
46735,மூன்றாம்,0,0,1,1
46734,சிலவேளைகளில்,0,0,1,1
46729,ജ്ഞാനമല്ല,0,0,1,1
46728,सामना,0,0,1,1
46727,अगला,0,0,1,1
46725,पी,0,0,1,1
46724,comptant,0,0,1,1
46721,критиков,0,0,1,1
46719,pourvus,0,0,1,1
46718,smage,0,0,1,1
46717,pedophilia,0,0,1,1
46714,ifadelerine,0,0,1,1
46712,ifaktor,0,0,1,1
46695,gangliaaf,0,0,1,1
46709,தந்தி,0,0,1,1
46708,conscientes,0,0,1,1
46707,تحقق,0,0,1,1
46706,planning,0,0,1,1
46705,deneyimi,0,0,1,1
46704,പേരുകേട്ടതാണ്,0,0,1,1
46703,أربع,0,0,1,1
46702,förutsätts,0,0,1,1
46701,السابقة,0,0,1,1
46700,cablegate,0,0,1,1
46699,внешностью,0,0,1,1
46698,بالقلق,0,0,1,1
46697,"
esperanto",0,0,1,1
47175,superstitions,0,0,1,1
47177,चौथी,0,0,1,1
47180,caractérisait,0,0,1,1
47728,ദശലക്ഷം,0,0,1,1
47682,äußersten,0,0,1,1
47681,medicine,0,0,1,1
47680,उदघाटन,0,0,1,1
47679,ஐந்து,0,0,1,1
47678,dorf,0,0,1,1
47677,definierade,0,0,1,1
47676,demandais,0,0,1,1
47674,ഉണ്ടായില്ല,0,0,1,1
47673,continuaba,0,0,1,1
47671,impressionante,0,0,1,1
47669,പരാതിപ്പെടുകയും,0,0,1,1
47668,ஊக்கத்துடன்,0,0,1,1
47666,robots ,0,0,1,1
47665,تدرب,0,0,1,1
47664,generalizar,0,0,1,1
47663,утопление,0,0,1,1
47662,സേർച്ച്,0,0,1,1
35,conterrà,1,1,0,1
47659,económicos,0,0,1,1
47657,webs,0,0,1,1
47656,vindicates,0,0,1,1
47654,terá,0,0,1,1
47653,மொழிப்பதிப்பும்,0,0,1,1
47652,எனப்,0,0,1,1
47651,വരുത്തുന്നു,0,0,1,1
47650,alınarak,0,0,1,1
47649,problematisera,0,0,1,1
47646,ülkeye,0,0,1,1
47645,κερδοσκοπικό,0,0,1,1
47683,transforme,0,0,1,1
47684,التحرير،,0,0,1,1
30,trovare,1,1,0,1
47712,cronometra,0,0,1,1
47726,sønderknust,0,0,1,1
47725,kuşunki,0,0,1,1
47724,eklenmesi,0,0,1,1
47723,нажали,0,0,1,1
47722,acerta,0,0,1,1
47721,χρησιμοποιεί,0,0,1,1
47720,remnants,0,0,1,1
47719,çıkarmanız,0,0,1,1
47718,amacı,0,0,1,1
47717,zufällig,0,0,1,1
47715,فتتلقى,0,0,1,1
47714,«нупедии» —,0,0,1,1
47713,frivilliga,0,0,1,1
24,trattazione,1,1,0,1
47687,intervalos,0,0,1,1
47708,suponha,0,0,1,1
47707,implausible,0,0,1,1
27,acquisizione,1,1,0,1
47705,സന്നദ്ധസമൂഹം,0,0,1,1
47702,editável,0,0,1,1
47699,jenny,0,0,1,1
47698,id,0,0,1,1
47697,coût,0,0,1,1
47696,perro,0,0,1,1
47695,"
chinês",0,0,1,1
47693,सुनाया,0,0,1,1
47691,wikiprogramvara,0,0,1,1
47690,quejan,0,0,1,1
47644,interpretive,0,0,1,1
47643,ontzagwekkende,0,0,1,1
47642,négliger,0,0,1,1
47580,​​உங்கள்,0,0,1,1
47597,πνίγω,0,0,1,1
47595,والعينات,0,0,1,1
47593,offrira,0,0,1,1
47592,necessity,0,0,1,1
47590,professional,0,0,1,1
47589,hierarchy,0,0,1,1
47588,تزايد,0,0,1,1
47,utilizzando,1,1,0,1
48,crescerà,1,1,0,1
47584,автор,0,0,1,1
47583,kalkylark,0,0,1,1
47582,κλπ,0,0,1,1
47581,«истории»,0,0,1,1
47578,ಹಿಂದಿನ,0,0,1,1
47599,जाऊँगा,0,0,1,1
47576,ಸಿನೆಮಾಗಳಿಗಾಗಿ,0,0,1,1
47575,narcissemamma,0,0,1,1
47573,periodically,0,0,1,1
47571,valuation,0,0,1,1
47570,samlas,0,0,1,1
47569,killed,0,0,1,1
47568,ay,0,0,1,1
47567,motståndare,0,0,1,1
47564,заданиями,0,0,1,1
47563,europeisk,0,0,1,1
47561,suffisent,0,0,1,1
47560,கட்டுரைத்,0,0,1,1
47559,ನಾರ್ಸಿಸಿಸಮ್,0,0,1,1
47598,نصها,0,0,1,1
47600,للإنترنت,0,0,1,1
47641,വിക്കിപീഡിയകൾ,0,0,1,1
39,infelice,1,1,0,1
47640,bedacht,0,0,1,1
47639,ενότητα,0,0,1,1
47638,வளர்ப்பதற்கு,0,0,1,1
47637,stinkt,0,0,1,1
47634,concentration,0,0,1,1
47633,പഠിക്കുന്ന,0,0,1,1
37,autorizza,1,1,0,1
47631,konuşalım,0,0,1,1
47629,ഇമെയിൽ,0,0,1,1
47628,noting,0,0,1,1
47627,മനസിലാക്കരുത്,0,0,1,1
38,fornendo,1,1,0,1
47625,eden,0,0,1,1
47623,ಕ್ಯಾಲಿಫೋರ್ನಿಯಾದಲ್ಲಿ,0,0,1,1
47602,forskningsartiklar,0,0,1,1
47622,وخوادم,0,0,1,1
40,giappone,1,1,0,1
47618,dije,0,0,1,1
47616,grædende,0,0,1,1
47615,ഉൽപത്തി,0,0,1,1
47613,ಒಂದನ್ನು,0,0,1,1
47611,مصرفي,0,0,1,1
47609,enterarse,0,0,1,1
42,omonimo,1,1,0,1
47606,एलेक्सा,0,0,1,1
47605,ευτυχισμένος,0,0,1,1
47604,когонибудь,0,0,1,1
43,poterlo,1,1,0,1
47727,performed,0,0,1,1
47730,drengen,0,0,1,1
49,posizione,1,1,0,1
47731,സാഹചര്യത്തിലായിരിക്കുക,0,0,1,1
47868,taliban,0,0,1,1
47867,counterparts,0,0,1,1
47866,bestempeld,0,0,1,1
47864,pixels,0,0,1,1
47861,കൃത്യമായൊരു,0,0,1,1
47859,encantada,0,0,1,1
47857,പിറ്റേന്ന്,0,0,1,1
47856,relatórios,0,0,1,1
47855,hadean,0,0,1,1
47854,ecke,0,0,1,1
47850,الأحرف,0,0,1,1
47849,editan,0,0,1,1
47847,parodi,0,0,1,1
47846,condicionales,0,0,1,1
47845,സംവൃതോകാരത്തിന്റെ,0,0,1,1
47844,подвез,0,0,1,1
47843,iphoneenheter,0,0,1,1
47842,separation,0,0,1,1
6,memoriam,1,1,0,1
7,magnifico,1,1,0,1
47838,shipments,0,0,1,1
47837,wiederholung,0,0,1,1
47836,paz,0,0,1,1
47835,uppträdde,0,0,1,1
47834,forsøger,0,0,1,1
47833,umursamıyorsun,0,0,1,1
47831,உப்பு,0,0,1,1
47829,отклонила,0,0,1,1
47828,royaumeuni,0,0,1,1
47869,تقوم,0,0,1,1
47870,kodlu,0,0,1,1
47871,totémisme,0,0,1,1
47890,ഇപയോഗിക്കുന്നത്,0,0,1,1
47908,применить,0,0,1,1
47906,uuu,0,0,1,1
47905,betrekkelijk,0,0,1,1
47904,instantaneamente,0,0,1,1
2,rimasto,1,1,0,1
47902,oke,0,0,1,1
47900,تعديلها,0,0,1,1
47899,arbetat,0,0,1,1
47897,zes,0,0,1,1
47896,collaborateurs,0,0,1,1
47893,ടി,0,0,1,1
47892,geldim,0,0,1,1
47891,αμερική,0,0,1,1
47888,ആദ്യ,0,0,1,1
47872,kronolojik,0,0,1,1
47887,favorece,0,0,1,1
47886,المتعددة,0,0,1,1
47885,aborígenes,0,0,1,1
47883,रीतिरिवाजों,0,0,1,1
3,redazionale,1,1,0,1
47880,hawaiano​,0,0,1,1
47879,ethnologie,0,0,1,1
5,descriverle,1,1,0,1
47877,தன்னார்வலர்களால்,0,0,1,1
47876,عاشت,0,0,1,1
47875,மகிழ்ச்சியற்றதையும்,0,0,1,1
47874,constitutionnelle,0,0,1,1
47873,casheservrar,0,0,1,1
47827,വാങ്ങാൻ,0,0,1,1
47825,شيركي،,0,0,1,1
47824,« diderot,0,0,1,1
16,raddoppiando,1,1,0,1
14,premendo,1,1,0,1
47777,طردت,0,0,1,1
47776,പദമില്ലാത്തതിനാൽ,0,0,1,1
47775,டிப்,0,0,1,1
47773,காலம்வரை,0,0,1,1
47771,utvärderade,0,0,1,1
47770,ആയിരിക്കുമെന്ന്,0,0,1,1
47766,பங்களிப்பாளர்கள்,0,0,1,1
47765,നോക്കാം,0,0,1,1
47764,uitdrukkelijk,0,0,1,1
47763,verilen,0,0,1,1
47762,وقتًا,0,0,1,1
47759,atribuição,0,0,1,1
18,apprese,1,1,0,1
47782,¿perdóneme,0,0,1,1
47751,ലിങ്ക്,0,0,1,1
47750,ochtend,0,0,1,1
47749,namely,0,0,1,1
47746,самоубийство,0,0,1,1
47744,boodschapper,0,0,1,1
19,additandole,1,1,0,1
47741,behandelde,0,0,1,1
47740,déconcertée,0,0,1,1
47739,твоих,0,0,1,1
47737,сделала,0,0,1,1
47736,возникающие,0,0,1,1
47735,उज्ज्वल,0,0,1,1
21,sorgenti,1,1,0,1
47781,മറ്റുള്ളവരോട്,0,0,1,1
47783,оплачиваемых,0,0,1,1
47823,„википедии“,0,0,1,1
47804,femme,0,0,1,1
47822,قفزت,0,0,1,1
47821,всеми,0,0,1,1
47819,diepbedroefd,0,0,1,1
47815,உரிமம்,0,0,1,1
47814,إصدار,0,0,1,1
47812,developers,0,0,1,1
47811,unintelligen,0,0,1,1
47810,corridor,0,0,1,1
47809,ഡൽഹിയിൽ,0,0,1,1
47808,esclusa,0,0,1,1
47807,prisonniers,0,0,1,1
47806,onwards,0,0,1,1
47805,fi,0,0,1,1
47803,confirming,0,0,1,1
47784,മനസ്സിലായില്ലെങ്കിൽ‌,0,0,1,1
47801,ஆதாரம்,0,0,1,1
47799,रोका,0,0,1,1
47798,gebeurde,0,0,1,1
47797,ಶಾಲೆಯಲ್ಲಿ,0,0,1,1
47796,وكأنه,0,0,1,1
47795,citable,0,0,1,1
47794,war •,0,0,1,1
11,pazientemente,1,1,0,1
47791,придерживаются,0,0,1,1
47790,pas »,0,0,1,1
47788,drukken,0,0,1,1
47787,തരത്തിലാണുള്ളത്,0,0,1,1
13,aggiornabile,1,1,0,1
47558,ونتيجة,0,0,1,1
47555,çıkardın,0,0,1,1
47188,communityproduced,0,0,1,1
47360,العشرة,0,0,1,1
47310,följde,0,0,1,1
47309,raison »,0,0,1,1
47308,paleis,0,0,1,1
47307,извинения,0,0,1,1
47306,отнести,0,0,1,1
47305,delega,0,0,1,1
47304,numérique »,0,0,1,1
47303,traduite,0,0,1,1
47301,സങ്കീർണ്ണവും,0,0,1,1
47299,filtrerades,0,0,1,1
47298,utseendet,0,0,1,1
47296,ஒலிக்கிறோம்,0,0,1,1
47293,പദങ്ങളോ,0,0,1,1
47292,مشتقة,0,0,1,1
47291,inconsistencia,0,0,1,1
47290,defendia,0,0,1,1
47289,पार्टी,0,0,1,1
47288,ವೀಡಿಯೊಗೆ,0,0,1,1
47287,إعجابًا,0,0,1,1
47286,владеет,0,0,1,1
47285,ederiz,0,0,1,1
47284,ortaya,0,0,1,1
93,formano,1,1,0,1
47281,parlak,0,0,1,1
47280,gebe,0,0,1,1
47279,दबाकर,0,0,1,1
47277,عروض,0,0,1,1
47276,تركت,0,0,1,1
47274,contido,0,0,1,1
47311,अलेक्सा,0,0,1,1
47312,rir,0,0,1,1
47313,പങ്കെടുക്കുമ്പോൾ,0,0,1,1
47334,tocante,0,0,1,1
47357,വെയറിന്റെ,0,0,1,1
47356,altos,0,0,1,1
85,tasso,1,1,0,1
47353,söylüyordun,0,0,1,1
86,zamolli,1,1,0,1
47351,കഴിക്കൂ,0,0,1,1
47350,ब्लॉक,0,0,1,1
47349,acontece,0,0,1,1
47345,webosbased,0,0,1,1
47344,ആധികാരിക,0,0,1,1
47339,aldıkları,0,0,1,1
47338,planejando,0,0,1,1
47335,geklickt,0,0,1,1
47333,connectionism,0,0,1,1
47314,ചെയ്യുകയായിരുന്നു,0,0,1,1
47332,événement,0,0,1,1
47331,αφού,0,0,1,1
47328,القمر،,0,0,1,1
47327,telefoniert,0,0,1,1
47325,melisa,0,0,1,1
47324,microclusters,0,0,1,1
47323,zinkt,0,0,1,1
47321,androidenheter,0,0,1,1
47320,behind,0,0,1,1
47319,фигурами,0,0,1,1
47317,efterfrågar,0,0,1,1
47316,lava,0,0,1,1
47315,अज़रबैजानी,0,0,1,1
47272,symboliques,0,0,1,1
47271,efficiently,0,0,1,1
47270,begrijp,0,0,1,1
47211,otimização,0,0,1,1
47228,εγκωμιάζουν,0,0,1,1
47226,الفعل,0,0,1,1
47224,genotypes,0,0,1,1
47223,ülkenin,0,0,1,1
47222,sonhou,0,0,1,1
47220,admiração,0,0,1,1
47219,sözlerim,0,0,1,1
47217,arquitetura,0,0,1,1
47216,salladığın,0,0,1,1
47215,повторил,0,0,1,1
47214,നോക്കിയപ്പോൾ,0,0,1,1
47213,والخبز,0,0,1,1
47212,diskutera,0,0,1,1
101,presentano,1,1,0,1
47230,tröga,0,0,1,1
47208,языком,0,0,1,1
47207,इनकी,0,0,1,1
47206,അപ്രാപ്യമല്ല,0,0,1,1
102,ricorrenze,1,1,0,1
103,autorizzazione,1,1,0,1
47199,प्रकरण,0,0,1,1
47197,முடுக்கிவிடுங்கள்,0,0,1,1
47195,intégralité,0,0,1,1
47194,marcher,0,0,1,1
47192,ಎಲ್ಲೀ,0,0,1,1
47191,компьютерные,0,0,1,1
47190,يومًا,0,0,1,1
47189,gemakkelijk,0,0,1,1
99,inaffidabile,1,1,0,1
47231,distinctly,0,0,1,1
47266,الفظة,0,0,1,1
47252,பேச்சுவழக்கு,0,0,1,1
47265,sayfada,0,0,1,1
47264,encargó,0,0,1,1
47263,confundido,0,0,1,1
47262,മാണിക്യ,0,0,1,1
47261,refereed,0,0,1,1
94,affondare,1,1,0,1
47259,उलझन,0,0,1,1
47258,fomenta,0,0,1,1
47257,നിർവ്വാഹകർ,0,0,1,1
47256,possibility,0,0,1,1
47255,riding,0,0,1,1
47254,rätta,0,0,1,1
47253,छोड़ने,0,0,1,1
47251,alternativt,0,0,1,1
47232,caixa,0,0,1,1
47250,kurallarında,0,0,1,1
47249,നിങ്ങൾക്കാവശ്യമുണ്ടെങ്കിൽ,0,0,1,1
47248,എന്നതു,0,0,1,1
47246,dupla,0,0,1,1
47245,—usuarios,0,0,1,1
96,elica,1,1,0,1
97,scapito,1,1,0,1
47241,ಖಚಿತವಾಗಿದೆಯೇ,0,0,1,1
47240,إيكونوميك,0,0,1,1
47239,sofrem,0,0,1,1
47238,المضيفون،,0,0,1,1
47237,ಬಂದನು,0,0,1,1
47236,dite,0,0,1,1
47359,zalimce,0,0,1,1
47361,والمجتمع,0,0,1,1
47554,instancias,0,0,1,1
83,pronunciarlo,1,1,0,1
47504,ನಾಮಪದವಾಗಿ,0,0,1,1
47503,"
macedónio",0,0,1,1
47502,realized,0,0,1,1
47501,சாப்பிடு,0,0,1,1
47500,treatment,0,0,1,1
47498,நடைமுறைப்படுத்தி,0,0,1,1
47496,fundamentally,0,0,1,1
47495,வழங்கப்பட்டது,0,0,1,1
47493,நொடியில்,0,0,1,1
47490,दोष,0,0,1,1
47488,tankerne,0,0,1,1
47487,çorbada,0,0,1,1
47486,умный,0,0,1,1
47485,knams,0,0,1,1
47484,efetivada,0,0,1,1
47483,பயன்படுத்திக்,0,0,1,1
47481,चूँकि,0,0,1,1
47480,gesproken,0,0,1,1
47479,मेज,0,0,1,1
47478,denkst,0,0,1,1
47477,ciência,0,0,1,1
47476,bütün,0,0,1,1
47475,اليابانية،,0,0,1,1
47471,مفتوح,0,0,1,1
47468,وخسرت,0,0,1,1
47467,കഴിക്കുന്നതിനേക്കാൾ,0,0,1,1
47466,корреляцию,0,0,1,1
47465,ಬಿರುಗಾಳಿಯ,0,0,1,1
47464,осознание,0,0,1,1
47505,تمضي,0,0,1,1
60,formulati,1,1,0,1
47507,phu,0,0,1,1
57,caratteristiche,1,1,0,1
47552,создавать,0,0,1,1
47551,ستريت,0,0,1,1
50,scorrono,1,1,0,1
47548,производных,0,0,1,1
51,impareremo,1,1,0,1
52,avevo,1,1,0,1
47544,relies,0,0,1,1
47543,வேளையில்,0,0,1,1
47541,portavoz,0,0,1,1
47540,minst,0,0,1,1
53,assai,1,1,0,1
47537,பாராட்டுகிறேன்,0,0,1,1
47536,betraktades,0,0,1,1
47531,الاتجاه,0,0,1,1
47509,ബാങ്ക്‌,0,0,1,1
47530,இணையத்,0,0,1,1
47528,medtaget,0,0,1,1
47527,efterfølgende,0,0,1,1
47523,ആശയത്തിനെ,0,0,1,1
47522,οικονομία,0,0,1,1
47521,уместно,0,0,1,1
47520,deverão,0,0,1,1
47519,plausible,0,0,1,1
47517,مقتبساً,0,0,1,1
47516,ತಂಪಾಗಿದೆ,0,0,1,1
58,redistribuiti,1,1,0,1
47513,താരതമ്യേന,0,0,1,1
59,focalizza,1,1,0,1
47462,அங்கேயே,0,0,1,1
47460,सोसाइटी,0,0,1,1
47459,ಇದಕ್ಕಾಗಿ,0,0,1,1
47386,conditionne,0,0,1,1
74,statico,1,1,0,1
47401,proportionnellement,0,0,1,1
47400,μίλησε,0,0,1,1
47398,cunhado,0,0,1,1
75,comprensivo,1,1,0,1
47395,conduisent,0,0,1,1
47394,hepsi,0,0,1,1
78,libere,1,1,0,1
47392,uitzicht,0,0,1,1
47391,coloniale,0,0,1,1
47389,şeyden,0,0,1,1
47388,honnêtement,0,0,1,1
80,guidare,1,1,0,1
47384,मानसिक,0,0,1,1
47409,pornografiska,0,0,1,1
47382,reflet,0,0,1,1
47381,brister,0,0,1,1
47380,ανακρίβεια,0,0,1,1
47376,ancestry,0,0,1,1
47374,е д свердлов,0,0,1,1
47373,كطباعة,0,0,1,1
47372,вашингтоне,0,0,1,1
47370,continuarmos,0,0,1,1
47369,« discussion »,0,0,1,1
82,intonazione,1,1,0,1
47367,conquest,0,0,1,1
47365,portrayals,0,0,1,1
47364,graham,0,0,1,1
47404,"हों।
इन",0,0,1,1
47411,கூடியனவாய்,0,0,1,1
47456,بمصدر،,0,0,1,1
47438,förslaget,0,0,1,1
47455,nergisli,0,0,1,1
47454,போகலாம்,0,0,1,1
47453,refleja,0,0,1,1
64,citato,1,1,0,1
47450,τύχη,0,0,1,1
65,osservato,1,1,0,1
47448,άκρη,0,0,1,1
47447,boğuşuyorum,0,0,1,1
66,genoma,1,1,0,1
47443,brevetage,0,0,1,1
47442,estilísticas,0,0,1,1
68,fallo,1,1,0,1
47440,ഭാഷാപരമായ,0,0,1,1
47437,ഒരുപാട്,0,0,1,1
47412,είπαν,0,0,1,1
47434,gale,0,0,1,1
47433,இழக்கப்பட்ட,0,0,1,1
47432,attributes,0,0,1,1
47430,вопросам,0,0,1,1
47429,origines,0,0,1,1
47426,voorbij,0,0,1,1
47424,الدراسات,0,0,1,1
47423,تثبت,0,0,1,1
47421,ಬಯಸುವ,0,0,1,1
47420,bezoeker,0,0,1,1
72,convenzioni,1,1,0,1
47415,மன்னிப்பு,0,0,1,1
47414,численных,0,0,1,1
46451,πήγε,0,0,1,1
198,ammirati,1,1,0,1
45016,signera,0,0,1,1
45451,الإعلامية,0,0,1,1
313,esercitarsi,1,1,0,1
45492,وتحريك,0,0,1,1
45491,geoinformação,0,0,1,1
45490,décontenancée,0,0,1,1
314,ieri,1,1,0,1
45488,épouse,0,0,1,1
45487,receitas,0,0,1,1
45486,தங்கமாக,0,0,1,1
45485,marchó,0,0,1,1
45482,möchtest,0,0,1,1
45481,सीखना,0,0,1,1
45479,azar,0,0,1,1
316,crusca,1,1,0,1
45477,हफ्ते,0,0,1,1
45476,şaşırdım,0,0,1,1
45475,करूं,0,0,1,1
45472,мысленно,0,0,1,1
45471,lusteloos,0,0,1,1
45469,tropicale,0,0,1,1
45468,однополых,0,0,1,1
317,pecora,1,1,0,1
45464,पहुंचते,0,0,1,1
319,nonlineari,1,1,0,1
45462,venant,0,0,1,1
45461,الطاولة,0,0,1,1
45458,ಮಾರ್ಗ,0,0,1,1
45457,spare,0,0,1,1
45456,ದೊಡ್ಡವಳು,0,0,1,1
45454,encontradas,0,0,1,1
45494,consistência,0,0,1,1
45495,ദേഷ്യമാണ്,0,0,1,1
45496,അവസാനിച്ചിട്ടില്ല,0,0,1,1
45518,مشغولاً,0,0,1,1
45541,environnementales,0,0,1,1
45540,torne,0,0,1,1
45537,लक्षित,0,0,1,1
45535,expressar,0,0,1,1
45533,masturbation,0,0,1,1
45530,géographie,0,0,1,1
310,creativa,1,1,0,1
45527,типизировать,0,0,1,1
45525,mínimo,0,0,1,1
45523,formé,0,0,1,1
45522,அழுக்கு,0,0,1,1
45521,disposal,0,0,1,1
45520,beklemesini,0,0,1,1
45517,ανοικτής,0,0,1,1
45497,собой,0,0,1,1
45516,valorizado,0,0,1,1
45515,regardless,0,0,1,1
45514,மூளை,0,0,1,1
45511,நன்றாகச்,0,0,1,1
45510,والجدير,0,0,1,1
45509,einstellen,0,0,1,1
45507,sobrecargas,0,0,1,1
45505,cognition,0,0,1,1
45503,fertig,0,0,1,1
45502,ಅಸಾಧಾರಣವಾದ,0,0,1,1
45501,fraud,0,0,1,1
45500,"​
larry",0,0,1,1
45499,географических,0,0,1,1
45452,അപ്പം,0,0,1,1
45450,masasına,0,0,1,1
46446,regularities,0,0,1,1
45449,языках,0,0,1,1
45403,resolved,0,0,1,1
45400,வாக்கியத்தைப்,0,0,1,1
45399,sinks,0,0,1,1
45398,branden,0,0,1,1
45397,ಸರಿಪಡಿಸಲು,0,0,1,1
45396,engendrement,0,0,1,1
45394,попрощаться,0,0,1,1
45392,вверх,0,0,1,1
45391,hémisphère,0,0,1,1
45390,«непредубеждения»,0,0,1,1
45389,ஆடைகளின்,0,0,1,1
45388,ഉറപ്പാണോ,0,0,1,1
45387,பெண்,0,0,1,1
45384,stabilise,0,0,1,1
45383,टुकड़ा,0,0,1,1
45382,التعليقات,0,0,1,1
45380,தொலைதூரத்தில்,0,0,1,1
45379,തോന്നാൻ,0,0,1,1
45376,அறியப்பட்ட,0,0,1,1
45375,reflect,0,0,1,1
45374,corregir,0,0,1,1
45372,armée,0,0,1,1
45371,الحلزون,0,0,1,1
45369,تعيينه,0,0,1,1
45366,άλλον,0,0,1,1
45365,ಇಂಗ್ಲಿಷ್‌ನಲ್ಲಿ,0,0,1,1
45364,calm,0,0,1,1
45363,θέα,0,0,1,1
45362,agrupan,0,0,1,1
45404,பன்மொழி,0,0,1,1
45406,മേശ,0,0,1,1
329,irrilevanti,1,1,0,1
45427,ahogando,0,0,1,1
45448,tekstpassages,0,0,1,1
45446,متوسط,0,0,1,1
45444,deltagande,0,0,1,1
320,corrette,1,1,0,1
45442,warren,0,0,1,1
45441,إليهم,0,0,1,1
321,inserimenti,1,1,0,1
45435,explication,0,0,1,1
45434,erfahrung,0,0,1,1
45432,zaden,0,0,1,1
45431,sanningsenlig,0,0,1,1
45430,нозека,0,0,1,1
45428,ಪಡೆದುಕೊಂಡೆ,0,0,1,1
45426,admettez,0,0,1,1
45409,വിജ്ഞാനശകലങ്ങൾ,0,0,1,1
45425,próximas,0,0,1,1
324,stupendi,1,1,0,1
45423,drunknar,0,0,1,1
45422,सांस्कृतिक,0,0,1,1
45421,parodia,0,0,1,1
45420,manifestation,0,0,1,1
45418,моём,0,0,1,1
45417,suspender,0,0,1,1
325,progresso,1,1,0,1
45414,liminar,0,0,1,1
45413,परिप्रेक्ष्य,0,0,1,1
45411,ಒಬಾಮಾ,0,0,1,1
45410,بمرور,0,0,1,1
307,inserite,1,1,0,1
45544,любого,0,0,1,1
45546,redigerade,0,0,1,1
306,guardarla,1,1,0,1
45677,simgesi,0,0,1,1
45675,ayrıntıya,0,0,1,1
45673,acima,0,0,1,1
45672,بالأرقام,0,0,1,1
290,raffinato,1,1,0,1
45668,повсеместная,0,0,1,1
45667,характер,0,0,1,1
45666,ഭയമായിരുന്നു,0,0,1,1
45665,uber,0,0,1,1
45664,кино,0,0,1,1
291,promossa,1,1,0,1
45662,चुनौती,0,0,1,1
45660,banimento,0,0,1,1
45659,recognizable,0,0,1,1
45657,enheter,0,0,1,1
45655,anthropique,0,0,1,1
292,reso,1,1,0,1
45652,milyon,0,0,1,1
45650,ಪೂರ್ತಿ,0,0,1,1
45649,പിടിച്ചില്ല,0,0,1,1
45648,பேசினால்,0,0,1,1
45646,புரியவில்லை,0,0,1,1
294,dichiararono,1,1,0,1
45643,وسري,0,0,1,1
45642,santiago,0,0,1,1
45641,utländska,0,0,1,1
45640,ചെയ്തത്,0,0,1,1
45637,ജനാധിപത്യ,0,0,1,1
45636,relatif,0,0,1,1
45678,bazılarının,0,0,1,1
45679,overmatige,0,0,1,1
45680,sahen,0,0,1,1
45703,gerçekleşirse,0,0,1,1
286,fonemi,1,1,0,1
45718,مزيف,0,0,1,1
287,classismo,1,1,0,1
45714,vivia,0,0,1,1
45713,अग्रणी,0,0,1,1
45712,uiquipedia,0,0,1,1
45711,تقتصر,0,0,1,1
45709,പൊതുഅവലംബ,0,0,1,1
45708,tyckte,0,0,1,1
45707,ದೂರು,0,0,1,1
45706,hotter,0,0,1,1
45705,sainte,0,0,1,1
45704,рисунками,0,0,1,1
45702,slot,0,0,1,1
45681,ഇവരേയും,0,0,1,1
45700,performances,0,0,1,1
45699,للإجابة,0,0,1,1
45698,éventuelles,0,0,1,1
288,febbraio,1,1,0,1
45696,edilmez,0,0,1,1
45694,बदले,0,0,1,1
45692,adabı,0,0,1,1
45689,apestosa,0,0,1,1
45688,தொலைபேசியை,0,0,1,1
45687,المجاور,0,0,1,1
45686,πίστευε,0,0,1,1
45685,பாங்கு,0,0,1,1
45682,uncertain,0,0,1,1
45634,تجربتهم,0,0,1,1
45632,minutiae,0,0,1,1
45631,لكل,0,0,1,1
45567,baseren,0,0,1,1
45583,imprime,0,0,1,1
45582,переписывают,0,0,1,1
45580,"
सामोगितियाई",0,0,1,1
45579,организатор,0,0,1,1
45578,принести,0,0,1,1
45577,télévisées,0,0,1,1
45575,بمجموعة,0,0,1,1
45574,tomarse,0,0,1,1
300,spaventoso,1,1,0,1
301,assumerti,1,1,0,1
45570,dorpje,0,0,1,1
45569,réduit,0,0,1,1
45568,المنازعات,0,0,1,1
45566,ашберн,0,0,1,1
45585,disentangles,0,0,1,1
45563,كاسم,0,0,1,1
45562,beteckna,0,0,1,1
302,trascinare,1,1,0,1
45560,exacte,0,0,1,1
45558,பார்க்காதபோது,0,0,1,1
45557,सराहना,0,0,1,1
303,addio,1,1,0,1
304,gustosi,1,1,0,1
45553,നെഗറ്റീവും,0,0,1,1
45552,sidetoside,0,0,1,1
45551,والثاني,0,0,1,1
45549,physics,0,0,1,1
45548,παρακολουθώντας,0,0,1,1
296,commutazione,1,1,0,1
45586,arises,0,0,1,1
45629,forvirrede,0,0,1,1
45609,модель,0,0,1,1
45628,siglo,0,0,1,1
295,ultimo,1,1,0,1
45625,confitures,0,0,1,1
45622,feest,0,0,1,1
45621,evidentes,0,0,1,1
45619,despidieron,0,0,1,1
45618,مجالهم,0,0,1,1
45617,unlike,0,0,1,1
45615,डिस्कशन,0,0,1,1
45614,столетия,0,0,1,1
45612,velocidade,0,0,1,1
45611,inteiro,0,0,1,1
45610,समस्याएं,0,0,1,1
45608,данному,0,0,1,1
45587,velsmagende,0,0,1,1
45607,bilmelisin,0,0,1,1
45606,peaked,0,0,1,1
45605,കൂടതൽ,0,0,1,1
45598,sociologer,0,0,1,1
45597,labsresearch,0,0,1,1
45596,larga,0,0,1,1
45595,angår,0,0,1,1
45594,färdigheter,0,0,1,1
45593,rejetés,0,0,1,1
45592,unintelligent,0,0,1,1
45591,aangezien,0,0,1,1
45589,tente,0,0,1,1
45588,للأكل,0,0,1,1
45361,അന്നുകണ്ട,0,0,1,1
45360,kullanacağım,0,0,1,1
45358,diseñar,0,0,1,1
356,polacchi,1,1,0,1
45141,синонимами,0,0,1,1
45140,vendo,0,0,1,1
45139,wildness,0,0,1,1
45138,fjortonde,0,0,1,1
361,elia,1,1,0,1
45134,sanger​,0,0,1,1
45133,जबरदस्त,0,0,1,1
45132,ഉപേക്ഷിച്ചാൽ,0,0,1,1
45128,şimdiye,0,0,1,1
45127,experiences,0,0,1,1
45125,conventional,0,0,1,1
45123,bordmanerer,0,0,1,1
45122,vaso,0,0,1,1
45121,sources ,0,0,1,1
45120,വിവരങ്ങൾtest,0,0,1,1
45118,കൂട്ടായ,0,0,1,1
45116,പറഞ്ഞുകഴിഞ്ഞാലുടൻ,0,0,1,1
45114,വലിയൊരാത്മവിശ്വാസം,0,0,1,1
45113,clearance,0,0,1,1
45112,frappant,0,0,1,1
45111,تستغرق,0,0,1,1
363,tavola,1,1,0,1
45108,особо,0,0,1,1
45107,മറ്റൊന്നും,0,0,1,1
45106,trädgård,0,0,1,1
45105,cenas,0,0,1,1
45104,لأمها,0,0,1,1
45103,വിക്കിപീഡിയർക്ക്,0,0,1,1
45102,εστιατόριο,0,0,1,1
45142,überhäuft,0,0,1,1
45143,réparations,0,0,1,1
45144,arrête,0,0,1,1
45164,múltiple,0,0,1,1
45182,israeli,0,0,1,1
45181,räknas,0,0,1,1
45180,waters,0,0,1,1
45178,sahne,0,0,1,1
45177,செய்துள்ளேன்,0,0,1,1
45176,சாப்பிடக்கூடிய,0,0,1,1
45175,ألواح,0,0,1,1
357,incontrato,1,1,0,1
45173,de ,0,0,1,1
45172,അന്തരം,0,0,1,1
45168,إجماع,0,0,1,1
45167,—ordenados,0,0,1,1
45165,durak,0,0,1,1
45163,alcançado,0,0,1,1
45145,polido,0,0,1,1
45162,ಇದುವರೆಗೆ,0,0,1,1
45161,ചെയ്യുന്നതെന്തും,0,0,1,1
45160,вниз,0,0,1,1
45159,contraseña,0,0,1,1
45157,franskspråkiga,0,0,1,1
359,bellissima,1,1,0,1
45154,معاكسة,0,0,1,1
45153,relacionadas,0,0,1,1
45152,பையன்,0,0,1,1
45150,cavalgou,0,0,1,1
45149,pierda,0,0,1,1
45147,marrons,0,0,1,1
45146,अचानक,0,0,1,1
45100,correcciones,0,0,1,1
45098,sorulduğunda,0,0,1,1
45097,നൽകിയ,0,0,1,1
45041,شرح,0,0,1,1
45057,vandálicas,0,0,1,1
45053,कक्षा,0,0,1,1
45052,anrufer,0,0,1,1
45051,artikelsidan,0,0,1,1
45050,പതിവിലും,0,0,1,1
45049,நன்றாகப்,0,0,1,1
45048,freezing,0,0,1,1
45047,demasiada,0,0,1,1
45046,الزوار,0,0,1,1
45045,തമിഴ്,0,0,1,1
45044,restent,0,0,1,1
369,interpellati,1,1,0,1
45042,അമിതമായി,0,0,1,1
45039,பெரும்பாலான,0,0,1,1
367,confondere,1,1,0,1
45038,वैश्विक,0,0,1,1
370,modificabile,1,1,0,1
45036,handle,0,0,1,1
45034,kämpfte,0,0,1,1
45033,കൃഷിയെപറ്റിയുള്ള,0,0,1,1
45030,tiny,0,0,1,1
45029,cinquième,0,0,1,1
45028,खिलाफ,0,0,1,1
45026,നീ,0,0,1,1
45025,çocuklar,0,0,1,1
45022,fördelade,0,0,1,1
45021,croises,0,0,1,1
45019,மகிழ்ச்சியடைகிறேன்,0,0,1,1
45058,bottar,0,0,1,1
45061,incomuns,0,0,1,1
45096,parcialmente,0,0,1,1
45079,largar,0,0,1,1
45095,அமெரிக்காவில்,0,0,1,1
45094,أتضور,0,0,1,1
45093,للموارد,0,0,1,1
45092,இலகுவில்,0,0,1,1
45091,vakfı,0,0,1,1
45089,выйдете,0,0,1,1
45086,توش,0,0,1,1
45085,regelmatig,0,0,1,1
45084,passetil,0,0,1,1
45083,கண்டுபிடிப்பு,0,0,1,1
45082,പരീക്ഷ,0,0,1,1
45081,തനിക്ക്,0,0,1,1
45080,блокирование,0,0,1,1
45078,முதன்மைச்,0,0,1,1
45062,تفسيراتهم,0,0,1,1
45077,stunning,0,0,1,1
45076,multilinear,0,0,1,1
45075,फोरम,0,0,1,1
45074,வார்த்தையைத்,0,0,1,1
364,interpretazione,1,1,0,1
45072,arbitrage,0,0,1,1
365,nemmeno,1,1,0,1
45069,стандартном,0,0,1,1
45068,ചോദ്യമാണ്,0,0,1,1
45066,fatally,0,0,1,1
45065,extensions,0,0,1,1
45064,फ्रीडम,0,0,1,1
45063,വീട്ടിലെത്തിയതായും,0,0,1,1
45183,şaka,0,0,1,1
355,malevole,1,1,0,1
45357,قادم,0,0,1,1
45190,«pequeño,0,0,1,1
45316,ಕಾಣಿಸುತ್ತಾಳೆ,0,0,1,1
45315,uitdrukking,0,0,1,1
45312,fåtal,0,0,1,1
45311,discernible,0,0,1,1
45310,e symposium,0,0,1,1
45307,defienden,0,0,1,1
45306,atordoado,0,0,1,1
45305,ಅಲ್ಲಿರುವ,0,0,1,1
45304,ровно,0,0,1,1
45303,மூலமாக,0,0,1,1
45301,elbiseyle,0,0,1,1
45300,பயனர்களை,0,0,1,1
45298,സഹായത്തിനായി,0,0,1,1
45297,hediye,0,0,1,1
45296,മെച്ചപ്പെടുത്തുന്നുണ്ട്,0,0,1,1
45295,اقترح,0,0,1,1
45293,population,0,0,1,1
45292,språkgrupp,0,0,1,1
45291,tornou,0,0,1,1
45289,slide,0,0,1,1
45288,panciera,0,0,1,1
45286,croyait,0,0,1,1
45285,foundation”,0,0,1,1
45283,guidance,0,0,1,1
45282,вечеринке,0,0,1,1
45281,одиноко»,0,0,1,1
45280,കടന്നുപോകാം,0,0,1,1
45279,आलोचना,0,0,1,1
45275,cyberspace,0,0,1,1
45318,интеллектуальной,0,0,1,1
45320,состояние,0,0,1,1
45321,värden,0,0,1,1
45339,utilizadores,0,0,1,1
334,mioglobina,1,1,0,1
45355,avancerad,0,0,1,1
45354,limitaría,0,0,1,1
45352,hawaiiaans,0,0,1,1
45351,intimidating,0,0,1,1
336,diciamo,1,1,0,1
45346,المشكلة,0,0,1,1
45345,многочисленных,0,0,1,1
45344,ответами,0,0,1,1
45343,entretenimiento,0,0,1,1
337,assieme,1,1,0,1
45341,onéreusement,0,0,1,1
45340,одноименной,0,0,1,1
45338,självklart,0,0,1,1
45322,आरम्भ,0,0,1,1
45337,dira,0,0,1,1
45336,ശരിയായി,0,0,1,1
45335,ಪ್ರತಿಬಿಂಬದಲ್ಲಿ,0,0,1,1
338,semplificata,1,1,0,1
45333,atlamamın,0,0,1,1
45332,imminente,0,0,1,1
45331,världskriget,0,0,1,1
45330,censureringar,0,0,1,1
45329,söyledim,0,0,1,1
45327,mãos,0,0,1,1
339,provocativo,1,1,0,1
45324,lighthearted,0,0,1,1
340,coesistettero,1,1,0,1
347,giunto,1,1,0,1
45273,υπερβάλλετε,0,0,1,1
45271,അവയുടെ,0,0,1,1
45213,scotland,0,0,1,1
45232,பட்டியலூடாக,0,0,1,1
45231,irait,0,0,1,1
45230,रिपब्लिक,0,0,1,1
45229,säkerställda,0,0,1,1
45228,enkätsvaren,0,0,1,1
45226,போதிய,0,0,1,1
45224,novelties,0,0,1,1
45222,консультируются»,0,0,1,1
45221,वास्तविक,0,0,1,1
45220,artikelredigering,0,0,1,1
45219,originalomslaget,0,0,1,1
45218,சுவேவ்,0,0,1,1
45214,almaya,0,0,1,1
352,particolarità,1,1,0,1
45234,άφησέ,0,0,1,1
45211,أيًا,0,0,1,1
45209,etkin,0,0,1,1
353,inadatte,1,1,0,1
45207,समाविष्टि,0,0,1,1
45206,fry,0,0,1,1
45205,exacto,0,0,1,1
45204,doradas,0,0,1,1
45203,редакторы,0,0,1,1
45202,используемый,0,0,1,1
45199,recurso,0,0,1,1
354,assegnazione,1,1,0,1
45197,आइए,0,0,1,1
45191,culte,0,0,1,1
45233,baas,0,0,1,1
45235,planerar,0,0,1,1
348,storico,1,1,0,1
45252,sinophones,0,0,1,1
45269,بإمكانك,0,0,1,1
45265,wikipedia»,0,0,1,1
45264,काट,0,0,1,1
45263,trajet,0,0,1,1
45262,meeste,0,0,1,1
45261,τρομακτική,0,0,1,1
45260,orsaker,0,0,1,1
45259,классическим,0,0,1,1
45258,syntaxiques,0,0,1,1
45256,generiek,0,0,1,1
45255,இறங்கினீர்கள்,0,0,1,1
45254,வழக்குரைஞர்கள்,0,0,1,1
45253,städer,0,0,1,1
45251,टाइप,0,0,1,1
45236,آخرين,0,0,1,1
45250,सैन,0,0,1,1
45249,نعود,0,0,1,1
45247,pratique ,0,0,1,1
45246,şehirdeki,0,0,1,1
45245,wikipédiameta,0,0,1,1
45244,humanidad,0,0,1,1
45243,talip,0,0,1,1
45242,événements,0,0,1,1
45241,créées,0,0,1,1
45240,захвачена,0,0,1,1
45239,changing,0,0,1,1
45238,raul,0,0,1,1
349,robuste,1,1,0,1
285,scopi,1,1,0,1
45721,boyle,0,0,1,1
45722,ಮುರಿದುಬಿದ್ದಿದೆ,0,0,1,1
220,accusata,1,1,0,1
46225,frihet,0,0,1,1
46224,jours »,0,0,1,1
46223,programın,0,0,1,1
46222,başarısız,0,0,1,1
46221,macaque,0,0,1,1
46220,അവിശ്വസനീയമാംവിധം,0,0,1,1
46219,ajoutant,0,0,1,1
46217,улыбаясь,0,0,1,1
46215,πέσεις,0,0,1,1
46214,зеркале,0,0,1,1
46213,क्षति,0,0,1,1
224,giusto,1,1,0,1
46211,продолжился,0,0,1,1
225,prossimo,1,1,0,1
46209,தம்முள்,0,0,1,1
226,pagamento,1,1,0,1
227,svolta,1,1,0,1
46206,организацией,0,0,1,1
46201,eventueel,0,0,1,1
46198,yapın,0,0,1,1
46196,kategoriserades,0,0,1,1
46194,ಆಗಲು,0,0,1,1
46193,следствием,0,0,1,1
46191,أخبرت,0,0,1,1
46189,notoriété,0,0,1,1
46188,ಯಾವುದೇ,0,0,1,1
46187,tercih,0,0,1,1
46184,databasserver,0,0,1,1
46183,enkätundersökningen,0,0,1,1
46226,bugle,0,0,1,1
46227,förutsättningarna,0,0,1,1
46228,abonneren,0,0,1,1
46254,estructuras,0,0,1,1
221,eri,1,1,0,1
46268,actuar,0,0,1,1
46267,atribuíram,0,0,1,1
46266,تقنية,0,0,1,1
46265,والتحرير,0,0,1,1
46264,одолжить,0,0,1,1
46262,ποιες,0,0,1,1
46261,разрушительных,0,0,1,1
46260,инцидент,0,0,1,1
46259,δικαιοδοσίας,0,0,1,1
46257,conference,0,0,1,1
46256,adelantarse,0,0,1,1
46255,verdadero,0,0,1,1
46253,ಇತರರಿಗೆ,0,0,1,1
46231,распространению,0,0,1,1
46250,blanding,0,0,1,1
46249,ಪಟ್ಟಣದ,0,0,1,1
46248,indican,0,0,1,1
46247,bewonderende,0,0,1,1
46246,traído,0,0,1,1
46243,varsayalım,0,0,1,1
46242,confundí,0,0,1,1
46239,வினைச்சொல்லாக,0,0,1,1
46238,ಮಾಣಿಕ್ಯ,0,0,1,1
46236,негативной,0,0,1,1
46235,brengt,0,0,1,1
46234,никак,0,0,1,1
46233,inblandning,0,0,1,1
231,considerandolo,1,1,0,1
46180,التبرعات,0,0,1,1
46178,högervinkling,0,0,1,1
46104,mått,0,0,1,1
46130,കോളർ‌,0,0,1,1
46129,vanligen,0,0,1,1
46128,inégalités,0,0,1,1
46126,hazırlanırken,0,0,1,1
46124,eliot,0,0,1,1
46123,lourd,0,0,1,1
46118,νύχτα,0,0,1,1
46117,لوفلاند,0,0,1,1
46116,ressembles,0,0,1,1
46113,ಓಬ್ಟೂಸ್,0,0,1,1
46112,pieds,0,0,1,1
46108,ವಾಸಿಸುತ್ತಿದ್ದಳು,0,0,1,1
46106,yolunu,0,0,1,1
46103,söta,0,0,1,1
46132,дамами,0,0,1,1
46102,ñiquipedia,0,0,1,1
46101,refletem,0,0,1,1
46100,реляционную,0,0,1,1
46097,итальянский,0,0,1,1
46096,iyiler,0,0,1,1
238,fruitori,1,1,0,1
46093,comenta,0,0,1,1
46092,секрет,0,0,1,1
46091,moatti,0,0,1,1
240,idealmente,1,1,0,1
46088,علق,0,0,1,1
46087,subsurface,0,0,1,1
46086,wonders,0,0,1,1
46131,маме,0,0,1,1
46133,planlægger,0,0,1,1
232,possesso,1,1,0,1
46156,tuin,0,0,1,1
233,avviene,1,1,0,1
234,ragazza,1,1,0,1
46173,sexta,0,0,1,1
46171,nynorsk,0,0,1,1
46169,umgangssprachlich,0,0,1,1
46168,الدنا،,0,0,1,1
46167,presentados,0,0,1,1
46165,വൃത്തിയാക്കൽ,0,0,1,1
46162,padronizado,0,0,1,1
46161,धनवानों,0,0,1,1
235,spingono,1,1,0,1
46159,ഇടയില്ലാത്ത,0,0,1,1
236,piccoli,1,1,0,1
46155,கேள்விகளில்,0,0,1,1
237,spicco,1,1,0,1
46153,supervise,0,0,1,1
46151,മന്ദഗതിയിലാണ്,0,0,1,1
46150,привилегированных,0,0,1,1
46147,സ്വതന്ത്രനാണ്,0,0,1,1
46146,جماعيا،,0,0,1,1
46145,thmostvisited,0,0,1,1
46144,søgningen,0,0,1,1
46143,ричарда,0,0,1,1
46142,downloading,0,0,1,1
46141,ಪರಿಸ್ಥಿತಿಯಲ್ಲಿರಬೇಕು,0,0,1,1
46140,prérogatives,0,0,1,1
46138,تخريب,0,0,1,1
46137,binnenkort,0,0,1,1
46271,ಪಾಸ್‌ವರ್ಡ್,0,0,1,1
46273,croyaitil,0,0,1,1
46084,ചേർക്കണം,0,0,1,1
46274,demeç,0,0,1,1
46404,synes,0,0,1,1
46402,feelings,0,0,1,1
46401,έτοιμοι,0,0,1,1
46400,incompréhensions,0,0,1,1
46399,ദേഷ്യപ്പെട്ടതുപോലെയാണെന്ന്,0,0,1,1
46398,പാർട്ടിപ്രവർത്തകൻ,0,0,1,1
46397,ಉತ್ತಮವಾದದ್ದನ್ನು,0,0,1,1
46396,vidsträckt,0,0,1,1
46395,അസ്വസ്ഥനാണ്,0,0,1,1
46392,kaleme,0,0,1,1
46391,مدير,0,0,1,1
46390,τεράστιου,0,0,1,1
46389,bitmiş,0,0,1,1
46387,ocasionales,0,0,1,1
46386,th •,0,0,1,1
46384,désaccord,0,0,1,1
46382,trabajadora,0,0,1,1
46381,அழகு,0,0,1,1
46380,veas,0,0,1,1
46379,undesired,0,0,1,1
46378,हवाई,0,0,1,1
46377,construites,0,0,1,1
46376,başlayacak,0,0,1,1
46375,mentionné,0,0,1,1
46374,befindet,0,0,1,1
46373,användarens,0,0,1,1
46371,ഇതി,0,0,1,1
205,dirla,1,1,0,1
206,cameriera,1,1,0,1
46407,raisonnable,0,0,1,1
46409,decades,0,0,1,1
46412,portugais,0,0,1,1
46430,charles,0,0,1,1
46445,pedagogiskt,0,0,1,1
46443,मांसके,0,0,1,1
46442,വെയർ,0,0,1,1
46440,موثوقة,0,0,1,1
46439,felicitaties,0,0,1,1
46438,jams,0,0,1,1
46437,consegue,0,0,1,1
46436,meningen,0,0,1,1
46435,framgår,0,0,1,1
199,etichettati,1,1,0,1
200,vialetto,1,1,0,1
46432,നൈറ്റിനെയോ,0,0,1,1
46431,testar,0,0,1,1
46429,وswedish،,0,0,1,1
46413,साक्षात्कार,0,0,1,1
46428,الالتزام,0,0,1,1
46427,syllabi,0,0,1,1
46426,salladın,0,0,1,1
46425,presencia,0,0,1,1
201,chiodo,1,1,0,1
46423,porções,0,0,1,1
46422,контакты,0,0,1,1
46420,velocidad,0,0,1,1
46418,തെറ്റായ,0,0,1,1
46417,ഭാഷകളും,0,0,1,1
46416,സമയമാണ്,0,0,1,1
46415,bout,0,0,1,1
46414,ಕೆಳಗಿನ,0,0,1,1
46366,സൂചിപ്പിക്കാൻ,0,0,1,1
46365,kontakter,0,0,1,1
46364,சுதந்திரம்,0,0,1,1
46295,التهجئة،,0,0,1,1
46312,"
inglês",0,0,1,1
46311,vader,0,0,1,1
46310,года — »,0,0,1,1
46309,квартале,0,0,1,1
46308,оболочки,0,0,1,1
46307,أتناوله,0,0,1,1
46306,abandonada,0,0,1,1
46305,सहन,0,0,1,1
46304,подъездной,0,0,1,1
46299,முக்கிய,0,0,1,1
46298,затопленный,0,0,1,1
46297,mythologiques,0,0,1,1
46296,mountainous,0,0,1,1
46294,нормальный,0,0,1,1
46315,killing,0,0,1,1
46293,ഇരിക്കുന്ന,0,0,1,1
46292,görüyorsunuz,0,0,1,1
46291,alleged,0,0,1,1
46290,وعدم,0,0,1,1
46289,productive,0,0,1,1
215,prenderti,1,1,0,1
46287,confundidos,0,0,1,1
46284,அங்கீகரிக்கப்படல்,0,0,1,1
46283,mängd,0,0,1,1
46282,நாசீசஸின்,0,0,1,1
46281,വാക്യങ്ങളും,0,0,1,1
219,lanciati,1,1,0,1
46275,depend,0,0,1,1
46313,الفاكهة,0,0,1,1
46316,källhänvisning,0,0,1,1
46363,لتشمل,0,0,1,1
46347,للمشروع,0,0,1,1
46362,واحصل,0,0,1,1
46361,референдум,0,0,1,1
46360,வலியுறுத்துவதைப்,0,0,1,1
46359,articlecreating,0,0,1,1
46358,ബന്ധപ്പെടുത്തിയ,0,0,1,1
46357,expend,0,0,1,1
46354,yakalayıp,0,0,1,1
46353,сшил,0,0,1,1
46352,деревушке,0,0,1,1
46351,संयोजन,0,0,1,1
46350,ತೋರುತ್ತೇವೆ,0,0,1,1
46349,оценки,0,0,1,1
208,legami,1,1,0,1
46345,حرب,0,0,1,1
46317,പുസ്തകത്തിൽ,0,0,1,1
46344,proporcionarle,0,0,1,1
46343,модификации,0,0,1,1
46342,κυριολεκτικά,0,0,1,1
46340,طبيعة,0,0,1,1
46338,şehit,0,0,1,1
46337,wikiproyectos,0,0,1,1
46336,പന്തിരുകുലം,0,0,1,1
46332,ஸ்பீக்கர்,0,0,1,1
46329,പോകുക,0,0,1,1
46325,julgamento,0,0,1,1
46322,lov,0,0,1,1
46319,ಅಹಂಕಾರಿ,0,0,1,1
46318,ಸೂಚನೆಗಳನ್ನು,0,0,1,1
46085,fået,0,0,1,1
46083,exclusively,0,0,1,1
284,espliciti,1,1,0,1
45902,bataklığın,0,0,1,1
45854,decisive,0,0,1,1
45853,நாசீஸை,0,0,1,1
45852,задача,0,0,1,1
45851,engendré,0,0,1,1
45850,समविष्टि,0,0,1,1
45849,എഴുതുന്നത്‌,0,0,1,1
268,appositi,1,1,0,1
45845,potentiellement,0,0,1,1
45844,trans,0,0,1,1
45843,تنافسية,0,0,1,1
45840,disposer,0,0,1,1
45837,ഒന്നുമല്ല,0,0,1,1
45836,expertgranskning,0,0,1,1
45835,व्हाट्सएप,0,0,1,1
45833,regroupe,0,0,1,1
45832,тон,0,0,1,1
269,svolto,1,1,0,1
45829,propiamente,0,0,1,1
45828,segos,0,0,1,1
270,usiamo,1,1,0,1
45826,അവലംബങ്ങളുംഉരുൾപൊട്ടൽ,0,0,1,1
45825,forskningsstandarder,0,0,1,1
45824,حزن,0,0,1,1
45823,sistêmicos,0,0,1,1
45820,renforcée,0,0,1,1
45819,പരീക്ഷിക്കുക,0,0,1,1
271,importare,1,1,0,1
272,letterarie,1,1,0,1
45815,describió,0,0,1,1
45855,necesito,0,0,1,1
45856,inşa,0,0,1,1
45857,garantia,0,0,1,1
45883,ಇನ್ನಷ್ಟು,0,0,1,1
45900,चुनूंगा,0,0,1,1
45899,effectués,0,0,1,1
45897,الانهيار,0,0,1,1
45896,offensantes,0,0,1,1
45895,parisien,0,0,1,1
45894,frequente,0,0,1,1
45893,tarihindeki,0,0,1,1
45892,എഞ്ചിനിയർ,0,0,1,1
260,etimologicamente,1,1,0,1
45889,ännu,0,0,1,1
45888,samspel,0,0,1,1
45887,desperté,0,0,1,1
261,perso,1,1,0,1
45882,கேட்கிறீர்கள்,0,0,1,1
45859,wikiwikiweb—,0,0,1,1
45881,außergewöhnlich,0,0,1,1
45880,dormait,0,0,1,1
45876,tøver,0,0,1,1
45875,tentar,0,0,1,1
45873,التسويف,0,0,1,1
45872,çevrilmiş,0,0,1,1
45871,വസ്തുതകളിലൂന്നിയുള്ള,0,0,1,1
45868,kommunikation,0,0,1,1
45867,residence,0,0,1,1
45866,какаято,0,0,1,1
45863,pests,0,0,1,1
45862,altında,0,0,1,1
45860,avaliação,0,0,1,1
45812,வேலையைப்,0,0,1,1
45810,மனிதனுக்கு,0,0,1,1
45809,ആശ്വസിപ്പിക്കാൻ,0,0,1,1
45745,pete,0,0,1,1
45762,вернуться,0,0,1,1
45761,слышите,0,0,1,1
45760,செயலதிகாரியான,0,0,1,1
45759,anklagats,0,0,1,1
45758,ശബ്ദമാണ്,0,0,1,1
279,differenze,1,1,0,1
45755,tornarmos,0,0,1,1
45754,aprendizado,0,0,1,1
280,sicuramente,1,1,0,1
45752,техники,0,0,1,1
45751,syriska,0,0,1,1
45750,editörleri,0,0,1,1
45746,решившегося,0,0,1,1
45743,olvides,0,0,1,1
45764,changeux,0,0,1,1
282,povera,1,1,0,1
45741,कॉफी,0,0,1,1
45740,anpassa,0,0,1,1
45739,tribunais,0,0,1,1
45737,remonte,0,0,1,1
45733,ಪ್ರೇರೇಪಿಸುತ್ತದೆ,0,0,1,1
45732,μιλούσατε,0,0,1,1
45731,gewogen,0,0,1,1
45730,നിയോഗിക്കുന്ന,0,0,1,1
45728,entonación,0,0,1,1
45727,இழுக்கவும்,0,0,1,1
45725,‎wikibidija‏,0,0,1,1
45724,ഫോണിൽ,0,0,1,1
45763,kosteloos,0,0,1,1
45765,denote,0,0,1,1
45806,ഓളം,0,0,1,1
45785,маркой,0,0,1,1
45805,beleidigung,0,0,1,1
45801,وبهذا,0,0,1,1
45800,முடிக்கிறேன்,0,0,1,1
45799,« dépourvus,0,0,1,1
45796,spelling,0,0,1,1
45794,samengewerkt,0,0,1,1
45792,هاتفك,0,0,1,1
45791,സ്വാധീനമുള്ള,0,0,1,1
45790,partenariat,0,0,1,1
45789,ökade,0,0,1,1
45788,ಧ್ವನಿಸುವ,0,0,1,1
45787,nécessite,0,0,1,1
45786,sitej,0,0,1,1
45784,ನೀವೇ,0,0,1,1
45767,inception,0,0,1,1
45783,snowpacks,0,0,1,1
45782,функций,0,0,1,1
45781,புளகாங்கிதம்,0,0,1,1
45780,ಅರ್ಥಗಳ,0,0,1,1
45779,вверху,0,0,1,1
274,inondazione,1,1,0,1
45776,يجعل,0,0,1,1
45774,wherefrom,0,0,1,1
45773,castelhana,0,0,1,1
45772,thoughts,0,0,1,1
45771,kapatılmasını,0,0,1,1
45770,подкреплены,0,0,1,1
45769,anglosakson,0,0,1,1
45901,structurantes,0,0,1,1
45903,conseguirá,0,0,1,1
46079,austriaca,0,0,1,1
45904,تعيشها,0,0,1,1
46040,അതിശയകരമായി,0,0,1,1
46039,"
कुर्द",0,0,1,1
46037,insultantes,0,0,1,1
46036,pasaran,0,0,1,1
46035,conduct,0,0,1,1
46034,artig,0,0,1,1
46033,φτωχή,0,0,1,1
46031,durée,0,0,1,1
46030,объекта,0,0,1,1
46029,recognizes,0,0,1,1
46027,познакомиться,0,0,1,1
46025,മീ,0,0,1,1
244,rivederti,1,1,0,1
46023,задумывалась,0,0,1,1
46022,locura,0,0,1,1
46018,يقتصر,0,0,1,1
46017,लेन,0,0,1,1
46016,абстрактного,0,0,1,1
46015,atteinte,0,0,1,1
46013,câncer,0,0,1,1
46012,тех,0,0,1,1
46007,yiyemiyorsan,0,0,1,1
46006,wikipub,0,0,1,1
46005,estaria,0,0,1,1
46002,كم,0,0,1,1
46001,британской,0,0,1,1
46000,jerarquía,0,0,1,1
45996,select,0,0,1,1
45994,ट्रांसक्लुजन,0,0,1,1
46041,шутите,0,0,1,1
46042,üzgünsün,0,0,1,1
46043,ಪಠ್ಯ,0,0,1,1
46062,பிடிக்கவில்லையா,0,0,1,1
241,sostenendo,1,1,0,1
46076,страницам,0,0,1,1
46075,ವಿಷಾದಿಸುತ್ತೇನೆ,0,0,1,1
46074,annuelle,0,0,1,1
46073,അവസ്ഥകളെ,0,0,1,1
46071,отрицательной,0,0,1,1
46069,grundskoleexamen,0,0,1,1
46068,മോശമാണ്,0,0,1,1
46067,nuclei,0,0,1,1
46066,subtropical,0,0,1,1
46065,ويصفون,0,0,1,1
46064,ouvrage,0,0,1,1
46063,læse,0,0,1,1
46061,"
पाश्चात्य",0,0,1,1
46044,அதிர்ச்சியடைந்தாள்,0,0,1,1
46060,मज़ाक,0,0,1,1
46058,interdisciplinar,0,0,1,1
46057,φάει,0,0,1,1
46056,popularidad—,0,0,1,1
46055,ouais,0,0,1,1
46054,labelliser,0,0,1,1
46053,aumenten,0,0,1,1
242,geografici,1,1,0,1
46050,സൃഷ്ടിക്കപ്പെട്ടിരിക്കുന്ന,0,0,1,1
46049,kalmasını,0,0,1,1
46048,handlade,0,0,1,1
243,classico,1,1,0,1
46045,காத்திருப்பு,0,0,1,1
45992,καν,0,0,1,1
45991,குறியீட்டு,0,0,1,1
45989,ആവർത്തിക്കണമെന്ന്,0,0,1,1
45920,иракскую,0,0,1,1
256,colloquiale,1,1,0,1
45936,minut,0,0,1,1
45935,parlamentar,0,0,1,1
45934,onglets,0,0,1,1
45933,серьёзно,0,0,1,1
45931,ഉണ്ടാവും,0,0,1,1
45929,emitidos,0,0,1,1
45928,أدخلت,0,0,1,1
45927,эпизод,0,0,1,1
45926,extraheren,0,0,1,1
45925,svært,0,0,1,1
45924,подтверждения,0,0,1,1
257,faceva,1,1,0,1
45919,ежегодном,0,0,1,1
45942,அண்மைய,0,0,1,1
45918,jenna,0,0,1,1
45917,സ്കോർ,0,0,1,1
45916,какимто,0,0,1,1
45915,continuent,0,0,1,1
45914,essentielles,0,0,1,1
45913,يفي,0,0,1,1
45912,behandlas,0,0,1,1
45911,ചിന്തിക്കാൻ,0,0,1,1
45910,clásica,0,0,1,1
45908,സഞ്ചരിച്ചു,0,0,1,1
45907,lenen,0,0,1,1
45906,والفيتنامية,0,0,1,1
45905,бора,0,0,1,1
45941,«criterios,0,0,1,1
45943,बनाना,0,0,1,1
45988,intenta,0,0,1,1
45967,வரையறை,0,0,1,1
45987,difamación,0,0,1,1
45986,இறுதிகளிலும்,0,0,1,1
45981,indkørslen,0,0,1,1
45980,effectuer,0,0,1,1
45978,गढ़ा,0,0,1,1
45976,взгляды,0,0,1,1
249,decisi,1,1,0,1
45973,sprake,0,0,1,1
45972,stoppa,0,0,1,1
45971,twijfel,0,0,1,1
45970,wikilibros,0,0,1,1
45969,descobertas,0,0,1,1
45968,μιλώντας,0,0,1,1
45966,croire,0,0,1,1
45944,கலைக்களஞ்சியமாகும்,0,0,1,1
45965,verilmez,0,0,1,1
45964,മനസിലാക്കുകയും,0,0,1,1
45963,आते,0,0,1,1
45962,செல்வேன்,0,0,1,1
45961,samtalet,0,0,1,1
45960,неразумным,0,0,1,1
45959,promoted,0,0,1,1
45956,войны,0,0,1,1
45955,ತಲೆಗೆ,0,0,1,1
45952,поддерживающей,0,0,1,1
45951,расстраиваться,0,0,1,1
45949,μοναδικό,0,0,1,1
45945,belpictogram,0,0,1,1
42107,arborescente,0,0,1,1
42103,hastigt,0,0,1,1
36243,जितने,0,0,1,1
38169,fashion,0,0,1,1
38213,ممكنة,0,0,1,1
38212,qualificavam,0,0,1,1
38209,traiter,0,0,1,1
38208,remarquez,0,0,1,1
38207,reddettiğinden,0,0,1,1
38206,desconcierto,0,0,1,1
38204,उदासीन,0,0,1,1
38203,bilgiyi,0,0,1,1
38201,varia,0,0,1,1
38197,expenses,0,0,1,1
38196,düşündüm,0,0,1,1
1357,espressa,1,1,0,1
38191,ayer,0,0,1,1
38190,неопытных,0,0,1,1
38189,violando,0,0,1,1
38188,joueur,0,0,1,1
38187,découvrir,0,0,1,1
38186,choices,0,0,1,1
38185,anlayışlı,0,0,1,1
38184,türlü,0,0,1,1
38182,والضحكات,0,0,1,1
38181,december update,0,0,1,1
38178,definiciones,0,0,1,1
38177,والدتك,0,0,1,1
38175,происходило,0,0,1,1
38174,adolescents,0,0,1,1
38173,राज्य,0,0,1,1
38172,просмотракомм,0,0,1,1
38171,atıp,0,0,1,1
38216,inser,0,0,1,1
38217,μπερδέψα,0,0,1,1
38218,finaliste,0,0,1,1
1346,lavorava,1,1,0,1
38261,للزواج,0,0,1,1
38259,പോകുന്നുവെങ്കിൽ,0,0,1,1
38258,hunden,0,0,1,1
38257,أحضرت,0,0,1,1
38256,wikiversité,0,0,1,1
38254,تعلمنا,0,0,1,1
1342,esistevano,1,1,0,1
38251,trademark,0,0,1,1
38248,النظر،,0,0,1,1
38247,பயணத்தை,0,0,1,1
38243,yaparım,0,0,1,1
38242,വിജ്ഞാന,0,0,1,1
38241,конференциях,0,0,1,1
38239,steam,0,0,1,1
38220,அமைப்புகளையும்,0,0,1,1
38238,углы»,0,0,1,1
38236,تصعيد,0,0,1,1
38235,fühlen,0,0,1,1
38233,akilleshäl,0,0,1,1
1347,sposati,1,1,0,1
38231,desfazem,0,0,1,1
38229,vanskelig,0,0,1,1
1350,prestarmi,1,1,0,1
38226,infantil​​,0,0,1,1
38225,கவலைப்படுகிறாள்,0,0,1,1
38223,الرئيس,0,0,1,1
1352,magazinesenza fonte,1,1,0,1
38221,സംബന്ധിച്ചുണ്ടായ,0,0,1,1
38170,colocar,0,0,1,1
38165,ಮುಕ್ತನಾಗಿದ್ದೇನೆ,0,0,1,1
37692,ഉപയോഗിച്ച,0,0,1,1
38164,üçüncü,0,0,1,1
38114,consacré,0,0,1,1
38112,maneiras,0,0,1,1
38111,حسنا,0,0,1,1
38110,kafanız,0,0,1,1
38109,पुस्क्तकों,0,0,1,1
38108,inmensa,0,0,1,1
38107,bandeaux,0,0,1,1
38106,المتوافقة,0,0,1,1
38105,பங்களிப்பையும்,0,0,1,1
38103,champion,0,0,1,1
38101,alemãode,0,0,1,1
38100,çocuk,0,0,1,1
38099,« neutralité,0,0,1,1
38098,categorization,0,0,1,1
38097,χρήσιμες,0,0,1,1
38095,kæmpede,0,0,1,1
38094,يحتاج,0,0,1,1
38093,വ്യത്യസ്തമാവും,0,0,1,1
38091,sobrenome,0,0,1,1
1368,sesto,1,1,0,1
1369,chiarire,1,1,0,1
38085,உணவிற்கு,0,0,1,1
1370,malefatta,1,1,0,1
38083,soruyorsunuz,0,0,1,1
1372,coniò,1,1,0,1
1375,necessaria,1,1,0,1
1376,brutto,1,1,0,1
38078,begreep,0,0,1,1
38076,fluvial,0,0,1,1
38115,comprobado,0,0,1,1
38116,لزيارة,0,0,1,1
38118,ஆண்கள்,0,0,1,1
38144,nez,0,0,1,1
38163,prémio,0,0,1,1
38160,"दिया।
विकिपीडिया",0,0,1,1
38159,swallow,0,0,1,1
38158,"
marata",0,0,1,1
1360,biforcazione,1,1,0,1
38155,авторитетные,0,0,1,1
38154,pareces,0,0,1,1
38153,algorithmiques,0,0,1,1
38150,filling,0,0,1,1
38148,participante,0,0,1,1
38147,وعندما,0,0,1,1
1361,considerazione,1,1,0,1
38145,interpretations,0,0,1,1
38140,μόλις,0,0,1,1
38120,ಗೊಂದಲಕ್ಕೀಡಾಗಿದ್ದೇನೆ,0,0,1,1
38135,красивых,0,0,1,1
38134,referenciadas,0,0,1,1
38133,« utilisateur »l,0,0,1,1
38132,constituents,0,0,1,1
1362,specializzati,1,1,0,1
38129,διαβάζω,0,0,1,1
38128,misslyckanden,0,0,1,1
38127,desirable,0,0,1,1
38126,kapıdan,0,0,1,1
38125,தங்கமாகவும்,0,0,1,1
1366,esibire,1,1,0,1
38123,hergebruikt,0,0,1,1
38122,articles »,0,0,1,1
38263,отношения,0,0,1,1
1340,professionale,1,1,0,1
38265,മെലിസയും,0,0,1,1
38266,informan,0,0,1,1
38391,scholarly,0,0,1,1
38390,agradáveis,0,0,1,1
38389,آرون,0,0,1,1
38388,basen,0,0,1,1
38387,രാജകുമാരൻ,0,0,1,1
38386,besonders,0,0,1,1
1316,celesti,1,1,0,1
38384,levé,0,0,1,1
38383,plåga,0,0,1,1
1317,comprensione,1,1,0,1
38381,പത്രമാസികകളും,0,0,1,1
38380,tillåtet,0,0,1,1
38379,интерфейсы,0,0,1,1
38376,offering,0,0,1,1
38375,അവർക്ക്,0,0,1,1
38374,bage,0,0,1,1
38373,ಫಿಕ್ಸ್‌ನಲ್ಲಿದ್ದಾಗ,0,0,1,1
38372,oiseaux,0,0,1,1
38371,referenceværk,0,0,1,1
38370,открытость,0,0,1,1
38369,വിക്കിപീഡിയരും,0,0,1,1
38368,ಕ್ಷಮೆಯಾಚಿಸುತ್ತಿದೆ,0,0,1,1
38365,सक्षम,0,0,1,1
38364,confundirse,0,0,1,1
38363,мозгу,0,0,1,1
1318,scelte,1,1,0,1
38360,förolämpning,0,0,1,1
38359,« tentatives,0,0,1,1
38358,разослано,0,0,1,1
38392,ceden,0,0,1,1
38393,طلبت,0,0,1,1
38395,خاصةً,0,0,1,1
38417,الفستان,0,0,1,1
1310,fallimenti,1,1,0,1
38438,élections,0,0,1,1
38437,imaginables,0,0,1,1
38434,lograr,0,0,1,1
38432,«wikiality»,0,0,1,1
38431,respectiva,0,0,1,1
38429,stupéfiant,0,0,1,1
38428,لجعل,0,0,1,1
38426,lilla,0,0,1,1
1311,tematiche,1,1,0,1
38421,förstår,0,0,1,1
38420,violações,0,0,1,1
38418,textbook,0,0,1,1
38415,"
catalão",0,0,1,1
38396,résume,0,0,1,1
38414,“davutoğlu’nun,0,0,1,1
38413,τύχης,0,0,1,1
38412,ഉത്തരം,0,0,1,1
38411,entra,0,0,1,1
1312,inizia,1,1,0,1
1314,benvenuti,1,1,0,1
38408,തിരഞ്ഞെടുക്കാൻ,0,0,1,1
38407,मुस्कुराते,0,0,1,1
38405,opdateringen,0,0,1,1
38404,സൃഷ്ടിക്കാറുണ്ടെങ്കിലും,0,0,1,1
38401,एडिटरइनचीफ,0,0,1,1
38398,seneste,0,0,1,1
38397,hatırlatmak,0,0,1,1
38357,отклику,0,0,1,1
38353,redistribución,0,0,1,1
38352,മനസ്സും,0,0,1,1
1331,abusata,1,1,0,1
38307,minnettarım,0,0,1,1
38306,poderi,0,0,1,1
38304,veinte,0,0,1,1
38301,prediga,0,0,1,1
38300,ആരംഭിക്കുന്നത്,0,0,1,1
1329,clonazione,1,1,0,1
38296,أريكتك,0,0,1,1
38295,alterou,0,0,1,1
38294,tier,0,0,1,1
38293,extérieures,0,0,1,1
38292,perfil,0,0,1,1
38291,aburrido,0,0,1,1
1330,sensori,1,1,0,1
38285,ಒಪ್ಪಲು,0,0,1,1
38309,período,0,0,1,1
38284,அடைந்தது,0,0,1,1
1332,partita,1,1,0,1
38280,اراك,0,0,1,1
38279,documentatie,0,0,1,1
38277,domme,0,0,1,1
38276,मिलते,0,0,1,1
1334,portoghese,1,1,0,1
1337,sbalordita,1,1,0,1
38272,विकिआ,0,0,1,1
38271,कॉलेज,0,0,1,1
1339,legislativo,1,1,0,1
38268,appar,0,0,1,1
38267,ഇതിനെക്കുറിച്ച്,0,0,1,1
38308,στάση,0,0,1,1
38310,நுபீடியாவிலிருந்த,0,0,1,1
38350,fatos,0,0,1,1
38329,подождать,0,0,1,1
38348,مجاني,0,0,1,1
38347,conozco,0,0,1,1
38345,tätt,0,0,1,1
1322,stabiliscono,1,1,0,1
1323,benvenuto,1,1,0,1
38341,jurken,0,0,1,1
1324,pensate,1,1,0,1
38339,undesirable,0,0,1,1
38337,германии,0,0,1,1
1326,peggio,1,1,0,1
38332,يتوقف,0,0,1,1
38331,artikelskrivandet,0,0,1,1
38330,encontramse,0,0,1,1
38327,واجه,0,0,1,1
38311,classent,0,0,1,1
38326,ريفيو,0,0,1,1
38325,framför,0,0,1,1
38324,genres,0,0,1,1
1327,dimenticano,1,1,0,1
38322,hablemos,0,0,1,1
38321,blacklist,0,0,1,1
38320,vandalisering,0,0,1,1
38319,veracidade,0,0,1,1
38318,கட்டுரைகளுக்கு,0,0,1,1
38316,exprimées,0,0,1,1
38315,പ്രപഞ്ചത്തെയും,0,0,1,1
1328,impedire,1,1,0,1
38313,दिमाग,0,0,1,1
38073,أخافت,0,0,1,1
38072,ಸೂಚಿಸುತ್ತದೆ,0,0,1,1
38071,வழக்கப்படியான,0,0,1,1
1412,crescerli,1,1,0,1
37831,pregunto,0,0,1,1
37830,प्रेमी,0,0,1,1
1422,pensanti,1,1,0,1
37826,españa,0,0,1,1
37825,மேலிருந்து,0,0,1,1
1424,«curare,1,1,0,1
37823,antingen,0,0,1,1
37820,implica,0,0,1,1
37819,«η,0,0,1,1
37817,சுவைக்கும்,0,0,1,1
37816,semiautomaticamente,0,0,1,1
37815,തന്നെയാണ്,0,0,1,1
37813,நிலமாகக்,0,0,1,1
37812,εβδομάδα,0,0,1,1
37811,مسح,0,0,1,1
37808,açıkla,0,0,1,1
37807,പ്രശ്നമല്ലെന്ന്,0,0,1,1
37804,zeldzaamheid,0,0,1,1
37803,இருந்ததைப்,0,0,1,1
37802,φράσεων,0,0,1,1
37800,நிறுவனத்தின்,0,0,1,1
37799,yemeğinde,0,0,1,1
37798,ecml,0,0,1,1
37797,ऑस्ट्रिया,0,0,1,1
1426,useresti,1,1,0,1
1427,istituzionale,1,1,0,1
1429,motivi,1,1,0,1
37789,வேகத்தில்,0,0,1,1
37788,decentralized,0,0,1,1
37832,winked,0,0,1,1
37834,доступных,0,0,1,1
37835,جلست,0,0,1,1
37858,crean,0,0,1,1
1413,scritto,1,1,0,1
37873,பார்த்தார்,0,0,1,1
37872,actors,0,0,1,1
37871,посвящённые,0,0,1,1
37868,fréquentesac,0,0,1,1
37867,رأيت,0,0,1,1
37866,behaves,0,0,1,1
37865,αποκτήσετε,0,0,1,1
37863,كمشتبه,0,0,1,1
37862,fournie,0,0,1,1
37861,mödan,0,0,1,1
37860,gelsin,0,0,1,1
37859,«откатить,0,0,1,1
37857,verdú,0,0,1,1
37836,ονειρευόσασταν,0,0,1,1
37856,кассовые,0,0,1,1
37855,مختلفين,0,0,1,1
37853,costolo,0,0,1,1
37851,பெறுவேன்,0,0,1,1
37850,सेलेब्रेट्स,0,0,1,1
1415,strutture,1,1,0,1
1418,danah,1,1,0,1
37845,introduit,0,0,1,1
37843,yakut,0,0,1,1
37842,burn,0,0,1,1
37840,corresponding,0,0,1,1
37838,redigeringssammanfattningar,0,0,1,1
37837,fågel,0,0,1,1
37787,желаем,0,0,1,1
37785,översättning,0,0,1,1
37784,«bibliotecarios»,0,0,1,1
37716,കഴിവനുസരിച്ച്,0,0,1,1
37734,മധ്യമാ‍ർഗത്തിനേ,0,0,1,1
37732,he •,0,0,1,1
37731,écologique »,0,0,1,1
37729,важнее,0,0,1,1
37728,ಮರೆತುಹೋಗುತ್ತಾನೆ,0,0,1,1
37727,kriteriet,0,0,1,1
37726,liberty,0,0,1,1
37723,descrevendo,0,0,1,1
37721,பரிந்துரை,0,0,1,1
37720,обобщённое,0,0,1,1
37719,registradas,0,0,1,1
37718,swami,0,0,1,1
37717,ஒழுங்கமைவுப்,0,0,1,1
1436,caldo,1,1,0,1
37738,القادم؟,0,0,1,1
37714,adamları,0,0,1,1
37713,онлайнголосований,0,0,1,1
37711,ذوي,0,0,1,1
37709,редактироваться,0,0,1,1
37706,hunde,0,0,1,1
1440,fermarti,1,1,0,1
37703,ഐസ്ക്രീമുകളുടെ,0,0,1,1
37701,ലഭിക്കുന്ന,0,0,1,1
37699,vackraste,0,0,1,1
37698,إليها,0,0,1,1
37697,gelmiş,0,0,1,1
37695,определение,0,0,1,1
37694,цифрах,0,0,1,1
37735,ചിഹ്നങ്ങളെയും,0,0,1,1
37741,வரையில்,0,0,1,1
37782,turc,0,0,1,1
37762,statements,0,0,1,1
37781,—«bibliotecarios»—,0,0,1,1
37780,« naître »,0,0,1,1
37779,हिन्दी,0,0,1,1
37778,போன்றவர்,0,0,1,1
37776,reinventions,0,0,1,1
37775,хихикала,0,0,1,1
37774,gems,0,0,1,1
37771,quantify,0,0,1,1
37769,poderosa,0,0,1,1
37768,ಎಸ್‌ಎಂಎಸ್,0,0,1,1
37765,afundar,0,0,1,1
37764,बोट्स,0,0,1,1
37763,எல்லாவற்றிற்கும்,0,0,1,1
37761,possède,0,0,1,1
37742,laboratories,0,0,1,1
37759,الاطلاق,0,0,1,1
37758,ಬಳಸಿದರೆ,0,0,1,1
37757,censurer,0,0,1,1
37756,വിഷമിക്കുന്നുവെന്നും,0,0,1,1
37754,தொடங்கப்,0,0,1,1
37753,acercando,0,0,1,1
37752,виргиния,0,0,1,1
37751,verjaardag,0,0,1,1
37750,"
वे",0,0,1,1
37749,enregistré,0,0,1,1
37747,solicitaron,0,0,1,1
37746,subfield,0,0,1,1
37745,formulerat,0,0,1,1
37875,உச்சரிப்பை,0,0,1,1
1410,indicato,1,1,0,1
38067,evolutionary,0,0,1,1
37880,خطا,0,0,1,1
38018,dagligdags,0,0,1,1
38017,الفشل,0,0,1,1
38016,diagnostics,0,0,1,1
38015,βρωμιά,0,0,1,1
38014,klassische,0,0,1,1
38012,காலை,0,0,1,1
38011,வருக,0,0,1,1
1392,digitalizzati,1,1,0,1
38008,уехала,0,0,1,1
38007,tamir,0,0,1,1
38006,knappen,0,0,1,1
38004,raciales,0,0,1,1
38003,والغالبية,0,0,1,1
38002,وولاية,0,0,1,1
38000,निरन्तर,0,0,1,1
1394,ero,1,1,0,1
37996,οτιδήποτε,0,0,1,1
37995,करमुक्त,0,0,1,1
37993,kontinuerligt,0,0,1,1
37992,ஆரம்பிக்கப்பட்டது,0,0,1,1
37991,listelerine,0,0,1,1
37989,contrastando,0,0,1,1
37988,உனக்கு,0,0,1,1
37987,வெளியே,0,0,1,1
37986,bardakçı’nın,0,0,1,1
37985,creaciones,0,0,1,1
37981,brugernavne,0,0,1,1
37980,walter,0,0,1,1
37978,buluşmayı,0,0,1,1
38019,bouchée,0,0,1,1
38020,القراء،,0,0,1,1
1391,povero,1,1,0,1
38051,edilmiş,0,0,1,1
38065,pacific,0,0,1,1
38064,intentionally,0,0,1,1
38063,போவதே,0,0,1,1
38062,abrió,0,0,1,1
38061,modificando,0,0,1,1
38059,γλύφους,0,0,1,1
38058,carolina,0,0,1,1
38057,बिनालाभार्जन,0,0,1,1
38056,zamandı,0,0,1,1
38055,информатизация,0,0,1,1
38054,запутаетесь,0,0,1,1
38053,ಆವರಿಸಿಕೊಳ್ಳಬಹುದೇ,0,0,1,1
1379,bevanda,1,1,0,1
38050,gerçekleşmez,0,0,1,1
38022,informativos,0,0,1,1
1381,utilizzano,1,1,0,1
1382,facoltà,1,1,0,1
38045,ботами,0,0,1,1
38042,semaines,0,0,1,1
38041,പരീക്ഷിച്ചുനോക്കാൻ,0,0,1,1
38040,تفكير,0,0,1,1
38039,rebuttal,0,0,1,1
38032,platonicien,0,0,1,1
38031,culminate,0,0,1,1
38028,ಸಾರ್ವಕಾಲಿಕ,0,0,1,1
38027,iguales,0,0,1,1
38026,дайтека,0,0,1,1
38024,unhappy,0,0,1,1
37977,fond,0,0,1,1
37975,эмбриональноподобное,0,0,1,1
37974,multilíngue,0,0,1,1
37906,dépassant,0,0,1,1
37927,keyfi,0,0,1,1
37925,رسول,0,0,1,1
37923,достоверной,0,0,1,1
37922,ασημί,0,0,1,1
37918,facultades,0,0,1,1
37917,داعى,0,0,1,1
37916,нетрадиционной,0,0,1,1
37915,polite,0,0,1,1
37914,llore,0,0,1,1
1405,adattivi,1,1,0,1
37910,ಮಾಡಬೇಕು,0,0,1,1
37908,அதேபோல்,0,0,1,1
37907,اتصالاً,0,0,1,1
37905,lades,0,0,1,1
1401,smussato,1,1,0,1
37903,engelsktalande,0,0,1,1
37901,دائم,0,0,1,1
37900,രൂപവും,0,0,1,1
37899,മധുരമുള്ള,0,0,1,1
37893,بحذف,0,0,1,1
1407,nupediacom,1,1,0,1
37890,struggled,0,0,1,1
37889,ويحق,0,0,1,1
37888,plagiar,0,0,1,1
37886,والصينية,0,0,1,1
37885,träume,0,0,1,1
37884,началась,0,0,1,1
37881,ಅವಳನ್ನು,0,0,1,1
1403,farsi,1,1,0,1
37931,لكلمتين,0,0,1,1
37972,sumarse,0,0,1,1
37952,demokratiske,0,0,1,1
37970,норманом,0,0,1,1
37969,gne,0,0,1,1
1398,pazienza,1,1,0,1
37966,تمكنهم,0,0,1,1
37965,عاديًا,0,0,1,1
37963,எங்கே,0,0,1,1
37961,λυπημένη,0,0,1,1
37960,wikipediaartikels,0,0,1,1
37959,canınızı,0,0,1,1
37958,curve,0,0,1,1
37957,ग्रिल्लिनी,0,0,1,1
37956,bevatten,0,0,1,1
37955,பிப்ரவரியில்,0,0,1,1
37951,പൂർണ്ണമായ,0,0,1,1
37934,quarter,0,0,1,1
37949,करेगी।,0,0,1,1
37948,noticeable,0,0,1,1
37946,gegeven,0,0,1,1
37945,المصدر,0,0,1,1
37944,physis,0,0,1,1
37942,alınmaz,0,0,1,1
37941,opère,0,0,1,1
37940,cálmate,0,0,1,1
1399,plausi,1,1,0,1
37938,speglade,0,0,1,1
37937,geliyordu,0,0,1,1
37936,publier,0,0,1,1
37935,ആസ്വദിക്കും,0,0,1,1
38440,initiativet,0,0,1,1
38441,hädelse,0,0,1,1
38442,voltar,0,0,1,1
38968,лучших,0,0,1,1
38922,graça,0,0,1,1
38921,ಸಂತೋಷದಿಂದ,0,0,1,1
1248,sentirai,1,1,0,1
38916,detail,0,0,1,1
38914,karışmış,0,0,1,1
38913,മാലാഖയെപ്പോലെയാണ്,0,0,1,1
38911,"
क्राइमियाई",0,0,1,1
38909,coolen,0,0,1,1
38907,تنسى,0,0,1,1
38906,столовую,0,0,1,1
1250,apporto,1,1,0,1
38903,பிடித்தது,0,0,1,1
38901,ചുറ്റും,0,0,1,1
38900,deshecho,0,0,1,1
1252,efficaci,1,1,0,1
38894,"
मांक्स",0,0,1,1
38893,சொல்லக்கூடிய,0,0,1,1
38892,घटनाएं,0,0,1,1
38891,aplicables,0,0,1,1
38889,उठाने,0,0,1,1
38887,रुचियों,0,0,1,1
38885,återgivningsrätt,0,0,1,1
38881,descrevendoo,0,0,1,1
38879,ಅದಕ್ಕಾಗಿ,0,0,1,1
38878,അത്ഭുതപ്പെട്ടു,0,0,1,1
38877,βιδώσω,0,0,1,1
38875,கண்ணாடியில்,0,0,1,1
38874,gråt,0,0,1,1
38873,ഒരർത്ഥത്തിൽ,0,0,1,1
38923,publiken,0,0,1,1
1247,raggiungimento,1,1,0,1
1246,fastidio,1,1,0,1
38945,ആവുന്നതിനു,0,0,1,1
38965,vagueness,0,0,1,1
38962,arriba,0,0,1,1
38961,umulig,0,0,1,1
38960,സംവിധാനമാണ്‌,0,0,1,1
38959,espagnol,0,0,1,1
38958,modifierd,0,0,1,1
38954,إطار,0,0,1,1
38953,strikser,0,0,1,1
38952,voulais,0,0,1,1
38950,balkondan,0,0,1,1
1243,romagnolo,1,1,0,1
38947,βασικούς,0,0,1,1
38946,generelle,0,0,1,1
38944,എന്നിവയാണ്,0,0,1,1
38927,höfling en,0,0,1,1
38942,idiomáticas,0,0,1,1
38941,σωστό,0,0,1,1
38940,पासवर्ड,0,0,1,1
38939,corrijan,0,0,1,1
38937,പിറക്കുകയായി,0,0,1,1
38936,लंबा,0,0,1,1
38935,seslerin,0,0,1,1
38934,"
फरवरी",0,0,1,1
38932,practicar,0,0,1,1
38931,κρέας,0,0,1,1
38930,factchallenged,0,0,1,1
38929,asociado,0,0,1,1
38928,rapporterats,0,0,1,1
1256,veneto,1,1,0,1
38871,العظمى,0,0,1,1
38870,ಉತ್ತಮವಾಗಿದೆ,0,0,1,1
1267,verità,1,1,0,1
38820,åtgärder,0,0,1,1
38819,ഹിന്ദി,0,0,1,1
1264,avvicinarsi,1,1,0,1
38817,hataları,0,0,1,1
38816,χρειάζεστε,0,0,1,1
38815,ediciones​,0,0,1,1
38814,stelde,0,0,1,1
38812,തിരയലിൽ,0,0,1,1
38810,तलाश,0,0,1,1
38809,எனக்குப்,0,0,1,1
38806,gericht,0,0,1,1
38805,logrado,0,0,1,1
38804,जानना,0,0,1,1
38802,qu’elle,0,0,1,1
38823,levande,0,0,1,1
38801,paródias,0,0,1,1
1268,pregiudizievoli,1,1,0,1
38798,ஊடகமாகவும்,0,0,1,1
38797,persian,0,0,1,1
38794,expertförfattad,0,0,1,1
38793,जोड़ा,0,0,1,1
38792,priority,0,0,1,1
1269,ecco,1,1,0,1
38789,umduğum,0,0,1,1
38788,ಪುನರಾವರ್ತನೆ,0,0,1,1
38787,satisfactorios,0,0,1,1
38785,знала,0,0,1,1
1272,appartenente,1,1,0,1
38822,perdeu,0,0,1,1
38824,heraclitus,0,0,1,1
38869,проектами,0,0,1,1
38852,கொள்கை,0,0,1,1
38868,കാലാന്തരത്തിൽ,0,0,1,1
38867,ಸಹಾಯಕವಾಗಿದೆಯೆ,0,0,1,1
38866,പുറകേ,0,0,1,1
1257,proporzione,1,1,0,1
38864,leaving,0,0,1,1
38863,subnational,0,0,1,1
38862,estranhos,0,0,1,1
38861,honestly,0,0,1,1
38860,classifications,0,0,1,1
38858,succession,0,0,1,1
38857,cabeça,0,0,1,1
38856,महिलाओं,0,0,1,1
38854,relationerna,0,0,1,1
38850,योजनाओं,0,0,1,1
38825,запись,0,0,1,1
1260,semplificare,1,1,0,1
38846,aurais,0,0,1,1
1262,suntimes,1,1,0,1
38844,particuliers,0,0,1,1
38842,وول,0,0,1,1
38840,ಣಾತ್ಮಕವಾಗಿರಬಹುದು,0,0,1,1
38839,davrandığının,0,0,1,1
38838,logoları,0,0,1,1
38837,partidos,0,0,1,1
38836,provável,0,0,1,1
38835,എന്തുകൊണ്ടെന്ന്,0,0,1,1
38832,ചിരിക്കാൻ,0,0,1,1
38831,wikicodeq,0,0,1,1
38967,وبكلمات,0,0,1,1
38971,merendeels,0,0,1,1
38779,défi ,0,0,1,1
38973,التحليلات,0,0,1,1
39102,википроекты,0,0,1,1
39099,dresses,0,0,1,1
39098,düşürürseniz,0,0,1,1
39097,الفترة,0,0,1,1
39096,clique,0,0,1,1
39094,ender,0,0,1,1
39093,besetzt,0,0,1,1
39092,"
पूर्वी",0,0,1,1
39091,استراتيجية,0,0,1,1
39090,editem,0,0,1,1
1226,rileva,1,1,0,1
39088,самый,0,0,1,1
39087,gene,0,0,1,1
39086,ತಿಳುವಳಿಕೆಯಿದ್ದರೆ,0,0,1,1
1227,viveva,1,1,0,1
39082,ρωτήσω,0,0,1,1
39077,chargée,0,0,1,1
39075,السلام,0,0,1,1
39074,greed,0,0,1,1
39073,स्मृति,0,0,1,1
39071,blikken,0,0,1,1
39069,соль,0,0,1,1
39065,وجهي,0,0,1,1
39064,जानता,0,0,1,1
39063,ബന്ധവും,0,0,1,1
39062,உதவுங்கள்,0,0,1,1
39061,raconte,0,0,1,1
39059,planetary,0,0,1,1
39055,फ़िक्स,0,0,1,1
1225,minacce,1,1,0,1
1224,concedere,1,1,0,1
39106,ಸಿಕ್ಕಿದ್ದು,0,0,1,1
39139,telaffuzumu,0,0,1,1
1216,britannico,1,1,0,1
39158,സിനിമകൾക്കായി,0,0,1,1
39156,لاتينية,0,0,1,1
39154,ನನಸಾದರೆ,0,0,1,1
39153,cedido,0,0,1,1
39149,الالتقاط,0,0,1,1
39148,wikikoden,0,0,1,1
39145,αδιάφοροt,0,0,1,1
39144,αποδείξετε,0,0,1,1
39143,написания,0,0,1,1
39142,stadt,0,0,1,1
39141,soudainement,0,0,1,1
39140,ಮಾಡುವಂತೆ,0,0,1,1
39137,टी,0,0,1,1
39111,allgemeine,0,0,1,1
39136,petição,0,0,1,1
39133,डीलीट,0,0,1,1
39131,statistiek,0,0,1,1
30295,patocka,0,0,1,1
39128,سأحضر,0,0,1,1
39127,informeel,0,0,1,1
39125,frit,0,0,1,1
39124,basması,0,0,1,1
39121,jamás,0,0,1,1
39119,mutuas,0,0,1,1
39118,والمحطة,0,0,1,1
39117,pc,0,0,1,1
39115,swarm,0,0,1,1
39052,gedik,0,0,1,1
39049,apport,0,0,1,1
39048,uppgift,0,0,1,1
38992,corée,0,0,1,1
39010,polaires,0,0,1,1
39007,блестящие,0,0,1,1
39006,ಒಮ್ಮೆ,0,0,1,1
39005,человеческой,0,0,1,1
39004,вкуса,0,0,1,1
39003,ರವಾನಿಸಬಹುದೇ,0,0,1,1
39002,δουλέψτε,0,0,1,1
39001,விளையாட்டை,0,0,1,1
39000,llevadas,0,0,1,1
38996,galen,0,0,1,1
38995,incorporava,0,0,1,1
38994,ಆಲಿಸಿ,0,0,1,1
38993,búsquedas,0,0,1,1
38991,ചർച്ചകളും,0,0,1,1
39012,τρεις,0,0,1,1
38990,прослеживает,0,0,1,1
38989,ваша,0,0,1,1
38986,praising,0,0,1,1
38985,மொழிப்பதிப்புகளில்,0,0,1,1
38984,ഉള്ളവരായിരിക്കും,0,0,1,1
38983,phrasen,0,0,1,1
38982,ನೋಡಬೇಡಿ,0,0,1,1
38980,birgitta,0,0,1,1
38979,köpcentret,0,0,1,1
38978,в переводе,0,0,1,1
38977,bilmiyorsunuz,0,0,1,1
38976,दुखी,0,0,1,1
38975,répétition,0,0,1,1
39011,colocan,0,0,1,1
39013,ಭಾವಿಸಿದ್ದಳು,0,0,1,1
39047,источниками,0,0,1,1
39032,åldersgruppen,0,0,1,1
39046,செய்வதன்,0,0,1,1
39045,reaching,0,0,1,1
39044,يجادل,0,0,1,1
39043,centrados,0,0,1,1
39042,dinin,0,0,1,1
39041,"
बिकोल",0,0,1,1
1235,affrontare,1,1,0,1
39039,estricto,0,0,1,1
39038,क्रोकर,0,0,1,1
39037,أَنَّ,0,0,1,1
39036,lessive,0,0,1,1
39035,snow,0,0,1,1
39033,seviyede,0,0,1,1
39030,ongelukkig,0,0,1,1
39014,применена,0,0,1,1
39029,வலை,0,0,1,1
1236,portabilità,1,1,0,1
39027,distinctif,0,0,1,1
1237,riscontrati,1,1,0,1
1238,preferenze,1,1,0,1
39024,classes,0,0,1,1
1239,risponde,1,1,0,1
39021,مقالاته,0,0,1,1
39019,मंत्री,0,0,1,1
1241,occhiolino,1,1,0,1
39017,ஆரம்பிக்கப்படும்,0,0,1,1
39016,marco,0,0,1,1
39015,transition,0,0,1,1
38780,καθόταν,0,0,1,1
38778,discuter,0,0,1,1
38444,ಅತ್ಯಾಚಾರ,0,0,1,1
38613,génération,0,0,1,1
38569,ю,0,0,1,1
38568,critique,0,0,1,1
38566,hart,0,0,1,1
38564,அதிகமான,0,0,1,1
38563,i̇skeletor,0,0,1,1
38562,°′″w﻿,0,0,1,1
38561,fotografia,0,0,1,1
38560,обходительный,0,0,1,1
38559,εκλεπτυσμένη,0,0,1,1
38553,cy •,0,0,1,1
38552,மரியனை,0,0,1,1
1300,reputazione,1,1,0,1
38547,directivos,0,0,1,1
38546,निर्दिष्ट,0,0,1,1
38545,разработанный,0,0,1,1
38544,nebula,0,0,1,1
38543,publicadas,0,0,1,1
38542,convenait,0,0,1,1
38541,consagrados,0,0,1,1
38540,फैसले,0,0,1,1
38539,it’s,0,0,1,1
38536,ಭಾವಿಸಿದ್ದೇನೆ,0,0,1,1
38535,berna,0,0,1,1
38534,robotics,0,0,1,1
38533,முன்னிறுத்தப்பட்டது,0,0,1,1
38532,لتسوية,0,0,1,1
38531,பொருத்தமானதாக,0,0,1,1
38530,hagamos,0,0,1,1
38529,etmekle,0,0,1,1
38570,klassieke,0,0,1,1
38571,أسقطت,0,0,1,1
38572,இழந்துவிட்டேன்,0,0,1,1
38594,sıkışıp,0,0,1,1
38611,demecinde,0,0,1,1
38610,ಪ್ರಾರಂಭಿಸಲಿದ್ದರೆ,0,0,1,1
38608,producerar,0,0,1,1
38606,streefde,0,0,1,1
38605,μείνε,0,0,1,1
38604,exagerar,0,0,1,1
38603,dönmeme,0,0,1,1
38601, —,0,0,1,1
38600,failing,0,0,1,1
1296,scena,1,1,0,1
38597,எழுந்தேன்,0,0,1,1
38596,hayalleriyle,0,0,1,1
38595,विद्वानों,0,0,1,1
38591,happens,0,0,1,1
38576,चर्चा,0,0,1,1
38590,تسألك,0,0,1,1
38589,« article,0,0,1,1
38588,ಹೇಳಿದ್ದಳು,0,0,1,1
38587,komik,0,0,1,1
38586,visuel,0,0,1,1
38585,traditionally,0,0,1,1
38584,levrel,0,0,1,1
38583,profite,0,0,1,1
38582,terrestre,0,0,1,1
38581,lægge,0,0,1,1
38580,entonação,0,0,1,1
38578,viagem,0,0,1,1
38577,открыт,0,0,1,1
38528,τράπεζα,0,0,1,1
38527,கூறினார்,0,0,1,1
38523,вид,0,0,1,1
38459,سكور,0,0,1,1
38475,dankeschöns,0,0,1,1
38474,расслышал,0,0,1,1
38473,கொடுக்கப்,0,0,1,1
38472,தகவல்களின்,0,0,1,1
38470,ними,0,0,1,1
38468,anglófono,0,0,1,1
38467,plagieringar,0,0,1,1
38465,assiette,0,0,1,1
38464,இரண்டிலும்,0,0,1,1
38463,correcteurs,0,0,1,1
38462,ಪರೀಕ್ಷೆಗೆ,0,0,1,1
38461,ಸಂಭಾಷಣೆಯ,0,0,1,1
1306,buone,1,1,0,1
38458,ceb,0,0,1,1
38480,sel,0,0,1,1
1308,valida,1,1,0,1
38456,llamadas,0,0,1,1
38455,знаком,0,0,1,1
38454,smiles,0,0,1,1
38453,wortelwoorden,0,0,1,1
38452,counts,0,0,1,1
38451,contredite,0,0,1,1
38450,εκτυπωθεί,0,0,1,1
38449,φύσης,0,0,1,1
38448,سكان,0,0,1,1
38447,mond,0,0,1,1
38446,español—​,0,0,1,1
1309,restrittiva,1,1,0,1
38478,föremål,0,0,1,1
38481,meritstatus,0,0,1,1
38522,forecasting,0,0,1,1
38504,निगमों,0,0,1,1
38521,mentalement,0,0,1,1
38520,происхождение,0,0,1,1
38518,തിരുത്തി,0,0,1,1
38517,bemerken,0,0,1,1
38515,பரீட்சைக்கு,0,0,1,1
38513,مستويات,0,0,1,1
38511,antigamente,0,0,1,1
38510,ಪುನರಾರಂಭಿಸಲು,0,0,1,1
38509,हैकृपया,0,0,1,1
38508,utilizados,0,0,1,1
38507,stilzwijgend,0,0,1,1
1303,dominavano,1,1,0,1
38505,αποχαιρετήσει,0,0,1,1
38503,الاتفاق,0,0,1,1
38482,jugar,0,0,1,1
38502,httpwwwwikipediade,0,0,1,1
38500,devoir,0,0,1,1
38499,പിടിച്ചില്ലേ,0,0,1,1
38497,приближается,0,0,1,1
38494,näsa,0,0,1,1
38492,είδατε,0,0,1,1
38491,പരിശീലിപ്പിക്കുക,0,0,1,1
38490,എന്താണെന്ന്,0,0,1,1
38489,aprobado,0,0,1,1
38488,телефону,0,0,1,1
38486,forstyrret,0,0,1,1
38484,لنفترض,0,0,1,1
38483,ക്യാരക്റ്റർ,0,0,1,1
38612,പരമാവധി,0,0,1,1
38614,humanlike,0,0,1,1
38777,φωνής,0,0,1,1
38615,അസ്സാമീസ്,0,0,1,1
38734,कॉपीराईट,0,0,1,1
38732,пользовательского,0,0,1,1
38731,divulgado,0,0,1,1
38730,клиффордом,0,0,1,1
38729,leyes,0,0,1,1
1277,sappi,1,1,0,1
38726,കണ്ടതെന്ന്,0,0,1,1
38725,трое,0,0,1,1
38724,السويدية،,0,0,1,1
38723,menina,0,0,1,1
38721,conversatie,0,0,1,1
38720,continuera,0,0,1,1
38719,घोषणा,0,0,1,1
38717,encontrarme,0,0,1,1
38715,persons,0,0,1,1
38712,കുഴഞ്ഞുമറിഞ്ഞു,0,0,1,1
38711,قدمي,0,0,1,1
38709,ಹೆಚ್ಚಿಸುವುದು,0,0,1,1
38708,குறிப்பாக,0,0,1,1
38706,retorting,0,0,1,1
38705,«знание»,0,0,1,1
38704,рок,0,0,1,1
38703,gennembrud,0,0,1,1
38702,slak,0,0,1,1
38701,soldats,0,0,1,1
38700,parenté,0,0,1,1
1281,incontrarmi,1,1,0,1
38698,verkrachtingsincidenten,0,0,1,1
38697,स्पॉट,0,0,1,1
38735,ஏற்கவும்,0,0,1,1
38736,графов,0,0,1,1
38737,structuur,0,0,1,1
38759,نجت,0,0,1,1
38775,ಸಾಮಾನ್ಯಕ್ಕಿಂತ,0,0,1,1
38774,രാത്രിയിൽ,0,0,1,1
38773,απαντήσω,0,0,1,1
38772,βασίζεται,0,0,1,1
38771,δοκίμιό,0,0,1,1
38769,ಹಲವಾರು,0,0,1,1
38768,respecter,0,0,1,1
38766,പൂരകസംവിധാനമായാണ്‌,0,0,1,1
38765,représentativité,0,0,1,1
38764,kullanılabilir,0,0,1,1
38763,avsiktligen,0,0,1,1
38762,tillåtna,0,0,1,1
38761,vont,0,0,1,1
38758,fédérales,0,0,1,1
38740,ലഭിച്ചാൽ,0,0,1,1
38757,externe,0,0,1,1
38755,أليكسا,0,0,1,1
38754,ಸುಲಭವಾಗಿ,0,0,1,1
38752,perigosos,0,0,1,1
38751,coexistiram,0,0,1,1
38750,colaboró,0,0,1,1
38749,വാഹന,0,0,1,1
38747,klikke,0,0,1,1
38746,langdurig,0,0,1,1
1276,scrisse,1,1,0,1
38743,håndtere,0,0,1,1
38742,случайно,0,0,1,1
38741,délicate,0,0,1,1
38696,recettes,0,0,1,1
38695,«тупой»,0,0,1,1
38694,château,0,0,1,1
38634,वेरिएबल्स,0,0,1,1
38652,kenne,0,0,1,1
38650,ശ്രദ്ധിക്കുന്നില്ല,0,0,1,1
38649,préparé,0,0,1,1
38647,επικριθεί,0,0,1,1
1290,obiettivi,1,1,0,1
1292,chiave,1,1,0,1
38642,ومرحبا,0,0,1,1
1293,compone,1,1,0,1
38640,abriter,0,0,1,1
38639,pipa—by,0,0,1,1
38638,sketches,0,0,1,1
38637,फ्लुमोक्स,0,0,1,1
38636,جالسين,0,0,1,1
38631,الكفاية,0,0,1,1
38654,sofa,0,0,1,1
38630,tornando,0,0,1,1
38629,ഭൂമി,0,0,1,1
38628,négatives,0,0,1,1
38626,artigt,0,0,1,1
38624,lyst,0,0,1,1
38623,हतोत्साहित,0,0,1,1
38622,promotie,0,0,1,1
38621,işlerin,0,0,1,1
38620,complicada,0,0,1,1
38619,எடுக்கலாமா,0,0,1,1
38618,കണക്കാക്കപ്പെടുന്നുവിക്കിസോഫ്‌റ്റ്‌വെയർ,0,0,1,1
38617,ikilem,0,0,1,1
38616,dime,0,0,1,1
38653,mångspråkig,0,0,1,1
38655,будьте,0,0,1,1
38693,لمقابلة,0,0,1,1
38676,base ,0,0,1,1
38692,நன்றாகத்,0,0,1,1
38691,ತಿಳಿದಿರಬೇಕು,0,0,1,1
38690,animées,0,0,1,1
38689,svårare,0,0,1,1
38688,lineares,0,0,1,1
1282,rendi,1,1,0,1
38685,onaylanmamış,0,0,1,1
1284,alfabeti,1,1,0,1
38682,assess,0,0,1,1
38681,വിഭാഗങ്ങളായ്,0,0,1,1
38679,förhindra,0,0,1,1
38678,historikern,0,0,1,1
1285,avanzamenti,1,1,0,1
38675,détermine,0,0,1,1
38656,vigtige,0,0,1,1
38673,சொற்றொடரையும்,0,0,1,1
38672,francophone,0,0,1,1
38671,colder,0,0,1,1
38668,சாப்பிடுவது,0,0,1,1
38667,presos,0,0,1,1
38666,лишь,0,0,1,1
38665,केमलकेस,0,0,1,1
38664,നിയോഗിച്ചിരിക്കുന്നു,0,0,1,1
38661,नक़ल,0,0,1,1
38660,несбалансированность,0,0,1,1
38659,внесением,0,0,1,1
38658,मीट,0,0,1,1
38657,quitte,0,0,1,1
37693,rechtes,0,0,1,1
1442,coniato,1,1,0,1
39162,betrof,0,0,1,1
36693,gränsen,0,0,1,1
36738,अंगूठे,0,0,1,1
36736,contraria,0,0,1,1
36733,wikiworld,0,0,1,1
36732,projetada,0,0,1,1
36731,découlent,0,0,1,1
36730,ഏതുസമയത്തും,0,0,1,1
36728,confusa,0,0,1,1
1578,muove,1,1,0,1
36725,billeder,0,0,1,1
1579,venissero,1,1,0,1
36721,നടുവിലാണ്,0,0,1,1
36719,balcon,0,0,1,1
36718,поздравления,0,0,1,1
36717,الجميل,0,0,1,1
36716,judea,0,0,1,1
36715,suspects,0,0,1,1
36714,"
latim",0,0,1,1
1580,incrementato,1,1,0,1
36712,أهلا,0,0,1,1
36710,española,0,0,1,1
36709,vindo,0,0,1,1
36707,"
cazaque",0,0,1,1
36704,ಒಳಗೊಂಡಂತೆ,0,0,1,1
36703,अनगिनत,0,0,1,1
36702,today’s,0,0,1,1
36701,grammar,0,0,1,1
36698,recaudación,0,0,1,1
36697,ತಾಯಿಯಾಗಲು,0,0,1,1
36696,балансирующие,0,0,1,1
36740,ortasındaysanız,0,0,1,1
36741,ദൂതനോടും,0,0,1,1
36742,ശ്രമിക്കുമ്പോൾ,0,0,1,1
36761,निष्क्रिय,0,0,1,1
36782,compenser »,0,0,1,1
36781,ಅವನೊಂದಿಗೆ,0,0,1,1
36779,affiliated,0,0,1,1
36777,बर्खास्त,0,0,1,1
1570,avvale,1,1,0,1
36770,κομμάτι,0,0,1,1
36769,பகுதிகளிலேயே,0,0,1,1
36768,selectie,0,0,1,1
36767,beliefs,0,0,1,1
36766,pearl,0,0,1,1
1572,papert,1,1,0,1
36764,الاحتجاجات,0,0,1,1
1573,itwikipediaorg,1,1,0,1
36760,documentering,0,0,1,1
1575,incentivo,1,1,0,1
36759,السلوك,0,0,1,1
36758,χαρείτε,0,0,1,1
36757,أفكر,0,0,1,1
36756,bok,0,0,1,1
36755,contaba,0,0,1,1
1574,togliere,1,1,0,1
36751,gaaf,0,0,1,1
36750,basit,0,0,1,1
36749,στρατό,0,0,1,1
36748,globales,0,0,1,1
36747,الخمس,0,0,1,1
36746,basque,0,0,1,1
36744,нежелательными,0,0,1,1
36695,énergétique,0,0,1,1
36692,ilustrativa,0,0,1,1
37689,mätningar,0,0,1,1
36691,பரந்த,0,0,1,1
36645,कार्यकारी,0,0,1,1
36644,refinado,0,0,1,1
36642,பதிப்பாக,0,0,1,1
36640,கட்டுரைகளிலும்,0,0,1,1
36639,வேலையைச்,0,0,1,1
36638,gaseous,0,0,1,1
36637,vådområde,0,0,1,1
36635,وإنشاء,0,0,1,1
36634,щелкнувший,0,0,1,1
36633,redden,0,0,1,1
36632,embark,0,0,1,1
36631,किस्मत,0,0,1,1
36630,voie,0,0,1,1
36628,فكلمة,0,0,1,1
36627,خوارزميات,0,0,1,1
36626,वही,0,0,1,1
1585,programmatori,1,1,0,1
36622,βάλτε,0,0,1,1
36620,جنولينكس,0,0,1,1
36618,hemmeligt,0,0,1,1
36617,escolar,0,0,1,1
36616,ಸಂಗತಿಗಳು,0,0,1,1
36615,fylld,0,0,1,1
36613,القائمون,0,0,1,1
1586,intrinsecamente,1,1,0,1
36611,hoeveelheden,0,0,1,1
36610,apresentar,0,0,1,1
36606,seeds,0,0,1,1
36604,распечатал,0,0,1,1
36646,conceptions,0,0,1,1
1584,città,1,1,0,1
36649,செய்தாலன்றி,0,0,1,1
36670,велась,0,0,1,1
36689,köpek,0,0,1,1
36686,ಕೇಳುವುದು,0,0,1,1
36685,çelişkili,0,0,1,1
36682,editó,0,0,1,1
36681,തന്നാൽ,0,0,1,1
36680,aptitudes,0,0,1,1
36679,almadınız,0,0,1,1
36678,وتلحن,0,0,1,1
36677,жестокое,0,0,1,1
36676,commander,0,0,1,1
36675,डेनियल,0,0,1,1
36673,carencia,0,0,1,1
36672,aimais,0,0,1,1
36668,copyrights,0,0,1,1
1583,produzione,1,1,0,1
36667,friedman,0,0,1,1
36666,pressas,0,0,1,1
36665,wordpresscom,0,0,1,1
36664,деятельность,0,0,1,1
36662,aufgehört,0,0,1,1
36661,hepimiz,0,0,1,1
36660,ഉദ്ധരിച്ചാണ്,0,0,1,1
36658,λειτουργίας,0,0,1,1
36657,traduire,0,0,1,1
36655,ഒന്നാം,0,0,1,1
36654,deductief,0,0,1,1
36653,negatieve,0,0,1,1
36652,liabilities,0,0,1,1
36784,grown,0,0,1,1
36785,ಒಪ್ಪುವುದು,0,0,1,1
36786,கட்டிப்பிடிக்க,0,0,1,1
36788,hablantes,0,0,1,1
36925,categorização,0,0,1,1
36923,exempelmeningar,0,0,1,1
36922,toma,0,0,1,1
36921,predicted,0,0,1,1
36918,محفوظات,0,0,1,1
36917,विकिइन्फो,0,0,1,1
36916,trompent,0,0,1,1
36915,sleeping,0,0,1,1
36914,projektredigeringar,0,0,1,1
36913,beğenme,0,0,1,1
36912,compréhension,0,0,1,1
36909,problemas​,0,0,1,1
36908,mundial​,0,0,1,1
36907,getirdim,0,0,1,1
36905,anlatabilirsiniz,0,0,1,1
1553,presentandole,1,1,0,1
36901,योगदानकर्ताज्ञान,0,0,1,1
36900,നല്ലതെന്ന്,0,0,1,1
36897,ഒബാമ,0,0,1,1
36896,عشوائية,0,0,1,1
36895,repris,0,0,1,1
36894,уэйлсом,0,0,1,1
36893,घूमते,0,0,1,1
1554,specialmente,1,1,0,1
36891,डॉइशलैंड,0,0,1,1
36889,forfait,0,0,1,1
36888,अमेरिकन्स,0,0,1,1
36887,batatas,0,0,1,1
36886,bokstavligen,0,0,1,1
36926,músicas,0,0,1,1
36929,المحتمل,0,0,1,1
36930,مفارقة,0,0,1,1
36951,ಲೋಟ,0,0,1,1
36969,написанном,0,0,1,1
36968,udtale,0,0,1,1
36967,للحظة؟,0,0,1,1
36965,hazırlanmış,0,0,1,1
36963,സൗകര്യപ്രദമാണ്,0,0,1,1
36962,ചുറ്റിപ്പറ്റിയുള്ള,0,0,1,1
36960,интонацию,0,0,1,1
36959,personalizadas,0,0,1,1
36957,എടുത്തുമാറ്റുക,0,0,1,1
36956,"
कापमपंगन",0,0,1,1
36954,araştırmada,0,0,1,1
36953,haciéndolo,0,0,1,1
1546,dover,1,1,0,1
36950,brett,0,0,1,1
36933,perigosas,0,0,1,1
36948,ಅಭ್ಯಾಸ,0,0,1,1
36947,verheiratet,0,0,1,1
36946,പ്രകാരം,0,0,1,1
36945,fitting,0,0,1,1
36943,pertenece,0,0,1,1
1548,agiscono,1,1,0,1
1549,incompatibili,1,1,0,1
36939,തിരയുന്നുവെങ്കിൽ,0,0,1,1
36938,принесет,0,0,1,1
36937,выпуск,0,0,1,1
36936,fahre,0,0,1,1
36935,задал,0,0,1,1
36934,hazard,0,0,1,1
36885,سوبود,0,0,1,1
36884,захватывающее,0,0,1,1
36883,«wikipedian,0,0,1,1
36813,arkadaşla,0,0,1,1
36831,കൃത്രിമം,0,0,1,1
36829,étonnée,0,0,1,1
36828,triffst,0,0,1,1
36827,நிறுவனர்கள்,0,0,1,1
36826,baktı,0,0,1,1
36825,textual,0,0,1,1
36822,കുലുങ്ങുന്നു,0,0,1,1
36821,«громадный»,0,0,1,1
36820,hæve,0,0,1,1
36819,обеспечивает,0,0,1,1
36818,рост,0,0,1,1
36817,ಇಷ್ಟಪಡುತ್ತೇನೆ,0,0,1,1
1560,uscite,1,1,0,1
36812,பகுதியை,0,0,1,1
36835,модным,0,0,1,1
36810,tilbud,0,0,1,1
36809,विशेषाधिकार,0,0,1,1
36807,शास्त्रीय,0,0,1,1
36805,टोफेल,0,0,1,1
36804,expresidente,0,0,1,1
1563,esplosione,1,1,0,1
36801,скопирована,0,0,1,1
36800,garry,0,0,1,1
36799,microecosystem,0,0,1,1
36797,benötigen,0,0,1,1
36796,الإدارية,0,0,1,1
36795,отбора,0,0,1,1
36792,çalışıyordu,0,0,1,1
36834,оценкам,0,0,1,1
36836,inlägg,0,0,1,1
36882,edilmiştir,0,0,1,1
36859,لوح,0,0,1,1
36881,criterio,0,0,1,1
36880,görüşme,0,0,1,1
36879,ಪ್ರಶ್ನೆ,0,0,1,1
36877,पूर्ण,0,0,1,1
36874,estabelecida,0,0,1,1
36873,limace,0,0,1,1
36872,förändrade,0,0,1,1
36871,akademisyenler,0,0,1,1
36870,secciones,0,0,1,1
36868,bırakılmış,0,0,1,1
36867,protests,0,0,1,1
36865,pathogenic,0,0,1,1
36860,கருத்துகள்,0,0,1,1
36858,souhaitez,0,0,1,1
36837,soulevée,0,0,1,1
36857,lettres,0,0,1,1
36855,semantics,0,0,1,1
36852,намерения,0,0,1,1
36851,ആഴത്തിൽ,0,0,1,1
1556,soltanto,1,1,0,1
1559,strada,1,1,0,1
36847,பதிப்பிடக்கூடிய,0,0,1,1
36845,fracos,0,0,1,1
36843,संपादकीय,0,0,1,1
36842,поощряет,0,0,1,1
36840,verlaat,0,0,1,1
36839,анонимы,0,0,1,1
36838,редакционном,0,0,1,1
36603,déposé,0,0,1,1
36602,raderingspolicy,0,0,1,1
36600,நினைக்கிறீர்கள்,0,0,1,1
36424,verrez,0,0,1,1
1619,burocrati,1,1,0,1
1620,chiederti,1,1,0,1
36376,defended,0,0,1,1
36375,auktoriteten,0,0,1,1
36374,കാര്യങ്ങളെല്ലാം,0,0,1,1
36373,trykket,0,0,1,1
36371,caras,0,0,1,1
36369,fyr,0,0,1,1
36367,accélérer,0,0,1,1
36365,organisés,0,0,1,1
36363,υποστηρίζεται,0,0,1,1
36362,ಮಾತನಾಡುತ್ತಿದ್ದರು,0,0,1,1
36359,खाने,0,0,1,1
36358,skruvat,0,0,1,1
36357,تسويته,0,0,1,1
36356,retourner,0,0,1,1
36355,stämmer,0,0,1,1
36352,pesadamente,0,0,1,1
36351,verschil,0,0,1,1
1624,inventore,1,1,0,1
36346,diff,0,0,1,1
36345,कम्पनी,0,0,1,1
36344,ಕಾರ್ಯನಿರತರಾಗಿದ್ದಾರೆ,0,0,1,1
36343,порнографическими,0,0,1,1
36341,educacional,0,0,1,1
36338,collaboratifs,0,0,1,1
36336,μέχρι,0,0,1,1
36335,vrolijken,0,0,1,1
36334,"
occitano",0,0,1,1
1618,ritengono,1,1,0,1
36380,afirmações,0,0,1,1
36381,грантом,0,0,1,1
36401,கொண்டார்,0,0,1,1
36422,découvertes »,0,0,1,1
1610,menti,1,1,0,1
36420,beantworten,0,0,1,1
36419,documentário,0,0,1,1
36418,yediğim,0,0,1,1
36417,خادم,0,0,1,1
36416,inaktiv,0,0,1,1
36415,çalışma,0,0,1,1
36412,ಹೊಳಪುಳ್ಳವನಾಗಿದ್ದಾನೆ,0,0,1,1
36411,العشوائي,0,0,1,1
36408,ಆರಂಭದ,0,0,1,1
36403,بالغ,0,0,1,1
36402,الخلافات,0,0,1,1
36399,നാണ്‌,0,0,1,1
36382,enkla,0,0,1,1
36398,varié,0,0,1,1
36397,supermarket,0,0,1,1
1615,distacco,1,1,0,1
36394,والصربية,0,0,1,1
36393,filtrering,0,0,1,1
36392,विकिअलिटी,0,0,1,1
36391,mücevherler,0,0,1,1
36389,wherein,0,0,1,1
36388,tadım,0,0,1,1
36387,credenciales,0,0,1,1
36386,tyvärr,0,0,1,1
36385,spredt,0,0,1,1
36384,मुद्रित,0,0,1,1
36333,concordamos,0,0,1,1
1626,distinto,1,1,0,1
36330,"
उज़्बैक",0,0,1,1
36267,interviennent,0,0,1,1
36286,palast,0,0,1,1
36285,إتمام,0,0,1,1
36284,optin,0,0,1,1
1632,attribuendoli,1,1,0,1
36281,ನಿಷ್ಪ್ರಯೋಜಕವಾಗಿದ್ದರಿಂದ,0,0,1,1
36279,umarmen,0,0,1,1
36277,aportaciones,0,0,1,1
36276,sprang,0,0,1,1
36275,encyclopédiet,0,0,1,1
36272,ночь,0,0,1,1
36270,étions,0,0,1,1
36269,krets,0,0,1,1
36268,ലേഖനങ്ങൾക്ക്‌,0,0,1,1
36266,بالمشاريع,0,0,1,1
36290,huvudet,0,0,1,1
36263,ومحركات,0,0,1,1
36261,isim,0,0,1,1
36260,hersenen,0,0,1,1
1635,compilativa,1,1,0,1
36257,plena,0,0,1,1
1636,ottico,1,1,0,1
36252,കഴിക്കണം,0,0,1,1
36251,гораздо,0,0,1,1
36250,medlingsärenden,0,0,1,1
1638,personaggi,1,1,0,1
36248,носящего,0,0,1,1
36246,anweisungen,0,0,1,1
36245,builtin,0,0,1,1
1631,realistico,1,1,0,1
36291,udvalgt,0,0,1,1
36329,प्रविष्ट,0,0,1,1
36312,leicht,0,0,1,1
36328,бурной,0,0,1,1
1627,iscritti,1,1,0,1
36324,oil,0,0,1,1
36323,säkerhetstjänst,0,0,1,1
36322,toestemming,0,0,1,1
36320,reverta,0,0,1,1
36319,சாதிக்காத,0,0,1,1
36318,സൃഷ്ടിക്കണമെന്ന്,0,0,1,1
1628,consultati,1,1,0,1
36316,φυλακές,0,0,1,1
36315,yesterday,0,0,1,1
36314,മന്ദഗതിയിലാകുന്നു,0,0,1,1
36313,தூண்டுதலால்,0,0,1,1
36311,undersøgelse,0,0,1,1
36293,വിക്കിയിലേക്കും,0,0,1,1
36310,मापदंडों,0,0,1,1
1629,secondi,1,1,0,1
36308,മോശമായ,0,0,1,1
36307,πλάι,0,0,1,1
36306,objectivité,0,0,1,1
36305,ஷெல்லின்,0,0,1,1
1630,fonda,1,1,0,1
36301,அடைந்தார்,0,0,1,1
36300,oluşturma,0,0,1,1
36299,constat,0,0,1,1
36298,العلوم في,0,0,1,1
36297,données ,0,0,1,1
36295,redigerar,0,0,1,1
36423,cohen,0,0,1,1
36425,استشهدت,0,0,1,1
36598,സാഹചര്യമാണ്,0,0,1,1
36427,поживаешь,0,0,1,1
36551,censur,0,0,1,1
1591,effettivamente,1,1,0,1
36549,ഇവ,0,0,1,1
36548,abandoned,0,0,1,1
36546,amerikalıların,0,0,1,1
36545,pommes,0,0,1,1
36541,بمواصلة,0,0,1,1
36540,transcendantalisme,0,0,1,1
36539,randomly,0,0,1,1
36536,near,0,0,1,1
36532,сломался,0,0,1,1
36531,políglota,0,0,1,1
36530,زائر،,0,0,1,1
36529,прямое,0,0,1,1
36527,explicabilité,0,0,1,1
36525,uyarılmaktadır,0,0,1,1
36524,स्कोलरपीडिया,0,0,1,1
1596,fissione,1,1,0,1
36520,بقي,0,0,1,1
36519,geheimnis,0,0,1,1
36518,pedagogos,0,0,1,1
36517,gelinliğimi,0,0,1,1
36516,родном,0,0,1,1
36515,obscenidade,0,0,1,1
36514,മൂർച്ചയുള്ള,0,0,1,1
36513,сети,0,0,1,1
1597,visitatori,1,1,0,1
36511,असफलता,0,0,1,1
36510,sw •,0,0,1,1
36552,endorse,0,0,1,1
36553,aumentarem,0,0,1,1
36554,മൂക്കും,0,0,1,1
36581,переплётом,0,0,1,1
36596,നഗരത്തിലെ,0,0,1,1
36595,yazarı,0,0,1,1
36594,kunskap,0,0,1,1
36593,boring,0,0,1,1
36592,ಬುದ್ಧಿಹೀನ,0,0,1,1
36591,عدة,0,0,1,1
36590,yeterlilik,0,0,1,1
36589,gebeurtenissen,0,0,1,1
36586,сообщений,0,0,1,1
36585,pologne,0,0,1,1
36584,मुहावरा,0,0,1,1
36583,sont ,0,0,1,1
36582,википедисты,0,0,1,1
1587,eliminazione,1,1,0,1
1590,annuale,1,1,0,1
36579,encyklopedin,0,0,1,1
36578,desencorajada,0,0,1,1
36576,anthropologie,0,0,1,1
36572,multilayer,0,0,1,1
36571,чисто,0,0,1,1
36570,da •,0,0,1,1
36569,leta,0,0,1,1
36564,ποιότητα,0,0,1,1
36562,rejettent,0,0,1,1
36560,कंटेंट,0,0,1,1
36559,മികച്ചതാക്കുക,0,0,1,1
36558,cirka,0,0,1,1
36556,merit,0,0,1,1
36509,изменяющими,0,0,1,1
36508,—de,0,0,1,1
36507,глубоко,0,0,1,1
1608,ruolo,1,1,0,1
36466,bijdragers,0,0,1,1
36465,instancia,0,0,1,1
36463,substantial,0,0,1,1
36462,توم,0,0,1,1
36459,qualifier,0,0,1,1
36457,bringe,0,0,1,1
36456,obeying,0,0,1,1
36455,ಚತುರನಾಗಿರುತ್ತೇನೆ,0,0,1,1
36454,agreed,0,0,1,1
36453,konular,0,0,1,1
36452,όνειρά,0,0,1,1
36451,prejuicios,0,0,1,1
36450,separado,0,0,1,1
36448,conotação,0,0,1,1
1604,senses,1,1,0,1
36447,इकलौती,0,0,1,1
36446,लंबे,0,0,1,1
36444,nossos,0,0,1,1
36442,lembramse,0,0,1,1
36440,βάζω,0,0,1,1
36438,വീഡിയോയിലേക്ക്,0,0,1,1
36437,биография,0,0,1,1
1609,riceve,1,1,0,1
36434,contraditórias,0,0,1,1
36433,désuets,0,0,1,1
36432,vazgeçmektedir,0,0,1,1
36431,alacak,0,0,1,1
36430,​​denne,0,0,1,1
36467,compétitif,0,0,1,1
36470,ശാസ്ത്രം,0,0,1,1
36506,эпохи,0,0,1,1
36490,замка,0,0,1,1
1599,«chi,1,1,0,1
36504,ledde,0,0,1,1
36503,вероятностью,0,0,1,1
36501,apontam,0,0,1,1
36499,رابطًا,0,0,1,1
36498,perceptrones,0,0,1,1
36497,sökning,0,0,1,1
36496,нас,0,0,1,1
36495,ದೇವದೂತನಾಗಿದ್ದೇನೆ,0,0,1,1
36494,patiently,0,0,1,1
36493,മകളേ,0,0,1,1
36492,"
कॉर्निश",0,0,1,1
36491,inskränkningar,0,0,1,1
36489,болота,0,0,1,1
36471,अचरज,0,0,1,1
36488,erasmusprijs,0,0,1,1
36487,loadbalancing,0,0,1,1
36486,verse,0,0,1,1
36485,معاداة,0,0,1,1
36483,handwritten,0,0,1,1
1602,annegare,1,1,0,1
36481,تشجيع,0,0,1,1
36480,نتيجة,0,0,1,1
1603,aggressivo,1,1,0,1
36475,главным,0,0,1,1
36474,freier,0,0,1,1
36473,usability,0,0,1,1
36472,கடவுச்சொல்லை,0,0,1,1
36970,normalement,0,0,1,1
36971,партнёрства,0,0,1,1
36972,المعاملات,0,0,1,1
37509,wikimedia…,0,0,1,1
37453,അമേരിക്കയിൽ,0,0,1,1
37452,रेस्तरां,0,0,1,1
37451,eigenaar,0,0,1,1
37447,guldguldbröd,0,0,1,1
37446,κάποιες,0,0,1,1
37445,ستصل,0,0,1,1
37443,prächtigen,0,0,1,1
37442,çuvalladım,0,0,1,1
37441,حزينة,0,0,1,1
37440,duur,0,0,1,1
37439,ஆதாயம்,0,0,1,1
37438,fotográfica,0,0,1,1
1477,sovrappongono,1,1,0,1
37436,expérimentation,0,0,1,1
37433,afogar,0,0,1,1
37432,felsefe,0,0,1,1
37431,ഭൗതികപ്രതിഭാസങ്ങളും,0,0,1,1
37430,c’est,0,0,1,1
1479,viaggi,1,1,0,1
37428,giggles,0,0,1,1
37427,ചിന്തിക്കുക,0,0,1,1
37425,duyun,0,0,1,1
37424,повсюду,0,0,1,1
37423,freut,0,0,1,1
1480,costruire,1,1,0,1
37420,والتعليق,0,0,1,1
37419,platenhoes,0,0,1,1
1483,volessi,1,1,0,1
37417,beschrijvingsvak,0,0,1,1
37454,hegemonia,0,0,1,1
37455,നാർസിസയെക്കുറിച്ചും,0,0,1,1
37458,ciddi,0,0,1,1
37482,agradables,0,0,1,1
37507,tragt,0,0,1,1
1469,considerano,1,1,0,1
37505,miraban,0,0,1,1
37502,bord,0,0,1,1
37501,ಮೈಲಿ,0,0,1,1
37497,brott,0,0,1,1
37493,sociales…,0,0,1,1
37490,toerist,0,0,1,1
37487,ನೋಡುವ,0,0,1,1
37486,ಹಿಡಿದಿಡಬಹುದೇ,0,0,1,1
37485,sammeln,0,0,1,1
37484,नियमित,0,0,1,1
37483,ejaculation,0,0,1,1
37480,protegido,0,0,1,1
37459,waarschijnlijk,0,0,1,1
37479,söyleme,0,0,1,1
1471,incorporati,1,1,0,1
37474,ayudaría,0,0,1,1
37473,വിവേകം,0,0,1,1
37471,energía,0,0,1,1
37470,extinctions,0,0,1,1
1473,continua,1,1,0,1
1474,supplementari,1,1,0,1
37466,सवालों,0,0,1,1
37465,моей,0,0,1,1
37464,toekomst,0,0,1,1
1475,poter,1,1,0,1
37462,போகிறது,0,0,1,1
37416,தன்மையாலும்,0,0,1,1
37415,отдельный,0,0,1,1
37414,creëren,0,0,1,1
1491,circondano,1,1,0,1
37368,ബി,0,0,1,1
37365,أفسدت,0,0,1,1
37362,tillträde,0,0,1,1
37361,wars,0,0,1,1
37359,предпочтение,0,0,1,1
37358,bite,0,0,1,1
37357,поговорить,0,0,1,1
37356,stormigt,0,0,1,1
37355,kultiverad,0,0,1,1
37353,occurrences,0,0,1,1
37352,والأوكرانية،,0,0,1,1
1490,applicare,1,1,0,1
37350,изменяют,0,0,1,1
37348,planering,0,0,1,1
37371,syntactic,0,0,1,1
37347,kalmeer,0,0,1,1
37346,passages,0,0,1,1
37344,erger,0,0,1,1
37343,кодом,0,0,1,1
37341,smsar,0,0,1,1
37340,telefones,0,0,1,1
1492,supervisione,1,1,0,1
1493,immagine,1,1,0,1
1494,equilibrato,1,1,0,1
37336,"
पंजाबी",0,0,1,1
1495,passarmi,1,1,0,1
37334,الغربية,0,0,1,1
37333,методами,0,0,1,1
37370,выборкой,0,0,1,1
37372,വാശി,0,0,1,1
37411,façam,0,0,1,1
37394,— «природа» —,0,0,1,1
37410,analogisme,0,0,1,1
37409,funcionando,0,0,1,1
37408,குறிப்பிட,0,0,1,1
37407,गरीब,0,0,1,1
37406,പതിപ്പാണ്,0,0,1,1
37404,reconheceu,0,0,1,1
1485,tardo,1,1,0,1
1487,vandalizzata,1,1,0,1
37401,pretendentes,0,0,1,1
1488,prestigiose,1,1,0,1
37398,bærende,0,0,1,1
37397,внутреннего,0,0,1,1
37395,konuşmayla,0,0,1,1
37393,dizerme,0,0,1,1
37373,പരീക്ഷയിൽ,0,0,1,1
37390,acumulado,0,0,1,1
37389,trustees,0,0,1,1
37388,computes,0,0,1,1
37386,கொண்டாட,0,0,1,1
37384,refuses,0,0,1,1
37383,прикладных,0,0,1,1
37382,divisé,0,0,1,1
37381,सेवी,0,0,1,1
1489,metodologici,1,1,0,1
37379,красоту,0,0,1,1
37377,ellen,0,0,1,1
37376,κανόνα—αλλά,0,0,1,1
37375,envelops,0,0,1,1
37508,इनका,0,0,1,1
37510,ağlamaya,0,0,1,1
1498,esatti,1,1,0,1
37511,hushålls,0,0,1,1
37642,eins,0,0,1,1
37641,febrero,0,0,1,1
1455,autobus,1,1,0,1
37639,fördjupade,0,0,1,1
1456,estensione,1,1,0,1
37636,bredt,0,0,1,1
1457,annata,1,1,0,1
37634,zevkti,0,0,1,1
37633,​​aos,0,0,1,1
37631,الخامسة,0,0,1,1
1458,strutturali,1,1,0,1
37628,​​enorme,0,0,1,1
37627,öncesi,0,0,1,1
37626,كامل،,0,0,1,1
37625,عاصفة,0,0,1,1
37624,fournissent,0,0,1,1
37623,ആയിരം,0,0,1,1
37622,emprestar,0,0,1,1
37620,gedachtegoed,0,0,1,1
37618,picarde,0,0,1,1
37617,contribue,0,0,1,1
37615,മറാഠി,0,0,1,1
37614,होना।,0,0,1,1
37613,toenemen,0,0,1,1
37612,apparent,0,0,1,1
37611,herinneren,0,0,1,1
37610,مرتبكًا,0,0,1,1
37608,vermelho,0,0,1,1
37606,ಖರೀದಿಸುವುದಿಲ್ಲ,0,0,1,1
1454,pappas,1,1,0,1
37644,verlagsgesellschaft,0,0,1,1
37645,questionado,0,0,1,1
37667,monta,0,0,1,1
37688,gehaald,0,0,1,1
37684,ജീവിതം,0,0,1,1
37683,cantonales,0,0,1,1
37681,atone,0,0,1,1
37680,nyhetsmedia,0,0,1,1
37678,ಹಿಂತಿರುಗಿಸುತ್ತೇನೆ,0,0,1,1
37676,ശ്രദ്ധപുലർത്തുന്നു,0,0,1,1
37674,sølvbrød,0,0,1,1
37672,विचारविमर्श,0,0,1,1
1448,accettato,1,1,0,1
37670,കണ്ണുകളും,0,0,1,1
37669,befordrad,0,0,1,1
37668,வரலாற்றைக்,0,0,1,1
1449,bellissimo,1,1,0,1
37646,injunction,0,0,1,1
1450,documentata,1,1,0,1
37664,ஆணியை,0,0,1,1
37662,godkänt,0,0,1,1
37661,doctrines,0,0,1,1
37660,vänstermarginal,0,0,1,1
37659,beispielsweise,0,0,1,1
37657,ولو,0,0,1,1
37655,fængsler,0,0,1,1
1453,supposta,1,1,0,1
37653,slecht,0,0,1,1
37650,verme,0,0,1,1
37649,فهل,0,0,1,1
37648,identifying,0,0,1,1
37605,بكونها,0,0,1,1
37604,νοιαζόταν,0,0,1,1
37603,إمتاعًا,0,0,1,1
37533,откликов,0,0,1,1
37552,interact,0,0,1,1
37551,arrêtés,0,0,1,1
37550,deixe,0,0,1,1
37549,ಕಿರುನಗೆ,0,0,1,1
37548,recebido,0,0,1,1
37547,récapitulant,0,0,1,1
37546,मेक्रो,0,0,1,1
37544,personligen,0,0,1,1
37543,ativos,0,0,1,1
37539,sûre,0,0,1,1
37538,entendo,0,0,1,1
37537,kritische,0,0,1,1
37536,विरोधाभासी,0,0,1,1
37532,μάθω,0,0,1,1
37555,gruppe,0,0,1,1
37530,entendement,0,0,1,1
1466,istituti,1,1,0,1
1467,definibile,1,1,0,1
37525,tercer,0,0,1,1
37524,støttes,0,0,1,1
37523,humanidade,0,0,1,1
37520,coordonner,0,0,1,1
1468,uniforme,1,1,0,1
37518,выпуска,0,0,1,1
37517,complémentaires,0,0,1,1
37514,idi,0,0,1,1
37513,മുന്നോട്ടു,0,0,1,1
37512,കാലുകൾ,0,0,1,1
37553,permiten,0,0,1,1
37556,ಪದವೆಂದರೆ,0,0,1,1
37602,சம்பிரதாயத்துக்காக,0,0,1,1
37578,deformation,0,0,1,1
37600,verkeerd,0,0,1,1
37599,нейросетях,0,0,1,1
37598,நடுநிலைமை,0,0,1,1
37596,முயற்சியானது,0,0,1,1
37595,esthétiques,0,0,1,1
37593,உரிமை,0,0,1,1
37591,وغمز,0,0,1,1
1461,nasce,1,1,0,1
37587,കാണാത്ത,0,0,1,1
37585,inocência,0,0,1,1
37583,நீங்களே,0,0,1,1
37582,वेंडरबिल्ट,0,0,1,1
37580,acusamna,0,0,1,1
37577,എങ്ങനെയിരിക്കും,0,0,1,1
37559,produtivos,0,0,1,1
37576,fueran,0,0,1,1
37575,harvardsystemet,0,0,1,1
37574,tvivel,0,0,1,1
37573,эффективным,0,0,1,1
37572,франко,0,0,1,1
37570,मैच,0,0,1,1
37569,அடிப்படையில்,0,0,1,1
37568,داعي,0,0,1,1
37564,இருவர்,0,0,1,1
37563,президентские,0,0,1,1
37562,காணமுடியும்,0,0,1,1
37561,تحته,0,0,1,1
37560,بوميس،,0,0,1,1
37332,पाठकों,0,0,1,1
37329,تشديد,0,0,1,1
36974,πρώτο,0,0,1,1
37156,taskspecific,0,0,1,1
37107,frågades,0,0,1,1
37106,عينات,0,0,1,1
1529,coperti,1,1,0,1
37099,السياسة,0,0,1,1
37098,garoto,0,0,1,1
37097,preferência,0,0,1,1
37095,المطبقة,0,0,1,1
37094,нечисловыми,0,0,1,1
37093,tí,0,0,1,1
1530,rivolge,1,1,0,1
37091,hauteur,0,0,1,1
37090,dictadores,0,0,1,1
1534,«…rappresenta,1,1,0,1
37087,ظل,0,0,1,1
1535,acquistano,1,1,0,1
37085,ಭಾಗವನ್ನು,0,0,1,1
37084,κινητό,0,0,1,1
37083,"
crioulo",0,0,1,1
37080,vite,0,0,1,1
37079,ಚಲನಚಿತ್ರಗಳಿಗೆ,0,0,1,1
37078,följt,0,0,1,1
1536,generalizzato,1,1,0,1
37076,सीमाओं,0,0,1,1
37074,disminuido,0,0,1,1
37073,exagérer,0,0,1,1
37072,entré,0,0,1,1
37071,authority,0,0,1,1
1537,citazione,1,1,0,1
37069,يضيف,0,0,1,1
37108,ഡിസംബർ,0,0,1,1
37109,எண்ணை,0,0,1,1
37111,തിരിയുന്നു,0,0,1,1
37139,ക്രിയാപദം,0,0,1,1
37154,ഉപയോഗിക്കാത്തതെന്താണ്,0,0,1,1
37153,fresco»,0,0,1,1
37152,accepte,0,0,1,1
37151,معطل,0,0,1,1
37150,പറയുമ്പോൾ,0,0,1,1
37149,الماكرو،,0,0,1,1
37147,acabará,0,0,1,1
37146,расположена,0,0,1,1
37145,റോമൻ,0,0,1,1
37144,ryssland,0,0,1,1
37143,​​από,0,0,1,1
37142,katılamadım,0,0,1,1
37141,quelles,0,0,1,1
37135,άποψης,0,0,1,1
37112,sujeito,0,0,1,1
37134,ഗ്നൂ,0,0,1,1
37133,hours,0,0,1,1
1524,utilità,1,1,0,1
37130,семена,0,0,1,1
37129,automates,0,0,1,1
37128,स्लाइस,0,0,1,1
37127,"
esloveno",0,0,1,1
37125,"
ज़ाज़ाकी",0,0,1,1
37123,sürü,0,0,1,1
37117,normales,0,0,1,1
37116,διαχείρισης,0,0,1,1
1527,iniziata,1,1,0,1
37113,camino,0,0,1,1
1538,oceano,1,1,0,1
37067,ಕಲಿತಿದ್ದೇವೆ,0,0,1,1
37066,معانيها,0,0,1,1
36998,gruppen,0,0,1,1
37023,восемь,0,0,1,1
37021,gérés,0,0,1,1
37017,genomsnitt,0,0,1,1
37015,minimum,0,0,1,1
37014,ಮಾಡಬೇಕೆಂಬುದನ್ನು,0,0,1,1
37013,riche,0,0,1,1
37012,основной,0,0,1,1
37011,"
सिंहला",0,0,1,1
37009,الجيش,0,0,1,1
37006,tentant,0,0,1,1
37005,σωστός,0,0,1,1
37003,പരിശീലന,0,0,1,1
37002,limiting,0,0,1,1
36991,«periodista,0,0,1,1
37025,wint,0,0,1,1
36990,வழிமுறையாகும்,0,0,1,1
36989,omröstningar,0,0,1,1
1542,spinge,1,1,0,1
36987,എവിടെയായിരുന്നു,0,0,1,1
36986,ധർമ്മസങ്കടമുള്ള,0,0,1,1
36985,jahr,0,0,1,1
36982,l’intervention,0,0,1,1
36980,oc •,0,0,1,1
36979,المنشأة,0,0,1,1
36978,ഫൗണ്ടേഷന്റെ,0,0,1,1
36977,പറ്റുമോ,0,0,1,1
36976,وجمالها,0,0,1,1
36975,klänningen,0,0,1,1
37024,şeklim,0,0,1,1
37026,мороженого,0,0,1,1
37065,ресурсов,0,0,1,1
37047,aardiger,0,0,1,1
37064,மீதான,0,0,1,1
37063,étonné,0,0,1,1
37062,photosynthesis,0,0,1,1
37059,getrouwd,0,0,1,1
37058,humanidades,0,0,1,1
37057,cerveau,0,0,1,1
37056,elinde,0,0,1,1
37054,escolhidos,0,0,1,1
37053,लेटेस्ट,0,0,1,1
37052,dirección,0,0,1,1
37051,riesgo,0,0,1,1
37049,மிகப்,0,0,1,1
37048,selfie,0,0,1,1
1539,avrà,1,1,0,1
37027,ξεκινήσετε,0,0,1,1
37044,miroirs,0,0,1,1
37043,adres,0,0,1,1
37042,أرتدي,0,0,1,1
37041,കുറവല്ല,0,0,1,1
37040,auprès,0,0,1,1
37039,revenues,0,0,1,1
37037,voltam,0,0,1,1
37035,குழந்தை,0,0,1,1
37034,أخبرتهم,0,0,1,1
37033,otroligt,0,0,1,1
37032,infeasible,0,0,1,1
37029,உட்கார்ந்திருப்பதைப்,0,0,1,1
37028,gitme,0,0,1,1
37155,ومراجعة,0,0,1,1
37157,വിശദീകരിക്കുക,0,0,1,1
37328,lb •,0,0,1,1
37159,spiegelbeeld,0,0,1,1
37286,செல்வம்,0,0,1,1
1505,poeta,1,1,0,1
1506,letto,1,1,0,1
37283,സമർപ്പിക്കപ്പെട്ടിരിക്കുന്നു,0,0,1,1
37280,lektier,0,0,1,1
37279,caráter,0,0,1,1
1508,wikipediano,1,1,0,1
37277,kaartsysteem,0,0,1,1
1509,avventore,1,1,0,1
1510,stabilita,1,1,0,1
37273,рендеринг,0,0,1,1
37272,लाद,0,0,1,1
37271,debía,0,0,1,1
37270,régions,0,0,1,1
37269,instante,0,0,1,1
37268,വച്ച്,0,0,1,1
1511,migrata,1,1,0,1
37266,definen,0,0,1,1
37265,kalırsa,0,0,1,1
37264,मच,0,0,1,1
37263,disfavor,0,0,1,1
37262,ನೋಡಿಕೊಳ್ಳಿ,0,0,1,1
37261,считала,0,0,1,1
37260,पकड़ना,0,0,1,1
37258,evolucionan,0,0,1,1
37257,dalaïlamaréf,0,0,1,1
37255,publicarse,0,0,1,1
37254,afirmó,0,0,1,1
37253,menos—,0,0,1,1
37289,بالضحك,0,0,1,1
37291,suciedad,0,0,1,1
37292,πουλί,0,0,1,1
1501,generare,1,1,0,1
1499,svolgere,1,1,0,1
37326,επινοήθηκε,0,0,1,1
37325,हटा,0,0,1,1
37324,intelectuais,0,0,1,1
1500,rappresentano,1,1,0,1
37320,ναρκίσια,0,0,1,1
37319,leger,0,0,1,1
37317,ಪೋರ್ಟಲ್ಗೆ,0,0,1,1
37316,கீழேயுள்ள,0,0,1,1
37315,tchakavien,0,0,1,1
37314,يصبحن,0,0,1,1
37313,طاولة,0,0,1,1
37312,விக்கிபீடியாவின்,0,0,1,1
37309,التذكاري؛,0,0,1,1
37294,विक्शनरी,0,0,1,1
37307,temse,0,0,1,1
37306,creditadas,0,0,1,1
1503,aperte,1,1,0,1
37304,मार्च,0,0,1,1
37303,synvinkel,0,0,1,1
37302,excessivo,0,0,1,1
37301,ಬಿಸಿಯಾಗಿರುತ್ತದೆ,0,0,1,1
37300,normer,0,0,1,1
37299,швеции,0,0,1,1
37298,сверху,0,0,1,1
37297,изменяется,0,0,1,1
37296,jeux,0,0,1,1
37295,échanger,0,0,1,1
37252,mercis,0,0,1,1
37251,fallecimiento,0,0,1,1
37250,பயன்பாட்டிற்காகவும்,0,0,1,1
37181,schweres,0,0,1,1
37197,oppose,0,0,1,1
37196,مليارات,0,0,1,1
37195,modersmål,0,0,1,1
37194,decorum,0,0,1,1
37193,электронном,0,0,1,1
37190,graffiti,0,0,1,1
37189,comentarios,0,0,1,1
37188,checking,0,0,1,1
37187,gebruikersbijdragen,0,0,1,1
37186,طفل,0,0,1,1
37185,பாதுகாப்பு,0,0,1,1
1517,interessanti,1,1,0,1
37182,выглядит,0,0,1,1
37180,disambiguation,0,0,1,1
37199,الى,0,0,1,1
37179,adında,0,0,1,1
37176,convenciones,0,0,1,1
37172,ಪಠ್ಯಕ್ಕೆ,0,0,1,1
37170,« repose,0,0,1,1
37169,"
इन",0,0,1,1
37168,formler,0,0,1,1
37167,والزميل,0,0,1,1
37166,പോകുമെന്ന്,0,0,1,1
37165,slette,0,0,1,1
37164,innovations,0,0,1,1
37163,أفاد,0,0,1,1
1522,comparabili,1,1,0,1
37161,sony,0,0,1,1
37198,ψήσω,0,0,1,1
1516,seduta,1,1,0,1
37249,réflexion,0,0,1,1
37229,koppla,0,0,1,1
37248,எதிர்மறையாக,0,0,1,1
37247,partitions,0,0,1,1
37245,cidadãos,0,0,1,1
37244,വെക്കാനുള്ള,0,0,1,1
37243,ಒನ್,0,0,1,1
37241,göstermektedir,0,0,1,1
37240,nord,0,0,1,1
37239,имеющее,0,0,1,1
37238,resulta,0,0,1,1
37237,ಅಸಮಾಧಾನಗೊಳ್ಳದಂತೆ,0,0,1,1
1513,ambizioso,1,1,0,1
37235,comprobase,0,0,1,1
37231,trouvait,0,0,1,1
37226,വിജ്ഞാനപ്രദമായ,0,0,1,1
1515,ebook,1,1,0,1
37223,уэйлса,0,0,1,1
37222,ಸಭ್ಯವಾಗಿರಲು,0,0,1,1
37219,maskinöversatts,0,0,1,1
37218,remaniée,0,0,1,1
37217,doncellas,0,0,1,1
37216,unimportant,0,0,1,1
37211,faydasızdı,0,0,1,1
37209,aimeriez,0,0,1,1
37208,"सका।
usa",0,0,1,1
37207,inserir,0,0,1,1
1514,implicite,1,1,0,1
37205,επαφή,0,0,1,1
37204,bereikte,0,0,1,1
39161,interativa,0,0,1,1
39163,слез,0,0,1,1
42102,açısından,0,0,1,1
41087,ஃப்ளூமாக்ஸைப்,0,0,1,1
944,euro,1,1,0,1
41126,βασικές,0,0,1,1
41125,जाएगा,0,0,1,1
41124,ja •,0,0,1,1
41123,software​,0,0,1,1
41122,waffling,0,0,1,1
41120,hy •,0,0,1,1
41119,ವಿಧಾನವೆಂದರೆ,0,0,1,1
41118,suajili,0,0,1,1
41117,familiares,0,0,1,1
41115,मिली,0,0,1,1
946,piacevole,1,1,0,1
948,dinamico,1,1,0,1
41112,conformada,0,0,1,1
41108,таков,0,0,1,1
41107,هارفارد،,0,0,1,1
41106,ஆரம்பித்து,0,0,1,1
41105,parfait,0,0,1,1
41104,கொடுத்த,0,0,1,1
949,accetto,1,1,0,1
41102,നിർമ്മാണപഠന,0,0,1,1
41101,യോജിക്കുന്നു,0,0,1,1
41100,ಹೋಗುತ್ತೀರಿ,0,0,1,1
41099,പശ്ചാത്തലത്തിൽ,0,0,1,1
951,denotare,1,1,0,1
41095,sides,0,0,1,1
41092,психолога,0,0,1,1
41091,κρεβάτι,0,0,1,1
953,risultati,1,1,0,1
943,dedicate,1,1,0,1
41131,completos,0,0,1,1
41133,asesino,0,0,1,1
41151,എന്നതിനെക്കുറിച്ചും,0,0,1,1
41167,egoistische,0,0,1,1
41166,முன்,0,0,1,1
41165,"വാൻഡലിസം
വരുന്നത്",0,0,1,1
41164,symbols,0,0,1,1
939,abito,1,1,0,1
41161,göremezsiniz,0,0,1,1
41160,conocen,0,0,1,1
41158,politikalarından,0,0,1,1
41157,frygt,0,0,1,1
41156,αμηχανία,0,0,1,1
41155,"
विशेष",0,0,1,1
41153,«обсуждение»,0,0,1,1
41152,signalent,0,0,1,1
41149,ناه,0,0,1,1
41134,அழகை,0,0,1,1
41148,இயங்குகிறது,0,0,1,1
41147,വിദഗ്ദ്ധനുമായ,0,0,1,1
41146,وعبارة,0,0,1,1
41145,espera,0,0,1,1
41144,परे,0,0,1,1
41143,искусства,0,0,1,1
41142,применения,0,0,1,1
41141,abstengan,0,0,1,1
41140,transactions,0,0,1,1
940,sconosciuta,1,1,0,1
941,assicurano,1,1,0,1
41136,estadístico,0,0,1,1
41135,வாட்ஸ்அப்,0,0,1,1
41088,istediği,0,0,1,1
954,dirigono,1,1,0,1
1020,determinarne,1,1,0,1
41085,αλήθεια,0,0,1,1
41035,выглядел,0,0,1,1
41034,എന്നിവ,0,0,1,1
41031,അരികിലിരുന്നു,0,0,1,1
41027,contenha,0,0,1,1
41026,policydrivet,0,0,1,1
41025,anlamadıysa,0,0,1,1
41024,ஆராய,0,0,1,1
963,svezia,1,1,0,1
41022,især,0,0,1,1
41021,bakalım,0,0,1,1
41020,затраты,0,0,1,1
964,semplificato,1,1,0,1
41018,പരിഗണനയും,0,0,1,1
966,emozioniamo,1,1,0,1
41015,stakes,0,0,1,1
41014,projectwide,0,0,1,1
41013,greenwich,0,0,1,1
41010,तेज,0,0,1,1
41007,сэром,0,0,1,1
41006,кампании,0,0,1,1
41005,hemsidan,0,0,1,1
968,nati,1,1,0,1
41003,engagement,0,0,1,1
41002,club,0,0,1,1
41001,بسلامة,0,0,1,1
41000,σχέση,0,0,1,1
40997,ಬಣ್ಣದ್ದಾಗಿತ್ತು,0,0,1,1
40994,ಮನೆಕೆಲಸವನ್ನು,0,0,1,1
40992,கூறுகிறது,0,0,1,1
41038,vonden,0,0,1,1
961,zolle,1,1,0,1
41044,suchen,0,0,1,1
41063,വിയോജിക്കുന്നു,0,0,1,1
956,sapresti,1,1,0,1
41082,διάφορα,0,0,1,1
41079,эмпирически,0,0,1,1
41077,denominan,0,0,1,1
41076,eksamen,0,0,1,1
41075,«история»,0,0,1,1
41074,editathons,0,0,1,1
41072,konuşulan,0,0,1,1
41071,സാമൂഹ്യവിരുദ്ധർ,0,0,1,1
41067,fingrene,0,0,1,1
41066,précision,0,0,1,1
41065,свободного,0,0,1,1
41064,germanlanguage,0,0,1,1
41062,ಮದುವೆಯಾದ,0,0,1,1
959,applicato,1,1,0,1
41061,βοήθεια,0,0,1,1
41060,amuse,0,0,1,1
41058,vikipedileri,0,0,1,1
41057,interagem,0,0,1,1
41056,അവർ‍,0,0,1,1
41055,ಕಾಫಿಯನ್ನು,0,0,1,1
41054,riktiga,0,0,1,1
41053,besteden,0,0,1,1
41052,aesthetic,0,0,1,1
41051,അതുകൊണ്ട്‌,0,0,1,1
41050,pay,0,0,1,1
41049,katılmak,0,0,1,1
41048,мухаммеда,0,0,1,1
41170,എഡിറ്റുകളെല്ലാം,0,0,1,1
41171,αμφιβολίας,0,0,1,1
41172,വിക്കിപീഡിയൻ,0,0,1,1
41175,internetgemenskap,0,0,1,1
41313,kelimesinden,0,0,1,1
41311,ومعظمها,0,0,1,1
41309,regelmæssigt,0,0,1,1
41308,παρουσίαση,0,0,1,1
41303,envoyezvous,0,0,1,1
41301,κύρια,0,0,1,1
41300,tardive,0,0,1,1
41299,ഇഷ്ടപ്പെടുകയും,0,0,1,1
41298,நாசீசஸ்,0,0,1,1
41297,பால்கனியில்,0,0,1,1
41296,grym,0,0,1,1
41295,சேர்த்து,0,0,1,1
41292,கால்களை,0,0,1,1
920,ripetizione,1,1,0,1
41289,ನಗುತ್ತಾ,0,0,1,1
41288,cheers,0,0,1,1
41287,அதிலிருந்து,0,0,1,1
41286,puzzled,0,0,1,1
41284,görünüyorlardı,0,0,1,1
41283,embarcarse,0,0,1,1
41281,publicerade,0,0,1,1
921,comportato,1,1,0,1
41279,mês,0,0,1,1
41274,പേരും,0,0,1,1
41273,fedorenta,0,0,1,1
41271,σταματήσαμε,0,0,1,1
41270,सोचने,0,0,1,1
41268,verificáveis,0,0,1,1
41267,generosamente,0,0,1,1
41314,محررون,0,0,1,1
41315,கொள்வாள்,0,0,1,1
41316,uzmanlık,0,0,1,1
41339,dinî,0,0,1,1
41357,разработанную,0,0,1,1
912,traduzioni,1,1,0,1
41354,paniek,0,0,1,1
41352,ಮಾಡುವವರಿಗೆ,0,0,1,1
41351,"
फ़ारसी",0,0,1,1
41350,voeren,0,0,1,1
41349,கற்கள்,0,0,1,1
41347,представительств,0,0,1,1
41346,quieren,0,0,1,1
41345,bizimle,0,0,1,1
41344,endangered,0,0,1,1
41342,éloignée,0,0,1,1
41341,beğenerek,0,0,1,1
41336,सिम्बल,0,0,1,1
915,ottimistico,1,1,0,1
41335,കാര്യങ്ങൾക്കെല്ലാം,0,0,1,1
41334,seemed,0,0,1,1
41332,estudiante,0,0,1,1
41331,découverte,0,0,1,1
41330,marionetter,0,0,1,1
41329,aangepast,0,0,1,1
41328,நிர்வாகிகள்,0,0,1,1
41327,домашнее,0,0,1,1
41325,tidligere,0,0,1,1
41324,préparer,0,0,1,1
41323,ettiğin,0,0,1,1
41322,зрелыми,0,0,1,1
914,miliardi,1,1,0,1
41265,متواضعة,0,0,1,1
41264,പദ്ധതി,0,0,1,1
41263,elders,0,0,1,1
41198,интернетакомм,0,0,1,1
41214,yemeklerden,0,0,1,1
41213,وfrench،,0,0,1,1
41212,başlangıçtan,0,0,1,1
41211,predilecta,0,0,1,1
41210,¿tiene,0,0,1,1
41209,قطعة,0,0,1,1
41207,грустная,0,0,1,1
41206,இதற்கு,0,0,1,1
41203,hilfe,0,0,1,1
41202,некоммерческого,0,0,1,1
41201,vannevar,0,0,1,1
41200,ಆದ,0,0,1,1
41199,suffisante,0,0,1,1
41197,ஆகியோரால்,0,0,1,1
41218,collaboratively,0,0,1,1
41195,incapacidade,0,0,1,1
935,minima,1,1,0,1
936,luciano,1,1,0,1
41191,invalidated,0,0,1,1
41189,بامتلاك,0,0,1,1
41188,atribuídos,0,0,1,1
41186,ಮಾಡಲ್ಪಟ್ಟಿದೆ,0,0,1,1
41185,correspondante,0,0,1,1
41184,nutteloos,0,0,1,1
41183,neuesten,0,0,1,1
41182,ഗൂഗിളിലേക്ക്,0,0,1,1
41178,ಖಾತ್ರಿಯಿಲ್ಲ,0,0,1,1
41176,बताएं,0,0,1,1
41215,allezvous,0,0,1,1
41219,предоставляется,0,0,1,1
41262,certainty,0,0,1,1
41240,tilladelse,0,0,1,1
41261,œuvres,0,0,1,1
41260,hadn,0,0,1,1
41259,μητέρας,0,0,1,1
41255,vann,0,0,1,1
41254,aics,0,0,1,1
41253,vulva,0,0,1,1
41251,probations,0,0,1,1
41250,வாக்கியங்களை,0,0,1,1
41248,olmadı,0,0,1,1
927,informativo,1,1,0,1
41244,massive,0,0,1,1
41242,विन्यास,0,0,1,1
41241,управления,0,0,1,1
41238,بعضهما,0,0,1,1
41220,relate,0,0,1,1
41236,സജീവ,0,0,1,1
41235,redistributions,0,0,1,1
932,affari,1,1,0,1
41232,visionen,0,0,1,1
41230,irishtimescom​​,0,0,1,1
41229,regard,0,0,1,1
41228,वैद्यता,0,0,1,1
41227,جعلتها,0,0,1,1
933,controversi,1,1,0,1
934,andati,1,1,0,1
41224,αναφορές,0,0,1,1
41223,vivrait,0,0,1,1
41222,comunicação,0,0,1,1
970,complessivo,1,1,0,1
40989,بعلامة,0,0,1,1
40988,deslocar,0,0,1,1
995,formattazione,1,1,0,1
40755,ಆಕ್ರಮಣಕಾರಿ,0,0,1,1
40751,olign,0,0,1,1
40749,källkod,0,0,1,1
1010,blocchi,1,1,0,1
40747,confundes,0,0,1,1
40746,बने,0,0,1,1
40745,ಪಡೆದರೆ,0,0,1,1
40743,അസാമാന്യമായ,0,0,1,1
40742,conflitos,0,0,1,1
40741,वैज्ञानिक,0,0,1,1
40740,ചെയ്തിട്ടില്ല,0,0,1,1
1011,fermo,1,1,0,1
40736,മാളിൽ,0,0,1,1
40733,dosyalarının,0,0,1,1
40732,लेती,0,0,1,1
40731,мешают,0,0,1,1
40730,rejoignit,0,0,1,1
40728,ನೀರು,0,0,1,1
40727,hilfreich,0,0,1,1
40726,அழைப்பில்,0,0,1,1
40725,العزيز,0,0,1,1
40724,hatalı,0,0,1,1
40723,ദയനീയമാണെന്ന്,0,0,1,1
40721,usualmente,0,0,1,1
40720,തുടക്കംകുറിച്ചത്,0,0,1,1
40719,indepth,0,0,1,1
40718,осознанном,0,0,1,1
40717,parecerem,0,0,1,1
40716,stopte,0,0,1,1
40757,صوت,0,0,1,1
40758,reducir,0,0,1,1
40759,فلست,0,0,1,1
40782,ಚೀರ್ಸ್,0,0,1,1
40800,харуко,0,0,1,1
40799,ಇನ್ನು,0,0,1,1
40798,argumentou,0,0,1,1
40797,യുദ്ധത്തിൽ,0,0,1,1
40796,fitted,0,0,1,1
40795,ജീവൻ,0,0,1,1
40794,plet,0,0,1,1
997,diventeranno,1,1,0,1
40791,"
उड़िया",0,0,1,1
40790,отображена,0,0,1,1
40789,ಕೇಳುತ್ತಿರಲಿಲ್ಲ,0,0,1,1
40786,martin,0,0,1,1
40785,sonst,0,0,1,1
40781,klædt,0,0,1,1
40761,hire,0,0,1,1
1000,provò,1,1,0,1
1001,colpito,1,1,0,1
40777,уставшим,0,0,1,1
40776,चूक,0,0,1,1
1006,fossero,1,1,0,1
1007,desiderati,1,1,0,1
40770,réutiliser,0,0,1,1
40768,traversa,0,0,1,1
40767,sphère,0,0,1,1
40766,önünde,0,0,1,1
40765,dolan,0,0,1,1
40763,ambiguïté,0,0,1,1
40762,"
पोलिश",0,0,1,1
40715,ಪುನರಾವರ್ತಿಸಬೇಕೆಂದು,0,0,1,1
40714,ಸೋಲಿಸುತ್ತಾನೆ,0,0,1,1
40713,حصل,0,0,1,1
40645,gebrauchen,0,0,1,1
40663,sitez,0,0,1,1
40662,κύριας,0,0,1,1
40661,informationen,0,0,1,1
1016,distribuiti,1,1,0,1
40659,battre,0,0,1,1
40658,openai,0,0,1,1
40657,abrange,0,0,1,1
40652,øverst,0,0,1,1
40651,попросите,0,0,1,1
40650,ലോകമെമ്പാടും,0,0,1,1
40649,настройка,0,0,1,1
40648,تنسيق,0,0,1,1
40647,уровню,0,0,1,1
40644,planètes,0,0,1,1
40667,regularization,0,0,1,1
40642,الأفلام,0,0,1,1
40639,cartésienne,0,0,1,1
40637,imagen—,0,0,1,1
40636,"w
अज़रबैजानी",0,0,1,1
40635,ينبغي,0,0,1,1
40634,permitida,0,0,1,1
40632,yapabilirler,0,0,1,1
40631,choice,0,0,1,1
40628,والمناقشات,0,0,1,1
40627,influir,0,0,1,1
40626,ووصلت,0,0,1,1
40623,blijft,0,0,1,1
40622,protegida,0,0,1,1
40664,والتنظيمات,0,0,1,1
40668,вебсайтов,0,0,1,1
40711,mandar,0,0,1,1
40692,நல்லவை,0,0,1,1
40708,دائما,0,0,1,1
40707,naber,0,0,1,1
40706,bankaya,0,0,1,1
40705,geotechnical,0,0,1,1
40704,δάγκωμα,0,0,1,1
40702,практики,0,0,1,1
40700,finir,0,0,1,1
40699,وذهبا,0,0,1,1
40698,"
रूसिन",0,0,1,1
40696,दाईं,0,0,1,1
40695,cogitans »,0,0,1,1
40694,എന്നും,0,0,1,1
40693,പോകുന്നതാണ്,0,0,1,1
40690,latinska,0,0,1,1
1015,sale,1,1,0,1
40689,பார்ப்பது,0,0,1,1
40688,identifiable,0,0,1,1
1012,cartaceo,1,1,0,1
40685,stoppen,0,0,1,1
40684,prévaloir,0,0,1,1
40683,frustration,0,0,1,1
40677,immédiates,0,0,1,1
1014,suggerimenti,1,1,0,1
40675,للباحثين,0,0,1,1
40674,συμπλήρωμα,0,0,1,1
40673,продолжите,0,0,1,1
40672,τηρούν,0,0,1,1
40671,ಹಾಯಿಸಿದರು,0,0,1,1
40802,officiellt,0,0,1,1
40806,instrucciones,0,0,1,1
40987,noiva,0,0,1,1
40807,يُسمح,0,0,1,1
40937,schat,0,0,1,1
40935,innegociable,0,0,1,1
974,quotidiano,1,1,0,1
40933,yapılmıştır,0,0,1,1
40932,edilir,0,0,1,1
40931,superó,0,0,1,1
40930,ತಂದಿದ್ದೇನೆ,0,0,1,1
40928,теорий,0,0,1,1
975,molecolare,1,1,0,1
40926,ಸಂತೋಷವಾಗಿರಲು,0,0,1,1
40924,ज़र्मन,0,0,1,1
40923,de •,0,0,1,1
40922,ഏവർക്കുമറിവുള്ളതാണല്ലോ,0,0,1,1
40921,accessas,0,0,1,1
40919,någonsin,0,0,1,1
40918,sugestões,0,0,1,1
40917,vastu,0,0,1,1
976,aggiunti,1,1,0,1
977,superficiali»,1,1,0,1
40907,jump,0,0,1,1
40905,ಪ್ರಶಂಸಿಸುತ್ತೇನೆ,0,0,1,1
40903,afastase,0,0,1,1
979,suonare,1,1,0,1
980,cavaliere,1,1,0,1
40900,കർത്തവ്യമാണ്,0,0,1,1
40899,yolculuğunuza,0,0,1,1
40898,"
ऑकिटन",0,0,1,1
40897,"
लातवियाई",0,0,1,1
40896,l’écriture,0,0,1,1
40938,γειά,0,0,1,1
40939,необходимости,0,0,1,1
40940,قدمًا,0,0,1,1
40966,провели,0,0,1,1
40986,faithful,0,0,1,1
40985,المستقبلية,0,0,1,1
40984,wikipedia»​​​​,0,0,1,1
40983,المساعد,0,0,1,1
40982,inträffade,0,0,1,1
40980,desconcertantemente,0,0,1,1
40979,delegados,0,0,1,1
40976,century,0,0,1,1
40975,ydi,0,0,1,1
40973,savunulmaktadır,0,0,1,1
972,particelle,1,1,0,1
40969,veré,0,0,1,1
40968,اسمح,0,0,1,1
40965,ltd,0,0,1,1
40941,അക്ഷരാർത്ഥത്തിൽ,0,0,1,1
40962,ശരിയാണെന്ന്,0,0,1,1
40961,प्रति,0,0,1,1
40960,aanleidinggevende,0,0,1,1
973,complesso,1,1,0,1
40956,лицензии,0,0,1,1
40955,religies,0,0,1,1
40952,انتحالًا,0,0,1,1
40951,divulgou,0,0,1,1
40949,grootte,0,0,1,1
40948,vinklingarna,0,0,1,1
40947,анонсировала,0,0,1,1
40945,सीखा,0,0,1,1
40944,البطاطس,0,0,1,1
40894,ಭೇಟಿ,0,0,1,1
40893,يشبه,0,0,1,1
981,col,1,1,0,1
40824,​​det,0,0,1,1
40843,ಪಾರ್ಟಿಯಲ್ಲಿರುವಾಗ,0,0,1,1
40841,sostuvo,0,0,1,1
40840,सम्नाक्ष,0,0,1,1
993,impraticabile,1,1,0,1
40836,vand,0,0,1,1
40835,இருந்திருக்கிறேன்,0,0,1,1
40834,السماء,0,0,1,1
40833,желающим,0,0,1,1
40831,интернетсайт,0,0,1,1
40829,पंजाबी,0,0,1,1
40828,apresentarei,0,0,1,1
40827,lenteur,0,0,1,1
40826,« décrire,0,0,1,1
40823,insana,0,0,1,1
40845,താല്പര്യമില്ല,0,0,1,1
40822,großen,0,0,1,1
40821,harbor,0,0,1,1
40820,начале,0,0,1,1
40817,çapında,0,0,1,1
40816,வைத்திருப்பது,0,0,1,1
40815,ಹಾದುಹೋಗಬಹುದು,0,0,1,1
40814,ಯೋಜನೆ,0,0,1,1
40813,défunte,0,0,1,1
40812,spams,0,0,1,1
40811,ரொட்டியுடன்,0,0,1,1
40810,éclosion,0,0,1,1
40809,എടുക്കുന്നതുപോലെ,0,0,1,1
40808,liberado,0,0,1,1
40844,selfguided,0,0,1,1
40846,كاثرين,0,0,1,1
40888,viajó,0,0,1,1
40869,efficiency,0,0,1,1
988,anglicizzanti,1,1,0,1
40885,وتقنيات,0,0,1,1
40884,продал,0,0,1,1
989,internazionale,1,1,0,1
40882,والنقاشات,0,0,1,1
40879,χάσει,0,0,1,1
40878,ತೀಕ್ಷ್ಣವಾಗಿ,0,0,1,1
40877,الوصف,0,0,1,1
40876,fremstilles,0,0,1,1
40875,ಶ್ರೀಮಂತರು,0,0,1,1
40873,arkivera,0,0,1,1
40871,paciente,0,0,1,1
40870,«βικιπαίδεια»,0,0,1,1
40868,combining,0,0,1,1
40849,doneerde,0,0,1,1
40865,weakly,0,0,1,1
40863,ദിവസേന,0,0,1,1
40862,читатель,0,0,1,1
40861,придется,0,0,1,1
40860,وأنواعًا,0,0,1,1
40859,leert,0,0,1,1
40858,மனைவியாக,0,0,1,1
990,sufficienti,1,1,0,1
40856,आशंका,0,0,1,1
40853,situer,0,0,1,1
40852,kolaylıkla,0,0,1,1
991,pomeriggio,1,1,0,1
40850,visioenen,0,0,1,1
41359,fidedignas,0,0,1,1
41360,χαιρετισμοί,0,0,1,1
41361,valued,0,0,1,1
41919,presenteert,0,0,1,1
41870,escravos,0,0,1,1
41868,ditesleur,0,0,1,1
41866,ومفيدة,0,0,1,1
41864,sixième,0,0,1,1
41862,améliorer »,0,0,1,1
41861,التكرار,0,0,1,1
41860,होस्टिंग,0,0,1,1
41859,codificada,0,0,1,1
827,tendiamo,1,1,0,1
41857,algorithmically,0,0,1,1
41854,aconteceu,0,0,1,1
41852,topten,0,0,1,1
41851,calcified,0,0,1,1
41850,करना।,0,0,1,1
41849,ಶ್ರಮವಹಿಸಬೇಕೆಂದು,0,0,1,1
41847,التحذيرات,0,0,1,1
41846,διαδίκτυο,0,0,1,1
41845,determining,0,0,1,1
41844,toevoegen,0,0,1,1
41843,optique,0,0,1,1
41842,passionnés,0,0,1,1
41840,പോകണമെന്ന്,0,0,1,1
41838,uniques,0,0,1,1
41835,hazreti,0,0,1,1
41834,மூளைச்சலவை,0,0,1,1
41833,സമ്പൂർണ്ണമാക്കുന്നതിനും,0,0,1,1
41832,telespectadores,0,0,1,1
41831,достичь,0,0,1,1
831,qualifica,1,1,0,1
41871,αλάτι,0,0,1,1
41872,догадаются,0,0,1,1
41873,ironfilled,0,0,1,1
41898,afbalancerede,0,0,1,1
41916,lieblingssmartwort,0,0,1,1
41915,والنص,0,0,1,1
41914,सुव्यवस्थित,0,0,1,1
41912,adéquation,0,0,1,1
41911,gizlice,0,0,1,1
41909,behandlade,0,0,1,1
41907,инструмент,0,0,1,1
41906,βασικοί,0,0,1,1
822,acculturato…,1,1,0,1
41902,elske,0,0,1,1
41901,uitspreekt,0,0,1,1
41900,onehalf,0,0,1,1
41899,பறவையைப்,0,0,1,1
41896,utiliza,0,0,1,1
41874,atendidos,0,0,1,1
41895,entdeckung,0,0,1,1
41894,extensively,0,0,1,1
824,riflesso,1,1,0,1
41892,தரப்பில்,0,0,1,1
41889,تدوين,0,0,1,1
41887,godzijdank,0,0,1,1
41886,प्रोजेक्टों,0,0,1,1
41882,karışırsa,0,0,1,1
41881,examplestasks,0,0,1,1
41880,χρόνια,0,0,1,1
41878,estáveis,0,0,1,1
41876,அதிநவீன,0,0,1,1
41875,चले,0,0,1,1
41829,überfluten,0,0,1,1
41828,uppmärksammades,0,0,1,1
41825,wikiespecies,0,0,1,1
41760,kritisk,0,0,1,1
41779,konusunda,0,0,1,1
41778,identificados,0,0,1,1
41777,अधिकतर,0,0,1,1
41773,நம்பமுடியாத,0,0,1,1
41772,എങ്ങനെയെങ്കിലും,0,0,1,1
41770,एटरीब्यूशनशेयर,0,0,1,1
41769,skede,0,0,1,1
41768,विकीवर्सिटी,0,0,1,1
842,simulata,1,1,0,1
41764,മരിയനെ,0,0,1,1
41763,ವಾಕ್ಯದಲ್ಲಿ,0,0,1,1
41762,أستراليون,0,0,1,1
41761,tændt,0,0,1,1
41759,எடுத்து,0,0,1,1
41783,"
गैलिसियाई",0,0,1,1
843,doppia,1,1,0,1
41754,bataklıkta,0,0,1,1
41753,construct,0,0,1,1
41752,göstermiştir,0,0,1,1
41751,afrika,0,0,1,1
41749,diskussionssidan,0,0,1,1
41748,दबाया,0,0,1,1
41747,പ്രയോഗിച്ചുകൊണ്ടാണ്,0,0,1,1
41746,schlimmes,0,0,1,1
41745,acusan,0,0,1,1
41744,ракушка,0,0,1,1
41743,desempenho,0,0,1,1
41741,nyheterna,0,0,1,1
41780,« meilleures,0,0,1,1
41784,fixes,0,0,1,1
41824,vivante,0,0,1,1
41802,blockera,0,0,1,1
41823,дорогое,0,0,1,1
41820,blijkt,0,0,1,1
41819,സ്വർണ്ണത്തിൽ,0,0,1,1
41818,imposé,0,0,1,1
832,scelta,1,1,0,1
41815,aurez,0,0,1,1
41814,tendency,0,0,1,1
41812,ψάχνουμε,0,0,1,1
41809,modsatte,0,0,1,1
41807,juegos,0,0,1,1
41806,superfluo,0,0,1,1
41804,winkelcentrum,0,0,1,1
41803,weliswaar,0,0,1,1
41801,beğeneceğinizi,0,0,1,1
840,andò,1,1,0,1
41800,грязь,0,0,1,1
41799,saniye,0,0,1,1
41798,« guerres,0,0,1,1
836,aggregatore,1,1,0,1
41796,جمالك,0,0,1,1
41794,avvisade,0,0,1,1
41792,catalisador,0,0,1,1
41791,månader,0,0,1,1
41790,jobbet,0,0,1,1
837,cambiata,1,1,0,1
41788,αναφέρετε,0,0,1,1
41787,«páginas,0,0,1,1
838,risulta,1,1,0,1
41917,अवरुद्ध,0,0,1,1
41920,பிடித்த,0,0,1,1
41738,ydmyg,0,0,1,1
41921,contundente,0,0,1,1
42050,kinesiska,0,0,1,1
42046,cliquear,0,0,1,1
42044,vancouversystemet,0,0,1,1
42043,فاجئك,0,0,1,1
42042,ಲೈಕ್,0,0,1,1
42041,"
bhasa",0,0,1,1
42040,अनुकूल,0,0,1,1
42039,ഉണ്ടായിരുന്നുവെന്ന്,0,0,1,1
42037,üstteki,0,0,1,1
42035,δίπλα,0,0,1,1
42034,bevæge,0,0,1,1
42033,уловки,0,0,1,1
42032,നിരന്തരമായ,0,0,1,1
42027,ಪೋರ್ಟಲ್,0,0,1,1
42026,ചൂടാണ്,0,0,1,1
42025,தரப்பும்,0,0,1,1
42024,absolument,0,0,1,1
42023,dagligen,0,0,1,1
42021,chimiques,0,0,1,1
42020,ಅಭಿಪ್ರಾಯವಿಲ್ಲ,0,0,1,1
42019,приглашения,0,0,1,1
42018,ссылается,0,0,1,1
42017,terminará,0,0,1,1
808,conosciuto,1,1,0,1
42015,يتحدث,0,0,1,1
42014,ಸಿದ್ಧರಿದ್ದೀರಿ,0,0,1,1
42013,fejltagelse,0,0,1,1
42012,anónimo,0,0,1,1
42011,anlamakta,0,0,1,1
805,osserva,1,1,0,1
42052,الأقل,0,0,1,1
42054,закончить,0,0,1,1
42076,handlinger,0,0,1,1
42100,censuur,0,0,1,1
42098,координации,0,0,1,1
42096,tempérées,0,0,1,1
42095,dataskyddsförordningen,0,0,1,1
42093,ведь,0,0,1,1
42091,"
अम्हारिक",0,0,1,1
42089,yazarlarının,0,0,1,1
42087,votar,0,0,1,1
42083,traités,0,0,1,1
42082,créative,0,0,1,1
798,sbalorditiva,1,1,0,1
42079,لمعلومات,0,0,1,1
42078,ശ്രദ്ധയിൽ,0,0,1,1
799,sedeva,1,1,0,1
42055,kökü,0,0,1,1
42074,ऑप्टिकल,0,0,1,1
800,legali,1,1,0,1
42070,पर्सन,0,0,1,1
42069,реальных,0,0,1,1
42068,adamların,0,0,1,1
42067,δείξει,0,0,1,1
802,riconoscere,1,1,0,1
42065,ξαναδώ,0,0,1,1
42064,rival,0,0,1,1
804,problematici,1,1,0,1
42059,அதிநவீனமாக,0,0,1,1
42057,indsats,0,0,1,1
42056,அம்மாவுக்குத்,0,0,1,1
809,disgregazione,1,1,0,1
42009,പ്രവർത്തനം,0,0,1,1
42007,artikelversion,0,0,1,1
41941,saai,0,0,1,1
41962,framfört,0,0,1,1
41961,даю,0,0,1,1
41960,അഞ്ച്,0,0,1,1
41959,saknat,0,0,1,1
41956,detektere,0,0,1,1
41955,راي,0,0,1,1
41954,بزيارة,0,0,1,1
814,sviluppatori,1,1,0,1
41952,«в,0,0,1,1
41950,gerou,0,0,1,1
41947,твоей,0,0,1,1
41946,zij,0,0,1,1
41943,contrer,0,0,1,1
41940,radikalt,0,0,1,1
41965,غالبية,0,0,1,1
41939,നാം,0,0,1,1
41938,yapmadığınız,0,0,1,1
41936,colonisés,0,0,1,1
41935,consultables,0,0,1,1
41934,अन्तर्गत,0,0,1,1
41933,बदलने,0,0,1,1
41930,ട്ട്,0,0,1,1
41928,målgruppe,0,0,1,1
41927,paradoxes,0,0,1,1
41926,ينوي,0,0,1,1
41924,ранних,0,0,1,1
41923,automáticos»,0,0,1,1
820,prende,1,1,0,1
41963,göründüğünde,0,0,1,1
41966,يدور,0,0,1,1
42005,dvds,0,0,1,1
41985,ooooo,0,0,1,1
42004,wind,0,0,1,1
42001,பார்க்கும்போது,0,0,1,1
42000,geluid,0,0,1,1
41998,ಮೂಗು,0,0,1,1
41996,മണമുള്ള,0,0,1,1
41995,substantivo,0,0,1,1
41994,egentliga,0,0,1,1
41993,تضمن,0,0,1,1
41992,отполированный,0,0,1,1
41991,видов,0,0,1,1
41990,techniek,0,0,1,1
41989,ஒபாமாவுக்கு,0,0,1,1
41986,couru,0,0,1,1
41984,சிறப்புக்கட்டுரைகளிடையே,0,0,1,1
811,ereditato,1,1,0,1
41983,caja,0,0,1,1
41982,avanços,0,0,1,1
810,lingua»,1,1,0,1
41978,تباعدوا,0,0,1,1
41977,meldde,0,0,1,1
41976,والتنسيق,0,0,1,1
41974,περισσότερα,0,0,1,1
41973,namiddag,0,0,1,1
41972,ಆಲಸ್ಯ,0,0,1,1
41971,fera,0,0,1,1
41970,« marques »,0,0,1,1
41969,அதற்கான,0,0,1,1
41968,यू॰एस॰,0,0,1,1
844,essi,1,1,0,1
845,tipico,1,1,0,1
41362,نشر,0,0,1,1
41549,plate,0,0,1,1
41503,точность,0,0,1,1
41502,xixe,0,0,1,1
41501,heliopause,0,0,1,1
887,piacerebbe,1,1,0,1
41497,seeking,0,0,1,1
41496,visitor,0,0,1,1
41495,mentaal,0,0,1,1
41494,பிரித்தானிக்கா,0,0,1,1
41493,अभिधान,0,0,1,1
41492,മീറ്റിംഗിനും,0,0,1,1
41491,begins,0,0,1,1
41490,sake,0,0,1,1
889,però,1,1,0,1
41487,гибкая,0,0,1,1
41486,شاركت,0,0,1,1
41485,repérer ,0,0,1,1
890,vecchia,1,1,0,1
41483,പറയുകയായിരുന്നു,0,0,1,1
41482,podrán,0,0,1,1
41481,froh,0,0,1,1
41479,amont,0,0,1,1
41477,yoluna,0,0,1,1
41476,olduktan,0,0,1,1
893,regolarità,1,1,0,1
41472,buchstäblich,0,0,1,1
41471,ουσιαστικό,0,0,1,1
41468,வார்த்தைகளில்,0,0,1,1
41467,terres,0,0,1,1
41466,εγγραφείτε,0,0,1,1
41504,διάρκεια,0,0,1,1
41506,शहरों,0,0,1,1
41509,leiden,0,0,1,1
41529,empty,0,0,1,1
41546,afspreken,0,0,1,1
41545,சிரமமாக,0,0,1,1
41544,सतर्क,0,0,1,1
41543,nonfiction,0,0,1,1
41542,physics—the,0,0,1,1
41541,offensant,0,0,1,1
41540,فمثلا,0,0,1,1
41537,يكتبه,0,0,1,1
41536,брайдл,0,0,1,1
41535,ulaşıp,0,0,1,1
41533,suggéré,0,0,1,1
41532,определении,0,0,1,1
41531,астрономической,0,0,1,1
41527,bulsam,0,0,1,1
41511,dergelijke,0,0,1,1
41525,செய்வதற்கான,0,0,1,1
41524,любую,0,0,1,1
41523,bedövad,0,0,1,1
885,«quando,1,1,0,1
41520,sufrido,0,0,1,1
41519,passende,0,0,1,1
41518,истории,0,0,1,1
41517,حاسوبياً,0,0,1,1
41516,adını,0,0,1,1
41515,mütevazı,0,0,1,1
41514,betegne,0,0,1,1
41513,சொற்றொடரின்,0,0,1,1
41512,voeden,0,0,1,1
41464,rammer,0,0,1,1
41463,புத்தகமான,0,0,1,1
41462,кластеров,0,0,1,1
41383,وسيمه,0,0,1,1
41405,tanrıya,0,0,1,1
41404,existia,0,0,1,1
41401,podrá,0,0,1,1
41400,kullanıyoruz,0,0,1,1
41399,stapt,0,0,1,1
41396,ನೋಡುತ್ತಾ,0,0,1,1
41395,ontwikkelen,0,0,1,1
41394,तीसरे,0,0,1,1
41391,πέντε,0,0,1,1
41389,allmänbildning,0,0,1,1
41388,discourage,0,0,1,1
41387,innecesarios,0,0,1,1
41384,«уборка»,0,0,1,1
41381,लूंगा।,0,0,1,1
41407,تفضيل,0,0,1,1
41380,«антиэлитарность»,0,0,1,1
41377,cerebro,0,0,1,1
41376,caparazón,0,0,1,1
41375,romaine,0,0,1,1
909,permettimi,1,1,0,1
41373,varsin,0,0,1,1
910,bravi,1,1,0,1
911,neutroni,1,1,0,1
41369,يتعلق,0,0,1,1
41368,continuamente,0,0,1,1
41366,समन्वय,0,0,1,1
41364,редакции,0,0,1,1
41363,рубинов,0,0,1,1
41406,περιστατικά,0,0,1,1
903,altrove,1,1,0,1
894,complementare,1,1,0,1
896,provarono,1,1,0,1
41460,അതിശക്തമായ,0,0,1,1
41458,பல்கலைக்கழகத்தில்,0,0,1,1
41456,красивом,0,0,1,1
41452,функция,0,0,1,1
41450,emne,0,0,1,1
41449,mediação,0,0,1,1
41448,wikee,0,0,1,1
41446,அட்டூழியம்,0,0,1,1
895,fammelo,1,1,0,1
41442,bestond,0,0,1,1
41439,uzmanların,0,0,1,1
41438,lujo,0,0,1,1
41436,asuntos,0,0,1,1
897,dormiva,1,1,0,1
41409,فهذا,0,0,1,1
41432,internetbaserade,0,0,1,1
41431,pleurs,0,0,1,1
41430,starving,0,0,1,1
41429,parlement,0,0,1,1
900,superato,1,1,0,1
41426,objects—the,0,0,1,1
41424,பயன்படுத்துவீர்கள்,0,0,1,1
41421,glæde,0,0,1,1
902,problematiche,1,1,0,1
41416,snabbheten,0,0,1,1
41413,عمليات,0,0,1,1
41411,president,0,0,1,1
41410,« bon,0,0,1,1
41547,ದೀರ್ಘಕಾಲ,0,0,1,1
41550,опыта,0,0,1,1
846,codici,1,1,0,1
41552,corner,0,0,1,1
41684,прыгну,0,0,1,1
862,ritirato,1,1,0,1
41682,μεγάλη,0,0,1,1
41680,اشتروه,0,0,1,1
41679,öbekleri,0,0,1,1
41678,நாளில்,0,0,1,1
41677,petrolífero,0,0,1,1
41676,наблюдения»,0,0,1,1
41674,وهناك,0,0,1,1
41673,издательством,0,0,1,1
41672,влияние,0,0,1,1
41671,obteve,0,0,1,1
864,indiana,1,1,0,1
41669,отключены,0,0,1,1
41668,kolaylaştırmak,0,0,1,1
41667,starte,0,0,1,1
865,tenuti,1,1,0,1
41665,favorablemente,0,0,1,1
41662,d’adaptation,0,0,1,1
41660,حاليًا,0,0,1,1
41658,resultaten,0,0,1,1
41657,skapande,0,0,1,1
41656,помоги,0,0,1,1
41655,vendus,0,0,1,1
41654,rends,0,0,1,1
41653,«fuentes,0,0,1,1
41652,gülümseyerek,0,0,1,1
41651,لتحرير,0,0,1,1
41649,överraskar,0,0,1,1
41686,şeye,0,0,1,1
41687,profondes »,0,0,1,1
41689,غيرت,0,0,1,1
41713,concepteurs,0,0,1,1
847,«a,1,1,0,1
41733,blinkede,0,0,1,1
41730,defendida,0,0,1,1
41726,especiais,0,0,1,1
850,facenti,1,1,0,1
41724,அணிந்திருந்தார்,0,0,1,1
41723,ഇവരും,0,0,1,1
41722,पीडिया,0,0,1,1
41721,запутаться,0,0,1,1
41719,ευρύ,0,0,1,1
41718,சொற்றொடராக,0,0,1,1
41715,ediyorsun,0,0,1,1
41714,അവലംബമായി,0,0,1,1
851,faziosi,1,1,0,1
41690,concourent,0,0,1,1
41710,outlaw,0,0,1,1
41709,surveiller,0,0,1,1
41708,umursamıyordu,0,0,1,1
41705,contestarte,0,0,1,1
854,rosso,1,1,0,1
41702,ambiente,0,0,1,1
41701,வங்கிக்,0,0,1,1
41699,думать,0,0,1,1
856,equilibrate,1,1,0,1
41696,comentar,0,0,1,1
41695,ஹலோ,0,0,1,1
41692,ಪ್ರಯಾಣಿಸುತ್ತಿದ್ದಾಗ,0,0,1,1
859,oversight,1,1,0,1
41648,referese,0,0,1,1
41647,étendra,0,0,1,1
41646,disculparse,0,0,1,1
41577,dépendant,0,0,1,1
41599,विकिकोट,0,0,1,1
41598,beskrivit,0,0,1,1
41593,lebensmitteln,0,0,1,1
879,segue,1,1,0,1
41590,annesinin,0,0,1,1
41589,വിക്കിപീഡിയരായി,0,0,1,1
41585,recourent,0,0,1,1
41584,gungar,0,0,1,1
41583,ചെയ്യുകയും,0,0,1,1
41581,entertainment,0,0,1,1
41580,സൃഷ്ടിച്ചു,0,0,1,1
41579,tallerken,0,0,1,1
41578,പുഞ്ചിരിച്ചു,0,0,1,1
41573,ties,0,0,1,1
41601,கலைக்களஞ்சியம்,0,0,1,1
41572,സങ്കേതത്തിൽ,0,0,1,1
41569,traveled,0,0,1,1
41567,quedó,0,0,1,1
41566,optimize,0,0,1,1
41563,இருந்தபோதிலும்,0,0,1,1
41562,दूंगा,0,0,1,1
41560,storbritanniens,0,0,1,1
881,quattromila,1,1,0,1
41557,inciclopedia,0,0,1,1
882,abbiamo,1,1,0,1
41555,повторения,0,0,1,1
41554,മേഖലയെ,0,0,1,1
41553,التكنولوجيا,0,0,1,1
41600,lägger,0,0,1,1
41604,प्रतिक्रिया,0,0,1,1
41644,темы,0,0,1,1
41625,kullanıma,0,0,1,1
869,ingressi,1,1,0,1
870,preoccupazioni,1,1,0,1
41639,ಮೇಲಿನಿಂದ,0,0,1,1
41638,lisanslanmaktadır,0,0,1,1
41637,intimidad,0,0,1,1
41636,magisch,0,0,1,1
41635,ಹೋಗಬೇಕಾಗಿದೆ,0,0,1,1
41634,b,0,0,1,1
873,voleva,1,1,0,1
41631,dileme,0,0,1,1
41630,painting,0,0,1,1
874,visuale,1,1,0,1
41627,внести,0,0,1,1
41624,rattachée,0,0,1,1
41605,адресу,0,0,1,1
41623,süslenmişti,0,0,1,1
41622,εξέπληξε,0,0,1,1
875,svolgimento,1,1,0,1
41619,خاصية,0,0,1,1
41616,beundrande,0,0,1,1
41615,للمقالة،,0,0,1,1
41614,"law ·
ഭൗതികശാസ്ത്രം ·
pollution",0,0,1,1
41613,прослушайте,0,0,1,1
41612,priorité,0,0,1,1
41611,അഭിപ്രായങ്ങൾ,0,0,1,1
41610,टैग,0,0,1,1
41609,علي,0,0,1,1
41608,inversement,0,0,1,1
40621,econômicas,0,0,1,1
40618,gevaar,0,0,1,1
39165,« naturels »,0,0,1,1
39632,ρίτσαρντ,0,0,1,1
39670,விக்கிப்பீடியாவிலிருந்து,0,0,1,1
1149,descrivere,1,1,0,1
39667,ಜೋಚ್,0,0,1,1
39666,handwriting,0,0,1,1
39664,владеющей,0,0,1,1
39663,ضمان,0,0,1,1
1150,collaborativa,1,1,0,1
39661,lagunas,0,0,1,1
39660,impureza,0,0,1,1
39659,omfattning,0,0,1,1
39658,карьеры,0,0,1,1
39655,கருத்தொருமிப்பின்,0,0,1,1
39654,intitulada,0,0,1,1
39653,«творческого,0,0,1,1
39652,നോക്കട്ടെ,0,0,1,1
39651,kaldırılmasının,0,0,1,1
39650,pior,0,0,1,1
39649,glockensymbol,0,0,1,1
39647,—libro,0,0,1,1
39646,« vous »,0,0,1,1
39645,τραπεζαρία,0,0,1,1
39644,protège,0,0,1,1
39642,pensamentos,0,0,1,1
39640,ശൈശവാവസ്ഥയിലാണ്,0,0,1,1
39639,русск»,0,0,1,1
39638,ನೆಚ್ಚಿನದು,0,0,1,1
39637,ertoe,0,0,1,1
39636,சாதனையாக,0,0,1,1
39635,возьму,0,0,1,1
39672,unrecognized,0,0,1,1
39673,പ്രവർത്തിക്കണമെന്ന്,0,0,1,1
1148,eccitante,1,1,0,1
39695,erik,0,0,1,1
39713,revertidos,0,0,1,1
39711,ocorrem,0,0,1,1
1142,prelevarne,1,1,0,1
39708,несъедобным,0,0,1,1
39707,pollueurpayeur,0,0,1,1
39706,являвшаяся,0,0,1,1
39705,preguiçoso,0,0,1,1
1143,considerare,1,1,0,1
39702,सांस,0,0,1,1
39701,കഴിക്കുന്നതിനെക്കുറിച്ച്,0,0,1,1
1144,collaboratori»,1,1,0,1
39699,സന്ദേശങ്ങളെ,0,0,1,1
39697,incorporación,0,0,1,1
39694,‘வழங்கி’யில்,0,0,1,1
39675,pointforpoint,0,0,1,1
39692,eğilimindedir,0,0,1,1
39691,озаглавленное,0,0,1,1
39690,βιβλία,0,0,1,1
39689,limitó,0,0,1,1
39687,requisito,0,0,1,1
39686,المميزات,0,0,1,1
39684,التجارية,0,0,1,1
39683,uppifrån,0,0,1,1
39681,американский,0,0,1,1
1146,esposizione,1,1,0,1
39679,wetlands,0,0,1,1
39678,ഉള്ളൂവെന്നും,0,0,1,1
1147,dicendomi,1,1,0,1
39634,écoute,0,0,1,1
39630,wakker,0,0,1,1
40617,arrivent,0,0,1,1
39629,« rapide »,0,0,1,1
39580,proporción,0,0,1,1
39579,mismo​,0,0,1,1
39578,വിജയിച്ചു,0,0,1,1
1162,topologia,1,1,0,1
1163,definite,1,1,0,1
1164,visita,1,1,0,1
39573,serais,0,0,1,1
39572,विकिन्यूज,0,0,1,1
1166,collettiva,1,1,0,1
39568,सपने,0,0,1,1
39567,عهد,0,0,1,1
39565,onionspotatoes,0,0,1,1
39564,bewundernden,0,0,1,1
39563,лицензирован,0,0,1,1
39560,الفساتين,0,0,1,1
39559,таково,0,0,1,1
39558,വെബ്‌,0,0,1,1
39556,അർഹനാണെന്ന്,0,0,1,1
39554,يصف,0,0,1,1
1167,primato,1,1,0,1
39548,ويقوم,0,0,1,1
1168,esito,1,1,0,1
39544,bumped,0,0,1,1
39543,fineste,0,0,1,1
39541,culto​​​,0,0,1,1
39539,ശ്രദ്ധിക്കാനാകില്ലെന്ന്,0,0,1,1
39538,propress,0,0,1,1
39536,påverka,0,0,1,1
39535,важной,0,0,1,1
39581,الظهيرة,0,0,1,1
39582,टेम्पलेट्स,0,0,1,1
39583,колеблясь,0,0,1,1
39611,títeres,0,0,1,1
39628,partagée,0,0,1,1
39627,تقريبًا،,0,0,1,1
1153,latino,1,1,0,1
39625,സമൂഹത്തിൽ,0,0,1,1
39624,ليه،,0,0,1,1
39623,ലഭ്യമല്ലെങ്കിൽ,0,0,1,1
39621,mijlpaal,0,0,1,1
39620,severos,0,0,1,1
39619,обществом,0,0,1,1
39618,ಹಿಂಜರಿಯುತ್ತಿದೆ,0,0,1,1
39616,مشيرة,0,0,1,1
39615,vicinity,0,0,1,1
39612,खरीदूंगा,0,0,1,1
39610,verbum,0,0,1,1
1159,linguisticamente,1,1,0,1
39609,norteamericano,0,0,1,1
1155,famosa,1,1,0,1
39604,മകളായ,0,0,1,1
39603,asemejen,0,0,1,1
39602,modernos,0,0,1,1
1157,etiche,1,1,0,1
39596,перевод,0,0,1,1
39595,പെരുമാറിയത്,0,0,1,1
39594,cognitive,0,0,1,1
39591,счастлив,0,0,1,1
39587,prouviez,0,0,1,1
39586,underbar,0,0,1,1
39585,glückwünsche,0,0,1,1
39714,policy—which,0,0,1,1
1141,pianto,1,1,0,1
39716,छह,0,0,1,1
39717,amatörer,0,0,1,1
39852,représenter,0,0,1,1
39851,ರತ್ನಗಳು,0,0,1,1
39850,حيوان,0,0,1,1
1126,abbi,1,1,0,1
39845,disregard,0,0,1,1
39844,طفيف،,0,0,1,1
1127,reciproche,1,1,0,1
39842,"
चुवाश",0,0,1,1
39841,έκπληκτος,0,0,1,1
39839,indicarles,0,0,1,1
39838,reprises,0,0,1,1
1128,dovrai,1,1,0,1
39836,массовых,0,0,1,1
39835,triplicado,0,0,1,1
39833,humanmade,0,0,1,1
39832,"
सोरानी",0,0,1,1
39830,ಚಿಂತೆಯಿಲ್ಲ,0,0,1,1
39829,gönderdin,0,0,1,1
39827,nivelar,0,0,1,1
39826,ആരെയോ,0,0,1,1
39824,répréhensibles,0,0,1,1
1129,palomar,1,1,0,1
39822,bitecek,0,0,1,1
39821,provoquant,0,0,1,1
1130,gamma,1,1,0,1
39814,மெதுவாகவும்,0,0,1,1
1131,comparativo,1,1,0,1
39812,беспокоюсь,0,0,1,1
39810,entraînement »,0,0,1,1
39853,localized,0,0,1,1
39854,garten,0,0,1,1
39856,μέρους,0,0,1,1
39874,ξαφνιασμένος,0,0,1,1
39896,indecent,0,0,1,1
39895,σκύλος,0,0,1,1
39894,ಅದ್ಭುತವಾಗಿ,0,0,1,1
39893,histórico,0,0,1,1
39892,evlendikten,0,0,1,1
39890,"
माओरी",0,0,1,1
39889,reconhecido,0,0,1,1
39888,طويلة,0,0,1,1
39887,കടിയെടുത്തു,0,0,1,1
39882,alemães,0,0,1,1
39881,economische,0,0,1,1
39880,കോട്ട,0,0,1,1
39879,مهذبًا,0,0,1,1
39873,«espejos»—,0,0,1,1
39857,encoded,0,0,1,1
39872,ആർക്കെങ്കിലും,0,0,1,1
39871,அழகைத்,0,0,1,1
39870,olgudur,0,0,1,1
39869,validity,0,0,1,1
39868,يفعله,0,0,1,1
39867,سلبي,0,0,1,1
39866,disculpas,0,0,1,1
39865,اللحم,0,0,1,1
39863,borrar,0,0,1,1
39861, مليار,0,0,1,1
39860,ತಂಪಾಗಿರಲು,0,0,1,1
39859,दूसरों,0,0,1,1
39858,होगी,0,0,1,1
39809,drastic,0,0,1,1
39805,återanvändas,0,0,1,1
39804,reader,0,0,1,1
39739,धोने,0,0,1,1
39758,hävde,0,0,1,1
39757,vayamos,0,0,1,1
1138,essersi,1,1,0,1
39755,hesitating,0,0,1,1
39754,habitable,0,0,1,1
39753,ignores,0,0,1,1
39752,sonido,0,0,1,1
39751,рассмотрим,0,0,1,1
39748,ವಿವರಣಾ,0,0,1,1
39746,blog,0,0,1,1
39743,μήνες,0,0,1,1
39742,комто,0,0,1,1
39741,omarbetats,0,0,1,1
39738,ಮಾತನಾಡೋಣ,0,0,1,1
39762,язык,0,0,1,1
39736,посчитает,0,0,1,1
39735,ದಣಿದ,0,0,1,1
39734,unglück,0,0,1,1
39733,klockikonen,0,0,1,1
39731,ಗೊಂದಲಗೊಳಿಸುವುದು,0,0,1,1
39730,ಇರಲು,0,0,1,1
39729,നിർമ്മിച്ചതാണ്,0,0,1,1
39728,ಧ್ವನಿಯನ್ನು,0,0,1,1
39725,belief,0,0,1,1
39724,وتطوير,0,0,1,1
39722,irc,0,0,1,1
1140,truppe,1,1,0,1
39719,serão,0,0,1,1
39759,öppenheten,0,0,1,1
1137,qr,1,1,0,1
39803,ಧನಾತ್ಮಕ,0,0,1,1
39786,പൊതുജനങ്ങൾക്കെല്ലാം,0,0,1,1
39802,مبكرين,0,0,1,1
39801,ആലിംഗനം,0,0,1,1
39800,inhabited,0,0,1,1
39799,tebrikleri,0,0,1,1
39797,sorular,0,0,1,1
39796,النتيجة,0,0,1,1
39794,статистику,0,0,1,1
39793,грубо,0,0,1,1
39792,έως,0,0,1,1
39791,deprived,0,0,1,1
39790,yaptım,0,0,1,1
39789,politiskt,0,0,1,1
39787,طاقة,0,0,1,1
39785,controversés,0,0,1,1
39767,വിചാരിക്കുന്നത്,0,0,1,1
39784,dawikipediaorg,0,0,1,1
39783,tastiest,0,0,1,1
1134,potessi,1,1,0,1
39780,иду,0,0,1,1
39778,ಹಾಡುಗಳಲ್ಲಿ,0,0,1,1
39777,ಹಿಡಿಯದಿದ್ದರೆ,0,0,1,1
39776,மறுப்புக்களுக்கான,0,0,1,1
39775,anna,0,0,1,1
39773,anlamadım,0,0,1,1
1135,archiviate,1,1,0,1
39771,åtanke,0,0,1,1
39770,injurieuse,0,0,1,1
39768,« alphago »,0,0,1,1
39534,περίμενε,0,0,1,1
39533,publicering,0,0,1,1
39532,tags,0,0,1,1
39340,विवादों,0,0,1,1
39295,imite,0,0,1,1
39293,விக்கிப்பீடியாக்களில்,0,0,1,1
39292,denir,0,0,1,1
39290,ihlalleri,0,0,1,1
39289,debattörer,0,0,1,1
39288,inició,0,0,1,1
39287,ഉറപ്പുവരുത്തുന്നതിന്,0,0,1,1
39286,ошибку,0,0,1,1
39285,ağlamasın,0,0,1,1
39283,سينتهي,0,0,1,1
39282,suportada,0,0,1,1
39281,temperatures,0,0,1,1
39279,وأحكام,0,0,1,1
39277,despercebida,0,0,1,1
39276,القانونية،,0,0,1,1
39275,cometí,0,0,1,1
39274,elevar,0,0,1,1
39273,indfødte,0,0,1,1
39272,disasters,0,0,1,1
39271,которому,0,0,1,1
39270,للدلالة,0,0,1,1
39269,മനസിലാക്കിയാൽ,0,0,1,1
39268,التقليدية،,0,0,1,1
39267,கொண்டிருந்தாள்,0,0,1,1
39266,बोलने,0,0,1,1
39265,modificado,0,0,1,1
39264,   articles,0,0,1,1
1208,eccetto,1,1,0,1
39262,disco,0,0,1,1
1205,confondi,1,1,0,1
39297,desacordo,0,0,1,1
1204,convinzione,1,1,0,1
39320,viva,0,0,1,1
39338,மனிதர்களாக,0,0,1,1
39336,statement,0,0,1,1
39335,réussit,0,0,1,1
39332,källan,0,0,1,1
39331,permaneceu,0,0,1,1
1199,riportato,1,1,0,1
39329,அமைதிப்படுத்திக்,0,0,1,1
39328,स्टोरी,0,0,1,1
39327,கடுமையாக,0,0,1,1
39325,ಕ್ರಿಯಾಪದವು,0,0,1,1
39324,антиэлитаризм,0,0,1,1
39322,ilgilenmiyorsan,0,0,1,1
39321,solucionar,0,0,1,1
39318,πχ,0,0,1,1
1203,annualmente,1,1,0,1
39317,soussol,0,0,1,1
39316,imaginar,0,0,1,1
1200,accadeva,1,1,0,1
39314,προς,0,0,1,1
39313,ಪ್ರಯಾಣದ,0,0,1,1
39312,البرنامج،,0,0,1,1
39311,ഇക്കാര്യത്തിലും,0,0,1,1
39310,έτρεξε,0,0,1,1
39308,заниматься,0,0,1,1
39306,удивительного,0,0,1,1
39304,énergisante,0,0,1,1
39303,threatening,0,0,1,1
39302,hopelijk,0,0,1,1
39261,visualización,0,0,1,1
39260,familière,0,0,1,1
39259,للاستخدام,0,0,1,1
1214,secolo,1,1,0,1
39197,cybersécurité,0,0,1,1
39196,synen,0,0,1,1
39195,பெயர்கள்,0,0,1,1
39194,registro,0,0,1,1
1213,reiterato,1,1,0,1
39192,existieron,0,0,1,1
39191,तुम्हारे,0,0,1,1
39190,شوارتز,0,0,1,1
39189,tillmätas,0,0,1,1
39188,undersöks,0,0,1,1
39187,bestäms,0,0,1,1
39185,sverker,0,0,1,1
39184,ഗുണാങ്കങ്ങളുടെ,0,0,1,1
39182,συνηθισμένη,0,0,1,1
39201,lionel,0,0,1,1
39181,തത്ത്വത്തിലാണ്,0,0,1,1
39180,danés,0,0,1,1
39179,representaban,0,0,1,1
39177,للقوات,0,0,1,1
39175,persondatorer,0,0,1,1
39174,diagnósticos,0,0,1,1
39173,replacement,0,0,1,1
39172,trabajadas,0,0,1,1
39171,outliers,0,0,1,1
39169,വിക്കിപീഡിയകളായ,0,0,1,1
39168,insuffisances,0,0,1,1
39167,معلموا,0,0,1,1
39166,बराक,0,0,1,1
39198,உருவாக்கப்பட்டு,0,0,1,1
39203,இணையத்தள,0,0,1,1
39258,الغداء,0,0,1,1
39236,alimenter,0,0,1,1
39256,efeito,0,0,1,1
39253,ranges,0,0,1,1
39251,indsætte,0,0,1,1
39250,எட்டப்படுகிறது,0,0,1,1
39248,seks,0,0,1,1
39247,dags,0,0,1,1
1210,sbatté,1,1,0,1
39244,ಒಬ್ಟ್ಯೂಸ್,0,0,1,1
39243,ex ,0,0,1,1
39241,ಆಶ್ಚರ್ಯಚಕಿತರಾಗಲು,0,0,1,1
39240,пишет,0,0,1,1
39239,colocando,0,0,1,1
39238,преуспевать,0,0,1,1
39235,sonraları,0,0,1,1
39204,ನಿಮಿಷದಲ್ಲಿ,0,0,1,1
39234,figures,0,0,1,1
39233,chegarem,0,0,1,1
39231,едва,0,0,1,1
39230,справочника,0,0,1,1
39229,अमृत,0,0,1,1
39227,whereas,0,0,1,1
39224,teach,0,0,1,1
39223,semillas,0,0,1,1
39222,l’entraînant,0,0,1,1
39219,wikipediaartiklars,0,0,1,1
39216,güney,0,0,1,1
39213,جادًا,0,0,1,1
39209,différence,0,0,1,1
39339,snelle,0,0,1,1
39341,японском,0,0,1,1
39530,satan,0,0,1,1
39342,വസ്തുതകളോട്,0,0,1,1
39480,σούπα,0,0,1,1
39479,பரபரப்பான,0,0,1,1
39478,"
italiano",0,0,1,1
39475,utilização,0,0,1,1
39474,ಕೆಂಪು,0,0,1,1
39472,amène,0,0,1,1
1177,batte,1,1,0,1
39470,राजनितिक,0,0,1,1
39469,ഗുണനിലവാരം,0,0,1,1
39467,chegavam,0,0,1,1
39466,αστεροειδών,0,0,1,1
39464,neither,0,0,1,1
39462,dublinés,0,0,1,1
39461,расчленяются,0,0,1,1
39460,rituais,0,0,1,1
39459,elbiselerden,0,0,1,1
39458,существительное,0,0,1,1
39457,لإخبار,0,0,1,1
39456,governo,0,0,1,1
39455,provavelmente,0,0,1,1
39454,accrue,0,0,1,1
39452,reconsideró,0,0,1,1
39451,τείνουμε,0,0,1,1
39449,« proches,0,0,1,1
39443,تغذية,0,0,1,1
39441,hoşgeldin,0,0,1,1
39440,physiques,0,0,1,1
39438,riddare,0,0,1,1
1181,cronologia,1,1,0,1
39482,compreensíveis,0,0,1,1
39483,naturalité,0,0,1,1
39484,مذهولًا,0,0,1,1
39509,katı,0,0,1,1
39528,ஒன்றும்,0,0,1,1
39527,പരിഹാരത്തിലാണെന്ന്,0,0,1,1
39526,வியக்க,0,0,1,1
1173,scoraggiando,1,1,0,1
39523,ideell,0,0,1,1
39522,rattraper,0,0,1,1
39519,freshwater,0,0,1,1
39517,yayımlanan,0,0,1,1
39516,магнусом,0,0,1,1
39515,ചതുപ്പുനിലത്ത്,0,0,1,1
39513,blockerar,0,0,1,1
1174,crowdsourcing,1,1,0,1
39510,"
दिवेही",0,0,1,1
39508,αγαπούσε,0,0,1,1
1176,blocco,1,1,0,1
39507,வந்தான்,0,0,1,1
39505,μαρίνα,0,0,1,1
39504,trader,0,0,1,1
39501,википедияинклюзионизм,0,0,1,1
39499,« durabilité »,0,0,1,1
39496,принципе,0,0,1,1
39495,अपेक्षाकृत,0,0,1,1
39494,திடீரென்று,0,0,1,1
39492,शहर,0,0,1,1
39490,البيتزا,0,0,1,1
39488,περνούσε,0,0,1,1
39487,nyheter,0,0,1,1
39486,öğrenciler,0,0,1,1
39436,meşgulse,0,0,1,1
39435,parlant,0,0,1,1
39434,varelser,0,0,1,1
39358,ab,0,0,1,1
39377,leeftijd,0,0,1,1
39376,mangelhaft,0,0,1,1
39374,ಹುಡುಕುತ್ತಿದ್ದರೆ,0,0,1,1
39372,смотрела,0,0,1,1
39370,എവിടെയെങ്കിലും,0,0,1,1
39369,verre,0,0,1,1
39368,السعيد,0,0,1,1
39367,صعوبة,0,0,1,1
39366,роду,0,0,1,1
39364,ತೊಂದರೆಯಿಲ್ಲ,0,0,1,1
39363,الفزع,0,0,1,1
39361,launches,0,0,1,1
39360,الانقسام,0,0,1,1
39357,नाक,0,0,1,1
1193,degustazione,1,1,0,1
39355,διασκεδαστικό,0,0,1,1
39354,referenser,0,0,1,1
39353,finder,0,0,1,1
39352,révèlent,0,0,1,1
39351,ദുരുദ്ദേശ്യത്തോടുകൂടി,0,0,1,1
39350,объясните,0,0,1,1
39349,ಮಾಡಿಲ್ಲ,0,0,1,1
1196,sphinxsystem,1,1,0,1
39347,förhoppningsvis,0,0,1,1
39346,breeding,0,0,1,1
39345,maintaining,0,0,1,1
1197,espressi,1,1,0,1
39343,suck,0,0,1,1
39379,interpretativa,0,0,1,1
39381,вторичных,0,0,1,1
39433,подходам,0,0,1,1
39404,hoppar,0,0,1,1
39432,helado,0,0,1,1
39431,organisées,0,0,1,1
1183,iscriverti,1,1,0,1
39426,hoşgörü,0,0,1,1
39425,فالزوجة,0,0,1,1
1187,modificano,1,1,0,1
39419,ontbrak,0,0,1,1
39416,निर्देशों,0,0,1,1
39413,dosyaları,0,0,1,1
39412,netfront,0,0,1,1
1188,personaggio,1,1,0,1
39409,मांगने,0,0,1,1
39407,खूबसूरती,0,0,1,1
39403,കാര്യങ്ങളിലും,0,0,1,1
39382,endişeye,0,0,1,1
39400,« encyclopédie,0,0,1,1
39399,австрии,0,0,1,1
39398,ದಣಿದಿದ್ದೀರಾ,0,0,1,1
39397,عنوان,0,0,1,1
39396,उधार,0,0,1,1
39395,περιοχή,0,0,1,1
1191,entusiasmanti,1,1,0,1
39390,തെളിയിച്ചില്ലെങ്കിൽ,0,0,1,1
39389,bibliotheken,0,0,1,1
39388,immense,0,0,1,1
39387,derude,0,0,1,1
39385,decide,0,0,1,1
39383,parou,0,0,1,1
39899,വിവാഹ,0,0,1,1
1122,controllati,1,1,0,1
1121,canepari,1,1,0,1
40434,الكوكب,0,0,1,1
40373,stickprov,0,0,1,1
40370,overstromen,0,0,1,1
40369,bibliotekarien,0,0,1,1
40368,ಮರೆತುಬಿಡುತ್ತಾರೆ,0,0,1,1
40367,känna,0,0,1,1
40366,african,0,0,1,1
40365,शिक्षा,0,0,1,1
40364,इंक,0,0,1,1
40363,yiyemediğim,0,0,1,1
40362,γαλλικός,0,0,1,1
40361,βικειπαιδιας,0,0,1,1
40358,അവയെ,0,0,1,1
40357,saudações,0,0,1,1
40356,കണ്ണടച്ചു,0,0,1,1
40355,مكالمة,0,0,1,1
40354,مذهلًا,0,0,1,1
40353,итогов,0,0,1,1
1067,intervallo,1,1,0,1
40351,भारी,0,0,1,1
40348,garantizan,0,0,1,1
40346,معنى,0,0,1,1
40344,cortésmente,0,0,1,1
40343,experimente,0,0,1,1
40342,χειρότερα,0,0,1,1
40340,yansıtmaya,0,0,1,1
40339,springs,0,0,1,1
40337,llamar,0,0,1,1
1068,supponiamo,1,1,0,1
40334,directrices,0,0,1,1
40374,увидимся,0,0,1,1
1065,dolly,1,1,0,1
40376,தேடுகிறோம்,0,0,1,1
40403,gekichert,0,0,1,1
40430,неплохо,0,0,1,1
40429,интеллект,0,0,1,1
40428,κύρος,0,0,1,1
40427,இழுத்து,0,0,1,1
40426,ocensurerade,0,0,1,1
40425,aplicáveis,0,0,1,1
40421,tänk,0,0,1,1
40417,ersättning,0,0,1,1
40416,comienzos,0,0,1,1
40412,ангел,0,0,1,1
40408,запустил,0,0,1,1
40407,കുഴപ്പമുണ്ടോ,0,0,1,1
40406,madrid​,0,0,1,1
40401,presionando,0,0,1,1
1064,classi,1,1,0,1
40400,прогнала,0,0,1,1
40399,veckan,0,0,1,1
40398,adquirimos,0,0,1,1
40396,steder,0,0,1,1
1060,abbracciare,1,1,0,1
40392,സംശയമില്ലാത്ത,0,0,1,1
40390,reparação,0,0,1,1
40388,overnemen,0,0,1,1
40386,passes,0,0,1,1
40384,süßen,0,0,1,1
40382,aktive,0,0,1,1
40381,खबर,0,0,1,1
40380,ವಾಕ್ಯವನ್ನು,0,0,1,1
1069,dorate,1,1,0,1
40332,ಇಷ್ಟಪಡುವ,0,0,1,1
40331,diras,0,0,1,1
40254,tratar,0,0,1,1
40276,تجعلني,0,0,1,1
40275,наблюдаемой,0,0,1,1
40274,elever,0,0,1,1
40273,μπορούν,0,0,1,1
40272,confianza,0,0,1,1
40270,hvert,0,0,1,1
40269,enige,0,0,1,1
40266,eqdfw,0,0,1,1
40263,gereken,0,0,1,1
40262,उल्लंघन,0,0,1,1
40260,arriverez,0,0,1,1
40259,frequência,0,0,1,1
40258,evaluate,0,0,1,1
40253,يسافرون,0,0,1,1
40278,iran,0,0,1,1
1078,venivano,1,1,0,1
40250,посещаемых,0,0,1,1
40249,ковариацией,0,0,1,1
40248,طعام,0,0,1,1
40247,അമ്മയ്ക്ക്,0,0,1,1
40245,ζητά,0,0,1,1
40243,contract,0,0,1,1
40242,असहमत,0,0,1,1
40240,πολύπλοκος,0,0,1,1
40239,माग्नस,0,0,1,1
1080,raggi,1,1,0,1
40236,besökarna,0,0,1,1
40234,ബുഷ്,0,0,1,1
40277,göras,0,0,1,1
40280,diplômes,0,0,1,1
40329,lance,0,0,1,1
40305,блокировкой,0,0,1,1
40328,avsevärt,0,0,1,1
40325,engaged,0,0,1,1
40324,अनियन,0,0,1,1
40323,لكشف,0,0,1,1
40321,समीक्षाओं,0,0,1,1
40320,கேள்விக்கு,0,0,1,1
40318,усыпана,0,0,1,1
40317,gravedad,0,0,1,1
40316,ബുദ്ധിശൂന്യമാണെന്ന്,0,0,1,1
40313,despedirse,0,0,1,1
40311,سؤاله,0,0,1,1
40309,sensibles,0,0,1,1
40308,τραγούδια,0,0,1,1
40303,വരുന്നവർ,0,0,1,1
40282,specifieke,0,0,1,1
40301,​​als,0,0,1,1
40300,प्रचार,0,0,1,1
40299,adorable,0,0,1,1
40298,प्रोफेसर,0,0,1,1
40297,центром,0,0,1,1
40295,survive,0,0,1,1
40292,പ്രവർത്തിക്കുന്നത്,0,0,1,1
40291,dengeli,0,0,1,1
40289,ഭക്ഷണത്തെക്കുറിച്ച്,0,0,1,1
40288,creep,0,0,1,1
40287,മറയ്ക്കാൻ,0,0,1,1
40285,விளங்கிய,0,0,1,1
40284,circulação,0,0,1,1
40433,pequenas,0,0,1,1
40435,précipitations,0,0,1,1
40232,سبتمبر,0,0,1,1
40436,sire,0,0,1,1
40567,ഇമെയിലിൽ,0,0,1,1
40565,brute,0,0,1,1
40564,fuese,0,0,1,1
40563,ഔട്ട്പുട്ടിലേക്കുള്ള,0,0,1,1
1030,classica,1,1,0,1
40561,реализованная,0,0,1,1
40560,toevallig,0,0,1,1
40559,പ്രവൃത്തികളും,0,0,1,1
40557,സ്വേവ്,0,0,1,1
40556,árbol,0,0,1,1
40555,fictício,0,0,1,1
40553,усилие,0,0,1,1
40552,центра,0,0,1,1
40550,διαγλωσσικές,0,0,1,1
40549,sarılmak,0,0,1,1
40548,வடிவம்,0,0,1,1
40546,groepsverstand,0,0,1,1
40545,geomagnetic,0,0,1,1
40543,independientes,0,0,1,1
40542,binary,0,0,1,1
1033,primitivi,1,1,0,1
40539,notada,0,0,1,1
40536,iğrençtir,0,0,1,1
40535,علاجاته,0,0,1,1
40534,trupperna,0,0,1,1
40533,concordando,0,0,1,1
40531,തോന്നിയെന്നിരിക്കട്ടെ,0,0,1,1
40529,dergelijks,0,0,1,1
40528,വരുത്താൻ,0,0,1,1
1029,interattiva,1,1,0,1
40571,نمط,0,0,1,1
40572,franceag,0,0,1,1
40599,tvätt,0,0,1,1
1021,rendere,1,1,0,1
40614,ergs,0,0,1,1
40613,—imprecisiones,0,0,1,1
40611,विकिपीडियाने,0,0,1,1
1024,timida,1,1,0,1
40609,désinformation,0,0,1,1
40607,wikipediaskribenter,0,0,1,1
40606,ವ್ಯಾಕರಣ,0,0,1,1
40605,നിയന്ത്രിക്കുന്നത്,0,0,1,1
40604,wikiality​,0,0,1,1
40603,påbegyndt,0,0,1,1
40602,ಕಂಡಿದ್ದೀರಿ,0,0,1,1
40601,испугался,0,0,1,1
40598,rato»,0,0,1,1
40573,التنغيم,0,0,1,1
40597,அருகில்,0,0,1,1
40595,bekle,0,0,1,1
1025,offrirti,1,1,0,1
40592,«рандеву,0,0,1,1
40588,نسخها,0,0,1,1
40585,логистическому,0,0,1,1
40584,emploie,0,0,1,1
40583,حلقة,0,0,1,1
40581,ημερομηνία,0,0,1,1
1027,linguistici,1,1,0,1
40578,साथी,0,0,1,1
40576,hipotético,0,0,1,1
40575,"
português",0,0,1,1
40525,நுபீடியாவிற்கான,0,0,1,1
40524,κουδούνι,0,0,1,1
1037,svariati,1,1,0,1
40461,respirer,0,0,1,1
40478,emphasis,0,0,1,1
1046,conferisce,1,1,0,1
40475,تصبح,0,0,1,1
40474,carrying,0,0,1,1
40473,seferinde,0,0,1,1
1049,specializzate,1,1,0,1
40471,которого,0,0,1,1
40469,vald,0,0,1,1
40467,ansvarig,0,0,1,1
40466,വാക്യത്തിൽ‌,0,0,1,1
40464,besøgende,0,0,1,1
40463,ഇല്ലയോ,0,0,1,1
40462,итоге,0,0,1,1
1051,costituire,1,1,0,1
40480,النشر,0,0,1,1
40456,إهانة,0,0,1,1
40453,« est,0,0,1,1
40451,conflicting,0,0,1,1
1053,settimane,1,1,0,1
40449,وثالث,0,0,1,1
40448,sétimo,0,0,1,1
40444,धन,0,0,1,1
40443,neuf,0,0,1,1
40442,discutido,0,0,1,1
40441,மாணிக்கங்களில்,0,0,1,1
40440,"
विकिमीडिया",0,0,1,1
40439,behandles,0,0,1,1
40437,couche,0,0,1,1
40479,மாலில்,0,0,1,1
40482,« apprendre »,0,0,1,1
40522,ലഭിക്കണമെങ്കിൽ,0,0,1,1
40499,modereras,0,0,1,1
40520,தாக்குதல்,0,0,1,1
40519,ജോസഫ്,0,0,1,1
40517,skapats,0,0,1,1
40515,കാണരുത്,0,0,1,1
40514,algemene,0,0,1,1
40512,vietnamese,0,0,1,1
40511,ಬೆಳೆಯುತ್ತಾಳೆ,0,0,1,1
40510,poderá,0,0,1,1
40507,للإنجليزية,0,0,1,1
40506,philosophe,0,0,1,1
40505,"
irlandês",0,0,1,1
40504,læringen,0,0,1,1
40500,حسناً,0,0,1,1
40498,плагиат,0,0,1,1
40483,anlayamadım,0,0,1,1
40497,darin,0,0,1,1
40496,philippe,0,0,1,1
40495,loosely,0,0,1,1
40494,புத்தகத்தை,0,0,1,1
40492,metric,0,0,1,1
40491,exceeding,0,0,1,1
40490,وسماع,0,0,1,1
40489,التدمير,0,0,1,1
40488,عديم,0,0,1,1
40487,சோகமாகவோ,0,0,1,1
40486,handicapant,0,0,1,1
40485,«obra,0,0,1,1
40484,videnskabeligt,0,0,1,1
40233,temsil,0,0,1,1
40230,സബ്‌സ്‌ക്രൈബുചെയ്യാൻ,0,0,1,1
39902,femme ,0,0,1,1
40070,​​med,0,0,1,1
40023,شديدة,0,0,1,1
40022,foradalei,0,0,1,1
40019,registrado,0,0,1,1
40018,الكهولة,0,0,1,1
40016,croatia,0,0,1,1
40014,നടത്തിയ,0,0,1,1
40013,التحيز,0,0,1,1
40012,biografen,0,0,1,1
40010,εμφανίσεις,0,0,1,1
40009,queries,0,0,1,1
40007,ειδήσεων,0,0,1,1
40006,преувеличить,0,0,1,1
40005,møder,0,0,1,1
40004,dilinde,0,0,1,1
1108,opposti,1,1,0,1
1109,errati,1,1,0,1
40001,spins,0,0,1,1
39999,stuur,0,0,1,1
39998,verbluft,0,0,1,1
39997,تجمع,0,0,1,1
39994,verreweg,0,0,1,1
39993,पांचवीं,0,0,1,1
39992,reprints,0,0,1,1
39989,ഓർമ്മിക്കുകയും,0,0,1,1
39988,ilgilenmiyorum,0,0,1,1
39987,പതിച്ചിരുന്നു,0,0,1,1
39985,المتحدة،,0,0,1,1
39984,historiquement,0,0,1,1
39983,alimentado,0,0,1,1
40025,запрещено,0,0,1,1
40026,favoring,0,0,1,1
40027,നോക്കിയ,0,0,1,1
1102,risultato,1,1,0,1
40066,വർദ്ധച്ചുകൊണ്ടിരിക്കുന്ന,0,0,1,1
1099,spostano,1,1,0,1
40064,httpskryptering,0,0,1,1
40062,necesaria,0,0,1,1
1100,nessuno,1,1,0,1
1101,arbitrale,1,1,0,1
40057,cuantas,0,0,1,1
40056,എന്നെഴുതുന്നു,0,0,1,1
40055,publicitaires,0,0,1,1
40054,प्रतिदिन,0,0,1,1
40053,"
cantonês",0,0,1,1
40052,различному,0,0,1,1
40051,wollte,0,0,1,1
40049,அதற்குப்,0,0,1,1
40028,kalitesi,0,0,1,1
40048,தொகுத்துள்ளார்,0,0,1,1
40045,ругательства,0,0,1,1
40044,mirent,0,0,1,1
40043,ഭക്ഷണമായിരുന്നു,0,0,1,1
1104,volutamente,1,1,0,1
40040,institutions,0,0,1,1
1105,volume,1,1,0,1
40038,поговорим,0,0,1,1
40037,बहुस्तरीय,0,0,1,1
40036,sayısı,0,0,1,1
40033,சிந்திக்க,0,0,1,1
40030,لقاء,0,0,1,1
40029,anförts,0,0,1,1
1110,incredibilmente,1,1,0,1
39980,बिस्तर,0,0,1,1
39979,വിളിക്കാം,0,0,1,1
39921,secondclass,0,0,1,1
39934,évaluations,0,0,1,1
39933,δείπνο,0,0,1,1
39932,الزيارات,0,0,1,1
39931,άκουσε,0,0,1,1
39930,награждения,0,0,1,1
39929,தொடரச்,0,0,1,1
39928,ومشاريع,0,0,1,1
39927,drukne,0,0,1,1
39926,hund,0,0,1,1
39925,"हैं।
",0,0,1,1
39924,n’était,0,0,1,1
39923,"
रूसी",0,0,1,1
39922,bero,0,0,1,1
39918,википроектами,0,0,1,1
39937,religionskritik,0,0,1,1
39916,répète,0,0,1,1
39915,அர்த்தங்கள்,0,0,1,1
39914,എന്നിലുടനീളം,0,0,1,1
39913,वेबसाइट्स,0,0,1,1
39911,தமது,0,0,1,1
1120,guadagno,1,1,0,1
39909,dirt,0,0,1,1
39908,değiştirebilir,0,0,1,1
39907,ನೀಡಲಾಗುತ್ತದೆ,0,0,1,1
39906,والبرتغالية,0,0,1,1
39905,webos,0,0,1,1
39904,vas,0,0,1,1
39903,ഉണ്ടായിരുന്നെങ്കിൽ,0,0,1,1
39936,kramme,0,0,1,1
1119,prefisso,1,1,0,1
1111,priva,1,1,0,1
39962,ഉത്ഭവം,0,0,1,1
39977,αίσθηση,0,0,1,1
1112,fluenti,1,1,0,1
39974,skipped,0,0,1,1
1113,contraddittorie,1,1,0,1
1114,introduction,1,1,0,1
1115,commesso,1,1,0,1
39970,maids,0,0,1,1
39969,ർജ്ജ,0,0,1,1
1116,gravi,1,1,0,1
39966,தொடங்கப்பட்டது,0,0,1,1
39965,запутал,0,0,1,1
39964,എന്തിന്,0,0,1,1
39963,samarbetsprojekt,0,0,1,1
39961,spectroscopy,0,0,1,1
1118,pronunciare,1,1,0,1
39960,രഹസ്യവുമായ,0,0,1,1
39959,preconceitos,0,0,1,1
39957,tænk,0,0,1,1
39956,prachtig,0,0,1,1
39955,violado,0,0,1,1
39954,मुख्यालय,0,0,1,1
39953,visera,0,0,1,1
39951,والعالم،,0,0,1,1
39950,ಅಲಂಕಾರಿಕ,0,0,1,1
39949,rad,0,0,1,1
39947,மூளையைச்,0,0,1,1
39946,elastic,0,0,1,1
39943,ಎಂಬುದನ್ನು,0,0,1,1
40069,circuler,0,0,1,1
40071,appearances,0,0,1,1
40229,répondant,0,0,1,1
40072,fazem,0,0,1,1
40191,έφερα,0,0,1,1
40190,ടെലിഫോൺ,0,0,1,1
40188,ശരിയാണ്,0,0,1,1
40187,представьте,0,0,1,1
40186,καταλαβαίνω,0,0,1,1
40185,embotado,0,0,1,1
40184,வெற்றிகரமாக,0,0,1,1
40182,أستطع,0,0,1,1
40181,упростить,0,0,1,1
40180,searches,0,0,1,1
40179,morceau,0,0,1,1
40176,കത്തിക്കുന്നു,0,0,1,1
40174,contemplados,0,0,1,1
40173,يشغل,0,0,1,1
40172,paralelo»,0,0,1,1
40171,berufserfahrung,0,0,1,1
40170,союзе,0,0,1,1
40169,"
suaíli",0,0,1,1
1086,addestrati,1,1,0,1
40166,sampling,0,0,1,1
40165,канады,0,0,1,1
40164,grants,0,0,1,1
40163,भूलें,0,0,1,1
40162,αλλάξουν,0,0,1,1
40161,d’évaluation,0,0,1,1
40160,nickel,0,0,1,1
40159,മലയാളികളാണ്,0,0,1,1
40158,μιλήσετε,0,0,1,1
40156,مزحة,0,0,1,1
40192,указанные,0,0,1,1
40193,fluidos,0,0,1,1
40194,искусственного,0,0,1,1
40212,connus,0,0,1,1
40228,بقدر,0,0,1,1
40226,manifold,0,0,1,1
40225,viktig,0,0,1,1
40224,balcón,0,0,1,1
40223,stellte,0,0,1,1
40221,πλούτος,0,0,1,1
1082,catturata,1,1,0,1
40219,doel,0,0,1,1
40217,kodeord,0,0,1,1
40216,eukaryotes,0,0,1,1
40215,بأدوار,0,0,1,1
40214,مساهمين,0,0,1,1
40213,gerektirir,0,0,1,1
40209,deselegante,0,0,1,1
40195,الأمور,0,0,1,1
40208,दूं,0,0,1,1
40207,توش،,0,0,1,1
1083,veicoli,1,1,0,1
40205,கருத்தைத்,0,0,1,1
40204,upphovsrätt,0,0,1,1
40203,помимо,0,0,1,1
1084,ispirati,1,1,0,1
40201,مربع,0,0,1,1
40200,संक्षिप्त,0,0,1,1
40199,немецкой,0,0,1,1
40198,ಕೂಡ,0,0,1,1
40197,extensões,0,0,1,1
40196,nagedacht,0,0,1,1
40155,произведён,0,0,1,1
40153,ешь,0,0,1,1
40151,إلا,0,0,1,1
1095,troll,1,1,0,1
40105,αντιμετωπίζονται,0,0,1,1
1092,apparisse,1,1,0,1
40103,symbolicknowledgebased,0,0,1,1
40102,matéria,0,0,1,1
40101,وريجل,0,0,1,1
40100,الأكاديمية,0,0,1,1
40099,கலந்துரையாடல்களுக்குப்,0,0,1,1
1093,sostiene,1,1,0,1
1094,giovanni,1,1,0,1
40096,servicio,0,0,1,1
40095,பெட்டியில்,0,0,1,1
40093,uppfattar,0,0,1,1
40092,τέλειο,0,0,1,1
40089,studded,0,0,1,1
40107,sangue,0,0,1,1
40088,озаглавленный,0,0,1,1
1096,sopra,1,1,0,1
1098,onestamente,1,1,0,1
40085,energydrink,0,0,1,1
40084,typologie,0,0,1,1
40083,atomic,0,0,1,1
40082,അർ‌ത്ഥമാക്കുന്നു,0,0,1,1
40080,drukner,0,0,1,1
40079,doğrudan,0,0,1,1
40078,driver,0,0,1,1
40076,mængde,0,0,1,1
40075,أتلانتيك,0,0,1,1
40074,остановилась,0,0,1,1
40106,അസ്വസ്ഥനാകുന്നത്,0,0,1,1
40108,«сообщество…,0,0,1,1
40149,stcentury,0,0,1,1
40129,webbrowsere,0,0,1,1
40148,yapılması,0,0,1,1
40147,библиотека,0,0,1,1
40145,consola,0,0,1,1
40144,middel,0,0,1,1
40141,nationell,0,0,1,1
40140,modtog,0,0,1,1
1088,imparato,1,1,0,1
1089,delizioso,1,1,0,1
40137,നിർത്തിയെന്നത്,0,0,1,1
40136,ഡിഗ്രിവിദ്യാർത്ഥി,0,0,1,1
40134,മാനദണ്ഡങ്ങൾ,0,0,1,1
1090,ottimo,1,1,0,1
40132,revisar,0,0,1,1
40127,roter,0,0,1,1
40109,kunniga,0,0,1,1
40126,établissements,0,0,1,1
40125,самоорганизацией,0,0,1,1
40124,സ്പാനിഷ്,0,0,1,1
40123,ಪುಸ್ತಕದಲ್ಲಿ,0,0,1,1
40122,αφήσει,0,0,1,1
40121,ausgefallene,0,0,1,1
40120,பிடிக்க,0,0,1,1
40118,dialectique ,0,0,1,1
40116,रणनीति,0,0,1,1
40115,meegebracht,0,0,1,1
40114,പുതിയതായി,0,0,1,1
40112,aspekter,0,0,1,1
40110,أخفقت,0,0,1,1
39130,മൂന്നുപേരും,0,0,1,1
26781,coincided,0,0,1,1
30294,പെരുമഴയാവുകയാണ്,0,0,1,1
13924,slutningen,0,0,1,1
13916,தலைப்புச்,0,0,1,1
13917,ξαφνικά,0,0,1,1
4599,erinnern,0,0,1,1
13919,وتذكر,0,0,1,1
13920,inspirer,0,0,1,1
13923,участник,0,0,1,1
13925,பணிவுடன்,0,0,1,1
13891,ಇಡೀ,0,0,1,1
13927,polémiques,0,0,1,1
13928,независимости»,0,0,1,1
13930,"
फ़िजी",0,0,1,1
13931,ಸುಂದರವಾಗಿದ್ದನ್ನು,0,0,1,1
13932,affedersiniz,0,0,1,1
13933,மூவரும்,0,0,1,1
13915,dificultades,0,0,1,1
13914,വകതിരിക്കാൻ,0,0,1,1
13913,forståelig,0,0,1,1
13912,பகுதிகளில்,0,0,1,1
13909,सम्मानित,0,0,1,1
13908,écrasements,0,0,1,1
13907,നല്കേണ്ട,0,0,1,1
13906,orígenes,0,0,1,1
13905,kochten,0,0,1,1
13902,excesiva,0,0,1,1
13900,εκείνους,0,0,1,1
4600,kullanılmak,0,0,1,1
13898,calúnia,0,0,1,1
13897,αμερόληπτα,0,0,1,1
13896,bulacaksınız,0,0,1,1
13894,contrariée,0,0,1,1
13893,financeiros,0,0,1,1
13934,clubic,0,0,1,1
4598,sohbet,0,0,1,1
13937,documented,0,0,1,1
13959,siguiendo,0,0,1,1
13983,distant,0,0,1,1
4597,åkte,0,0,1,1
13980,optaram,0,0,1,1
13979,приводит,0,0,1,1
13978,lyckades,0,0,1,1
13977,lita,0,0,1,1
13976,ഒരുപക്ഷേ,0,0,1,1
13971,"
सार्डिनियाई",0,0,1,1
13969,actif,0,0,1,1
13967,നിഷ്കളങ്കമായി,0,0,1,1
13964,informella,0,0,1,1
13963,amerikalının,0,0,1,1
13962,modtager,0,0,1,1
13961,صديقتك,0,0,1,1
13957,femhundra,0,0,1,1
13938,दिनों,0,0,1,1
13954,ஆடை,0,0,1,1
13953,имеется,0,0,1,1
13952,قريبا,0,0,1,1
13951,ചെയ്യുന്നില്ല,0,0,1,1
13950,fomentado,0,0,1,1
13949,പ്രവർത്തനങ്ങളിലൂടെ,0,0,1,1
13947,christianisme,0,0,1,1
13946,hice,0,0,1,1
13944,"ജീവശാസ്ത്രം ·
രസതന്ത്രം ·
environmental",0,0,1,1
13943,മാസത്തിൽ,0,0,1,1
13942,magisches,0,0,1,1
13941,internetentreprenören,0,0,1,1
13940,ulsfo,0,0,1,1
13939,обнаружить,0,0,1,1
13892,masiva,0,0,1,1
13889,« réconciliation »,0,0,1,1
13986,لمحاولات,0,0,1,1
4610,മനസ്സിലാക്കുന്നത്,0,0,1,1
13818,японская —,0,0,1,1
13819,sidvisningar,0,0,1,1
13820,beschreibungsfeld,0,0,1,1
13823,zoos,0,0,1,1
13824,verbeter,0,0,1,1
13825,тарелке,0,0,1,1
13827,последняя,0,0,1,1
13888,محادثة؟,0,0,1,1
4609,फरवरी,0,0,1,1
13829,mencionou,0,0,1,1
13830,உலகெங்கிலுமுள்ள,0,0,1,1
13831,запросов,0,0,1,1
13832,prisões,0,0,1,1
13833,இதயத்திற்கு,0,0,1,1
13817,witty,0,0,1,1
4611,deixou,0,0,1,1
13815,المجتمعية،,0,0,1,1
13814,называется,0,0,1,1
13813,инноваторству,0,0,1,1
13812,مكثفة،,0,0,1,1
13811,जावा,0,0,1,1
13810,നല്ലതുപോലെയാണ്,0,0,1,1
13807,eetkamer,0,0,1,1
13806,autonomie,0,0,1,1
13805,paternitépartage,0,0,1,1
13804,традиционных,0,0,1,1
13803,wenigen,0,0,1,1
13802,സംരംഭം,0,0,1,1
13800,spids,0,0,1,1
13799,нравятся,0,0,1,1
13798,प्रतिपादित,0,0,1,1
13834,compraria,0,0,1,1
13836,ನಕಲಿಸಲು,0,0,1,1
13839,എഴുതാവുന്നതുകൊണ്ട്,0,0,1,1
13863,ಪಡೆಯುವುದಿಲ್ಲ,0,0,1,1
13887,أشارت,0,0,1,1
13886,കാണപ്പെടുന്നത്,0,0,1,1
13882,jonger,0,0,1,1
13879,udvise,0,0,1,1
13878,manieren,0,0,1,1
4601,περιγράφεται,0,0,1,1
13876,google​—,0,0,1,1
13875,claros,0,0,1,1
13873,imprecise,0,0,1,1
13872,восхищенные,0,0,1,1
13870,esboços,0,0,1,1
4603,أحمر,0,0,1,1
13867,voluntarily,0,0,1,1
13866,രോഗികളുടെ,0,0,1,1
13862,références »,0,0,1,1
13840,reparera,0,0,1,1
13860,silverbröd,0,0,1,1
13858,പതിപ്പുകളിൽ,0,0,1,1
13856,لصحيفة,0,0,1,1
13855,являлось,0,0,1,1
13854,പോസിറ്റീവും,0,0,1,1
4607,വിവിധഘട്ടങ്ങളെ,0,0,1,1
13852,очевидной,0,0,1,1
13851,nãoficção,0,0,1,1
13849,глобальной,0,0,1,1
13848,оторваться,0,0,1,1
13847,மின்னஞ்சலில்,0,0,1,1
13846,φολιδωτή,0,0,1,1
13845,τέρι,0,0,1,1
13844,detalles,0,0,1,1
13984,amüsanteste,0,0,1,1
13988,renovar,0,0,1,1
13430,financement,0,0,1,1
14117,материала,0,0,1,1
14110,கூட்டாகத்,0,0,1,1
14111,மணமான,0,0,1,1
14112,prémunir,0,0,1,1
14113,orienté,0,0,1,1
14114,испанской,0,0,1,1
14115,averió,0,0,1,1
14121,lgbt,0,0,1,1
14088,recognition،,0,0,1,1
14123,frankrig,0,0,1,1
14125,онлайнсправочников,0,0,1,1
14126,ужин,0,0,1,1
4577,üst,0,0,1,1
14128,directement,0,0,1,1
14130,vidas,0,0,1,1
14109,duda,0,0,1,1
14107,leckersten,0,0,1,1
14106,privilégio,0,0,1,1
14105,للاهتمام,0,0,1,1
14104,rediseñó,0,0,1,1
14103,formulation,0,0,1,1
4578,ισορροπημένες,0,0,1,1
4579,മീറ്റിംഗിന്,0,0,1,1
14099,anticonsenso,0,0,1,1
14098,المفضل,0,0,1,1
14097,adoraria,0,0,1,1
14096,sözcüğünden,0,0,1,1
14094,« pays,0,0,1,1
14093,yiyemiyorum,0,0,1,1
14092,достоверности,0,0,1,1
14091,conventionally,0,0,1,1
14090,ക്രിയയായി,0,0,1,1
14131,malo,0,0,1,1
14133,популярный,0,0,1,1
14135,eleştirmiştir,0,0,1,1
14162,hoparlör,0,0,1,1
14183,அச்சத்தினாலும்,0,0,1,1
14182,കണ്ടെത്തിയാൽ,0,0,1,1
14181,മാനദണ്ഡങ്ങളുപയോഗിച്ചാണ്,0,0,1,1
4569,направляемых,0,0,1,1
4570,வந்த,0,0,1,1
4571,المتوازنة,0,0,1,1
14175,mensajero,0,0,1,1
14173,mantidos,0,0,1,1
14172,مرجعية,0,0,1,1
4573,выборе,0,0,1,1
14169,instituida,0,0,1,1
14168,  cdrom,0,0,1,1
14166,regardant,0,0,1,1
14164,guerre,0,0,1,1
14161,eventuellt,0,0,1,1
14136,παρέα,0,0,1,1
14160,متحيزًا,0,0,1,1
14159,أمره,0,0,1,1
14157,прощения,0,0,1,1
4575,mailinglist,0,0,1,1
14154,управление,0,0,1,1
14152,rockez,0,0,1,1
14151,espagnole,0,0,1,1
14149,സൗന്ദര്യമല്ലാതെ,0,0,1,1
14147,weniger,0,0,1,1
14146,natten,0,0,1,1
14145,lebte,0,0,1,1
14143,ممثلون,0,0,1,1
14141,ebartikel,0,0,1,1
14137,characterizing,0,0,1,1
4580,காண்பீர்கள்,0,0,1,1
14087,പരിപാലിക്കുക,0,0,1,1
13989,rankad,0,0,1,1
14026,बेवकूफी,0,0,1,1
14015,तोड़,0,0,1,1
14016,diffèrent,0,0,1,1
14017,absoluta,0,0,1,1
14020,മഹാരാഷ്ട്രയും,0,0,1,1
14023,évaluant,0,0,1,1
14025,सुनते,0,0,1,1
14027,«wikileaks»​,0,0,1,1
14085,uykusunda,0,0,1,1
4592,صلة،,0,0,1,1
14029,conocidas,0,0,1,1
14030,adapt,0,0,1,1
14031,diferenciar,0,0,1,1
14032,बनाया,0,0,1,1
14033,validation ,0,0,1,1
4594,atacadas,0,0,1,1
14013,nono,0,0,1,1
4595,tills,0,0,1,1
14011,விக்கிப்பீடியாஓர்க்,0,0,1,1
14008,др,0,0,1,1
14007,certainement,0,0,1,1
14006,parvint,0,0,1,1
14004,istiyor,0,0,1,1
14002,aanvullend,0,0,1,1
14001,smaken,0,0,1,1
13999,olmaktan,0,0,1,1
13998,wapediamobi,0,0,1,1
13997,संसद,0,0,1,1
13995,установило,0,0,1,1
13993,água,0,0,1,1
13991,gubernamental,0,0,1,1
13990,epost,0,0,1,1
14035,مصداقيتها,0,0,1,1
14036,суд,0,0,1,1
4591,guían,0,0,1,1
14060,കാണുന്ന,0,0,1,1
14084,പരാമർശിച്ചിട്ടില്ല,0,0,1,1
14083,കുട്ടിക്ക്,0,0,1,1
14081,знак,0,0,1,1
14080,autoencoders,0,0,1,1
14079,ನೋಡುವಾಗ,0,0,1,1
14078,забавное,0,0,1,1
14075,herşey,0,0,1,1
14074,internet ,0,0,1,1
14072,корни,0,0,1,1
14071,നാർസിസയുടെ,0,0,1,1
4581,അഭിമുഖത്തിലോ,0,0,1,1
14066,vêlo,0,0,1,1
14063,άλλαξε,0,0,1,1
4583,incohérences,0,0,1,1
14059,overrasker,0,0,1,1
14038,atteint,0,0,1,1
14056,പറയാമോ,0,0,1,1
4586,turned,0,0,1,1
14054,avancerade,0,0,1,1
14053,yasaklanmasını,0,0,1,1
4587,chronicle,0,0,1,1
14050,निति,0,0,1,1
14049,പൂരകസംവിധാനമായി,0,0,1,1
14048,μηεγκυκλοπαιδικούς,0,0,1,1
14047,"
इतिहासकार",0,0,1,1
14045,ilerlemek,0,0,1,1
14043,وتعددت,0,0,1,1
4588,artikelförfattarna,0,0,1,1
14041,conhecer,0,0,1,1
14039,säkert,0,0,1,1
13797,причинам,0,0,1,1
13795,stödja,0,0,1,1
13794,ορίζουν,0,0,1,1
13550,procès,0,0,1,1
13542,എടുക്കരുത്,0,0,1,1
4643,underground,0,0,1,1
13544,ഡിസന്റ്,0,0,1,1
13545,amateurastronoom,0,0,1,1
13547,terfi,0,0,1,1
4642,profiel,0,0,1,1
13551,développées,0,0,1,1
4647,yapılmaktadır,0,0,1,1
13552,самостоятельно,0,0,1,1
13553,மாற்றங்களையும்,0,0,1,1
13555,умышленно,0,0,1,1
13556,നിർവചനത്തെയാണ്,0,0,1,1
13557,βλέπεις,0,0,1,1
13558,uppdatera,0,0,1,1
13541,ലേഖനങ്ങളായി,0,0,1,1
13540,robótica,0,0,1,1
13539,مدة,0,0,1,1
13538,pub,0,0,1,1
13537,istediğiniz,0,0,1,1
13536,ಚಲನಚಿತ್ರಗಳನ್ನು,0,0,1,1
13535,опытов,0,0,1,1
13534,विशेषकर,0,0,1,1
13531,sıcak,0,0,1,1
13530,cometió,0,0,1,1
13529,algoritmico,0,0,1,1
4644,стрессовых,0,0,1,1
4646,rob,0,0,1,1
13524,അസാധ്യമായ,0,0,1,1
13523,articulation,0,0,1,1
13522,കണ്ടുപിടിക്കലാണ്,0,0,1,1
13521,szl •,0,0,1,1
4640,koyamadığım,0,0,1,1
13561,ταξιδιών,0,0,1,1
13562,representerats,0,0,1,1
13580,σύνδεσμο,0,0,1,1
13595,പുനരാരംഭിക്കാൻ‌,0,0,1,1
13594,புளூமாக்ஸிற்குப்,0,0,1,1
4639,основанием,0,0,1,1
13591,investigador,0,0,1,1
13590,gruwelijk,0,0,1,1
13589,марта,0,0,1,1
13588,επισκεφτούν,0,0,1,1
13587,doutoranda,0,0,1,1
13586,الطلاب,0,0,1,1
13585,spisestuen,0,0,1,1
13584,lesma,0,0,1,1
13583,haydi,0,0,1,1
13582,desacordos,0,0,1,1
13581,открыта,0,0,1,1
13579,ноги,0,0,1,1
13563,tormentosa,0,0,1,1
13578,soplo,0,0,1,1
13577,húngaro,0,0,1,1
13576,utvecklingen,0,0,1,1
13575,കൈവരിക്കാൻ,0,0,1,1
13574,ವೈಫಲ್ಯಗಳ,0,0,1,1
13573,تأسيس,0,0,1,1
13572,caísse,0,0,1,1
13570,مديرو,0,0,1,1
13569,théorique,0,0,1,1
13568,தரக்கணிப்பீட்டு,0,0,1,1
13567,моменткогда,0,0,1,1
13566,webbaserad,0,0,1,1
13565,encyclopedically,0,0,1,1
13564,uttalet,0,0,1,1
13520,wikiexpertsus,0,0,1,1
13517,மாற்றமடையும்,0,0,1,1
13792,gebruiksvriendelijk,0,0,1,1
13462,incierto,0,0,1,1
13455,salvar,0,0,1,1
13456,യന്ത്രപഠനത്തിലാകട്ടെ,0,0,1,1
13457,بلغات,0,0,1,1
13458,publique,0,0,1,1
13459,fordele,0,0,1,1
13460,தேர்வில்,0,0,1,1
13464,necessary,0,0,1,1
13516,सिटिज़नडियम,0,0,1,1
13465,تتحدث,0,0,1,1
13466,മണിക്കൂറിലും,0,0,1,1
13467,repetition,0,0,1,1
13468,பதிலளிக்க,0,0,1,1
13470,يمتلك,0,0,1,1
13472,குரலின்,0,0,1,1
13454,दिलचस्पी,0,0,1,1
13453,peuplements,0,0,1,1
13452,gekleidet,0,0,1,1
4652,ബുദ്ധിശൂന്യതയാണെന്നാണ്,0,0,1,1
4653,فرنسية,0,0,1,1
13448,твёрдым,0,0,1,1
13447,embrasser,0,0,1,1
13444,elección,0,0,1,1
13443,convention,0,0,1,1
4654,δροσερό,0,0,1,1
13440,واستضافة,0,0,1,1
13439,اثنين,0,0,1,1
13438,decidió,0,0,1,1
13436,കരയരുതെന്ന്,0,0,1,1
13434,പറ്റില്ല,0,0,1,1
4655,fêtes,0,0,1,1
13432,نوعا,0,0,1,1
13473,sufrió,0,0,1,1
13474,hoffentlich,0,0,1,1
13475,informó,0,0,1,1
13495,ഫോണ്ട്,0,0,1,1
13515,kız,0,0,1,1
13514,vendría,0,0,1,1
13513,отдельные,0,0,1,1
13512,operadores,0,0,1,1
4648,vatikanen,0,0,1,1
13510,máximo,0,0,1,1
13508,போர்ட்டலுக்குள்,0,0,1,1
13507,பதிக்கப்பட்டிருந்தது,0,0,1,1
13506,stanfordbased,0,0,1,1
4649,wikípedo,0,0,1,1
4650,englischsprachigen,0,0,1,1
13499,ಅಧಿಕೃತ,0,0,1,1
13497,غيغابايت,0,0,1,1
13496,हित,0,0,1,1
13494,அதிகாரத்,0,0,1,1
13476,domestic,0,0,1,1
13493,தூண்டுகிறது,0,0,1,1
13492,тематики,0,0,1,1
13491,ഭാഷകൾ,0,0,1,1
13490,الصراع,0,0,1,1
13489,incommensurables,0,0,1,1
13488,قناة,0,0,1,1
13486,yansımasına,0,0,1,1
13485,declines,0,0,1,1
13483,കരച്ചിൽ,0,0,1,1
13482,espalhar,0,0,1,1
13480,الشعبية,0,0,1,1
13479,ಗ್ಮಾಟ್,0,0,1,1
13478,ಎಲ್ಲದಕ್ಕೂ,0,0,1,1
13477,kombination,0,0,1,1
13600,theorists,0,0,1,1
13601,одет,0,0,1,1
4637,cosmological,0,0,1,1
13735,சந்திப்புக்கு,0,0,1,1
13722,वॉचलिस्ट,0,0,1,1
13727,smartphones,0,0,1,1
13729,разработки,0,0,1,1
4619,exposed,0,0,1,1
13732,chances,0,0,1,1
13733,enojes,0,0,1,1
13736,സത്യവിരുദ്ധമായ,0,0,1,1
13603,supposed,0,0,1,1
13738,αγγλικές,0,0,1,1
13739,produjo,0,0,1,1
13740,серебряный,0,0,1,1
13741,lembrálo,0,0,1,1
13742,серверах,0,0,1,1
13743,مغرورًا,0,0,1,1
4621,இருவருக்கும்,0,0,1,1
13720,algoritmische,0,0,1,1
4622,பலவிதமான,0,0,1,1
13718,stehen,0,0,1,1
13717,dvs,0,0,1,1
13715,gewesen,0,0,1,1
4623,συμφωνήσω,0,0,1,1
13712,ക്ലാസിക്കൽ,0,0,1,1
13710,entscheidungen,0,0,1,1
13708,monobook,0,0,1,1
13707,الميزات,0,0,1,1
13706,αντανάκλαση,0,0,1,1
13705,похожим,0,0,1,1
13704,wilderness—wild,0,0,1,1
13703,articler,0,0,1,1
13702,violents,0,0,1,1
13701,وسيول,0,0,1,1
13744,réservée,0,0,1,1
13745,طلاقة,0,0,1,1
13746,нарушения,0,0,1,1
13764,ernaast,0,0,1,1
4613,plagiat,0,0,1,1
13790,salió,0,0,1,1
13789,لشبكات,0,0,1,1
13787,оставили,0,0,1,1
13786,கோட்டை,0,0,1,1
13785,விரும்பத்தகாத,0,0,1,1
13780,വ്യക്തിപരമായി,0,0,1,1
13777,ويعتمد,0,0,1,1
13776,സ്രോതസ്സ്,0,0,1,1
13775,constituyeron,0,0,1,1
13771,التجاري,0,0,1,1
13770,персонажами,0,0,1,1
13768,kapitalistiska,0,0,1,1
13765,അടിക്കുന്നു,0,0,1,1
13763,जुलती,0,0,1,1
13748,soldado,0,0,1,1
13762,തുടക്കത്തിൽ,0,0,1,1
13761,إثارة,0,0,1,1
13760,norvégien,0,0,1,1
13759,классную,0,0,1,1
13758,imprimables,0,0,1,1
4617,foregår,0,0,1,1
13756,центральных,0,0,1,1
13755,assert,0,0,1,1
13754,expertas,0,0,1,1
13753,tilted,0,0,1,1
13752,omhelzen,0,0,1,1
13751,ತಾಯಿಯಾಗಿದ್ದು,0,0,1,1
13750,മനസാണ്,0,0,1,1
13749,independiente,0,0,1,1
13699,anfragen,0,0,1,1
13698,agent,0,0,1,1
13697,مسؤولون,0,0,1,1
13622,iseniz,0,0,1,1
13643,снилось,0,0,1,1
13642,ചെയ്തതിന്,0,0,1,1
13641,текстового,0,0,1,1
13640,odds,0,0,1,1
13637,användarnas,0,0,1,1
13636,companhia,0,0,1,1
13635,indique,0,0,1,1
13634,ими,0,0,1,1
13632,« good,0,0,1,1
13630,സഹായിക്കാനായി,0,0,1,1
13628,θετικό,0,0,1,1
13626,обедом,0,0,1,1
4635,வழங்கப்போகிறேன்,0,0,1,1
13623,güzellerdi,0,0,1,1
13621,существительных,0,0,1,1
13645,വരുമ്പോൾ,0,0,1,1
13620,قليلة,0,0,1,1
13619,raises,0,0,1,1
13617,زاوية,0,0,1,1
13616,herhaalt,0,0,1,1
13615,faitesmoi,0,0,1,1
13614,आठ,0,0,1,1
13613,такое,0,0,1,1
4636,stanislas,0,0,1,1
13611,أذكرك,0,0,1,1
13610,disséquées,0,0,1,1
13608,educated,0,0,1,1
13607,ശ്രദ്ധിക്കുന്നു,0,0,1,1
13606,talere,0,0,1,1
13605,ചെയ്ത,0,0,1,1
13644,domestiques,0,0,1,1
13649,αμβλείος,0,0,1,1
13696,ഇന്നും,0,0,1,1
13674,enfaticamente,0,0,1,1
13695,theories,0,0,1,1
13694,ಕೈದಿಗಳಿಗೆ,0,0,1,1
13690,expertgenererat,0,0,1,1
13688,അറിയാമോ,0,0,1,1
4624,kararının,0,0,1,1
4625,reikte,0,0,1,1
13685,consigo,0,0,1,1
13684,​​enkele,0,0,1,1
13683,costumamos,0,0,1,1
13682,காதலி,0,0,1,1
13681,"
दूसरा",0,0,1,1
13680,"
भोजपुरी",0,0,1,1
13679,exposiciones,0,0,1,1
13676,അസ്വസ്ഥമാകരുത്,0,0,1,1
13673,tentativa,0,0,1,1
4627,uppenbart,0,0,1,1
13670,pensamiento,0,0,1,1
13669,بتصميم,0,0,1,1
13668,ಎಲ್ಲವು,0,0,1,1
13664,പലതുള്ളി,0,0,1,1
13662,comedic,0,0,1,1
13661, ,0,0,1,1
13660,tarjetas,0,0,1,1
13659,തൂപ്പുകാരുമാണ്,0,0,1,1
13658,села,0,0,1,1
13657,ειδήσεις,0,0,1,1
13656,trophy,0,0,1,1
13653,ανόητο,0,0,1,1
13652,ഭാഗ്യവാൻ,0,0,1,1
13651,disagreeing,0,0,1,1
14184,учётной,0,0,1,1
14185,coincé,0,0,1,1
14186,بالتالي,0,0,1,1
14693,एईजेसब्रांड,0,0,1,1
14683,അംഗീകരിക്കപ്പെട്ടിരിക്കുന്ന,0,0,1,1
14684,combinou,0,0,1,1
14686,enviarei,0,0,1,1
14688,δίνω,0,0,1,1
14690,sete,0,0,1,1
14691,pornographically,0,0,1,1
4492,predictivo,0,0,1,1
14658,ubicó,0,0,1,1
14695,ونميل,0,0,1,1
4491,പൂർത്തിയാക്കട്ടെ,0,0,1,1
14698,звук,0,0,1,1
14699,lesser,0,0,1,1
14700,utsatt,0,0,1,1
14701,reproducción,0,0,1,1
14682,gillat,0,0,1,1
14681,ആവശ്യത്തിന്,0,0,1,1
14680,onmiddellijk,0,0,1,1
14679,chanceux,0,0,1,1
4493,αντίθετο,0,0,1,1
14676,ಭೀಕರ,0,0,1,1
4495,bekijken,0,0,1,1
4496,файлы,0,0,1,1
14673,værre,0,0,1,1
14670,ಪಾಠದಲ್ಲಿ,0,0,1,1
14669,ledigt,0,0,1,1
14668,anlamları,0,0,1,1
14667,boven,0,0,1,1
14666,favoriet,0,0,1,1
4497,ಫ್ಲಮ್ಮೋಕ್ಸ್ಡ್,0,0,1,1
14664,теоретическим,0,0,1,1
14662,ദൂരവ്യാപകമായി,0,0,1,1
14704,datasets,0,0,1,1
14706,apologizing,0,0,1,1
14707,латинский,0,0,1,1
14733,opérationnelle,0,0,1,1
14756,schlecht,0,0,1,1
14755,treffpunkt,0,0,1,1
14754,seventh,0,0,1,1
14753,பங்களிப்புக்களை,0,0,1,1
14752,चाहता।,0,0,1,1
14751,seixas,0,0,1,1
4485,reisen,0,0,1,1
14748,नोट,0,0,1,1
14747,poids,0,0,1,1
14744,unconscious,0,0,1,1
14742,والـ,0,0,1,1
4486,cahiers,0,0,1,1
14737,വിജയിച്ചാൽ,0,0,1,1
14734,رغم,0,0,1,1
14730,informative,0,0,1,1
14708,olgulara,0,0,1,1
14729,ошеломленным,0,0,1,1
14728,persoonlijk,0,0,1,1
14727,متنوع،,0,0,1,1
14726,هما,0,0,1,1
14725,conspirar,0,0,1,1
14724,βαρετό,0,0,1,1
14723,librement,0,0,1,1
14720,nordpertinence,0,0,1,1
14719,combiné,0,0,1,1
14718,existía,0,0,1,1
14716,goudgoud,0,0,1,1
14715,നിർമ്മാണം,0,0,1,1
4489,ಹಣವಿದೆ,0,0,1,1
14712,ahnung,0,0,1,1
14660,ശാഖയുടെ,0,0,1,1
14657,popüler,0,0,1,1
4517,दें,0,0,1,1
14599,قسم,0,0,1,1
14589,கொண்டு,0,0,1,1
14593,davam,0,0,1,1
14594,estender,0,0,1,1
14595,انتهي,0,0,1,1
4510,encoding,0,0,1,1
14598,hüzünlü,0,0,1,1
14600,हल्का,0,0,1,1
14656,infeliz,0,0,1,1
14601,போன்றவற்றிலிருந்து,0,0,1,1
14602,персонаж,0,0,1,1
4509,avdelning,0,0,1,1
14604,ಮೊಂಡಾದದ್ದನ್ನು,0,0,1,1
14606,तिहाई,0,0,1,1
14607,bayer,0,0,1,1
14588,"
तेलुगू",0,0,1,1
14587,fru,0,0,1,1
14585,adapted,0,0,1,1
14583,verhalten,0,0,1,1
14582,notice,0,0,1,1
14581,கட்டுரையொன்றை,0,0,1,1
14580,súper,0,0,1,1
14579,parametrar,0,0,1,1
14575,ಉತ್ತಮವಾಗಿರುತ್ತದೆ,0,0,1,1
14574,വലിച്ചിടുന്നതോ,0,0,1,1
4514,kostte,0,0,1,1
14572,clés,0,0,1,1
4515,schönes,0,0,1,1
14567,eras,0,0,1,1
14566,வேண்டியதெல்லாம்,0,0,1,1
14565,وبالنسبة,0,0,1,1
14564,المائدة,0,0,1,1
14608,alojado,0,0,1,1
14610,തരുന്നതതാണ്,0,0,1,1
14612,нами,0,0,1,1
14638,البعض،,0,0,1,1
14655,identitet,0,0,1,1
14654,anställa,0,0,1,1
14653,പരസ്പരവിരുദ്ധമായ,0,0,1,1
14652,chien,0,0,1,1
14651,പത്രവാർത്തകളും,0,0,1,1
4498,बनाते,0,0,1,1
14649,плакал,0,0,1,1
14648,funcionalidade,0,0,1,1
14646,assurent,0,0,1,1
14644,realización,0,0,1,1
14642,homo,0,0,1,1
14641,elegante,0,0,1,1
14640,revertidas,0,0,1,1
14639,воздействий,0,0,1,1
14637,المطور,0,0,1,1
14613,أجل,0,0,1,1
14636,övrigt,0,0,1,1
14635,ಉಡುಪಿನಲ್ಲಿದ್ದಾಗ,0,0,1,1
14633,—incluidos,0,0,1,1
4500,qu’en,0,0,1,1
14629,takımın,0,0,1,1
14628,wikinotícias,0,0,1,1
14627,misspellings,0,0,1,1
4504,बचाव,0,0,1,1
4505,خدمة,0,0,1,1
14621,объектов,0,0,1,1
14620,ಕುಳಿತಿದ್ದ,0,0,1,1
14618,programında,0,0,1,1
14617,cumplimiento,0,0,1,1
14616,உசாத்துணைப்,0,0,1,1
4484,damerna,0,0,1,1
4483,വാർത്തയിൽ,0,0,1,1
14760,വിറ്റതെന്ന്,0,0,1,1
14892,påminna,0,0,1,1
14884,elite,0,0,1,1
14885,региональные,0,0,1,1
14888,réussir,0,0,1,1
14889,تجاهل,0,0,1,1
4469,قدم,0,0,1,1
14891,നിർവചിക്കണം,0,0,1,1
14893,ointelligent,0,0,1,1
14761,"
अन्यथा",0,0,1,1
14894,dozens,0,0,1,1
14895,iniciar,0,0,1,1
14896,infiniment,0,0,1,1
14897,новости,0,0,1,1
4468,opponent,0,0,1,1
14903,तुलनात्मक,0,0,1,1
14883,marié,0,0,1,1
14882,miembro»,0,0,1,1
14881,மாதங்கள்,0,0,1,1
14878,मिले,0,0,1,1
14877,gathered,0,0,1,1
14876,conserving,0,0,1,1
14875,ലേഖനമെഴുതാനുദ്ദേശിക്കുന്ന,0,0,1,1
14874,умным,0,0,1,1
14871,κεφάλι,0,0,1,1
14868,ومخيف,0,0,1,1
14867,caracteres,0,0,1,1
14866,geçiyor,0,0,1,1
4471,unutma,0,0,1,1
14863,rit,0,0,1,1
14862,behandelt,0,0,1,1
14861,يعد,0,0,1,1
14860,ഇരുവർക്കും,0,0,1,1
14904,enviar,0,0,1,1
14906,sexuada,0,0,1,1
14909,சாங்கரால்,0,0,1,1
14933,responding,0,0,1,1
14951,تقل,0,0,1,1
14949,introduite,0,0,1,1
14947,lider,0,0,1,1
14946,vues,0,0,1,1
14945,ಪಿಜ್ಜಾ,0,0,1,1
14944,زعم,0,0,1,1
4460,basingstoke,0,0,1,1
14942,спала,0,0,1,1
4462,выучить,0,0,1,1
14940,तस्वीरें,0,0,1,1
14938,الثروات,0,0,1,1
14937,vackra,0,0,1,1
14936,எல்லாக்,0,0,1,1
14935,बधाई,0,0,1,1
14932,textonly,0,0,1,1
14910,atravesó,0,0,1,1
14931,diles,0,0,1,1
14930,dukker,0,0,1,1
14928,piloté,0,0,1,1
14926,examensrapporter,0,0,1,1
14924,istemeyeceğini,0,0,1,1
14923,tidningen,0,0,1,1
14922,иллинойс,0,0,1,1
4464,redistributing,0,0,1,1
14918,luck,0,0,1,1
14917,решались,0,0,1,1
14916,تعديله,0,0,1,1
14913,underartiklar,0,0,1,1
4465,σταυρωμένα,0,0,1,1
14911,autoclavagem,0,0,1,1
14859,лучшее,0,0,1,1
14858,ഉറപ്പായിട്ടും,0,0,1,1
14857,previsões,0,0,1,1
14780,σπασμένη,0,0,1,1
14799,ನಿಧಾನಗೊಳಿಸುತ್ತದೆ,0,0,1,1
14798,сомнительными,0,0,1,1
14797,infört,0,0,1,1
14796,ಬಂದಿದ್ದೇನೆ,0,0,1,1
4479,"
हंगेरियाई",0,0,1,1
14794,votações,0,0,1,1
14791,ವಾಟ್ಸಾಪ್,0,0,1,1
14790,wann,0,0,1,1
14789,unutuyor,0,0,1,1
14788,deveriam,0,0,1,1
14787,capítulos,0,0,1,1
14786,stuck,0,0,1,1
14783,नान,0,0,1,1
14781,कैसी,0,0,1,1
4480,casser,0,0,1,1
14801,estímulo,0,0,1,1
14778,distu,0,0,1,1
14777,يضيء,0,0,1,1
14776,femenino,0,0,1,1
14775,capturar,0,0,1,1
14773,ತಿಳಿದಿದ್ದರಿಂದ,0,0,1,1
14772,esquecem,0,0,1,1
14771,exata,0,0,1,1
4481,rappelezvous,0,0,1,1
14769,smiling,0,0,1,1
14768,"ethics ·
environmental",0,0,1,1
14767,extensive,0,0,1,1
4482,ψεύτικο,0,0,1,1
14765,concours,0,0,1,1
14763,επιτυχής,0,0,1,1
14800,ತನ್ನನ್ನು,0,0,1,1
14802,sammanfattade,0,0,1,1
14856,प्रतियोगिता,0,0,1,1
14833,secretive,0,0,1,1
14855,henvender,0,0,1,1
14853,användaridentitet,0,0,1,1
14852,zamanı,0,0,1,1
14851,fared,0,0,1,1
14848,ζεστό,0,0,1,1
4474,"
डीलीट",0,0,1,1
4475,அறிவும்,0,0,1,1
14842,inhuren,0,0,1,1
14841,ದೀರ್ಘಕಾಲದವರೆಗೆ,0,0,1,1
14840,olhou,0,0,1,1
4476,साइटने,0,0,1,1
14837,littéral,0,0,1,1
14836,يهتم,0,0,1,1
14834,நுழைந்தார்கள்,0,0,1,1
14830,eenmaal,0,0,1,1
14804,शुक्रिया।,0,0,1,1
14828,surgir,0,0,1,1
14821,bodde,0,0,1,1
14820,إيه,0,0,1,1
14819,केस,0,0,1,1
14818,பழக்கவழக்கங்கள்,0,0,1,1
14817,drömmamma,0,0,1,1
14814,diversité,0,0,1,1
14812,صاغ,0,0,1,1
14811,eğitim,0,0,1,1
4477,​​vraag,0,0,1,1
14809,surpreender,0,0,1,1
14808,gehouden,0,0,1,1
14806,вопросительным,0,0,1,1
14805,úteis,0,0,1,1
14563,yöntemleri,0,0,1,1
4519,validated,0,0,1,1
14187,participa,0,0,1,1
4549,d’avoir,0,0,1,1
14306,отражаться,0,0,1,1
4552,ಯೋಚಿಸಿ,0,0,1,1
14309,estu,0,0,1,1
14310,scharfe,0,0,1,1
4550,ಸಮತೋಲಿತ,0,0,1,1
14314,regardé,0,0,1,1
14318,manifestations,0,0,1,1
14281,जानने,0,0,1,1
14321,மற்றவர்களிடம்,0,0,1,1
14322,childcare,0,0,1,1
14323,biyografi,0,0,1,1
14324,കാര്യനിർവ്വാഹകരുടെ,0,0,1,1
14325,platt,0,0,1,1
14326,أقدم,0,0,1,1
14305,വിക്കിയിൽ,0,0,1,1
14304,contratarte,0,0,1,1
14303,afbryde,0,0,1,1
14302,preguntaron,0,0,1,1
14301,bezoek,0,0,1,1
14299,bevakar,0,0,1,1
14295,kans,0,0,1,1
14294,indonesian,0,0,1,1
14292,reversiones,0,0,1,1
14291,prompted,0,0,1,1
14290,дампа,0,0,1,1
14288,hissediyorum,0,0,1,1
14287,lehrer,0,0,1,1
14286,ιππότης,0,0,1,1
14285,curta,0,0,1,1
14284,özensizlik,0,0,1,1
14283,istersen,0,0,1,1
14328,أغسطس،,0,0,1,1
14329,relativos,0,0,1,1
14330,കഴിക്കുന്നു,0,0,1,1
14352,sevdiğini,0,0,1,1
14377,متوازن,0,0,1,1
14376,automatiques,0,0,1,1
14373,минуту,0,0,1,1
14372,japanska,0,0,1,1
14369,ಹೇಳೋಣ,0,0,1,1
14368,outlining,0,0,1,1
14367,περιγραφής,0,0,1,1
14366,வகையை,0,0,1,1
14364,വിരസമാണ്,0,0,1,1
14360,çoğu,0,0,1,1
14359,അസൈൻമെന്റുകളിൽ,0,0,1,1
14357,tomasz,0,0,1,1
14356,தளையறு,0,0,1,1
14353,ಖಂಡಿತ,0,0,1,1
14351,croissante,0,0,1,1
14333,«андрушевской,0,0,1,1
14350,basket,0,0,1,1
14349,consta,0,0,1,1
14348,ऊपरी,0,0,1,1
4548,എന്ത്,0,0,1,1
14346,denen,0,0,1,1
14345,instans,0,0,1,1
14344,أخرى؟,0,0,1,1
14342,frozen,0,0,1,1
14341,पोस्टिंग,0,0,1,1
14340,വെയ്കാനും,0,0,1,1
14337,bibliothek,0,0,1,1
14336,ಅತ್ಯುತ್ತಮವಾದದ್ದು,0,0,1,1
14335,controvertidos​,0,0,1,1
14334,மரகதங்களின்,0,0,1,1
14282,keskinliği,0,0,1,1
14280,téléchargeables,0,0,1,1
14560,வாக்கியத்தில்,0,0,1,1
14221,القديم,0,0,1,1
14213,உருவாக்குகிறது,0,0,1,1
14214,सर्वाधिक,0,0,1,1
14216,verwarren,0,0,1,1
14218,africano,0,0,1,1
14219,arrêtait,0,0,1,1
14220,δεξιά,0,0,1,1
14222,cuba,0,0,1,1
14279,तुरंत,0,0,1,1
4564,употребляемое,0,0,1,1
14227,preocupaba,0,0,1,1
4563,троллями,0,0,1,1
14229,വന്നത്,0,0,1,1
14230,elektronisk,0,0,1,1
14231,поняли,0,0,1,1
14212,computerprogrammeur,0,0,1,1
14210,உருவாக்கியுள்ளது,0,0,1,1
14208,intressanta,0,0,1,1
14205,vetting,0,0,1,1
4565,"
ख्मेर",0,0,1,1
14203,சாலடுகள்,0,0,1,1
14200,surprise,0,0,1,1
14199,uitlegde,0,0,1,1
14198,പാവയും,0,0,1,1
4566,വസ്ത്രത്തിൽ,0,0,1,1
14196,aldığınızda,0,0,1,1
14195,παγκόσμιο,0,0,1,1
14194,дням,0,0,1,1
14192,признаете,0,0,1,1
14191,pierres,0,0,1,1
14190,transport,0,0,1,1
4567,المجلات,0,0,1,1
14232,வைக்கிறேன்,0,0,1,1
14233,عيوب,0,0,1,1
4562,εξετάσεις,0,0,1,1
14260,ಬೆರಗುಗೊಳಿಸುತ್ತದೆ,0,0,1,1
14278,désormais,0,0,1,1
14277,uitzonderlijk,0,0,1,1
4554,destacados,0,0,1,1
14275,أسأل,0,0,1,1
14274,ഓണത്തെപ്പറ്റി,0,0,1,1
14272,comprometido,0,0,1,1
14271,autorisé,0,0,1,1
14270,schauen,0,0,1,1
14269,« facebook »,0,0,1,1
4555,palavrasraiz,0,0,1,1
14266,volken,0,0,1,1
14265,genstand,0,0,1,1
14263,mh,0,0,1,1
14261,ഇക്കാരണം,0,0,1,1
14259,الاعتماد،,0,0,1,1
4561,wikimediaprojekten,0,0,1,1
14258,prétendants,0,0,1,1
4557,yatağa,0,0,1,1
14254,endereço,0,0,1,1
14253,забираете,0,0,1,1
14252,oublie,0,0,1,1
4558,newsletter,0,0,1,1
14250,данными,0,0,1,1
14249,العشاء,0,0,1,1
14248,അഹംഭാവമുള്ള,0,0,1,1
14246,sırrı,0,0,1,1
14243,egotistical,0,0,1,1
14241,डूबना,0,0,1,1
14240,fonde,0,0,1,1
14239,அதே,0,0,1,1
14378,poliment,0,0,1,1
14379,opgewonden,0,0,1,1
14380,классификаторы,0,0,1,1
14504,acelerado,0,0,1,1
14495,высмеивают,0,0,1,1
4527,intimement,0,0,1,1
14499,competitive,0,0,1,1
14500,infieren,0,0,1,1
14501,technieken,0,0,1,1
4526,joint,0,0,1,1
4525,nätgemenskap,0,0,1,1
14381,опасения,0,0,1,1
14506,mecaniste,0,0,1,1
14507,ήρθα,0,0,1,1
14508,simple •,0,0,1,1
14509,görkemli,0,0,1,1
14512,λίθους,0,0,1,1
14513,αμερόληπτη,0,0,1,1
4529,എന്നിവയൊക്കെ,0,0,1,1
14493,iron,0,0,1,1
14491,زيارات,0,0,1,1
14490,production ,0,0,1,1
4530,wikipedia »,0,0,1,1
14487,написать,0,0,1,1
14486,نظرك,0,0,1,1
14485,مساءً,0,0,1,1
14484,ಎದೆಗುಂದಿದಳು,0,0,1,1
14483,والسياسية,0,0,1,1
14482,платьев,0,0,1,1
14481,कॉपीलेफ्ट,0,0,1,1
14479,wikinoticias,0,0,1,1
14478,sujetb,0,0,1,1
14477,desnecessário,0,0,1,1
14476,häufiges,0,0,1,1
4531,respectivas,0,0,1,1
14514,ഉദാഹരണം,0,0,1,1
14515,anlatırken,0,0,1,1
14516,rusa—,0,0,1,1
14541,instaladas,0,0,1,1
14559,पुनर्वितरण,0,0,1,1
14557,neerzet,0,0,1,1
4520,¿verdad,0,0,1,1
14554,διέσχισαν,0,0,1,1
4521,izinli,0,0,1,1
14551,separación,0,0,1,1
14550,эксперимента,0,0,1,1
14549,arrivée,0,0,1,1
14548,энергией,0,0,1,1
14547,അഭിനയിക്കുന്നവരാരെല്ലാം,0,0,1,1
14546,geschehen,0,0,1,1
4522,നിയമസംഹിതയോ,0,0,1,1
14543,пришел,0,0,1,1
14542,പ്രശ്നങ്ങളൊന്നും,0,0,1,1
14540,മറന്നതിനാൽ,0,0,1,1
14517,названный,0,0,1,1
14538,нанесён,0,0,1,1
14536,trafik,0,0,1,1
14534,​​for,0,0,1,1
14531,لطيفين,0,0,1,1
4524,trouvent,0,0,1,1
14529,الطلبات,0,0,1,1
14528,"
वेब",0,0,1,1
14526,предоставлением,0,0,1,1
14525,récuse,0,0,1,1
14523,anfang,0,0,1,1
14522,ρωτώ,0,0,1,1
14520,usálo,0,0,1,1
14519,الدعم,0,0,1,1
14518,clou,0,0,1,1
14474,blicke,0,0,1,1
14473,ресторан,0,0,1,1
4532,авторы,0,0,1,1
14399,информацию»,0,0,1,1
14419,schaut,0,0,1,1
14418,underbart,0,0,1,1
14417,vb,0,0,1,1
14416,αντίχειρες,0,0,1,1
14415,கேட்டிருக்கலாம்,0,0,1,1
14414,ассоциации,0,0,1,1
14410,многими,0,0,1,1
14409,обобщённой,0,0,1,1
14408,ficamos,0,0,1,1
14405,gigaoctets,0,0,1,1
14404,anime,0,0,1,1
14403,скачивания,0,0,1,1
14402,péjorative,0,0,1,1
14401,glædeligt,0,0,1,1
14398,sumado,0,0,1,1
14424,yazdıkları,0,0,1,1
14397,उपसमुच्चय,0,0,1,1
14396,mandou,0,0,1,1
14394,forests,0,0,1,1
14393,معاديًا,0,0,1,1
4542,verloop,0,0,1,1
14391,ഭൂരിപക്ഷം,0,0,1,1
4543,μεταφορά,0,0,1,1
14389,πρόσβασής,0,0,1,1
14388,கோணமாகும்,0,0,1,1
14386,अवलोकित,0,0,1,1
14385,magnétique,0,0,1,1
14384,punhado,0,0,1,1
14383,mesafede,0,0,1,1
4544,gelächelt,0,0,1,1
14423,நடுநிலைமையை,0,0,1,1
14425,ನೇಮಿಸಿಕೊಳ್ಳಬೇಕು,0,0,1,1
14471,എന്നതിൽ,0,0,1,1
14450,مرصعة,0,0,1,1
14470,nessas,0,0,1,1
14468,சுற்றுலாப்,0,0,1,1
14465,reconoce,0,0,1,1
14463,bekler,0,0,1,1
14462,denunciado,0,0,1,1
14461,ಜಿಗಿದರೆ,0,0,1,1
14460,schrok,0,0,1,1
14459,repetitive,0,0,1,1
4534,bird,0,0,1,1
4535,சரியா,0,0,1,1
14455,العمومية,0,0,1,1
14453,slovaque,0,0,1,1
14452,karıştırdım,0,0,1,1
14451,ladies,0,0,1,1
4536,nãowiki,0,0,1,1
14426,αναφέρονται,0,0,1,1
14447,demanda,0,0,1,1
14446,escritura,0,0,1,1
14445,небольшие,0,0,1,1
14442,للمناقشة,0,0,1,1
4537,προτού,0,0,1,1
14440,timen,0,0,1,1
14438,assisté,0,0,1,1
14437,έχουν,0,0,1,1
14436,ويليز,0,0,1,1
4538,αλλάξει,0,0,1,1
14432,vitalist,0,0,1,1
14430,നടത്തുന്നതിനാണ്,0,0,1,1
14429,ethics,0,0,1,1
14427,dækker,0,0,1,1
13431,полезным,0,0,1,1
13427,ಪ್ರಯಾಣವನ್ನು,0,0,1,1
14954,करेगी,0,0,1,1
12415,χρησιμοποιημένη,0,0,1,1
12408,собираюсь,0,0,1,1
12410,baker,0,0,1,1
12411,കുറിച്ചും,0,0,1,1
12412,determinando,0,0,1,1
12413,βυθίζεται,0,0,1,1
12414,χτυπάτε,0,0,1,1
12417,ಬಡ್ತಿ,0,0,1,1
12382,മാനഭംഗക്കേസുകളിൽ,0,0,1,1
12418,daquele,0,0,1,1
12419,hazırlanan,0,0,1,1
12420,kennedy,0,0,1,1
12421,vehicles,0,0,1,1
12423,மேற்பார்வையிடல்களுக்குப்,0,0,1,1
4781,அன்பான,0,0,1,1
12407,—alrededor,0,0,1,1
12405,träffas,0,0,1,1
12403,क्रम,0,0,1,1
12402,вела,0,0,1,1
12401,risos,0,0,1,1
12400,надёжность,0,0,1,1
12399,drückt,0,0,1,1
12398,prêter,0,0,1,1
12394,episkt,0,0,1,1
12393,المسكينة,0,0,1,1
12392,artikelmaterial,0,0,1,1
12391,werkervaring,0,0,1,1
12390,шесть,0,0,1,1
12388,صديقين,0,0,1,1
12387,corridors,0,0,1,1
12385,призваны,0,0,1,1
12384,американских,0,0,1,1
12426,plagiarism,0,0,1,1
12428,düğmesini,0,0,1,1
4780,félicitations,0,0,1,1
12453,दें।,0,0,1,1
12471,وطعمه,0,0,1,1
12470,अनुभाग,0,0,1,1
12468,ಸಂತೋಷ,0,0,1,1
12467,മങ്ങിയ,0,0,1,1
12465,entropía,0,0,1,1
12464,izlerken,0,0,1,1
12463,eventuele,0,0,1,1
12462,equipped,0,0,1,1
12461,ನಿಜವಾದ,0,0,1,1
12460,argument,0,0,1,1
12458,jardín,0,0,1,1
12456,motkultur,0,0,1,1
4776,roupa,0,0,1,1
12454,negligenciáveis,0,0,1,1
12452,eerlijk,0,0,1,1
12432,turistin,0,0,1,1
4777,bazar,0,0,1,1
12450,تشرفت,0,0,1,1
12449,فعله,0,0,1,1
12448,encontrará,0,0,1,1
12446,rotulada,0,0,1,1
12445,minutes »,0,0,1,1
12444,മായ്ച്ചുകളയുന്നതും,0,0,1,1
12442,diecisiete,0,0,1,1
12441,वित्त,0,0,1,1
12440,കുറ്റകരമായ,0,0,1,1
4778,bénéficient,0,0,1,1
12437,mogelijk,0,0,1,1
12436,parallèlement,0,0,1,1
12435,termes,0,0,1,1
12383,departure,0,0,1,1
12381,compactness,0,0,1,1
12473,dichotomiquement,0,0,1,1
12324,ro •,0,0,1,1
12312,arbitraje,0,0,1,1
12316,شاهدها,0,0,1,1
12317,качаетесь,0,0,1,1
12318,déclarer,0,0,1,1
12319,написал,0,0,1,1
4793,contém,0,0,1,1
12325,achèterais,0,0,1,1
12380,federais,0,0,1,1
12326,ഡച്ച്,0,0,1,1
4792,constructivos,0,0,1,1
12328,ക്ലസ്റ്ററിംഗ്,0,0,1,1
12329,neuroscience,0,0,1,1
12330,внесёнными,0,0,1,1
12331,ಪದಕ್ಕೆ,0,0,1,1
12309,ηλεκτρονική,0,0,1,1
12306,kvartal,0,0,1,1
12305,தூங்கும்போது,0,0,1,1
12304,chain,0,0,1,1
12303,മാതൃകകളെ,0,0,1,1
12301,années »,0,0,1,1
12300,ужасна,0,0,1,1
12297,immediate,0,0,1,1
12296,destacando,0,0,1,1
12295,എടുത്തു,0,0,1,1
12294,climatique,0,0,1,1
12293,adorerais,0,0,1,1
12292,المنزلي,0,0,1,1
12291,zomer,0,0,1,1
12290,profuse,0,0,1,1
12288,backpropagated,0,0,1,1
12287,hybrides,0,0,1,1
12332,preguntarte,0,0,1,1
4791,വിശ്വസിക്കുന്നവരിപ്പോൾ,0,0,1,1
12335,casarse,0,0,1,1
4786,hawaii,0,0,1,1
4784,சலிப்பாக,0,0,1,1
12377,отменить,0,0,1,1
12376,uniform,0,0,1,1
12374,geloven,0,0,1,1
4785,pixelgrootte,0,0,1,1
12369,canales,0,0,1,1
12368,تحلم,0,0,1,1
12367,propuestas,0,0,1,1
12365,составление,0,0,1,1
12364,επικό,0,0,1,1
12363,ಮಾಂಸದ,0,0,1,1
12362,projeler,0,0,1,1
12361,gelişimini,0,0,1,1
12360,tomado,0,0,1,1
12354,ഒന്നിച്ച്,0,0,1,1
12336,internautas,0,0,1,1
12353,நிறுத்த,0,0,1,1
12352,préoccupe,0,0,1,1
12350,motivations,0,0,1,1
12349,بإصلاح,0,0,1,1
12348,presentan,0,0,1,1
12347,ابق,0,0,1,1
12346,പ്രാധാന്യമുണ്ട്,0,0,1,1
12345,nævnt,0,0,1,1
12344,उपडोमेन,0,0,1,1
12343,nie,0,0,1,1
4788,இணைப்பை,0,0,1,1
12341,വംശജരെക്കാളും,0,0,1,1
4789,altruista—,0,0,1,1
12337,समुच्चय,0,0,1,1
12472,കാണപ്പെട്ടു,0,0,1,1
12474,والآخر,0,0,1,1
13425,интервью,0,0,1,1
4764,envisager,0,0,1,1
12594,மேற்பார்வையின்,0,0,1,1
12597,copo,0,0,1,1
12598,équilibrés,0,0,1,1
12599,membre,0,0,1,1
12601,نذهب,0,0,1,1
12602,roles,0,0,1,1
12604,திருமணத்தில்,0,0,1,1
12572,മൂലയിൽത്തന്നെ,0,0,1,1
12605,valeurs…,0,0,1,1
12607,squelette,0,0,1,1
12608,favoriete,0,0,1,1
12610,وإحلال,0,0,1,1
12612,drunkning,0,0,1,1
12613,المحررين،,0,0,1,1
4765,टाटर,0,0,1,1
12592,हंसना,0,0,1,1
12591,അപേക്ഷിച്ച്,0,0,1,1
12590,medeniyeti,0,0,1,1
12589,ψηφιακή,0,0,1,1
12588,पाठों,0,0,1,1
12587,сасаи,0,0,1,1
4767,implícita,0,0,1,1
12585,değiştirmekte,0,0,1,1
12583,പാടേ,0,0,1,1
12582,ಮೆಸೆಂಜರ್,0,0,1,1
12581,permettrait,0,0,1,1
12580,aussieht,0,0,1,1
12579,സുഹൃത്തിനെ,0,0,1,1
12578,французский,0,0,1,1
12577,darme,0,0,1,1
12576,manzara,0,0,1,1
12616,"
ज़ीलैण्डी",0,0,1,1
12617,ನಿಲ್ಲಿಸಿದಂತೆ,0,0,1,1
12618,collectif,0,0,1,1
12642,drop,0,0,1,1
12663,probabilidades,0,0,1,1
4759,utformad,0,0,1,1
12660,dilerim,0,0,1,1
12659,votos,0,0,1,1
12658,foran,0,0,1,1
12657,перевода,0,0,1,1
12653,बजे,0,0,1,1
12652,utiliseriez,0,0,1,1
12651,рой,0,0,1,1
12649,neglen,0,0,1,1
12648,पाऊँगी।,0,0,1,1
12645,lección,0,0,1,1
12644,المحررون,0,0,1,1
12643,sparas,0,0,1,1
12641,azul,0,0,1,1
12619,overreported,0,0,1,1
12640,massivement,0,0,1,1
12639,डॉङ्ग,0,0,1,1
12637,октябре,0,0,1,1
12636,dört,0,0,1,1
12635,ليسوا,0,0,1,1
12634,filarkivet,0,0,1,1
12633,fonctionnement ,0,0,1,1
12631,woordenboek,0,0,1,1
4760,подписаться,0,0,1,1
12626,யூ,0,0,1,1
12625,installations,0,0,1,1
12624,التعتيم,0,0,1,1
4762,പോലെയാണ്,0,0,1,1
12621,developmental,0,0,1,1
12574,selfreplicating,0,0,1,1
12570,restées,0,0,1,1
12476,അതു,0,0,1,1
12507,исследовательский,0,0,1,1
12498,caracterización,0,0,1,1
12499,hörde,0,0,1,1
12500,προσωπικά,0,0,1,1
4773,lagförslag,0,0,1,1
12503,interrumpirte,0,0,1,1
12504,paramètres,0,0,1,1
12510,limitada,0,0,1,1
12568,فسوف,0,0,1,1
12512,ആദ്യതാളിൽ,0,0,1,1
12513,goudbrood,0,0,1,1
4771,oudste,0,0,1,1
12516,mids,0,0,1,1
12517,¿cuáles,0,0,1,1
12518,ദുസ്വപ്നം,0,0,1,1
12497,വേരുകളുണ്ട്,0,0,1,1
12496,نائمة,0,0,1,1
12493,إدارتها,0,0,1,1
12492,happened,0,0,1,1
12490,aniversario,0,0,1,1
12489,ഉണ്ടാവാം,0,0,1,1
12488,прогнозирования,0,0,1,1
12487,സാക്ഷാത്കരിക്കുമെന്ന്,0,0,1,1
12486,എടുത്തുക്കൊള്ളാം,0,0,1,1
12485,beroende,0,0,1,1
12484,пять,0,0,1,1
12483,optout,0,0,1,1
12482,asustado,0,0,1,1
12481,കാര്യനിർവ്വാഹകരെ,0,0,1,1
12480,almanızı,0,0,1,1
12478,вандалов,0,0,1,1
12477,experiments,0,0,1,1
12519,столкнулся,0,0,1,1
12520,палец,0,0,1,1
12521,kapitalismen,0,0,1,1
12548,systematically,0,0,1,1
12567,التوفل,0,0,1,1
12566,dédié,0,0,1,1
12564,grant,0,0,1,1
12562,крутятся,0,0,1,1
12561,genoemde,0,0,1,1
12560,الاجتماعي,0,0,1,1
12558,الموسوعتين,0,0,1,1
12557,практически,0,0,1,1
12556,называемые,0,0,1,1
12555,montrer,0,0,1,1
12553,chinois,0,0,1,1
12551,великолепного,0,0,1,1
12550,fitzerald,0,0,1,1
12549,मार्मिक,0,0,1,1
12546,свободных,0,0,1,1
12522,طرق,0,0,1,1
12545,बीस,0,0,1,1
12543,требовал,0,0,1,1
12542,glycoproteins,0,0,1,1
12541,മുൻ,0,0,1,1
4768,independentlyrun,0,0,1,1
12539,الأمير,0,0,1,1
12537,wilde,0,0,1,1
12536,ഉറക്കമുണർന്നു,0,0,1,1
12533,critiquent,0,0,1,1
12532,lindos,0,0,1,1
12529,επιθετικό,0,0,1,1
12527,عمومًا،,0,0,1,1
12526,உற்சாகப்படுத்த,0,0,1,1
4770,kartoffeln,0,0,1,1
12286,تتعرض,0,0,1,1
12285,feit,0,0,1,1
12284,prochain,0,0,1,1
12045,ஆவண,0,0,1,1
12035,написание,0,0,1,1
12037,التالية,0,0,1,1
12038,affirmations,0,0,1,1
12039,religieuse,0,0,1,1
12042,fejlede,0,0,1,1
12044,एकत्रित,0,0,1,1
12046,extensiones,0,0,1,1
12008,magisteruppsats,0,0,1,1
12047,afogamento,0,0,1,1
12049,discordando,0,0,1,1
12050,deinem,0,0,1,1
12051,борисом,0,0,1,1
12052,சகோதரியாகவோ,0,0,1,1
12054,​​tag,0,0,1,1
12034,permissão,0,0,1,1
12033,llevaré,0,0,1,1
12032,ತಿನ್ನು,0,0,1,1
12031,ಹೊಂದುವ,0,0,1,1
12029,серьезно,0,0,1,1
12028,​​het,0,0,1,1
12026,बर्क्मेन,0,0,1,1
12025,d’idéalisme,0,0,1,1
12024,источников,0,0,1,1
12023,இன்பம்,0,0,1,1
4822,ನಿಧಾನವಾಗಿದ್ದೇನೆ,0,0,1,1
12018,உணவை,0,0,1,1
12017,معضلة,0,0,1,1
12015,признал,0,0,1,1
12014,violated,0,0,1,1
12013,أصدقاء,0,0,1,1
12011,постоянно,0,0,1,1
12055,alcanzaron,0,0,1,1
12056,tillod,0,0,1,1
12057,comenzado,0,0,1,1
12077,создававшихся,0,0,1,1
12093,interwikis,0,0,1,1
12092,परत,0,0,1,1
12091,aulas,0,0,1,1
12090,наверное,0,0,1,1
12088,സ്വപ്നമാണെന്നും,0,0,1,1
12087,ആണി,0,0,1,1
12086,sémantiques,0,0,1,1
12085,deveríamos,0,0,1,1
12084,компетентным,0,0,1,1
12083,tíbet,0,0,1,1
4816,ropa,0,0,1,1
4817,hittas,0,0,1,1
12080,महत्त्व,0,0,1,1
12079,velozpedia,0,0,1,1
12076,legitimiteten,0,0,1,1
4820,universität,0,0,1,1
12074,δημοφιλούς,0,0,1,1
12073,dolu,0,0,1,1
12072,severler,0,0,1,1
12071,himmel,0,0,1,1
12070,peerreview,0,0,1,1
12069,വരുന്നുണ്ടെന്നും,0,0,1,1
12068,"
कोमीपेर्मायक",0,0,1,1
12066,രണ്ടാം,0,0,1,1
12064,lipnet,0,0,1,1
12063,yere,0,0,1,1
12062,moois,0,0,1,1
12061,dilemmes,0,0,1,1
12060,tırnağa,0,0,1,1
12059,ஆறு,0,0,1,1
12009,perdu,0,0,1,1
12007,തിരഞ്ഞെടുക്കുന്നതാണ്,0,0,1,1
12283,ವರ್ತಿಸಿದ,0,0,1,1
11953,घिरे,0,0,1,1
11944,borró,0,0,1,1
4838,parcialidad,0,0,1,1
4835,അതിഭീകരരായ,0,0,1,1
11948,والرجل,0,0,1,1
11951,بلودجيت,0,0,1,1
11952,ಅಡ್ಡಿಪಡಿಸುವುದು,0,0,1,1
11954,nederlandstalige,0,0,1,1
12006,vereyim,0,0,1,1
11958,procrastination,0,0,1,1
11959,préparée,0,0,1,1
11960,oficinas,0,0,1,1
11961,devia,0,0,1,1
11962,riktig,0,0,1,1
11963,nagel,0,0,1,1
11942,kennisgevingen,0,0,1,1
11940,многократно,0,0,1,1
4839,zihinde,0,0,1,1
11938,frankreich,0,0,1,1
11937,مجتمعة,0,0,1,1
11936,httpdewikipediaorg,0,0,1,1
11935,periódico—,0,0,1,1
11933,प्लेटफोर्म,0,0,1,1
11932,wealthy,0,0,1,1
11931,ähm,0,0,1,1
11930,califórnia,0,0,1,1
11929,pipa,0,0,1,1
11928,культурный,0,0,1,1
11926,opgestart,0,0,1,1
11925,αδιάφορος,0,0,1,1
11924,lichte,0,0,1,1
11923,versionshantering,0,0,1,1
4833,uppdateras,0,0,1,1
11965,والمساهمين،,0,0,1,1
11966,ocultados,0,0,1,1
4831,وهؤلاء,0,0,1,1
12005,desea,0,0,1,1
12004,ഹായ്,0,0,1,1
4827,glaciation,0,0,1,1
12002,έξι,0,0,1,1
12001,taraflarına,0,0,1,1
12000,calunioso,0,0,1,1
11999,hond,0,0,1,1
11997,initiaux,0,0,1,1
11995,ചേരുന്നവരെ,0,0,1,1
11993,dumt,0,0,1,1
11992,reputadas,0,0,1,1
4830,термины,0,0,1,1
11990,fear,0,0,1,1
11989,morality,0,0,1,1
11986,ಬೃಹತ್,0,0,1,1
11967,കൊടുങ്കാറ്റ്,0,0,1,1
11985,repentinamente,0,0,1,1
11984,एडिटोरिअल,0,0,1,1
11983,article »aa,0,0,1,1
11982,யோங்களே,0,0,1,1
11981,πια,0,0,1,1
11979,bemvindo,0,0,1,1
11978,अन्डू,0,0,1,1
11976,étrangère,0,0,1,1
11975,mantente,0,0,1,1
11974,adding,0,0,1,1
11972,oficiales,0,0,1,1
11970,imkansız,0,0,1,1
11969,instalado,0,0,1,1
11968,"
फ़्रियुलियाई",0,0,1,1
12094,مجلس,0,0,1,1
12096,عيني,0,0,1,1
12097,paciencia,0,0,1,1
12223,दोंनों,0,0,1,1
12216,നൽകുന്നതിന്,0,0,1,1
12217,vikidia,0,0,1,1
12218,desconsolada,0,0,1,1
12219,счёт,0,0,1,1
12220,sözünü,0,0,1,1
12221,ಅದೃಷ್ಟಶಾಲಿ,0,0,1,1
12224,ക്രൂരമായിരുന്നു,0,0,1,1
4815,édition »,0,0,1,1
12225,"
hebraico",0,0,1,1
4800,texas,0,0,1,1
12227,अनावश्यक,0,0,1,1
12228,लिखती,0,0,1,1
12230,மாலை,0,0,1,1
12231,våren,0,0,1,1
12215,altı,0,0,1,1
12214,gern,0,0,1,1
12211,pushing,0,0,1,1
12210,കാര്യനിർവ്വാഹർക്കുണ്ട്,0,0,1,1
12208,surpreendentemente,0,0,1,1
4802,durduğunda,0,0,1,1
12204,konstaterar,0,0,1,1
12203,almalıyız,0,0,1,1
12201,edelim,0,0,1,1
12200,computación,0,0,1,1
12198,മനുഷ്യനാണ്,0,0,1,1
12197,fairness,0,0,1,1
12196,suivante,0,0,1,1
12195,imprimir,0,0,1,1
12194,ipadress,0,0,1,1
12193,பயனரோ,0,0,1,1
12192,workaround,0,0,1,1
12232,ಕೇಳಿ,0,0,1,1
12233,ценю,0,0,1,1
4799,ευχαρίστησή,0,0,1,1
12261,फेसबुक,0,0,1,1
12282,പതിപ്പാണ്‌,0,0,1,1
12281,adım,0,0,1,1
12280,ಬದಲಾಗಿದ್ದಾಳೆ,0,0,1,1
12279,രെക്കഗ്നിഷൻ,0,0,1,1
4795,содержал,0,0,1,1
12275,ارتباط,0,0,1,1
12273,permaneció,0,0,1,1
12272,يغرق,0,0,1,1
12270,ومصداقيتها,0,0,1,1
12267,englen,0,0,1,1
12266,naturalistes,0,0,1,1
12264,находящейся,0,0,1,1
12263,fonctionnent,0,0,1,1
12262,people”,0,0,1,1
12259,uppringare,0,0,1,1
12236,உதவும்,0,0,1,1
12257,incomegenerating,0,0,1,1
12255,offrent,0,0,1,1
12254,intermingled,0,0,1,1
4796,koncepten,0,0,1,1
12252,идут,0,0,1,1
12251,principios​,0,0,1,1
12250,corrections,0,0,1,1
4797,வினை,0,0,1,1
12248,العرض,0,0,1,1
4798,ಫೋನ್‌ನಲ್ಲಿ,0,0,1,1
12244,मालूम।,0,0,1,1
12243,nupedias,0,0,1,1
12238,قبيح,0,0,1,1
12237,оценочный,0,0,1,1
12191,beynimizi,0,0,1,1
12190,mangez,0,0,1,1
12187,færre,0,0,1,1
12126,ಸಂತೋಷವಾಗಿದೆ,0,0,1,1
12145,zweiten,0,0,1,1
12140,gyldent,0,0,1,1
12139,κρύο,0,0,1,1
12138,survives,0,0,1,1
12137,mènent,0,0,1,1
12136,чьи,0,0,1,1
12135,absolutely,0,0,1,1
12134,സംസ്കാരവും,0,0,1,1
12133,आयोजन,0,0,1,1
12132,rot,0,0,1,1
12131,actuele,0,0,1,1
12130,കോഫി,0,0,1,1
12128,ಅಷ್ಟೇನೂ,0,0,1,1
12127,tereddüt,0,0,1,1
12125,marinarkeologi,0,0,1,1
12147,blockeras,0,0,1,1
12122,yayımlanmış,0,0,1,1
12120,kone,0,0,1,1
12118,wreed,0,0,1,1
12117,iniciais,0,0,1,1
12112,skyldig,0,0,1,1
12111,upptäckas,0,0,1,1
12109,противоречивые,0,0,1,1
12108,разделения,0,0,1,1
4814,autoorganisé,0,0,1,1
12103,encantaría,0,0,1,1
12102,"
नाम",0,0,1,1
12101,ಸಮಸ್ಯೆಗಿಂತ,0,0,1,1
12100,ബസ്,0,0,1,1
12099,നിർവ്വചിക്കുന്നു,0,0,1,1
4812,frågetecken,0,0,1,1
12148,manned,0,0,1,1
12186,ಹುಡುಕಾಟದಲ್ಲಿ,0,0,1,1
12168,oprichtte,0,0,1,1
12184,كثيرين,0,0,1,1
12183,приятным,0,0,1,1
12182,assign,0,0,1,1
12181,φανταστείτε,0,0,1,1
12180,abriljunio,0,0,1,1
12179,milliers,0,0,1,1
12178,bitirmeme,0,0,1,1
12177,поколение,0,0,1,1
4804,chegado,0,0,1,1
4805,ಅನುಮತಿ,0,0,1,1
12172,aliments,0,0,1,1
12171,сестра,0,0,1,1
12170,appelées,0,0,1,1
4806,составления,0,0,1,1
4807,geçmişinden,0,0,1,1
12149,സഹോദരിയേ,0,0,1,1
4808,knowing,0,0,1,1
12164,vatten,0,0,1,1
12163,kvalitetssäkring,0,0,1,1
12162,meleğe,0,0,1,1
4809,पत्नी,0,0,1,1
4810,parecían,0,0,1,1
12158,hardcore,0,0,1,1
4811,bijdrage,0,0,1,1
12156,savait,0,0,1,1
12155,decrease,0,0,1,1
12153,modificación,0,0,1,1
12152,autoaprentissage,0,0,1,1
12151,slott,0,0,1,1
12150,собрания,0,0,1,1
12664,buildings,0,0,1,1
12665,olhada,0,0,1,1
12666,cocacola,0,0,1,1
13192,öfkeliydi,0,0,1,1
13184,métawiki,0,0,1,1
13185,facettes,0,0,1,1
13188,gülümsüyor,0,0,1,1
13189,لعقد,0,0,1,1
13190,பட்டியலைப்,0,0,1,1
13191,millimetre,0,0,1,1
13193,സംഭാഷണത്തിൽ‌,0,0,1,1
13156,आपसी,0,0,1,1
13194,traerte,0,0,1,1
13195,الذهبية,0,0,1,1
13197,deberían,0,0,1,1
13198,kodning,0,0,1,1
13199,γουικιπίντια,0,0,1,1
13200,голодаю,0,0,1,1
13182,പണികളിലേതെങ്കിലും,0,0,1,1
4680,സോഫ്റ്റ്,0,0,1,1
13180,ഭാവിയിലെ,0,0,1,1
13179,istediğini,0,0,1,1
13176,பாருங்கள்,0,0,1,1
13175,bibliotek,0,0,1,1
13174,ഒട്ടുമിക്ക,0,0,1,1
13170,φυτέψω,0,0,1,1
13169,प्रसंग,0,0,1,1
4681,प्यू,0,0,1,1
13166,έλλειψη,0,0,1,1
13165,வேறுபட்டிருப்பதைக்,0,0,1,1
13164,സന്നദ്ധരായവരെ,0,0,1,1
13163,guarantees,0,0,1,1
13162,γρήγορους,0,0,1,1
13160,internetcensur,0,0,1,1
13158,rastreado,0,0,1,1
4679,assertion,0,0,1,1
13202,revisados,0,0,1,1
13204,salée,0,0,1,1
13225,потерянное,0,0,1,1
13241,открытое,0,0,1,1
13239,doldurma,0,0,1,1
13238,கட்டுரை”யொன்று,0,0,1,1
13237,sigues,0,0,1,1
13236,தொகுப்பானது,0,0,1,1
13235,மங்கலான,0,0,1,1
13234,القلب,0,0,1,1
13232,başlıca,0,0,1,1
13231,fallstudie,0,0,1,1
13230,miró,0,0,1,1
13229,ഇന്ത്യാ,0,0,1,1
13228,daring,0,0,1,1
13227,höfliche,0,0,1,1
13226,schéma,0,0,1,1
4677,inférieur,0,0,1,1
13205,പാമരനും,0,0,1,1
13222,ಕೋನವಾಗಿದ್ದು,0,0,1,1
13221,ತಟ್ಟೆಯಲ್ಲಿ,0,0,1,1
4678,áustria,0,0,1,1
13219,digital»,0,0,1,1
13218,interesa,0,0,1,1
13217,wegen,0,0,1,1
13216,ρόλους,0,0,1,1
13215,licenciés,0,0,1,1
13212,तार्किक,0,0,1,1
13211,അഭിപ്രായമിടുന്നതിലൂടെ,0,0,1,1
13210,amar,0,0,1,1
13209,dagelijkse,0,0,1,1
13207,samenvatting,0,0,1,1
13206,semenciers,0,0,1,1
13157,чьих,0,0,1,1
13155,compensaban,0,0,1,1
13047,μάτι,0,0,1,1
13089,marx,0,0,1,1
13077,möjliggör,0,0,1,1
4697,αδερφή,0,0,1,1
4696,contenía,0,0,1,1
13084,sauvage,0,0,1,1
13086,"





o
n
i
o
n
s

p
o
t
a
t
o
e
s


⇒


b
u
r
g
e
r




displaystyle",0,0,1,1
13088,justifiée,0,0,1,1
13090,kullanılmasını,0,0,1,1
13154,يجعلني,0,0,1,1
13093,ريتشارد,0,0,1,1
13094,عصفور,0,0,1,1
4690,ಸಿಗದಿದ್ದಾಗ,0,0,1,1
13097,തമാശയാണ്,0,0,1,1
13098,hälsningar,0,0,1,1
13099,التنفيذي,0,0,1,1
4699,வேர்கள்,0,0,1,1
13075,"
हम",0,0,1,1
13072,അറിഞ്ഞിരിക്കണം,0,0,1,1
13071,ника,0,0,1,1
13070,नामक,0,0,1,1
13069,внесена,0,0,1,1
13067,puéril,0,0,1,1
13066,δίκαιη,0,0,1,1
4700,ಮತ್ತೊಮ್ಮೆ,0,0,1,1
13064,großartiger,0,0,1,1
13063,ذا,0,0,1,1
13062,избегая,0,0,1,1
13060,الموقف,0,0,1,1
13059,الدمية,0,0,1,1
13057,cenar,0,0,1,1
13053,غرفة,0,0,1,1
13052,fraudes,0,0,1,1
13100,ಉಸಿರಾಡಲು,0,0,1,1
13101,человеческий,0,0,1,1
4689,உடைந்தாள்,0,0,1,1
13132,മെല്ലിയോടും,0,0,1,1
13153,обо,0,0,1,1
13152,இதற்கான,0,0,1,1
13150,вернулась,0,0,1,1
4682,совместно,0,0,1,1
13148,obterá,0,0,1,1
13146,extracellular,0,0,1,1
13145,судейская,0,0,1,1
13144,documentos,0,0,1,1
4683,hielt,0,0,1,1
13142,opgemerkt,0,0,1,1
13140,विजित,0,0,1,1
13139,വളരെക്കാലമായിരിക്കുന്നു,0,0,1,1
13137,лондоне,0,0,1,1
13136,coauteurs,0,0,1,1
13130,bloquer,0,0,1,1
13105,segundos,0,0,1,1
13129,synergies,0,0,1,1
13127,restoran,0,0,1,1
13124,الهائلة,0,0,1,1
13123,puppets,0,0,1,1
13122,master,0,0,1,1
13118,législation,0,0,1,1
4686,permit,0,0,1,1
13115,ಉದಾಹರಣೆಗಳನ್ನು,0,0,1,1
13114,précondition,0,0,1,1
13112,уроке,0,0,1,1
4687,αναρωτιόμουν,0,0,1,1
13109,വാർത്ത,0,0,1,1
13107,مايو,0,0,1,1
13106,متعددة,0,0,1,1
13242,ступит,0,0,1,1
13243,prometteuses,0,0,1,1
13244,clin,0,0,1,1
13369,berömda,0,0,1,1
13361,réagir,0,0,1,1
13362,privilege,0,0,1,1
13363,rättvis,0,0,1,1
13366,"
बश्किर",0,0,1,1
13367,détecter,0,0,1,1
13368,ಅಳುತ್ತಿದ್ದರೆ,0,0,1,1
13370,आंकडों,0,0,1,1
13245,populära,0,0,1,1
13371,catalogue,0,0,1,1
13372,மாட்டீர்கள்,0,0,1,1
13373,раза,0,0,1,1
13379,istekte,0,0,1,1
13380,porcentaje,0,0,1,1
13381,വിഷയത്തിലെ,0,0,1,1
4661,συγχαρητήρια,0,0,1,1
13359,பெயர்ச்சொல்லாக,0,0,1,1
13358,değiştirilebilir,0,0,1,1
4662,നിലനിൽപ്പുണ്ടാവൂ,0,0,1,1
13356,balkongen,0,0,1,1
13355,السعي,0,0,1,1
13352,കോടതിയോ,0,0,1,1
13351,citat,0,0,1,1
13350,desværre,0,0,1,1
13349,opôsse,0,0,1,1
13348,ಹೆದರುತ್ತಿದ್ದೆ,0,0,1,1
4663,söyler,0,0,1,1
13346,passé,0,0,1,1
13344,yiyebileceğim,0,0,1,1
13342,auc,0,0,1,1
13340,بإنشاء,0,0,1,1
13339,खींचें।,0,0,1,1
13382,abd,0,0,1,1
13383,शुक्रिया,0,0,1,1
13384,kibarca,0,0,1,1
13405,вебсервер,0,0,1,1
13423,convencidas,0,0,1,1
13422,früher,0,0,1,1
13421,inégalitaire,0,0,1,1
13420,titres,0,0,1,1
13418,insats,0,0,1,1
13417,слове,0,0,1,1
13416,cadaver,0,0,1,1
13415,télégramme,0,0,1,1
4656,جنوني,0,0,1,1
4657,proyectos​,0,0,1,1
13411,notablemente,0,0,1,1
13410,അർത്ഥമെന്താണെന്ന്,0,0,1,1
4658,всей,0,0,1,1
13407,değiştirmektedir,0,0,1,1
13404,وطريقة,0,0,1,1
13385,gözyaşlarına,0,0,1,1
13403,ഇഷ്ടമാണെന്ന്,0,0,1,1
13402,hörs,0,0,1,1
13401,कठिन,0,0,1,1
13400,வெறித்தனமாக,0,0,1,1
13399,என்றும்,0,0,1,1
13398,आर्द्रभूमि,0,0,1,1
13397,سيطرة,0,0,1,1
13395,रोजमर्रा,0,0,1,1
13393,bone,0,0,1,1
13392,zor,0,0,1,1
13391,sprechersymbol,0,0,1,1
13388,отведу,0,0,1,1
4660,atualizado,0,0,1,1
13386,migrated,0,0,1,1
13336,igual,0,0,1,1
13335,haveria,0,0,1,1
13332,مساء,0,0,1,1
13266,gwh,0,0,1,1
13283,articles ,0,0,1,1
13282,cruzamiento,0,0,1,1
13281,uppnå,0,0,1,1
13280,நெடு,0,0,1,1
13278,ഒരിക്കൽ,0,0,1,1
13276,μάλλον,0,0,1,1
13274,testet,0,0,1,1
13273,medley,0,0,1,1
13272,hjemmesider,0,0,1,1
13271,évolué,0,0,1,1
13270,primario,0,0,1,1
13269,états,0,0,1,1
13268,പുറത്തുള്ള,0,0,1,1
13267,éditoriale ,0,0,1,1
13265,primære,0,0,1,1
13285,gewonnen,0,0,1,1
13264,«иракская,0,0,1,1
13263,среднем,0,0,1,1
13262,വസ്ത്രങ്ങൾ,0,0,1,1
13260,വ്യാപിച്ചു,0,0,1,1
13259,resumo,0,0,1,1
13258,பயணி,0,0,1,1
13257,ലൈബ്രറി,0,0,1,1
13256,distinguen​,0,0,1,1
13255,കൃത്യതയും,0,0,1,1
4674,موقعا,0,0,1,1
13251,yanında,0,0,1,1
13249,adaptée,0,0,1,1
13247,നല്ലതാണെന്ന്,0,0,1,1
13246,iterative,0,0,1,1
13284,ficaram,0,0,1,1
13286,arkadaşlarına,0,0,1,1
13331,rein,0,0,1,1
13311,prédictive,0,0,1,1
4668,പിടിക്കാത്തതിനാൽ,0,0,1,1
13329,مصحح,0,0,1,1
13328,பயன்படுத்துகிறோம்,0,0,1,1
13326,gitmeme,0,0,1,1
13325,paulo,0,0,1,1
13324,personaje,0,0,1,1
4669,φεύγω,0,0,1,1
13322,allmänheten,0,0,1,1
13321,يتقاضون,0,0,1,1
13320,ನಿಖರವಾಗಿ,0,0,1,1
13318,ಕಣ್ಣೀರಿಗೆ,0,0,1,1
13317,spelen,0,0,1,1
13315,الوقت،,0,0,1,1
13314,traummutter,0,0,1,1
13309,coréenne,0,0,1,1
13287,لنصبح,0,0,1,1
13308,ಸಂಬಂಧವಿದೆ,0,0,1,1
13307,ಸಿದ್ಧವಾಗಿದೆ,0,0,1,1
13305,journée,0,0,1,1
13304,சுயாதீனமாக,0,0,1,1
4670,സംരംഭമാണ്,0,0,1,1
13300,notorias,0,0,1,1
13298,взволнованы,0,0,1,1
4671,κλαις,0,0,1,1
13296,ändrat,0,0,1,1
13295,إضافات,0,0,1,1
4672,взяла,0,0,1,1
13290,latinos,0,0,1,1
13289,इयर,0,0,1,1
13288,election,0,0,1,1
13050,പറയുന്നതായും,0,0,1,1
13046,சூப்பில்,0,0,1,1
12667,allés,0,0,1,1
12797,टूट,0,0,1,1
12786,gördüğünden,0,0,1,1
4735,satisfactoria,0,0,1,1
12788,myntas,0,0,1,1
12789,சொல்,0,0,1,1
12790,ಯೋಚಿಸಲು,0,0,1,1
12793,அதையே,0,0,1,1
12798,பரிசீலித்து,0,0,1,1
12763,individuo,0,0,1,1
12799,ναρκισσισμός,0,0,1,1
12800,logistique,0,0,1,1
12802,başarılı,0,0,1,1
12804,लम्बे,0,0,1,1
4733,prachtige,0,0,1,1
12807,بالعرض,0,0,1,1
12785,आलोचनाओं,0,0,1,1
12784,ഉണ്ടായിരിക്കണമെന്ന്,0,0,1,1
4736,пользователями,0,0,1,1
12782,ಗಂಟೆ,0,0,1,1
12781,кэшем,0,0,1,1
12778,wikiviajes,0,0,1,1
12777,historians,0,0,1,1
12776,ഉറങ്ങുമ്പോൾ,0,0,1,1
12775,ईमानदारी,0,0,1,1
12774,cliquant,0,0,1,1
12773,δευτερόλεπτο,0,0,1,1
12772,compréhensive,0,0,1,1
12771,ocidental,0,0,1,1
12770,içeriklerinde,0,0,1,1
12769,மாறிவிட்டாள்,0,0,1,1
12767,tête,0,0,1,1
12766,théoriques,0,0,1,1
4732,அரைப்,0,0,1,1
4730,tillåter,0,0,1,1
12811,തിരുത്താനും,0,0,1,1
12844,никаких,0,0,1,1
12860,पदोन्नति,0,0,1,1
12859,gelmesi,0,0,1,1
12858,suscripción,0,0,1,1
12857,captar,0,0,1,1
12856,فأحب,0,0,1,1
12855,لكتاباتهم،,0,0,1,1
12854,ಮಧ್ಯಾಹ್ನದ,0,0,1,1
12853,குழுவொன்று,0,0,1,1
12852,സന്തുലിതമായ,0,0,1,1
12849,καταλάβει,0,0,1,1
12848,hossein,0,0,1,1
12847,scared,0,0,1,1
12846,τάση,0,0,1,1
12845,மேஜையில்,0,0,1,1
12841,медалью,0,0,1,1
12814,തിരിച്ചറിയാൻ,0,0,1,1
12840,administração,0,0,1,1
12839,படையினருக்கு,0,0,1,1
12838,बनाये,0,0,1,1
12837,bercezvous,0,0,1,1
12836,refoulée,0,0,1,1
12831,argumentava,0,0,1,1
12828,ക്രൂരതയും,0,0,1,1
12825,dåsedansk,0,0,1,1
12824,"
espanhol",0,0,1,1
12823,الحظر,0,0,1,1
12821,seyahatlerini,0,0,1,1
12820,betterwritten,0,0,1,1
12819,استخدم,0,0,1,1
12817,prétentieux,0,0,1,1
4740,idioma»,0,0,1,1
12762,ഉദാഹരണങ്ങളിലെ,0,0,1,1
4701,berühmten,0,0,1,1
12701,mechanismref,0,0,1,1
12691,τύπος,0,0,1,1
12693,rahatsızlık,0,0,1,1
12694,foton,0,0,1,1
4755,வைரங்களில்,0,0,1,1
12696,proje,0,0,1,1
12700,bars,0,0,1,1
4753,«„википедия“ —,0,0,1,1
4742,αγόρασαν,0,0,1,1
4752,sürümünde,0,0,1,1
12706,gaming,0,0,1,1
12709,आत्महत्या,0,0,1,1
12710,उत्पीड़क,0,0,1,1
12711,தொடர்பில்,0,0,1,1
12712,maruz,0,0,1,1
12690,« passage,0,0,1,1
12689,adicionais,0,0,1,1
12688,"
हक्का",0,0,1,1
12685,aramada,0,0,1,1
12684,quieras,0,0,1,1
12683,narsizaydı,0,0,1,1
12682,accompagné,0,0,1,1
12680,gravity,0,0,1,1
12679,limonpedia,0,0,1,1
12678,приходят,0,0,1,1
12675,présidentielles,0,0,1,1
12674,chercheuse,0,0,1,1
12673,castelo,0,0,1,1
4756,leverde,0,0,1,1
4757,parcourant,0,0,1,1
12669,மூழ்குவதைக்,0,0,1,1
12668,освещения,0,0,1,1
4750,μεγαλύτερο,0,0,1,1
12716,принято,0,0,1,1
12717,snail,0,0,1,1
12739,transformative,0,0,1,1
12760,روعة,0,0,1,1
12759,प्रोग्रामिंग,0,0,1,1
4743,vriendin,0,0,1,1
12757,gegenteil,0,0,1,1
12756,காப்புரிமை,0,0,1,1
12755,sociólogos,0,0,1,1
12751,kaynaklarla,0,0,1,1
12750,учителя,0,0,1,1
12749,unikke,0,0,1,1
12748,krydser,0,0,1,1
12746,المستقل,0,0,1,1
12745,движок,0,0,1,1
12742,åtminstone,0,0,1,1
4745,قادرا,0,0,1,1
12738,связывают,0,0,1,1
12718,அழைத்துச்,0,0,1,1
12737,uitsluitend,0,0,1,1
12736,affiliation,0,0,1,1
12733,дочерью,0,0,1,1
4747,selecionado,0,0,1,1
12730,नही।,0,0,1,1
12729,कृत्रिम,0,0,1,1
12728,aristotle,0,0,1,1
12727,islas,0,0,1,1
12726,tranche,0,0,1,1
12725,disseram,0,0,1,1
12723,പ്രക്രിയയിലൂടെ,0,0,1,1
12722,കൃത്രിമ,0,0,1,1
12721,nuitlà,0,0,1,1
12719,grafia,0,0,1,1
12862,ifølge,0,0,1,1
12863,derivative,0,0,1,1
12865,неверными,0,0,1,1
12992,имеющей,0,0,1,1
12984,l’occasion,0,0,1,1
12985,blindtester,0,0,1,1
12986,شروط,0,0,1,1
12987,ನಿಲ್ಲಿಸಿ,0,0,1,1
12988,wilson,0,0,1,1
12991,assuré,0,0,1,1
12993,количеством,0,0,1,1
12866,​​persoon,0,0,1,1
4706,അശ്ലീല,0,0,1,1
12996,blunt,0,0,1,1
12997,evliliği,0,0,1,1
12998,ഇരുപതിനായിരം,0,0,1,1
13000,തേടുകയാണ്,0,0,1,1
13002,സഹായിക്കുമോ,0,0,1,1
12983,вставлять,0,0,1,1
12982,broma,0,0,1,1
12981,ποτήρι,0,0,1,1
12979,hornear,0,0,1,1
4707,intelligence »,0,0,1,1
12977,خطيرة،,0,0,1,1
12976,сюда,0,0,1,1
12975,ಸೆಕೆಂಡಿಗೆ,0,0,1,1
12974,ശരിയാക്കിയിട്ടുണ്ടോ,0,0,1,1
4708,питером,0,0,1,1
12972,irgendwie,0,0,1,1
12971,konst,0,0,1,1
4710,ocultas,0,0,1,1
12967,ökningen,0,0,1,1
12966,பள்ளியில்,0,0,1,1
12965,neutraliteten,0,0,1,1
12964,ordenadas,0,0,1,1
13003,comparación,0,0,1,1
13004,வா,0,0,1,1
13005,metin,0,0,1,1
13026,lages,0,0,1,1
13044,للتحرير،,0,0,1,1
13043,förtal,0,0,1,1
13042,tweede,0,0,1,1
13041,पैसों,0,0,1,1
13038,gezocht,0,0,1,1
13037,بالك؟,0,0,1,1
13034,مخزنة,0,0,1,1
13033,tomaras,0,0,1,1
13032,viveria,0,0,1,1
13031,കിട്ടുന്ന,0,0,1,1
13030,yemeği,0,0,1,1
13029,предметов,0,0,1,1
13028,உருவாக்கி,0,0,1,1
13027,sapiens,0,0,1,1
13024,обучаемой,0,0,1,1
13006,ursprungligen,0,0,1,1
13023,βικιταξίδια,0,0,1,1
13022,заблокировать,0,0,1,1
13020,ficaria,0,0,1,1
13019,diretora,0,0,1,1
4703,الأحوال,0,0,1,1
13017,staarde,0,0,1,1
13016,चलाये,0,0,1,1
13015,जाएगी।,0,0,1,1
13014,നടുങ്ങിപ്പോയി,0,0,1,1
13012,المدينة,0,0,1,1
13010,"
basco",0,0,1,1
13009,reich,0,0,1,1
13008,şaşırttığında,0,0,1,1
13007,polerad,0,0,1,1
12963,தாருங்கள்,0,0,1,1
12962,suscribirte,0,0,1,1
12961,indivíduos,0,0,1,1
12886,വൃത്തികെട്ട,0,0,1,1
12908,τρομερό,0,0,1,1
12907,заметьте,0,0,1,1
12906,læsere,0,0,1,1
12904,foros,0,0,1,1
12903,സമാനമായത്,0,0,1,1
12902,ಸುಸೇವ್,0,0,1,1
12900,veteranos—,0,0,1,1
12898,spécificité,0,0,1,1
12895,estimado,0,0,1,1
12893,സിസോപ്പുകൾ,0,0,1,1
12891,mejore,0,0,1,1
12890,délicieux,0,0,1,1
12889,l’inverse,0,0,1,1
12887,kanun,0,0,1,1
12885,كثيرا,0,0,1,1
12911,ಕಾರ್ಯಯೋಜನೆಗಳಿವೆ,0,0,1,1
12884,kilomètre,0,0,1,1
12883,ಬಳಕೆಗಾಗಿ,0,0,1,1
12882,ಯಾವುದರ,0,0,1,1
12881,ρυθμός,0,0,1,1
12880,συνάντησε,0,0,1,1
12879,قدمت,0,0,1,1
12877,épidémique,0,0,1,1
12875,oförenligt,0,0,1,1
12874,கட்டுரையைத்,0,0,1,1
4724,والخوادم,0,0,1,1
4725,voeten,0,0,1,1
12870,cape,0,0,1,1
12869,പരിശീലനങ്ങളെക്കുറിച്ചും,0,0,1,1
12868,пользователям,0,0,1,1
12909,précaution,0,0,1,1
12912,devese,0,0,1,1
4711,ಮಾಲ್‌ನಲ್ಲಿ,0,0,1,1
12933,duymak,0,0,1,1
12956,ನೆಚ್ಚಿನ,0,0,1,1
12954,المساعدة,0,0,1,1
4714,центральным,0,0,1,1
12951,συμβεί,0,0,1,1
12950,«нейтральной,0,0,1,1
12949,tested,0,0,1,1
12948,പഠിക്കാൻ,0,0,1,1
12947,pedazo,0,0,1,1
12943,ಒಲವು,0,0,1,1
12942,ನಡೆಯುತ್ತಿಲ್ಲ,0,0,1,1
12939,identifierade,0,0,1,1
4715,авторства,0,0,1,1
4717,நடந்துகொண்டது,0,0,1,1
12934,onafhankelijk,0,0,1,1
12932,ಕ್ಷಣದಲ್ಲಿ,0,0,1,1
12913,كفعل,0,0,1,1
12931,forçait,0,0,1,1
12930,ನಕಾರಾತ್ಮಕ,0,0,1,1
12929,corresponsales,0,0,1,1
12928,wetenschappers,0,0,1,1
12927,എന്തുണ്ട്,0,0,1,1
4720,lessem,0,0,1,1
12925,μπαράκ,0,0,1,1
12924,ശാഖയായ,0,0,1,1
12923,bilden,0,0,1,1
12922,registra,0,0,1,1
12920,प्यारा,0,0,1,1
12919,διάφορες,0,0,1,1
12916,फ़रवरी,0,0,1,1
12914,لاحق,0,0,1,1
14953,crystallize,0,0,1,1
14955,yapıyorsun,0,0,1,1
11921,يقاس,0,0,1,1
16973,обзор,0,0,1,1
16962,focalicen,0,0,1,1
16965,विकिट्रेवल,0,0,1,1
16966,fotografering,0,0,1,1
16967,antissociais,0,0,1,1
4187,низкие,0,0,1,1
16972,स्टेटस,0,0,1,1
16974,opposé,0,0,1,1
16937,dépositaire,0,0,1,1
16975,ഉയർത്തുകയും,0,0,1,1
16976,identifiquen,0,0,1,1
16977,இணையதளம்,0,0,1,1
16978,συγχαρώ,0,0,1,1
16979,northeast,0,0,1,1
16980,ആഗ്രഹിക്കുന്നുവെന്നും,0,0,1,1
16960,webbgränssnitt,0,0,1,1
16959,yapılmış,0,0,1,1
16958,indkøbscentret,0,0,1,1
16957,volgt,0,0,1,1
16956,википе́дия,0,0,1,1
4188,yansır,0,0,1,1
4189,gekregen,0,0,1,1
16952,energia,0,0,1,1
16950,narsis,0,0,1,1
16949,равен,0,0,1,1
16948,ಓಡಿಹೋದಳು,0,0,1,1
16947,निका,0,0,1,1
16945,hazırlayıp,0,0,1,1
16944,skillnad,0,0,1,1
16941,സാമുവൽ,0,0,1,1
16940,rebanada,0,0,1,1
16939,coke,0,0,1,1
4186,sk •,0,0,1,1
16983,fortement,0,0,1,1
16984,editando,0,0,1,1
17015,triggered,0,0,1,1
17037,تطوّر,0,0,1,1
17036,nacional,0,0,1,1
17033,versionshistorik,0,0,1,1
4182,sølv,0,0,1,1
17031,تتبعهم،,0,0,1,1
17030,aplicar,0,0,1,1
17028,verkeert,0,0,1,1
17026,تلتقي,0,0,1,1
17025,persistaient,0,0,1,1
17024,intimate,0,0,1,1
17023,caps,0,0,1,1
17021,എത്തിച്ചേരുകയാണ്,0,0,1,1
17018,лицензированная,0,0,1,1
17016,വായനക്കാരന്റെ,0,0,1,1
17014,kende,0,0,1,1
4184,artiste,0,0,1,1
17013,μοντέλο,0,0,1,1
17009,أقسام,0,0,1,1
17006,chemistry,0,0,1,1
17005,achtergelaten,0,0,1,1
17004,cinste,0,0,1,1
17003,programmeur,0,0,1,1
17002,выиграла,0,0,1,1
16998,μαθητές,0,0,1,1
16996,communes,0,0,1,1
16995,évaluation,0,0,1,1
16994,acudirse,0,0,1,1
16992,continuam,0,0,1,1
16990,alloué,0,0,1,1
16989,ربحية,0,0,1,1
16938,जितना,0,0,1,1
16936,promotional,0,0,1,1
17039,ലോകം,0,0,1,1
16875,أعداد,0,0,1,1
16867,datters,0,0,1,1
16869,உருவாக்கப்பட்ட,0,0,1,1
16871,भयावह,0,0,1,1
16872,çalışmayı,0,0,1,1
16873,пошли,0,0,1,1
16874,ಅವಕಾಶವಿಲ್ಲ,0,0,1,1
16876,скрещенные,0,0,1,1
16934,திட்டங்களைச்,0,0,1,1
16877,المشاريع،,0,0,1,1
16878,raccorder,0,0,1,1
16879,നോക്കിയിരുന്നു,0,0,1,1
16880,klingon,0,0,1,1
16881,conozcas,0,0,1,1
16883,இலவச,0,0,1,1
16866,croyances,0,0,1,1
16864,yapabilirim,0,0,1,1
16863,manga,0,0,1,1
16862,विख्याति,0,0,1,1
16861,ടൈപ്പുചെയ്യുക,0,0,1,1
16860,हेंडलिंग,0,0,1,1
16858,twice,0,0,1,1
16857,asien,0,0,1,1
16856,ஸ்டுபண்டஸ்,0,0,1,1
16855,ചതുപ്പ്,0,0,1,1
16854,keşfi,0,0,1,1
4200,organisée,0,0,1,1
16851,petit »,0,0,1,1
16849,செயல்களைப்,0,0,1,1
16848,kanunlarına,0,0,1,1
16847,hugely,0,0,1,1
16846,bs •,0,0,1,1
16884,بلاد,0,0,1,1
16891,സൃഷ്ടികളേയും,0,0,1,1
16892,സത്യം,0,0,1,1
4191,попрактиковаться,0,0,1,1
16933,اليومي,0,0,1,1
16932,дорожки,0,0,1,1
16931,suporte,0,0,1,1
16930,சைர்,0,0,1,1
16928,ಶುಭಾಶಯಗಳು,0,0,1,1
16927,ചിലപ്പോഴെല്ലാം,0,0,1,1
16923,ಮನುಷ್ಯನಿಗೆ,0,0,1,1
16921,wikipediaprojektets,0,0,1,1
16920,ಸಮಯಕ್ಕೆ,0,0,1,1
16919,outnumbered,0,0,1,1
16918,حدث,0,0,1,1
16917,ಮೊದಲನೆಯದನ್ನು,0,0,1,1
16916,वेंबेर्गेर,0,0,1,1
16915,bereit,0,0,1,1
16913,σιγουρευτείτε,0,0,1,1
16893,مستاء,0,0,1,1
4192,एसएमएस,0,0,1,1
4194,glitrende,0,0,1,1
4195,ребенку,0,0,1,1
16909,dikes,0,0,1,1
16908,контринтуитивную,0,0,1,1
16907,तुम।,0,0,1,1
16904,undgår,0,0,1,1
16903,pestañas,0,0,1,1
16902,desculpando,0,0,1,1
16901,காக்கப்படுகின்றன,0,0,1,1
16898,importants,0,0,1,1
16897,diste,0,0,1,1
16896,كلها,0,0,1,1
16894,أتزوجك,0,0,1,1
17038,ഭാഗ്യവാനാണെന്ന്,0,0,1,1
17041,homework,0,0,1,1
16464,ısırık,0,0,1,1
17186,cadeau,0,0,1,1
17177,covid,0,0,1,1
17179,ಕೊರತೆಯನ್ನು,0,0,1,1
4165,globalmente,0,0,1,1
17182,ദിനമായി,0,0,1,1
17183,sökningen,0,0,1,1
17184,mücadeleyi,0,0,1,1
17187,ഭ്രാന്തൻ,0,0,1,1
17148,подверженных,0,0,1,1
17189,realworld,0,0,1,1
17191,connexion,0,0,1,1
17193,wikipediaskribenterna,0,0,1,1
17195,ക്ഷീണവും,0,0,1,1
17198,скрестите,0,0,1,1
17199,wait,0,0,1,1
17176,ಎಂಬುದರಂತೆ,0,0,1,1
17175,വിളിച്ചു,0,0,1,1
17173,सिर,0,0,1,1
17172,havaiana,0,0,1,1
4167,parcial,0,0,1,1
17168,partenariats,0,0,1,1
17167,solutions,0,0,1,1
17164,feeder,0,0,1,1
17163,riesigen,0,0,1,1
17162,législatives »,0,0,1,1
17160,όμορφα,0,0,1,1
17159,amplo,0,0,1,1
17158,trist,0,0,1,1
17157,ensaísticos,0,0,1,1
17156,ಎಲ್ಲೋ,0,0,1,1
17155,متى,0,0,1,1
17152,اللازم,0,0,1,1
17200,мужчин,0,0,1,1
17201,turkiet,0,0,1,1
4163,statistique,0,0,1,1
17224,« dans,0,0,1,1
17244,collaboratives,0,0,1,1
17243,udgav,0,0,1,1
17242,choro,0,0,1,1
17240,golpea,0,0,1,1
17238,टेलीविजन,0,0,1,1
17234,موظفين,0,0,1,1
17233,devrionsnous,0,0,1,1
4157,pular,0,0,1,1
17230,unverifiable,0,0,1,1
17229,hittat,0,0,1,1
17228,artistic,0,0,1,1
17227,begreppet,0,0,1,1
17226,yapmanı,0,0,1,1
17225,grijze,0,0,1,1
17223,ortak,0,0,1,1
4162,لاتيني,0,0,1,1
17222,υπήρχε,0,0,1,1
17221,aude,0,0,1,1
17220,nascor,0,0,1,1
17218,evidencia,0,0,1,1
4158,azzam,0,0,1,1
17215,लगेगा,0,0,1,1
17214,ಹಿಡಿದುಕೊಳ್ಳಿ,0,0,1,1
4159,ತದನಂತರ,0,0,1,1
17212,réalisation,0,0,1,1
17211,prohíbe,0,0,1,1
17210,διανομή,0,0,1,1
17209,анализом,0,0,1,1
17207,reflejarse,0,0,1,1
4161,onderzoeksveld,0,0,1,1
17151,مولاي,0,0,1,1
17145,திருத்தங்கள்,0,0,1,1
17042,நிறுவனமான,0,0,1,1
17087,qualificatif,0,0,1,1
17077,tests,0,0,1,1
17079,بيزنس,0,0,1,1
17080,revelado,0,0,1,1
17081,таинственное,0,0,1,1
4173,നിസാര,0,0,1,1
17086,plaatsen,0,0,1,1
17088,lægger,0,0,1,1
17144,ആസ്പദമാക്കി,0,0,1,1
17090,والإسبانية,0,0,1,1
17092,δύσκολη,0,0,1,1
17093,därifrån,0,0,1,1
17095,komende,0,0,1,1
17096,சொல்வதைச்,0,0,1,1
17099,βυθιστεί,0,0,1,1
4174,ಇದ್ದಕ್ಕಿದ್ದಂತೆ,0,0,1,1
17074,διαμαρτύρεται,0,0,1,1
17072,токио,0,0,1,1
4176,dehors,0,0,1,1
17070,kullanılıyordu,0,0,1,1
17069,görünmesine,0,0,1,1
17067,ಮುಂದುವರಿಯಲು,0,0,1,1
17064,சாதாரண,0,0,1,1
17062,egoïstische,0,0,1,1
17061,niesde,0,0,1,1
17058,pornografía,0,0,1,1
17055,огромного,0,0,1,1
17054,trevligare,0,0,1,1
17053,acarrearía,0,0,1,1
17046,nelerdir,0,0,1,1
4180,пятой“,0,0,1,1
17044,planları,0,0,1,1
17101,изменчивое,0,0,1,1
17102,അന്താരാഷ്ട്ര,0,0,1,1
17103,exceto,0,0,1,1
17126,உரைக்கு,0,0,1,1
17143,caught,0,0,1,1
17142,عقليًا,0,0,1,1
17141,γενικά,0,0,1,1
4168,असंगति,0,0,1,1
17138,лицензируются,0,0,1,1
17137,സംസ്കാരത്തെപ്പറ്റിയുമൊക്കെയുള്ള,0,0,1,1
17136,incompatible,0,0,1,1
4169,« é »,0,0,1,1
17133,befinner,0,0,1,1
17132,originalartiklar,0,0,1,1
17131,raisonnable »,0,0,1,1
17129,डबल,0,0,1,1
17128,особенности,0,0,1,1
17127,burger,0,0,1,1
17125,разрешает,0,0,1,1
17104,matthews,0,0,1,1
17123,vérifiables,0,0,1,1
17122,entran,0,0,1,1
4171,പറഞ്ഞയച്ചത്,0,0,1,1
17119,ஏதோ,0,0,1,1
17118,defendem,0,0,1,1
17117,utgivningsbevis,0,0,1,1
17116,περιμένει,0,0,1,1
17115,जापान,0,0,1,1
17114,sowieso,0,0,1,1
17113,ಬೆರಳುಗಳು,0,0,1,1
17111,ಪ್ರಾರಂಭಿಸೋಣ,0,0,1,1
17109,ಕೆಲವೇ,0,0,1,1
17108,قائلاً،,0,0,1,1
17106,diyelim,0,0,1,1
4201,ಹುಚ್ಚನಾಗಿದ್ದೇನೆ,0,0,1,1
16844,frygtelige,0,0,1,1
16843,numériques,0,0,1,1
16596,كريم؟,0,0,1,1
16589,cruza,0,0,1,1
16590,totalité,0,0,1,1
16591,данной,0,0,1,1
16592,diyorum,0,0,1,1
16593,رحلتك,0,0,1,1
16595,propone,0,0,1,1
16599,الوحيدة,0,0,1,1
16562,загрузки,0,0,1,1
16600,verdere,0,0,1,1
16601,artikelämnen,0,0,1,1
4244,it •,0,0,1,1
16607,கனவைப்,0,0,1,1
16608,condemned,0,0,1,1
16609,dee,0,0,1,1
16588,moda,0,0,1,1
16585,ഇതര,0,0,1,1
16583,vergelijkend,0,0,1,1
16582,സംഭാഷണവും,0,0,1,1
4247,suivantes ,0,0,1,1
16580,saint,0,0,1,1
16579,önceki,0,0,1,1
4248,அதிகரிப்பதன்,0,0,1,1
16577,விக்கித்,0,0,1,1
16576,பயனர்களின்,0,0,1,1
16574,telefonat,0,0,1,1
16572,الأوائل,0,0,1,1
16570,முன்னேறியது,0,0,1,1
16567,volvió,0,0,1,1
16566,judiciais,0,0,1,1
16565,işim,0,0,1,1
16564,unexpected,0,0,1,1
16610,βοηθήσεις,0,0,1,1
16611,connaissezvous,0,0,1,1
16612,ಇದೀಗ,0,0,1,1
16631,இடம்பெற,0,0,1,1
16645,slightly,0,0,1,1
16644,compliquée,0,0,1,1
16643,varanda,0,0,1,1
16642,выпустил,0,0,1,1
16641,வெற்றியடையவில்லை,0,0,1,1
16640,applying,0,0,1,1
16639,påpekar,0,0,1,1
16638,qualities,0,0,1,1
16637,combinées,0,0,1,1
16636,ملاك,0,0,1,1
16635,konuşuyordu,0,0,1,1
4238,generated,0,0,1,1
16633,одиночный,0,0,1,1
4239,beschikken,0,0,1,1
4240,இணைப்பாக,0,0,1,1
16613,ذكيًا,0,0,1,1
16629,ಪರಿಸ್ಥಿತಿಯಲ್ಲಿರುವುದು,0,0,1,1
16628,voelt,0,0,1,1
16627,attirée,0,0,1,1
16626,transgenre,0,0,1,1
16625,disruptively,0,0,1,1
16624,ಮಾಡಬಲ್ಲೆ,0,0,1,1
16623,appuyez,0,0,1,1
16622,pisar,0,0,1,1
16621,aspecto,0,0,1,1
4241,tips,0,0,1,1
16619,autopromocionales,0,0,1,1
16618,citaträtten,0,0,1,1
16615,установлено,0,0,1,1
16614,άνθρωπος,0,0,1,1
4249,tepeden,0,0,1,1
4250,неделю —,0,0,1,1
16842,credentials,0,0,1,1
4259,शाम,0,0,1,1
16488,girdi,0,0,1,1
16489,internetföretag,0,0,1,1
16491,favorisant,0,0,1,1
16492,fiables»,0,0,1,1
16493,вошло,0,0,1,1
16494,parlamentosu,0,0,1,1
4258,polémicos,0,0,1,1
16560,коннотацией,0,0,1,1
16497,«площадкой»,0,0,1,1
4257,"
हैतियाई",0,0,1,1
16500,gekleed,0,0,1,1
16501,disant,0,0,1,1
16502,ഇന്റലിജൻസ്,0,0,1,1
16503,μέσων,0,0,1,1
16487,konferensartikeln,0,0,1,1
16485,divulgación,0,0,1,1
16484,المخربون,0,0,1,1
16483,شخصا,0,0,1,1
16482,recordarte,0,0,1,1
16481,самая,0,0,1,1
16480,ayudarlo,0,0,1,1
4261,inancıyla,0,0,1,1
4263,english،,0,0,1,1
16476,रीडायरेक्शन,0,0,1,1
16475,кластерах,0,0,1,1
4264,நேசித்தாள்,0,0,1,1
16472,പ്രത്യേകിച്ച്,0,0,1,1
16471,verhungern,0,0,1,1
16470,متردد,0,0,1,1
4266,कहें,0,0,1,1
16466,सुनना,0,0,1,1
16507,الكلمة؟,0,0,1,1
16508,ನೋಡುತ್ತಿದ್ದರು,0,0,1,1
16509,avoiding,0,0,1,1
16538,aanzet,0,0,1,1
16559,oopsla,0,0,1,1
4251,observa,0,0,1,1
16555,τελειώσω,0,0,1,1
16552,лицензирования,0,0,1,1
16550,admiten,0,0,1,1
16549,τραπεζιού,0,0,1,1
4253,அதிகமில்லை,0,0,1,1
16547,விக்கிப்பீடியாவும்,0,0,1,1
16546,anzurufen,0,0,1,1
16544,drogs,0,0,1,1
16543,онлайнсотрудничества,0,0,1,1
16542,staan,0,0,1,1
16541,വച്ചിരുന്നു,0,0,1,1
16539,गुड़िया,0,0,1,1
16537,nauwelijks,0,0,1,1
16510,referenciados,0,0,1,1
16536,formateras,0,0,1,1
16534,உங்களுடைய,0,0,1,1
16533,നിർബന്ധമില്ല,0,0,1,1
16528,физиком,0,0,1,1
16526,дочери,0,0,1,1
16523,medya,0,0,1,1
16520,ഡ്രൈവ്വേയിൽ,0,0,1,1
16519,тадичем,0,0,1,1
16517,выдал,0,0,1,1
16516,liberar,0,0,1,1
4256,kenmerkend,0,0,1,1
16514,aimant,0,0,1,1
16512,себе,0,0,1,1
16511,fann,0,0,1,1
16646,अतिरंजित,0,0,1,1
16647,ilginç,0,0,1,1
16648,wwwwikipediacom،,0,0,1,1
16782,fremstille,0,0,1,1
16773,स्लेशडॉट,0,0,1,1
16776,fassiez,0,0,1,1
16777,åldrarna,0,0,1,1
16778,കഴിക്കേണ്ടതുണ്ട്,0,0,1,1
16779,எதிரான,0,0,1,1
16780,நடைமுறையை,0,0,1,1
16785,الطحين,0,0,1,1
4237,reinforcing,0,0,1,1
4212,இன்றிரவு,0,0,1,1
16787,पीपुल्स,0,0,1,1
4210,മുഖത്തേക്ക്,0,0,1,1
16789,слубице,0,0,1,1
16791,fanger,0,0,1,1
16794,момента,0,0,1,1
4213,distinguir,0,0,1,1
16771,ಶಬ್ದವಾಗಿದೆ,0,0,1,1
16770,உருவாக்கத்திற்கான,0,0,1,1
16769,युद्ध,0,0,1,1
16765,പരിഭ്രാന്തരായി,0,0,1,1
4214,decía,0,0,1,1
4215,vejret,0,0,1,1
16760,يساهم,0,0,1,1
16759,dwaze,0,0,1,1
16757,ಅರ್ಪಿಸಿದ್ದಕ್ಕಾಗಿ,0,0,1,1
4216,आकाश,0,0,1,1
16755,группу,0,0,1,1
16753,последнюю,0,0,1,1
4219,υψηλό,0,0,1,1
16750,സ്ഥാനത്ത്,0,0,1,1
4221,اللوحات,0,0,1,1
16746,övergett,0,0,1,1
16795,കവിഞ്ഞു,0,0,1,1
16798,güzelliğe,0,0,1,1
16799,quick,0,0,1,1
16817,ചവറും,0,0,1,1
16839,تعديلات،,0,0,1,1
16838,китайских,0,0,1,1
16836,lågkvalitetsändringar,0,0,1,1
16835,гриллини,0,0,1,1
16834,«sensibles»,0,0,1,1
16831,κεντρικής,0,0,1,1
16829,жена,0,0,1,1
4203,نتابع,0,0,1,1
16826,verändert,0,0,1,1
16824,обсерватории»,0,0,1,1
16822,habituel,0,0,1,1
16821,أتمنى,0,0,1,1
16820,praktiken,0,0,1,1
16818,pareciam,0,0,1,1
16816,suggérant,0,0,1,1
16801,उदास,0,0,1,1
16815,ننظر,0,0,1,1
16814,bildiğim,0,0,1,1
16813,artificiell,0,0,1,1
16812,estagnação,0,0,1,1
4206,proteção,0,0,1,1
16810,ಮುಳುಗುವುದು,0,0,1,1
16809,visually,0,0,1,1
16808,लेखकों,0,0,1,1
4207,стратегию,0,0,1,1
16806,отдельных,0,0,1,1
16805,oneetbaar,0,0,1,1
16804,wanted,0,0,1,1
16803,ತಿನ್ನಬಹುದಾದ,0,0,1,1
4208,ಟೇಬಲ್,0,0,1,1
4222,ಮಾಣಿಕ್ಯಗಳ,0,0,1,1
16744,steady,0,0,1,1
16743,«отделения,0,0,1,1
16676,psychologie,0,0,1,1
16692,صالح,0,0,1,1
16691,വിവരങ്ങളലൂടെ,0,0,1,1
16690,crítico,0,0,1,1
16689,βαθιά,0,0,1,1
16687,peace,0,0,1,1
4229,zehn,0,0,1,1
16684,முதற்பக்கத்தில்,0,0,1,1
4230,தரங்கள்,0,0,1,1
16682,toets,0,0,1,1
16681,встретить,0,0,1,1
16680,பதிப்பொன்றை,0,0,1,1
16679,للاستفادة,0,0,1,1
16678,nordkorea,0,0,1,1
4231,répartition,0,0,1,1
16674,målet,0,0,1,1
16695,جزءًا,0,0,1,1
16668,தொடங்கியது,0,0,1,1
16667,اقبل,0,0,1,1
4233,फिलोसोफी,0,0,1,1
16665,письме,0,0,1,1
16664,geográfica,0,0,1,1
16663,अकार्डिंग,0,0,1,1
16661,misleidende,0,0,1,1
16657,പരിശോധനാ,0,0,1,1
16656,udviklet,0,0,1,1
16655,pensées,0,0,1,1
16654,كثير,0,0,1,1
4235,dúvidas,0,0,1,1
16651,indecisa,0,0,1,1
16650,hemispheres,0,0,1,1
16694,പ്രസിദ്ധീകരണങ്ങളും,0,0,1,1
4228,முன்னால்,0,0,1,1
4223,traducidos,0,0,1,1
4227,isterse,0,0,1,1
16736,esquece,0,0,1,1
16735,τηλεγραφήματος,0,0,1,1
4226,chevrontexaco,0,0,1,1
16732,abiertas,0,0,1,1
16731,raakte,0,0,1,1
16730,ಪ್ರೀತಿಯ,0,0,1,1
16729,വലുതാണെന്ന്,0,0,1,1
16728,gouvernance,0,0,1,1
16726,afluencia,0,0,1,1
16725,exigir,0,0,1,1
16724,interdit,0,0,1,1
16723,σαλάτες,0,0,1,1
16722,costume,0,0,1,1
16720,internacionalmente,0,0,1,1
16716,ακαδημαϊκό,0,0,1,1
16698,réseau »,0,0,1,1
16715,नॉनफिक्शन,0,0,1,1
16714,ചേർക്കാവുന്നതാണ്,0,0,1,1
16713,lagstiftningen,0,0,1,1
16712,الكتب,0,0,1,1
16710,clasificado,0,0,1,1
16709,прекрасна,0,0,1,1
16708,பசியாக,0,0,1,1
16707,ಕಲಿಯಿರಿ,0,0,1,1
16705,сайты,0,0,1,1
16703,aanleidinggevend,0,0,1,1
16702,revolves,0,0,1,1
16701,privata,0,0,1,1
16700,ഭാഗ്യവാനായ,0,0,1,1
16699,المدهشة,0,0,1,1
17245,ईमेल,0,0,1,1
17246,одноимённым,0,0,1,1
17247,kæpheste,0,0,1,1
4100,ഭക്ഷണവും,0,0,1,1
17747,منع,0,0,1,1
17748,i»,0,0,1,1
17749,expanding,0,0,1,1
17750,irlandais,0,0,1,1
17751,وأيضًا,0,0,1,1
17752,ficava,0,0,1,1
17754,anónimos,0,0,1,1
17716,பிரதிபலிப்பில்,0,0,1,1
17755,языке»,0,0,1,1
17756,consertar,0,0,1,1
4099,लगाते,0,0,1,1
17759,óbvio,0,0,1,1
17760,ميلًا,0,0,1,1
17761,riktat,0,0,1,1
17744,अशिष्टता,0,0,1,1
17742,benutzt,0,0,1,1
17741,مسؤولة,0,0,1,1
17740,τονίσετε,0,0,1,1
17738,διεύθυνση,0,0,1,1
17736,താമസിച്ചിരുന്നു,0,0,1,1
17735,hakkı,0,0,1,1
17733,privado,0,0,1,1
17732,causou,0,0,1,1
17731,определенно,0,0,1,1
17730,namorada,0,0,1,1
4102,citerade,0,0,1,1
17726,främställs,0,0,1,1
17724,erfolgreich,0,0,1,1
17723,pertenecen,0,0,1,1
17722,സ്വാഭാവികമായും,0,0,1,1
4103,sahte,0,0,1,1
4098,palace,0,0,1,1
17764,रहने,0,0,1,1
17765,hjärtskadad,0,0,1,1
17787,opened,0,0,1,1
17808,سياسة,0,0,1,1
17807,i̇ngilizcede,0,0,1,1
17806,bios,0,0,1,1
17805,negativa,0,0,1,1
17804,propiciado,0,0,1,1
17801,തെറ്റെഴുതിയാൽ,0,0,1,1
17800,inletts,0,0,1,1
17799,nätcommunities,0,0,1,1
17798,linguistics,0,0,1,1
4090,αγαπώ,0,0,1,1
17793,yaşadığı,0,0,1,1
17792,μαζικής,0,0,1,1
17789,വജ്രങ്ങളിലും,0,0,1,1
4091,útiles,0,0,1,1
17786,id •,0,0,1,1
4096,denunció,0,0,1,1
17785,hi •,0,0,1,1
17783,dirigée,0,0,1,1
17782,bry,0,0,1,1
17780,എഴുതിവെക്കുന്നതും,0,0,1,1
17778,учителем,0,0,1,1
17777,barajando,0,0,1,1
17774,hansson,0,0,1,1
17773,—familiar,0,0,1,1
17772,ചെറുതുള്ളികൾ,0,0,1,1
17771,المضي,0,0,1,1
17770,ഒരാളുടെ,0,0,1,1
4095,faisons,0,0,1,1
17768,colaboran,0,0,1,1
17767,fracción,0,0,1,1
17717,وبدون,0,0,1,1
17715,arkiverade,0,0,1,1
17616,bıraktıysanız,0,0,1,1
17654,salud​,0,0,1,1
4116,армией,0,0,1,1
4115,ಕೇಳಬಹುದಾದ,0,0,1,1
17650,செப்டம்பர்,0,0,1,1
4114,निषिद्ध,0,0,1,1
17652,αγώνας,0,0,1,1
17653,широкому,0,0,1,1
17655,shell,0,0,1,1
17714,possibilités,0,0,1,1
17658,وجدوا,0,0,1,1
17659,ಶಬ್ದವನ್ನು,0,0,1,1
4113,concentrée,0,0,1,1
17661,tillåta,0,0,1,1
17662,söylediğinde,0,0,1,1
17664,tricky,0,0,1,1
4117,pluripotency,0,0,1,1
17643,ಆಟವನ್ನು,0,0,1,1
17640,ارى,0,0,1,1
17639,lugna,0,0,1,1
17638,cultivée,0,0,1,1
17637,अंक,0,0,1,1
17636,amérique,0,0,1,1
17634,डार्टमाउथ,0,0,1,1
17633,മത്സരം,0,0,1,1
17632,പഠനത്തിന്,0,0,1,1
17627,patrón,0,0,1,1
17625,പരീക്ഷണം,0,0,1,1
17624,wellordered,0,0,1,1
17623,فتى,0,0,1,1
17622,παντρευτεί,0,0,1,1
17621,ustedes,0,0,1,1
17619,അവസ്ഥയിലായിരിക്കുക,0,0,1,1
17667,ஃபேஸ்புக்,0,0,1,1
17668,enregistrés,0,0,1,1
17669,вежливым,0,0,1,1
17690,croissant,0,0,1,1
17713,волнует,0,0,1,1
17712,திருமண,0,0,1,1
17709,вышел,0,0,1,1
17708,maître,0,0,1,1
17705,власти,0,0,1,1
17704,افعل,0,0,1,1
17703,πρόταση,0,0,1,1
17702,göz,0,0,1,1
4107,डेल्ही,0,0,1,1
17699,likeknop,0,0,1,1
17698,मोडल,0,0,1,1
17697,оперативно,0,0,1,1
17696,ഇടാൻ,0,0,1,1
4108,jerga,0,0,1,1
17689,ressources,0,0,1,1
17670,blandad,0,0,1,1
17688,ampliaría,0,0,1,1
17687,externas,0,0,1,1
4109,വാക്യങ്ങളോ,0,0,1,1
17685,unutulmamalıdır,0,0,1,1
17684,pensez,0,0,1,1
17683,бесплатного,0,0,1,1
17682,« valeur »,0,0,1,1
17681,offrir,0,0,1,1
17677,इनक्यूबेटर,0,0,1,1
4111,resuméer,0,0,1,1
17675,yaparsınız,0,0,1,1
17674,தொலைபேசியில்,0,0,1,1
4112,claude,0,0,1,1
17671,باستنتاج,0,0,1,1
17809,cultivé,0,0,1,1
17810,kültürlü,0,0,1,1
17811,”smaklöst”,0,0,1,1
4074,acreditada,0,0,1,1
17940,воспроизведение,0,0,1,1
17941,مقالات،,0,0,1,1
17942,duyarım,0,0,1,1
17943,değildi,0,0,1,1
17945,schmecken,0,0,1,1
17946,பேச்சாளர்கள்,0,0,1,1
17949,serverklustren,0,0,1,1
17813,preguntaba,0,0,1,1
17950,ಯಾರೋ,0,0,1,1
17951,घुस,0,0,1,1
17952,schnellen,0,0,1,1
17960,fpr,0,0,1,1
17961,использовали,0,0,1,1
17962,dadian,0,0,1,1
17936,acontecimientos,0,0,1,1
17934,schlägt,0,0,1,1
17932,upright,0,0,1,1
17931,كافحت,0,0,1,1
4075,utgångspunkt,0,0,1,1
4076,जाएं,0,0,1,1
17925,பாரம்பரியக்,0,0,1,1
17923,acıktım,0,0,1,1
17922,souris,0,0,1,1
17921,कानूनों,0,0,1,1
17920,systémique,0,0,1,1
17919,inclusréf,0,0,1,1
17918,afgewezen,0,0,1,1
17917,liedjes,0,0,1,1
17916,paysagères,0,0,1,1
17914,அறிக்கையையும்,0,0,1,1
17913,تسمية,0,0,1,1
17964,числе,0,0,1,1
17965,nankín,0,0,1,1
17966,betegner,0,0,1,1
17986,όντα,0,0,1,1
18006,анонсирована,0,0,1,1
18005,behalve,0,0,1,1
18004,generating,0,0,1,1
18003,atribuições,0,0,1,1
18002,toppositie,0,0,1,1
18000,fictitious,0,0,1,1
17999,опираться,0,0,1,1
17998,ഉണ്ടാകും,0,0,1,1
17997,സൈന്യം,0,0,1,1
17995,magique,0,0,1,1
17994,بي،,0,0,1,1
17993,téléphonique,0,0,1,1
17989,استئناف,0,0,1,1
17988,kutsche,0,0,1,1
17985,sædvanlige,0,0,1,1
4072,ansiklopedilerden,0,0,1,1
17984,ನುಡಿಗಟ್ಟುಗಳ,0,0,1,1
17983,الحكم,0,0,1,1
17982,guerras,0,0,1,1
17980,everyday,0,0,1,1
17978,لجميع,0,0,1,1
17977,στατιστικές,0,0,1,1
17976,πηγαίνει,0,0,1,1
17975,synder,0,0,1,1
17974,തിരുത്തുകൾ,0,0,1,1
17973,pauvres,0,0,1,1
4071,galerie,0,0,1,1
17971,идея,0,0,1,1
17970,многоуровневую,0,0,1,1
17969,परिष्कृत।,0,0,1,1
17912,engeller,0,0,1,1
17910,yı,0,0,1,1
4077,nongouvernementales,0,0,1,1
17839,perplexed,0,0,1,1
17860,källkritik,0,0,1,1
17859,συνειδητοποιήσετε,0,0,1,1
17858,intensives,0,0,1,1
17857,transmit,0,0,1,1
17855,göklerin,0,0,1,1
17851,متباينة،,0,0,1,1
17850,yapmasına,0,0,1,1
17849,üzülme,0,0,1,1
17848,violates,0,0,1,1
17847,te •,0,0,1,1
17844,contest,0,0,1,1
17843,προσπαθήστε,0,0,1,1
17842,mandarei,0,0,1,1
17841,tamamlanmayacağı,0,0,1,1
17838,acrescentando,0,0,1,1
17863,greatly,0,0,1,1
17837,உடைந்துவிட்டது,0,0,1,1
17835,klassiska,0,0,1,1
17833,المعرفية،,0,0,1,1
17832,tommelfingre,0,0,1,1
17831,βανδαλισμός,0,0,1,1
17830,iyiyim,0,0,1,1
17827,فارس,0,0,1,1
17826,gratitude,0,0,1,1
17825,stylistic,0,0,1,1
17824,rappeler,0,0,1,1
17823,принципах,0,0,1,1
17822,ஸ்லக்,0,0,1,1
17815,متعدد,0,0,1,1
17814,reject,0,0,1,1
17862,lika,0,0,1,1
17865,ύπνο,0,0,1,1
17907,суток,0,0,1,1
17888,konkurrens,0,0,1,1
4079,handlede,0,0,1,1
17904,ضغطت,0,0,1,1
17903,представления,0,0,1,1
17902,σελίδες,0,0,1,1
17901,wegener,0,0,1,1
17900,affecting,0,0,1,1
17899,സ്വപ്ന,0,0,1,1
17897,மீளப்பெறவோ,0,0,1,1
17896,founding,0,0,1,1
17895,væk,0,0,1,1
4080,dilim,0,0,1,1
17893,signos,0,0,1,1
17892,uppslukad,0,0,1,1
17890,particles,0,0,1,1
17887,génèrent,0,0,1,1
4083,intresseväckande,0,0,1,1
17886,risken,0,0,1,1
17885,yapıldığı,0,0,1,1
17884,फ्लुमॉक्स,0,0,1,1
17882,استضافة,0,0,1,1
4081,அழுகிற,0,0,1,1
17879,udøver,0,0,1,1
17878,شائعة,0,0,1,1
17877,militent,0,0,1,1
17876,vänsterpolitisk,0,0,1,1
17875,ಜೀವಿಗಳು,0,0,1,1
17874,ಬಯಸಿದ್ದರು,0,0,1,1
17873,என்பதைப்,0,0,1,1
17872,laid,0,0,1,1
17871,obsession,0,0,1,1
17617,handlung,0,0,1,1
17614,сформулировало,0,0,1,1
17248,enciclopédicos,0,0,1,1
17362,voorstellen,0,0,1,1
17353,سياق,0,0,1,1
17355,неспособность,0,0,1,1
17356,invite,0,0,1,1
17357,kaffee,0,0,1,1
17359,معا,0,0,1,1
17361,تضع,0,0,1,1
17363,ಗೋಲ್ಡನ್,0,0,1,1
17329,स्लेव,0,0,1,1
17364,उत्साहित,0,0,1,1
17365,उठाते,0,0,1,1
17366,δροσερές,0,0,1,1
17368,igualmente,0,0,1,1
17369,fria,0,0,1,1
17372,وسيم,0,0,1,1
4142,drink,0,0,1,1
4143,podrías,0,0,1,1
17350,proposer,0,0,1,1
17349,enfants,0,0,1,1
17348,ಯೂಟ್ಯೂಬ್‌ನಲ್ಲಿ,0,0,1,1
17346,veckotidskrifterna,0,0,1,1
17345,γραφής,0,0,1,1
17344,ಕೋನದಲ್ಲಿ,0,0,1,1
17343,reporters,0,0,1,1
17342,χαζή,0,0,1,1
17341,अति,0,0,1,1
17340,cümleleri,0,0,1,1
17339,पक्षपातहीन,0,0,1,1
17338,leckeren,0,0,1,1
17337,sebebiyet,0,0,1,1
17333,അലക്കു,0,0,1,1
17332,wikeepeedeeə,0,0,1,1
17373,σαλιγκαριών,0,0,1,1
17374,mínima,0,0,1,1
17375,आयी,0,0,1,1
17398,cuadro,0,0,1,1
4137,മകളുടെ,0,0,1,1
17416,हेल्लो,0,0,1,1
17415,klottrares,0,0,1,1
17413,boken,0,0,1,1
17412,valendo,0,0,1,1
17411,intervalle,0,0,1,1
17410,உயரிய,0,0,1,1
4138,« seuls,0,0,1,1
4139,ведомства,0,0,1,1
17407,beskytte,0,0,1,1
17406,любила,0,0,1,1
17405,decomposition,0,0,1,1
17403,gagner,0,0,1,1
17400,regeln,0,0,1,1
17395,усталым,0,0,1,1
17378,commentary,0,0,1,1
17394,വിശ്വസിക്കാൻ,0,0,1,1
17393,പ്രശ്‌നമായിരുന്നു,0,0,1,1
17392,olmasıdır,0,0,1,1
17391,تبكي؟,0,0,1,1
17390,பார்த்தான்,0,0,1,1
17388,defecto,0,0,1,1
17387,trabalhista,0,0,1,1
17386,തീരുമാനമാണെന്നും,0,0,1,1
17385,चुपके,0,0,1,1
17384,walls,0,0,1,1
17383,வெளியேற,0,0,1,1
17382,ಮುಕ್ತರಾಗಿದ್ದೀರಾ,0,0,1,1
17381,inexacta,0,0,1,1
17380,ഇന്ത്യയിൽ,0,0,1,1
17331,eminim,0,0,1,1
17328,mystère,0,0,1,1
17613,വിഷയങ്ങളിലുള്ള,0,0,1,1
17276,viessem,0,0,1,1
17270,uyar,0,0,1,1
17271,garantir,0,0,1,1
17272,ಮಾಡಿದ್ದರೆ,0,0,1,1
17273,viola,0,0,1,1
17274,υγρότοπου,0,0,1,1
17275,desigualdades,0,0,1,1
17278,προτιμούσα,0,0,1,1
17327,reviendra,0,0,1,1
17279,пересадки,0,0,1,1
17280,الكلام,0,0,1,1
17281,ложные,0,0,1,1
17282,kleidungssinn,0,0,1,1
17283,സുഖമാണോ,0,0,1,1
17284,spannends,0,0,1,1
17269,സമ്പ്രദായത്തെ,0,0,1,1
17268,dayan,0,0,1,1
17267,കന്നഡ,0,0,1,1
17265,محظوظًا,0,0,1,1
17264,attendues ,0,0,1,1
17263,bienvenidos,0,0,1,1
17262,gekopieerde,0,0,1,1
17261,اللحظة,0,0,1,1
17260,functionality,0,0,1,1
17259,குழப்புவது,0,0,1,1
17258,employée,0,0,1,1
17257,செய்யப்படுகின்றன,0,0,1,1
4154,കൊട്ടാരത്തിൽ,0,0,1,1
4156,ml —,0,0,1,1
17251,prettiest,0,0,1,1
17250,relire,0,0,1,1
17249,licencesf,0,0,1,1
17285,والمتألقة,0,0,1,1
17286,ജോലികൾ,0,0,1,1
17287,आंद्रे,0,0,1,1
17307,δολάρια,0,0,1,1
17326,destinadas,0,0,1,1
17325,"
finlandês",0,0,1,1
17324,cayo,0,0,1,1
17323,ταξίδευαν,0,0,1,1
17322,l’animisme,0,0,1,1
17321,റഷ്യൻ,0,0,1,1
17320,ಸೈನಿಕರಿಗೆ,0,0,1,1
4146,telefonda,0,0,1,1
17316,spectre,0,0,1,1
17315,logowedstrijd,0,0,1,1
4147,köşedeki,0,0,1,1
17312,simbólicos,0,0,1,1
17310,neerlandesa,0,0,1,1
17308,centradas,0,0,1,1
4149,monthly,0,0,1,1
4152,κλάμα,0,0,1,1
17304,കണ്ടിട്ടില്ലെന്നാണ്,0,0,1,1
17303,delecionismo,0,0,1,1
17302,deletionism,0,0,1,1
17301,ننتقل,0,0,1,1
17300,haklıydın,0,0,1,1
17299,diep,0,0,1,1
17298,октября,0,0,1,1
17296,anlamadınız,0,0,1,1
17295,സംസാരിക്കുന്നുണ്ടാകാം,0,0,1,1
17293,cumplan,0,0,1,1
17292,désignées,0,0,1,1
17291,menino,0,0,1,1
17290,sl •,0,0,1,1
4150,اعتقاده,0,0,1,1
17420,நியூயார்க்கைச்,0,0,1,1
17422,أسمع,0,0,1,1
17424,कूद,0,0,1,1
17549,biliyor,0,0,1,1
17541,mundo—​​,0,0,1,1
17542,unterbrechen,0,0,1,1
17543,ಹಣವನ್ನು,0,0,1,1
4129,знаменитой,0,0,1,1
17545,συμπεριλαμβανομένης,0,0,1,1
17547,sizden,0,0,1,1
17550,intentado,0,0,1,1
17425,ಖಂಡಿತವಾಗಿಯೂ,0,0,1,1
17551,plays,0,0,1,1
17552,पर्यटन,0,0,1,1
17556,إشارة,0,0,1,1
17558,विभाजन,0,0,1,1
17560,expose,0,0,1,1
17561,ατρόμητο,0,0,1,1
17539,mirando,0,0,1,1
17537,estén,0,0,1,1
17536,écrivit,0,0,1,1
17535,علاوة,0,0,1,1
17532,teveel,0,0,1,1
17531,பயிற்சி,0,0,1,1
17530,दान,0,0,1,1
17529,संसाधन,0,0,1,1
4130,القرصنة,0,0,1,1
17527,planeo,0,0,1,1
17526,domination,0,0,1,1
17525,ಕ್ರಿಯಾಪದವಾಗಿ,0,0,1,1
17524,intéressantes,0,0,1,1
17523,impulsado,0,0,1,1
17521,rakesh,0,0,1,1
17519,கருத்தொருமிப்புப்,0,0,1,1
17518,حياتها,0,0,1,1
17562,borç,0,0,1,1
17563,plötsligt,0,0,1,1
17565,mirándola,0,0,1,1
4122,попасть,0,0,1,1
17612,പോവുന്നത്,0,0,1,1
17610,geometría,0,0,1,1
17609,intentional,0,0,1,1
17608,προωθήθηκα,0,0,1,1
17607,ക്രോസ്സ്,0,0,1,1
17605,ornamentation,0,0,1,1
17604,devant,0,0,1,1
4119,χαρακτηριστικά,0,0,1,1
17602,jet,0,0,1,1
17601,صعبًا,0,0,1,1
17600,farväl,0,0,1,1
4120,الخلوي؟,0,0,1,1
17598,tilfældig,0,0,1,1
17596,contrastes,0,0,1,1
17591,استندت,0,0,1,1
17568,ek,0,0,1,1
17590,zorgelijke,0,0,1,1
17589,യന്ത്രപഠനത്തെ,0,0,1,1
17588,تقطع,0,0,1,1
4123,weiteres,0,0,1,1
17583,обычный,0,0,1,1
4125,droit ,0,0,1,1
17581,perçoit,0,0,1,1
17580,похожи,0,0,1,1
17578,удаление,0,0,1,1
17576,yanılıyorsun,0,0,1,1
17574,disais,0,0,1,1
17573,revidera,0,0,1,1
17571,desfazer,0,0,1,1
17569,تقييم,0,0,1,1
17517,statistiquement,0,0,1,1
17514,நிர்வாகிகளினால்,0,0,1,1
17513,requeria,0,0,1,1
17444,столлмана,0,0,1,1
17464,gerçekleşir,0,0,1,1
17463,mantle,0,0,1,1
17460,schools,0,0,1,1
17457,hjerne,0,0,1,1
17455,cuidas,0,0,1,1
17454,foregik,0,0,1,1
17453,വ്യാജ,0,0,1,1
17452,raro,0,0,1,1
17451,स्कोप,0,0,1,1
17450,nodes,0,0,1,1
17448,الإتمامِ,0,0,1,1
17447,wonder,0,0,1,1
17446,ложной,0,0,1,1
17445,naïvement,0,0,1,1
17443,معقولة,0,0,1,1
17466,hamburger,0,0,1,1
17441,évoquant,0,0,1,1
17439,leída,0,0,1,1
17438,funktionsprincip,0,0,1,1
17436,science »,0,0,1,1
17435,மீளமைக்கப்படக்,0,0,1,1
17434,prefixo,0,0,1,1
17433,tipografía,0,0,1,1
4134,المسائل,0,0,1,1
17431,varient,0,0,1,1
4135,jugé,0,0,1,1
17429,luminosity,0,0,1,1
17428,அழுகிறீர்கள்,0,0,1,1
17427,fourthhighest,0,0,1,1
17426,इलेक्ट्रोनिका,0,0,1,1
4133,يأتون,0,0,1,1
17469,flooding,0,0,1,1
17512,multiagent,0,0,1,1
17493,intelectual —,0,0,1,1
17510,संदेह,0,0,1,1
17509,प्रकाशनों,0,0,1,1
4131,சிரிக்கத்,0,0,1,1
17505,സാഹചര്യത്തെ,0,0,1,1
17503,путешествие,0,0,1,1
17502,femininas,0,0,1,1
17501,fleste,0,0,1,1
17500,दयालु,0,0,1,1
17499,tränen,0,0,1,1
17498,encargado,0,0,1,1
17497,تتصدر,0,0,1,1
17496,approved,0,0,1,1
4132,ബ്രെഡിൽ,0,0,1,1
17494,أخبرني,0,0,1,1
17490,خارجية،,0,0,1,1
17470,കർമ്മ,0,0,1,1
17489,abartmak,0,0,1,1
17488,comentários,0,0,1,1
17486,roda,0,0,1,1
17485,replaces,0,0,1,1
17484, علمية,0,0,1,1
17483,œil,0,0,1,1
17482,relus,0,0,1,1
17481,നഷ്‌ടപ്പെട്ടു,0,0,1,1
17479,servantes,0,0,1,1
17478,معنا,0,0,1,1
17477,надёжности,0,0,1,1
17476,utgåvorna,0,0,1,1
17472,actualité,0,0,1,1
17471,أمس,0,0,1,1
16465,inscreverse,0,0,1,1
16463,"
quirguiz",0,0,1,1
14957,ഇതിനായി,0,0,1,1
15449,encyclopédien,0,0,1,1
15439,историю,0,0,1,1
15441,произносите,0,0,1,1
15442,tellurique,0,0,1,1
4396,cherche,0,0,1,1
15445,socio,0,0,1,1
15446,soluciones,0,0,1,1
15450,لنبدأ,0,0,1,1
15418,സ്പീക്കറിൽ,0,0,1,1
4395,अत्याचारपूर्ण,0,0,1,1
15453,tightening,0,0,1,1
15454,கருத்துக்,0,0,1,1
4394,مثالية,0,0,1,1
15458,«anónima»,0,0,1,1
15459,законах,0,0,1,1
15438,solicitada,0,0,1,1
15437,десятка»,0,0,1,1
15436,guided,0,0,1,1
15435,salataları,0,0,1,1
15434,πάρει,0,0,1,1
15431,تحتل,0,0,1,1
15430,umursayamazdım,0,0,1,1
15429,аспирантом,0,0,1,1
15428,merveilleux,0,0,1,1
15427,encantado,0,0,1,1
15426,पूछता,0,0,1,1
15425,"
म्यान्मारी",0,0,1,1
15424,disponível,0,0,1,1
15423,الغالب,0,0,1,1
15422,милые,0,0,1,1
15421,adicionam,0,0,1,1
15420,सी,0,0,1,1
15460,informationskällor,0,0,1,1
4392,mestadels,0,0,1,1
15465,المائة,0,0,1,1
15491,κάθεστε,0,0,1,1
15512,ഉപയോഗിക്കരുത്,0,0,1,1
15511,தண்ணீர்,0,0,1,1
15510,δώρο,0,0,1,1
15509,ഇല്ലെങ്കിൽ,0,0,1,1
15508,положительной,0,0,1,1
15507,diderot,0,0,1,1
15505,tenu,0,0,1,1
4388,ιδεολογιών,0,0,1,1
15500,taïwan,0,0,1,1
15499,ifadeyi,0,0,1,1
15496,tituló,0,0,1,1
15495,ips,0,0,1,1
15494,réciproquement,0,0,1,1
15493,sınava,0,0,1,1
15489,செயலை,0,0,1,1
15467,απολυτο,0,0,1,1
15488,nahezu,0,0,1,1
15487,തിരുത്തുന്നതിനും,0,0,1,1
15486,ಅರ್ಥಮಾಡಿಕೊಳ್ಳಲು,0,0,1,1
15485,سلبية,0,0,1,1
15484,rentrant,0,0,1,1
15483,публикацию,0,0,1,1
15481,للإعجاب,0,0,1,1
15480,എന്തെങ്കിലുമൊക്കെ,0,0,1,1
15478,أقدر,0,0,1,1
15477,desafortunadamente,0,0,1,1
15475,producen,0,0,1,1
4391,heldere,0,0,1,1
15473,pudiste,0,0,1,1
15468,целиком,0,0,1,1
15419,കാഴ്ച്ചപ്പാട്,0,0,1,1
15417,multidões,0,0,1,1
4387,laureada,0,0,1,1
4408,« naissance »,0,0,1,1
15346,memnun,0,0,1,1
15347,wikiprocedurerne,0,0,1,1
15348,മന്ദഗതിയിലായിരുന്നു,0,0,1,1
4410,போகிறோம்,0,0,1,1
15351,самим,0,0,1,1
4409,वॉन,0,0,1,1
15356,википроектов,0,0,1,1
15415,ondernemer,0,0,1,1
15357,gevoel,0,0,1,1
15359,samfundsvidenskab,0,0,1,1
4406,എഴുതുന്നത്,0,0,1,1
15363,മനസ്സിലായി,0,0,1,1
15365,enciende,0,0,1,1
15366,ಸೈರ್,0,0,1,1
15344,distribuer,0,0,1,1
15343,редактором,0,0,1,1
15342,പ്രവൃത്തിയാണെന്ന്,0,0,1,1
15341,magasiner,0,0,1,1
15340,alejandro,0,0,1,1
15339,surveillants,0,0,1,1
15338,datas,0,0,1,1
15337,تحسينات,0,0,1,1
4412,stelle,0,0,1,1
15335,bekende,0,0,1,1
15333,dönük,0,0,1,1
15332,स्वाभाविक,0,0,1,1
15331,absurdas,0,0,1,1
15330,verborreica,0,0,1,1
15329,uppslagsverksartikel,0,0,1,1
15327,förstör,0,0,1,1
4415,incluía,0,0,1,1
15368,ತಬ್ಬಿಕೊಳ್ಳಲು,0,0,1,1
4405,præcision,0,0,1,1
15371,ಚಿನ್ನವನ್ನು,0,0,1,1
15393,hastily,0,0,1,1
4398,учитель,0,0,1,1
15413,отправлении,0,0,1,1
4399,gebruikers,0,0,1,1
15410,சமயங்களில்,0,0,1,1
15409,പരിശീലിപ്പിക്കുകയും,0,0,1,1
15408,abordé,0,0,1,1
15406,приступим,0,0,1,1
4400,datamining,0,0,1,1
15401,recevant,0,0,1,1
15399,ηχείου,0,0,1,1
15397,africâner,0,0,1,1
15396,другого,0,0,1,1
4401,typografisk,0,0,1,1
15394,succèdent,0,0,1,1
15392,gevonden,0,0,1,1
15373,fängelser,0,0,1,1
15391,bahçelerinde,0,0,1,1
15390,وقانون,0,0,1,1
15389,πλημμύρα,0,0,1,1
15387,വിലമതിക്കാനാവാത്തത്,0,0,1,1
4402,ταξίδεψε,0,0,1,1
15384,onzichtbaar,0,0,1,1
15383,செல்போனைப்,0,0,1,1
15381,ಇಲ್ಲಿಯೇ,0,0,1,1
15380,stannar,0,0,1,1
15379,obtain,0,0,1,1
4403,deformed,0,0,1,1
15377,feraisje,0,0,1,1
15375,castillo,0,0,1,1
4404,admiring,0,0,1,1
15513,"
hindi",0,0,1,1
15515,pájaro,0,0,1,1
16462,ആശയക്കുഴപ്പത്തിലാക്കി,0,0,1,1
15656,निर्माणात्मक,0,0,1,1
15648,تغيير,0,0,1,1
15649,للإجماع,0,0,1,1
4371,primitif,0,0,1,1
15652,merdé,0,0,1,1
4370,uninitiated,0,0,1,1
15655,civilisé,0,0,1,1
15657,goleiro,0,0,1,1
15621,ನೋಡಿ,0,0,1,1
15658,удивительной,0,0,1,1
15659,exército,0,0,1,1
15661,chamar,0,0,1,1
15662,prazo,0,0,1,1
15663,сетевая,0,0,1,1
15664,opmuntring,0,0,1,1
15647,yüce,0,0,1,1
15646,nietbestaande,0,0,1,1
15643,всему,0,0,1,1
15642,susceptibility,0,0,1,1
15641,ഉപയോഗത്തിനും,0,0,1,1
4372,هائل,0,0,1,1
15639,expresado,0,0,1,1
15638,सच्चाई,0,0,1,1
4373,ordagrant,0,0,1,1
15634,dioxide,0,0,1,1
15633,характерной,0,0,1,1
15632,hsts,0,0,1,1
15630,بعدد,0,0,1,1
15629,redevenue,0,0,1,1
15628,görülebilir,0,0,1,1
15627,incorrectes,0,0,1,1
15623,litígios,0,0,1,1
15667,empirique,0,0,1,1
15668,achevé,0,0,1,1
15669,sustantivo,0,0,1,1
4367,சொற்றொடர்களைப்,0,0,1,1
4366,necesarios,0,0,1,1
15706,ಸುಂದರರು,0,0,1,1
15705,högskolebibliotekarien,0,0,1,1
15704,falsa—,0,0,1,1
15701,изложение,0,0,1,1
15699,تحاول,0,0,1,1
15698,previa,0,0,1,1
15697,அனுப்பி,0,0,1,1
15696,الاختبار,0,0,1,1
15695,δώσουμε,0,0,1,1
15694,veranderde,0,0,1,1
15693,физической,0,0,1,1
15692,brisés,0,0,1,1
15691,instantáneo,0,0,1,1
15689,trabalhando,0,0,1,1
15671,بكتابة,0,0,1,1
4368,oneindig,0,0,1,1
15687,тематическому,0,0,1,1
15686,prioridad,0,0,1,1
15685,inmediato,0,0,1,1
15684,بوضوح,0,0,1,1
15682, €,0,0,1,1
15680,prohibieron,0,0,1,1
15679,officiële,0,0,1,1
15678,mk •,0,0,1,1
15677,एजेंसियों,0,0,1,1
15676,raros,0,0,1,1
15675,தன்,0,0,1,1
15673,немецких,0,0,1,1
15672,ಅಸಭ್ಯವಾಗಿ,0,0,1,1
15622,août,0,0,1,1
15620,والذي,0,0,1,1
15516,مرتين,0,0,1,1
15552,célèbre,0,0,1,1
15541,«введите,0,0,1,1
15542,evaluates,0,0,1,1
15546,fonctionner,0,0,1,1
15547,namnrymder,0,0,1,1
15549,nyskapade,0,0,1,1
15550,мировым,0,0,1,1
15553,மணி,0,0,1,1
15619,ansågs,0,0,1,1
15555,передаётся,0,0,1,1
15556,ചിയേഴ്സ്,0,0,1,1
15557,நேர்மறை,0,0,1,1
4380,rocken,0,0,1,1
15564,ബംഗാളി,0,0,1,1
15566,astronomers,0,0,1,1
15538,دخل,0,0,1,1
4381,गुजरते,0,0,1,1
4382,desciclopédia,0,0,1,1
15535,security”,0,0,1,1
15534,μη,0,0,1,1
15533,കാര്യമോ,0,0,1,1
15532,കൂട്ടിച്ചേർത്തോളും,0,0,1,1
15531,ಟ್,0,0,1,1
4386,செயல்படுகிறீர்களானால்,0,0,1,1
15525,valorize,0,0,1,1
15524,estructura,0,0,1,1
15523,nämn,0,0,1,1
15522,या।,0,0,1,1
15521,klottraren,0,0,1,1
15520,globala,0,0,1,1
15519,julien,0,0,1,1
15517,attesté,0,0,1,1
4378,presione,0,0,1,1
15572,форматах,0,0,1,1
15573,невероятно,0,0,1,1
4374,unnecessary,0,0,1,1
15617,ದೂರ,0,0,1,1
15616,حان,0,0,1,1
15614,வைத்தீர்கள்,0,0,1,1
15613,സാവധാനത്തിൽ,0,0,1,1
15612,vinkede,0,0,1,1
15611,pratiquezla,0,0,1,1
15610,rothenburg,0,0,1,1
15607,encombrants,0,0,1,1
15606,bewegt,0,0,1,1
15604,dilemmasmartwörter,0,0,1,1
15603,distribuídas,0,0,1,1
15602,விட்டுவிட்டால்,0,0,1,1
15601,ആഴ്ച,0,0,1,1
15600,virtually,0,0,1,1
4375,forment,0,0,1,1
15575,cargo,0,0,1,1
15595,плохо,0,0,1,1
15590,अभिनेता,0,0,1,1
15589,திரும்பப்,0,0,1,1
4377,diretor,0,0,1,1
15587,знай,0,0,1,1
15585,ذهبوا,0,0,1,1
15584,antecedência,0,0,1,1
15583,enseignements,0,0,1,1
15582,activas—,0,0,1,1
15581,மெர்ரி,0,0,1,1
15579,gevolg,0,0,1,1
15578,ആശയക്കുഴപ്പമുണ്ടായാൽ,0,0,1,1
15577,convergent,0,0,1,1
15576,nachricht,0,0,1,1
4416,toman,0,0,1,1
15323,расскажет,0,0,1,1
15322,atingiu,0,0,1,1
15085,физикохимических,0,0,1,1
15076,çalışmıyorsa,0,0,1,1
15077,mediafiler,0,0,1,1
15078,seriös,0,0,1,1
15081,forstår,0,0,1,1
15082,supprimer,0,0,1,1
15083,apprécie,0,0,1,1
15086,फैंसी,0,0,1,1
15050,англоязычного,0,0,1,1
15088,επισκευή,0,0,1,1
15089,görmemişsinizdir,0,0,1,1
15091,sachez,0,0,1,1
15092,έναρξη,0,0,1,1
15093,mastersmagisterexamen,0,0,1,1
4448,подошел,0,0,1,1
15075,skapar,0,0,1,1
15073,titeln,0,0,1,1
15072,വിഷമമുണ്ടെന്ന്,0,0,1,1
15071,fortsetzt,0,0,1,1
15067,"
हिब्रू",0,0,1,1
15066,النموذج,0,0,1,1
15065,നിയന്ത്രിക്കപ്പെട്ടിരിക്കുന്നു,0,0,1,1
15063,thailand,0,0,1,1
15061,इंटरविकी,0,0,1,1
4450,minderårig,0,0,1,1
15059,εσυ,0,0,1,1
15058,памятник,0,0,1,1
15057,rythme,0,0,1,1
15056,വിരലുകളിൽ,0,0,1,1
15054,αναστατωθείς,0,0,1,1
15053,بالتشعب,0,0,1,1
4451,ചിത്രങ്ങളും,0,0,1,1
4447,έδαφος,0,0,1,1
15097,سن,0,0,1,1
4446,تي,0,0,1,1
15121,fiesta,0,0,1,1
15139,efectuada,0,0,1,1
15138,alfred,0,0,1,1
15137,negativas,0,0,1,1
15136,पूर्वाग्रहों,0,0,1,1
15135,работников,0,0,1,1
15133,скрыты,0,0,1,1
15131,defendam,0,0,1,1
15130,ആക്റ്റിവിസത്തിന്റെ,0,0,1,1
15129,rapides,0,0,1,1
4439,целью,0,0,1,1
15126,விலங்கு,0,0,1,1
15125,الفكرة,0,0,1,1
15124,росту,0,0,1,1
15123,galten,0,0,1,1
15120,ലേഖനങ്ങളുടേയും,0,0,1,1
15100,lejos,0,0,1,1
4440,ಸುಸಂಸ್ಕೃತ,0,0,1,1
15118,opdagelse,0,0,1,1
15117,ಅಕ್ಷರಶಃ,0,0,1,1
15115,desarrollamos,0,0,1,1
15114,வடிவியல்,0,0,1,1
15112,ചെയ്യുന്നതായി,0,0,1,1
15111,ചോദിക്കുന്നുണ്ടെങ്കിൽ,0,0,1,1
15110,لثلاثة,0,0,1,1
4444,ಕಲಿಯಲು,0,0,1,1
15106,освободить,0,0,1,1
15105,அடுத்ததாக,0,0,1,1
15104,ಅಭಿನಂದಿಸುವ,0,0,1,1
4445,إحساسها,0,0,1,1
15101,muttersprachler,0,0,1,1
15051,പോലും,0,0,1,1
15049,сообществом,0,0,1,1
15321,placements,0,0,1,1
14993,കൂടിക്കാഴ്ചയ്ക്ക്,0,0,1,1
14985,பார்த்ததில்லை,0,0,1,1
14987,மாற்றங்களைப்,0,0,1,1
14988,gösterenlerin,0,0,1,1
4456,विज्ञापनों,0,0,1,1
14990,cobrindo,0,0,1,1
14991,ಟೆಲಿಗ್ರಾಮ್,0,0,1,1
14994,nuttig,0,0,1,1
15048,abusive,0,0,1,1
14995,lækre,0,0,1,1
14997,opportunity,0,0,1,1
14998,uzbekistan,0,0,1,1
14999,pancarte,0,0,1,1
15000,ligações,0,0,1,1
15001,yorumlar,0,0,1,1
14984,bretonne,0,0,1,1
14982,нужным,0,0,1,1
4457,ಸಿದ್ಧಪಡಿಸಿದ್ದೇನೆ,0,0,1,1
14980,melpiger,0,0,1,1
14979,स्तब्ध,0,0,1,1
14978,comparaisons,0,0,1,1
14976,лечатся,0,0,1,1
14974,¿debería,0,0,1,1
14972,சந்திப்பைப்,0,0,1,1
14971,ತಯಾರಿಸಲಾಗುತ್ತದೆ,0,0,1,1
14970,ಬೇರೇನಾದರೂ,0,0,1,1
14966,bienfondé,0,0,1,1
14964,ευχαριστήσω,0,0,1,1
14963,याचना,0,0,1,1
14960,køre,0,0,1,1
14959,ತಾಯಿಯಲ್ಲ,0,0,1,1
4458,colegial,0,0,1,1
15003,fund,0,0,1,1
15004,حلم,0,0,1,1
4455,produziu,0,0,1,1
15029,извлечением,0,0,1,1
4453,авторитетность,0,0,1,1
15045,ആൾ,0,0,1,1
15044,iteration,0,0,1,1
15043,ಮುಳುಗಬಹುದು,0,0,1,1
15042,aprendiendo,0,0,1,1
15041,"
टोंगीयाई",0,0,1,1
15040,യന്ത്രപഠനത്തിൽ,0,0,1,1
15038,seriøst,0,0,1,1
15036,സമയങ്ങളിൽ,0,0,1,1
15035,redaktionell,0,0,1,1
15034,gustaban,0,0,1,1
15033,разговора,0,0,1,1
15031,специального,0,0,1,1
15030,обозначен,0,0,1,1
15028,logiquement,0,0,1,1
15008,kompakt,0,0,1,1
15027,felter,0,0,1,1
15024,gosta,0,0,1,1
15022,capture,0,0,1,1
15021,المسؤولين,0,0,1,1
15020,émoussé,0,0,1,1
15019,ಒಳ್ಳೆಯವನು,0,0,1,1
15017,upptäckts,0,0,1,1
15016,exclure,0,0,1,1
15015,fördel,0,0,1,1
15014,mehlmädchen,0,0,1,1
15013,bevarade,0,0,1,1
15011,வீடியோவைப்,0,0,1,1
15010,retirada,0,0,1,1
15009,المجانية,0,0,1,1
15140,empirisme,0,0,1,1
15141,nãoparcialidade,0,0,1,1
15142,vanlig,0,0,1,1
15266,കഴിയാത്ത,0,0,1,1
15258,قريب,0,0,1,1
15260,സന്തോഷകരമായ,0,0,1,1
4425,concrétisation,0,0,1,1
15263,eylem,0,0,1,1
15264,schwester,0,0,1,1
15265,adicción»,0,0,1,1
15268,pricing,0,0,1,1
15145,इंटरेक्टिव,0,0,1,1
15269,υπευθυνότητας,0,0,1,1
15270,açıklar,0,0,1,1
15271,نسخة,0,0,1,1
15272,متكررة,0,0,1,1
15273,கேள்விக்குறியுடன்,0,0,1,1
15274,hörnet,0,0,1,1
15257,cinematch,0,0,1,1
15256,conhecida,0,0,1,1
15255,dejó,0,0,1,1
15250,தொழில்நுட்பத்தை,0,0,1,1
15249,зарегистрированный,0,0,1,1
15248,masanın,0,0,1,1
15247,fallacieuse,0,0,1,1
15246,подобного,0,0,1,1
15245,भूलें।,0,0,1,1
15244,ജർമൻ,0,0,1,1
15241,രാജ്യത്തേക്ക്,0,0,1,1
4428,définitivement,0,0,1,1
15237,quinlan,0,0,1,1
4429,tilgå,0,0,1,1
4430,weken,0,0,1,1
15234,araştırmayı,0,0,1,1
15233,жаловался,0,0,1,1
15275,والكتالونية,0,0,1,1
15277,प्रारूप,0,0,1,1
15279,hakkını,0,0,1,1
15302,பயன்படுத்தித்,0,0,1,1
15319,ಅನಿಸುತ್ತದೆ,0,0,1,1
15318,السيدات,0,0,1,1
15317,salater,0,0,1,1
15315,ചെയ്യുന്നതെന്ന്,0,0,1,1
15314,ಬಯಸುತ್ತಾಳೆ,0,0,1,1
15313,άχρηστο,0,0,1,1
15312,transformations,0,0,1,1
4417,γραμματοσειρά,0,0,1,1
15310,silberbrot,0,0,1,1
15308,«читать,0,0,1,1
15306,urbaine,0,0,1,1
4418,flore,0,0,1,1
15304,удовольствием,0,0,1,1
15303,everybodywiki,0,0,1,1
15301,wendt,0,0,1,1
15280,percentage,0,0,1,1
4420,पंथ,0,0,1,1
15296,мамой,0,0,1,1
15295,опыт,0,0,1,1
15294,"
काशुबियाई",0,0,1,1
15293,pointed,0,0,1,1
4422,животное,0,0,1,1
15289,¿sabrías,0,0,1,1
15288,ತಿನ್ನಲಾಗದ,0,0,1,1
15287,nachdenken,0,0,1,1
15286,மக்களுக்கு,0,0,1,1
15285,collègues,0,0,1,1
15284,المعادي,0,0,1,1
15283,τυχερό,0,0,1,1
15282,marche ,0,0,1,1
15232,rádio,0,0,1,1
15231,بالمقارنة،,0,0,1,1
4431,koblet,0,0,1,1
15169,ഭൗതികപ്രപഞ്ചത്തെ,0,0,1,1
4438,transcendentalism,0,0,1,1
15183,hunnit,0,0,1,1
15182,स्वचालित,0,0,1,1
15181,καλούντα,0,0,1,1
15180,respecta,0,0,1,1
15179,கண்டுபிடிப்பின்படி,0,0,1,1
15178,വേരുകൾ,0,0,1,1
15177,ಅಳುತ್ತಿರುವ,0,0,1,1
15176,confeccionar,0,0,1,1
15175,ранней,0,0,1,1
15174,contributes,0,0,1,1
15172,soy,0,0,1,1
15171,إداريو,0,0,1,1
15170,польского,0,0,1,1
15168,newly,0,0,1,1
15187,quebrou,0,0,1,1
15166,bedecken,0,0,1,1
15165,fragmented,0,0,1,1
15163,эгоистичный,0,0,1,1
15162,എട്ട്,0,0,1,1
15161,amusing,0,0,1,1
15159,vistas,0,0,1,1
15157,succesvol,0,0,1,1
15156,angebot,0,0,1,1
15155,depende,0,0,1,1
15152,действительные,0,0,1,1
15151,impressa,0,0,1,1
15149,udbrød,0,0,1,1
15147,നാമെല്ലാവരും,0,0,1,1
15146,uger,0,0,1,1
15185,proceeds,0,0,1,1
15188,усилия,0,0,1,1
15229,crowdsourcing ,0,0,1,1
4434,intresserade,0,0,1,1
15228,trails,0,0,1,1
15226,ಹಾಸ್ಯವನ್ನು,0,0,1,1
15225,industrialisés,0,0,1,1
15224,gällande,0,0,1,1
15223,विकिमिडिया,0,0,1,1
15222,placeret,0,0,1,1
15221,представлять,0,0,1,1
15220,scolastique ,0,0,1,1
15218,kısmının,0,0,1,1
15217,ஸ்டால்மன்,0,0,1,1
15216,eligió,0,0,1,1
15214,പഠിക്കും,0,0,1,1
15213,conhecidos,0,0,1,1
15212,ಪ್ರಾರಂಭಿಸಲು,0,0,1,1
15208,forbi,0,0,1,1
15189,أداة,0,0,1,1
15206,കുട്ടികൾ,0,0,1,1
15205,المهمة,0,0,1,1
15204,alexnet,0,0,1,1
15203,serieuze,0,0,1,1
15201,nonlinearity,0,0,1,1
15200,autorización,0,0,1,1
15199,pounds,0,0,1,1
15197,попрощавшись,0,0,1,1
15195,profunda,0,0,1,1
15194,connotation,0,0,1,1
4437,vågnede,0,0,1,1
15192,virtuellement,0,0,1,1
15191,ведущих,0,0,1,1
15190,préconisent,0,0,1,1
4365,действии,0,0,1,1
15709,syltetøj,0,0,1,1
4363,contended,0,0,1,1
16217,ρωτήσεις,0,0,1,1
16208,китая,0,0,1,1
16211,rojo,0,0,1,1
16212,sunmuştur,0,0,1,1
16213,نشطة,0,0,1,1
16214,resistência,0,0,1,1
16216,apareció,0,0,1,1
16219,paradoxalement,0,0,1,1
16187,fondant,0,0,1,1
16221,விளம்பர,0,0,1,1
16222,etmelerini,0,0,1,1
4301,heraus,0,0,1,1
16225,δανείσετε,0,0,1,1
16226,സവിശേഷതയാണ്,0,0,1,1
4300,ficará,0,0,1,1
16207,διάσημο,0,0,1,1
16206,καλλιέργεια,0,0,1,1
16205,அனைவருக்கும்,0,0,1,1
16204,делают,0,0,1,1
16203,संगठित,0,0,1,1
16202,easiest,0,0,1,1
16201,аналитически,0,0,1,1
16200,exercice,0,0,1,1
16198,drivs,0,0,1,1
16197,سأستخدمه,0,0,1,1
16196,الشريحة,0,0,1,1
16194,quisieras,0,0,1,1
16193,congé,0,0,1,1
16192,крест,0,0,1,1
16191,basan,0,0,1,1
16190,lærer,0,0,1,1
4304,bepaalde,0,0,1,1
4297,"
लाडिनो",0,0,1,1
16229,поиске,0,0,1,1
16230,proclamé,0,0,1,1
16253,administrativa,0,0,1,1
16269,propostas,0,0,1,1
16268,φοβερού,0,0,1,1
16266,முயற்சிகள்,0,0,1,1
16265,prospectivement,0,0,1,1
16264,வழியாக,0,0,1,1
16263,secretively,0,0,1,1
16262,produzida,0,0,1,1
16261,estamos,0,0,1,1
16260,ക്ലിക്കുചെയ്യുന്നത്,0,0,1,1
4294,utilisons,0,0,1,1
16257,излагались,0,0,1,1
16256,ищем,0,0,1,1
16255,எழுதப்பட்ட,0,0,1,1
16254,போராடிய,0,0,1,1
16251,недостоверной,0,0,1,1
16232,acompanha,0,0,1,1
16250,gedag,0,0,1,1
16249,habido,0,0,1,1
16245,relatado,0,0,1,1
16244,ಬಯಸದಿದ್ದರೆ,0,0,1,1
16243,inducción,0,0,1,1
16242,encontrase,0,0,1,1
16240,shell—including,0,0,1,1
16239,यो,0,0,1,1
16238,постепенно,0,0,1,1
4295,"rely
heavily",0,0,1,1
16236,"sciences ·
പരിതഃസ്ഥിതിക",0,0,1,1
16235,rike,0,0,1,1
16234,बेकार,0,0,1,1
4296,നല്ലൊരു,0,0,1,1
4305,отслеживать,0,0,1,1
16184,கூட்டாக,0,0,1,1
16082,svåra,0,0,1,1
16120,ഹെല്ലർ,0,0,1,1
16112,άνθρωποι,0,0,1,1
16114,—en,0,0,1,1
16115,methoden,0,0,1,1
16116,attribué,0,0,1,1
16117,количеству,0,0,1,1
16118,संदर्भ,0,0,1,1
16121,മേശപ്പുറത്ത്,0,0,1,1
4306,emblématique,0,0,1,1
16122,lu,0,0,1,1
16123,texts,0,0,1,1
16126,conmovido,0,0,1,1
16128,"
checo",0,0,1,1
16130,derrière,0,0,1,1
16131,प्रौद्योगिकी,0,0,1,1
16111,أقلل,0,0,1,1
16110,സംരക്ഷിക്കുക,0,0,1,1
16108,ലേഖനങ്ങളാണ്,0,0,1,1
16107,ordered,0,0,1,1
4312,"
नेपाल",0,0,1,1
16103,doy,0,0,1,1
16102,"l
किसी",0,0,1,1
16101,ولديك,0,0,1,1
16100,хорошие,0,0,1,1
16097,waraywaray,0,0,1,1
16096,strikta,0,0,1,1
16095,‘மென்பொருட்கள்’,0,0,1,1
16094,titel,0,0,1,1
16091,उद्धृत,0,0,1,1
16090,cogna,0,0,1,1
16089,deceased,0,0,1,1
16086,باراك,0,0,1,1
16132,hosts,0,0,1,1
16133,anlamsızca,0,0,1,1
16135,yüksek,0,0,1,1
4308,voir ,0,0,1,1
16182,"
malgaxe",0,0,1,1
16181,ಐದು,0,0,1,1
16179,масштабах,0,0,1,1
16177,démagogie,0,0,1,1
16176,schrecklichen,0,0,1,1
16175,أزمة,0,0,1,1
16174,spicules,0,0,1,1
16170,hemlighetsfullt,0,0,1,1
16166,ओमेगाविकि,0,0,1,1
16165,संवेदनशील,0,0,1,1
16164,ಡೆಲ್ಹಿಯಲ್ಲಿ,0,0,1,1
16163,जड़ें,0,0,1,1
16162,​​te,0,0,1,1
16161,отчасти,0,0,1,1
16158,நேர்மையாக,0,0,1,1
16136,starrten,0,0,1,1
16157,المربى,0,0,1,1
16156,augustus,0,0,1,1
16155,assistant,0,0,1,1
16153,restaurangen,0,0,1,1
16152,canapé,0,0,1,1
4309,студент,0,0,1,1
16147,appalling,0,0,1,1
16146,løgne,0,0,1,1
16145,ഉപയോഗിക്കുന്നത്,0,0,1,1
16144,çıkarmaktadır,0,0,1,1
16143,നടപ്പിലാക്കാമെന്ന,0,0,1,1
16141,discrimination,0,0,1,1
4310,منقوشة,0,0,1,1
16137,wikipédien,0,0,1,1
16270,tendríamos,0,0,1,1
16271,gestern,0,0,1,1
16274,أحدًا,0,0,1,1
16405,confie,0,0,1,1
16398,intrinsic,0,0,1,1
16399,தொகுக்கக்கூடியவாறு,0,0,1,1
16400,uhr,0,0,1,1
16402,الرابع,0,0,1,1
16403,ಬುದ್ಧಿವಂತಿಕೆಯು,0,0,1,1
16404,ಕಲಿಯಲಿದ್ದೇವೆ,0,0,1,1
16406,ഗൂണാങ്കങ്ങളിൽ,0,0,1,1
16275,hingekommen,0,0,1,1
4279,overschreden,0,0,1,1
16409,എന്നിങ്ങനെയുള്ള,0,0,1,1
16410,ചേരുന്നതും,0,0,1,1
16411,கிடைக்கவேண்டும்”,0,0,1,1
16413,d’aller,0,0,1,1
4276,pişirmeme,0,0,1,1
16397,snabba,0,0,1,1
16396,أية,0,0,1,1
16395,عنها,0,0,1,1
16394,പണ്ഡിതനും,0,0,1,1
16393,minimize,0,0,1,1
16390,relationer,0,0,1,1
16386,sponges,0,0,1,1
16385,évaluer,0,0,1,1
16384,жёстких,0,0,1,1
16383,مسيئة،,0,0,1,1
16382,применялись,0,0,1,1
4281,проявляется,0,0,1,1
16380,bloggers,0,0,1,1
16379,criálos,0,0,1,1
16378,αποφθεγμάτων,0,0,1,1
16376,استهدفت,0,0,1,1
16375,большинстве,0,0,1,1
4275,الألمانية،,0,0,1,1
4274,esquina,0,0,1,1
16419,വൃത്തികെട്ടതും,0,0,1,1
4270,besteht,0,0,1,1
4268,للحظة,0,0,1,1
16459,officielles,0,0,1,1
16458,pojken,0,0,1,1
16457,​​kolayca,0,0,1,1
16456,bogstaveligt,0,0,1,1
16455,hypertext,0,0,1,1
16454,parcs,0,0,1,1
4269,brincam,0,0,1,1
16452,handhållna,0,0,1,1
16451,ಟ್ರಿಕಿ,0,0,1,1
16449,описал,0,0,1,1
16448,പ്രാവീണ്യമുള്ളവരാകാനുള്ള,0,0,1,1
16447,steigern,0,0,1,1
16446,genehmigung,0,0,1,1
16444,दूरदूर,0,0,1,1
16422,lus,0,0,1,1
16443,ದೂರದವರೆಗೆ,0,0,1,1
16440,normalden,0,0,1,1
16437,uninformed,0,0,1,1
16436, ˌwɪkɨˈpiːdiə,0,0,1,1
16435,பக்கம்,0,0,1,1
16433,ζώο,0,0,1,1
16432,recrutar,0,0,1,1
16430,முடிவுகளில்,0,0,1,1
16429,особенных,0,0,1,1
4272,مهتم,0,0,1,1
16427,tenían,0,0,1,1
16425,düşünmeye,0,0,1,1
16424,இயங்கத்,0,0,1,1
16423,anarchy,0,0,1,1
4282,ihtiyacım,0,0,1,1
16372,коллектив,0,0,1,1
16371,verschilt,0,0,1,1
16296,efe,0,0,1,1
16317,interpretada,0,0,1,1
16315,cérebro,0,0,1,1
16313,ಮಾಡಿದ್ದೀರಿ,0,0,1,1
16312,പിന്നിലുണ്ടെങ്കിലേ,0,0,1,1
16311,يسجلون,0,0,1,1
16310,مدخلات,0,0,1,1
16308,petits,0,0,1,1
4289,fils,0,0,1,1
4290,മനസിലാക്കാൻ,0,0,1,1
16302,глагол,0,0,1,1
16301,расскажи,0,0,1,1
16299,orkanen,0,0,1,1
16298,ಬಿಟ್ಟಿದ್ದರೆ,0,0,1,1
16297,существовало,0,0,1,1
16295,γυμνοσάλιαγκας,0,0,1,1
16321,sinken,0,0,1,1
16294,செயன்முறையின்,0,0,1,1
16292,купить,0,0,1,1
4291,londinense,0,0,1,1
16289,leuke,0,0,1,1
16288,zweifel,0,0,1,1
16286,попал,0,0,1,1
16285,अपमान,0,0,1,1
16284,amsterdã,0,0,1,1
16283,позволяло,0,0,1,1
16282,ejercen,0,0,1,1
16280,uitgehongerd,0,0,1,1
4292,जानवर,0,0,1,1
16278,ب,0,0,1,1
16277,وcebuano،,0,0,1,1
4288,stopped,0,0,1,1
16322,ошибок,0,0,1,1
16370,ഗുണാങ്കങ്ങൾ,0,0,1,1
16345,ചാനലിലേക്ക്,0,0,1,1
16369,இருக்கிறோம்,0,0,1,1
16368,slepend,0,0,1,1
16367,hiérarchique,0,0,1,1
16365,تسحب,0,0,1,1
16364,ತ್ವರಿತ,0,0,1,1
16361,находилась,0,0,1,1
16360,anlam,0,0,1,1
16358,அளவுத்திட்டத்துக்கு,0,0,1,1
16357,ನಡವಳಿಕೆ,0,0,1,1
16356,выпущено,0,0,1,1
16355,sentiment,0,0,1,1
16353,slut,0,0,1,1
16352,घबराए,0,0,1,1
16347,அழைக்க,0,0,1,1
16344,مجهول,0,0,1,1
4287,"
सर्बोक्रोएशियाई",0,0,1,1
16343,मानते,0,0,1,1
16340,hundirse,0,0,1,1
4284,«invirtió,0,0,1,1
16338,ഉപയോക്താവിന്,0,0,1,1
16337,விருத்தி,0,0,1,1
16335,σύγκριση,0,0,1,1
16333,ಖಚಿತವಿಲ್ಲ,0,0,1,1
4285,aralık,0,0,1,1
16331,navigateur,0,0,1,1
16330,оптических,0,0,1,1
16329,manteau,0,0,1,1
16328,أليكسا،,0,0,1,1
4286,complétés,0,0,1,1
16325,eventuella,0,0,1,1
16083,ajuda,0,0,1,1
16081,wahrscheinlich,0,0,1,1
4362,редактируются,0,0,1,1
15838,بذلك؟,0,0,1,1
15829,humor,0,0,1,1
15830,നോട്ടത്തിൽ,0,0,1,1
15831,promoção,0,0,1,1
15833,intelligentie,0,0,1,1
15835,ശ്രമകരമായിത്തോന്നാം,0,0,1,1
15836,flavio,0,0,1,1
15839,suitors,0,0,1,1
4350,statistiskt,0,0,1,1
15840,सर्चिंग,0,0,1,1
15841,смущенной,0,0,1,1
15842,അനുകൂല,0,0,1,1
15843,märka,0,0,1,1
15844,relativas,0,0,1,1
15848,الحيوية,0,0,1,1
15826,وتعتمد,0,0,1,1
4349,olvida,0,0,1,1
15824,« doncosaque »,0,0,1,1
15823,ಆಯ್ಕೆಗಳ,0,0,1,1
15822,iii»,0,0,1,1
15819,உதாரணத்திற்கு,0,0,1,1
15818,revisionréf,0,0,1,1
15817,упрекать,0,0,1,1
15815,lutou,0,0,1,1
15814,hayret,0,0,1,1
15813,réutilisations,0,0,1,1
15811,вялой,0,0,1,1
15810,británica»,0,0,1,1
15809,« six,0,0,1,1
15808,चित्रwiki,0,0,1,1
15807,"
coreano",0,0,1,1
15806,डगलस,0,0,1,1
15849,μεγαλύτερη,0,0,1,1
15851,öğretmen,0,0,1,1
15852,डिजीटल,0,0,1,1
15873,récente,0,0,1,1
15888,hayan,0,0,1,1
4341,पृष्टों,0,0,1,1
15885,आमेरिकेन,0,0,1,1
15884,fantastic,0,0,1,1
15883,ನೋಡಿದಾಗ,0,0,1,1
15882,sahipse,0,0,1,1
15881,விடைபெறாமல்,0,0,1,1
15880,томах,0,0,1,1
4343,equidad,0,0,1,1
15878,processing‏,0,0,1,1
15877,للتطوير,0,0,1,1
15876,सहायक,0,0,1,1
15875,كلي,0,0,1,1
15874,hap,0,0,1,1
15872,പ്രശ്നമുള്ള,0,0,1,1
15853,شهورًا,0,0,1,1
15871,heartbroken,0,0,1,1
15870,kazandı,0,0,1,1
4344,زيادة,0,0,1,1
15867,sahibi,0,0,1,1
15866,« on,0,0,1,1
15865,reportedly,0,0,1,1
15864,afortunada,0,0,1,1
15863,طفلي,0,0,1,1
15861,сделана,0,0,1,1
15860,الدراسة,0,0,1,1
4346,interpretações,0,0,1,1
15858,zamanın,0,0,1,1
15856,വർദ്ധിക്കുമ്പോൾ,0,0,1,1
15855,исследованиях,0,0,1,1
15805,مقابلة,0,0,1,1
15803,projetsa,0,0,1,1
16080,وكلمة,0,0,1,1
15742,marques,0,0,1,1
15733,извиняюсь,0,0,1,1
15734,tidens,0,0,1,1
15735,поисковыми,0,0,1,1
15737,साल,0,0,1,1
15740,manager,0,0,1,1
15741,ചേരാത്തതുമായ,0,0,1,1
15743,വിക്കിഎഴുതുന്നതെല്ലാം,0,0,1,1
15802,ഫിക്സ്,0,0,1,1
15744,സംസാരിക്കുന്നു,0,0,1,1
15745,бесчисленное,0,0,1,1
15746,endişelenmeyin,0,0,1,1
15747,ತಿಳಿದಿರುವುದರಿಂದ,0,0,1,1
15749,melekle,0,0,1,1
15750,ശ്വസിക്കാൻ,0,0,1,1
15732,தொகுக்கப்படும்,0,0,1,1
4359,достоянии,0,0,1,1
15729,salladerna,0,0,1,1
15728,geométricos,0,0,1,1
15726,γυρίζει,0,0,1,1
4360,nobody,0,0,1,1
4361,விளம்பரங்களின்,0,0,1,1
15723,फुल्का,0,0,1,1
15722,arıyoruz,0,0,1,1
15720,clay,0,0,1,1
15719,requérant,0,0,1,1
15717,ഒന്നു,0,0,1,1
15716,hrw,0,0,1,1
15715,തെളിവുകൾ,0,0,1,1
15714,narzissen,0,0,1,1
15713,ಚಂದಾದಾರರಾಗಲು,0,0,1,1
15712,نارسيسا,0,0,1,1
15754,остановились,0,0,1,1
15755,alimentar,0,0,1,1
15756,ಕಾಣಬಹುದು,0,0,1,1
4353,لهجات,0,0,1,1
15800,eliminação,0,0,1,1
15799,especificar,0,0,1,1
15798,ederler,0,0,1,1
15797,цифрового,0,0,1,1
15795,légitimes,0,0,1,1
15792,piracy,0,0,1,1
15790,aussi ,0,0,1,1
15788,വസ്തുക്കളുടെ,0,0,1,1
15787,asistentes,0,0,1,1
15785,இணையானது,0,0,1,1
15783,ಬಾಲ್ಕನಿಯಲ್ಲಿ,0,0,1,1
15781,chiffré,0,0,1,1
15778,ಮಾಡುತ್ತೇನೆ,0,0,1,1
15777,kasparov,0,0,1,1
15773,являясь,0,0,1,1
15757,статей»,0,0,1,1
15772,εργασίας,0,0,1,1
15771,créateur ,0,0,1,1
15770,மகளின்,0,0,1,1
15769,dissimilar,0,0,1,1
15768,введена,0,0,1,1
15767,telefoongesprek,0,0,1,1
15765,воды,0,0,1,1
4355,ಸ್ಪಾಟ್,0,0,1,1
4356,ಸಾಲ,0,0,1,1
15762,sacaste,0,0,1,1
15761,dépendent,0,0,1,1
4357,ആശ്ചര്യപ്പെടുത്തുന്നതാണ്,0,0,1,1
15759,forbløffet,0,0,1,1
4358,hände,0,0,1,1
15890,retención,0,0,1,1
15891,impulsando,0,0,1,1
15892,kafasını,0,0,1,1
16026,blackbody,0,0,1,1
16017,gebeurd,0,0,1,1
16019,стволовых,0,0,1,1
16020,തുടങ്ങുവാനോ,0,0,1,1
16023,ചതുപ്പുനിലമായിട്ടുണ്ട്,0,0,1,1
16024,confundi,0,0,1,1
16025,"
उदाहरण",0,0,1,1
16027,revelam,0,0,1,1
15894,istersiniz,0,0,1,1
16029,വരാനുള്ള,0,0,1,1
16030,şans,0,0,1,1
4321,—clusters—,0,0,1,1
16032,culturas,0,0,1,1
16033,கலிஃபோர்னியாவில்,0,0,1,1
16036,difíceis,0,0,1,1
16016,تسجيل,0,0,1,1
16014,ouvrir,0,0,1,1
16013,« vandalismes »,0,0,1,1
16011,raakt,0,0,1,1
4322,السؤال,0,0,1,1
16009,annotera,0,0,1,1
16008,ağlıyorsa,0,0,1,1
4323,ತಲುಪಲು,0,0,1,1
16001,ബെൽഗാം,0,0,1,1
15998,reappeared,0,0,1,1
15997,தெரிவிக்க,0,0,1,1
15996,magiska,0,0,1,1
15995,φόρεμα,0,0,1,1
15994, kilotonne,0,0,1,1
15993,jacopo,0,0,1,1
15992,clef,0,0,1,1
15991,mutsuz,0,0,1,1
16037,fresco,0,0,1,1
16038,aardappelen,0,0,1,1
16039,düşünüyorsun,0,0,1,1
16063,ஏற்படுத்தவில்லை,0,0,1,1
4314,esbozo,0,0,1,1
16077,характера,0,0,1,1
16076,என்பதற்கு,0,0,1,1
16075,ഔദ്യോഗിക,0,0,1,1
16074,skills,0,0,1,1
16073,വിറ്റതായി,0,0,1,1
16072,anadili,0,0,1,1
16071,stormy,0,0,1,1
16069,وديسمبر,0,0,1,1
16068,ньюйорке,0,0,1,1
16067,еженедельник,0,0,1,1
16066,എന്നില്ല,0,0,1,1
16065,wachsen,0,0,1,1
16064,pretende,0,0,1,1
16060,yenilerinin,0,0,1,1
16040,ووسيم,0,0,1,1
16059,ഡാറ്റയാണ്,0,0,1,1
16058,എന്നാലും,0,0,1,1
4316,டிகிரிக்குக்,0,0,1,1
16056,τονισμό,0,0,1,1
16054,bg •,0,0,1,1
16053,détection,0,0,1,1
16051,excitante,0,0,1,1
16048,estrategias,0,0,1,1
16047,forskere,0,0,1,1
16046,fausses,0,0,1,1
4319,ಮಧ್ಯದಲ್ಲಿದ್ದೀರಿ,0,0,1,1
16043,mitigation,0,0,1,1
16042,oradan,0,0,1,1
16041,பயன்படுத்தப்பட்டது,0,0,1,1
15990,överanvändt,0,0,1,1
15989,നേറ്റീവ്,0,0,1,1
15987,അതിലെ,0,0,1,1
15915,complete,0,0,1,1
15934,സ്വതന്ത്രമായി,0,0,1,1
15932,மூழ்கடிப்பது,0,0,1,1
15930,“controlada”,0,0,1,1
15929,использовалось,0,0,1,1
15928,beweegt,0,0,1,1
4332,ವಿರೋಧಾಭಾಸ,0,0,1,1
15925,कोवेन,0,0,1,1
4333,содержала,0,0,1,1
15923,συνεχίστε,0,0,1,1
15922,pasan,0,0,1,1
15920,இலாப,0,0,1,1
15918,momentos,0,0,1,1
15917,företeelsen,0,0,1,1
15916,corpora,0,0,1,1
15912,perfecta,0,0,1,1
15936,ഹീബ്രു,0,0,1,1
15911,trophic,0,0,1,1
15910,adı,0,0,1,1
15909,olayları,0,0,1,1
15908,confronter,0,0,1,1
15907,filósofo,0,0,1,1
15906,decisionmaking,0,0,1,1
15904,ಉಲ್ಲೇಖಿಸಬೇಡಿ,0,0,1,1
15903,sıfatlar,0,0,1,1
15902,redactores,0,0,1,1
15900,குளிர்,0,0,1,1
15899,επομένως,0,0,1,1
15898,conflicto,0,0,1,1
4339,yaşanırsa,0,0,1,1
15895,போரின்போது,0,0,1,1
15935,ದಿನದಿಂದ,0,0,1,1
15937,டைம்,0,0,1,1
15986,analistas,0,0,1,1
4330,koltuğunuzda,0,0,1,1
15985,photography,0,0,1,1
4328,wikipediawatchorg,0,0,1,1
15981,colonies,0,0,1,1
15979,oturuyor,0,0,1,1
4329,преодолении,0,0,1,1
15977,sakinleşin,0,0,1,1
15976,مراجعات,0,0,1,1
15975,transclusion,0,0,1,1
15973,വശങ്ങളും,0,0,1,1
15970,للمحتوى,0,0,1,1
15968,الشأن,0,0,1,1
15967,ficam,0,0,1,1
15962,« immanente » ,0,0,1,1
15961,الحمد,0,0,1,1
15959,испанская —,0,0,1,1
15938,maomé,0,0,1,1
15958,accommodation,0,0,1,1
15955,unbalanced,0,0,1,1
15954,condensing,0,0,1,1
15953,doigt,0,0,1,1
15949,سجل,0,0,1,1
15948,اعتذر,0,0,1,1
15947,ಬಯಸುವಿರಾ,0,0,1,1
15945,veteraner,0,0,1,1
15944,ദർശനം,0,0,1,1
15943,repeated,0,0,1,1
15942,ارتكب,0,0,1,1
15941,αμφισβητούμενο,0,0,1,1
15940,aturdido,0,0,1,1
15939,കാണാത്തപ്പോൾ‌,0,0,1,1
11922,wpartikel,0,0,1,1
11920,بإجمالي,0,0,1,1
30292,énormes,0,0,1,1
7725,bedava,0,0,1,1
7712,commençons,0,0,1,1
7713,wijziging,0,0,1,1
5378,berlim,0,0,1,1
7720,إقراضي,0,0,1,1
7722, gb,0,0,1,1
7724,fría,0,0,1,1
7726,وقدم,0,0,1,1
7681,туристической,0,0,1,1
7727,votes,0,0,1,1
5377,estágios,0,0,1,1
7730,potencial,0,0,1,1
7732,вебсерверов,0,0,1,1
7733,സാമാന്യം,0,0,1,1
5376,“விக்கிமீடீயா”,0,0,1,1
7711,സംഭവിക്കാത്ത,0,0,1,1
7710,universally,0,0,1,1
7709,sınavınız,0,0,1,1
7708,കോമൺസ്,0,0,1,1
7707,stieg,0,0,1,1
7706,« sociotechnique »,0,0,1,1
7705,أظهر,0,0,1,1
7703,upptäckt,0,0,1,1
7698,prédiction,0,0,1,1
7695,  km,0,0,1,1
7694,yazan,0,0,1,1
7692,gittiler,0,0,1,1
7689,ದ,0,0,1,1
7688,préjugés,0,0,1,1
5381,filtrados,0,0,1,1
5382,eruit,0,0,1,1
7685,لصديقهما,0,0,1,1
7735,identifiés,0,0,1,1
7737,स्पार्कली,0,0,1,1
7739,грамматика,0,0,1,1
7760,bright,0,0,1,1
7785,συχνά,0,0,1,1
7784,напуган,0,0,1,1
7783,американская,0,0,1,1
7782,fluentes,0,0,1,1
5368,என்பதைச்,0,0,1,1
7777,تصرفت,0,0,1,1
7773,dosyalar,0,0,1,1
7772,தயாராகிவிட்டேன்,0,0,1,1
7771,sorunu,0,0,1,1
7770,சொல்கிறாரோ,0,0,1,1
7768,കേൾക്കാൻ,0,0,1,1
7767,ഉറവിടങ്ങളുണ്ട്,0,0,1,1
7762,περάσεις,0,0,1,1
7761,ന്യൂപീഡിയ,0,0,1,1
7759,весь,0,0,1,1
5374,etmez,0,0,1,1
5372,سرا,0,0,1,1
7756,câmara,0,0,1,1
5373,förändrats,0,0,1,1
7754,بالنسخة,0,0,1,1
7753,காவியத்தைப்,0,0,1,1
7750,الحلو,0,0,1,1
7749,tapisseries,0,0,1,1
7747,describía,0,0,1,1
7746,encontre,0,0,1,1
7745,أجزاء,0,0,1,1
7744,tenant,0,0,1,1
7743,andamán,0,0,1,1
7742,публично,0,0,1,1
7741,slowing,0,0,1,1
7682,cumulant,0,0,1,1
7679,കൃത്യതയെ,0,0,1,1
7787,bulk,0,0,1,1
7616,увидела,0,0,1,1
7606,проведённое,0,0,1,1
7607,descumprem,0,0,1,1
5396,നിലനിൽക്കുന്നതായി,0,0,1,1
5395,arkadaşların,0,0,1,1
5394,ನಡೆಯುತ್ತಿದ್ದರೆ,0,0,1,1
7615,എത്തി,0,0,1,1
7619,« wikimedia »,0,0,1,1
7678,olmadan,0,0,1,1
7620,olabilirdim,0,0,1,1
7621,തിരികെ,0,0,1,1
7623,सर्व,0,0,1,1
5392,ആവശ്യപ്പെടാത്തപ്പോൾ,0,0,1,1
7626,blackberry,0,0,1,1
7627,एनर्जी,0,0,1,1
7603,skarpa,0,0,1,1
7601,вчера,0,0,1,1
7600,διάστημα,0,0,1,1
5397,مرخص,0,0,1,1
7594,असंभव,0,0,1,1
7593,மூலையில்,0,0,1,1
7592,elevate,0,0,1,1
7591,уволены,0,0,1,1
7590,specificity,0,0,1,1
7589,повседневного,0,0,1,1
7588,கவலைப்பட்டார்,0,0,1,1
5398,bidragydere,0,0,1,1
7586,eğlenceli,0,0,1,1
7585,പെരുവെള്ളം,0,0,1,1
7584,خططًا,0,0,1,1
7582,एसोसिएशन,0,0,1,1
7581,മാതൃ,0,0,1,1
5391,ആശയസംഘട്ടനങ്ങൾ,0,0,1,1
5390,angebote,0,0,1,1
7631,enfatizando,0,0,1,1
7654,hjärna,0,0,1,1
7677,verstehen,0,0,1,1
7674,verwirren,0,0,1,1
7672,chiste,0,0,1,1
5384,ಪ್ರದೇಶವನ್ನು,0,0,1,1
7670,الفوضى,0,0,1,1
7669,combien,0,0,1,1
5386,شخصية,0,0,1,1
7666,consigue,0,0,1,1
7664,täcker,0,0,1,1
5388,المطاف,0,0,1,1
7661,kvantiteten,0,0,1,1
7660,fotograf,0,0,1,1
7657,wetenschappen,0,0,1,1
7655,remerciant,0,0,1,1
7650,رسم,0,0,1,1
7632,militär,0,0,1,1
7649,curtindo,0,0,1,1
7648,döndü,0,0,1,1
7647,لاستخدامها,0,0,1,1
7646,autonomous,0,0,1,1
7645,முகவரிகளினால்,0,0,1,1
7644,кнр,0,0,1,1
7643,afunda,0,0,1,1
7642,« dieu,0,0,1,1
7638,применений,0,0,1,1
7637,الدينية,0,0,1,1
7636,данного,0,0,1,1
7635,ήρεμος,0,0,1,1
7634,amin,0,0,1,1
7633,leken,0,0,1,1
5367,fugles,0,0,1,1
7788,الأفراد,0,0,1,1
7195,distributing,0,0,1,1
7916,cumulatively,0,0,1,1
7908,analys,0,0,1,1
7909,réveillé,0,0,1,1
5353,afirmación,0,0,1,1
7911,സെൽ,0,0,1,1
7914,ദക്ഷതയോടെ,0,0,1,1
7915,onderkend,0,0,1,1
5352,cinéaste,0,0,1,1
7880,தெரிந்த,0,0,1,1
7918,ನಂಬಲಾಗದ,0,0,1,1
7919,seyahatleri,0,0,1,1
7920,जेल,0,0,1,1
7921,hävdade,0,0,1,1
7922,"
स्कॉटिश",0,0,1,1
7923,worse,0,0,1,1
7907,واكتب,0,0,1,1
7906,captó,0,0,1,1
7905,redaktionella,0,0,1,1
7904,crudivorismo,0,0,1,1
7902,merk,0,0,1,1
7901,jemals,0,0,1,1
7900,ответ»,0,0,1,1
7899,இவற்றோடு,0,0,1,1
7898,membres,0,0,1,1
7895,பற்றிய,0,0,1,1
7894,дополнение,0,0,1,1
7891,négatif,0,0,1,1
7890,asiáticas,0,0,1,1
7889,മടുപ്പില്ല,0,0,1,1
7888,informal,0,0,1,1
7884,разве,0,0,1,1
7883,bulundukları,0,0,1,1
5351,полезно,0,0,1,1
7925,subsanadas,0,0,1,1
7926,ടെറൻസും,0,0,1,1
7950,офисы,0,0,1,1
7968,ജോലിയുടെ,0,0,1,1
7967,يضربني,0,0,1,1
7966,elimination,0,0,1,1
7965,بصراحة,0,0,1,1
7963,descargar,0,0,1,1
7962,merak,0,0,1,1
7958,arıyorsanız,0,0,1,1
7957,ಸಿಲುಕಿಕೊಂಡಿದ್ದೀರಿ,0,0,1,1
7956,aesthetics,0,0,1,1
7955,सूत्रपात,0,0,1,1
7954,hemsk,0,0,1,1
7953,എന്തുപറയുന്നു,0,0,1,1
7952,ознакомления,0,0,1,1
7951,uzaklaştılar,0,0,1,1
7948,manifestes,0,0,1,1
7927,cultureel,0,0,1,1
7947,соответствующий,0,0,1,1
7946,ನಿಮ್ಮಲ್ಲಿ,0,0,1,1
7945,interna,0,0,1,1
7942,equilibrado,0,0,1,1
7941,tisch,0,0,1,1
7940,albumet,0,0,1,1
7939,отзыв,0,0,1,1
7938,cyclones,0,0,1,1
5350,unfeasible,0,0,1,1
7934,yakalayamadıysan,0,0,1,1
7933,beweerde,0,0,1,1
7931,gesamte,0,0,1,1
7929,avoirw,0,0,1,1
7928,വസ്തുതകൾ,0,0,1,1
7881,responsabilités,0,0,1,1
7879,accurately,0,0,1,1
7789,gentemot,0,0,1,1
7819,hverdag,0,0,1,1
7812,técnica,0,0,1,1
7813,ഉണ്ടാവുക,0,0,1,1
7814,maddesinden,0,0,1,1
7815,बनता,0,0,1,1
7816,защитной,0,0,1,1
7818,παλάτι,0,0,1,1
7820,запутать,0,0,1,1
7878,मनोनीत,0,0,1,1
7821,insinuer,0,0,1,1
5362,написанием,0,0,1,1
7823,acontecido,0,0,1,1
7824,وبعد,0,0,1,1
7827,slice,0,0,1,1
7828,administrar,0,0,1,1
5363,synapses,0,0,1,1
7809,المساهمة,0,0,1,1
7808,frihetens,0,0,1,1
7805,"
बुगिनी",0,0,1,1
7804,قرّر,0,0,1,1
7803,സ്വപ്‌നം,0,0,1,1
7802,thema,0,0,1,1
7800,hawaiianske,0,0,1,1
7799,aufregendes,0,0,1,1
7798,faux,0,0,1,1
5365,этими,0,0,1,1
7796,organismo,0,0,1,1
7795,behaviour,0,0,1,1
5366,oublient,0,0,1,1
7792,demeliyim,0,0,1,1
7791,incrémentale,0,0,1,1
7790,स्तरों,0,0,1,1
7830,يرتكب,0,0,1,1
7831,اصطدمت,0,0,1,1
7832,nacheinander,0,0,1,1
5360,intención,0,0,1,1
7876,ağladığın,0,0,1,1
5357,financière,0,0,1,1
7871,πόδια,0,0,1,1
5358,പരിഹരിക്കപ്പെടുമെന്നാണ്,0,0,1,1
7866,vertegenwoordigers,0,0,1,1
7865,preguiçosos,0,0,1,1
7862,देखूंगा।,0,0,1,1
7861,لتأثير,0,0,1,1
7860,filters,0,0,1,1
7859,sondage,0,0,1,1
7856,προγράμματα,0,0,1,1
7854,chariot,0,0,1,1
7853,അഭിപ്രായ,0,0,1,1
7852,புழுக்கமாகப்,0,0,1,1
7849,لطيف,0,0,1,1
5361,നിങ്ങളെത്തന്നെ,0,0,1,1
7848,منطقي,0,0,1,1
7847,ставить,0,0,1,1
7846,hypothétique,0,0,1,1
7845,caes,0,0,1,1
7844,സാധ്യമാക്കുന്നത്,0,0,1,1
7843,салаты,0,0,1,1
7842,exhibits,0,0,1,1
7841,συμμετεχόντων,0,0,1,1
7840,ಆವಿಷ್ಕಾರ,0,0,1,1
7839,πηγαίνουμε,0,0,1,1
7838,comparar,0,0,1,1
7837,tumor,0,0,1,1
7836,godaste,0,0,1,1
7835,संबोधित,0,0,1,1
7580,έπεσε,0,0,1,1
7579,north,0,0,1,1
7578,नवाचार,0,0,1,1
7326,ಖರೀದಿಸಿದ,0,0,1,1
7317,naturalmente,0,0,1,1
7320,equivocarse,0,0,1,1
7322,rumano,0,0,1,1
7323,الرائعة,0,0,1,1
7324,آخذك,0,0,1,1
7325,மைஸ்பேஸ்,0,0,1,1
7327,mıyım,0,0,1,1
7287,tatien,0,0,1,1
7331,pies,0,0,1,1
5429,ऑक्सफ़ोर्ड,0,0,1,1
7334,चांदी,0,0,1,1
7335,liaison,0,0,1,1
7336,aşar,0,0,1,1
7337,ஓட்டங்கள்,0,0,1,1
7316,lis,0,0,1,1
7315,ज़ेड,0,0,1,1
5433,hierarchical,0,0,1,1
7313,"
तुर्क",0,0,1,1
7311,ಸರಿಯಾಗಿದ್ದೇನೆ,0,0,1,1
7310,يد,0,0,1,1
7309,verticale,0,0,1,1
7306,tuzu,0,0,1,1
7305,telegramm,0,0,1,1
7304,hjørnet,0,0,1,1
7302,ஹவாய்,0,0,1,1
7300,ಕೆಟ್ಟ,0,0,1,1
7299,lagts,0,0,1,1
5435,korkmuştu,0,0,1,1
7297,قصة,0,0,1,1
7291,இருந்து,0,0,1,1
7289,ecosystems,0,0,1,1
7338,مجهودك,0,0,1,1
7339,physicists,0,0,1,1
7340,عليه,0,0,1,1
7365,commercialisé,0,0,1,1
7383,داخل,0,0,1,1
7382,sexist,0,0,1,1
5428,simplifié,0,0,1,1
7379,hervat,0,0,1,1
7378,fleisch,0,0,1,1
7377,कब,0,0,1,1
7376,"
polonêspolaco",0,0,1,1
7374,сохранить,0,0,1,1
7373,ಕ್ರೀಮ್,0,0,1,1
7372,bornes,0,0,1,1
7371,mediawiki —,0,0,1,1
7370,förhållanden,0,0,1,1
7368,поднять,0,0,1,1
7367,вставкам,0,0,1,1
7364,ಸಮಾಚಾರ,0,0,1,1
7341,selamlar,0,0,1,1
7363,gemensamma,0,0,1,1
7361,highdimensional,0,0,1,1
7360,consideramse,0,0,1,1
7359,høj,0,0,1,1
7358,eenzijdiger,0,0,1,1
7357,ശരിയാക്കുന്നു,0,0,1,1
7356,personnage,0,0,1,1
7355,ortnamn,0,0,1,1
7354,അറിയാമെങ്കിൽ,0,0,1,1
7352,conocer,0,0,1,1
7351,liant,0,0,1,1
7348,condamné,0,0,1,1
7345,intresseområden,0,0,1,1
7344,удивит,0,0,1,1
7288,കണ്ടുമുട്ടുന്നു,0,0,1,1
7286,guiñaron,0,0,1,1
7576,சொல்லுக்கு,0,0,1,1
7229,பக்கம்’,0,0,1,1
5441,رحلاته,0,0,1,1
7224,respetarla,0,0,1,1
7225,kütüphanenin,0,0,1,1
7226,supported,0,0,1,1
7227,மற்றொன்று,0,0,1,1
5440,ಕರೆಯಲ್ಲಿ,0,0,1,1
5439,منهجي،,0,0,1,1
7285,citada,0,0,1,1
7233,radiophoniques,0,0,1,1
5438,geçide,0,0,1,1
7235,ovenfra,0,0,1,1
7236,прилагающаяся,0,0,1,1
7237,bleiben,0,0,1,1
7238,acusado,0,0,1,1
7222,tolka,0,0,1,1
7220,രഥം,0,0,1,1
7219,fransk,0,0,1,1
7217,ஆகியவற்றுக்கு,0,0,1,1
7216,användarkonto,0,0,1,1
5443,volatil,0,0,1,1
7214,reunir,0,0,1,1
7213,stance,0,0,1,1
7211,ನಿರರ್ಗಳವಾಗಲು,0,0,1,1
5444,അങ്ങനെയായിരിക്കും,0,0,1,1
7208,descendente,0,0,1,1
7205,നിലനിൽക്കുന്നത്,0,0,1,1
7204,birisine,0,0,1,1
7203,definitivt,0,0,1,1
7202,volontairement,0,0,1,1
7199,grander,0,0,1,1
5447,doutrina,0,0,1,1
7239,haklısın,0,0,1,1
7240,dissected,0,0,1,1
7241,constaté,0,0,1,1
7265,colecciones,0,0,1,1
7284,solvable,0,0,1,1
7283,പ്രവർത്തനങ്ങളിൽ,0,0,1,1
7281,opted,0,0,1,1
7278,ziyarete,0,0,1,1
7277,uur,0,0,1,1
7276,സ്രോതസ്സുകളുടെ,0,0,1,1
7274,solzhenitsyn,0,0,1,1
7273,buffon,0,0,1,1
7272,boğuluyorum,0,0,1,1
7270,ജർമ്മൻ,0,0,1,1
7269,المناسبة،note,0,0,1,1
7268,मेजबान,0,0,1,1
7267,ಉಲ್ಲೇಖಿಸಿಲ್ಲ,0,0,1,1
7266,bovendien,0,0,1,1
7264,याचिका,0,0,1,1
7242,вводится,0,0,1,1
7263,बहुभाषी,0,0,1,1
7262,stück,0,0,1,1
7261,sexuais,0,0,1,1
7260,plagued,0,0,1,1
7259,lutté,0,0,1,1
7258,employee,0,0,1,1
7256,सूप,0,0,1,1
5437,doneren,0,0,1,1
7251,கவலைப்படாதீர்கள்,0,0,1,1
7250,telefónica,0,0,1,1
7247,suscité,0,0,1,1
7246,включала,0,0,1,1
7244,அச்சுவழிப்,0,0,1,1
7243,uyurken,0,0,1,1
7385,obscenity,0,0,1,1
7386,памяти,0,0,1,1
7387,लेंग्वेज,0,0,1,1
7526,മിശ്രശബ്ദമാണ്,0,0,1,1
7517,arrêter,0,0,1,1
7519,φταρνίστηκε,0,0,1,1
7520,ಜ್ಯಾಮಿತಿ,0,0,1,1
5407,المعلقة,0,0,1,1
7523,σχετική,0,0,1,1
7525,ವ್ಯಕ್ತಿಯು,0,0,1,1
5405,ഡ്രിങ്ക്,0,0,1,1
5427,realizaram,0,0,1,1
7529,தகுதியானவள்,0,0,1,1
7530,എന്നതുപോലുള്ള,0,0,1,1
7531,واللغات,0,0,1,1
7533,perdi,0,0,1,1
7534,συγχωρείς,0,0,1,1
7535,ಧರಿಸಿದ್ದರು,0,0,1,1
7516,"control ·
sustainability ·
പാഴ്വസ്തു",0,0,1,1
7515,seje,0,0,1,1
7512,والدتهما,0,0,1,1
5409,l’intégralité,0,0,1,1
5410,هاتفية,0,0,1,1
7507,रहो।,0,0,1,1
7506,medido,0,0,1,1
7505,കനത്ത,0,0,1,1
7504,പറയാനാകുമോ,0,0,1,1
7501,الـ,0,0,1,1
7500,fysiska,0,0,1,1
7499,horen,0,0,1,1
7497,серьёзный,0,0,1,1
5412,بوقاحة,0,0,1,1
7491,حقيقي,0,0,1,1
5413,échappent,0,0,1,1
7489,உலகப்,0,0,1,1
7536,garantiza,0,0,1,1
7537,frikostigt,0,0,1,1
7538,ويكيبديا،,0,0,1,1
7558,наибольшее,0,0,1,1
7575,आज़माएँ,0,0,1,1
7574,rudely,0,0,1,1
7573,बाहरी,0,0,1,1
7572,secuencia,0,0,1,1
7571,ونأمل,0,0,1,1
5399,indicada,0,0,1,1
7568,выполняя,0,0,1,1
7566,interpretadas,0,0,1,1
7565,نومها,0,0,1,1
7564,полномочия,0,0,1,1
5403,redaktörer,0,0,1,1
7561,​​कि,0,0,1,1
7560,"
telugu",0,0,1,1
7559,ಅದ್ಭುತವಾಗಿದ್ದೀರಿ,0,0,1,1
7557,censored,0,0,1,1
7539,köpte,0,0,1,1
7556,मिलेंगे।,0,0,1,1
7555,yapmaya,0,0,1,1
7554,الإجتماعيين,0,0,1,1
7553,"
गुजराती",0,0,1,1
7552,vandalizadoras,0,0,1,1
7550,فلنطعمك,0,0,1,1
7549,establecidos,0,0,1,1
5404,ಹಳ್ಳಿಯಲ್ಲಿ,0,0,1,1
7545,обучаться,0,0,1,1
7544,ರೋಮಾಂಚನಕಾರಿ,0,0,1,1
7543,apprenant,0,0,1,1
7542,served,0,0,1,1
7541,advantage,0,0,1,1
7540,d’autant,0,0,1,1
7488,cambiado,0,0,1,1
7486,أكتوبر,0,0,1,1
7485,σύγχυση,0,0,1,1
7413,hoparlöre,0,0,1,1
7436,vahşet,0,0,1,1
5424,ελληνική,0,0,1,1
7427,lagrade,0,0,1,1
7426,arduamente,0,0,1,1
7425,جورنال,0,0,1,1
7424,lyssna,0,0,1,1
7421,res,0,0,1,1
7420,llegaste,0,0,1,1
7419,ρωτάω,0,0,1,1
7418,നാർസിസയെ,0,0,1,1
7417,ecstatic,0,0,1,1
7416,adapter,0,0,1,1
7415,вебсайта,0,0,1,1
7414,rejection,0,0,1,1
7412,policiam,0,0,1,1
7439,കഴിയാത്തതിനാൽ,0,0,1,1
7407,jouant,0,0,1,1
7406,المعروفين,0,0,1,1
7404,infrecuentes,0,0,1,1
7403,നല്കിയിരിക്കുന്നു,0,0,1,1
7401,crearles,0,0,1,1
7399,иерархическая,0,0,1,1
7398,mencionado,0,0,1,1
7397,نيويورك،,0,0,1,1
7396,பொருந்தக்கூடிய,0,0,1,1
7395,பெயரில்,0,0,1,1
7394,invested,0,0,1,1
7392,γεύση,0,0,1,1
7390,ಬಂದಾಗ,0,0,1,1
7389,மகளைப்,0,0,1,1
7438,conexão,0,0,1,1
7441,millimètreréf,0,0,1,1
7484,eettafel,0,0,1,1
7463,kalırsınız,0,0,1,1
7483,shared,0,0,1,1
7482,reemplazado,0,0,1,1
7479,plagiarizing,0,0,1,1
7477,единственном,0,0,1,1
5414,прокат,0,0,1,1
7475,തിരുത്തലുകളും,0,0,1,1
7474,കണക്കാക്കാറില്ല,0,0,1,1
7471,അത്യാധുനികമാണ്,0,0,1,1
5416,sorudan,0,0,1,1
7468,visões,0,0,1,1
7467,ಹೇಳಿದೆ,0,0,1,1
5419,"
बांग्ला",0,0,1,1
7465,multidisciplinært,0,0,1,1
7464,coffee,0,0,1,1
7462,fornærmelse,0,0,1,1
7442,koldt,0,0,1,1
7461,ليدعم,0,0,1,1
7460,சுதந்திரமாக,0,0,1,1
7458,belgeleme,0,0,1,1
7456,ağlamayı,0,0,1,1
7455,méritos,0,0,1,1
5420,കേൾക്കുക,0,0,1,1
5421,financée,0,0,1,1
5422,añadidura,0,0,1,1
7449,ζωντανό,0,0,1,1
7448,consultant,0,0,1,1
7446,देती,0,0,1,1
7445,പുതുക്കാറുണ്ട്,0,0,1,1
7444,restriktioner,0,0,1,1
7443,ситуация,0,0,1,1
7971,exprimée,0,0,1,1
7972,yazılmalıdır,0,0,1,1
7973,நோக்கமாகும்,0,0,1,1
8487,católico,0,0,1,1
8478,silabarios,0,0,1,1
8479,விஷயத்தில்,0,0,1,1
8480,sousbranches ,0,0,1,1
5281,nutricionista,0,0,1,1
8482,documento,0,0,1,1
8486,للتماسك،,0,0,1,1
8488,smartmobiler,0,0,1,1
8457,pede,0,0,1,1
8489,tadı,0,0,1,1
5279,vrijgave,0,0,1,1
5278,wikiprincipen,0,0,1,1
8493,ಬೆಳ್ಳಿಯನ್ನು,0,0,1,1
8495,കാണുമ്പോൾ,0,0,1,1
8496,χρυσός,0,0,1,1
8477,γεννηθεί,0,0,1,1
8476,« éviter,0,0,1,1
5282,lisanslama,0,0,1,1
8474,लिंग,0,0,1,1
8473,estabilizado,0,0,1,1
8472,ಅಳುತ್ತಿದ್ದೀರಿ,0,0,1,1
8471,özrümü,0,0,1,1
8470,stykker,0,0,1,1
8469,इलाज,0,0,1,1
8468,bulunmaktadır,0,0,1,1
8466,snowball,0,0,1,1
8465,strider,0,0,1,1
8464,обслужены,0,0,1,1
5285,சொல்லை,0,0,1,1
8461,отправлять,0,0,1,1
8460,διστάζω,0,0,1,1
8459,نفسه,0,0,1,1
8497,ಒಳ್ಳೆಯವರಾಗಿದ್ದಾರೆ,0,0,1,1
8498,മുൻപ്,0,0,1,1
8499,जताया,0,0,1,1
8524,مراجعته,0,0,1,1
8544,ഇല്ലായിരുന്നു,0,0,1,1
8542,kullanılmaz,0,0,1,1
8540,конечная,0,0,1,1
8537,الأمريكية,0,0,1,1
8536,تسأله,0,0,1,1
8535,carry,0,0,1,1
8534,испечь,0,0,1,1
8531,avantage,0,0,1,1
8530,சோர்வாகவும்,0,0,1,1
8529,പാഴ്‌മെയിലാണോയെന്ന്,0,0,1,1
8528,решающее,0,0,1,1
8527,являющейся,0,0,1,1
8526,ഉരുളക്കിഴങ്ങ്,0,0,1,1
8525,ನಾರುವ,0,0,1,1
8523,reliée,0,0,1,1
8502,സുപ്രധാനനേട്ടവും,0,0,1,1
8522,wenig,0,0,1,1
5272,initialement,0,0,1,1
8519,женихи,0,0,1,1
8518,остановить,0,0,1,1
8517,نبرة,0,0,1,1
5274,utforma,0,0,1,1
8513,animalia,0,0,1,1
8512,ലേഖകസംഘം,0,0,1,1
8511,സൈർ,0,0,1,1
8510,initiating,0,0,1,1
5275,हूवरिंग,0,0,1,1
8508,görüşemedik,0,0,1,1
8504,ಅದೃಷ್ಟವಂತ,0,0,1,1
5276,സൗരയൂഥത്തിൽ,0,0,1,1
8458,katıldığımdan,0,0,1,1
8456,കൊണ്ടുവരട്ടെ,0,0,1,1
8354,aktuella,0,0,1,1
8394,വരുത്തി,0,0,1,1
8382,துவக்கல்,0,0,1,1
8383,historiska,0,0,1,1
8384,وسيأتي,0,0,1,1
8387,—மீக்கா,0,0,1,1
8389,mantuvo,0,0,1,1
8392,позицию,0,0,1,1
8396,gpus,0,0,1,1
8455,बीजों,0,0,1,1
8398,columnist,0,0,1,1
5296,பிடித்துக்,0,0,1,1
8402,obtuvo,0,0,1,1
8403,அழுத்திப்,0,0,1,1
8406,இயலாது,0,0,1,1
8407,πλήρως,0,0,1,1
8381,quotidien,0,0,1,1
8380,डाउन,0,0,1,1
8378,euros,0,0,1,1
8377,ölüyorum,0,0,1,1
8375,acrecentando,0,0,1,1
8374,sientes,0,0,1,1
8373,achte,0,0,1,1
5299,proche,0,0,1,1
8371,susceptibilidad,0,0,1,1
8369,cassation,0,0,1,1
8367,увеличения,0,0,1,1
5300,ಜನರಿಗೆ,0,0,1,1
8365,geheimzinnigs,0,0,1,1
8363,fraile,0,0,1,1
8362,étape,0,0,1,1
8361,സങ്കീർണ്ണമായ,0,0,1,1
8360,hususlar,0,0,1,1
8408,கிளிக்,0,0,1,1
8409,zamanım,0,0,1,1
5292,entornos,0,0,1,1
5288,isologo,0,0,1,1
5286,großartig,0,0,1,1
8452,делал,0,0,1,1
8450,gerektiği,0,0,1,1
8449,ವಾರಾಂತ್ಯದ,0,0,1,1
5287,recogida,0,0,1,1
8447,samesex,0,0,1,1
8446,suffit,0,0,1,1
8445,έπαιρνα,0,0,1,1
8443,बॉक्स,0,0,1,1
8442,psalms,0,0,1,1
8441,escuches,0,0,1,1
8438,teori,0,0,1,1
8437,ثري,0,0,1,1
8436,hechas,0,0,1,1
8433,യന്ത്രപഠനത്തിനു,0,0,1,1
5291,matta,0,0,1,1
8432,"
piemontês",0,0,1,1
8430,لتربيهم,0,0,1,1
8427,شهر,0,0,1,1
8425,addresses,0,0,1,1
8424,ಒಬ್ಬರನ್ನೊಬ್ಬರು,0,0,1,1
8423,правительственных,0,0,1,1
8422,licensors,0,0,1,1
5289,एहसास,0,0,1,1
8418,венгерские,0,0,1,1
8417,языковыми,0,0,1,1
8416,grego,0,0,1,1
8415,soruyor,0,0,1,1
8413,geradeaus,0,0,1,1
8412,கலைக்களஞ்சியத்தை,0,0,1,1
8547,bedekken,0,0,1,1
8548,knolकृपया,0,0,1,1
8549,econômica,0,0,1,1
8690,ಬ್ರೆಡ್ನಲ್ಲಿ,0,0,1,1
8682,لاحقة،,0,0,1,1
5248,lignende,0,0,1,1
5247,ubicación,0,0,1,1
8687,explícitamente,0,0,1,1
8688,எடுத்துக்காட்டுகளைப்,0,0,1,1
8689,suppression,0,0,1,1
8692,hitwise,0,0,1,1
8551,dejlige,0,0,1,1
8693,ämnesområden,0,0,1,1
8694,απίστευτα,0,0,1,1
8695,ആരംഭിക്കുന്നതിനുള്ള,0,0,1,1
5243,predeterminada,0,0,1,1
8700,dijeron,0,0,1,1
8701,inger,0,0,1,1
8681,αγγλική,0,0,1,1
8679,информацию,0,0,1,1
5249,izliyordu,0,0,1,1
8676,découle,0,0,1,1
8675,عملها,0,0,1,1
5250,septième,0,0,1,1
5251,polysémie,0,0,1,1
5252,olhares,0,0,1,1
8670,புகழ்பெற்றதுமாகும்,0,0,1,1
8668,drukning,0,0,1,1
5253,sophistiqués,0,0,1,1
8663,exploitée,0,0,1,1
8661,பள்ளியிலிருந்து,0,0,1,1
8658,‘இணைய,0,0,1,1
8656,reutilização,0,0,1,1
8655,ಟೋಫ್ಲ್,0,0,1,1
8654,söylediğin,0,0,1,1
8702,വായിച്ച്,0,0,1,1
8704,değiştirmesiyle,0,0,1,1
8706,реакций,0,0,1,1
8728,responsibility”,0,0,1,1
8749,bouleversé,0,0,1,1
8748,afirmam,0,0,1,1
8747,boyfriend,0,0,1,1
8743,لغتا,0,0,1,1
8742,reacción,0,0,1,1
8740,вашем,0,0,1,1
8739,"
माल्टी",0,0,1,1
5236,neutraal,0,0,1,1
8734,участие,0,0,1,1
8733,teorier,0,0,1,1
8732,குழப்பமடைந்தால்,0,0,1,1
8731,dramatic,0,0,1,1
5238,вызванных,0,0,1,1
8729,गोपनीयता,0,0,1,1
8727,رئيس,0,0,1,1
5242,arctic,0,0,1,1
5239,العلمي،,0,0,1,1
8725,செய்யத்,0,0,1,1
8724,представленного,0,0,1,1
8722,ಗೆದ್ದಿದೆ,0,0,1,1
5240,amongst,0,0,1,1
8720,சந்திப்பேன்,0,0,1,1
8719,partager,0,0,1,1
8717,सुसंस्कृत,0,0,1,1
8716,arasında,0,0,1,1
8714,constitution,0,0,1,1
8713,dîner,0,0,1,1
8711,wiktionnaire,0,0,1,1
8710,diferenciada,0,0,1,1
8708,വിലയിരുത്തുന്നു,0,0,1,1
8653,dignos,0,0,1,1
8652,piltangenter,0,0,1,1
8651,overhand,0,0,1,1
5269,നൽകണം,0,0,1,1
8593,obs,0,0,1,1
8592,ಸೀನುವಾಗ,0,0,1,1
8589,padronizações,0,0,1,1
5265,buluşmaya,0,0,1,1
8586,लीजिए,0,0,1,1
8585,faydalı,0,0,1,1
8584,ásia,0,0,1,1
8583,influencé,0,0,1,1
5267,instrumento,0,0,1,1
8581,важно,0,0,1,1
5268,nutzen,0,0,1,1
8578,образовано,0,0,1,1
8577,ವಿವಾಹದ,0,0,1,1
8576,«lo,0,0,1,1
8572,argumentée,0,0,1,1
5260,filosóficas,0,0,1,1
8571,granskat,0,0,1,1
8570,"
búlgaro",0,0,1,1
8568,firent,0,0,1,1
8567,വളർത്താൻ,0,0,1,1
8563,универсальная,0,0,1,1
8562,oprettet,0,0,1,1
8561,сумасшедшие»,0,0,1,1
8560,comedian,0,0,1,1
8559,ಕೂಡಿದೆ,0,0,1,1
8557,الضخمة,0,0,1,1
8555,parlait,0,0,1,1
8554,lapso,0,0,1,1
8553,സ്കൂൾ,0,0,1,1
8552,dibujada,0,0,1,1
8594,ಆಳವಾಗಿ,0,0,1,1
8598,സാക്ഷാത്കരിക്കപ്പെട്ടാൽ,0,0,1,1
8649,humoristiques,0,0,1,1
5257,மறந்துவிடுகிறார்கள்,0,0,1,1
8648,medfølgende,0,0,1,1
8647,இருந்தாள்,0,0,1,1
5254,അവസാനത്തിലും,0,0,1,1
8645,s’accroissait,0,0,1,1
8644,apresentação,0,0,1,1
8643,secrète,0,0,1,1
8642,ಪರಿಪೂರ್ಣವಾದ,0,0,1,1
5255,secuencias,0,0,1,1
8640,കടന്നുപോകാൻ,0,0,1,1
8637,matarna,0,0,1,1
8630,superou,0,0,1,1
8629,общедоступным,0,0,1,1
8628,vidéos etc,0,0,1,1
8627,сердится,0,0,1,1
8625,πλανήτη,0,0,1,1
8600,réunie,0,0,1,1
8623,dão,0,0,1,1
8622,velocipedia,0,0,1,1
8620,rik,0,0,1,1
8619,παραδέχεστε,0,0,1,1
8618,contraste,0,0,1,1
8617,тесте,0,0,1,1
8616,recommends,0,0,1,1
8615,wikiformat,0,0,1,1
8614,ethnicities,0,0,1,1
8611,கொண்டது,0,0,1,1
8609,δική,0,0,1,1
5258,διοικούνται,0,0,1,1
8607,encyclopédique,0,0,1,1
8605,“மைசீக்குவல்”,0,0,1,1
8358,uafhængig,0,0,1,1
8353,convertir,0,0,1,1
7974,إسرائيلية,0,0,1,1
8105,समय।,0,0,1,1
5336,androidbased,0,0,1,1
8100,décerné,0,0,1,1
8101,irão,0,0,1,1
8102,papel,0,0,1,1
8103,yapacağım,0,0,1,1
8104,मुस्कुराने,0,0,1,1
8106,zorunluluğu,0,0,1,1
8073,ஐஸ்கிரீம்,0,0,1,1
8107,γνώριζε,0,0,1,1
8108,resor,0,0,1,1
8110,arkadaşı,0,0,1,1
8111,στρατιώτες,0,0,1,1
8113,நுபீடியாவிற்கும்,0,0,1,1
8114,mathematically,0,0,1,1
8097,"
estamos",0,0,1,1
8096,случаю,0,0,1,1
8095,chile,0,0,1,1
8094,cite,0,0,1,1
8092,vim,0,0,1,1
8090,ज़रूर,0,0,1,1
8089,സ്പീക്കർ,0,0,1,1
8087,فهناك,0,0,1,1
8086,mariée,0,0,1,1
8085,ناقصا,0,0,1,1
8084,donald,0,0,1,1
8082,comestible,0,0,1,1
8081,വേറൊരു,0,0,1,1
8080,restrições,0,0,1,1
8078,banklånet,0,0,1,1
5337,conservatrice,0,0,1,1
8076,கட்டுரைகளான,0,0,1,1
8116,ഇടയിൽ,0,0,1,1
5335,possuindo,0,0,1,1
8118,vetenskaplig,0,0,1,1
8139,afectados,0,0,1,1
8157,comprarte,0,0,1,1
8156,zeros,0,0,1,1
8155,exclusivity,0,0,1,1
5327,தோட்டத்தில்,0,0,1,1
5328,prácticas,0,0,1,1
8151,ತೊಂದರೆಯಿಲ್ಲದ,0,0,1,1
8148,നിരൂപണങ്ങൾ,0,0,1,1
8147,passando,0,0,1,1
8146,basándose,0,0,1,1
5330,persist,0,0,1,1
8144,loveland,0,0,1,1
8143,permitting,0,0,1,1
8141,parlons,0,0,1,1
8140,ತುದಿ,0,0,1,1
8138,beroemde,0,0,1,1
5334,cart,0,0,1,1
8137,людям,0,0,1,1
8136,πηγής,0,0,1,1
8134,deemed,0,0,1,1
8133,الأصليون,0,0,1,1
8132,parameters,0,0,1,1
8131,وتمت,0,0,1,1
5331,തടസ്സപ്പെടുത്തുന്നു,0,0,1,1
5332,поступок,0,0,1,1
8126,favorecer,0,0,1,1
8125,പറയുന്ന,0,0,1,1
5333,·i,0,0,1,1
8122,പുതുമുഖങ്ങൾക്ക്,0,0,1,1
8121,إستوحت,0,0,1,1
8120,للمخربين,0,0,1,1
8075,вайнбергером,0,0,1,1
8072,kött,0,0,1,1
8351,vengera,0,0,1,1
8008,குறுங்கட்டுரையாகவே,0,0,1,1
7996,يلقى,0,0,1,1
7997,pioneer,0,0,1,1
7998,இருந்ததா,0,0,1,1
7999,baka,0,0,1,1
5345,ابنتك,0,0,1,1
8005,ദീർഘനാളായി,0,0,1,1
8009,değiştirme,0,0,1,1
8069,mostraba,0,0,1,1
8010,திட்டங்கள்,0,0,1,1
8011,lagstiftning,0,0,1,1
8012,ഹൃദയത്തിലേക്ക്,0,0,1,1
8014,inspira,0,0,1,1
8015,persistencia,0,0,1,1
8016,khosla,0,0,1,1
7995,செய்திகளில்,0,0,1,1
7994,إعلانات،,0,0,1,1
7993,மொழிகளைக்,0,0,1,1
7992,koruyabilir,0,0,1,1
7990,clúster,0,0,1,1
7989,aptal,0,0,1,1
7988,അനായാസമായ,0,0,1,1
7986,निगरानी,0,0,1,1
7985,sidde,0,0,1,1
7984,"
हिन्दी",0,0,1,1
5347,والانتقادات,0,0,1,1
7981,قيودًا,0,0,1,1
7979,എവിടെയാണെന്ന്,0,0,1,1
7978,दिलाया,0,0,1,1
7977,siglos,0,0,1,1
5349,മാസങ്ങളോ,0,0,1,1
7975,shortening,0,0,1,1
8019,ಕೋಷ್ಟಕಕ್ಕೆ,0,0,1,1
8020,премии,0,0,1,1
8022,பட்சத்தில்,0,0,1,1
8048,читателей,0,0,1,1
5339,verket,0,0,1,1
8066,സഹായിക്കാമോ,0,0,1,1
5341,നിർത്തുക,0,0,1,1
8062,कॉमस्कोर,0,0,1,1
8061,скомпрометировать,0,0,1,1
8059,польском,0,0,1,1
8058,rundt,0,0,1,1
8057,अंग्रेजीभाषा,0,0,1,1
8055,горем,0,0,1,1
8054,japonaise,0,0,1,1
8053,доктриной,0,0,1,1
8052,يتفق,0,0,1,1
5342,—no,0,0,1,1
8050,подбодрить,0,0,1,1
8046,meters,0,0,1,1
8023,optaria,0,0,1,1
8042,chato,0,0,1,1
5344,معيبة,0,0,1,1
8040,எவராலும்,0,0,1,1
8039,ming,0,0,1,1
8037,പറയിപെറ്റ,0,0,1,1
8036,factuais,0,0,1,1
8034,ಹೋದರೆ,0,0,1,1
8031,தகவல்,0,0,1,1
8030,verspreid,0,0,1,1
8029,omfattas,0,0,1,1
8028,citerad,0,0,1,1
8026,snavs,0,0,1,1
8025,γλυκιάς,0,0,1,1
8024,نصًا,0,0,1,1
8158,என்பதோடு,0,0,1,1
8159,व्यंग्य,0,0,1,1
8160,kalt,0,0,1,1
8291,elegantes,0,0,1,1
8285,സ്വപ്നത്തെക്കുറിച്ച്,0,0,1,1
8286,otlet,0,0,1,1
8287,fizera,0,0,1,1
8288,decimotercer,0,0,1,1
8289,"
विनैरे",0,0,1,1
8290,listada,0,0,1,1
8292,ടോഫൽ,0,0,1,1
5325,sudcoréen,0,0,1,1
8294,peːdɪa,0,0,1,1
8295,formuleerde,0,0,1,1
8296,सबस्क्रिप्शनओनली,0,0,1,1
8297,mfl,0,0,1,1
8298,пояснении,0,0,1,1
8299,ரீதியில்,0,0,1,1
8283,തടവുകാരെ,0,0,1,1
5307,പെർഫക്റ്റാവണം,0,0,1,1
8278,stavefejl,0,0,1,1
8277,meistens,0,0,1,1
8276,sudden,0,0,1,1
8275,forbid,0,0,1,1
8274,متحيزة،,0,0,1,1
5310,undskyldning,0,0,1,1
8272,корневые,0,0,1,1
8271,källa behövs,0,0,1,1
8270,arka,0,0,1,1
8268,équitable,0,0,1,1
8266,personas​​,0,0,1,1
8265,எதையும்,0,0,1,1
8264,datats,0,0,1,1
8262,طويلًا,0,0,1,1
8261,श्रृंखला,0,0,1,1
8300,எடுத்துக்கொண்டது,0,0,1,1
8302,மனித,0,0,1,1
8303,കാലെടുത്തുവച്ചാൽ,0,0,1,1
8330,ವಜ್ರಗಳಿಂದ,0,0,1,1
5302,ಭಾವಿಸಿದ್ದೀರಿ,0,0,1,1
8349,delstaten,0,0,1,1
8347,copiaron,0,0,1,1
5303,stan,0,0,1,1
8345,американской,0,0,1,1
8344,എനർജി,0,0,1,1
8341,யோ,0,0,1,1
8338,spills,0,0,1,1
8337,precedes,0,0,1,1
8336,klädd,0,0,1,1
8335,forsøgte,0,0,1,1
8334,integrity,0,0,1,1
8333,antissocial,0,0,1,1
8331,quejarse,0,0,1,1
8329,finlandés,0,0,1,1
8305,зверский,0,0,1,1
8328,ജ്യാമിതി,0,0,1,1
8327,منزعج,0,0,1,1
8326,restaurar,0,0,1,1
8324,vandalizando,0,0,1,1
8323,универсальной,0,0,1,1
8322,интеллектуальным,0,0,1,1
8321,الاعتذار,0,0,1,1
8320,"
georgiano",0,0,1,1
8318,النباتات,0,0,1,1
8314,விஞ்சி,0,0,1,1
8313,efterladt,0,0,1,1
5304,illustrée,0,0,1,1
8309,எங்களுடன்,0,0,1,1
8308,visions,0,0,1,1
8259,путешествовала,0,0,1,1
8258,vinod,0,0,1,1
8256,പ്രവേശിച്ചുവെങ്കിൽ,0,0,1,1
8184,мобильным,0,0,1,1
8201,saúde,0,0,1,1
8198,obligada,0,0,1,1
8197,"
नेपाली",0,0,1,1
8196,herrera,0,0,1,1
5320,watchlist,0,0,1,1
8193,våra,0,0,1,1
8192,desinformar,0,0,1,1
8191,gittiğinde,0,0,1,1
8190,matérielle,0,0,1,1
8189,peinture,0,0,1,1
8188,क्रियोल,0,0,1,1
8187,ലഭിക്കും,0,0,1,1
8186,ومشتق,0,0,1,1
8185,entidades,0,0,1,1
8183,participer »,0,0,1,1
8205,yapacaklarını,0,0,1,1
8182,സമൂഹത്തെ,0,0,1,1
8180,anglosajón,0,0,1,1
8178,σχέδιο,0,0,1,1
5322,планировалось,0,0,1,1
8176,σ,0,0,1,1
5324,illustrera,0,0,1,1
8171,personalized,0,0,1,1
8170,hvornår,0,0,1,1
8169,nämns,0,0,1,1
8168,маленькой,0,0,1,1
8167,اجتازت,0,0,1,1
8166,driveway,0,0,1,1
8165,finite,0,0,1,1
8162,inovação,0,0,1,1
8202,लव,0,0,1,1
8206,ಪ್ರಯತ್ನಿಸುವಾಗ,0,0,1,1
8254,вредительское,0,0,1,1
8232,μαριόν,0,0,1,1
8252,confundem,0,0,1,1
8251,придерживаясь,0,0,1,1
8249,emenda,0,0,1,1
8248,anatomy,0,0,1,1
5313,suscetibilidade,0,0,1,1
8246,connectionist,0,0,1,1
8245,присутствовать,0,0,1,1
8243,förekommande,0,0,1,1
8240,traditioner,0,0,1,1
8237,ağlamak,0,0,1,1
8236,espelho,0,0,1,1
8235,latín,0,0,1,1
8234,يهدف,0,0,1,1
8233,laissent,0,0,1,1
8231,чертой,0,0,1,1
8207,مدققو,0,0,1,1
8229,confirmaba,0,0,1,1
8228,databasen,0,0,1,1
8227,protest,0,0,1,1
8226,предотвращения,0,0,1,1
8225,ಶಾಂತಗೊಳಿಸಿ,0,0,1,1
8224,excluíu,0,0,1,1
8221,frø,0,0,1,1
5317,प्रासंगिक,0,0,1,1
8218,« google »,0,0,1,1
8216,qualitéh,0,0,1,1
8214,ಹೆಬ್ಬೆರಳು,0,0,1,1
8211,ಬೈಟ್,0,0,1,1
8209,ангелом,0,0,1,1
8208,operado,0,0,1,1
7196,constantemente,0,0,1,1
5448,skewed,0,0,1,1
8752,материнарциссе,0,0,1,1
6180,ഘട്ടത്തിലും,0,0,1,1
6172,брендом,0,0,1,1
6173,resourceconsuming,0,0,1,1
6174,moeilijke,0,0,1,1
6175,belangrijke,0,0,1,1
6176,महिला,0,0,1,1
6179,otobüsümüz,0,0,1,1
6182,—que,0,0,1,1
6145,مستنقع,0,0,1,1
6183,бесполезен,0,0,1,1
6185,webbtjänsten,0,0,1,1
6187,сводятся,0,0,1,1
6188,amplia,0,0,1,1
5574,تنس,0,0,1,1
6191,ಅವುಗಳ,0,0,1,1
5575,prolog,0,0,1,1
6168,hatan,0,0,1,1
6166,நடந்த,0,0,1,1
6165,بطء,0,0,1,1
6163,onthouden,0,0,1,1
6162,subsidiaria,0,0,1,1
6161,اللاحق,0,0,1,1
6160,उपलब्धियों,0,0,1,1
6159,എഡിറ്റ്,0,0,1,1
6158,гавайского,0,0,1,1
6157,تشجيعاً,0,0,1,1
6155,μπαλκόνι,0,0,1,1
6154,المشاركون,0,0,1,1
6153,birth,0,0,1,1
6152,débattre,0,0,1,1
6151,colaboradores—,0,0,1,1
6150,égoïste,0,0,1,1
6192,വിക്കിപീഡിയരേയും,0,0,1,1
6193,eenieder,0,0,1,1
6195,സ്വപ്നങ്ങളുടെ,0,0,1,1
6222,knapphändigt,0,0,1,1
5569,placés,0,0,1,1
6237,teknik,0,0,1,1
6236,sulter,0,0,1,1
6234,surgiram,0,0,1,1
6233,مستويين,0,0,1,1
6232,tembelleştiriyor,0,0,1,1
6230,अभिनय,0,0,1,1
6229,эксперименты,0,0,1,1
6228,nämnt,0,0,1,1
6227,alltag,0,0,1,1
6226,uttalar,0,0,1,1
6225,представлена,0,0,1,1
6224,ड्रिंक,0,0,1,1
6223,وسأل,0,0,1,1
6219,localizados,0,0,1,1
5573,"
islandês",0,0,1,1
6217,unavailability,0,0,1,1
6215,அப்பால்,0,0,1,1
6214,mobilanpassade,0,0,1,1
6211,பிற்பகுதியில்,0,0,1,1
6210,തീര്ച്ചയായും,0,0,1,1
6207,hävdar,0,0,1,1
6206,صرح,0,0,1,1
6205,bedrijven,0,0,1,1
6204,الإشارة,0,0,1,1
6203,engelsksprogede,0,0,1,1
6202,haberlerde,0,0,1,1
6201,διακόψαμε,0,0,1,1
6198,жаргоне,0,0,1,1
6197,animaux ,0,0,1,1
6149,categoría,0,0,1,1
6144,d’interprétabilité,0,0,1,1
6247,poorer,0,0,1,1
5588,hayvandır,0,0,1,1
5589,neurophysiologiste,0,0,1,1
6072,jornalista,0,0,1,1
6073,thick,0,0,1,1
6074,तारास्कीविका,0,0,1,1
6075,медлительный,0,0,1,1
6076,ideográmicos,0,0,1,1
6082,inverificáveis,0,0,1,1
5583,erreichen,0,0,1,1
6083,wikipediaartikler,0,0,1,1
6085,título,0,0,1,1
6087,способный,0,0,1,1
5587,dormía,0,0,1,1
6090,كومنز,0,0,1,1
6091,dragging,0,0,1,1
5590,സമ്മാനം,0,0,1,1
6069,descrito,0,0,1,1
6067,verdadeiras,0,0,1,1
6065,resimler,0,0,1,1
6063,وبالمثل،,0,0,1,1
6062,शो,0,0,1,1
6058,figurant,0,0,1,1
6057,смотрели,0,0,1,1
6056,reportaje,0,0,1,1
6055,combinatoire,0,0,1,1
6053,കൂടെ,0,0,1,1
6051,matbordet,0,0,1,1
6050,ಪಡೆಯಬೇಕು,0,0,1,1
6049,greek,0,0,1,1
6048,​​du,0,0,1,1
6046,subvenciones,0,0,1,1
6045,собираемся,0,0,1,1
6092,kesmek,0,0,1,1
6093,legislação,0,0,1,1
6094,procedures,0,0,1,1
6126,பயணம்,0,0,1,1
6142,removido,0,0,1,1
6141,concurreert,0,0,1,1
6140,présenté,0,0,1,1
6139,faune,0,0,1,1
6138,ന്യൂപീഡിയയെ,0,0,1,1
5584,ışıltılı,0,0,1,1
6135,കൊടുക്കുന്നു,0,0,1,1
5586,заявлении,0,0,1,1
6132,ತೆಗೆದುಕೊಳ್ಳುತ್ತೇನೆ,0,0,1,1
6131,officer,0,0,1,1
6130,انعكاسه,0,0,1,1
6129,strikeslip,0,0,1,1
6128,collaborativement,0,0,1,1
6127,inclusief,0,0,1,1
6125,secretamente,0,0,1,1
6096,tillämpa,0,0,1,1
6123,mühim,0,0,1,1
6122,വിവരിക്കുന്നുള്ളൂ,0,0,1,1
6120,uteslutande,0,0,1,1
6117,തടയുവാനായി,0,0,1,1
6115,xvii°siècle,0,0,1,1
6114,ansvarlige,0,0,1,1
6113,refere,0,0,1,1
6112,zweedstalige,0,0,1,1
6110,привлечь,0,0,1,1
6105,yakalayana,0,0,1,1
6101,magiske,0,0,1,1
6100,bedraagt,0,0,1,1
6098,координационным,0,0,1,1
6097,edifícios,0,0,1,1
6240,الكسل,0,0,1,1
6248,شخصياتها,0,0,1,1
7193,internetencyklopædi,0,0,1,1
6384,читателям,0,0,1,1
6373,yield,0,0,1,1
6375,roger,0,0,1,1
6376,οκτώ,0,0,1,1
6377,aplicações,0,0,1,1
6381,semejanza,0,0,1,1
6382,ملحمي,0,0,1,1
6389,overdrive,0,0,1,1
6340,διαδικτυακή,0,0,1,1
6391,ಹಸಿವಿನಿಂದ,0,0,1,1
6392,собственностинеавторитетный,0,0,1,1
6393,füße,0,0,1,1
6395,ತೊಂದರೆಗೊಳಿಸಿದ್ದಕ್ಕೆ,0,0,1,1
6396,мировой,0,0,1,1
6398,குறுக்கிட்டதற்கு,0,0,1,1
5561,шутишь,0,0,1,1
6367,комитеты,0,0,1,1
6365,esfuerzos,0,0,1,1
6364,geléias,0,0,1,1
6363,framträdande,0,0,1,1
6360,independencias,0,0,1,1
6359,accepteert,0,0,1,1
6357,बिल्टइन,0,0,1,1
6356,ecoregion,0,0,1,1
6351,cruelle,0,0,1,1
6350,passerait,0,0,1,1
6349,وكلمات,0,0,1,1
6348,வித்தியாசமாகக்,0,0,1,1
6347,technological,0,0,1,1
6344,vapeur,0,0,1,1
6343,சம்பவங்கள்,0,0,1,1
6342,diferencia,0,0,1,1
6399,கொள்ளாதீர்கள்,0,0,1,1
6400,filtreringen,0,0,1,1
5559,மாவு,0,0,1,1
6433,interests,0,0,1,1
6451,കൂടുതലും,0,0,1,1
6450,محاولة,0,0,1,1
6448,взял,0,0,1,1
6446,нужен,0,0,1,1
6445,والعبارات,0,0,1,1
5554,تلو,0,0,1,1
6443,medverkan,0,0,1,1
6441,உலகம்,0,0,1,1
6440,попадете,0,0,1,1
6439,освещение,0,0,1,1
6438,வழங்கியது,0,0,1,1
6437,itentreprenören,0,0,1,1
6436,அழுத்துவதன்,0,0,1,1
5555,заданий,0,0,1,1
6432,соответствующую,0,0,1,1
6404,atribuir,0,0,1,1
5556,عقولنا,0,0,1,1
6430,declined,0,0,1,1
6429,кэширующих,0,0,1,1
6426,bones,0,0,1,1
6425,نقاش,0,0,1,1
6423,hayas,0,0,1,1
6420,anlatabilir,0,0,1,1
6419,azb •,0,0,1,1
6418,совсем,0,0,1,1
6412,рекорд,0,0,1,1
6410,обновлённый,0,0,1,1
6409,romantisme,0,0,1,1
6408,നിങ്ങൾക്കത്,0,0,1,1
5558,പിസ്സ,0,0,1,1
6341,مختلف,0,0,1,1
6339,المتطوعين،,0,0,1,1
6249,इंडेक्सिंग।,0,0,1,1
6277,സർവ്വകലാശാലയിൽ,0,0,1,1
5568,വീഡിയോയ്ക്ക്,0,0,1,1
5567,ура,0,0,1,1
6273,pick,0,0,1,1
6274,யோசிக்கிறேன்,0,0,1,1
6275,стивен,0,0,1,1
6276,внимательно,0,0,1,1
6278,abarcar,0,0,1,1
6338,mémoire,0,0,1,1
6279,கடந்துவிட்டீர்கள்,0,0,1,1
6280,оскорбительными,0,0,1,1
6282,«trabajadores,0,0,1,1
6284,മാസങ്ങളിൽ,0,0,1,1
6286,предыдущей,0,0,1,1
6287,கண்டீர்கள்,0,0,1,1
6268,барак,0,0,1,1
6267,समानता,0,0,1,1
6266,argentine,0,0,1,1
6265,edelsteinen,0,0,1,1
6264,χρησιμοποιήθηκε,0,0,1,1
6263,colaborou,0,0,1,1
6262,इंडीपेनडेंस,0,0,1,1
6261,понимающей,0,0,1,1
6260,controversa,0,0,1,1
6259,മനുഷ്യനിർമിതമായ,0,0,1,1
6258,وضعت,0,0,1,1
6257,recorde,0,0,1,1
6256,entités,0,0,1,1
6255,¿y,0,0,1,1
6254,escudo,0,0,1,1
6253,spændende,0,0,1,1
6251,तीखे,0,0,1,1
6288,waarbij,0,0,1,1
6291,bag,0,0,1,1
6292,сайте,0,0,1,1
6314,καλοσύνης,0,0,1,1
6336,revenue,0,0,1,1
6335,الألعاب,0,0,1,1
6334,വിളിക്കാൻ,0,0,1,1
6333,വസ്ത്രധാരണരീതി,0,0,1,1
6331,tadic,0,0,1,1
6330,ಮಾಡಲಿದೆ,0,0,1,1
6324,aangenaam,0,0,1,1
6322,لمنتدى,0,0,1,1
6321,índice,0,0,1,1
6320,दर्जे,0,0,1,1
6319,உங்களால்,0,0,1,1
6318,baserade,0,0,1,1
6317,стороны —,0,0,1,1
6315,juridiques,0,0,1,1
6313,condenou,0,0,1,1
5565,எதிர்மாறாக,0,0,1,1
6311,açıda,0,0,1,1
5562,hænger,0,0,1,1
6309,adlı,0,0,1,1
6307,telgraf,0,0,1,1
6306,фотографиями,0,0,1,1
6305,കർണ്ണാടകയും,0,0,1,1
6303,antiélitisme,0,0,1,1
6300,kızmışım,0,0,1,1
6299,ursprungliga,0,0,1,1
6298,ಹೊಂದಿದ್ದಾನೆ,0,0,1,1
6297,शिक्षाविदों,0,0,1,1
6296,independentemente,0,0,1,1
6295,eraan,0,0,1,1
5564,محررو,0,0,1,1
6044,líderes,0,0,1,1
6043,fylla,0,0,1,1
6042,semiprotegidas,0,0,1,1
5785,foreslå,0,0,1,1
5775,nn •,0,0,1,1
5776,biélorusse,0,0,1,1
5777,satmanı,0,0,1,1
5635,ridende,0,0,1,1
5779,ಇನ್ನೊಂದಕ್ಕೆ,0,0,1,1
5633,gældende,0,0,1,1
5786,объяснениях,0,0,1,1
5639,அட்டவணை,0,0,1,1
5787,gördüğünde,0,0,1,1
5788,probabiliste,0,0,1,1
5630,स्नो,0,0,1,1
5791,allinclusive,0,0,1,1
5792,സവാരിക്ക്,0,0,1,1
5793,englische,0,0,1,1
5774,vi •,0,0,1,1
5773,وحده,0,0,1,1
5770,notskrift,0,0,1,1
5769,masiva»,0,0,1,1
5768,ಮಂಚದ,0,0,1,1
5766,भूमण्डल,0,0,1,1
5764,ledere,0,0,1,1
5637,adivinhar,0,0,1,1
5761,universelle »,0,0,1,1
5759,يلجأ,0,0,1,1
5758,компании,0,0,1,1
5638,"
सर्बियाई",0,0,1,1
5756,இதழ்,0,0,1,1
5755,organic,0,0,1,1
5754,erste,0,0,1,1
5753,संगोष्ठी,0,0,1,1
5751,bijzijn,0,0,1,1
5794,administratör,0,0,1,1
5795,அழகும்,0,0,1,1
5797,еде,0,0,1,1
5825,confine,0,0,1,1
5847,killer—a,0,0,1,1
5845,വരുമ്പൊൾ,0,0,1,1
5844,പഠിക്കുന്നുണ്ടെങ്കിൽ‌,0,0,1,1
5843,പ്രവർത്തിക്കുമെന്ന്,0,0,1,1
5842,പഠനത്തിലൂടെ,0,0,1,1
5841,employees,0,0,1,1
5838,nodige,0,0,1,1
5837,fizesse,0,0,1,1
5834,pedofilia,0,0,1,1
5833,oprichters,0,0,1,1
5832,immanente,0,0,1,1
5829,columbia,0,0,1,1
5828,antérieurs,0,0,1,1
5827,وتركز,0,0,1,1
5629,bible,0,0,1,1
5798,conforme,0,0,1,1
5822,engineers,0,0,1,1
5821,ಉಚ್ಚರಿಸುತ್ತಿದ್ದೀರಿ,0,0,1,1
5820,meninger,0,0,1,1
5819,விக்கிப்பீடியாவானது,0,0,1,1
5817,लीब्रे,0,0,1,1
5816,determined,0,0,1,1
5811,"
ऑसिशियाई",0,0,1,1
5810,ಎಲ್ಲವನ್ನೂ,0,0,1,1
5809,onaylanmış,0,0,1,1
5808,недели,0,0,1,1
5806,lie,0,0,1,1
5802,निर्भर,0,0,1,1
5801,başta,0,0,1,1
5799,webbtrafik,0,0,1,1
5750,gösterilmiştir,0,0,1,1
5748,singulière,0,0,1,1
5593,forming,0,0,1,1
5688,चली,0,0,1,1
5649,autoconfirmed,0,0,1,1
5681,transcendance,0,0,1,1
5682,മലയാള,0,0,1,1
5683,обязательно,0,0,1,1
5685,நத்தை,0,0,1,1
5648,توقفت,0,0,1,1
5689,homogénéité,0,0,1,1
5746,diante,0,0,1,1
5646,تحويها,0,0,1,1
5691,bloqueando,0,0,1,1
5693,ಪಡೆದುಕೊಂಡಿದ್ದೇನೆ,0,0,1,1
5694,ತೀಕ್ಷ್ಣವಾದ,0,0,1,1
5695,éditeur,0,0,1,1
5696,"
नॉर्मन",0,0,1,1
5679,processeurs,0,0,1,1
5677,mystery,0,0,1,1
5676,olmuştu,0,0,1,1
5675,open—anyone,0,0,1,1
5674,annuaire,0,0,1,1
5670,декабрь,0,0,1,1
5667,i̇çeriğinin,0,0,1,1
5666,contraignants,0,0,1,1
5665,sökbar,0,0,1,1
5664,vio,0,0,1,1
5663,ज़ोर,0,0,1,1
5662,εκτιμώ,0,0,1,1
5660,इनकार,0,0,1,1
5650,إحدى,0,0,1,1
5657,задаваемых,0,0,1,1
5656,figaro,0,0,1,1
5655,publiek,0,0,1,1
5699,ноябре,0,0,1,1
5701,hazır,0,0,1,1
5702,النظرية,0,0,1,1
5722,सौ,0,0,1,1
5743,facing,0,0,1,1
5742,പ്രിയങ്കരമെന്നും,0,0,1,1
5640,среда,0,0,1,1
5740,vanwege,0,0,1,1
5642,തിരുത്തിക്കോളും,0,0,1,1
5736,успокойся,0,0,1,1
5733,betygsätta,0,0,1,1
5731,ikinci,0,0,1,1
5729,человечества,0,0,1,1
5728,constituted,0,0,1,1
5727,l’« homme,0,0,1,1
5726,britse,0,0,1,1
5643,reminds,0,0,1,1
5724,выпустила,0,0,1,1
5721,ekmekle,0,0,1,1
5703,avaliado,0,0,1,1
5720,gebrekkig,0,0,1,1
5719,sitesine,0,0,1,1
5718,കൂട്ടിച്ചേർത്തെന്നുവരും,0,0,1,1
5717,சதுப்புநிலமானது,0,0,1,1
5644,செய்துவிட்டதாகவும்,0,0,1,1
5715,सियोल,0,0,1,1
5713,gidin,0,0,1,1
5712,incita,0,0,1,1
5645,noyade,0,0,1,1
5708,заказ,0,0,1,1
5707,ನೋಡುತ್ತಿದ್ದಾರೆ,0,0,1,1
5706,എന്തുചെയ്യും,0,0,1,1
5705,எடுக்கப்பட்டது,0,0,1,1
5704,utformat,0,0,1,1
5851,എത്രത്തോളമാവണം,0,0,1,1
5852,चित्रमाला,0,0,1,1
5853,вмешивается,0,0,1,1
5604,similares,0,0,1,1
5971,മുന്നോട്ടുപോകുക,0,0,1,1
5973,प्रतिनिधित्व,0,0,1,1
5976,yunan,0,0,1,1
5979,второе,0,0,1,1
5980,переживает,0,0,1,1
5981,юнеско,0,0,1,1
5983,wunderschön,0,0,1,1
5854,revient,0,0,1,1
5984,μεγαλώσει,0,0,1,1
5986,aarzelend,0,0,1,1
5987,отличный,0,0,1,1
5989,filme,0,0,1,1
5991,créationniste,0,0,1,1
5992,вебпорталом,0,0,1,1
5970,påbörja,0,0,1,1
5969,finsk,0,0,1,1
5968,wikimedia ,0,0,1,1
5967,माइक्रोसोफ्ट,0,0,1,1
5605,anpassas,0,0,1,1
5962,вдохновлённые,0,0,1,1
5960,emprega,0,0,1,1
5959,وارد,0,0,1,1
5607,repetidos,0,0,1,1
5955,tvärt,0,0,1,1
5951,வாரம்,0,0,1,1
5949,طبيعي,0,0,1,1
5948,bewildered,0,0,1,1
5608,للتعلم,0,0,1,1
5945,doublé ,0,0,1,1
5610,സഞ്ചരിച്ചിരുന്ന,0,0,1,1
5943,meşhur,0,0,1,1
5994,skrivaredigera,0,0,1,1
5602,سُئلت,0,0,1,1
5996,badly,0,0,1,1
5597,تعايش,0,0,1,1
6039,проведено,0,0,1,1
5594,refléter,0,0,1,1
6036,مناقشة,0,0,1,1
6035,república,0,0,1,1
6034,സ്റ്റോപ്പ്,0,0,1,1
6033,toulouse,0,0,1,1
6032,ಪಕ್ಷಿಗಳಂತೆ,0,0,1,1
6029,आंकडे,0,0,1,1
6028,propelling,0,0,1,1
6027,गूंगा,0,0,1,1
6026,motsvarar,0,0,1,1
5596,öğrenebilirsiniz,0,0,1,1
6022,ഓഫറുകൾ,0,0,1,1
6021,придумана,0,0,1,1
6019,derecho,0,0,1,1
5998,espéronsle,0,0,1,1
6018,eigendom,0,0,1,1
6017,ഉദാ‍ഹരണത്തിന്,0,0,1,1
5598,dialects,0,0,1,1
6014,bilgisayara,0,0,1,1
6013,confunde,0,0,1,1
5599,ಕೇವಲ,0,0,1,1
6011,ತೆಗೆದುಕೊಂಡನು,0,0,1,1
6010,السيبوانية,0,0,1,1
6008,контента,0,0,1,1
6007,„ахиллесовой,0,0,1,1
6006,restricted,0,0,1,1
6001,italie »m,0,0,1,1
6000,primair,0,0,1,1
5601,declarações,0,0,1,1
5942,assiste,0,0,1,1
5611,probabilidad,0,0,1,1
5613,acessíveis,0,0,1,1
5873,kaba,0,0,1,1
5893,тегами,0,0,1,1
5892,чудовищный,0,0,1,1
5890,exposición,0,0,1,1
5889,профессиональных,0,0,1,1
5888,ht •,0,0,1,1
5887,गाइडस्टार,0,0,1,1
5885,oturan,0,0,1,1
5884,फर्जी,0,0,1,1
5883,получив,0,0,1,1
5881,takılmıyorsun,0,0,1,1
5880,الرطبة,0,0,1,1
5879,‘கணினிச்,0,0,1,1
5877,interesadamente,0,0,1,1
5875,malheureusement,0,0,1,1
5872,हिसाब,0,0,1,1
5619,пытаются,0,0,1,1
5871,പഠിച്ചു,0,0,1,1
5622,mg •,0,0,1,1
5869,प्रविष्टियां,0,0,1,1
5867,конфликтам,0,0,1,1
5866,extending,0,0,1,1
5865,सारी,0,0,1,1
5864,gestart,0,0,1,1
5623,begik,0,0,1,1
5862,fixe ,0,0,1,1
5624,ನನ್ನೊಂದಿಗೆ,0,0,1,1
5860,സാധ്യമല്ല,0,0,1,1
5859,എഴുതുന്നുണ്ട്,0,0,1,1
5857,connectée,0,0,1,1
5855,âme,0,0,1,1
5894,attachées,0,0,1,1
5897,общим,0,0,1,1
5934,entgegen,0,0,1,1
5918,بينهم،,0,0,1,1
5614,kalbi,0,0,1,1
5932,"
फ़िनिश",0,0,1,1
5931,skrivstugor,0,0,1,1
5930,ditesnous,0,0,1,1
5615,நாட்களாக,0,0,1,1
5927,échappentréf,0,0,1,1
5926,coloquialmente,0,0,1,1
5925,maravilhada,0,0,1,1
5924,بإغرائهم,0,0,1,1
5923,കണക്ക്,0,0,1,1
5922,çalışmanız,0,0,1,1
5617,общественным,0,0,1,1
5920,owners,0,0,1,1
5919,أقبل,0,0,1,1
5916,வழங்கிகள்,0,0,1,1
5898,årevis,0,0,1,1
5915,программное,0,0,1,1
5913,плюрипотентности,0,0,1,1
5911,mandiberg,0,0,1,1
5910,healing,0,0,1,1
5909,colonisation,0,0,1,1
5908,rodord,0,0,1,1
5907,ದುರಸ್ತಿ,0,0,1,1
5906,ಫ್ರೆಂಚ್,0,0,1,1
5905,eklemeler,0,0,1,1
5904,μιλούσε,0,0,1,1
5903,taxonomía,0,0,1,1
5902,collégiale,0,0,1,1
5900,قمت,0,0,1,1
5899,सोचिए,0,0,1,1
6453,وجود,0,0,1,1
6454,favoriniz,0,0,1,1
5553,kathryn,0,0,1,1
6952,kvalitetsbrister,0,0,1,1
6946,revistos,0,0,1,1
5485,falhas,0,0,1,1
6948,paradoxa,0,0,1,1
6949,κατασκευασμένη,0,0,1,1
6950,ക്ഷമാപണം,0,0,1,1
6951,olun,0,0,1,1
6953,salvo,0,0,1,1
6923,anonymes,0,0,1,1
6956,olanı,0,0,1,1
6957,mascotas,0,0,1,1
6959,intersektionalitet,0,0,1,1
6960,مينج,0,0,1,1
6961,kedeligt,0,0,1,1
6963,അർത്ഥമാക്കുന്നതിന്,0,0,1,1
5486,révèle,0,0,1,1
6942,prestação,0,0,1,1
6941,cujas,0,0,1,1
5487,ramen,0,0,1,1
6938,സന്നദ്ധനാണ്,0,0,1,1
6936,ഓടി,0,0,1,1
5488,நலமாக,0,0,1,1
6934,veritabanından,0,0,1,1
6933,тупого,0,0,1,1
6932,ಸ್ಟುಪೆಂಡಸ್,0,0,1,1
6931,antivandal,0,0,1,1
6930,ويكي،,0,0,1,1
6929,doll,0,0,1,1
6928,instrument,0,0,1,1
6927,அமைப்பதாக,0,0,1,1
5489,lebender,0,0,1,1
6925,бейзингстоке,0,0,1,1
6964,ಅಪ್,0,0,1,1
6965,games,0,0,1,1
6967,लिखूंगा,0,0,1,1
5478,اليكم,0,0,1,1
7015,മറയ്‌ക്കാൻ‌,0,0,1,1
7014,beskrivs,0,0,1,1
7013,tenías,0,0,1,1
5475,hopefully,0,0,1,1
7011,சதுப்புநிலம்,0,0,1,1
7010,manuscrits,0,0,1,1
7009,двенадцатитомное,0,0,1,1
7007,nombrar,0,0,1,1
7006,நண்பர்,0,0,1,1
7005,protestataire,0,0,1,1
7004,ojämn,0,0,1,1
7003,gfdle,0,0,1,1
5476,ആർട്ടിഫിഷ്യൽ,0,0,1,1
5477,хуже,0,0,1,1
5480,instruments,0,0,1,1
6968,framework,0,0,1,1
6993,имеющих,0,0,1,1
5481,föreslår,0,0,1,1
6990,visualisera,0,0,1,1
6989,cèdent,0,0,1,1
6988,réductible,0,0,1,1
6987,bindi,0,0,1,1
6984,vándalos,0,0,1,1
6981,വെള്ളം,0,0,1,1
6979,vaknade,0,0,1,1
6974,онлайнэнциклопедии,0,0,1,1
6972,anomalous,0,0,1,1
6971,παράδοξη,0,0,1,1
5483,भेजूंगा,0,0,1,1
6969,கண்காணிக்கப்படுகின்றன,0,0,1,1
6924,erosion,0,0,1,1
6921,smakend,0,0,1,1
6830,reemplazados,0,0,1,1
6866,espinoza,0,0,1,1
6855,maç,0,0,1,1
5499,„википедию“ —,0,0,1,1
6857,जागरूकता,0,0,1,1
6860,estatísticos,0,0,1,1
6862,கொண்டுள்ளேன்,0,0,1,1
5498,نبحث,0,0,1,1
6869,« nécessaire »,0,0,1,1
6920,grekiskans,0,0,1,1
6870,acusações,0,0,1,1
6871,للامتحان,0,0,1,1
6873,​​opmerking,0,0,1,1
6874,korrelerat,0,0,1,1
6876,வேலைக்கு,0,0,1,1
6877,elva,0,0,1,1
6853,clouds,0,0,1,1
6852,avbryta,0,0,1,1
5500,adopta,0,0,1,1
6850,υπερβολικά,0,0,1,1
6848,ಹಾಸಿಗೆಯ,0,0,1,1
6847,способность,0,0,1,1
6846,derseniz,0,0,1,1
5501,dynamiques,0,0,1,1
6842,otimizam,0,0,1,1
6841,raymond,0,0,1,1
6838,vokse,0,0,1,1
6837,ποτό,0,0,1,1
6836,रूपों,0,0,1,1
6835,d’outils,0,0,1,1
6834,ಬೇರುಗಳನ್ನು,0,0,1,1
6833,അദ്ദേഹത്തിന്റെ,0,0,1,1
6832,pagerank,0,0,1,1
6879,λειτουργεί,0,0,1,1
6880,boneca,0,0,1,1
6882,trage,0,0,1,1
6901,проверены,0,0,1,1
6919,adequadas,0,0,1,1
6918,എന്നതൊക്കെ,0,0,1,1
6917,ändras,0,0,1,1
6916,yılında,0,0,1,1
6915,ಜಾಮ್‌ಗಳನ್ನು,0,0,1,1
6914,gevolgen,0,0,1,1
6912,guter,0,0,1,1
6911,ಬದಲಾಯಿಸಿದಳು,0,0,1,1
6910,റാണിയില്ലാത്ത,0,0,1,1
6907,ധനികനും,0,0,1,1
5492,eksisteret,0,0,1,1
6905,minoritetsuppfattningar,0,0,1,1
6904,പോർട്ടലിലൂടെ,0,0,1,1
6903,conjunction,0,0,1,1
6899,மூக்கைக்,0,0,1,1
6883,fnissar,0,0,1,1
6898,regista,0,0,1,1
6897,урегулирования,0,0,1,1
6896,оценено,0,0,1,1
6894,ഗംഭീരവുമായ,0,0,1,1
5494,vinklade,0,0,1,1
6892,чём,0,0,1,1
5495,заносят,0,0,1,1
6890,യൂട്യൂബിൽ,0,0,1,1
6889,diamonds,0,0,1,1
6888,deleting,0,0,1,1
6887,bundan,0,0,1,1
6886,”can,0,0,1,1
6885,forneça,0,0,1,1
6884,സമ്പൂർണവുമായ,0,0,1,1
7016,hervatten,0,0,1,1
7017,விரைவு,0,0,1,1
7018,എഴുതിയ,0,0,1,1
7144,حاولت,0,0,1,1
7136,"
वू",0,0,1,1
7138,للمستخدمين,0,0,1,1
7140,poignée,0,0,1,1
5457,förstående,0,0,1,1
7142,beräknades,0,0,1,1
7143,somehow,0,0,1,1
7145,station,0,0,1,1
7019,lächelten,0,0,1,1
7146,“change,0,0,1,1
5456,certainly,0,0,1,1
7148,klassiske,0,0,1,1
5455,ಮೆಲ್ಲೀ,0,0,1,1
5454,المتحدثون,0,0,1,1
7151,girl,0,0,1,1
5459,தூக்கத்தில்,0,0,1,1
7134,अहंकारी,0,0,1,1
7133,экземпляре,0,0,1,1
7132,hosting,0,0,1,1
7131,amoralidade,0,0,1,1
7130,ரொட்டியால்,0,0,1,1
7129,proliferate,0,0,1,1
7128,retain,0,0,1,1
5460,kulağa,0,0,1,1
7125,размещены,0,0,1,1
7124,courte,0,0,1,1
7123,imprimée,0,0,1,1
7122,पूछें।,0,0,1,1
5461,kinderpornografie,0,0,1,1
7119,സ്വതന്ത്രവിജ്ഞാനകോശം,0,0,1,1
7118,proving,0,0,1,1
7116,निरंतर,0,0,1,1
7152,culpable,0,0,1,1
7154,zim,0,0,1,1
7156,выпустить,0,0,1,1
7177,språkliga,0,0,1,1
7191,دورية,0,0,1,1
5449,existed,0,0,1,1
7189,pojke,0,0,1,1
7188,confirmer,0,0,1,1
7187,ആഗ്രഹിച്ചില്ല,0,0,1,1
7186,مكتوبة,0,0,1,1
7185,сентябре,0,0,1,1
7184,betarask •,0,0,1,1
7183,prisioneiros,0,0,1,1
7182,الرغبة,0,0,1,1
7181,"നിഷ്പക്ഷത
ഉറപ്പാക്കുന്നു",0,0,1,1
7180,inactivity,0,0,1,1
5450,diagnose,0,0,1,1
5451,"
जर्मन",0,0,1,1
7176,φορέματα,0,0,1,1
7157,அதோடு,0,0,1,1
5453,destacado,0,0,1,1
7174,etsem,0,0,1,1
7173,ജീവിതത്തിലെ,0,0,1,1
7171,ലാബിൽ,0,0,1,1
7170,macroecosystem,0,0,1,1
7168,வந்தன,0,0,1,1
7167,facia,0,0,1,1
7166,instantáneamente,0,0,1,1
7165,अवसर,0,0,1,1
7164,എന്നതുപോലെയാണ്,0,0,1,1
7162,captured,0,0,1,1
7160,trouverez,0,0,1,1
7159,sayfayı,0,0,1,1
7158,saisies,0,0,1,1
7115,количество,0,0,1,1
5462,rapportés,0,0,1,1
7113,complaining,0,0,1,1
7043,vertus,0,0,1,1
7059,engouement,0,0,1,1
7058,ಹೇಳುವಂತೆ,0,0,1,1
7057,"
volapuque",0,0,1,1
7056,noam,0,0,1,1
7054,പോലെയാണിവർ,0,0,1,1
7053,выросла,0,0,1,1
7052,dormindo,0,0,1,1
7051,ونفس,0,0,1,1
7050,rudemente,0,0,1,1
7049,selfsustaining,0,0,1,1
7048,mezcla,0,0,1,1
7047,حديثًا,0,0,1,1
7046,alcanzaba,0,0,1,1
7045,التهنئة,0,0,1,1
7042,ಕನಸನ್ನು,0,0,1,1
7061,दस्तावेजों,0,0,1,1
5470,museum,0,0,1,1
7040,retórico,0,0,1,1
7039,كلية,0,0,1,1
7038,weltkriegs,0,0,1,1
7036,مهذب,0,0,1,1
5472,playing,0,0,1,1
7033,другим»,0,0,1,1
5473,கிடைக்காதபோது,0,0,1,1
7031,weit,0,0,1,1
7030,دكتوراه,0,0,1,1
7029,पीटर,0,0,1,1
7026,görünmesini,0,0,1,1
7024,держала,0,0,1,1
7022,hoefler,0,0,1,1
7060,അവരിലൊരാളായി,0,0,1,1
7062,автоматизированный,0,0,1,1
5463,ναρκίσσας,0,0,1,1
7088,verschiedene,0,0,1,1
5464,தாக்குதலுக்குள்ளாகும்,0,0,1,1
7110,"
यूनानी",0,0,1,1
7109,manipulates,0,0,1,1
7107,partit,0,0,1,1
7106,équipés,0,0,1,1
7104,draws,0,0,1,1
7103,tillhandahålls,0,0,1,1
7100,skyldes,0,0,1,1
7099,وتحمل,0,0,1,1
7098,donantes,0,0,1,1
7096,تحت,0,0,1,1
7095,parálo,0,0,1,1
5466,värre,0,0,1,1
7091,bevara,0,0,1,1
7087,تراكمت,0,0,1,1
7063,no •,0,0,1,1
7084,ജൂലൈ,0,0,1,1
7083,categorización,0,0,1,1
5469,olvidan,0,0,1,1
7081,கொள்கையாக,0,0,1,1
7080,sunmaya,0,0,1,1
7079,وتحريره,0,0,1,1
7076,ಪಾದಗಳನ್ನು,0,0,1,1
7075,"
आयरिश",0,0,1,1
7071,الثانية،,0,0,1,1
7070,memnuniyet,0,0,1,1
7069,soe,0,0,1,1
7068,தூதர்,0,0,1,1
7067,разграничение,0,0,1,1
7064,successives,0,0,1,1
6831,probablement,0,0,1,1
6827,adeus,0,0,1,1
6456,besleyelim,0,0,1,1
6580,incógnito,0,0,1,1
6571,flahault,0,0,1,1
6573,ಹೊರಬಂದು,0,0,1,1
6574,asteroid,0,0,1,1
6575,ساعدني,0,0,1,1
6576,കാണാനായതിൽ,0,0,1,1
6577,محق,0,0,1,1
6581,l’utilisateur,0,0,1,1
6546,nachts,0,0,1,1
6582,அதைக்,0,0,1,1
6587,प्रणालीगत,0,0,1,1
6589,inseridas,0,0,1,1
6590,översvämning,0,0,1,1
6592,carbon,0,0,1,1
6594,അല്ലാത്തവയെയും,0,0,1,1
6569,வார்த்தைகளுக்கு,0,0,1,1
6568,commonso,0,0,1,1
6567,el •,0,0,1,1
6566,exibição,0,0,1,1
6565,हटाया,0,0,1,1
6564,latitudinal,0,0,1,1
6563,keuzes,0,0,1,1
6562,ஒருங்கிணைந்து,0,0,1,1
6561,aldın,0,0,1,1
6560,легче,0,0,1,1
6558,மறைக்க,0,0,1,1
6557,amazon,0,0,1,1
6554,älskade,0,0,1,1
6553,யாரும்,0,0,1,1
6552,forestil,0,0,1,1
6551,несчастный,0,0,1,1
6549,προέλευση,0,0,1,1
5540,monday,0,0,1,1
6597,divisant,0,0,1,1
6598,ejército,0,0,1,1
6623,слышал,0,0,1,1
6640,ബുദ്ധിയുടെ,0,0,1,1
6638,quería,0,0,1,1
6637,beispiele,0,0,1,1
6636,şükür,0,0,1,1
6635,неполными,0,0,1,1
6634,fournit,0,0,1,1
6632,класс,0,0,1,1
6631,τουρίστας,0,0,1,1
5534,வழங்குகின்றன,0,0,1,1
6628,exploratory,0,0,1,1
6627,difíciles,0,0,1,1
6626,afterward,0,0,1,1
5535,arrangeras,0,0,1,1
6624,редактируется,0,0,1,1
6622,visie,0,0,1,1
6599,قرض,0,0,1,1
5537,ερωτηματικό,0,0,1,1
6619,static,0,0,1,1
6617,voldtægtshændelser,0,0,1,1
6616,interglaciaires,0,0,1,1
6615,كاتب,0,0,1,1
5538,панорамы,0,0,1,1
6611,nimmst,0,0,1,1
6610,ചെയ്യാമെന്ന്,0,0,1,1
6609,злотых,0,0,1,1
5539,sällan,0,0,1,1
6607,παρακολούθηση,0,0,1,1
6605,ചെയ്തെടുക്കുന്നു,0,0,1,1
6604,ownership,0,0,1,1
6601,الطفولة،,0,0,1,1
6548,necrológicas,0,0,1,1
6544,l’on,0,0,1,1
5503,занимался,0,0,1,1
6486,напомнить,0,0,1,1
6478,exactitud,0,0,1,1
5550,behoud,0,0,1,1
6480,повторила,0,0,1,1
6481,ಸ್ಥಗಿತಗೊಳಿಸಿ,0,0,1,1
6482,أعارض,0,0,1,1
6484,existé,0,0,1,1
6487,ümmete,0,0,1,1
6542,internetencyclopedie,0,0,1,1
6488,الأفارقة,0,0,1,1
6490,doorheeft,0,0,1,1
6491,заставило,0,0,1,1
6492,stiegler,0,0,1,1
6494,തോന്നുന്നതുപോലെ,0,0,1,1
6497,ммм,0,0,1,1
6477,ремонтом,0,0,1,1
6476,verloren,0,0,1,1
5551,делаю,0,0,1,1
6474,لتخبره,0,0,1,1
6473,पर्यटक,0,0,1,1
6472,az •,0,0,1,1
6470,olsaydı,0,0,1,1
6468,पात्र,0,0,1,1
6467,universiteit,0,0,1,1
6466,ನೆನಪಿಸಲು,0,0,1,1
6464,πιάτο,0,0,1,1
6463,இல்லாத,0,0,1,1
6462,المساء,0,0,1,1
6461,κήπο,0,0,1,1
6459,pretendientes,0,0,1,1
6458,turner,0,0,1,1
6457,guldbrød,0,0,1,1
6498,saati,0,0,1,1
6499,kvantitativ,0,0,1,1
6501,സമ്പർക്കം,0,0,1,1
6520,"modell
",0,0,1,1
6541,bebek,0,0,1,1
6540,spring,0,0,1,1
6539,викисклада,0,0,1,1
6535,oproportionerligt,0,0,1,1
6534,справа,0,0,1,1
6533,மாண்டி’,0,0,1,1
6532,ох,0,0,1,1
6530,remercie,0,0,1,1
6528,وأقول,0,0,1,1
6525,fodre,0,0,1,1
6524,kanala,0,0,1,1
6523,πληρώσει,0,0,1,1
6522,பார்த்தபோது,0,0,1,1
6521,religiously,0,0,1,1
6519,mordaza,0,0,1,1
6503,schmeckendes,0,0,1,1
5547,نزاعات,0,0,1,1
6517,teklifini,0,0,1,1
6516,ஆனது,0,0,1,1
6515,والكورية،,0,0,1,1
6514,போகும்,0,0,1,1
6513,പുറത്താക്കിയത്,0,0,1,1
6512,അമ്മയായിരുന്നു,0,0,1,1
6511,précisant ,0,0,1,1
6510,بالمائة،,0,0,1,1
6509,​​en,0,0,1,1
6508,quarta,0,0,1,1
6506,ಉದ್ಯೋಗವನ್ನು,0,0,1,1
6505,വാക്കിനെക്കുറിച്ച്,0,0,1,1
6504,высокий,0,0,1,1
6644,plotkin,0,0,1,1
6645,താൽപ്പര്യമില്ല,0,0,1,1
5531,стадии,0,0,1,1
6767,ആഗ്രഹിക്കുന്ന,0,0,1,1
6760,country,0,0,1,1
5512,fontenelle,0,0,1,1
6763,prohibit,0,0,1,1
6764,nooit,0,0,1,1
6765,inativado,0,0,1,1
6766,tapez,0,0,1,1
6768,अच्छा।,0,0,1,1
6647,privilegiadas,0,0,1,1
6769,denoising,0,0,1,1
6771,बिलकुल।,0,0,1,1
6773,damos,0,0,1,1
5511,കൂടുതലുള്ളതും,0,0,1,1
6775,nacemos,0,0,1,1
6776,растерянной,0,0,1,1
5513,отмечено,0,0,1,1
6758,oroar,0,0,1,1
6757,découlant,0,0,1,1
6756,torsdag,0,0,1,1
6755,perceived,0,0,1,1
6753,എങ്ങനെയുണ്ട്,0,0,1,1
6752,«usuarios»,0,0,1,1
6751,l’interprétabilité,0,0,1,1
6750,crazy,0,0,1,1
5514,страх,0,0,1,1
6747,assertions,0,0,1,1
6746,وقبل,0,0,1,1
6745,فهم,0,0,1,1
6742,प्राप्ति,0,0,1,1
6739,étudiés,0,0,1,1
6738,ಗೂಗಲ್‌ಗೆ,0,0,1,1
6737,πρόσωπό,0,0,1,1
5510,അയയ്ക്കാനോ,0,0,1,1
6779,definitief,0,0,1,1
6780,nine,0,0,1,1
6801,comencemos,0,0,1,1
5504,förväntade,0,0,1,1
6824,ударилась,0,0,1,1
6822,പറയണം,0,0,1,1
6819,ಹೆದರುವುದಿಲ್ಲ,0,0,1,1
6816,заявив,0,0,1,1
6815,pleure,0,0,1,1
5506,انتقل,0,0,1,1
6813,allesomvattende,0,0,1,1
6811,bidragen,0,0,1,1
6810,κρατήσετε,0,0,1,1
6809,contratado,0,0,1,1
5507,فلنفعل,0,0,1,1
6803,вручении,0,0,1,1
6802,egenintresse,0,0,1,1
6799,balcony,0,0,1,1
6781,ಮೈಲಿಗೆ,0,0,1,1
5508,مقالاتها،,0,0,1,1
6797,vain »,0,0,1,1
5509,ഇരിക്കുന്നതുപോലെയാണ്,0,0,1,1
6795,அறிவிக்கப்பட்டது,0,0,1,1
6794,единственной,0,0,1,1
6793,تتمتع,0,0,1,1
6792,bildiğin,0,0,1,1
6790,ಹೇಳಿದ್ದೇನೆ,0,0,1,1
6789,bienvenido,0,0,1,1
6787,ആശയം,0,0,1,1
6786,δώσετε,0,0,1,1
6785,freundin,0,0,1,1
6784,إيقافك,0,0,1,1
6782,ശബ്ദത്തിന്റെ,0,0,1,1
6736,﻿°n,0,0,1,1
6735,تعليقات,0,0,1,1
5515,غاضب,0,0,1,1
6666,آرثر,0,0,1,1
6684,“poor,0,0,1,1
6682,умного,0,0,1,1
6680,asegúrate,0,0,1,1
5525,മുഴുവനും,0,0,1,1
6678,formidable,0,0,1,1
6677,обобщению,0,0,1,1
5527,zinken,0,0,1,1
6673,الأولى،,0,0,1,1
6672,« vitaliste »,0,0,1,1
6671,anlaman,0,0,1,1
6670,скорее,0,0,1,1
5528,n’existait,0,0,1,1
5529,phenomenon,0,0,1,1
6667,الأوربية,0,0,1,1
6665,ಇತ್ತು,0,0,1,1
6686,judaïque,0,0,1,1
6664,stinkende,0,0,1,1
6663,messages,0,0,1,1
6660,മൂർച്ചയെ,0,0,1,1
6659,बाधित,0,0,1,1
6658,sansade,0,0,1,1
6657,polis,0,0,1,1
6656,relevé,0,0,1,1
5530,implied,0,0,1,1
6654,некоторого,0,0,1,1
6653,fishing,0,0,1,1
6652,شاكرا,0,0,1,1
6651,syrien,0,0,1,1
6649,codfw,0,0,1,1
6648,desejar,0,0,1,1
6685,ederseniz,0,0,1,1
6688,konuşuyordun,0,0,1,1
6732,cumhurbaşkanı,0,0,1,1
6712,விரும்புவதில்லை,0,0,1,1
6731,noem,0,0,1,1
6730,ചീത്തയാണോ,0,0,1,1
6727,ಮಂದ,0,0,1,1
5517,meramente,0,0,1,1
6724,införandet,0,0,1,1
6723,தேவதையைப்,0,0,1,1
6722,بخلاف,0,0,1,1
5518,mme,0,0,1,1
6720,"
japonês",0,0,1,1
6718,özgürlüğüm,0,0,1,1
6717,പാട്ടുകളിൽ,0,0,1,1
6715,редактора,0,0,1,1
5519,raw,0,0,1,1
6713,recommandations,0,0,1,1
6711,äktenskapet,0,0,1,1
5522,comenzaba,0,0,1,1
6708,παγκόσμια,0,0,1,1
6707,организациями,0,0,1,1
6706,ಮಹಾಕಾವ್ಯವನ್ನು,0,0,1,1
6705,d’extrapolation,0,0,1,1
6703,skriverier,0,0,1,1
6701,arcaísmo,0,0,1,1
6700,οδηγίες,0,0,1,1
6699,മാതൃകയിലുള്ള,0,0,1,1
6698,"
अंतर",0,0,1,1
6697,فظة,0,0,1,1
5521,tab,0,0,1,1
6694,wiknic,0,0,1,1
6693,കരയുന്നത്,0,0,1,1
6692,வேண்டுமானாலும்,0,0,1,1
8750,успешно,0,0,1,1
8753,ಸಂಪತ್ತು,0,0,1,1
4840,bâtiments,0,0,1,1
10888,klibinde,0,0,1,1
10882,оксфордского,0,0,1,1
10883,indesejável,0,0,1,1
10884,consultable,0,0,1,1
4981,خطأي,0,0,1,1
10886,campaign,0,0,1,1
10887,τηλέφωνό,0,0,1,1
10890,quejas,0,0,1,1
10853,событиях,0,0,1,1
10891,للمجتمع,0,0,1,1
4980,உதவியுடன்,0,0,1,1
10895,ahí,0,0,1,1
4979,géré,0,0,1,1
10897,enbomis,0,0,1,1
4978,entsetzlich,0,0,1,1
10881,pueblo,0,0,1,1
4982,descubrir,0,0,1,1
10877,ആരംഭിച്ചപ്പോഴാണ്,0,0,1,1
10875,eclat,0,0,1,1
10874,conquistas,0,0,1,1
10871,ಪಡೆಯುವವರೆಗೂ,0,0,1,1
10870,ರಹಸ್ಯವನ್ನು,0,0,1,1
10869,veckotidskrift,0,0,1,1
10868,televisão,0,0,1,1
10867,δουλεύεις,0,0,1,1
10864,состоит,0,0,1,1
10863,التوثيق,0,0,1,1
4985,நகைச்சுவை,0,0,1,1
10860,وصبر,0,0,1,1
10859,найдете,0,0,1,1
10858,रॉय,0,0,1,1
10855,ಮನಸ್ಸು,0,0,1,1
10899,perguntaram,0,0,1,1
10900,sederna,0,0,1,1
10903,mensageiro,0,0,1,1
10923,احتمالية,0,0,1,1
10940,திரைப்படங்கள்,0,0,1,1
10938,professionella,0,0,1,1
10935,вошла,0,0,1,1
10934,تعاونيًا,0,0,1,1
10933,disk,0,0,1,1
10932,« youtube »,0,0,1,1
10931,eklenebilmesine,0,0,1,1
10930,sætningsnummer,0,0,1,1
10929,മന്ദത,0,0,1,1
10928,الانتقادات,0,0,1,1
10927,медленный,0,0,1,1
10926,intimidatorias,0,0,1,1
10925,wedstrijd,0,0,1,1
4973,ಮಗು,0,0,1,1
10921,"
कोमी",0,0,1,1
10904,liknandeknappen,0,0,1,1
10920,ಜಾಗದಲ್ಲಿ,0,0,1,1
10918,bilderna,0,0,1,1
10916,discount,0,0,1,1
10915,உழைக்க,0,0,1,1
10914,பணியாற்றியவர்,0,0,1,1
10913,επιχείρηση,0,0,1,1
10912,acknowledged,0,0,1,1
4976,d’inclure,0,0,1,1
10910,пародий,0,0,1,1
10909,ಆಹ್ಲಾದಕರ,0,0,1,1
10908,mathehausaufgaben,0,0,1,1
10907,редакторских,0,0,1,1
10906,considerava,0,0,1,1
10905,സ്വർണ്ണനിറത്തിലായിരുന്നപ്പോൾ,0,0,1,1
10854,проделал,0,0,1,1
10852,yiyeceklerden,0,0,1,1
10942,ஸ்லாஷ்டாட்,0,0,1,1
10791,pænt,0,0,1,1
10782,வைக்கும்,0,0,1,1
10784,имела,0,0,1,1
10785,bilmediği,0,0,1,1
10786,matriz,0,0,1,1
10788,ashton,0,0,1,1
4992,geheimen,0,0,1,1
10792,joaquín,0,0,1,1
10851,συναρπαστικό,0,0,1,1
10794,stagne,0,0,1,1
10795,intressant,0,0,1,1
10796,நிதி,0,0,1,1
10801,നയിക്കും,0,0,1,1
10802,википедияудализм,0,0,1,1
10803,anglais ,0,0,1,1
10781,infoga,0,0,1,1
10780,отрасли,0,0,1,1
10779,fouille,0,0,1,1
10778,неуклонно,0,0,1,1
10777,ಸಂದರ್ಶನವೊಂದರಲ್ಲಿ,0,0,1,1
10776,istisnalar,0,0,1,1
10772,apagados,0,0,1,1
10771,நிலமானது,0,0,1,1
10770,privilegier,0,0,1,1
10768,veckor,0,0,1,1
10767,ಅನುಮಾನಕ್ಕೆ,0,0,1,1
10766,avsaknad,0,0,1,1
10765,अनुदान,0,0,1,1
10762,ಪ್ರಕಾರಕ್ಕಿಂತ,0,0,1,1
10761,gebrochenem,0,0,1,1
10760,verenigde,0,0,1,1
10757,extinción,0,0,1,1
10804,parçasıdır,0,0,1,1
10805,alison,0,0,1,1
10806,вандализирующими,0,0,1,1
10832,உதவிக்காக,0,0,1,1
4988,soffa,0,0,1,1
10849,μάθηση,0,0,1,1
10848,झांका।,0,0,1,1
10847,ಮೊದಲಿಗೆ,0,0,1,1
10846,divisée,0,0,1,1
10842,கேள்வியைத்,0,0,1,1
10841,reden,0,0,1,1
10840,மோசமானது,0,0,1,1
10839,ആയിരുന്നോ,0,0,1,1
10838,celestial,0,0,1,1
10836,ನಲ್ಲಿದ್ದೇನೆ,0,0,1,1
10835,വരുത്തുക,0,0,1,1
10834,வெளியேறினேன்,0,0,1,1
10833,वास्तुकला,0,0,1,1
10831,ചേർന്ന്,0,0,1,1
10810,ತಿನ್ನಬೇಕು,0,0,1,1
10826,χαμογελάσει,0,0,1,1
10825,पिज्जा,0,0,1,1
10824,spørgsmålstegn,0,0,1,1
10823,сайтов,0,0,1,1
10822,modstridende,0,0,1,1
10821,заключенные,0,0,1,1
10820,ഒരാൾ,0,0,1,1
10818,الحق,0,0,1,1
4990,grundaren,0,0,1,1
10815,للمجتمع،,0,0,1,1
10814,هنري,0,0,1,1
10813,apparaten,0,0,1,1
4991,ಸ್ಮೈಲ್ಸ್,0,0,1,1
10811,മനുഷ്യനും,0,0,1,1
10941,மறுநாள்,0,0,1,1
10943,ಅದರಿಂದ,0,0,1,1
10361,reverses,0,0,1,1
11070,кажется,0,0,1,1
4958,connaît,0,0,1,1
11062,எப்படியிருந்தாலும்,0,0,1,1
4956,arun,0,0,1,1
11064,söylüyorsun,0,0,1,1
11066,wikipediagemeenschap,0,0,1,1
11067,состоящих,0,0,1,1
11071,darnos,0,0,1,1
11037,تيرنس,0,0,1,1
4955,المعارض,0,0,1,1
4953,ecologically,0,0,1,1
11074,opmaak,0,0,1,1
11077,introduces,0,0,1,1
11078,ഭക്ഷ്യയോഗ്യമല്ലാത്ത,0,0,1,1
11079,والتشخيص,0,0,1,1
11060,succinct,0,0,1,1
11059,വരുമെന്നും,0,0,1,1
11056,tilfældigvis,0,0,1,1
11055,knapp,0,0,1,1
11054,இதுவரை,0,0,1,1
11053,എടുത്ത,0,0,1,1
11052,sérieux,0,0,1,1
11051,mevcut,0,0,1,1
11050,pose,0,0,1,1
11049,सटीक,0,0,1,1
11048,फ्राई,0,0,1,1
11046,हास्यास्पद,0,0,1,1
11045,പിന്നിലെ,0,0,1,1
11044,acheter,0,0,1,1
11043,т н,0,0,1,1
11040,λεκτικό,0,0,1,1
11039,onlardan,0,0,1,1
11080,வீடியோவை,0,0,1,1
11081,hearing,0,0,1,1
11082,मिलन,0,0,1,1
11101,sönder,0,0,1,1
11119,ಮಾತನಾಡಬಲ್ಲಿರಾ,0,0,1,1
11118,brief,0,0,1,1
11117,पकड़ने,0,0,1,1
11116,lättåtkomliga,0,0,1,1
11114,assembled,0,0,1,1
11112,മീറ്റിംഗ്,0,0,1,1
11111,identificaba,0,0,1,1
11110,விக்கிப்பீடியாகொம்,0,0,1,1
11109,especifica,0,0,1,1
11108,vectors,0,0,1,1
11107,randevusu,0,0,1,1
11105,gradientes,0,0,1,1
11104,റൂമിലേക്ക്,0,0,1,1
11102,விக்கியை,0,0,1,1
11099,hong,0,0,1,1
4951,दिसंबर,0,0,1,1
11098,irs,0,0,1,1
11097,സ്ക്കൂൾ,0,0,1,1
11096,कारणों,0,0,1,1
11095,उत्कृष्टविरोधी,0,0,1,1
11094,स्ट्रिप,0,0,1,1
11093,criarlos,0,0,1,1
11092,μαθηματικό,0,0,1,1
11091,construcción»,0,0,1,1
11090,comemora,0,0,1,1
11088,الخطط,0,0,1,1
11087,studerar,0,0,1,1
11086,شكل,0,0,1,1
11085,हमला,0,0,1,1
11084,ഉപയോഗിക്കാം,0,0,1,1
11038,sortuda,0,0,1,1
11035,irmos,0,0,1,1
10944,हास्यपूर्ण,0,0,1,1
10982,رد,0,0,1,1
10973,wikipediocracy,0,0,1,1
10974,niks,0,0,1,1
4964,गणना,0,0,1,1
4963,அதிகப்,0,0,1,1
10977,sesgadas,0,0,1,1
10978,séparation,0,0,1,1
10983,ينشئا,0,0,1,1
11033,arrêté,0,0,1,1
10985,تشكيل,0,0,1,1
10986,highquality,0,0,1,1
10987,المعرفة,0,0,1,1
10988,وشخص,0,0,1,1
10989,proactifs,0,0,1,1
4962,sakligt,0,0,1,1
10972,unmanned,0,0,1,1
10970,എല്ലാവരേയും,0,0,1,1
10969,لطيفان,0,0,1,1
10968,linéaire,0,0,1,1
10967,വിവരത്തെ,0,0,1,1
10965,aprendido,0,0,1,1
10964,ഉപേക്ഷിച്ചിട്ടുണ്ടെങ്കിൽ,0,0,1,1
4967,mücadele,0,0,1,1
10961,البذاءة,0,0,1,1
4970,تيمز,0,0,1,1
10955,nærheden,0,0,1,1
10953,troepen,0,0,1,1
10951,телеграмму,0,0,1,1
10950,tpr,0,0,1,1
10948,نقل,0,0,1,1
10947,вкладчиков,0,0,1,1
10946,авторских,0,0,1,1
10992,выучили,0,0,1,1
10993,حيرة,0,0,1,1
10994,geuit,0,0,1,1
11017,picante,0,0,1,1
11032,तथा,0,0,1,1
11031,réglementant,0,0,1,1
11030,സമ്മതിക്കുന്നുവെന്ന്,0,0,1,1
11029,müzik,0,0,1,1
11028,lachend,0,0,1,1
11027,та,0,0,1,1
11026,"
वियतनामी",0,0,1,1
11025,infallsvinklar,0,0,1,1
11024,dağıtım,0,0,1,1
11022,yaşardı,0,0,1,1
11021,artikelhistorik,0,0,1,1
11020,involved,0,0,1,1
11019,erronée,0,0,1,1
11018,vagn,0,0,1,1
4960,സമൂഹത്തിന്,0,0,1,1
10995,serve,0,0,1,1
11015,değişik,0,0,1,1
11013,omitted,0,0,1,1
11012,важными,0,0,1,1
11011,adaptive,0,0,1,1
11009,καλής,0,0,1,1
11008,medicinal,0,0,1,1
4961,relegada,0,0,1,1
11004,exportar,0,0,1,1
11003,περίπτωση,0,0,1,1
11002,væsener,0,0,1,1
11001,güzelliğinden,0,0,1,1
10998,गर्म,0,0,1,1
10997,موافق,0,0,1,1
10996,afbryder,0,0,1,1
10755,مبتسمين,0,0,1,1
10754,concordar,0,0,1,1
10752,tvekande,0,0,1,1
10498,depleting,0,0,1,1
10488,volvería,0,0,1,1
10490,هدية,0,0,1,1
10491,ಹೊಂದಿರಬೇಕು,0,0,1,1
10492,dismissed,0,0,1,1
10493,ursäkta,0,0,1,1
10494,intrinsically,0,0,1,1
10499,ignorant,0,0,1,1
10464,felen,0,0,1,1
10502,kloonwebsites,0,0,1,1
10503,asemejan,0,0,1,1
10504,yapılabilir,0,0,1,1
10505,bristfällig,0,0,1,1
10506,änderte,0,0,1,1
5021,turkije,0,0,1,1
10487,قوانين,0,0,1,1
10486,klaarmaken,0,0,1,1
10485,telefoneren,0,0,1,1
10484,fastslog,0,0,1,1
10481,usædvanligt,0,0,1,1
10480,portals,0,0,1,1
10477,geautomatiseerde,0,0,1,1
10476,एनसिक्लोपेडिया,0,0,1,1
10475,verstehe,0,0,1,1
10474,evolucionando,0,0,1,1
10473,liberal,0,0,1,1
10472,критику,0,0,1,1
10471,ಮುಂದುವರಿಸಿ,0,0,1,1
5022,görmek,0,0,1,1
10469,jolie,0,0,1,1
10468,"
प्रारंभ",0,0,1,1
10467,extensa »,0,0,1,1
10508,ತೊಂದರೆಯುಂಟುಮಾಡುವ,0,0,1,1
10509,edersen,0,0,1,1
10511,вклады,0,0,1,1
10534,വിലയിരുത്തൽ,0,0,1,1
10560,पेशकश,0,0,1,1
5015,edemezsin,0,0,1,1
10555,ಅನುಭವವಿಲ್ಲದೆ,0,0,1,1
10554,ಗಂಭೀರವಾದ,0,0,1,1
10553,stemmetone,0,0,1,1
5017,перелицензировать,0,0,1,1
10550,delats,0,0,1,1
10549,kökenine,0,0,1,1
10546,« comme,0,0,1,1
10545,officiella,0,0,1,1
10544,revise,0,0,1,1
10543,ഇഫക്റ്റ്,0,0,1,1
5019,°w﻿,0,0,1,1
10537,morimos,0,0,1,1
10533,vermeiden,0,0,1,1
10512,notoires,0,0,1,1
10531,halftruth,0,0,1,1
10529,ಒಪ್ಪಿಕೊಳ್ಳಿ,0,0,1,1
10528,bardakçı,0,0,1,1
10527,upphovspersonerna,0,0,1,1
10525,ethvert,0,0,1,1
10524,versies,0,0,1,1
10522,आँसुओं,0,0,1,1
10521,potatis,0,0,1,1
10520,получили,0,0,1,1
10518,bake,0,0,1,1
10517,править —,0,0,1,1
10516,türden,0,0,1,1
10514,entero,0,0,1,1
10513,reflexo,0,0,1,1
10465,—usemod—,0,0,1,1
10462,متخصصين،,0,0,1,1
10750,exposure,0,0,1,1
10396,выборки,0,0,1,1
10386,mata,0,0,1,1
10387,utomstående,0,0,1,1
10390,ഗുണമേന്മയുള്ള,0,0,1,1
10391,सूचित,0,0,1,1
5031,ನಿಯೋಜನೆಗಳೊಂದಿಗೆ,0,0,1,1
10395,pair,0,0,1,1
10397,correctoras,0,0,1,1
10461,ಬೆಲ್,0,0,1,1
10398,nederlandse,0,0,1,1
10401,wikimodellen,0,0,1,1
10404,tes,0,0,1,1
10405,didier,0,0,1,1
10406,مؤكدة،,0,0,1,1
10408,υπομονετικά,0,0,1,1
10385,matériels,0,0,1,1
10382,θυελλώδη,0,0,1,1
10381,"
birmanês",0,0,1,1
10380,தொடக்கத்திற்குப்,0,0,1,1
10379,कहेंगे,0,0,1,1
10378,web ,0,0,1,1
10376,делаются,0,0,1,1
10375,треть,0,0,1,1
10373,athéisme,0,0,1,1
5032,​​ontmoetingsplaats,0,0,1,1
10369,durdurabilir,0,0,1,1
10368,अणुओं,0,0,1,1
10367,σέρνουν,0,0,1,1
10366,поздравить,0,0,1,1
10365,പോകാമെന്ന്,0,0,1,1
10364,yaparak,0,0,1,1
10363,ακούσω,0,0,1,1
10409,  imagesk,0,0,1,1
5030,потерял,0,0,1,1
5029,بجد,0,0,1,1
10430,söyleyebilirim,0,0,1,1
10460,субботних,0,0,1,1
10457,anzutreten,0,0,1,1
10456,λέγοντας,0,0,1,1
10455,tıklayarak,0,0,1,1
10454,старые,0,0,1,1
10453,للناس,0,0,1,1
10450,ചെയ്യരുത്,0,0,1,1
10448,बँधा,0,0,1,1
10447,ആശയക്കുഴപ്പത്തിലാക്കുക,0,0,1,1
10446,голоса,0,0,1,1
10445,​​till,0,0,1,1
10444,locaux,0,0,1,1
10438,vereiste,0,0,1,1
10432,απέρριψε,0,0,1,1
10429,расширяется,0,0,1,1
10413,defensores,0,0,1,1
10427,രത്നങ്ങളിലും,0,0,1,1
10426,secundárias,0,0,1,1
10425,accepter,0,0,1,1
10424,permitiria,0,0,1,1
10423,изданы,0,0,1,1
10422,initiéec,0,0,1,1
10421,القدرة,0,0,1,1
10420,sağ,0,0,1,1
10419,τυχαίνει,0,0,1,1
10418,பெற்றுக்,0,0,1,1
10417,المجتمع،,0,0,1,1
10416,jeanpierre,0,0,1,1
10415,anlat,0,0,1,1
10414,பெரிதாக,0,0,1,1
10561,اللذيذ,0,0,1,1
10562,beroepsschrijvers,0,0,1,1
10563,رحلتهم,0,0,1,1
10691,استوحت,0,0,1,1
10684,எல்லோருக்கும்,0,0,1,1
10685,карьере»,0,0,1,1
10686,بهذه,0,0,1,1
10687,الطبي,0,0,1,1
10689,editar»,0,0,1,1
10690,agência,0,0,1,1
5000,έχεις,0,0,1,1
10564,редакционную,0,0,1,1
10694,இருப்பதைக்,0,0,1,1
4999,reconstruction,0,0,1,1
10696,saborosa,0,0,1,1
4998,majeurs,0,0,1,1
10698,spiken,0,0,1,1
10699,sandım,0,0,1,1
10683,aşağıya,0,0,1,1
10682,प्रबल,0,0,1,1
10681,fundamentalt,0,0,1,1
5002,stürmisches,0,0,1,1
10678,aboutir,0,0,1,1
10677,تكتب,0,0,1,1
10676,χρειάζομαι,0,0,1,1
10675,radicalement,0,0,1,1
10674,வேலையுடன்,0,0,1,1
10673,drømmen,0,0,1,1
10672,нашем,0,0,1,1
10671,लिखित,0,0,1,1
10670,évolutif,0,0,1,1
10669,அழைப்பாளருக்கோ,0,0,1,1
10668,«wikipedistas»,0,0,1,1
10667,والمواقع,0,0,1,1
10665,isteğinde,0,0,1,1
10701,ഫലത്തിലെത്താൻ,0,0,1,1
10702,overal,0,0,1,1
10705,sostenida,0,0,1,1
10728,ಹೊರತುಪಡಿಸಿ,0,0,1,1
10749,episk,0,0,1,1
10748,программному,0,0,1,1
10747,"
फ़्रान्सीसी",0,0,1,1
10744,operava,0,0,1,1
10742,remanescentes,0,0,1,1
10740,परियोजनाएं,0,0,1,1
10738,atemberaubend,0,0,1,1
10737,osaklig,0,0,1,1
10736,olsa,0,0,1,1
10734,parentes,0,0,1,1
10733,leçon,0,0,1,1
10732,தயங்குகிறது,0,0,1,1
10731,plastic,0,0,1,1
10729,öğleden,0,0,1,1
10727,സത്യസന്ധമായി,0,0,1,1
10706,προσβολή,0,0,1,1
4994,المسجليين,0,0,1,1
10725,pseudovetenskap,0,0,1,1
10724,magtmisbrug,0,0,1,1
10723,மிகப்பெரும்,0,0,1,1
10721,främsta,0,0,1,1
10718,articulação,0,0,1,1
10714,suisseah,0,0,1,1
10713,umarım,0,0,1,1
10712,ಹೆಜ್ಜೆ,0,0,1,1
10711,« gauchiste » »,0,0,1,1
10710,വിഷമിപ്പിക്കരുതെന്ന്,0,0,1,1
10709,sende,0,0,1,1
10708,recomenda,0,0,1,1
10707,monde »,0,0,1,1
10664,αγγελιοφόρου,0,0,1,1
10663,πρώτος,0,0,1,1
10662,सेवाओ,0,0,1,1
10591,فيولا,0,0,1,1
10611,heleboel,0,0,1,1
10610,cohérence,0,0,1,1
10609,zurückkommen,0,0,1,1
10607,mécaniques,0,0,1,1
10604,கணிப்பதில்,0,0,1,1
10603,даниэлем,0,0,1,1
10600,سترى,0,0,1,1
10599,अन्तर्राष्ट्रीय,0,0,1,1
10598,essentia,0,0,1,1
10597,peña,0,0,1,1
10596,lived,0,0,1,1
10595,कीजिय,0,0,1,1
10593,εγγενείς,0,0,1,1
10592,temporary,0,0,1,1
10590,yazdıklarının,0,0,1,1
10615,сэнгера,0,0,1,1
10589,تكونا,0,0,1,1
5012,autres ,0,0,1,1
10584,неточными,0,0,1,1
10583,archipelagos,0,0,1,1
10578,repose,0,0,1,1
10577,вялыми,0,0,1,1
10576,бизнес,0,0,1,1
10573,—al,0,0,1,1
10572,distinctifs,0,0,1,1
10571,வேலைக்காரிகள்,0,0,1,1
10569,கலைக்களஞ்சியத்,0,0,1,1
5014,выражая,0,0,1,1
10567,empiriques,0,0,1,1
10565,एम्स्टरडाम,0,0,1,1
10612,amical,0,0,1,1
10616,titlen,0,0,1,1
10661,yıkayacağım,0,0,1,1
10638, года,0,0,1,1
10659,ശാസ്ത്രജ്ഞന്മാർ,0,0,1,1
5005,presidencial,0,0,1,1
10656,epostamda,0,0,1,1
5006,civility,0,0,1,1
10654,онлайнобращение,0,0,1,1
10653,ഗ്രന്ഥങ്ങളും,0,0,1,1
10652,الحيرة,0,0,1,1
10651,tust,0,0,1,1
10650,metoderna,0,0,1,1
10649,продвижения,0,0,1,1
10646,días,0,0,1,1
10645,മാനദണ്ഡങ്ങളെ,0,0,1,1
10644,समारोह,0,0,1,1
5007,limités,0,0,1,1
10637,atribuyen,0,0,1,1
5011,« robots »,0,0,1,1
5008,høje,0,0,1,1
10635,لطفاء,0,0,1,1
5009,forklare,0,0,1,1
5010,rasgos,0,0,1,1
10629,ನೆಡಲು,0,0,1,1
10628,செய்தார்கள்,0,0,1,1
10627,mathebuch,0,0,1,1
10626,إنسايدر,0,0,1,1
10625,നടക്കുന്നത്,0,0,1,1
10624,grootst,0,0,1,1
10623,gymnasieelever,0,0,1,1
10622,കേരള,0,0,1,1
10620,çiviyi,0,0,1,1
10619,أصول,0,0,1,1
11121,tegenovergestelde,0,0,1,1
11122,चिह्न,0,0,1,1
11123,lächeln,0,0,1,1
11667,besøge,0,0,1,1
11660,compensations,0,0,1,1
11662,macro,0,0,1,1
11663,टक्कर,0,0,1,1
11664,– million,0,0,1,1
11665,செய்யப்பட்டுள்ளன,0,0,1,1
11666,நர்சிசாவின்,0,0,1,1
11668,criminosas,0,0,1,1
11631,അതിശയിപ്പിച്ചു,0,0,1,1
11670,здравоохранении,0,0,1,1
11671,планет»,0,0,1,1
11672,—cuya,0,0,1,1
11673,compuesta,0,0,1,1
11674,скучно,0,0,1,1
11676,موسوعي,0,0,1,1
4871,« ne,0,0,1,1
11657,ചോദിക്കുമ്പോൾ,0,0,1,1
11656,discrepó,0,0,1,1
11655,conversar,0,0,1,1
11653,autrui,0,0,1,1
11651,établies,0,0,1,1
11650,വിക്കിയിലെ,0,0,1,1
11649,combined,0,0,1,1
4873,действие,0,0,1,1
11641,cultured,0,0,1,1
11640,पांच,0,0,1,1
11639,deelname,0,0,1,1
11638,übertreiben,0,0,1,1
11637,ettiğinizden,0,0,1,1
4875,والسؤال,0,0,1,1
11635,повысили,0,0,1,1
11633,gravitation,0,0,1,1
11677,meridional,0,0,1,1
11678,waardeer,0,0,1,1
11679,universellement,0,0,1,1
11712,apoiam,0,0,1,1
4865,flow,0,0,1,1
11729,frecuente,0,0,1,1
11727,partide,0,0,1,1
11726,ನಾಳೆಗಾಗಿ,0,0,1,1
11725,ಮಾಡಲ್ಪಟ್ಟನು,0,0,1,1
11724,لنا,0,0,1,1
11723,bulunmuştur,0,0,1,1
11720,"
malaio",0,0,1,1
4866,иметься,0,0,1,1
11717,architecture,0,0,1,1
11716,दर्शाता,0,0,1,1
11715,omitidas,0,0,1,1
11714,underhållande,0,0,1,1
11713,маленькие,0,0,1,1
11711,impossível,0,0,1,1
11683,പരസ്യപ്രചരണമോ,0,0,1,1
11708,телефоном,0,0,1,1
11706,fortune,0,0,1,1
11704,جذرية,0,0,1,1
11703,ತೆಗೆದುಕೊಳ್ಳಬೇಕೆಂದು,0,0,1,1
11702,برنامجا,0,0,1,1
4868,جامعيًا,0,0,1,1
11697,violant,0,0,1,1
11694,guarantee,0,0,1,1
11690,genişti,0,0,1,1
11689,brains,0,0,1,1
11688,بالعودة,0,0,1,1
11687,организацию»,0,0,1,1
11685,sueca,0,0,1,1
11684,galeries,0,0,1,1
11632,பேச்சுப்பக்கத்தைப்,0,0,1,1
4877,norwich,0,0,1,1
11529,ശൂന്യമായ,0,0,1,1
11569,τρομακτικά,0,0,1,1
11559,mulher,0,0,1,1
11560,sürekli,0,0,1,1
11561,wikipediaförfattarna,0,0,1,1
11565,திட்டமாக,0,0,1,1
11566,belirtmek,0,0,1,1
4887,obtuviste,0,0,1,1
4886,lekkere,0,0,1,1
11627,различна,0,0,1,1
11573,навсегда,0,0,1,1
11574,मानक,0,0,1,1
11576,रूचि,0,0,1,1
11577,contribution »,0,0,1,1
4885,básico,0,0,1,1
4884,അവധി,0,0,1,1
11557,dê,0,0,1,1
11556,ξεκινήσουμε,0,0,1,1
11555,البرمجية،,0,0,1,1
11554,sözcüğü,0,0,1,1
11552,ಸಂಗತಿಯಿದೆ,0,0,1,1
11550,séparable,0,0,1,1
11549,இரு,0,0,1,1
11548,blocked,0,0,1,1
4889,ഉപയോഗിക്കാനുള്ള,0,0,1,1
11545,falava,0,0,1,1
11542,أربكتك,0,0,1,1
11541,preparé,0,0,1,1
11537,informático,0,0,1,1
11536,الاقتباس,0,0,1,1
11534,proponía,0,0,1,1
11533,подойди,0,0,1,1
11532,"
malaiala",0,0,1,1
11580,mundiais,0,0,1,1
11581,overleden,0,0,1,1
11582,விதத்தில்,0,0,1,1
11606,أعضاء,0,0,1,1
11626,abla,0,0,1,1
11625,comêlo,0,0,1,1
11624,redigerat,0,0,1,1
4878,ஆச்சரியமாகக்,0,0,1,1
11622,afficher,0,0,1,1
11621,लोड,0,0,1,1
11620,listor,0,0,1,1
11619,التي،,0,0,1,1
11618,"
इमिलियाईरोमग्नोल",0,0,1,1
11617,anlattı,0,0,1,1
11616,johansson sv,0,0,1,1
11613,observadores,0,0,1,1
4879,eenvoudige,0,0,1,1
11609,correções,0,0,1,1
11604,الإداريون,0,0,1,1
11583,اقتباس,0,0,1,1
11603,fécond,0,0,1,1
11601,seriously,0,0,1,1
4881,olycklig,0,0,1,1
11599,kritiska,0,0,1,1
11598,teneinde,0,0,1,1
11596,руководствуются,0,0,1,1
11595,നേരിട്ടുള്ള,0,0,1,1
11593,neiging,0,0,1,1
11592,reformed,0,0,1,1
4883,γραμματική,0,0,1,1
11589,ей,0,0,1,1
11586,متجهة,0,0,1,1
11585,correos,0,0,1,1
11584,बड़ी,0,0,1,1
11733,högre,0,0,1,1
11734,arrive,0,0,1,1
11736,criterion,0,0,1,1
11867,marche,0,0,1,1
11858,wirtschaft,0,0,1,1
11859,पड़े,0,0,1,1
11860,تنوي,0,0,1,1
11863,cavaleiro,0,0,1,1
11864,aims,0,0,1,1
11865,ಹತ್ತಿದಳು,0,0,1,1
11868,almuerzo,0,0,1,1
11737,உள்ளுணர்வைக்,0,0,1,1
11871,ചതുപ്പുനിലമാക്കി,0,0,1,1
11872,ρουμπίνι,0,0,1,1
11873,ആരംഭിച്ചത്‌,0,0,1,1
11874,avbryter,0,0,1,1
11875,funcionalidad,0,0,1,1
11876,يفوق,0,0,1,1
11857,"
अस्तूरियाई",0,0,1,1
11856,ertrage,0,0,1,1
11854,drömde,0,0,1,1
11853,odasına,0,0,1,1
4847,opkijken,0,0,1,1
11850,tilbage,0,0,1,1
11849,എന്താണെന്ന്‌,0,0,1,1
4848,caducar,0,0,1,1
11847,pocas,0,0,1,1
11846,kutusuna,0,0,1,1
11845,reptiles,0,0,1,1
11843,veteranos,0,0,1,1
11842,visiteur,0,0,1,1
4849,diversified,0,0,1,1
4850,vrijwillige,0,0,1,1
11838,فريد,0,0,1,1
11837,mammalian,0,0,1,1
11877,processadas,0,0,1,1
11878,fellow,0,0,1,1
4846,rechtsboven,0,0,1,1
11902,المجال,0,0,1,1
11918,ലഭിക്കേണ്ടതാണ്,0,0,1,1
11917,afripédia,0,0,1,1
11916,இணையத்தொடர்பையும்,0,0,1,1
11915,bookstores,0,0,1,1
11913,знаменитости,0,0,1,1
11912,وتحصل,0,0,1,1
11911,измерения,0,0,1,1
11910,χαρούμενος,0,0,1,1
11908,su •,0,0,1,1
11907,describir,0,0,1,1
11906,işte,0,0,1,1
11905,ശക്തമായി,0,0,1,1
11904,ख़राब,0,0,1,1
11903,probabilístico,0,0,1,1
11899,ಮಗುವಿಗೆ,0,0,1,1
11881,சென்றார்கள்,0,0,1,1
11898,gratulera,0,0,1,1
4841,ಅಭ್ಯಾಸವನ್ನು,0,0,1,1
11896,drown,0,0,1,1
11894,μπριτάννικα,0,0,1,1
4842,മൂല്യം,0,0,1,1
11892,популярной,0,0,1,1
11891,لذلك؟,0,0,1,1
4844,einde,0,0,1,1
11888,displaced,0,0,1,1
11887,campos,0,0,1,1
11886,حاول,0,0,1,1
4845,மூழ்கிவிடுவார்கள்,0,0,1,1
11883,combine,0,0,1,1
11882,aufzupassen,0,0,1,1
11836,gabinete,0,0,1,1
11834,ಆಶ್ಚರ್ಯವಾದರೆ,0,0,1,1
4851,mühe,0,0,1,1
11761,protective,0,0,1,1
11778,ടെസ്റ്റിൽ‌,0,0,1,1
11777,ಗೊತ್ತಿಲ್ಲ,0,0,1,1
11776,anges,0,0,1,1
11775,эразма,0,0,1,1
11773,എഴുതപ്പെടുന്ന,0,0,1,1
11772,பராக்,0,0,1,1
11771,capacity,0,0,1,1
11770,संकलित,0,0,1,1
11769,aufhalten,0,0,1,1
11767,aseguraría,0,0,1,1
11766,ಕನ್ನಡಿಯಲ್ಲಿ,0,0,1,1
4860,பழைய,0,0,1,1
11764,‎wikipidia‏؛,0,0,1,1
4861,décennies,0,0,1,1
4862,göreceli,0,0,1,1
11782,kurallar,0,0,1,1
11759,telefonumu,0,0,1,1
11758,somente,0,0,1,1
4863,samkör,0,0,1,1
11755,principlenote,0,0,1,1
11752,incluían,0,0,1,1
11751,έξυπνων,0,0,1,1
4864,മോശമായിത്തീർന്നത്,0,0,1,1
11747,വന്ന്,0,0,1,1
11746,ಕಾರ್ಯನಿರತವಾಗಿದೆ,0,0,1,1
11744,negativos,0,0,1,1
11743,veelen,0,0,1,1
11741,ആയിരക്കണക്കിനു,0,0,1,1
11740,perspective,0,0,1,1
11739,kk •,0,0,1,1
11779,موثوقة،,0,0,1,1
11783,تمثيلا,0,0,1,1
11829,smuts,0,0,1,1
11805,இடத்தைக்,0,0,1,1
11828,ഉപയോക്താക്കളിൽ,0,0,1,1
4852,ಅದೃಷ್ಟವನ್ನು,0,0,1,1
11825,svmwikipediaorg,0,0,1,1
11824,artikelrekommendation,0,0,1,1
11822,« reconnaître,0,0,1,1
11821,zusammenhang,0,0,1,1
11820,الجميع,0,0,1,1
11817,ζητήσει,0,0,1,1
11815,включаемых,0,0,1,1
11814,விளக்கும்,0,0,1,1
4853,hobbes,0,0,1,1
11810,vandals,0,0,1,1
4854,delivered,0,0,1,1
4855,visites,0,0,1,1
11804,bedt,0,0,1,1
11784,criba,0,0,1,1
11803,إِلى,0,0,1,1
11802,கூடுவன,0,0,1,1
11801,ബിസിനസ്സ്,0,0,1,1
4856,abertas,0,0,1,1
11799,സാധിക്കണമെങ്കിൽ,0,0,1,1
11795,agradecerles,0,0,1,1
4857,germany,0,0,1,1
11793,compared,0,0,1,1
11792,ಅವರೊಂದಿಗೆ,0,0,1,1
11791,مجموع,0,0,1,1
11790,забывает,0,0,1,1
11789,executados,0,0,1,1
11788,landscape,0,0,1,1
11785,assuntos,0,0,1,1
11530,أبريل,0,0,1,1
11525,राजनीतिक,0,0,1,1
11124,sixthmostused,0,0,1,1
11270,"
माज़न्दारिनी",0,0,1,1
11262,വീട്ടിലെത്തിയപ്പോൾ,0,0,1,1
11263,справочником,0,0,1,1
11265,καλύπτει,0,0,1,1
11266,البيروقراطيون،,0,0,1,1
11267,sv •,0,0,1,1
11268,модные,0,0,1,1
11271,दौड़ी,0,0,1,1
11234,يكرر,0,0,1,1
11273,bob,0,0,1,1
11274,maden,0,0,1,1
11275,nourrir,0,0,1,1
11277,bilda,0,0,1,1
11278,softwares,0,0,1,1
11279,ತಲುಪಿದಾಗ,0,0,1,1
11261,associações,0,0,1,1
11260,ثقيلة,0,0,1,1
11259,fuertes,0,0,1,1
11258,erfarenhet,0,0,1,1
11256,പരിശീലിക്കാനുള്ള,0,0,1,1
4923,normalde,0,0,1,1
11254,содержащий,0,0,1,1
11253,महीने,0,0,1,1
11252,വിശേഷിപ്പിക്കുന്നുഅഭിപ്രായസ്വാതന്ത്ര്യം,0,0,1,1
11251,സംഭവിക്കാം,0,0,1,1
11250,ही।,0,0,1,1
11247,ಪ್ರಪಂಚದಾದ್ಯಂತ,0,0,1,1
11246,тюрьмах,0,0,1,1
11244,vandrare,0,0,1,1
11243,reconnaissant,0,0,1,1
4925,പോലെ,0,0,1,1
11237,خاص,0,0,1,1
11280,fermée,0,0,1,1
11281,felicitaciones,0,0,1,1
11282,vienen,0,0,1,1
11307,observandoa,0,0,1,1
11325,mitigate,0,0,1,1
4917,устаю,0,0,1,1
11320,യന്ത്രത്തിൻറെ,0,0,1,1
11319,ತಯಾರಿಸಲು,0,0,1,1
11318,своему,0,0,1,1
11317,prenumerera,0,0,1,1
11316,yiyecek,0,0,1,1
11315,meteors,0,0,1,1
11314,ദൈവത്തെപ്പോലെ,0,0,1,1
4918,وبنائها,0,0,1,1
11312,bretón,0,0,1,1
11311,высшим,0,0,1,1
4919,réglé,0,0,1,1
11308,अलाइक,0,0,1,1
11306,ನಿನ್ನೆ,0,0,1,1
11284,мае,0,0,1,1
11304,framförs,0,0,1,1
11302,इयर्स,0,0,1,1
11301,tårar,0,0,1,1
11299,voorzien,0,0,1,1
11297,исходным,0,0,1,1
11296,decirnos,0,0,1,1
11294,связывания,0,0,1,1
11292,meritsystemverktyg,0,0,1,1
11291,adverte,0,0,1,1
11290,delta,0,0,1,1
11289,tunisien,0,0,1,1
4920,ξεκίνησε,0,0,1,1
11287,transformée,0,0,1,1
11285,rağmen,0,0,1,1
11236,சொற்களைத்,0,0,1,1
4928,सलेक्शन,0,0,1,1
11524,wikcionario,0,0,1,1
11163,afi ˌwɪkiˈpiːdiə,0,0,1,1
11154,åtta,0,0,1,1
11157,"
lituano",0,0,1,1
11158,güisquipedia,0,0,1,1
11159,anlıyorum,0,0,1,1
11160,выяснила,0,0,1,1
11162,composta,0,0,1,1
11165,aceptación,0,0,1,1
11232,угрозами,0,0,1,1
11166,høflig,0,0,1,1
4943,occasionnée,0,0,1,1
4941,क्वाडि्ृगा,0,0,1,1
11171,vitesse,0,0,1,1
4940,udenfor,0,0,1,1
11174,reparere,0,0,1,1
11153,açıldı,0,0,1,1
11152,συντάκτες,0,0,1,1
4946,ടെസ്റ്റിലെ,0,0,1,1
11148,низкокачественные,0,0,1,1
11147,оптимизации,0,0,1,1
4948,thermally,0,0,1,1
11145,استعداد,0,0,1,1
11144,जताई।,0,0,1,1
11142,ഉപയോഗിച്ചുകൊണ്ട്,0,0,1,1
11141,datorer,0,0,1,1
11137,"
प्रत्येक",0,0,1,1
11136,tends,0,0,1,1
11132,വെച്ച്,0,0,1,1
11131,molecule,0,0,1,1
11129,ಹಂತವನ್ನು,0,0,1,1
11128,organisaties,0,0,1,1
11126,strunta,0,0,1,1
11176,phrased,0,0,1,1
4939,неточностей —,0,0,1,1
4938,οπτική,0,0,1,1
11211,nutshell,0,0,1,1
11231,enteros,0,0,1,1
11230,подписки,0,0,1,1
11228,"
याकूत",0,0,1,1
11225,стимулом англ,0,0,1,1
11224,condemns,0,0,1,1
4929,compromise,0,0,1,1
11222,такая,0,0,1,1
11221,tectoniques,0,0,1,1
11220,tekniske,0,0,1,1
11218,discussieforum,0,0,1,1
11216,demographic,0,0,1,1
4930,congress—the,0,0,1,1
11214,tercümelerine,0,0,1,1
11212,testen,0,0,1,1
11208,أستمر,0,0,1,1
11180,பங்களிப்பின்,0,0,1,1
11206,ère,0,0,1,1
11205,opendoor,0,0,1,1
11204,колокольчика,0,0,1,1
11203,licensen,0,0,1,1
11202,revolution,0,0,1,1
11200,fixés,0,0,1,1
4935,காண,0,0,1,1
11196,αποτυχίες,0,0,1,1
11195,prenais,0,0,1,1
11193,ആർതർ,0,0,1,1
11184,"
यिद्दी",0,0,1,1
11183,geldiğinizi,0,0,1,1
11182,émergente,0,0,1,1
11181,mobilisent,0,0,1,1
11326,रॉक,0,0,1,1
11327,ಪಂದ್ಯವನ್ನು,0,0,1,1
11328,латинские,0,0,1,1
11466,dutch,0,0,1,1
4899,contestée,0,0,1,1
11459,नंबर्स,0,0,1,1
4898,auffordert,0,0,1,1
11461,tropics,0,0,1,1
11462,granska,0,0,1,1
11463,asturies,0,0,1,1
11467,എഴുതാൻപോരുന്നവരാ‍യാൽ,0,0,1,1
11329,பங்களிப்புகளைப்,0,0,1,1
11468,düster,0,0,1,1
11470,உரையாடலின்,0,0,1,1
11471,fotografias,0,0,1,1
11472,compañeros,0,0,1,1
11473,ಪಕ್ಕದಲ್ಲಿರುವ,0,0,1,1
11474,മുന്നോട്ടുപോയില്ല,0,0,1,1
11457,"
ताजिक",0,0,1,1
11455,يضم,0,0,1,1
11451,حياديتها،,0,0,1,1
11450,regardait,0,0,1,1
11449,cnet,0,0,1,1
11448,dropping,0,0,1,1
11446,പ്രതിബിംബത്തിൽ,0,0,1,1
11444,visant,0,0,1,1
11443,означающей,0,0,1,1
11439,desordenado,0,0,1,1
11438,interrupting,0,0,1,1
11437,പരാമർശിക്കരുത്,0,0,1,1
11435,süslü,0,0,1,1
11433,değildir,0,0,1,1
11431,δημιουργικής,0,0,1,1
11428,excitant,0,0,1,1
11427,الجامعة,0,0,1,1
11475,சேனலான,0,0,1,1
11476,frappez,0,0,1,1
11477,голосов,0,0,1,1
11503,نشرت,0,0,1,1
11521,owing,0,0,1,1
11519,இவை,0,0,1,1
11518,infrequent,0,0,1,1
11517,जोर,0,0,1,1
4892,häftigt,0,0,1,1
11514,gymnasieexamen,0,0,1,1
11513,θαλασσωσα,0,0,1,1
11512,jihadistes,0,0,1,1
11511,communauté »,0,0,1,1
11510,tuyau,0,0,1,1
11509,lift,0,0,1,1
11508,erholt,0,0,1,1
11505,μέσω,0,0,1,1
11504,πνιγεί,0,0,1,1
11501,التفرد,0,0,1,1
4896,grundprinciper,0,0,1,1
11498,рунета,0,0,1,1
11497,sporters,0,0,1,1
11496,perjuicio,0,0,1,1
11495,لvice,0,0,1,1
4894,recherche ,0,0,1,1
11493,taşlarından,0,0,1,1
11490,"
servocroata",0,0,1,1
11489,gebruikmaakte,0,0,1,1
11488,inclusionismo,0,0,1,1
11487,"
स्लोवाक",0,0,1,1
11484,thousand,0,0,1,1
11482,γλυκό,0,0,1,1
11481,troops,0,0,1,1
11480,विकिसोर्स,0,0,1,1
4903,almacén,0,0,1,1
11425,tids,0,0,1,1
4904,ലിപിയിൽ,0,0,1,1
11355,configurations,0,0,1,1
11374,opgezet,0,0,1,1
11373,ढांचा,0,0,1,1
11372,वार्षिक,0,0,1,1
11370,തങ്ങൾക്ക്,0,0,1,1
11369,inscrits,0,0,1,1
11367,bezighoudt,0,0,1,1
11366,fantastik,0,0,1,1
11363,aufgeregt,0,0,1,1
11362,pantalla,0,0,1,1
11361,finalité,0,0,1,1
11360,الأوساخ,0,0,1,1
4913,ಆವರಿಸಬಹುದೇ,0,0,1,1
11357,جزء,0,0,1,1
11356,بالملابس,0,0,1,1
11353,varnande,0,0,1,1
11377,trust,0,0,1,1
11349,تغرق,0,0,1,1
11348,exclusivement,0,0,1,1
11347,ಎನರ್ಜಿ,0,0,1,1
11345,gustado,0,0,1,1
11344,inédite,0,0,1,1
11343,pudiendo,0,0,1,1
11342,സൂക്ഷ്മത,0,0,1,1
11340,exemplifierar,0,0,1,1
11339,folkrepubliken,0,0,1,1
11338,personligt,0,0,1,1
11337,अन्यभाषाओं,0,0,1,1
11336,сайта —,0,0,1,1
11332,वस्तुओं,0,0,1,1
11330,conservador,0,0,1,1
11375,വ്യവസ്ഥിതികളുടെയും,0,0,1,1
4912,kommunistiska,0,0,1,1
11422,തമ്മിലുള്ള,0,0,1,1
11403,signing,0,0,1,1
11421,أوائل,0,0,1,1
11420,ಸಂಖ್ಯೆಯನ್ನು,0,0,1,1
11418,åkturen,0,0,1,1
11417,samband,0,0,1,1
11416,sunduğu,0,0,1,1
11414,sq •,0,0,1,1
11413,المشاريع,0,0,1,1
11412,forsinkelse,0,0,1,1
4905,culturelles ,0,0,1,1
11410,японскими,0,0,1,1
11409,tembel,0,0,1,1
11407,κωδικό,0,0,1,1
11405,تحطمت,0,0,1,1
11404,necesidades,0,0,1,1
11402,donnezlui,0,0,1,1
11379,blik,0,0,1,1
11401,സ്വാഭാവികമായി,0,0,1,1
11400,இருக்கின்றன,0,0,1,1
11399,வழிகளைத்,0,0,1,1
4907,المنطقي,0,0,1,1
11395,தலைமை,0,0,1,1
11393,தொடருங்கள்,0,0,1,1
4908,അതൊട്ട്‌,0,0,1,1
11391,reemplazo,0,0,1,1
11390,повторите,0,0,1,1
11389,житомирской,0,0,1,1
11388,நைட்,0,0,1,1
11386,गाने,0,0,1,1
11381,നൽകുന്നു,0,0,1,1
4911,സുഹൃത്തുക്കളും,0,0,1,1
5033,अचंभित,0,0,1,1
5035,değmediğini,0,0,1,1
8754,لكنك,0,0,1,1
9289,courants,0,0,1,1
9279,whereby,0,0,1,1
9280,incorporation,0,0,1,1
9283,αποδέχομαι,0,0,1,1
9284,svagt,0,0,1,1
9285,cbn,0,0,1,1
9286,വ്യവസ്ഥിതിയാണ്,0,0,1,1
9290,sorrindo,0,0,1,1
5164,казались,0,0,1,1
9291,pertenecientes,0,0,1,1
9292,ödül,0,0,1,1
9293,næse,0,0,1,1
9295,അൽഗോരിതങ്ങൾ,0,0,1,1
9297,столь,0,0,1,1
9300,വീഡിയോയുടെ,0,0,1,1
9278,krävas,0,0,1,1
9276,ഇന്റർനെറ്റിലും,0,0,1,1
5161,bernard,0,0,1,1
9273,جالسة,0,0,1,1
9272,μπερδέψεις,0,0,1,1
9271,gesloten,0,0,1,1
9270,തിരുത്തുന്നു,0,0,1,1
9269,verifiable,0,0,1,1
9268,இயக்கத்துக்கு,0,0,1,1
9265,nisan,0,0,1,1
9264,manuais,0,0,1,1
5162,utilisées,0,0,1,1
9262,accordant,0,0,1,1
9261,ukrainian,0,0,1,1
5163,tarihinde,0,0,1,1
9256,تهمه,0,0,1,1
9255,الآيس,0,0,1,1
9301,webpagina,0,0,1,1
9302,وgerman،,0,0,1,1
9303,independente,0,0,1,1
5159,rubin,0,0,1,1
9353,adivinhado,0,0,1,1
9349,encantadora,0,0,1,1
9347,एनलाइटएनमेंट,0,0,1,1
9345,yolculuk,0,0,1,1
9341,classificados,0,0,1,1
5152,thematic,0,0,1,1
5153,തീരുമാനമാണ്,0,0,1,1
9337,financiación,0,0,1,1
5156,moeilijk,0,0,1,1
9334,ಪ್ರವಾಸಿಗನು,0,0,1,1
9333,schlaf,0,0,1,1
9330,واجب,0,0,1,1
9329,nominated,0,0,1,1
5157,basée,0,0,1,1
9323,குறைவாகக்,0,0,1,1
9304,législationsu,0,0,1,1
9322,उर्दू,0,0,1,1
9321,användarnamn,0,0,1,1
9320,skat,0,0,1,1
9319,ബാങ്കിനോട്,0,0,1,1
9318,सीमित,0,0,1,1
9317,blijven,0,0,1,1
9316,burayı,0,0,1,1
9315,hébergent,0,0,1,1
9312,discutiu,0,0,1,1
9310,salud,0,0,1,1
9309,conscientious,0,0,1,1
5160,riktlinjerna,0,0,1,1
9306,dynamics,0,0,1,1
9305,beschikbare,0,0,1,1
9254,подъехала,0,0,1,1
9251,ursprünge,0,0,1,1
9355,تتعلق,0,0,1,1
5171,olmana,0,0,1,1
9188,hierover,0,0,1,1
9189,—se,0,0,1,1
9190,almam,0,0,1,1
9191,ξεφλουδίστηκε,0,0,1,1
9192,bardak,0,0,1,1
9193,одинединственный,0,0,1,1
9197,написанное,0,0,1,1
9250,புளூமாக்ஸாக,0,0,1,1
9198,acadêmico,0,0,1,1
9199,جديد,0,0,1,1
9200,சேர்க்கப்பட்டதும்,0,0,1,1
9203,питтсбургского,0,0,1,1
9205,ಸವಾರಿಯ,0,0,1,1
9206,struktur,0,0,1,1
9187,специальных,0,0,1,1
9186,participative »,0,0,1,1
9184,മറുപടി,0,0,1,1
5172,रेटिंग,0,0,1,1
9182,uncovered,0,0,1,1
9181,صحتها،,0,0,1,1
9180,கொண்டிருந்தார்கள்,0,0,1,1
9179,denying,0,0,1,1
9178,الفظيعة,0,0,1,1
9177,ഏതു,0,0,1,1
9174,يتمكن,0,0,1,1
9173,ulykkelig,0,0,1,1
9172,questionada,0,0,1,1
9170,تسميتها,0,0,1,1
9169,പെടുന്ന,0,0,1,1
9168,തെറ്റിദ്ധരിച്ചതായി,0,0,1,1
9166,फ्रेंको,0,0,1,1
9207,ejemplo—,0,0,1,1
9208,vulgariser,0,0,1,1
9210,subkultur,0,0,1,1
9230,energetic,0,0,1,1
9249,எளிமையான,0,0,1,1
9248,opbeuren,0,0,1,1
5165,territoires,0,0,1,1
9242,शिक्षक,0,0,1,1
9241,hundreds,0,0,1,1
9240,raciste,0,0,1,1
9238,шварцем,0,0,1,1
5168,وما,0,0,1,1
5169,excluded,0,0,1,1
9235,permitirse,0,0,1,1
9234,recognition‏،,0,0,1,1
9233,جودة,0,0,1,1
9232,प्रवक्ता,0,0,1,1
9231,citadas,0,0,1,1
9229,научного,0,0,1,1
9211,hizmetlileri,0,0,1,1
9228,belge,0,0,1,1
9227,അറിവുള്ള,0,0,1,1
9226,путешествий,0,0,1,1
9225,analyseren,0,0,1,1
9223,telaşa,0,0,1,1
9222,commis,0,0,1,1
9221,märkbart,0,0,1,1
9220,supérieures,0,0,1,1
9219,êtesvous,0,0,1,1
5170,விரும்புவீர்கள்,0,0,1,1
9217,danois,0,0,1,1
9214,prinses,0,0,1,1
9213,medier,0,0,1,1
9212,punt,0,0,1,1
9354,decentralizing,0,0,1,1
9356,períodos,0,0,1,1
10359,verständnisvoller,0,0,1,1
5138,—tras,0,0,1,1
9492,ಉದಾಹರಣೆಗಳಂತೆ,0,0,1,1
5139,sinemaya,0,0,1,1
9496,ders,0,0,1,1
9497,चित्र,0,0,1,1
9498,ಇಮೇಲ್‌ನಲ್ಲಿ,0,0,1,1
9499,havlu,0,0,1,1
5136,frem,0,0,1,1
9461,elaborado,0,0,1,1
9505,difamálos,0,0,1,1
9506,உதாரணமாகச்,0,0,1,1
9508,públicos—,0,0,1,1
5135,இருக்கவும்,0,0,1,1
9512,χρονικό,0,0,1,1
5134,старому,0,0,1,1
9491,sunulması,0,0,1,1
9490,imiter,0,0,1,1
9489,بأوسمة,0,0,1,1
9488,സ്പീക്കറുകൾ,0,0,1,1
9484,описано,0,0,1,1
9483,snabb,0,0,1,1
9482,dirigeerden,0,0,1,1
9481,وشرح,0,0,1,1
9480,beskrivelsesboksen,0,0,1,1
9478,точку,0,0,1,1
9476,“death,0,0,1,1
9475,cumpliesen,0,0,1,1
9474,കാണിച്ചു,0,0,1,1
9471,அவருக்கு,0,0,1,1
5143,monument,0,0,1,1
9464,बायोलोजी,0,0,1,1
9463,samarbetar,0,0,1,1
9516,causaba,0,0,1,1
9519,συνέντευξη,0,0,1,1
9520,മിനിറ്റുകൾക്കുള്ളിൽ,0,0,1,1
9545,चलाया,0,0,1,1
9564,பிரமிக்க,0,0,1,1
9563,manifestant,0,0,1,1
9562,ووالدتها,0,0,1,1
9560,—cuando,0,0,1,1
9559,collecté,0,0,1,1
9556,allgemeinen,0,0,1,1
5129,التاريخ,0,0,1,1
9553,vidunderligt,0,0,1,1
9552,पहने,0,0,1,1
9551,lineales,0,0,1,1
9550,archean,0,0,1,1
9548,десяти,0,0,1,1
9547,saberia,0,0,1,1
9546,etiquetas,0,0,1,1
5130,nås,0,0,1,1
9522,redirecionar,0,0,1,1
9542,തോന്നണമെങ്കിൽ,0,0,1,1
9541,построить,0,0,1,1
9539,тонуть,0,0,1,1
9538,വസ്തുക്കളെ,0,0,1,1
9536,erbij,0,0,1,1
9534,eons,0,0,1,1
9532,процент,0,0,1,1
9531,يحتوي,0,0,1,1
9528,stabilizes,0,0,1,1
9527,affectations,0,0,1,1
9526, mo,0,0,1,1
9525,விளம்பரங்களைக்,0,0,1,1
9524,أنتما,0,0,1,1
9523,stødende,0,0,1,1
9462,kritiker,0,0,1,1
9460,protracted,0,0,1,1
9357,renseignement,0,0,1,1
9390,fa •,0,0,1,1
9381,diariamente,0,0,1,1
9382,гарантирует,0,0,1,1
9385,mythologies,0,0,1,1
9386,ödevlerle,0,0,1,1
9387,എത്തിച്ചേരേണ്ട,0,0,1,1
9388,välmodig,0,0,1,1
9391,okuldan,0,0,1,1
9459,يجعلها,0,0,1,1
9393,activation,0,0,1,1
5150,invalidado,0,0,1,1
9397,frontpage,0,0,1,1
9398,reparos,0,0,1,1
9399,ഡാറ്റാ,0,0,1,1
9401,an ,0,0,1,1
9380,माध्यमिक,0,0,1,1
9379,പോർട്ടൽ,0,0,1,1
9377,denis,0,0,1,1
9376,"
आर्मिनियाई",0,0,1,1
9375,marianne,0,0,1,1
9372,„википедию“»,0,0,1,1
9371,siderian,0,0,1,1
9370,работах,0,0,1,1
9369,doktoranders,0,0,1,1
9368,planétaires,0,0,1,1
9366,سر,0,0,1,1
9365,некорректным,0,0,1,1
9363,производстве,0,0,1,1
9362,conservé,0,0,1,1
9361,casuais,0,0,1,1
9360,स्टैनफोर्ड,0,0,1,1
9359,मिश्रित,0,0,1,1
9402,routière,0,0,1,1
9404,தடுக்கவும்,0,0,1,1
5149,convoluted,0,0,1,1
9435,bilindiğinden,0,0,1,1
9456,versus,0,0,1,1
9455,augustin,0,0,1,1
9453,വ്യാപകമായി,0,0,1,1
9451,hilsner,0,0,1,1
9450,prevented,0,0,1,1
9448,« bonnes »,0,0,1,1
9447,programspråket,0,0,1,1
9446,είτε,0,0,1,1
9444,ಹೆಂಡತಿಯಾಗಿರಬೇಕು,0,0,1,1
9441,остального,0,0,1,1
5144,μιλήσουμε,0,0,1,1
5145,çocuğa,0,0,1,1
9437,trataste,0,0,1,1
9436,menselijke,0,0,1,1
5146,apropiado,0,0,1,1
9406,gorilas,0,0,1,1
9433,weekendontdekking,0,0,1,1
9432,kullanarak,0,0,1,1
9427,ಅರ್ಥವೇನೆಂದು,0,0,1,1
9426,улучшайте,0,0,1,1
9425,ημιτελής,0,0,1,1
9424,вирджилом,0,0,1,1
9423,boende,0,0,1,1
9422,chansons,0,0,1,1
9421,émilie,0,0,1,1
5148,رأيين,0,0,1,1
9415,mapping,0,0,1,1
9411,inrikesdepartementets,0,0,1,1
9409,ansiklopedilerindeki,0,0,1,1
9408,geologic,0,0,1,1
5175,videodaki,0,0,1,1
5176,ജോലിയും,0,0,1,1
9161,സൂപ്പിലോ,0,0,1,1
5222,ostenten,0,0,1,1
5223,concluíram,0,0,1,1
8877,mapean,0,0,1,1
8878,finger,0,0,1,1
8879,ലേർണിങ്machine,0,0,1,1
8880,sabırla,0,0,1,1
8882,énervé,0,0,1,1
8884,இதுபோன்ற,0,0,1,1
8845,പ്രശസ്തമായ,0,0,1,1
8885,έμαθα,0,0,1,1
8886,بمقياس,0,0,1,1
8889,ansiklopediler,0,0,1,1
8893,ζητήσετε,0,0,1,1
8894,acredito,0,0,1,1
8895,règle,0,0,1,1
8875,терпеливо,0,0,1,1
8870,push,0,0,1,1
8869,länders,0,0,1,1
8867,traducciones,0,0,1,1
8866,múltiplos,0,0,1,1
8865,crossvalidation,0,0,1,1
5225,تجري,0,0,1,1
8861,സ്ഥാപിതമായതും,0,0,1,1
8859,قبول,0,0,1,1
8858,இற்றைப்படுத்தப்படும்,0,0,1,1
8856,развитии,0,0,1,1
8855,википедией —,0,0,1,1
8854,espuria,0,0,1,1
8853,ickevinstinriktade,0,0,1,1
8852,sink,0,0,1,1
8850,återgavs,0,0,1,1
5226,नियमों,0,0,1,1
8896,несвободные,0,0,1,1
5221,мысль,0,0,1,1
8902,tanımlamaktadır,0,0,1,1
8926,أنف,0,0,1,1
8946,सहसंस्थापक,0,0,1,1
8945,izleme,0,0,1,1
8943,leyó,0,0,1,1
8942,karısı,0,0,1,1
8941,censuráveis,0,0,1,1
8938,suscribirse,0,0,1,1
8937,annotated,0,0,1,1
8936,друзьям,0,0,1,1
8934,ratios,0,0,1,1
8932,prouver,0,0,1,1
8931,amerikaanse,0,0,1,1
8930,assuming,0,0,1,1
8929,geçtiğini,0,0,1,1
8928,almorzar,0,0,1,1
8925,കോളിൽ,0,0,1,1
8903,rijk,0,0,1,1
5215,tic,0,0,1,1
8921,هاواي,0,0,1,1
8920,وغيرت,0,0,1,1
8919,बनाम,0,0,1,1
8918,olduğun,0,0,1,1
8917,separar,0,0,1,1
8916,ಅರಮನೆಯಲ್ಲಿ,0,0,1,1
8914,फेडरल,0,0,1,1
5218,സംസാരിക്കുന്നത്,0,0,1,1
5220,مرعوب,0,0,1,1
8909,хватает,0,0,1,1
8906,возможны,0,0,1,1
8905,alpha,0,0,1,1
8904,приписывается,0,0,1,1
8846,ಟೈಪ್,0,0,1,1
8843,extrasolar,0,0,1,1
9160,fungere,0,0,1,1
8783,tedavi,0,0,1,1
5234,hawaïen,0,0,1,1
8776,exigindo,0,0,1,1
8778,തളർന്നില്ലെന്ന്,0,0,1,1
5233,bakıyordu,0,0,1,1
8780,genotipo,0,0,1,1
5232,السهل,0,0,1,1
8784,بنصيب,0,0,1,1
8842,conduits,0,0,1,1
8785,ഒറ്റ,0,0,1,1
8786,betydelsen,0,0,1,1
8787,العلوي,0,0,1,1
8788,ബാങ്കിങ്,0,0,1,1
8789,catedral,0,0,1,1
8790,свободным,0,0,1,1
8774,complementos,0,0,1,1
5235,صموئيل،,0,0,1,1
8771,воздействию,0,0,1,1
8770,اقتراحك,0,0,1,1
8768,rusa,0,0,1,1
8767,बोलियों,0,0,1,1
8766,éviter,0,0,1,1
8765,شريحة,0,0,1,1
8764,besuchen,0,0,1,1
8763,γνωστή,0,0,1,1
8762,emeğiniz,0,0,1,1
8761,sentado,0,0,1,1
8760,lekkerste,0,0,1,1
8759,regelbundna,0,0,1,1
8757,uyandım,0,0,1,1
8756,measurement,0,0,1,1
8755,africans,0,0,1,1
8792,вопросами,0,0,1,1
8794,വരുന്ന,0,0,1,1
8796,вошёл,0,0,1,1
8820,atelle,0,0,1,1
8839,विकटियोनरी,0,0,1,1
8838,неэкспертами,0,0,1,1
8837,धैर्य,0,0,1,1
8836,annenin,0,0,1,1
8835,desarrollados,0,0,1,1
8834,inclusion,0,0,1,1
8833,överflödigt,0,0,1,1
8832,inédites,0,0,1,1
8831,இவற்றுள்,0,0,1,1
8830,urban,0,0,1,1
8829,ಎರಡನೆಯ,0,0,1,1
8828,vocation,0,0,1,1
8823,anmodninger,0,0,1,1
8822,gemenskapen,0,0,1,1
8819,propôs,0,0,1,1
8800,transmitiu,0,0,1,1
8817,établit,0,0,1,1
8815,kurulmuştur,0,0,1,1
8814,ಪ್ರತಿಯೊಬ್ಬರೂ,0,0,1,1
8813,musea,0,0,1,1
8812,tomó,0,0,1,1
8811,വേണമെങ്കിൽ,0,0,1,1
8810,politicamente,0,0,1,1
8809,ringa,0,0,1,1
8808,"economics ·
environmental",0,0,1,1
8806,tremendos,0,0,1,1
8804,upphovsrättsbrott,0,0,1,1
8803,zusterproject,0,0,1,1
8802,مساعدتي,0,0,1,1
8801,учётных,0,0,1,1
8950,നിർജീവമാണ്,0,0,1,1
8953,gibt,0,0,1,1
8954,edip,0,0,1,1
9089,hebrea—,0,0,1,1
9080,kvinna,0,0,1,1
9083,ಹೋಗುತ್ತೇವೆ,0,0,1,1
9084,supermarkets,0,0,1,1
9085,ചൈനീസ്,0,0,1,1
9086,علامة,0,0,1,1
9087,உதவியாக,0,0,1,1
9090,dispostos,0,0,1,1
5210,television—how,0,0,1,1
9091,χαμόγελα,0,0,1,1
9094,brandväggen,0,0,1,1
9096,"
सैटरलैण्ड",0,0,1,1
9097,имеющейся,0,0,1,1
9098,പോകുകയാണെങ്കിൽ,0,0,1,1
5183,coreia,0,0,1,1
9077,uitgebalanceerde,0,0,1,1
5185,kamu,0,0,1,1
9075,نيوبيديا،,0,0,1,1
9074,நுபீடியாவானது,0,0,1,1
9073,deneyim,0,0,1,1
9072,كجزء,0,0,1,1
9069,financieele,0,0,1,1
9068,modales,0,0,1,1
9067,അളവിലുള്ള,0,0,1,1
5187,избранные,0,0,1,1
9064,alın,0,0,1,1
9063,kurallarından,0,0,1,1
5188,veda,0,0,1,1
9058,şeyleri,0,0,1,1
9056,returns,0,0,1,1
5190,« tapez,0,0,1,1
9052,ഉച്ചരിക്കുകയാണെന്ന്,0,0,1,1
9101,vogel,0,0,1,1
5182,melhoram,0,0,1,1
9108,tirou,0,0,1,1
9139,بالعربية,0,0,1,1
9159,vestimentaire,0,0,1,1
9158,gérant,0,0,1,1
9156,excluílas,0,0,1,1
9155,الخادمات,0,0,1,1
9154,actualización,0,0,1,1
9153,reilly,0,0,1,1
9152,rendimiento,0,0,1,1
9151,முரண்பாடு,0,0,1,1
9150,werkwoordsvorm,0,0,1,1
9149,ηχείο,0,0,1,1
9147,தெரிவித்தது,0,0,1,1
9146,ಅಭಿಪ್ರಾಯವೇನು,0,0,1,1
9144,пароль,0,0,1,1
9143,sammanslagning,0,0,1,1
9138,ejaculação,0,0,1,1
9110,stewards,0,0,1,1
9137,പ്രശ്നത്തേക്കാൾ,0,0,1,1
9134,approuvés,0,0,1,1
9132,മാണിക്യത്തിന്റെ,0,0,1,1
9131,unterricht,0,0,1,1
9127,ما،,0,0,1,1
9126,सीख,0,0,1,1
9122,squares,0,0,1,1
9121,allvarligt,0,0,1,1
9120,ضخم,0,0,1,1
9118,introduire,0,0,1,1
5181,operates,0,0,1,1
9115,функционал,0,0,1,1
9113,stratégiquement,0,0,1,1
9112,русском,0,0,1,1
5191,textbased,0,0,1,1
9049,asian,0,0,1,1
9048,farkında,0,0,1,1
8979,qualité ,0,0,1,1
9005,faltas,0,0,1,1
9003,dönüştürme,0,0,1,1
9002,sujeira,0,0,1,1
8998,incluyen,0,0,1,1
8997,ക്രിക്കറ്റ്,0,0,1,1
8994,"
baixo",0,0,1,1
8993,omitiendo,0,0,1,1
8992,развития»,0,0,1,1
8991,"
डैनिश",0,0,1,1
8990,предпочтения,0,0,1,1
8988,пределами,0,0,1,1
5206,doméstico,0,0,1,1
8986,katkıların,0,0,1,1
8981,ಸಂತೋಷವಾಗಿದ್ದೇನೆ,0,0,1,1
8978,تستخدم,0,0,1,1
9008,ಅವ್ಯವಸ್ಥೆಯಲ್ಲಿದ್ದೇನೆ,0,0,1,1
8977,tillgängligt,0,0,1,1
5209,démissionne,0,0,1,1
8975,രീതിയിലേക്ക്,0,0,1,1
8971,viajaban,0,0,1,1
8970,bağımsızdır,0,0,1,1
8967,supprimée,0,0,1,1
8966,تفسرها,0,0,1,1
8965,fiquei,0,0,1,1
8963,geçmişinde,0,0,1,1
8962,uppsatsens,0,0,1,1
8961,القيمة,0,0,1,1
8960,işiniz,0,0,1,1
8959,utgivaren,0,0,1,1
8958,botanists,0,0,1,1
9007,framsteg,0,0,1,1
9009,yönergesi,0,0,1,1
9046,κινείται,0,0,1,1
5198,çevrimiçi,0,0,1,1
5192,τρώω,0,0,1,1
9044,semestre,0,0,1,1
9043,« quelle,0,0,1,1
9042,besökares,0,0,1,1
5193,perda,0,0,1,1
9037,compararam,0,0,1,1
9036,έθιμα,0,0,1,1
5195,सशक्त,0,0,1,1
9033,mencionan,0,0,1,1
9032,വിജ്ഞാനതൃഷ്ണയും,0,0,1,1
9031,सलाद,0,0,1,1
5197,объёму,0,0,1,1
9029,apaixonadamente,0,0,1,1
9028,സൃഷ്ടിച്ച്,0,0,1,1
5199,tartışmalı,0,0,1,1
9010,உள்ளடக்கங்களையும்,0,0,1,1
9024,metodudur,0,0,1,1
9023,дисперсией,0,0,1,1
9022,பெரியதும்,0,0,1,1
9021,большим,0,0,1,1
5200,مذهلاً,0,0,1,1
5201,klokkeikonet,0,0,1,1
9018,yazarlarından,0,0,1,1
9017,proppen,0,0,1,1
9016,tillämpliga,0,0,1,1
5202,προφέρετε,0,0,1,1
9014,haarlem,0,0,1,1
5203,nyttigt,0,0,1,1
9012,ஆசிரியராகப்,0,0,1,1
9011,ஒன்றாகும்,0,0,1,1
5128,വിലകൾക്ക്,0,0,1,1
9567,സ്വർണ്ണം,0,0,1,1
9568,etmesini,0,0,1,1
10096,खरीदना,0,0,1,1
10089,انخفضت,0,0,1,1
10090,mixed,0,0,1,1
10091,செய்முறைப்படி,0,0,1,1
10092,exitosa,0,0,1,1
5055,право,0,0,1,1
10094,கேட்கிறார்கள்,0,0,1,1
5054,functional,0,0,1,1
10067,espejo,0,0,1,1
10098,получилось,0,0,1,1
10099,kfoldcrossvalidation,0,0,1,1
10100,दुबारा,0,0,1,1
10101,देखकर,0,0,1,1
10102,конфигурация,0,0,1,1
10104,முடிவிலும்,0,0,1,1
10088,magiques,0,0,1,1
10087,истина»,0,0,1,1
10086,استفهام,0,0,1,1
10085,подпадает,0,0,1,1
10084,conjectured,0,0,1,1
10083,équilibrer,0,0,1,1
10082,നേതാക്കന്മാരുടെ,0,0,1,1
5056,statesman,0,0,1,1
10079,iyisin,0,0,1,1
10078,bedøvet,0,0,1,1
10076,запрашиваемых,0,0,1,1
10075,миру,0,0,1,1
10074,trampar,0,0,1,1
10073,பயன்படுத்துவதன்,0,0,1,1
10072,desktops,0,0,1,1
10070,одну,0,0,1,1
10069,religions,0,0,1,1
10106,joplin,0,0,1,1
10107,autorité,0,0,1,1
10108,methodology,0,0,1,1
10140,ловушки,0,0,1,1
10161,tagit,0,0,1,1
10158,திருத்தல்,0,0,1,1
10157,varsågod,0,0,1,1
10155,mentionnent,0,0,1,1
5051,concepten,0,0,1,1
10152,خلالها,0,0,1,1
10151,augmenter,0,0,1,1
10150,இற்றைப்படுத்தப்படுவதேயாகும்,0,0,1,1
10147,révisions,0,0,1,1
10146,विनम्रता,0,0,1,1
10145,ήχο,0,0,1,1
10144,aftes,0,0,1,1
10142,reddit,0,0,1,1
10141,போன்றன,0,0,1,1
10139,beweisen,0,0,1,1
5053,polysémique,0,0,1,1
10138,ayaklarımı,0,0,1,1
10137,гипотетическую,0,0,1,1
10134,δικιο,0,0,1,1
10133,förrän,0,0,1,1
10132,differ,0,0,1,1
10131,فاندربيلت،,0,0,1,1
10129,ثقافة,0,0,1,1
10127,reacts,0,0,1,1
10124,libresoft,0,0,1,1
10123,драгоценными,0,0,1,1
10120,alcanzase,0,0,1,1
10118,naturae,0,0,1,1
10117,ಅಮ್ಮನಾಗಿ,0,0,1,1
10111,comunistas,0,0,1,1
5058,любимым,0,0,1,1
10066,dotée,0,0,1,1
9966,ورفع,0,0,1,1
10003,beweringen,0,0,1,1
9997,vilseledande,0,0,1,1
9998,zugeritten,0,0,1,1
9999,customarily,0,0,1,1
10000,​​wat,0,0,1,1
10001,ചോദ്യചിഹ്നത്തിലൂടെയും,0,0,1,1
10002,формы,0,0,1,1
10004,bandet,0,0,1,1
10064,estratégia,0,0,1,1
10005,incômodo,0,0,1,1
10006,σταμάτησε,0,0,1,1
10007,owned,0,0,1,1
10008,lagar,0,0,1,1
5068,भागीदार,0,0,1,1
10010,பாதுகாக்கப்படுகின்றன,0,0,1,1
5069,δώστε,0,0,1,1
9989,сотрудничеству,0,0,1,1
9985,والمساهمين,0,0,1,1
9984,telefonsamtal,0,0,1,1
9982,नौकरानियों।,0,0,1,1
5071,يستحوذ,0,0,1,1
9980,целом,0,0,1,1
5072,creerlo,0,0,1,1
9978,deskundigen,0,0,1,1
9977,producto,0,0,1,1
9976,aprendendo,0,0,1,1
9975,wondering,0,0,1,1
9974,motstridiga,0,0,1,1
9973,победил,0,0,1,1
9972,இல்லாமலேயே,0,0,1,1
9970,عامية,0,0,1,1
9968,ಪ್ರಸಿದ್ಧ,0,0,1,1
5067,gilla,0,0,1,1
10014,habitées,0,0,1,1
5066,«офис»,0,0,1,1
10036,meilleurs,0,0,1,1
10062,ஏனைய,0,0,1,1
10061,دون,0,0,1,1
10060,sounds,0,0,1,1
5059,landsby,0,0,1,1
10055,நர்சிசாவைப்,0,0,1,1
10050,нагрузку,0,0,1,1
5060,репутацией,0,0,1,1
10045,gives,0,0,1,1
10043,generando,0,0,1,1
10042,கிகில்ஸ்,0,0,1,1
10041,ஆங்கிலப்,0,0,1,1
5063,दिनप्रतिदिन,0,0,1,1
10039,antag,0,0,1,1
10038,uğraşısı,0,0,1,1
10035,классифицировать,0,0,1,1
10018,attendre,0,0,1,1
10034,பிழைத்திருத்தத்திற்கு,0,0,1,1
10033,உருளைக்கிழங்கை,0,0,1,1
10032,kvartalet,0,0,1,1
10031,பெல்,0,0,1,1
10029,शेयर,0,0,1,1
10028,gentileza,0,0,1,1
10026,laboral,0,0,1,1
10025,dejar,0,0,1,1
10024,trip,0,0,1,1
10023,anciens,0,0,1,1
10022,ಹೊಳೆಯುವ,0,0,1,1
5064,продвижении,0,0,1,1
10020,tiempo—,0,0,1,1
5065,ഗുണമേന്മയ്ക്കു,0,0,1,1
10164,sustainable,0,0,1,1
10166,குறிப்பிடப்படுகிறது,0,0,1,1
10167,zweimal,0,0,1,1
10298,spared,0,0,1,1
10290,ameliorate,0,0,1,1
10292,fourthlargest,0,0,1,1
10293,недавние,0,0,1,1
10294,المصرفي,0,0,1,1
5043,grossièrement,0,0,1,1
10297,cidade,0,0,1,1
10299,обеспечению,0,0,1,1
10169,"w
कैटलन",0,0,1,1
10300,مستهلك,0,0,1,1
10301,afstemninger,0,0,1,1
10302,χώρος,0,0,1,1
10304,purposefully,0,0,1,1
10305,desarrolla,0,0,1,1
10306,yayımladığı,0,0,1,1
10289,κοίταζαν,0,0,1,1
10288,efendim,0,0,1,1
10287,مقدما,0,0,1,1
10286,studerende,0,0,1,1
10285,ومختلفة,0,0,1,1
10284,लगता।,0,0,1,1
10283,castigos,0,0,1,1
10280,αιώνες,0,0,1,1
10276,ചേർക്കുമ്പോൾ,0,0,1,1
10274,underpolicyer,0,0,1,1
10273,traduzido,0,0,1,1
10271,concludeerde,0,0,1,1
10270,épisode,0,0,1,1
10269,göreceksiniz,0,0,1,1
10268,localidades,0,0,1,1
10267,импактфактор,0,0,1,1
10266,gebruikmaakten,0,0,1,1
5041,missvisande,0,0,1,1
10308,ಕ್ಷಮೆಯನ್ನು,0,0,1,1
10309,carte,0,0,1,1
10336,ಬೆಳೆಸಲು,0,0,1,1
10358,fixed,0,0,1,1
10356,hayali,0,0,1,1
10354,സഹായകരമാണോ,0,0,1,1
10351,ಒತ್ತುವ,0,0,1,1
10350,المال؟,0,0,1,1
10348,οποιεσδήποτε,0,0,1,1
10346,ligar,0,0,1,1
10345,announcement,0,0,1,1
5038,தொடங்குங்கள்,0,0,1,1
10343,உள்ளீர்கள்,0,0,1,1
10341,ತೊಂದರೆಗೊಳಿಸುವುದಕ್ಕೆ,0,0,1,1
10339,preparese,0,0,1,1
10338,différences,0,0,1,1
10337,personagem,0,0,1,1
10331,أندرو,0,0,1,1
10310,tat,0,0,1,1
10330,hoogkwalitatieve,0,0,1,1
10328,έργο,0,0,1,1
10327,പേരിന്റെ,0,0,1,1
10326,παραπονεθώ,0,0,1,1
10325,തികഞ്ഞ,0,0,1,1
10324,इसी,0,0,1,1
10323,चयन,0,0,1,1
10319,ritmo,0,0,1,1
10318,syster,0,0,1,1
10317,ಸೂಪ್‌ನಲ್ಲಿದ್ದೇನೆ,0,0,1,1
10316,объявление,0,0,1,1
10315,والماس,0,0,1,1
10313,combinação,0,0,1,1
10312,relatar,0,0,1,1
10265,μόνιμα,0,0,1,1
10264,exhibiting,0,0,1,1
10261,wert,0,0,1,1
5048,verebilirsin,0,0,1,1
10208,പേർക്കും,0,0,1,1
10204,dağıtma,0,0,1,1
10202,programação,0,0,1,1
10200,llegan,0,0,1,1
10199,اسمحوا,0,0,1,1
10198,المكتبة؟,0,0,1,1
10197,пойду,0,0,1,1
10196,raden,0,0,1,1
10195,προτίμησης,0,0,1,1
10194,«фазы,0,0,1,1
10193,renginde,0,0,1,1
10192,bozuldu,0,0,1,1
10191,अकाउंट,0,0,1,1
10190,rencontre,0,0,1,1
10188,fliken,0,0,1,1
10213,téléphonie,0,0,1,1
10186,grafemas,0,0,1,1
10185,salads,0,0,1,1
5049,poliert,0,0,1,1
10183,публичное,0,0,1,1
10182,vendue,0,0,1,1
10181,fizeram,0,0,1,1
5050,комик,0,0,1,1
10178,المضللة,0,0,1,1
10177,പോകുന്നുവെന്ന്,0,0,1,1
10176,tenir,0,0,1,1
10175,பதிவுகள்,0,0,1,1
10174,ಮುಂದುವರಿಸುವ,0,0,1,1
10173,adiós,0,0,1,1
10172,n’héritent,0,0,1,1
10210,vécue,0,0,1,1
10216,upprepning,0,0,1,1
10258,yaptıysa,0,0,1,1
10237,afrique,0,0,1,1
10257,softwareinterface,0,0,1,1
10255,morse,0,0,1,1
10254,укрепить,0,0,1,1
10253,exibir,0,0,1,1
10252,restante,0,0,1,1
10251,идете,0,0,1,1
10250,wikiscanninghistorien,0,0,1,1
10248,lanzamiento,0,0,1,1
10247,uitgestorven,0,0,1,1
10246,चाहेंगे,0,0,1,1
10245,substitui,0,0,1,1
10243,dits,0,0,1,1
10242,dettaförtydliga,0,0,1,1
10241,अपशब्द,0,0,1,1
10236,autorités,0,0,1,1
10217,അസൈൻമെന്റുകൾ,0,0,1,1
10235,«народная,0,0,1,1
10234,recreate,0,0,1,1
10231,arboretums,0,0,1,1
10230,imparcialidad,0,0,1,1
10229,clarified,0,0,1,1
10227,நடக்காத,0,0,1,1
5046,isolées,0,0,1,1
10225,الغسيل,0,0,1,1
10224,πόλεμο,0,0,1,1
10223,sabedoria,0,0,1,1
5047,εξασκηθείτε,0,0,1,1
10221,porn,0,0,1,1
10220,cuire,0,0,1,1
10219,தனி,0,0,1,1
9967,الأسبوع؟,0,0,1,1
9964,أسرة,0,0,1,1
5127,ಇದರ,0,0,1,1
5100,interesado,0,0,1,1
9695,للذهاب,0,0,1,1
5101,wikifika,0,0,1,1
9699,ergo,0,0,1,1
9700,وأعلن,0,0,1,1
9701,ಪುರುಷರು,0,0,1,1
9702,தொடர,0,0,1,1
9708,fréquentation,0,0,1,1
9667,имею,0,0,1,1
9709,ಗೊಂಬೆ,0,0,1,1
9711,ಎನ್,0,0,1,1
9712,ಥಂಬ್ಸ್,0,0,1,1
9713,troupes,0,0,1,1
5099,النوع,0,0,1,1
9717,செய்யலாம்,0,0,1,1
9694,mötesplats,0,0,1,1
9690,أمرا,0,0,1,1
9689,отличная,0,0,1,1
9688,publikation,0,0,1,1
9687,ευχάριστο,0,0,1,1
9685,proportions,0,0,1,1
5104,πληκτρολογήστε,0,0,1,1
9681,doulhe,0,0,1,1
9680,തിരുത്തുവാനും,0,0,1,1
9679,perceber,0,0,1,1
9675,einzigen,0,0,1,1
9674,linjeorganisationens,0,0,1,1
5108,hizo,0,0,1,1
9672,supernatural,0,0,1,1
9671,croît,0,0,1,1
9670,கேட்காதபோது,0,0,1,1
9669,тайно,0,0,1,1
9718,buys,0,0,1,1
9719,empoderar,0,0,1,1
9721,prato,0,0,1,1
9744,tane,0,0,1,1
9763,accélérée,0,0,1,1
5093,amatörernas,0,0,1,1
9761,verdenskrig,0,0,1,1
9760,magasin,0,0,1,1
9757,yazılanın,0,0,1,1
9756,vaticano,0,0,1,1
9755,والدة,0,0,1,1
9754,ακολουθούν,0,0,1,1
9751,officielt,0,0,1,1
5094,vandal,0,0,1,1
9749,स्थायी,0,0,1,1
9748,obscenities,0,0,1,1
9747,voltaire,0,0,1,1
9746,εξηγήστε,0,0,1,1
9743,kafanı,0,0,1,1
9722,சோம்பலாகவோ,0,0,1,1
9742,உணவுக்கு,0,0,1,1
9741,görüşmesinde,0,0,1,1
5095,dactylographié,0,0,1,1
9739,когдато,0,0,1,1
9738,समझाता,0,0,1,1
9737,التغطية,0,0,1,1
9733,ஒரேயளவினதாய்,0,0,1,1
9731,spiegelbild,0,0,1,1
9730,vallely,0,0,1,1
9727,पड़ता।,0,0,1,1
9726,الحساسة,0,0,1,1
9725,экономически,0,0,1,1
9724,ಸಮಯದಿಂದ,0,0,1,1
9723,stirrede,0,0,1,1
9668,വരെ,0,0,1,1
9665,frightening,0,0,1,1
9963,ситуаций,0,0,1,1
9605,sock,0,0,1,1
9595,aprieto,0,0,1,1
9597,لتبدو,0,0,1,1
9598,അത്‌,0,0,1,1
9601,refuse,0,0,1,1
9603,monitorados,0,0,1,1
9604,байесовские,0,0,1,1
9606,kızınızın,0,0,1,1
5109,വിവര,0,0,1,1
9608,repetição,0,0,1,1
9609,placer,0,0,1,1
9611,беспорядке,0,0,1,1
9612,illaluktande,0,0,1,1
9613,беспорядок,0,0,1,1
5121,arreglado,0,0,1,1
9593,médiathèques,0,0,1,1
9592,waffling—encouraged,0,0,1,1
5124,estudiante​,0,0,1,1
9590,процессу,0,0,1,1
9589,hydrocarbon,0,0,1,1
9586,tomos—,0,0,1,1
9585,வருத்தப்படுகிறார்,0,0,1,1
9584,रहस्य,0,0,1,1
9583,inquiétude,0,0,1,1
5125,തുടക്കംകുറിച്ചത്‌,0,0,1,1
9581,yale,0,0,1,1
5126,சிமிட்டினர்,0,0,1,1
9577,regarda,0,0,1,1
9576,portant,0,0,1,1
9575,intrusions,0,0,1,1
9572,повторяется,0,0,1,1
9571,टुडे,0,0,1,1
5120,paylaşılmaktadır,0,0,1,1
9616,quadrinhos,0,0,1,1
9617,μάθετε,0,0,1,1
9643,goostman,0,0,1,1
5110,करेंगी,0,0,1,1
9661,посвящённой,0,0,1,1
9660,repetiam,0,0,1,1
5111,triviais,0,0,1,1
5112,قارات,0,0,1,1
5113,larmes,0,0,1,1
9656,والنرويجية,0,0,1,1
9655,наука,0,0,1,1
9651,picture,0,0,1,1
9650,arm,0,0,1,1
9647,саду,0,0,1,1
9646,யூடியூபில்,0,0,1,1
9645,வழங்கப்பட்டுக்,0,0,1,1
9644,пришло,0,0,1,1
9642,nan,0,0,1,1
9618,warst,0,0,1,1
9641,एजेंसीयों,0,0,1,1
9638,ഇടമില്ലെന്ന്,0,0,1,1
5114,اغتيال,0,0,1,1
9634,visait,0,0,1,1
9633,belirterek,0,0,1,1
5117,മറ്റുള്ളവർക്ക്,0,0,1,1
5118,referans,0,0,1,1
9625,"
कोरियाई",0,0,1,1
9624,chaud,0,0,1,1
9623,ærligt,0,0,1,1
9622,erika,0,0,1,1
9621,പിടിക്കുക,0,0,1,1
9620,snegleeksempel,0,0,1,1
5119,anneyi,0,0,1,1
9764,είδε,0,0,1,1
9765,പത്ത്,0,0,1,1
9766,लूरी,0,0,1,1
9907,evaluar,0,0,1,1
9898,motivera,0,0,1,1
5079,ansigt,0,0,1,1
9902,biodiversity,0,0,1,1
9904,«значимой»,0,0,1,1
9905,obtén,0,0,1,1
9906,nontrivial,0,0,1,1
9908,συγκεντρώνονται,0,0,1,1
5092,baffling,0,0,1,1
9909,وتراجعت,0,0,1,1
9910,antigas,0,0,1,1
9912,റെസ്റ്റോറന്റാണിത്,0,0,1,1
9913,endehors,0,0,1,1
9914,powerful,0,0,1,1
9915,ζητήσουν,0,0,1,1
9896,ಕಳುಹಿಸುತ್ತೇನೆ,0,0,1,1
9895,oprindelser,0,0,1,1
5080,нейтральной,0,0,1,1
9892,вручена,0,0,1,1
9890,noemt,0,0,1,1
9887,июля,0,0,1,1
9886,"
जापानी",0,0,1,1
9885,sohbetin,0,0,1,1
9883,tian,0,0,1,1
9881,கேள்வி,0,0,1,1
9880,croisée,0,0,1,1
9879,помедленнее,0,0,1,1
9878,ഇംഗ്ലീഷിലെ,0,0,1,1
9875,bloqueadas,0,0,1,1
9874,yavaşça,0,0,1,1
9872,благом,0,0,1,1
9870,академик,0,0,1,1
9916,étend,0,0,1,1
9917,ledig,0,0,1,1
9918,alia,0,0,1,1
9939,ojo,0,0,1,1
5073,primitive,0,0,1,1
9959,overlap,0,0,1,1
5074,ಸ್ನೇಹಿತರೆಲ್ಲರೂ,0,0,1,1
9957,ನಾರ್ಸಿಸಾಳನ್ನು,0,0,1,1
5075,compromises,0,0,1,1
9954,gözleri,0,0,1,1
9953,offentlighed,0,0,1,1
9951,बोलचाल,0,0,1,1
9949,cto,0,0,1,1
9946,generelt,0,0,1,1
9945,ουδετερότητας,0,0,1,1
9943,freecontent,0,0,1,1
9941,älskling,0,0,1,1
9940,وابنتها,0,0,1,1
9938,nervous,0,0,1,1
9919,susceptibles,0,0,1,1
9937,مدريد,0,0,1,1
9936,nefes,0,0,1,1
9935,spreche,0,0,1,1
9934,έννοιες,0,0,1,1
9933,ondervertegenwoordigd,0,0,1,1
9932,இடம்பெறலாம்,0,0,1,1
9929,лучшую,0,0,1,1
9927,ಪಡೆದಿದ್ದೀರಾ,0,0,1,1
9926,olmuştur,0,0,1,1
9924,décourager,0,0,1,1
9923,undécimo,0,0,1,1
9922,auxiliar,0,0,1,1
9921,contextdependent,0,0,1,1
9920,zamanlarda,0,0,1,1
9867,ccbysanl,0,0,1,1
9866,individer,0,0,1,1
9865,någonstans,0,0,1,1
9791,μεγαλώσετε,0,0,1,1
9810,إنجليزية,0,0,1,1
9809,сожалению,0,0,1,1
9808,المقالة،,0,0,1,1
9807,språkupplagan,0,0,1,1
9806,ro,0,0,1,1
5090,escuchaste,0,0,1,1
9803,ड्राइववे,0,0,1,1
9802,aceite,0,0,1,1
9801,negotiating,0,0,1,1
9800,ಎಚ್ಚರವಾಯಿತು,0,0,1,1
9799,ಮುಖದ,0,0,1,1
9797,வாழ்க்கையிலும்,0,0,1,1
9796,bicholim,0,0,1,1
9792,terminal,0,0,1,1
9790,zoekresultaten,0,0,1,1
9815,والذكية,0,0,1,1
9789,massives,0,0,1,1
9787,winzigen,0,0,1,1
9786,മൂലം,0,0,1,1
9785,rigen,0,0,1,1
9784,autocorregirse,0,0,1,1
9781,adicionada,0,0,1,1
9780,முடியாவிட்டால்,0,0,1,1
9779,habitude,0,0,1,1
9777,entraram,0,0,1,1
9776,مقياس,0,0,1,1
9775,hesitando,0,0,1,1
9774,släktforskare,0,0,1,1
9771,signifier,0,0,1,1
9768,игру,0,0,1,1
9814,intercepter,0,0,1,1
9818,абоненту,0,0,1,1
9863,morges,0,0,1,1
9841,தீவிரமாக,0,0,1,1
9862,« a,0,0,1,1
5083,மாதங்களில்,0,0,1,1
9858,अद्यतन,0,0,1,1
9856,frequent,0,0,1,1
9855,habilidad,0,0,1,1
9854,créateurs,0,0,1,1
5084,സംശയത്തിന്,0,0,1,1
9852,muñeca,0,0,1,1
9851,просить,0,0,1,1
9848,பயமாக,0,0,1,1
9847,ستجده,0,0,1,1
9846,californien,0,0,1,1
9843,restored,0,0,1,1
9842,ಬರುವುದಿಲ್ಲ,0,0,1,1
9840,demostrarse,0,0,1,1
9819,имел,0,0,1,1
9838,gobbling,0,0,1,1
9837,мессенджер,0,0,1,1
9834,izquierdista,0,0,1,1
9833,tillförlitligheten,0,0,1,1
9832,μορφή,0,0,1,1
5089,reparar,0,0,1,1
9830,mönster,0,0,1,1
9829,ലേഖനത്തിനും,0,0,1,1
9826,såklart,0,0,1,1
9825,λόγια,0,0,1,1
9824,refleksion,0,0,1,1
9823,feasible,0,0,1,1
9822,ನೀನು,0,0,1,1
9821,lags,0,0,1,1
18007,yapılır,0,0,1,1
18008,pédia,0,0,1,1
18009,fühle,0,0,1,1
26244,obtendría,0,0,1,1
26237,கட்டுரை,0,0,1,1
26238,téléphoniques,0,0,1,1
26239,angleterre,0,0,1,1
26240,bedank,0,0,1,1
26241,سرعان,0,0,1,1
26243,उम्र,0,0,1,1
26245,assassination,0,0,1,1
26210,goalseeking,0,0,1,1
26246,salyangoz,0,0,1,1
3032,critiche,1,1,0,1
3031,possiede,1,1,0,1
26249,சாப்பாட்டு,0,0,1,1
26250,откусил,0,0,1,1
26251,पोस्ट,0,0,1,1
26236,unfortunately,0,0,1,1
26235,अभियोगपत्र,0,0,1,1
26234,صعد,0,0,1,1
26231,ಸ್ವಾತಂತ್ರ್ಯವಿಲ್ಲ,0,0,1,1
26230,कैलीफ़ोर्निया,0,0,1,1
26228,സുന്ദരനായിരുന്നു,0,0,1,1
26227,رجل,0,0,1,1
26225,morrendo,0,0,1,1
26224,χώρα,0,0,1,1
26223,ödevi,0,0,1,1
3035,promosso,1,1,0,1
26221,έρχεται,0,0,1,1
26219,visiblement,0,0,1,1
26218,omslaget,0,0,1,1
26217,automatisation,0,0,1,1
26215,reenters,0,0,1,1
26214,لحل,0,0,1,1
26252,öğreniyorum,0,0,1,1
26254,haag,0,0,1,1
26255,cirkelen,0,0,1,1
26278,améliorations,0,0,1,1
26302,arbre,0,0,1,1
26299,evitan,0,0,1,1
26298,والفكاهة,0,0,1,1
26297,кислоту —,0,0,1,1
26295,stumpfen,0,0,1,1
26293,engraved,0,0,1,1
26292,χάος,0,0,1,1
26291,ഇരിക്കുന്നതായും,0,0,1,1
26290,الفلبين,0,0,1,1
3025,preoccupare,1,1,0,1
26287,hjemmesiden,0,0,1,1
26285,plateau,0,0,1,1
3027,attribuiti,1,1,0,1
26281,ஐகானையும்,0,0,1,1
26277,ˌwɪki,0,0,1,1
26257,എഴുതപ്പെടുന്നത്,0,0,1,1
26275,братские,0,0,1,1
26273,buradan,0,0,1,1
26272,hindra,0,0,1,1
26271,ചങ്ങാതിമാരും,0,0,1,1
26270,വിക്കിസോഫ്റ്റ്,0,0,1,1
26269,ba •,0,0,1,1
26266,leave,0,0,1,1
26265,сбитым,0,0,1,1
26264,uintelligent,0,0,1,1
26263,rechten,0,0,1,1
26262,ændret,0,0,1,1
26261,обращает,0,0,1,1
26259,ficticia,0,0,1,1
26258,ನಾವೆಲ್ಲರೂ,0,0,1,1
26212,incompetent,0,0,1,1
26207,kleines,0,0,1,1
26305,influenced,0,0,1,1
26154,douradas,0,0,1,1
26145,endorheic,0,0,1,1
26146,réalités,0,0,1,1
26147,जाएगा।,0,0,1,1
26149,допустим,0,0,1,1
26150,ευχηθείτε,0,0,1,1
26153,ascendieron,0,0,1,1
3044,dimostrato»,1,1,0,1
26206,тобой,0,0,1,1
26156,δομημένων,0,0,1,1
3041,pianeta,1,1,0,1
26159,πορεία,0,0,1,1
26160,naken,0,0,1,1
26162,chiffre,0,0,1,1
26163,radera,0,0,1,1
26144,بجامعة,0,0,1,1
26142,динамика,0,0,1,1
26141,കാത്തിരിക്കാൻ,0,0,1,1
3046,iniziale,1,1,0,1
26138,उंगलियां,0,0,1,1
26137,देगा,0,0,1,1
26135,receiver,0,0,1,1
26128,இழுப்பதாகவோ,0,0,1,1
26127,noticed,0,0,1,1
26126,ickehierarkisk,0,0,1,1
26125,تكرار,0,0,1,1
26124,eliminado,0,0,1,1
26123,بالمشاهدة,0,0,1,1
26122,listo,0,0,1,1
26121,mordida,0,0,1,1
26119,wijdde,0,0,1,1
26118,racistas,0,0,1,1
26164,تتلقى,0,0,1,1
26165,கற்றல்,0,0,1,1
26166,deposunda,0,0,1,1
26188,vue »,0,0,1,1
26205,patates,0,0,1,1
26204,கேட்கிறேன்,0,0,1,1
26201,fortfahren,0,0,1,1
26200,പദങ്ങൾക്കും,0,0,1,1
26199,نسبيًا,0,0,1,1
26197,reparieren,0,0,1,1
26196,—correcciones,0,0,1,1
26195,востребованным»,0,0,1,1
26194,technologically,0,0,1,1
26193,انطلق,0,0,1,1
26192,ayudarías,0,0,1,1
3038,aiutami,1,1,0,1
26190,المطولة,0,0,1,1
26189,enheten,0,0,1,1
26187,spektrum,0,0,1,1
26167,собственных,0,0,1,1
26186,étroitement,0,0,1,1
3039,offerte,1,1,0,1
3040,occasioni,1,1,0,1
26182,другая,0,0,1,1
26180,ключевыми,0,0,1,1
26179,ктонибудь,0,0,1,1
26177,விக்கியைப்,0,0,1,1
26176,encyclopedia»,0,0,1,1
26175,تصنيفها،,0,0,1,1
26174,stycken,0,0,1,1
26173,biografias,0,0,1,1
26170,σκοπεύω,0,0,1,1
26169,haberleri,0,0,1,1
26168,värdelöst,0,0,1,1
26303,hängst,0,0,1,1
26306,servrar,0,0,1,1
25730,निमंत्रण,0,0,1,1
26456,ബന്ധങ്ങൾ,0,0,1,1
26447,bahsetmediniz,0,0,1,1
26448,يتعلَّم,0,0,1,1
26451,പരുഷമായി,0,0,1,1
26452,பெறுகிறார்கள்,0,0,1,1
26453,communiqué,0,0,1,1
26455,μπερδευτείτε,0,0,1,1
26457,towns,0,0,1,1
26417,appui,0,0,1,1
26458,संपर्क,0,0,1,1
3005,profilo,1,1,0,1
26461,pekat,0,0,1,1
26463,onani,0,0,1,1
26464,ಉಡುಪಿನಲ್ಲಿ,0,0,1,1
26468,فيرجينيا,0,0,1,1
26446,weinberger en,0,0,1,1
26445,societies,0,0,1,1
26444,കാര്യത്തെക്കുറിച്ച്,0,0,1,1
26441,പോലീസോ,0,0,1,1
26440,تتجاهل,0,0,1,1
26439,மாற்றங்கள்’,0,0,1,1
3006,energetico,1,1,0,1
26437,codificación,0,0,1,1
26436,saturn,0,0,1,1
26435,പ്രൊജക്റ്റിനു,0,0,1,1
3007,esistenza,1,1,0,1
3008,scaturisce,1,1,0,1
26428,‘பேச்சுப்,0,0,1,1
26427,blois,0,0,1,1
26426,neuen,0,0,1,1
26425,fællesskab,0,0,1,1
26419,duymuşsunuzdur,0,0,1,1
26469,plucker,0,0,1,1
26470,hæren,0,0,1,1
26471,hug,0,0,1,1
26497,puinhoop,0,0,1,1
26512,schommelt,0,0,1,1
26511,longo,0,0,1,1
26510,तूफानी,0,0,1,1
26509,इंगित,0,0,1,1
26508,дорабатывали,0,0,1,1
26507,ಗೆಳತಿ,0,0,1,1
26506,kelimedir,0,0,1,1
26505,rattachés,0,0,1,1
26504,sofra,0,0,1,1
26503,durmiendo,0,0,1,1
26502,wikipédiag,0,0,1,1
26501,βελτιώστε,0,0,1,1
26499,geliştireceği,0,0,1,1
26498,പദത്തിന്,0,0,1,1
26494,självmord,0,0,1,1
26472,foncière,0,0,1,1
26493,incrivelmente,0,0,1,1
26492,മറികടന്നു,0,0,1,1
26491,गड़बड़,0,0,1,1
26488,поймешь,0,0,1,1
26487,உதவிகரமாக,0,0,1,1
26485,начаты,0,0,1,1
26484,നിലവിലുണ്ട്,0,0,1,1
26483,حدد,0,0,1,1
26482,répondu,0,0,1,1
26481,сравнить,0,0,1,1
26479,تستأنف,0,0,1,1
26477,διανεμηθεί,0,0,1,1
26475,plage,0,0,1,1
26473,krama,0,0,1,1
26418,removal,0,0,1,1
26416,nyttige,0,0,1,1
26307,inférieure,0,0,1,1
26349,தாய்க்கு,0,0,1,1
26340,automatizar,0,0,1,1
26341,മെസഞ്ചർ,0,0,1,1
26345,ائتمانًا,0,0,1,1
26346,varsayılmaktadır,0,0,1,1
26347,والواراي,0,0,1,1
26348,erstaunt,0,0,1,1
26351,редакционным,0,0,1,1
3010,specifico,1,1,0,1
26354,வந்ததும்,0,0,1,1
26357,بغض,0,0,1,1
26360,ودعوا,0,0,1,1
26361,சனிக்கிழமை,0,0,1,1
26363,yavaştır,0,0,1,1
26364,விதிவிலக்காக,0,0,1,1
26336,wikiversidade,0,0,1,1
26333,facteur,0,0,1,1
26328,suivi »,0,0,1,1
26326,одед,0,0,1,1
26325,parciales,0,0,1,1
26324,suivre »,0,0,1,1
3021,pezzo,1,1,0,1
26322,blacking,0,0,1,1
26318,sterker,0,0,1,1
26317,bibliograaf,0,0,1,1
3024,sfera,1,1,0,1
26315,положение,0,0,1,1
26314,remind,0,0,1,1
26312,bakayım,0,0,1,1
26311,массовое,0,0,1,1
26310,πρόσφατα,0,0,1,1
26308,révélant,0,0,1,1
3018,comparato,1,1,0,1
26368,klickt,0,0,1,1
26369,féminines,0,0,1,1
26394,planter,0,0,1,1
26412,détournées,0,0,1,1
26411,ನಗಲು,0,0,1,1
26410,sauriezvous,0,0,1,1
26409,ανεβάζετε,0,0,1,1
26408,professors,0,0,1,1
26406,hormiga,0,0,1,1
3015,accademia,1,1,0,1
26404,أسابيع,0,0,1,1
26403,kontrolleras,0,0,1,1
26402,गैरविकिपीडिया,0,0,1,1
26400,explicar,0,0,1,1
26398,транспорте,0,0,1,1
26396,स्टेवर्डशिप,0,0,1,1
26395,дальнейшее,0,0,1,1
26392,പെരുപ്പിച്ചു,0,0,1,1
26370,démarches,0,0,1,1
26391,désordre,0,0,1,1
26390,kökenleri,0,0,1,1
26389,स्वीकृतियों,0,0,1,1
26388,оценок,0,0,1,1
26387,നന്നായിരിക്കും,0,0,1,1
26386,autoproduction,0,0,1,1
3016,pronte,1,1,0,1
26380,έλεγες,0,0,1,1
26379,lecturers,0,0,1,1
26378,interativo,0,0,1,1
26377,famoso»,0,0,1,1
26375,просмотренных,0,0,1,1
26372,zugeben,0,0,1,1
26371,ಓದುತ್ತಿದ್ದೇನೆ,0,0,1,1
26114,ரியோக்காசு,0,0,1,1
26113,вялого,0,0,1,1
3050,tentare,1,1,0,1
25860,integrando,0,0,1,1
25853,hakikaten,0,0,1,1
25854,थोडा,0,0,1,1
25855,noticiado,0,0,1,1
25856,contribuiu,0,0,1,1
25858,participating,0,0,1,1
25859,മീറ്റിംഗായിരുന്നു,0,0,1,1
25861,dieciséis,0,0,1,1
25824,tummarna,0,0,1,1
3086,jōichi,1,1,0,1
25866,ओक्स्फोर्ड,0,0,1,1
25867,åbne,0,0,1,1
25870,भागों,0,0,1,1
3085,tuttora,1,1,0,1
25873,തരംതിരിക്കാൻ,0,0,1,1
25850,مخالف,0,0,1,1
25849,журналистике,0,0,1,1
25848,والآراء,0,0,1,1
25847,corrija,0,0,1,1
25846,déterminations,0,0,1,1
3087,mangio,1,1,0,1
25842,gemeenschappen,0,0,1,1
25841,convite,0,0,1,1
25840,குனூ,0,0,1,1
25837,अध्यायों,0,0,1,1
25835,जानेमन,0,0,1,1
25834,الاختلافات,0,0,1,1
25832,jarre,0,0,1,1
25830,intégrale,0,0,1,1
25829,الأمريكيين,0,0,1,1
25828,ಬದಲಿಗೆ,0,0,1,1
25827,tandis,0,0,1,1
25874,изменение,0,0,1,1
25875,multimídias,0,0,1,1
3084,digita,1,1,0,1
3081,misurato,1,1,0,1
25919,commenting,0,0,1,1
25916,flippede,0,0,1,1
25915,μαγικά,0,0,1,1
25914,للقوانين,0,0,1,1
25912,മര്യാദ,0,0,1,1
25911,принц,0,0,1,1
25909,grecque,0,0,1,1
25908,ಹಾಕುತ್ತಿದ್ದೇನೆ,0,0,1,1
25907,لأطلب,0,0,1,1
25906,अडिग,0,0,1,1
25905,teoría,0,0,1,1
25904,dini,0,0,1,1
25903,illustrative,0,0,1,1
25902,ética,0,0,1,1
25896,counting,0,0,1,1
25877,readability,0,0,1,1
25895,relating,0,0,1,1
25893,couches ,0,0,1,1
25892,വിലാസത്തിന്റെ,0,0,1,1
25891,تسعة,0,0,1,1
25890,ädelstenar,0,0,1,1
25888,escolhas,0,0,1,1
25886,купили,0,0,1,1
25885,renouvelables,0,0,1,1
25884,magnificent,0,0,1,1
25882,شخصياً,0,0,1,1
25881,പ്രവൃത്തി,0,0,1,1
25880,reisde,0,0,1,1
25879,comblé,0,0,1,1
3083,includere,1,1,0,1
25826,förberedde,0,0,1,1
25823,rendueles,0,0,1,1
26109,εμείς,0,0,1,1
25764,подготовка,0,0,1,1
3100,completezza,1,1,0,1
25757,ederek,0,0,1,1
25759,κόκκινο,0,0,1,1
25761,capté,0,0,1,1
3097,fondazione,1,1,0,1
25763,situada,0,0,1,1
25765,merkezinde,0,0,1,1
25822,विस्मयित,0,0,1,1
25766,exhaustivo,0,0,1,1
25767,مرتبات،,0,0,1,1
25771,triumphing,0,0,1,1
25772,بالمحتوى,0,0,1,1
25773,ειλικρινά,0,0,1,1
25774,occupée…,0,0,1,1
25755,കണക്കാക്കാം,0,0,1,1
25753,കഴിഞ്ഞത്,0,0,1,1
25752,അങ്ങനെയുള്ള,0,0,1,1
3106,regolata,1,1,0,1
25750,saute,0,0,1,1
25749,peerreviewed,0,0,1,1
25747,расширена,0,0,1,1
25745,ಹಿಸಿದ್ದೇನೆ,0,0,1,1
25741,समझना,0,0,1,1
25740,graines,0,0,1,1
25739,ഗ്ലാസ്,0,0,1,1
25738,génie,0,0,1,1
25737,стакан,0,0,1,1
25736,കണ്ടതിൽ,0,0,1,1
25735,validade,0,0,1,1
25734,വിത്തുകൾ,0,0,1,1
25733,belgique,0,0,1,1
3095,dispongono,1,1,0,1
25779,formatering,0,0,1,1
3094,descritta,1,1,0,1
25803,المنخفضة,0,0,1,1
25820,يركزون,0,0,1,1
25817,கண்,0,0,1,1
25816,viajes,0,0,1,1
25815,omfattande,0,0,1,1
25814,layout,0,0,1,1
25813,கொடுங்கள்,0,0,1,1
25811,hierarkisk,0,0,1,1
25810,bredvid,0,0,1,1
25809,gisteravond,0,0,1,1
25808,ameaças,0,0,1,1
25807,styrkor,0,0,1,1
25806,घूर,0,0,1,1
25805,apoyando,0,0,1,1
25804,vienes,0,0,1,1
25802,desenvolver,0,0,1,1
25783,préhistoire,0,0,1,1
25801,chanceuse,0,0,1,1
25800,basisinstructies,0,0,1,1
25798,onları,0,0,1,1
25796,διαφορετικούς,0,0,1,1
25795,tohumları,0,0,1,1
25794,تشتكي,0,0,1,1
25793,librepedia,0,0,1,1
25792,تشاهدون,0,0,1,1
25791,poussée,0,0,1,1
25789,rendra,0,0,1,1
3093,entrambe,1,1,0,1
25787,connaître,0,0,1,1
25785,மோசமான,0,0,1,1
25784,constamment,0,0,1,1
25921,inbördeskriget,0,0,1,1
25923,üniversiteye,0,0,1,1
25924,பட்டினி,0,0,1,1
26050,nåd,0,0,1,1
26043,corrección,0,0,1,1
26044,ಮಾಡಬಹುದೇ,0,0,1,1
26045,mande,0,0,1,1
3062,«pochi,1,1,0,1
26048,üzülmeyin,0,0,1,1
26049,nua,0,0,1,1
26051,grandissante,0,0,1,1
25926,tidsskrifter,0,0,1,1
26052,toxic,0,0,1,1
26053,jämnt,0,0,1,1
26054,recht,0,0,1,1
26055,لنذهب,0,0,1,1
26057,digesting,0,0,1,1
26060,कार्यालय,0,0,1,1
26041,förespråkare,0,0,1,1
26040,språkversion,0,0,1,1
26039,famílias,0,0,1,1
26038,hydrological,0,0,1,1
26036,முதன்மைக்,0,0,1,1
26035,aangeslagen,0,0,1,1
26034,« modifications,0,0,1,1
26031,puppe,0,0,1,1
26030,εκατομμύριο,0,0,1,1
3063,banche,1,1,0,1
26028,пойти,0,0,1,1
26025,ലഭിക്കുന്നതിന്,0,0,1,1
26024,ಸುಂದರವಾದ,0,0,1,1
26020,άρεσαν,0,0,1,1
26018,مفتوحًا,0,0,1,1
26017,legitimidad,0,0,1,1
26015,популярное,0,0,1,1
26062,ಹೇಳಬಹುದಾದ,0,0,1,1
26064,استثنائي,0,0,1,1
26067,ушли,0,0,1,1
26086,durable,0,0,1,1
26108,sınavda,0,0,1,1
26107,культура,0,0,1,1
26105,personally,0,0,1,1
3052,illustrati,1,1,0,1
3053,wikipeˈdia,1,1,0,1
26098,blair,0,0,1,1
26097,skiva,0,0,1,1
3054,guardarono,1,1,0,1
26095,granskade,0,0,1,1
26094,வெளிப்படுத்தினேன்,0,0,1,1
26093,ചിലതിന്,0,0,1,1
26092,पृष्ट,0,0,1,1
26091,académicos—,0,0,1,1
26087,implementations,0,0,1,1
26085,ναρκίσσους,0,0,1,1
26068,എടുത്താൽ,0,0,1,1
26084,passada,0,0,1,1
26083,пародировал,0,0,1,1
26081,تحتاج,0,0,1,1
3057,suono,1,1,0,1
26079,دلهي,0,0,1,1
26077,உருவாக்கினார்,0,0,1,1
26076,великой,0,0,1,1
26075,gazetesi,0,0,1,1
3058,scalpore,1,1,0,1
26073,damwikipediaorg,0,0,1,1
26072,« aide »,0,0,1,1
26071,تامبا،,0,0,1,1
26070,ansiktet,0,0,1,1
3059,salutare,1,1,0,1
3067,sforzo,1,1,0,1
26013,shortly,0,0,1,1
26012,பயன்படுத்துவது,0,0,1,1
25948,sens »,0,0,1,1
25964,ms •,0,0,1,1
25963,ഏറി,0,0,1,1
3076,incontrarti,1,1,0,1
25961,representantes,0,0,1,1
25960,slag,0,0,1,1
25959,പ്രവർത്തകർ,0,0,1,1
25958,ചെയ്തു,0,0,1,1
25957,welldefined,0,0,1,1
25955,resimlerin,0,0,1,1
25954,отсутствующим,0,0,1,1
25953,stalin,0,0,1,1
25952,bridle,0,0,1,1
25951,videodur,0,0,1,1
25949,añadir,0,0,1,1
25946,добивается,0,0,1,1
25967,различия,0,0,1,1
25945,paysage,0,0,1,1
25944,users ,0,0,1,1
25943,टेबल,0,0,1,1
25941,تستطيع,0,0,1,1
25939,såväl,0,0,1,1
25938,shirky,0,0,1,1
25935,valresultaten,0,0,1,1
25934,télévisé,0,0,1,1
25933,échoué,0,0,1,1
25932,ತಿರುಗುತ್ತಾನೆ,0,0,1,1
25931,வலியுறுத்துவது,0,0,1,1
25930,സാങർ,0,0,1,1
25928,telefonopkald,0,0,1,1
25927,плюрипотентное,0,0,1,1
25966,emocionante,0,0,1,1
25968,utsträckning,0,0,1,1
26008,മാതൃവെബ്സൈറ്റിനെയും,0,0,1,1
25988,backen,0,0,1,1
26007,هذا؟,0,0,1,1
26006,ധരിച്ചിട്ടുണ്ടെന്നും,0,0,1,1
26004,buss,0,0,1,1
26003,partagés,0,0,1,1
26001,argumentaram,0,0,1,1
3070,categorizzazione,1,1,0,1
25996,вандализирована,0,0,1,1
25995,divergent,0,0,1,1
25994,appréhender,0,0,1,1
25993,цифровой,0,0,1,1
3071,domini,1,1,0,1
25991,ಇದ್ದವು,0,0,1,1
3072,tradeoff,1,1,0,1
3073,modellati,1,1,0,1
25987,परियोजनाएंजैसे,0,0,1,1
25970, ومؤسسة,0,0,1,1
25986,niña,0,0,1,1
3074,affermò,1,1,0,1
25984,catholiques,0,0,1,1
25983,منفرج,0,0,1,1
25982,adoptado,0,0,1,1
25981,descrever,0,0,1,1
25979,vanvittigt,0,0,1,1
25978,κάθονται,0,0,1,1
25977,देंगे,0,0,1,1
25976,exceptionellt,0,0,1,1
25975,chevalier,0,0,1,1
25974,диалекты,0,0,1,1
25973,universitetsnivå,0,0,1,1
25972,avancée,0,0,1,1
26513,συνεχίσουμε,0,0,1,1
26516,meanings,0,0,1,1
26517,явно,0,0,1,1
27039,அழகானவர்,0,0,1,1
27033,implémentation,0,0,1,1
27034,aufzumuntern,0,0,1,1
27035,വിചാരിക്കുന്നില്ല,0,0,1,1
27036,हमारी,0,0,1,1
27037,أهتم,0,0,1,1
27038,बगीचे,0,0,1,1
27041,verifiera,0,0,1,1
27001,أضع,0,0,1,1
27042,økonomien,0,0,1,1
27043,وانفتاحًا,0,0,1,1
27044,англоязычную,0,0,1,1
27045,tempestuosa,0,0,1,1
2934,parliamo,1,1,0,1
2933,commentare,1,1,0,1
27031,സമതുലിതമായ,0,0,1,1
27028,monte,0,0,1,1
27027,естественно,0,0,1,1
27026,impossibilité,0,0,1,1
27025,வெளியிடுவதாகவே,0,0,1,1
27020,floride,0,0,1,1
27019,thirdgeneration,0,0,1,1
27018,tartışılır,0,0,1,1
27016,മാംസം,0,0,1,1
27015,صنع,0,0,1,1
2938,linguistico,1,1,0,1
27013,mooiste,0,0,1,1
27011,പ്ലാനിങ്,0,0,1,1
27010,halsizlik,0,0,1,1
27009,muscles,0,0,1,1
27007,песнях,0,0,1,1
27005,व्याकरण,0,0,1,1
27049,உள்ளதாகத்,0,0,1,1
27051,парадокс,0,0,1,1
27052,benden,0,0,1,1
27072,mobility,0,0,1,1
27088,чувствуете,0,0,1,1
27087,aboutit,0,0,1,1
27086,வாசகரும்,0,0,1,1
27085,സമർപ്പിക്കുക,0,0,1,1
27083,والثروات,0,0,1,1
27082,എല്ലാവരോടും,0,0,1,1
27081,माइस्पेस,0,0,1,1
27080,cezaevlerinde,0,0,1,1
27079,istemezdim,0,0,1,1
27078,incompetentes,0,0,1,1
27076,kaynaklarıyla,0,0,1,1
27075,örneğinde,0,0,1,1
27074,sløv,0,0,1,1
27073,الاصابع,0,0,1,1
27071,préfère,0,0,1,1
27054,kwartaal,0,0,1,1
27069,"
जॉर्जियाई",0,0,1,1
27068,utvecklat,0,0,1,1
27067,выводы,0,0,1,1
27066,पहुँचे,0,0,1,1
2931,limitano,1,1,0,1
2932,«…per,1,1,0,1
27062,താഴെയാണ്,0,0,1,1
27061,conduzido,0,0,1,1
27060,periods,0,0,1,1
27059,πότε,0,0,1,1
27058,संज्ञा,0,0,1,1
27057,مستحيلًا,0,0,1,1
27056,تفهمًا,0,0,1,1
27055,создают,0,0,1,1
27003,publicité,0,0,1,1
27000,vormen,0,0,1,1
2955,italianizzate,1,1,0,1
26937,stupide,0,0,1,1
26930,consulté »,0,0,1,1
26932,esprits,0,0,1,1
26933,​​of,0,0,1,1
26934,expression »,0,0,1,1
26935,الرحلة,0,0,1,1
26936,ಕೆಲಸವಿದೆ,0,0,1,1
26939,microbes,0,0,1,1
26999,pratiquer,0,0,1,1
26940,والوسائط,0,0,1,1
26941,спектр,0,0,1,1
26943,ചിലമേഖലകളെ,0,0,1,1
26946,déclaré,0,0,1,1
26947,oavsett,0,0,1,1
2952,possiamo,1,1,0,1
26929,காரணமாகும்,0,0,1,1
26928,ടെസ്റ്റു,0,0,1,1
26927,αγενή,0,0,1,1
26925,ನೀರಸವಾಗಿದೆ,0,0,1,1
26924,pladsen,0,0,1,1
26921,prejudicial,0,0,1,1
26920,الجلوس,0,0,1,1
26919,diamants,0,0,1,1
26918,സമീപനത്തിന്,0,0,1,1
26917,बनाता,0,0,1,1
26915,"
इण्डोनेशियाई",0,0,1,1
26914,"
ucraniano",0,0,1,1
26913,sketch,0,0,1,1
26912,абзацев,0,0,1,1
26911,ஜோசப்,0,0,1,1
26910,ಹಸಿದಿಲ್ಲ,0,0,1,1
26909,والجزء,0,0,1,1
26950,നടത്തുന്നുമുണ്ട്,0,0,1,1
26953,yazı,0,0,1,1
26954,गिलास,0,0,1,1
26975,escasa,0,0,1,1
26998,цитируемых,0,0,1,1
26996,mümkündür,0,0,1,1
26995,утверждают,0,0,1,1
26994,digitizing,0,0,1,1
2943,permanenti,1,1,0,1
26990,достать,0,0,1,1
26989,anlayışı,0,0,1,1
2944,catalizzatore,1,1,0,1
26982,ನೋಡಿಲ್ಲ,0,0,1,1
26981,ಸುಳಿವು,0,0,1,1
26980,multitudinaria,0,0,1,1
26979,chief,0,0,1,1
26978,finaste,0,0,1,1
26977,разнообразию,0,0,1,1
2946,troverebbe,1,1,0,1
26955,أضاف,0,0,1,1
26972,அவரை,0,0,1,1
26971,lämnar,0,0,1,1
26970,وصُفت,0,0,1,1
26969,teklifler,0,0,1,1
26968,столе,0,0,1,1
26967,desenhos,0,0,1,1
26966,обеспечение,0,0,1,1
26964,ksvd,0,0,1,1
2948,scientifico,1,1,0,1
2949,contenute,1,1,0,1
26961,στρατεύματα,0,0,1,1
26960,ആശ്ചര്യകരമായ,0,0,1,1
2950,prezzi,1,1,0,1
26956,verificadores,0,0,1,1
27089,الابتسامات,0,0,1,1
27090,hermosos,0,0,1,1
27091,ಕಾಲದಲ್ಲಿ,0,0,1,1
27221,sh •,0,0,1,1
27212,γνωστό,0,0,1,1
27213,ರೆಸ್ಟೋರೆಂಟ್,0,0,1,1
2914,secoli,1,1,0,1
27215,عارض,0,0,1,1
27216,oprit,0,0,1,1
27217,programmering,0,0,1,1
27222,λήμματά,0,0,1,1
27092,modificaron,0,0,1,1
27223,opzetten,0,0,1,1
27224,similar—,0,0,1,1
27225,naturligtvis,0,0,1,1
27226,overhovedet,0,0,1,1
27227,"
javanês",0,0,1,1
27229,ontsluiten,0,0,1,1
27211,integrating,0,0,1,1
27210,högerperspektiv,0,0,1,1
27208,quotidiennes,0,0,1,1
27207,கட்டுரையிலும்,0,0,1,1
27204,renovable,0,0,1,1
27201,координируются,0,0,1,1
27200,ಒಳ್ಳೆಯವರು,0,0,1,1
27199,magnifikt,0,0,1,1
27198,voren,0,0,1,1
27197,constitute,0,0,1,1
27196,വളരെയധികമില്ല,0,0,1,1
27193,medias,0,0,1,1
27192,எழுதப்பட்டது,0,0,1,1
27190,considerarla,0,0,1,1
27188,« significative,0,0,1,1
27187,renunciou,0,0,1,1
27186,μπροστά,0,0,1,1
2913,bibliotecari,1,1,0,1
27231,प्रिक्स,0,0,1,1
27233,ലക്ഷത്തിൽ,0,0,1,1
27255,förklaringen,0,0,1,1
27274,exponentially,0,0,1,1
2910,riprendi,1,1,0,1
27272,марка,0,0,1,1
27269,συνειδητοποιήσω,0,0,1,1
27268,olsaydın,0,0,1,1
27265,ಬದಲಾಗಿ,0,0,1,1
27264,года —,0,0,1,1
27262,സ്ഥാപനമാണ്,0,0,1,1
27261,பின்னரே,0,0,1,1
27260,والإجراءات,0,0,1,1
27259,viable,0,0,1,1
27258,трудно,0,0,1,1
27257,universeel,0,0,1,1
27256,संपदा,0,0,1,1
27254,bureaucracy,0,0,1,1
27235,soğuk,0,0,1,1
27253,eliminó,0,0,1,1
27252,പുരുഷന്മാരെ,0,0,1,1
27251,resultatet,0,0,1,1
27250,بأنك,0,0,1,1
27248,dependence,0,0,1,1
27247,غبي,0,0,1,1
27246,associada,0,0,1,1
2911,opposto,1,1,0,1
27244,ठंडी,0,0,1,1
27242,ನಿಧಾನಗತಿಯಲ್ಲಿ,0,0,1,1
27241,ಕಾಮೆಂಟ್‌ಗಳ,0,0,1,1
27238,बढ़ावा,0,0,1,1
27237,мэттьюс,0,0,1,1
27236,மறுத்துரைத்த,0,0,1,1
27184,करेगा,0,0,1,1
27182,élevés,0,0,1,1
27181,agilizar,0,0,1,1
27114,telefônica,0,0,1,1
2927,confermare,1,1,0,1
27131,предположим,0,0,1,1
27130,frivilligt,0,0,1,1
27129,coexistieron,0,0,1,1
27128,schneckenbeispiel,0,0,1,1
27127,fark,0,0,1,1
27126,μπράβο,0,0,1,1
27124,lyden,0,0,1,1
27123,upptäcka,0,0,1,1
27122,concluding,0,0,1,1
27119,предполагающих,0,0,1,1
27118,wunderbar,0,0,1,1
27117,meter,0,0,1,1
27115,lunar,0,0,1,1
27112,wikiwikiwebad,0,0,1,1
27135,потерпи,0,0,1,1
27111,islands,0,0,1,1
27110,rewrite,0,0,1,1
27108,refus,0,0,1,1
27106,प्राधिकारी,0,0,1,1
27105,"है।
हालाँकि",0,0,1,1
27104,étiquettes,0,0,1,1
27102,ಗದ್ದೆ,0,0,1,1
27101,"
tâmil",0,0,1,1
27100,നേരിട്ട്,0,0,1,1
27099,சொற்களில்,0,0,1,1
27098,"
टाटर",0,0,1,1
27097,anlatırsa,0,0,1,1
27094,വിടുകയാണെന്ന്,0,0,1,1
27093,hoch,0,0,1,1
27134,surutilisé,0,0,1,1
27136,റൊട്ടിയുമായി,0,0,1,1
27180,किसने,0,0,1,1
27159,ವಾರಗಳು,0,0,1,1
27177,repetitiva,0,0,1,1
27175,exercício,0,0,1,1
27172,व्यतीत,0,0,1,1
2921,espresse,1,1,0,1
27170,gillar,0,0,1,1
27169,zukünftige,0,0,1,1
2923,pilastri,1,1,0,1
27166,ementas,0,0,1,1
27165,comets,0,0,1,1
27164,actuelles,0,0,1,1
27163,debería,0,0,1,1
27162,sendte,0,0,1,1
27161,எடுத்துக்காட்டில்,0,0,1,1
27160,contenus,0,0,1,1
27157,arkadaşım,0,0,1,1
27138,подтверждает,0,0,1,1
27156,lyckligt,0,0,1,1
27155,editado,0,0,1,1
27154,aziz,0,0,1,1
27152,wikipediaresurser,0,0,1,1
27151,sprecher,0,0,1,1
27150,läsas,0,0,1,1
27148,ಬ್ಯಾಂಕ್‌ಗೆ,0,0,1,1
27147,équatoriale,0,0,1,1
27146,replace,0,0,1,1
2925,elenchi,1,1,0,1
27144,assinatura,0,0,1,1
27143,wesen,0,0,1,1
27142,dilemas,0,0,1,1
27140,bloquea,0,0,1,1
26908,«интервики»ссылки,0,0,1,1
26906,bajada,0,0,1,1
26518,største,0,0,1,1
26656,सामान्य।,0,0,1,1
26649,reclama,0,0,1,1
26650,essayait,0,0,1,1
2984,editoriale,1,1,0,1
26652,arguably,0,0,1,1
26653,anunciaram,0,0,1,1
26655,ijsbrand,0,0,1,1
26657,geistig,0,0,1,1
26620,gränssnitt,0,0,1,1
26659,उठाये,0,0,1,1
26661,மாட்டாள்,0,0,1,1
26664,έκδοση,0,0,1,1
2978,organizzata,1,1,0,1
26667,പരാജയങ്ങൾക്ക്,0,0,1,1
26669,arbetslivserfarenhet,0,0,1,1
26648,yerini,0,0,1,1
26647,almennyttig,0,0,1,1
2985,telegramma,1,1,0,1
26644,baixa,0,0,1,1
2986,soprannominata,1,1,0,1
26640,katıldığını,0,0,1,1
26638,பட்டியலில்,0,0,1,1
26637,وسائل,0,0,1,1
26636,معاملة,0,0,1,1
26635,ultimate,0,0,1,1
26634,الواحد,0,0,1,1
26632,evlenme,0,0,1,1
26630,வளர்ந்தது,0,0,1,1
26627,dagblad,0,0,1,1
26624,إجازة,0,0,1,1
26623,الإذن,0,0,1,1
26622,eu •,0,0,1,1
2976,ore,1,1,0,1
26673,illimité,0,0,1,1
26674,مروع,0,0,1,1
26698,principios,0,0,1,1
26718,máster,0,0,1,1
26717,உத்தியோகபூர்வ,0,0,1,1
26716,പെരുമാറിയ,0,0,1,1
26715,வழங்கிக்,0,0,1,1
26714,παζλ,0,0,1,1
26712,signpost,0,0,1,1
26709,مؤقتًا,0,0,1,1
26708,шумиха,0,0,1,1
26707,ರವಾನಿಸಬಹುದು,0,0,1,1
26705,بمعايير,0,0,1,1
26704,cameron,0,0,1,1
26701,ستفعل,0,0,1,1
26700,ചിലരാകട്ടെ,0,0,1,1
26699,oylamalarına,0,0,1,1
2974,impegno,1,1,0,1
26675,particulier ,0,0,1,1
2975,ea,1,1,0,1
26691,рецензированы,0,0,1,1
26690,पैसा,0,0,1,1
26688,duplicating,0,0,1,1
26687,совокупность,0,0,1,1
26686,controlled,0,0,1,1
26685,يجيب,0,0,1,1
26684,hazırsınız,0,0,1,1
26683,biologists,0,0,1,1
26682,للبنك,0,0,1,1
26681,fortsætter,0,0,1,1
26680,gecultiveerd,0,0,1,1
26679,ശ്രമിക്കുകയായിരുന്നു,0,0,1,1
26676,lt •,0,0,1,1
26621,शराबी,0,0,1,1
26619,franska,0,0,1,1
26905,ಪ್ರವಾಸವನ್ನು,0,0,1,1
26551,نفسها،,0,0,1,1
26543,لوحي,0,0,1,1
26544,डेविड,0,0,1,1
26545,amazed,0,0,1,1
26546,جننت,0,0,1,1
26548,sustained,0,0,1,1
26549,double,0,0,1,1
26552,пытаетесь,0,0,1,1
26618,дело,0,0,1,1
26554,νωρίτερα,0,0,1,1
26555,blackout,0,0,1,1
2997,nate,1,1,0,1
26559,opcional,0,0,1,1
26560,والإيطالية,0,0,1,1
26565,pensait,0,0,1,1
26542,indépendants,0,0,1,1
26540,करेगा।,0,0,1,1
26539,surgem,0,0,1,1
26537,énormément,0,0,1,1
26536,blijf,0,0,1,1
26535,ವಯಸ್ಸಿನ,0,0,1,1
26532,கேள்விப்பட்டிருக்கிறீர்கள்,0,0,1,1
26531,complet,0,0,1,1
26529,definan,0,0,1,1
26528,ಇಬ್ಬರೂ,0,0,1,1
26527,sekiz,0,0,1,1
26526,முயற்சிக்கு,0,0,1,1
26525,läroböcker,0,0,1,1
26523,sucesivos,0,0,1,1
26521,signs,0,0,1,1
26520,تحديد,0,0,1,1
26519,iletişimde,0,0,1,1
26566,tolereras,0,0,1,1
26568,towards,0,0,1,1
26569,സ്വാതന്ത്ര്യമില്ല,0,0,1,1
26595,redigido,0,0,1,1
26617,смотрел,0,0,1,1
26615,பஸ்,0,0,1,1
26614,الاسم,0,0,1,1
26613,vía,0,0,1,1
26612,kırptı,0,0,1,1
26610,தம்மிடையேயான,0,0,1,1
26609,êxtase,0,0,1,1
26607,أدى,0,0,1,1
26605,تسوية,0,0,1,1
26604,للتنفس,0,0,1,1
26603,rotord,0,0,1,1
26602,uttal,0,0,1,1
26599,impresión,0,0,1,1
26596,yüzüme,0,0,1,1
26593,desconcertaron,0,0,1,1
26570,حافزًا,0,0,1,1
26589,शायरियां,0,0,1,1
26587,bære,0,0,1,1
26585,participative,0,0,1,1
26584,kommentere,0,0,1,1
26582,لوصف,0,0,1,1
26581,tilskynder,0,0,1,1
2995,riuscito,1,1,0,1
26579,beeldmateriaal,0,0,1,1
26577,bat,0,0,1,1
26576,பயனர்களும்,0,0,1,1
26574,hakaretlere,0,0,1,1
26573,trovärdig,0,0,1,1
26572,ужасном,0,0,1,1
26571,eneste,0,0,1,1
26719,основным,0,0,1,1
26720,mature,0,0,1,1
26721,publiquement,0,0,1,1
26844,zihinsel,0,0,1,1
26837,ediyordum,0,0,1,1
26838,تنحاز,0,0,1,1
26839,longstanding,0,0,1,1
26840,medewerker,0,0,1,1
26841,துறையில்,0,0,1,1
26843,நகலெடுக்க,0,0,1,1
26845,yalnızca,0,0,1,1
26722,inc —,0,0,1,1
26846,поддерживаемые,0,0,1,1
26848,transclusão,0,0,1,1
26849,современных,0,0,1,1
26851,മറക്കുന്നു,0,0,1,1
26855,dens,0,0,1,1
26856,περιγράψετε,0,0,1,1
26836,diminishing,0,0,1,1
26835,"
स्लोवेनियाई",0,0,1,1
26834,χρυσές,0,0,1,1
2961,sognato,1,1,0,1
26832,улиток,0,0,1,1
26830,ഇവിടെയെത്തി,0,0,1,1
26829,arbetar,0,0,1,1
26828,ಅತೃಪ್ತಿಯನ್ನು,0,0,1,1
26826,deren,0,0,1,1
26825,ಕುಳಿತುಕೊಳ್ಳುವ,0,0,1,1
26824,exponencialmente,0,0,1,1
26823,преданная,0,0,1,1
26822,பொறுமையாகவும்,0,0,1,1
26821,سانجر،,0,0,1,1
26820,afirmando,0,0,1,1
26819,помещаю,0,0,1,1
2962,sbagliato»,1,1,0,1
26857,αναφοράς,0,0,1,1
26859,തിരുത്തലുകളോട്,0,0,1,1
26860,புகழ்பெற்ற,0,0,1,1
26885,adotada,0,0,1,1
26904,tanınıyor,0,0,1,1
26903,lecture,0,0,1,1
26902,ಪ್ರಶ್ನೆಗಳಿಗೆ,0,0,1,1
26900,robijnrode,0,0,1,1
26897,repente,0,0,1,1
26896,расположенных,0,0,1,1
26895,അതിശയകരമായത്,0,0,1,1
26894,especificados,0,0,1,1
26892,wikimini,0,0,1,1
2958,riscontrabili,1,1,0,1
26890,temporarily,0,0,1,1
26889,عالية,0,0,1,1
26887,kunskaper,0,0,1,1
26886,kafaları,0,0,1,1
26883,spegeln,0,0,1,1
26861,وصيغة,0,0,1,1
26882,εθελοντές,0,0,1,1
26881,einkaufszentrum,0,0,1,1
26880,matchen,0,0,1,1
2959,venduta,1,1,0,1
26877,μάθημα,0,0,1,1
26876,belonged,0,0,1,1
26875,preferindo,0,0,1,1
26871,vaud,0,0,1,1
26869,coordinate,0,0,1,1
26867,sendes,0,0,1,1
26866,считает,0,0,1,1
26865,കർഷകൻ,0,0,1,1
26864,preferences,0,0,1,1
26862,ನೀಡುತ್ತಿದೆ,0,0,1,1
26816,wapsidor,0,0,1,1
26815,tirar,0,0,1,1
26814,كلمتك,0,0,1,1
26746,കോണാണ്,0,0,1,1
26762,ಕೇಳಬಹುದು,0,0,1,1
26760,kød,0,0,1,1
26758,ax,0,0,1,1
26757,நடத்தை,0,0,1,1
26756,repasse,0,0,1,1
26755,परिभाषायें,0,0,1,1
26754,ridge,0,0,1,1
26753,serres,0,0,1,1
26752,parisnanterre,0,0,1,1
26751,definerer,0,0,1,1
2969,offerta,1,1,0,1
26749,gefängnissen,0,0,1,1
26748,считать,0,0,1,1
26747,évoluent,0,0,1,1
26742,sneezed,0,0,1,1
26768,katılım,0,0,1,1
26741,representante,0,0,1,1
26740,abraçar,0,0,1,1
26738,annoncer,0,0,1,1
2971,sguardi,1,1,0,1
26736,sabatier,0,0,1,1
2972,mattina,1,1,0,1
26734,ஆண்டுகளாக,0,0,1,1
26732,ഉദ്യമമായി,0,0,1,1
26731,இயல்பாக,0,0,1,1
26727,viens,0,0,1,1
26726,κανένα,0,0,1,1
26725,capacidad,0,0,1,1
26724,sökmotorer,0,0,1,1
26723,சொற்களின்,0,0,1,1
26765,الحاسوب,0,0,1,1
26769,prinzen,0,0,1,1
26813,müstakbel,0,0,1,1
26793,chair,0,0,1,1
26812,установил,0,0,1,1
2963,logico,1,1,0,1
26810,varlıklardı,0,0,1,1
26809,implementaciones,0,0,1,1
26807,costumes,0,0,1,1
26806,продолжим,0,0,1,1
26805,accélération,0,0,1,1
26804,гриффитом,0,0,1,1
26800,deviendra,0,0,1,1
26799,സാധിക്കും,0,0,1,1
26798,पुस्तकें,0,0,1,1
26797,damaging,0,0,1,1
26796,improvements,0,0,1,1
26794,fr •,0,0,1,1
26792,çoğalmıştır,0,0,1,1
26770,εγχειρίδια,0,0,1,1
2964,discrepanza,1,1,0,1
26788,إطلاقه,0,0,1,1
26787,traditionellt,0,0,1,1
26785,kullanabilirler,0,0,1,1
26784,разочарованием,0,0,1,1
5653,ಅನುಭವವನ್ನು,0,0,1,1
26780,høfligt,0,0,1,1
26779,korku,0,0,1,1
26778,opsummeringer,0,0,1,1
2965,troppe,1,1,0,1
26776,dedicaba,0,0,1,1
2966,fratelli,1,1,0,1
26774,редактируемой,0,0,1,1
26771,exato,0,0,1,1
25731,netter,0,0,1,1
25729,critiquée,0,0,1,1
27279,izing,0,0,1,1
24685,தந்திரமான,0,0,1,1
24675,classificação,0,0,1,1
24679,ಸೈನ್ಯವು,0,0,1,1
24680,tollen,0,0,1,1
24682,വിശദീകരിക്കുന്ന,0,0,1,1
3238,aggiornata,1,1,0,1
24684,विवरण,0,0,1,1
3235,scientifici,1,1,0,1
24647,विज्ञापनदाता,0,0,1,1
24687,existían,0,0,1,1
24688,απαραίτητοι,0,0,1,1
24689,ಕೇಳುತ್ತೇನೆ,0,0,1,1
24690,qu’on,0,0,1,1
24691,assustador,0,0,1,1
24692,संज्ञाओं,0,0,1,1
24673,sparkly,0,0,1,1
24672,isteyebilirim,0,0,1,1
24671,متحمسون,0,0,1,1
24669,cheaper,0,0,1,1
24668,initiatieven,0,0,1,1
24667,രുചിയുടെ,0,0,1,1
24666,iluminação,0,0,1,1
24665,mcculloch,0,0,1,1
24664,jaren,0,0,1,1
24663,l’accent,0,0,1,1
24662,തർക്ക,0,0,1,1
24661,decade,0,0,1,1
24659,blanket,0,0,1,1
24655,सुविचारित,0,0,1,1
24654,الدروس,0,0,1,1
24653,ajude,0,0,1,1
24650,упоминай,0,0,1,1
24693,நகைச்சுவையைச்,0,0,1,1
24694,abertos,0,0,1,1
24695,internetanvändare,0,0,1,1
24718,"
वर्तमान",0,0,1,1
3229,locali,1,1,0,1
3230,aggiudica,1,1,0,1
24731,attribuent,0,0,1,1
24730,voulezvous,0,0,1,1
3231,vicina,1,1,0,1
24728,adivinara,0,0,1,1
24727,correto,0,0,1,1
24725,ലഭ്യമായാൽ,0,0,1,1
24724,estompée,0,0,1,1
24723,வழமையாக,0,0,1,1
3232,informato,1,1,0,1
24721,चाइना,0,0,1,1
24720,importância,0,0,1,1
24719,ചേർക്കാനാണ്,0,0,1,1
24717,öğreniyorsan,0,0,1,1
24696,ليلة,0,0,1,1
24716,obviamente,0,0,1,1
3233,dollari,1,1,0,1
24713,tornarse,0,0,1,1
24712,रचना,0,0,1,1
24711,snapte,0,0,1,1
24710,utgivare,0,0,1,1
24707,зайдите,0,0,1,1
24706,forskningsciteringar,0,0,1,1
24705,sevmesiydi,0,0,1,1
24704,занимала,0,0,1,1
24703,கூட்டாக்க,0,0,1,1
24702,аннотируя,0,0,1,1
24701,σκεφτώ,0,0,1,1
24699,souvenezvous,0,0,1,1
24648,പുറമേ,0,0,1,1
24645,संयुक्त,0,0,1,1
24736,குறுக்கிடுகிறது,0,0,1,1
24591,отмечая,0,0,1,1
24585,argumentó,0,0,1,1
24586,немецкая —,0,0,1,1
3244,adottato,1,1,0,1
24588,‘குழுச்,0,0,1,1
24589,benaderen,0,0,1,1
24590,concentrated,0,0,1,1
24592,parar,0,0,1,1
24644,காரியத்தைச்,0,0,1,1
24593,தெரிவிப்பதன்,0,0,1,1
3243,costruisce,1,1,0,1
24596,بمصادر,0,0,1,1
24597,genus,0,0,1,1
24598,"
क्या",0,0,1,1
24599,überstrapaziertes,0,0,1,1
24584,convaincre,0,0,1,1
24583,örnekler,0,0,1,1
24582,ತುಂಬಿಸಲು,0,0,1,1
24581,updates,0,0,1,1
24580,höra,0,0,1,1
24579,"
दूसरे",0,0,1,1
24578,kullanıcıları,0,0,1,1
24576,ಕೆಳಕ್ಕೆ,0,0,1,1
24575,يو,0,0,1,1
24574,bètawetenschapper,0,0,1,1
24572,discute,0,0,1,1
24571,listed,0,0,1,1
24570,espirrou,0,0,1,1
3246,lavora,1,1,0,1
24568,विकिपीडिया।,0,0,1,1
24567,قولها,0,0,1,1
24565,прошлой,0,0,1,1
24601,utrolige,0,0,1,1
24603,amendment,0,0,1,1
24604,basura,0,0,1,1
24623,تنطبق,0,0,1,1
24643,licenciado,0,0,1,1
24642,വെള്ളിയാഴ്ചയാണെന്ന്,0,0,1,1
24641,appreciation,0,0,1,1
24639,sammanhållande,0,0,1,1
24638,വിടപറഞ്ഞു,0,0,1,1
3239,riprenditi,1,1,0,1
24635,обама,0,0,1,1
24632,अर्स,0,0,1,1
24631,paper,0,0,1,1
24630,norteamericana,0,0,1,1
24628,ദീർഘനേരം,0,0,1,1
24627,αυτοί,0,0,1,1
24625,viejo,0,0,1,1
24624,ഭയന്ന്,0,0,1,1
24622,எளிதில்,0,0,1,1
24605,«срезать,0,0,1,1
3240,vocabolari,1,1,0,1
24620,गले,0,0,1,1
24619,waved,0,0,1,1
24618,personnellement,0,0,1,1
24617,associadas,0,0,1,1
24616,பேசலாம்,0,0,1,1
3241,foresta,1,1,0,1
24614,αναστατωθεί,0,0,1,1
3242,riscoperta,1,1,0,1
24610,guldbrødet,0,0,1,1
24609,gratuitamente,0,0,1,1
24608,इनके,0,0,1,1
24607,ಭಾವಿಸುವ,0,0,1,1
24606,وعملت,0,0,1,1
24735,metamorphosed,0,0,1,1
24739,opposing,0,0,1,1
25727,betrat,0,0,1,1
24869,போகிறதென்றால்,0,0,1,1
24858,मीठी,0,0,1,1
24861,cultiver,0,0,1,1
24862,ονειρεμένη,0,0,1,1
24863,innehållsdrivet,0,0,1,1
24864,ಪ್ರತಿಕ್ರಿಯಿಸಲು,0,0,1,1
24865,биологических,0,0,1,1
24870,பதிப்பில்,0,0,1,1
24836,администраторов,0,0,1,1
24872,autocensuró,0,0,1,1
24873,വേർതിരിക്കുന്നത്,0,0,1,1
3213,concerto,1,1,0,1
3212,partite,1,1,0,1
24877,sloot,0,0,1,1
24878,чьюлибо,0,0,1,1
24857,remplazada,0,0,1,1
24856,classificatie,0,0,1,1
24855,क्रियाओं,0,0,1,1
24854,राजस्व,0,0,1,1
24853,avoided,0,0,1,1
3215,esplora,1,1,0,1
24850,språkversionen,0,0,1,1
24849,وفَر,0,0,1,1
3216,bicchiere,1,1,0,1
24846,பயனரின்,0,0,1,1
24845,τρομερή,0,0,1,1
24844,dedikerede,0,0,1,1
24843,நபருக்கு,0,0,1,1
24841,ناقدة,0,0,1,1
24840,ಸುದ್ದಿ,0,0,1,1
24839,முன்னதான,0,0,1,1
24838,सातवीं,0,0,1,1
24879,crosses,0,0,1,1
24880,сборы,0,0,1,1
24881,computertijdschrift,0,0,1,1
24901,hardly,0,0,1,1
3204,invito,1,1,0,1
24922,لدراسة,0,0,1,1
24921,grusomme,0,0,1,1
24920,ilustrador,0,0,1,1
24918,procure,0,0,1,1
24917,इट,0,0,1,1
24916,രണ്ടോ,0,0,1,1
24912,नाराज,0,0,1,1
24911,पहुँचने,0,0,1,1
24910,மீறல்,0,0,1,1
24909,என்பதில்,0,0,1,1
24908,diretivo,0,0,1,1
24907,ತಪ್ಪಾದ,0,0,1,1
24904,ಮುಳುಗಿಸುವುದು,0,0,1,1
24900,произошло,0,0,1,1
3211,aiuteresti,1,1,0,1
24899,försiktighet,0,0,1,1
24898,"
bengali",0,0,1,1
3209,redistribuzione,1,1,0,1
24894,दिशानिर्देश,0,0,1,1
24892,പരിഹാരത്തിനുപകരം,0,0,1,1
24891,ಕಾರ್ಯನಿರ್ವಹಿಸದಿದ್ದರೆ,0,0,1,1
24890,aufnehmen,0,0,1,1
3210,rotto,1,1,0,1
24888,ocurriendo,0,0,1,1
24887,applikationer,0,0,1,1
24886,accesses,0,0,1,1
24885,tritt,0,0,1,1
24884,വിതരണം,0,0,1,1
24883,interrogação,0,0,1,1
24837,поддельному,0,0,1,1
24835,inkl,0,0,1,1
24740,القاسي,0,0,1,1
24776,localizado,0,0,1,1
24765,கணிப்பிடும்,0,0,1,1
24766,integrated,0,0,1,1
24767,إتش,0,0,1,1
3227,moglie,1,1,0,1
24769,ചെയ്യപ്പെട്ടു,0,0,1,1
24773,produits,0,0,1,1
24777,trouvé,0,0,1,1
24833,rommelig,0,0,1,1
24778,udsigt,0,0,1,1
24780,spaces,0,0,1,1
24781,exploitent,0,0,1,1
24782,φόβος,0,0,1,1
24784,разрешающими,0,0,1,1
24785,asırlardır,0,0,1,1
24764,gülümsemesini,0,0,1,1
24761,качаешься,0,0,1,1
24759,πάρτι,0,0,1,1
24758,धारणा,0,0,1,1
24756,feliciteren,0,0,1,1
24753,اختصاص،,0,0,1,1
24752,يعانون,0,0,1,1
24751,press,0,0,1,1
24750,rewards,0,0,1,1
24749,вежливо,0,0,1,1
24748,activitésréf,0,0,1,1
24747,माफी,0,0,1,1
24746,இருந்தனர்,0,0,1,1
24745,أخفيه,0,0,1,1
24744,ಒಪ್ಪಿಕೊಳ್ಳುತ್ತೇನೆ,0,0,1,1
24743,अस्थिर,0,0,1,1
24742,مجلدًا,0,0,1,1
24787,старых,0,0,1,1
24788,развитие,0,0,1,1
24789,smakprov,0,0,1,1
3222,"
stiamo",1,1,0,1
24832,discussions etc,0,0,1,1
24831,счастливым,0,0,1,1
3217,vivente,1,1,0,1
24828,instruções,0,0,1,1
24827,"
अफ़्रीकान्स",0,0,1,1
3219,insindacabile,1,1,0,1
3220,bagno,1,1,0,1
24824,совершённое,0,0,1,1
24823,  voitures,0,0,1,1
24822,ಅಂತಹ,0,0,1,1
24821,gütmeyen,0,0,1,1
24820,καλιφόρνια,0,0,1,1
24817,forskares,0,0,1,1
24815,संवेदनशीलता,0,0,1,1
24813,تشكر,0,0,1,1
24791,tackling,0,0,1,1
24811,സുന്ദരനാണെന്ന്,0,0,1,1
24810,инструкции,0,0,1,1
24809,afternoon,0,0,1,1
24808,അൽഗോരിതം,0,0,1,1
24807,queixa,0,0,1,1
24806,decentralizes,0,0,1,1
24804,específica,0,0,1,1
3224,addirittura,1,1,0,1
24802,pleures,0,0,1,1
24801,എടുക്കുന്നു,0,0,1,1
24797,—por,0,0,1,1
24796,olhando,0,0,1,1
24794,bagunçado,0,0,1,1
24793,உறுதிப்படுத்தப்படாத,0,0,1,1
24564,agraciada,0,0,1,1
3248,unica,1,1,0,1
24559,ಯಾವುವು,0,0,1,1
24294,denuncia,0,0,1,1
24284,applicable,0,0,1,1
24285,épaisse,0,0,1,1
24286,herói,0,0,1,1
24287,ഡൈനിംഗ്,0,0,1,1
3284,frammentazione,1,1,0,1
24293,мнению,0,0,1,1
24298,verklaring,0,0,1,1
24259,معروف,0,0,1,1
24299,citizens,0,0,1,1
24301,പഞ്ചാബി,0,0,1,1
24302,ಮೀರಿ,0,0,1,1
3281,consigliate,1,1,0,1
24307,उबाऊ,0,0,1,1
24308,ನಿಯಮಗಳನ್ನು,0,0,1,1
24283,presenterats,0,0,1,1
24282,вялости,0,0,1,1
24281,asombrosa,0,0,1,1
24280,bid,0,0,1,1
24279,assemblée,0,0,1,1
24278,ಹುಡುಗರಲ್ಲಿ,0,0,1,1
24276,henüz,0,0,1,1
24275,sencillo,0,0,1,1
24274,"jpdk
",0,0,1,1
24273,"
बास्क",0,0,1,1
24271,ആചാരങ്ങളാൽ,0,0,1,1
24270,enfocada,0,0,1,1
24268,सह,0,0,1,1
24265,stond,0,0,1,1
24264,التأكيد,0,0,1,1
24263,aangeboden,0,0,1,1
24261,instantanément,0,0,1,1
24310,ayudarte,0,0,1,1
3278,linguistica,1,1,0,1
3277,beneficiato,1,1,0,1
24337,ಕಣ್ಣು,0,0,1,1
24356,webcomic,0,0,1,1
24355,nda,0,0,1,1
24353,zoekopdracht,0,0,1,1
24352,thereby,0,0,1,1
24351,попросить,0,0,1,1
24350,mestre,0,0,1,1
24349,اثنا,0,0,1,1
24347,théorique…,0,0,1,1
24346,folga,0,0,1,1
24345,embarcar,0,0,1,1
24341,എന്നതിനാൽ,0,0,1,1
24340,anulada,0,0,1,1
24339,അതിശയകരമായിരിക്കും,0,0,1,1
24338,"
विष्णुप्रिया",0,0,1,1
24336,ಸುತ್ತುವ,0,0,1,1
3275,intenzionale,1,1,0,1
24334,tratados,0,0,1,1
24333,yarayacağını,0,0,1,1
24332,فلماذا,0,0,1,1
24330,ದೇವದೂತರೊಂದಿಗೆ,0,0,1,1
24329,frecuencia,0,0,1,1
24328,kitabınızı,0,0,1,1
24326,voluntariamente,0,0,1,1
24324,abouti,0,0,1,1
24322,விருப்பமான,0,0,1,1
24320,تخبره,0,0,1,1
24319,يتحرك,0,0,1,1
24318,yokmuş,0,0,1,1
24317,trabalhado,0,0,1,1
24315,hayranlarının,0,0,1,1
3287,lievi,1,1,0,1
24257,sjunker,0,0,1,1
3251,potrà,1,1,0,1
24201,запрашивая,0,0,1,1
24192,"സമൂഹമാണ്
വിക്കിപീഡിയരുടേത്",0,0,1,1
24193,wikiprojeto,0,0,1,1
3305,ridere,1,1,0,1
24195,boursier ,0,0,1,1
24197,piensas,0,0,1,1
3304,sopravvissuta»,1,1,0,1
24202,तिमाही,0,0,1,1
24256,μαρμελάδες,0,0,1,1
24203,acheté,0,0,1,1
24204,overeenkomstige,0,0,1,1
24205,tillfälligt,0,0,1,1
24206,surrounded,0,0,1,1
24207,മെയ്,0,0,1,1
24208,பகுதியில்,0,0,1,1
24191,miroir,0,0,1,1
24190,упомянули,0,0,1,1
24189,clasificarse,0,0,1,1
24188,echte,0,0,1,1
24186,—wikipedia—,0,0,1,1
24183,händelser,0,0,1,1
3306,magico,1,1,0,1
24181,cometidos,0,0,1,1
24180,plötzlich,0,0,1,1
24179,ഉപജ്ഞാതാവ്,0,0,1,1
24178,gefällt,0,0,1,1
24177,dillerde,0,0,1,1
24174,interessant,0,0,1,1
24173,σταθερά,0,0,1,1
3307,eccoti,1,1,0,1
24171,sesin,0,0,1,1
24169,பொறி,0,0,1,1
24209,voudrait,0,0,1,1
24210,expressou,0,0,1,1
24211,skolarbete,0,0,1,1
24234,കാണിക്കാൻ,0,0,1,1
3288,credere,1,1,0,1
3289,esistiti,1,1,0,1
24252,идеологической,0,0,1,1
24251,widersprüchliche,0,0,1,1
24250,råka,0,0,1,1
24249,istemediğimde,0,0,1,1
3291,condivisi,1,1,0,1
24244,guy,0,0,1,1
24243,ഹലോ,0,0,1,1
3292,ridistribuirli,1,1,0,1
3293,bilico,1,1,0,1
24240,lendo,0,0,1,1
3294,preparati,1,1,0,1
24235,балкона,0,0,1,1
24232,escribe,0,0,1,1
24213,probable,0,0,1,1
24230,kabuğumun,0,0,1,1
24229,предложениям,0,0,1,1
3296,frequenza,1,1,0,1
24226,खरीदा,0,0,1,1
24225,«activas»,0,0,1,1
3297,sorta,1,1,0,1
24221,stötande,0,0,1,1
3298,supporti,1,1,0,1
24219,övergav,0,0,1,1
24218,twenty,0,0,1,1
3299,sposa,1,1,0,1
24216,επιβάλλουν,0,0,1,1
24215,चिड़िया,0,0,1,1
3301,diventata,1,1,0,1
3273,scusi,1,1,0,1
24359,spontanément,0,0,1,1
24360,ಕಾಣಿಸುತ್ತಿದ್ದಳು,0,0,1,1
24492,« lois »,0,0,1,1
24485,kadın,0,0,1,1
24486,руководствам,0,0,1,1
24487,konudaki,0,0,1,1
24489,avisam,0,0,1,1
3259,sorgono,1,1,0,1
24491,sends,0,0,1,1
24493,pointofview,0,0,1,1
24361,प्लेट,0,0,1,1
24494,பதிவுசெய்த,0,0,1,1
24495,поставлена,0,0,1,1
24497,inferencial,0,0,1,1
3258,diresse,1,1,0,1
3257,portando,1,1,0,1
24501,ağlayarak,0,0,1,1
24484,côtés,0,0,1,1
24482,curtir,0,0,1,1
24478,natureculture,0,0,1,1
24477,популярность,0,0,1,1
24476,animada,0,0,1,1
24475,кластеры,0,0,1,1
24474,விக்கிப்பீடியாவுக்கு,0,0,1,1
24473,abonnementsknappen,0,0,1,1
24472,база,0,0,1,1
24470,செயற்படுகிறது,0,0,1,1
24468,ஐ,0,0,1,1
24467,fundamentais,0,0,1,1
24466,показывает,0,0,1,1
24465,klonen,0,0,1,1
24464,scientology,0,0,1,1
24463,worthy,0,0,1,1
24461,grafías,0,0,1,1
24505,редакционных,0,0,1,1
24507,медицине,0,0,1,1
24511,придумал,0,0,1,1
24537,confidence,0,0,1,1
24557,relicenciar,0,0,1,1
24555,chinois ,0,0,1,1
24554,примерно,0,0,1,1
24553,centralt,0,0,1,1
24551,inexperientes,0,0,1,1
24550,ತೊಂದರೆಗೊಳಗಾಗಿದ್ದೇನೆ,0,0,1,1
24547,yakutların,0,0,1,1
24546,visités,0,0,1,1
24544,تشاركها,0,0,1,1
24542,funcionalidades,0,0,1,1
24541,collecte,0,0,1,1
24540,നാർസിസിന്റെ,0,0,1,1
24539,سابق,0,0,1,1
24538,ودقتها,0,0,1,1
24536,lithify,0,0,1,1
24513,uz •,0,0,1,1
24534,ಹೇಗಿದ್ದೀರಿ,0,0,1,1
24531,"
इस्परान्तो",0,0,1,1
24530,منخفضة,0,0,1,1
24529,publicerats,0,0,1,1
24526,blanda,0,0,1,1
24525,philosophiques,0,0,1,1
24523,aner,0,0,1,1
24522,souple,0,0,1,1
24521,influencées,0,0,1,1
24519,لمقالة،,0,0,1,1
24518,judicial,0,0,1,1
24517,கொண்டிருந்தாலும்,0,0,1,1
3255,piano,1,1,0,1
24515,المحتوى،,0,0,1,1
24460,persistent,0,0,1,1
24459,بالقرب,0,0,1,1
24458,internetbaserede,0,0,1,1
24388,закончится,0,0,1,1
24410,maalesef,0,0,1,1
24407,दिखता,0,0,1,1
24406,toetsing,0,0,1,1
24405,willemalexander,0,0,1,1
24404,حركة,0,0,1,1
24402,skillnaden,0,0,1,1
24400,reporting,0,0,1,1
24399,والجدال,0,0,1,1
24397,используя,0,0,1,1
24396,eğilimindeyiz,0,0,1,1
24395,διασχίζετε,0,0,1,1
24392,grusomt,0,0,1,1
24390,மனமார்ந்த,0,0,1,1
24389,reichtümer,0,0,1,1
3268,animale,1,1,0,1
24413,സിന്ധൂനദീതടസംസ്കാരം,0,0,1,1
24385,ബട്ടണും,0,0,1,1
24380,sizes,0,0,1,1
24379,anonymity,0,0,1,1
24376,fortsætte,0,0,1,1
24375,—aunque,0,0,1,1
24373,traditionnelle,0,0,1,1
24372,വസ്ത്രധാരണത്തിൽ,0,0,1,1
3269,sfruttando,1,1,0,1
24370,ಉತ್ತರಿಸಲು,0,0,1,1
3270,migliora,1,1,0,1
24368,άλλους,0,0,1,1
24367,роб,0,0,1,1
24363,chamou,0,0,1,1
24362,डूबने,0,0,1,1
24412,дартмутского,0,0,1,1
24414,níveis,0,0,1,1
3260,stabilite,1,1,0,1
24438,والنزاعات,0,0,1,1
24456,paradigms,0,0,1,1
24455,ഭാഗ്യത്തിന്റെ,0,0,1,1
3261,imparziale,1,1,0,1
24452,pangaea,0,0,1,1
24451,indirilmesi,0,0,1,1
24450,concluent,0,0,1,1
3262,sovrappone,1,1,0,1
24448,librei,0,0,1,1
24445,d’attribuer,0,0,1,1
24444,narsizaya,0,0,1,1
24443,erstaunlicher,0,0,1,1
3263,collegamento,1,1,0,1
24440,reter,0,0,1,1
24439,voortbestaan,0,0,1,1
3264,fitness,1,1,0,1
24415,sinnet,0,0,1,1
24430,embaixo,0,0,1,1
24428,objektif,0,0,1,1
3265,spazi,1,1,0,1
24426,oud,0,0,1,1
24425,operation,0,0,1,1
24424,ലൈക്ക്,0,0,1,1
24423,vanmorgen,0,0,1,1
24422,zamanlar,0,0,1,1
24421,வியப்படைந்தாள்,0,0,1,1
24420,chefe,0,0,1,1
24419,μιλήσεις,0,0,1,1
24418,deadnames,0,0,1,1
24417,familie,0,0,1,1
24416,yazdım,0,0,1,1
24925,νερό,0,0,1,1
24926,gehirn,0,0,1,1
3202,funziona,1,1,0,1
25461,antworten,0,0,1,1
25449,maastricht,0,0,1,1
25452,veelvoorkomend,0,0,1,1
25454,fastnar,0,0,1,1
25455,kaydı,0,0,1,1
25456,встречаетесь,0,0,1,1
25457,röportajda,0,0,1,1
25462,ಶುಕ್ರವಾರ,0,0,1,1
25420,ಕಾಣುತ್ತಿದ್ದರು,0,0,1,1
25463,reemplazada,0,0,1,1
25464,ആക്യുറസി,0,0,1,1
3136,teorica,1,1,0,1
25467,τρόποι,0,0,1,1
3135,sgarbatamente,1,1,0,1
25469,zümrüt,0,0,1,1
25448,"
कॉर्सिकाई",0,0,1,1
25447,சந்தித்ததில்,0,0,1,1
25446,spijker,0,0,1,1
25445,sattığını,0,0,1,1
25444,trubbiga,0,0,1,1
25443,تنتشر,0,0,1,1
25442,concluyó,0,0,1,1
25441,çabası,0,0,1,1
25437,desconcertar,0,0,1,1
25432,ചുവന്ന,0,0,1,1
25431,तीनों,0,0,1,1
25430,произведённых,0,0,1,1
25429,miré,0,0,1,1
25426,borrado,0,0,1,1
25425,divertido,0,0,1,1
3143,microfono,1,1,0,1
25422,இருங்கள்,0,0,1,1
25470,collagen,0,0,1,1
25471,concluait,0,0,1,1
25472,വ്യാകരണം,0,0,1,1
25507,estuve,0,0,1,1
25529,realizó,0,0,1,1
25526,பார்ப்பேன்,0,0,1,1
25524,سأغادر,0,0,1,1
25522,тяжелый,0,0,1,1
25519,указывают,0,0,1,1
25518,masturbação,0,0,1,1
25517,başbakanı,0,0,1,1
3129,diceva,1,1,0,1
25514,ದೌರ್ಜನ್ಯದ,0,0,1,1
25513,cream,0,0,1,1
25512,διαμάντια,0,0,1,1
25511,शूट,0,0,1,1
25509,zoophilia,0,0,1,1
25508,implementation,0,0,1,1
25503,உங்களுக்குச்,0,0,1,1
25473,messager,0,0,1,1
25502,trouvant,0,0,1,1
25501,beğen,0,0,1,1
25495,escritor,0,0,1,1
25494,blokere,0,0,1,1
25492,définit,0,0,1,1
25491,формул,0,0,1,1
25489,s’avérer,0,0,1,1
25488,बालकनी,0,0,1,1
25487,nueva,0,0,1,1
25486,filtrera,0,0,1,1
25483,farine,0,0,1,1
25481,चीज़,0,0,1,1
25477,ಕ್ಯಾಸಲ್,0,0,1,1
25476,galardones,0,0,1,1
25421,"
बवारियाई",0,0,1,1
25417,unuturlar,0,0,1,1
25323,कराते,0,0,1,1
25361,للحواسيب,0,0,1,1
25352,tercera,0,0,1,1
25355,avsluta,0,0,1,1
25356,segredo,0,0,1,1
25357,riesgos,0,0,1,1
3158,sposarmi,1,1,0,1
25359,uzatır,0,0,1,1
25362,judiciaire…,0,0,1,1
25415,കണ്ടെത്തും,0,0,1,1
25364,formu,0,0,1,1
25365,sorabileceğin,0,0,1,1
25366,configuration,0,0,1,1
25367,emnet,0,0,1,1
25368,kitaplarda,0,0,1,1
3156,castello,1,1,0,1
25351,electric,0,0,1,1
25350,equivocadas,0,0,1,1
25349,feces,0,0,1,1
25348,carbonandwaterbased,0,0,1,1
25347,engelskspråkigt,0,0,1,1
3160,distribuendo,1,1,0,1
25343,побудило,0,0,1,1
25342,போலவும்,0,0,1,1
25341,ദിനപത്രങ്ങളാണ്,0,0,1,1
25340,hot,0,0,1,1
25339,typographic,0,0,1,1
25338,मनोरंजक,0,0,1,1
25335,அவதூறான,0,0,1,1
25332,распределённую,0,0,1,1
25331,मिशन,0,0,1,1
3162,wikiwikiweb,1,1,0,1
25325,estúpido,0,0,1,1
25371,पड़ा,0,0,1,1
25372,​​அவர்,0,0,1,1
25373,uitpraten,0,0,1,1
25396,يخضع,0,0,1,1
3145,pone,1,1,0,1
25412,sheets,0,0,1,1
25410,ضعيف,0,0,1,1
25408,സ്ഥലത്തെ,0,0,1,1
25407,involving,0,0,1,1
3147,ipertestuali,1,1,0,1
25405,kant,0,0,1,1
25404,проверить,0,0,1,1
3148,dinamici,1,1,0,1
25402,لكى,0,0,1,1
25401,vergessen,0,0,1,1
3149,prescindere,1,1,0,1
25399,türban,0,0,1,1
25397,оценка,0,0,1,1
25395,étiquetées,0,0,1,1
25374,inconsistência,0,0,1,1
25394,recherches,0,0,1,1
3153,offensivo,1,1,0,1
25389,settle,0,0,1,1
3155,cellulari,1,1,0,1
25386,सात,0,0,1,1
25383,sorundan,0,0,1,1
25382,nicer,0,0,1,1
25381,verenigd,0,0,1,1
25380,fart,0,0,1,1
25379,iescgeekcorpsmali,0,0,1,1
25378,sodass,0,0,1,1
25377,الفيضان,0,0,1,1
25376,выходящие,0,0,1,1
25375,viam,0,0,1,1
25535,سمعته,0,0,1,1
25536,алгоритмы,0,0,1,1
25537,reír,0,0,1,1
25670,plagiering,0,0,1,1
25664,kişilerden,0,0,1,1
25665,മുറിച്ചുകടക്കുമെന്നും,0,0,1,1
25666,consultar,0,0,1,1
25667,классифицирующий,0,0,1,1
3111,incontri,1,1,0,1
25669,தட்டச்சு,0,0,1,1
25672,adn,0,0,1,1
25538,«рандеву»,0,0,1,1
25673,دعم,0,0,1,1
25674,codes,0,0,1,1
25675,cubierto,0,0,1,1
25677,wochen,0,0,1,1
25678,കൊടുത്തിരുന്ന,0,0,1,1
25679,صخرة,0,0,1,1
25663,rencontré,0,0,1,1
25662,ಚೂಪಾದವು,0,0,1,1
25661,κολλήσετε,0,0,1,1
25660,помогать,0,0,1,1
25657,بالو,0,0,1,1
25656,dialectos,0,0,1,1
25653,войск,0,0,1,1
25652,verdrink,0,0,1,1
25651,teller,0,0,1,1
3113,temi,1,1,0,1
25644,الإجابة,0,0,1,1
25643,odf,0,0,1,1
25640,friedrich,0,0,1,1
25639,botste,0,0,1,1
25638,européens,0,0,1,1
25636,ಆಟದ,0,0,1,1
25635,getroffen,0,0,1,1
25680,fusão,0,0,1,1
3110,simulare,1,1,0,1
25685,adil,0,0,1,1
25705,élaboré,0,0,1,1
25725,mécanismes,0,0,1,1
25723,hábil,0,0,1,1
25720,ബന്ധിപ്പിക്കുന്നു,0,0,1,1
25718,планирую,0,0,1,1
25717,yazar,0,0,1,1
25716,स्टाप,0,0,1,1
25715,году»,0,0,1,1
25714,использовал,0,0,1,1
25713,minoritaire,0,0,1,1
25712,finalidade,0,0,1,1
25709,rubí,0,0,1,1
25708,подход,0,0,1,1
25707,يونجل,0,0,1,1
25706,balanserade,0,0,1,1
25704,அருமையாக,0,0,1,1
25686,tercümesi,0,0,1,1
25703,adamın,0,0,1,1
25702,pelarna,0,0,1,1
25701,تزيد,0,0,1,1
25700,styrke,0,0,1,1
25698,അറിയാവുന്ന,0,0,1,1
25697,подожди,0,0,1,1
25696,"
tailandês",0,0,1,1
25694,sliep,0,0,1,1
25693,выпустило,0,0,1,1
25691,täckte,0,0,1,1
25690,fatih,0,0,1,1
25689,вышла,0,0,1,1
25688,etablerad,0,0,1,1
25687,नीदरलैंड,0,0,1,1
25634,gigantesques,0,0,1,1
25628,chegando,0,0,1,1
25624,manners,0,0,1,1
3122,spera,1,1,0,1
25575,ഇടുന്നു,0,0,1,1
25574,"
वैनितियाई",0,0,1,1
25573,afkomstig,0,0,1,1
25572,on—the,0,0,1,1
25571,siquiera,0,0,1,1
25570,chronométrez,0,0,1,1
25569,ignora,0,0,1,1
25568,المحظوظ,0,0,1,1
25566,मार,0,0,1,1
25564,بالشفرة,0,0,1,1
25563,никогда,0,0,1,1
25562,zhyue •,0,0,1,1
25561,"
लग्ज़म्बर्गी",0,0,1,1
25560,ആരുണ്ടാക്കി,0,0,1,1
25558,varav,0,0,1,1
25578,φοβερό,0,0,1,1
25557,compreensiva,0,0,1,1
25555,ನಿದ್ರೆಯಲ್ಲಿ,0,0,1,1
25554,पुरुषों,0,0,1,1
25553,боролась,0,0,1,1
3124,cellulare,1,1,0,1
3125,avrei,1,1,0,1
25550,καλές,0,0,1,1
25549,mensuelles,0,0,1,1
25546,nutzlos,0,0,1,1
25545,चेतावनी,0,0,1,1
25542,കണ്ടിട്ടുള്ളതിൽ,0,0,1,1
25541,мужчине,0,0,1,1
25540,extinct,0,0,1,1
3127,decidere,1,1,0,1
25577,trompez,0,0,1,1
3120,esagerare,1,1,0,1
25623,വേണ്ടി,0,0,1,1
25603,побежала,0,0,1,1
25621,katkıda,0,0,1,1
25620,перебил,0,0,1,1
3118,contava,1,1,0,1
25617,soil,0,0,1,1
25615,dahil,0,0,1,1
25614,apresentada,0,0,1,1
25613,reputado,0,0,1,1
25612,αναγράφεται,0,0,1,1
25611,وجودة,0,0,1,1
25610,confusos,0,0,1,1
25609,விதைகளை,0,0,1,1
25608,extralimitan,0,0,1,1
25607,insult,0,0,1,1
25604,kalitede,0,0,1,1
25601,músico,0,0,1,1
25580,पायी,0,0,1,1
25600,angive,0,0,1,1
25599,பயணத்தின்போது,0,0,1,1
25598,ദ്യോഗിക,0,0,1,1
25596,formaliserat,0,0,1,1
25595,നാനാവിധ,0,0,1,1
3119,attribuzione,1,1,0,1
25593,kallt,0,0,1,1
25592,തടയേണ്ട,0,0,1,1
25590,обоката,0,0,1,1
25589,свете,0,0,1,1
25587,kwijt,0,0,1,1
25584,landform,0,0,1,1
25582,verbform,0,0,1,1
25581,prehistory,0,0,1,1
25324,мгновенно,0,0,1,1
25322,أيضا،,0,0,1,1
24929,tido,0,0,1,1
25060,യന്ത്രപഠനമാണ്,0,0,1,1
25052,الجماعي،,0,0,1,1
25053,розенцвейг,0,0,1,1
25054,destansı,0,0,1,1
25056,artiklen,0,0,1,1
25058,ಉದಾಹರಣೆಯೆಂದರೆ,0,0,1,1
25059,ويدعو,0,0,1,1
25061,sohbette,0,0,1,1
25026,സൂക്ഷിച്ച്,0,0,1,1
25063,ужасными,0,0,1,1
25066,ലിപികളും,0,0,1,1
25067,internacionales,0,0,1,1
25069,βεβαιωθείτε,0,0,1,1
25070,إضافيًا,0,0,1,1
25072,wikitekniken,0,0,1,1
25051,confondre,0,0,1,1
3189,tenta,1,1,0,1
3190,cognitivi,1,1,0,1
25047,africarelated,0,0,1,1
25046,"
लातिन",0,0,1,1
25045,متقاطعة,0,0,1,1
25044,инкубаторе,0,0,1,1
25043,beats,0,0,1,1
25041,fniser,0,0,1,1
25040,முக்கியமான,0,0,1,1
25039,england,0,0,1,1
25038,εισαι,0,0,1,1
25037,judiciaires,0,0,1,1
25034,convenir,0,0,1,1
25033,cogito,0,0,1,1
25032,aynada,0,0,1,1
25028,filosofen,0,0,1,1
25073,ಆಹಾರದ,0,0,1,1
25074,википедиях,0,0,1,1
25075,ആകുവാൻ,0,0,1,1
25103,labyrinthine,0,0,1,1
25118,ಚಿಹ್ನೆಯೊಂದಿಗೆ,0,0,1,1
25117,للوصول,0,0,1,1
25116,έκδοσή,0,0,1,1
25115,leraar,0,0,1,1
25114,startet,0,0,1,1
25113,vinkade,0,0,1,1
25111,πίτσα,0,0,1,1
3186,statunitense,1,1,0,1
25109,kaynakları,0,0,1,1
25108,chiffrer,0,0,1,1
25107,широко,0,0,1,1
25106,سنة,0,0,1,1
25105,protester»,0,0,1,1
25104,കുഴപ്പത്തിലാണ്,0,0,1,1
25102,описываются,0,0,1,1
25076,breed,0,0,1,1
25100,ky •,0,0,1,1
25098,ദേഷ്യപ്പെടുന്നു,0,0,1,1
3187,lasciando,1,1,0,1
25095,करायेगा।,0,0,1,1
25093,πέρα,0,0,1,1
25092,éducatif,0,0,1,1
25090,κορυφαίες,0,0,1,1
3188,arrivo,1,1,0,1
25085,opdoen,0,0,1,1
25084,gutaussehender,0,0,1,1
25083,принесу,0,0,1,1
25081,vivaient,0,0,1,1
25078,troisième,0,0,1,1
25077,especializadas,0,0,1,1
25027,ಶೀತವಾಗಿದೆ,0,0,1,1
25025,anns,0,0,1,1
25321,altan,0,0,1,1
24964,graphes,0,0,1,1
24955,والمصرية,0,0,1,1
24958,kelimeyle,0,0,1,1
24959,telefonunu,0,0,1,1
24961,suddas,0,0,1,1
24962,അസ്വസ്ഥനാകരുതെന്ന്,0,0,1,1
24963,δουλεύετε,0,0,1,1
24966,സാമ്യതയുള്ളവയെ,0,0,1,1
25023,pertinente,0,0,1,1
24967,ಹಲೋ,0,0,1,1
24969,முனைப்பான,0,0,1,1
24970,bekräftar,0,0,1,1
24972,geestdriftige,0,0,1,1
24973,இம்முறைமையின்,0,0,1,1
3196,bambina,1,1,0,1
24954,excited,0,0,1,1
24953,connaissances »,0,0,1,1
24952,അഭിനന്ദനങ്ങൾ,0,0,1,1
3198,facciamo,1,1,0,1
24948,reparler,0,0,1,1
24947,रीस्टोर,0,0,1,1
24946,ಸುಂದರವಾಗಿದ್ದಾಳೆಂದು,0,0,1,1
3199,uniformandosi,1,1,0,1
24942,recommenceras,0,0,1,1
24939,"
eslovaco",0,0,1,1
24938,écrite,0,0,1,1
3201,curata,1,1,0,1
24934,reads,0,0,1,1
24933,linnaeus,0,0,1,1
24932,compleet,0,0,1,1
24931,എല്ലിക്കും,0,0,1,1
24930,kazanmış,0,0,1,1
24975,страницах,0,0,1,1
24977,ಮಾಹಿತಿಗಾಗಿ,0,0,1,1
24979,பீட்சா,0,0,1,1
25000,наличию,0,0,1,1
25021,indicators,0,0,1,1
25019,benedicto,0,0,1,1
25018,புதிதாக,0,0,1,1
25017,metadados,0,0,1,1
25016,உணர,0,0,1,1
25015,നല്ലതാണെന്ന,0,0,1,1
25013,satirique,0,0,1,1
25011,ga •,0,0,1,1
25010,primária,0,0,1,1
3192,stabili,1,1,0,1
25007,ubiquiste,0,0,1,1
25004,требованиям,0,0,1,1
25003,glittrande,0,0,1,1
25002,சொந்தமான,0,0,1,1
24999,strickland,0,0,1,1
24980,végétale,0,0,1,1
24997,impedir,0,0,1,1
24996,ಕುದುರೆಯಂತಹ,0,0,1,1
24995,llevo,0,0,1,1
24993,"
अरागोनियाई",0,0,1,1
3195,faithbased,1,1,0,1
24991,distribuable,0,0,1,1
24990,priority ,0,0,1,1
24988,ongelooflijk,0,0,1,1
24987,fornece,0,0,1,1
24985,«unos,0,0,1,1
24984,jedoch,0,0,1,1
24983,juiste,0,0,1,1
24982,immune,0,0,1,1
24981,bénéfice,0,0,1,1
25119,സുന്ദരിയാണെന്ന്,0,0,1,1
25120,toparla,0,0,1,1
25121,yaptıysanız,0,0,1,1
3172,avvertimento,1,1,0,1
25246,parenthèses,0,0,1,1
25247,напиток,0,0,1,1
25248,άδεια,0,0,1,1
25249,referente,0,0,1,1
25250,yemekte,0,0,1,1
25251,prinz,0,0,1,1
25258,foods,0,0,1,1
25123,taha,0,0,1,1
25259,स्कॉलरपीडिया,0,0,1,1
3171,affogando,1,1,0,1
25263,podían,0,0,1,1
25264,உதவிக்குறிப்பை,0,0,1,1
25265,يصنع,0,0,1,1
25268,testées,0,0,1,1
25245,hydrogen,0,0,1,1
3173,foscolo,1,1,0,1
25243,surgiu,0,0,1,1
25242,umursayamam,0,0,1,1
25239,erstaunliches,0,0,1,1
25234,läsarens,0,0,1,1
25233,tayyip,0,0,1,1
25231,appointment,0,0,1,1
25230,paradigme,0,0,1,1
25226,lieblich,0,0,1,1
25225,realizando,0,0,1,1
25224,ശ്രദ്ധിക്കുക,0,0,1,1
25223,raderats,0,0,1,1
25222,kennenzulernen,0,0,1,1
25221,arıyorsun,0,0,1,1
25219,individualiste,0,0,1,1
25218,"
vi",0,0,1,1
25271,vaguely,0,0,1,1
25272,maximum,0,0,1,1
25273,freeknowledge,0,0,1,1
25293,sujeta,0,0,1,1
25320,ವಿಷಯವಲ್ಲ,0,0,1,1
25318,सम्मेलनों,0,0,1,1
25317,കാര്യ,0,0,1,1
25316,нарцису,0,0,1,1
25313,പറയുന്നതും,0,0,1,1
25310,meestal,0,0,1,1
25308,entropy,0,0,1,1
25305,llega,0,0,1,1
25303,youif,0,0,1,1
3167,fermati,1,1,0,1
25298,maddenin,0,0,1,1
25297,accéder,0,0,1,1
25295,разрешение,0,0,1,1
25294,kop,0,0,1,1
3168,sostenitori,1,1,0,1
25274,verificación​,0,0,1,1
25291,الممر,0,0,1,1
25290,desmentida,0,0,1,1
25288,pequeno,0,0,1,1
25287,simgesine,0,0,1,1
25286,demás,0,0,1,1
3169,salì,1,1,0,1
25283,комментарием,0,0,1,1
25282,tiver,0,0,1,1
25281,गोर्मनने,0,0,1,1
25280,അനുവദിക്കുന്നുണ്ട്,0,0,1,1
25278,reprendre,0,0,1,1
25277,spetsig,0,0,1,1
25276,eis,0,0,1,1
25275,دموعك,0,0,1,1
25215,früheres,0,0,1,1
25214,"
tajique",0,0,1,1
25212,kollaborativa,0,0,1,1
25146,preference,0,0,1,1
25169,ergebnis,0,0,1,1
25167,películas,0,0,1,1
25166,സഹായിക്കൂ,0,0,1,1
25165,المبادئ,0,0,1,1
25164,jv •,0,0,1,1
25163,garaj,0,0,1,1
25161,operan,0,0,1,1
25159,tratamento,0,0,1,1
25158,نشاطاً،,0,0,1,1
25156,experiências,0,0,1,1
25153,ಆಸಕ್ತಿ,0,0,1,1
25150,।flummoxed,0,0,1,1
25148,സംസാരിക്കുന്ന,0,0,1,1
25147,giyinmiş,0,0,1,1
25142,verdelen,0,0,1,1
3184,aumentare,1,1,0,1
25141,англоязычной,0,0,1,1
25140,provocerande,0,0,1,1
25139,reage,0,0,1,1
25137,प्रसारित,0,0,1,1
25136,ಮೃದುವಾದ,0,0,1,1
25135,främjas,0,0,1,1
25134,baikecom,0,0,1,1
25132,слово»,0,0,1,1
25131,trials,0,0,1,1
25129,لصدفة,0,0,1,1
25128,encorajar,0,0,1,1
25126,الآخرون,0,0,1,1
25125,роли,0,0,1,1
25124,അപ്പ്,0,0,1,1
25170,overzichtsartikelen,0,0,1,1
25172,journey,0,0,1,1
25211,fondent,0,0,1,1
3179,francoprovenzale,1,1,0,1
25210,convirtiéndose,0,0,1,1
25208,piecewise,0,0,1,1
25207,संकेत,0,0,1,1
25206,أهلاً,0,0,1,1
25205,ولكنه,0,0,1,1
25204,thème ,0,0,1,1
25203,ಇಷ್ಟಪಟ್ಟಿದ್ದೀರಿ,0,0,1,1
25202,save,0,0,1,1
25201,acompanhar,0,0,1,1
25200,நடவடிக்கையின்,0,0,1,1
25197,تعافى,0,0,1,1
3176,vada,1,1,0,1
25195,നാട്ടറിവുകൾ,0,0,1,1
25193,«седьмой,0,0,1,1
25191,utilisezvous,0,0,1,1
25173,gestopt,0,0,1,1
25190,ജോലികൾക്കു,0,0,1,1
3180,fiacco,1,1,0,1
25188,uitgebreider,0,0,1,1
25187,ತನ್ನದೇ,0,0,1,1
25186,ತಮಾಷೆಯ,0,0,1,1
25185,ಉದಾಹರಣೆಯಲ್ಲಿ,0,0,1,1
25184,lagra,0,0,1,1
25183,المنسقة,0,0,1,1
3181,venire,1,1,0,1
25180,നൽകുകയും,0,0,1,1
25179,bulamadığın,0,0,1,1
25176,documentada,0,0,1,1
25175,englischen,0,0,1,1
3183,provenga,1,1,0,1
27278,oxygenation,0,0,1,1
27280,draaide,0,0,1,1
18011,ನೋಡುತ್ತಿದ್ದಾಗ,0,0,1,1
29304,ഉറവിടം,0,0,1,1
29295,venaient,0,0,1,1
29296,damerne,0,0,1,1
29299,exigidos,0,0,1,1
29301,likelihood,0,0,1,1
29302,والتعليمات,0,0,1,1
29303,sitesini,0,0,1,1
29305,традиционную,0,0,1,1
29269,അഭിനന്ദിക്കുന്നു,0,0,1,1
2646,fattore,1,1,0,1
29307,nonprobabilistic,0,0,1,1
29309,filer,0,0,1,1
29310,ort,0,0,1,1
29312,realizing,0,0,1,1
29313,उबुन्टु,0,0,1,1
29294,houvesse,0,0,1,1
29293,deltagarportalerna,0,0,1,1
29292,pionnier,0,0,1,1
29291,ಬೆಳಗಬಹುದು,0,0,1,1
2647,ˈviki,1,1,0,1
29288,d’être,0,0,1,1
29287,tournent,0,0,1,1
29286,  lecteurs,0,0,1,1
29285,hunting,0,0,1,1
29283,depicts,0,0,1,1
29281,വിശാലവും,0,0,1,1
2650,mangi,1,1,0,1
29278,storslået,0,0,1,1
29277,datacenter,0,0,1,1
29276,حر،,0,0,1,1
29273,inundação,0,0,1,1
29272,تعاونية,0,0,1,1
2645,assunzione,1,1,0,1
2644,provi,1,1,0,1
29316,wikifiera,0,0,1,1
29337,estelle,0,0,1,1
29358,yakın,0,0,1,1
29357,алгоритм,0,0,1,1
29352,posteriori,0,0,1,1
29351,സലാഡുകളും,0,0,1,1
29348,ಪ್ರೀತಿಸುತ್ತೀರಿ,0,0,1,1
2641,sbaglia,1,1,0,1
29346,итальянских,0,0,1,1
29344,многоязычная,0,0,1,1
29343,الأراضي,0,0,1,1
29342,хранилища,0,0,1,1
29341,computerprogramma,0,0,1,1
29340,aspire,0,0,1,1
29339,പതിവ്,0,0,1,1
29338,वित्तीय,0,0,1,1
29336,нарушениями,0,0,1,1
29317,जाऊं,0,0,1,1
29335,snygga,0,0,1,1
29334,holtzbrinck,0,0,1,1
29333,« exemple,0,0,1,1
29332,"
मलय",0,0,1,1
29331,oldun,0,0,1,1
29327,സംഭാഷണമാണ്,0,0,1,1
29326,parallèle,0,0,1,1
29324,"
asturiano",0,0,1,1
29323,तकनीकी,0,0,1,1
2643,simile,1,1,0,1
29321,мюнхене,0,0,1,1
29320,ಮನೆಯ,0,0,1,1
29319,ओपनसोलारिस,0,0,1,1
29318,estritas,0,0,1,1
29270,"
लिंगला",0,0,1,1
29268,researcher,0,0,1,1
29361,supieran,0,0,1,1
2660,lavanderia,1,1,0,1
29194,classic,0,0,1,1
29195,ptmwikipediaorg,0,0,1,1
29196,സമീപകാല,0,0,1,1
2661,appropriato,1,1,0,1
29199,ड्राफ्ट,0,0,1,1
29200,agira,0,0,1,1
2659,seduti,1,1,0,1
29267,سبب,0,0,1,1
29204,brandit,0,0,1,1
29206,israël,0,0,1,1
2657,stretti,1,1,0,1
2654,dipende,1,1,0,1
29214,القرض,0,0,1,1
29215,എക്സ്ക്യൂസ്,0,0,1,1
29193,ionized,0,0,1,1
29192,बेनाम,0,0,1,1
29191,representatividad,0,0,1,1
2662,esseri,1,1,0,1
29189,encuentra,0,0,1,1
29188,تشاهد,0,0,1,1
29187,seem,0,0,1,1
29186,felaktiga,0,0,1,1
29185,нейронных,0,0,1,1
29183,ಮುಸುಕಿನ,0,0,1,1
29182,статью»,0,0,1,1
29180,காரணமாக,0,0,1,1
29179,அதிர்ஷ்டத்தின்,0,0,1,1
29178,roches,0,0,1,1
29177,கட்டுப்பாடில்லாத,0,0,1,1
29176,ಕೋಪಗೊಂಡಿದ್ದೀರಿ,0,0,1,1
29175,vida»,0,0,1,1
29216,heather,0,0,1,1
29218,गैरलाभकारी,0,0,1,1
29220,обнаружено,0,0,1,1
29244,courts,0,0,1,1
29266,«какая,0,0,1,1
29265,दिलाना,0,0,1,1
29264,പകുതി,0,0,1,1
2651,tempestosa,1,1,0,1
29262,accepteres,0,0,1,1
29261,onderbreek,0,0,1,1
29260,മൂർച്ചയുള്ളവയെ,0,0,1,1
29257,κάντε,0,0,1,1
29255,obligation,0,0,1,1
29254,wikipédianota,0,0,1,1
29252,guise,0,0,1,1
29251,vorschläge,0,0,1,1
29250,slutade,0,0,1,1
29247,φροντίστε,0,0,1,1
29242,dimwitted,0,0,1,1
29221,للنوم,0,0,1,1
29241,مجهولون,0,0,1,1
29239,californie,0,0,1,1
29238,ஒலி,0,0,1,1
29237,rubinmarmelade,0,0,1,1
29235,нахожусь,0,0,1,1
29234,initiales,0,0,1,1
29232,noticia,0,0,1,1
29230,favorisée,0,0,1,1
2652,umanità,1,1,0,1
29227,träna,0,0,1,1
29226,oplossing,0,0,1,1
29225,பிரிவில்,0,0,1,1
29224,മന്ദഗതിയിലാക്കുന്നു,0,0,1,1
29223,cresce,0,0,1,1
29360,வருகிறது,0,0,1,1
29362,enlever,0,0,1,1
28805,ieee,0,0,1,1
29493,minor,0,0,1,1
29482,hoşçakal,0,0,1,1
29484,весело»,0,0,1,1
2626,effetto,1,1,0,1
2625,lacune,1,1,0,1
29488,لدولة,0,0,1,1
29489,chegaram,0,0,1,1
29494,colaboraciones,0,0,1,1
2629,collaborano,1,1,0,1
29496,httpenwikipediaorg,0,0,1,1
29497,polished,0,0,1,1
29500,описывал,0,0,1,1
29501,meelmeisjes,0,0,1,1
29503,confusión,0,0,1,1
29504,solely,0,0,1,1
29481,stock,0,0,1,1
29479,έφυγε,0,0,1,1
2627,spadolini,1,1,0,1
29474,உட்பட,0,0,1,1
29473,satisfacer,0,0,1,1
29471,معينة،,0,0,1,1
29470,gentagelse,0,0,1,1
29468,новая,0,0,1,1
29467,التأثير,0,0,1,1
29466,وجهت,0,0,1,1
29464,नवीनतम,0,0,1,1
29461,ποτέ,0,0,1,1
29460,preassigned,0,0,1,1
29459,dismoi,0,0,1,1
29458,التعليمات,0,0,1,1
29457,rumpelte,0,0,1,1
2628,positivi,1,1,0,1
2620,includendo,1,1,0,1
29506,souriant,0,0,1,1
29508,وحذف,0,0,1,1
2614,patate,1,1,0,1
29555,aussicht,0,0,1,1
29554,veria,0,0,1,1
29552,aprendi,0,0,1,1
29550,توزيع,0,0,1,1
2611,collaboratore,1,1,0,1
29548,энциклопедию,0,0,1,1
2612,evolve,1,1,0,1
29545,welt,0,0,1,1
2613,uccello,1,1,0,1
29543,vidare,0,0,1,1
29542,tappat,0,0,1,1
29541,имевшихся,0,0,1,1
29540,ponctuellement,0,0,1,1
29539,அழாதபடி,0,0,1,1
29537,amatör,0,0,1,1
29510,förhandsgranskning,0,0,1,1
29534,संगीत,0,0,1,1
29532,galardonada,0,0,1,1
29530,ग्रिफ़िथ,0,0,1,1
29529,önska,0,0,1,1
29527,опубликованными,0,0,1,1
29526,распределяются,0,0,1,1
29525,hydrology,0,0,1,1
29524,grameri,0,0,1,1
2618,consigliata,1,1,0,1
29521,मल्टिपल,0,0,1,1
29519,saisie,0,0,1,1
29518,fondamental,0,0,1,1
2619,iniziare,1,1,0,1
29511,economie,0,0,1,1
29455,mettent,0,0,1,1
29453,चक्कर,0,0,1,1
29363,للأبحاث,0,0,1,1
29392,வங்கி,0,0,1,1
29386,المقاطعة,0,0,1,1
29387,विज्ञापनपर,0,0,1,1
29388,വിശക്കുന്നു,0,0,1,1
29389,schätzen,0,0,1,1
29390,jackson,0,0,1,1
29391,nede,0,0,1,1
29393,энциклопедий,0,0,1,1
29452,natuur,0,0,1,1
29394,smagseksempel,0,0,1,1
29396,amável,0,0,1,1
29397,—sobre,0,0,1,1
29398,ಪರಸ್ಪರ,0,0,1,1
29401,бьет,0,0,1,1
29403,जी,0,0,1,1
29384,vollständig,0,0,1,1
29383,الربح,0,0,1,1
29382,ಕುಳಿತಳು,0,0,1,1
29381,ಪೆಟ್ಟಿಗೆಯಲ್ಲಿ,0,0,1,1
29380,vo •,0,0,1,1
29379,ನನಸಾಗುತ್ತದೆ,0,0,1,1
29378,العلماء،,0,0,1,1
2636,leggermente,1,1,0,1
29376,äldsta,0,0,1,1
29375,форма,0,0,1,1
29372,höjde,0,0,1,1
29371,latinske,0,0,1,1
29370,aired,0,0,1,1
2638,punizione,1,1,0,1
29366,perpetuidad,0,0,1,1
29365,suponga,0,0,1,1
29364,movie,0,0,1,1
29406,n’oppose,0,0,1,1
29407,«проверяемость,0,0,1,1
29408,ಕಲಿಯುತ್ತಿದ್ದರೆ,0,0,1,1
29430,स्थल,0,0,1,1
29450,проживет,0,0,1,1
29449,poursuivre,0,0,1,1
29447,granskar,0,0,1,1
29445,öğrendim,0,0,1,1
29444,വണ്ടി,0,0,1,1
2630,basano,1,1,0,1
29441,movido,0,0,1,1
2632,sorrisi,1,1,0,1
29438,கேட்கவும்,0,0,1,1
29437,define,0,0,1,1
29436,പക്ഷപാതിത്വം,0,0,1,1
29435,irse,0,0,1,1
29432,positionnement,0,0,1,1
29431,permisesx,0,0,1,1
29429,emulados,0,0,1,1
29409,assistir,0,0,1,1
29428,rechazada,0,0,1,1
29427,രണ്ടാമത്തെ,0,0,1,1
29425,ഭ്രാന്താണ്,0,0,1,1
29424,خوان,0,0,1,1
29423,hierher,0,0,1,1
29420,франции,0,0,1,1
29419,لتزايد,0,0,1,1
29418,hiérarchisation,0,0,1,1
29416,للحديث,0,0,1,1
29414,değerlendirilir,0,0,1,1
29413,تعليمية,0,0,1,1
29412,diseñada,0,0,1,1
29411,بماذا,0,0,1,1
2635,contenessero,1,1,0,1
29174,talenversies,0,0,1,1
2665,scuse,1,1,0,1
29172,തയ്യാറാക്കികൊണ്ടിരിക്കുന്നു,0,0,1,1
28928,modernere,0,0,1,1
2694,quantità,1,1,0,1
28923,givet,0,0,1,1
2693,riportava,1,1,0,1
28925,புதியகட்டுரை,0,0,1,1
2692,madrelingua,1,1,0,1
2691,web»,1,1,0,1
28929,habillé,0,0,1,1
28899,முன்னரே,0,0,1,1
28930,börjat,0,0,1,1
28931,ಮಾತನಾಡುತ್ತಿದ್ದೀರಿ,0,0,1,1
28932,macrolinguagem,0,0,1,1
28937,обработки,0,0,1,1
28940,πάρεις,0,0,1,1
28941,incentiva,0,0,1,1
28920,ممكن,0,0,1,1
28919,провести,0,0,1,1
28918,respectent,0,0,1,1
28917,juridiquement,0,0,1,1
28916,பழக்கவழக்கங்களால்,0,0,1,1
28915,أدوات,0,0,1,1
28914,سنوات,0,0,1,1
28913,പോയാൽ,0,0,1,1
28912,സിനിമകളിലേക്ക്,0,0,1,1
28911,nomeadamente,0,0,1,1
28910,orientadas,0,0,1,1
28909,satírico,0,0,1,1
28908,kültürel,0,0,1,1
28907,noun,0,0,1,1
28906,геометрии,0,0,1,1
28903,exponencial,0,0,1,1
28902,حيادية,0,0,1,1
28942,المتكررين,0,0,1,1
28943,வளர்ந்த,0,0,1,1
28944,medicate,0,0,1,1
28967,försumbara,0,0,1,1
28984,практику»,0,0,1,1
28983,ആഗ്രഹിക്കുന്നത്,0,0,1,1
28981,കാണിക്കുന്ന,0,0,1,1
28980,diciéndola,0,0,1,1
28979,dvdдиск,0,0,1,1
28978,सइबरआर्ट्स,0,0,1,1
28977,tendo,0,0,1,1
2681,disprezzo,1,1,0,1
28975,ambiguidade,0,0,1,1
28974,എന്തും,0,0,1,1
28973,മറ്റേയാൾക്ക്,0,0,1,1
28970,поймали,0,0,1,1
28969,европейском,0,0,1,1
28968,våtmark,0,0,1,1
28966,«усилия,0,0,1,1
28948,bois,0,0,1,1
28965,вызывают,0,0,1,1
2682,dubbi,1,1,0,1
2684,quantificare,1,1,0,1
2685,maggiormente,1,1,0,1
28958,प्रथम,0,0,1,1
28957,kullanılan,0,0,1,1
28956,قالت,0,0,1,1
28955,विफलताओं,0,0,1,1
28954,فريق,0,0,1,1
28953,പ്രാവർത്തികമാക്കാനുള്ള,0,0,1,1
2686,corpo,1,1,0,1
28951,redistribuer,0,0,1,1
28950,somewhere,0,0,1,1
2687,difficilmente,1,1,0,1
28900,taux,0,0,1,1
28898,കരുതുന്നില്ല,0,0,1,1
29171,मिलनी,0,0,1,1
28842,ജോലിഭാരം,0,0,1,1
28832,глобальное,0,0,1,1
28833,وأبل,0,0,1,1
28835,andor,0,0,1,1
28836,season,0,0,1,1
28837,angenehmes,0,0,1,1
28839,renvoie,0,0,1,1
2705,svolti,1,1,0,1
28896,أدرك,0,0,1,1
28844,சுற்றி,0,0,1,1
28845,absurd,0,0,1,1
28846,bağımsız,0,0,1,1
2704,solleva,1,1,0,1
28850,frío,0,0,1,1
28851,hasard,0,0,1,1
28830,ഇഷ്ടമാണ്,0,0,1,1
28828,görünmek,0,0,1,1
28827,glücklich,0,0,1,1
28826,ಸಂದರ್ಭದಲ್ಲಿ,0,0,1,1
28825,qualitatif,0,0,1,1
28824,resultaram,0,0,1,1
2706,speranza»,1,1,0,1
28822,annorlunda,0,0,1,1
28821,आपजानते,0,0,1,1
2707,cambia,1,1,0,1
28819,syftar,0,0,1,1
28818,போலல்லாது,0,0,1,1
28817,conçue,0,0,1,1
28814,посетителям,0,0,1,1
28811,крокером,0,0,1,1
28810,лишена,0,0,1,1
28809,утонченным,0,0,1,1
28853,envolvidas,0,0,1,1
28854,വിയോജിക്കുകയും,0,0,1,1
28855,ಪೋಯ್ಸ್ಡ್,0,0,1,1
28879,beantwoorden,0,0,1,1
28895,الجمهور,0,0,1,1
28894,jugements,0,0,1,1
2696,copiare,1,1,0,1
28891,deberíamos,0,0,1,1
28890,zwinkerten,0,0,1,1
2697,incontrerò,1,1,0,1
28887,resúmenes,0,0,1,1
28886,vandalized,0,0,1,1
28885,какието,0,0,1,1
28884,severas,0,0,1,1
28883,تتضمن,0,0,1,1
28882,ayudarme,0,0,1,1
28881,droomde,0,0,1,1
28880,ஏற்கிறது,0,0,1,1
28877,inné »,0,0,1,1
28856,مربى,0,0,1,1
2698,imparando,1,1,0,1
28874,initiate,0,0,1,1
28873,സ്താനാർബുദം,0,0,1,1
28872,വാഗ്ദാനം,0,0,1,1
28871,المذاق,0,0,1,1
28870,deseo,0,0,1,1
28869,modificables,0,0,1,1
28868,സങ്കീർണ്ണത,0,0,1,1
2701,intensifica,1,1,0,1
28863,وجهات,0,0,1,1
28862,nãoespecialistas,0,0,1,1
28861,connections,0,0,1,1
28860,hu •,0,0,1,1
28859,പരിഹാരത്തിലും,0,0,1,1
28985,становится,0,0,1,1
28986,contribuyentes»,0,0,1,1
28989,साथसाथ,0,0,1,1
29112,oturmak,0,0,1,1
29106,നര്ചിഷ,0,0,1,1
29107,recebem,0,0,1,1
29108,تشير,0,0,1,1
29109,свадебном,0,0,1,1
29110,скачать,0,0,1,1
29111,groep,0,0,1,1
29113,aangetroffen,0,0,1,1
28991,επίσημη,0,0,1,1
29114,estates,0,0,1,1
29115,கேள்விப்பட்டிருக்கிறேன்,0,0,1,1
29119,march update,0,0,1,1
29120,conhecêlo,0,0,1,1
29124,распределённом,0,0,1,1
29126,ನಿರ್ಧಾರ,0,0,1,1
29105,pássaro,0,0,1,1
29104,للتعبير,0,0,1,1
29103,богатств,0,0,1,1
29102,laïque,0,0,1,1
2673,adeguata,1,1,0,1
29099,entregue,0,0,1,1
29097,sammanfattas,0,0,1,1
29096,—contracción,0,0,1,1
29095,incompleta,0,0,1,1
29094,inexplorable,0,0,1,1
29093,enables,0,0,1,1
29092,dybt,0,0,1,1
29090,voortbouwen,0,0,1,1
29089,краткое,0,0,1,1
29088,экспертами,0,0,1,1
29086,താളുകൾ‍,0,0,1,1
29085,interessanter,0,0,1,1
29127,بوجود,0,0,1,1
29129,ഉറക്കത്തിൽ,0,0,1,1
29131,polyvalente,0,0,1,1
29151,representadas,0,0,1,1
29168,وبين موسوعة,0,0,1,1
29167,نشرها,0,0,1,1
29166,faixa,0,0,1,1
2669,approssimativamente,1,1,0,1
29163,kommentarfältet,0,0,1,1
29162,விடுமுறை,0,0,1,1
29160,уроки,0,0,1,1
29159,navegava,0,0,1,1
29157,oyununuzu,0,0,1,1
29156,سلاش,0,0,1,1
29155,sechs,0,0,1,1
29154,deli,0,0,1,1
29153,займемся,0,0,1,1
29152,bilen,0,0,1,1
29150,l’automatisation,0,0,1,1
29132,ulaştığını,0,0,1,1
29149,первых,0,0,1,1
29148,ಮೂಕ,0,0,1,1
29147,مدهش,0,0,1,1
29146,சாங்கரையேச்,0,0,1,1
29145,താൽപ്പര്യമുണ്ടെന്ന്,0,0,1,1
29144,ஆச்சரியம்,0,0,1,1
29142,walmart,0,0,1,1
2670,migliorano,1,1,0,1
29139,revertingreverted,0,0,1,1
29137,योग्यता,0,0,1,1
29136,അതുകൊണ്ടൊക്കെ,0,0,1,1
29135,cümlede,0,0,1,1
29134,providing,0,0,1,1
29133,قال,0,0,1,1
29084,sıklıkla,0,0,1,1
29083,дисках,0,0,1,1
29082,behulp,0,0,1,1
29013,encontró,0,0,1,1
29033,ಸಂಪರ್ಕದಲ್ಲಿರಿ,0,0,1,1
29032,வருகின்றது,0,0,1,1
29031,"science ·
ഹൈഡ്രോളജി",0,0,1,1
29029,ಎಂಟು,0,0,1,1
29028,sinkt,0,0,1,1
29026,تتطلب,0,0,1,1
29025,കണ്ടെത്തലുകളും,0,0,1,1
29024,प्रकाशन,0,0,1,1
29021,கொண்டுவரலாம்,0,0,1,1
29019,grafema,0,0,1,1
29018,bırakmamı,0,0,1,1
29017,рассказал,0,0,1,1
29015,aprende,0,0,1,1
29014,yasaklı,0,0,1,1
29012,conspiracy,0,0,1,1
29035,accusent,0,0,1,1
29011,definir,0,0,1,1
29010,गम,0,0,1,1
29009,ноябрь,0,0,1,1
29008,politically,0,0,1,1
29007,contacted,0,0,1,1
29002,ऑफिस,0,0,1,1
29001,परिचय,0,0,1,1
29000,elefantes,0,0,1,1
28999,superar,0,0,1,1
28997,безумие,0,0,1,1
28996,coğrafyada,0,0,1,1
28995,аароном,0,0,1,1
28993,നടത്തേണ്ടതുണ്ടെന്നും,0,0,1,1
28992,elizabeth,0,0,1,1
29034,fetzer,0,0,1,1
29036,открытием,0,0,1,1
29081,tribos,0,0,1,1
29060,noemde,0,0,1,1
29079,vaters,0,0,1,1
29078,percept,0,0,1,1
29077,الخلاف,0,0,1,1
29076,« pédia »,0,0,1,1
29075,нейтральная,0,0,1,1
29074,മേഖല,0,0,1,1
29073,снится,0,0,1,1
29072,одному,0,0,1,1
29068,paradojas,0,0,1,1
29067,ಸೈನ್ಯದ,0,0,1,1
29066,غالباً،,0,0,1,1
29065,правило,0,0,1,1
29064,centuple,0,0,1,1
29061,வழியாகப்,0,0,1,1
29057,somalí,0,0,1,1
29038,കിട്ടി,0,0,1,1
29056,choix,0,0,1,1
29055,heet,0,0,1,1
29053,ചായ്‌വ്,0,0,1,1
29052,വഷളായി,0,0,1,1
2676,maniere,1,1,0,1
29050,cohesiveness,0,0,1,1
29049,எனவும்,0,0,1,1
29047,forced,0,0,1,1
29045,предприняты,0,0,1,1
29044,relaties,0,0,1,1
29043,നിർദ്ദേശിച്ചിട്ടുള്ള,0,0,1,1
29042,grundat,0,0,1,1
29041,rart,0,0,1,1
29039,görmediğinizde,0,0,1,1
29556,സ്റ്റം‌പൻ‌ഡസിനുപകരം,0,0,1,1
29558,வருகிறார்கள்,0,0,1,1
29559,lanzó,0,0,1,1
30059,தேடலில்,0,0,1,1
2536,democrazia,1,1,0,1
30053,हैंडसम,0,0,1,1
30054,зачем,0,0,1,1
30055,defect,0,0,1,1
30056,tropperne,0,0,1,1
2534,risatine,1,1,0,1
30060,الأخرى،,0,0,1,1
30023,dehaene,0,0,1,1
30061,സഞ്ചി,0,0,1,1
30062,പ്രിയപ്പെട്ടവനാണ്,0,0,1,1
30064,υπηρέτησε,0,0,1,1
30065,продовольствие,0,0,1,1
30066,объёмов,0,0,1,1
30067,جميلًا,0,0,1,1
30051,wikimedia—,0,0,1,1
2537,affinché,1,1,0,1
30048,craintes,0,0,1,1
30046,parallèles,0,0,1,1
30045,microwave,0,0,1,1
30044,possesseur,0,0,1,1
30043,வளர்ந்து,0,0,1,1
30042,visualizar,0,0,1,1
30040,ευχαριστήσετε,0,0,1,1
30039,सौभाग्य।,0,0,1,1
30038,കൊള്ളാം,0,0,1,1
30036,находитесь,0,0,1,1
30035,lekkers,0,0,1,1
30034,разговаривали,0,0,1,1
30031,« nature,0,0,1,1
30030,ವಿಷಯಗಳನ್ನು,0,0,1,1
30029,pictures,0,0,1,1
30068,தாக்கத்தை,0,0,1,1
30069,സൈനികർക്ക്,0,0,1,1
2531,mutazione,1,1,0,1
30096,улыбалась,0,0,1,1
2527,anglosassone,1,1,0,1
30115,cuídate,0,0,1,1
30114,aportar,0,0,1,1
30113,pestaña,0,0,1,1
30110,поддерживались,0,0,1,1
30109,ലക്ഷക്കണക്കിന്,0,0,1,1
30107,utilization,0,0,1,1
30106,ca •,0,0,1,1
30105,ಪ್ರಶ್ನಾರ್ಥಕ,0,0,1,1
30103,καθρέφτη,0,0,1,1
30102,മാതൃകയുടെ,0,0,1,1
30101,النصف,0,0,1,1
30100,roden,0,0,1,1
30098,konferanslarda,0,0,1,1
30092,damaged,0,0,1,1
30071,viennent,0,0,1,1
30091,контентомкомм,0,0,1,1
30090,കണക്കുകൂട്ടൽ,0,0,1,1
30089,stay,0,0,1,1
30087,plato,0,0,1,1
30086,sementes,0,0,1,1
30084,उतने,0,0,1,1
30083,ओपन,0,0,1,1
30079,ആഗ്രഹിക്കുന്നിടത്തോളം,0,0,1,1
30078,attrapé,0,0,1,1
30077,दावे,0,0,1,1
30076,مخطئ,0,0,1,1
30074,actives,0,0,1,1
30073,contribuído,0,0,1,1
30072,التعاوني،,0,0,1,1
30028,राष्ट्रपति,0,0,1,1
30022,அமைந்திருந்தது,0,0,1,1
29923,вперемешку,0,0,1,1
29961,انطلقت,0,0,1,1
29953,canciones,0,0,1,1
29954,minister,0,0,1,1
29955,tasting,0,0,1,1
2546,modificati,1,1,0,1
29957,карролтон,0,0,1,1
29959,geological,0,0,1,1
29962,läraren,0,0,1,1
30019,« wikipedia,0,0,1,1
2545,comprato,1,1,0,1
29964,"
मालागासे",0,0,1,1
29970,ceasing,0,0,1,1
29971,klassificerat,0,0,1,1
29973,കൊടുത്തുകൊണ്ടുള്ള,0,0,1,1
29974,വരിക,0,0,1,1
29952,हफ्तों,0,0,1,1
2548,spiegare,1,1,0,1
29947,unnatural,0,0,1,1
29945,ألتو,0,0,1,1
29944,købte,0,0,1,1
29942,എല്ലാക്കാലവും,0,0,1,1
29941,ആണിക്കല്ലായി,0,0,1,1
29940,buluyorum,0,0,1,1
29939,قراءة,0,0,1,1
2550,tradotte,1,1,0,1
29937,kahraman,0,0,1,1
29936,—dirigidas,0,0,1,1
29935,रत्नों,0,0,1,1
29934,получена,0,0,1,1
29930,друга,0,0,1,1
2553,discretamente,1,1,0,1
29927,smaka,0,0,1,1
29975,ಕಳೆದ,0,0,1,1
29976,embodied,0,0,1,1
29979,خورازميات,0,0,1,1
30002,"
स्कॉट्स",0,0,1,1
30018,ഇടമില്ല,0,0,1,1
30017,سأخذه,0,0,1,1
30016,என்பதே,0,0,1,1
30015,intervient,0,0,1,1
30014,yttrande,0,0,1,1
30012,владелец,0,0,1,1
30011,indenfor,0,0,1,1
30010,fatores,0,0,1,1
30009,ведомств,0,0,1,1
30008,réussite,0,0,1,1
30007,явный,0,0,1,1
30006,المتبقي,0,0,1,1
30005,antik,0,0,1,1
30004,நேசிக்கிறேன்,0,0,1,1
30000,തുടരുന്നതിന്,0,0,1,1
29980,δάκρυά,0,0,1,1
29999,loved,0,0,1,1
29998,وضع,0,0,1,1
2541,avviata,1,1,0,1
29993,темам,0,0,1,1
29992,déchristianisation,0,0,1,1
29991,zorunluğu,0,0,1,1
29990,win,0,0,1,1
29989,изданием,0,0,1,1
29987,записей,0,0,1,1
29986,chiffrement,0,0,1,1
29985,मुद्दे,0,0,1,1
29983,hoor,0,0,1,1
29982,ഫ്ലംമോക്സായി,0,0,1,1
29981,géométrie,0,0,1,1
30118,மாற்றினாள்,0,0,1,1
30119,смеяться,0,0,1,1
30122,beruhige,0,0,1,1
30234,பிரமாதமாக,0,0,1,1
30223,nécessité,0,0,1,1
30224,படையினருக்கான,0,0,1,1
2516,discesa,1,1,0,1
30227,качаешь,0,0,1,1
30230,المتعمدة,0,0,1,1
30233,أريده,0,0,1,1
30235,å,0,0,1,1
30125,duitse,0,0,1,1
30236,ഉപവിഭാഗമാണ്,0,0,1,1
30238,désencyclopédie,0,0,1,1
30239,reservado,0,0,1,1
30240,отпустила,0,0,1,1
2513,comprerei,1,1,0,1
2512,docente,1,1,0,1
30222,consisting,0,0,1,1
30221,düşünmüyorum,0,0,1,1
30220,divulgadas,0,0,1,1
30219,práctica,0,0,1,1
30218,discutezen,0,0,1,1
30217,alınmış,0,0,1,1
30216,становиться,0,0,1,1
30215,фразам,0,0,1,1
30214,confirma,0,0,1,1
30213,subtropicaleréf,0,0,1,1
2517,goliardiche,1,1,0,1
2518,maremoto,1,1,0,1
30210,hollanda,0,0,1,1
30208,homonymes,0,0,1,1
30207,artikelform,0,0,1,1
30206,खत्म,0,0,1,1
30205,acabou,0,0,1,1
30246,haces,0,0,1,1
30248,patent,0,0,1,1
30249,tilbyde,0,0,1,1
30273,видах,0,0,1,1
2506,progettata,1,1,0,1
30289,uppmanar,0,0,1,1
30288,அவரிடம்,0,0,1,1
30287,учебник,0,0,1,1
30286,angesehen,0,0,1,1
30285,universitarios,0,0,1,1
30284,चिंतित,0,0,1,1
30283,veranderd,0,0,1,1
30281,mérite,0,0,1,1
30280,ücretsiz,0,0,1,1
30278,जटिल,0,0,1,1
30277,saknar,0,0,1,1
30276,பிரிட்டானிக்காவின்,0,0,1,1
30275,бесплатно,0,0,1,1
30272,finnish,0,0,1,1
30250,وثلاثة,0,0,1,1
30271,осуществляют,0,0,1,1
30270,percatara,0,0,1,1
30269,व्यवसाय,0,0,1,1
30268,सकूं,0,0,1,1
30266,تقدمها,0,0,1,1
30265,gelmeyen,0,0,1,1
2509,finanziamento,1,1,0,1
30260,innebar,0,0,1,1
30258,moedertaalsprekers,0,0,1,1
30256,وتحرير,0,0,1,1
30254,ಮುಂದುವರಿಸಲು,0,0,1,1
30253,coexisted,0,0,1,1
30252,attenuates,0,0,1,1
2510,compilata,1,1,0,1
30203,supports,0,0,1,1
30202,എന്നതുകൊണ്ട്,0,0,1,1
30201,genomineerd,0,0,1,1
2523,ladina,1,1,0,1
30160,religious,0,0,1,1
30159,hole,0,0,1,1
30158,forvirre,0,0,1,1
30156,donaties,0,0,1,1
30153,guldgyldent,0,0,1,1
30152,recevoir,0,0,1,1
30151,souciait,0,0,1,1
30150,wikipedista,0,0,1,1
30149,കണ്ടെത്തൽ,0,0,1,1
30148,σύζυγος,0,0,1,1
30147,tatlım,0,0,1,1
30146,analytics,0,0,1,1
30145,ಅಳಲು,0,0,1,1
2521,uscita,1,1,0,1
30141,fixa,0,0,1,1
30162,actualisée,0,0,1,1
30140,mètres,0,0,1,1
30139,survived,0,0,1,1
30138,பெற்றுள்ளேன்,0,0,1,1
30137,ಶುಕ್ರವಾರವಾಗಿದ್ದರೆ,0,0,1,1
30136,തിരയിലിലൂടെ,0,0,1,1
2524,esaltano,1,1,0,1
30134,şişman,0,0,1,1
2525,specializzato,1,1,0,1
30132,कोरियाई,0,0,1,1
30131,dependendo,0,0,1,1
30130,κάθισε,0,0,1,1
2526,seguenti,1,1,0,1
30128,обнаружен,0,0,1,1
30126,automobile,0,0,1,1
30161,ενθαρρύνονται,0,0,1,1
30163,notify,0,0,1,1
30200,végétal,0,0,1,1
30184,luister,0,0,1,1
30199,skepsis,0,0,1,1
30198,украинскими,0,0,1,1
30196,novatos,0,0,1,1
30195,കാലങ്ങളായി,0,0,1,1
2520,prendessi,1,1,0,1
30193,ministre,0,0,1,1
30192,ನೋಡುತ್ತಿದ್ದರೆ,0,0,1,1
30191,λατρεύω,0,0,1,1
30190,സമ്പദ്‌വ്യവസ്ഥ,0,0,1,1
30189,choses ,0,0,1,1
30188,beş,0,0,1,1
30187,foreslået,0,0,1,1
30186,aylardır,0,0,1,1
30185,excesivo,0,0,1,1
30183,chelsea,0,0,1,1
30164,söyledi,0,0,1,1
30182,മതിയായ,0,0,1,1
30181,antigua,0,0,1,1
30179,ഭാഷയിലുള്ള,0,0,1,1
30177,ആശ്ചര്യപ്പെടുത്തുന്ന,0,0,1,1
30176,എന്നിവയിൽ,0,0,1,1
30175,आखिरी,0,0,1,1
30173,நர்சிஸ்,0,0,1,1
30172,ಭಾವಿಸಿದೆ,0,0,1,1
30171,intellectuelles,0,0,1,1
30169,انتقد,0,0,1,1
30168,ведущие,0,0,1,1
30167,entraîne,0,0,1,1
30166,supérieur,0,0,1,1
30165,passés,0,0,1,1
29926,zazaki,0,0,1,1
29922,consistera,0,0,1,1
29560,wikipediaträff,0,0,1,1
29684,bekendmaken,0,0,1,1
29676,dinosaurs,0,0,1,1
29677,разрабатывались,0,0,1,1
29678,замуж,0,0,1,1
29679,большому,0,0,1,1
29681,வாசகர்களையும்,0,0,1,1
29682,energidrik,0,0,1,1
29685,فيها،,0,0,1,1
29651,കണ്ടെത്തുകയാണ്,0,0,1,1
29686,கண்டறிந்ததோடு,0,0,1,1
29687,മാർഗ്ഗമാണ്,0,0,1,1
29690,stub,0,0,1,1
29691,sucediendo,0,0,1,1
29692,controverse ,0,0,1,1
29693,knappe,0,0,1,1
29675,उपहार,0,0,1,1
29674,παντρευτώ,0,0,1,1
29673,неделю,0,0,1,1
29672,amplio,0,0,1,1
29671,eleita,0,0,1,1
29670,coding,0,0,1,1
29667,وضميرًا,0,0,1,1
29666,weird,0,0,1,1
29665,administrative,0,0,1,1
29664,opensourcesoftware,0,0,1,1
29663,विज्ञान,0,0,1,1
29661,figuram,0,0,1,1
29660,"
luxemburguês",0,0,1,1
29656,viajando,0,0,1,1
2597,origini,1,1,0,1
29654,nederig,0,0,1,1
29653,planteamiento,0,0,1,1
2592,osservati,1,1,0,1
2591,comprare,1,1,0,1
29697,മില്ല്യൺ,0,0,1,1
29725,личных,0,0,1,1
29740,നെഗറ്റീവ്,0,0,1,1
29739,விளைவைப்,0,0,1,1
29738,هنا؟,0,0,1,1
29737,selfreplication,0,0,1,1
2587,sento,1,1,0,1
29735,masivo,0,0,1,1
29733,bn •,0,0,1,1
29732,السائح,0,0,1,1
29731,पता।,0,0,1,1
29730,consultationsmodifications,0,0,1,1
29729,ഉചിതമല്ല,0,0,1,1
29728,سيمونس,0,0,1,1
2588,capitoli,1,1,0,1
29726,girdiyse,0,0,1,1
29720,describen,0,0,1,1
29698,islandés,0,0,1,1
29718,"
सिलीसियाई",0,0,1,1
29716,горничные,0,0,1,1
29713,venga,0,0,1,1
29711,заведомо,0,0,1,1
29710,gestão,0,0,1,1
29709,tonlamayı,0,0,1,1
29708,postings,0,0,1,1
29707,δουλεύει,0,0,1,1
2590,prettamente,1,1,0,1
29705,реализуют,0,0,1,1
29704,شكر,0,0,1,1
29702,பயணத்தைத்,0,0,1,1
29701,участвуют,0,0,1,1
29700,birisidir,0,0,1,1
29652,альтернатива,0,0,1,1
29650,l’émergence,0,0,1,1
29921,sqlite,0,0,1,1
29594,pisa,0,0,1,1
29586,characterized,0,0,1,1
29587,simulan,0,0,1,1
29588,sondés,0,0,1,1
29591,tl •,0,0,1,1
29592,giderse,0,0,1,1
29593,கேள்விகளால்,0,0,1,1
29595,tagits,0,0,1,1
2598,steward,1,1,0,1
29597,மொத்தக்,0,0,1,1
2604,derivato,1,1,0,1
29600,cosmic,0,0,1,1
29602,compartilhada,0,0,1,1
29603,confère »,0,0,1,1
29604,ഒച്ചയുടെ,0,0,1,1
29585,வந்தார்கள்,0,0,1,1
29584,اتضح,0,0,1,1
29583,звонка,0,0,1,1
29582,téléverser,0,0,1,1
29580,dakikalar,0,0,1,1
2606,studiano,1,1,0,1
29578,मस्तिष्क,0,0,1,1
29577,सफलतापूर्वक,0,0,1,1
29576,सिफोलिली,0,0,1,1
29575,നിങ്ങൾക്കറിയാമെങ്കിൽ,0,0,1,1
29574,задание,0,0,1,1
29573,விக்கிப்பீடியாவாக,0,0,1,1
2608,partecipata,1,1,0,1
29566,kamm,0,0,1,1
29564,adoptó,0,0,1,1
2609,affidata,1,1,0,1
29561,المسجلون,0,0,1,1
29605,deliberate,0,0,1,1
29606,indícios,0,0,1,1
29607,vurgulamakta,0,0,1,1
29629,βιβλιογραφία,0,0,1,1
29647,اصبروا,0,0,1,1
29645,انقر,0,0,1,1
29644,sidst,0,0,1,1
29642,والإندونيسية,0,0,1,1
29641,originales,0,0,1,1
29640,oficina,0,0,1,1
2600,definizioni,1,1,0,1
29637,ಬಂದಿತು,0,0,1,1
29635,विक्षनरी,0,0,1,1
29634,dividir,0,0,1,1
29633,växla,0,0,1,1
29632,tommelfingrene,0,0,1,1
2601,rimanere,1,1,0,1
29630,orbital,0,0,1,1
29628,vorbereitet,0,0,1,1
29608,ವಿವರಿಸುವ,0,0,1,1
29627,πόλη,0,0,1,1
29626,ஆக்கப்பட்டு,0,0,1,1
29623,information ,0,0,1,1
29622,حساب,0,0,1,1
29621,париже,0,0,1,1
29619,sonriendo,0,0,1,1
29618,இருப்பதாகவும்,0,0,1,1
29617,குழுசேர,0,0,1,1
29616,التفكير,0,0,1,1
29613,ósseo,0,0,1,1
29612,टेलीग्राम,0,0,1,1
2602,inserzionisti,1,1,0,1
2603,ottenute,1,1,0,1
29609,inkluderar,0,0,1,1
29741,kommen,0,0,1,1
29742,« usage,0,0,1,1
29744,democratic,0,0,1,1
29865,venez,0,0,1,1
29858,скобок,0,0,1,1
29859,commons —,0,0,1,1
2565,strategia,1,1,0,1
29861,खुलापन,0,0,1,1
29862,organizados,0,0,1,1
29863,nicholson,0,0,1,1
29867,ಆರ್ಥಿಕತೆಯು,0,0,1,1
29745,ಎಲ್ಲಿದೆ,0,0,1,1
29868,erfaring,0,0,1,1
29869,anglia,0,0,1,1
29870,hızlıca,0,0,1,1
2564,alvinn,1,1,0,1
2562,organizzano,1,1,0,1
29873,wichtig,0,0,1,1
2566,colpevoli,1,1,0,1
29855,ziehen,0,0,1,1
2568,terzo,1,1,0,1
29853,اختلافات,0,0,1,1
2570,spezzato,1,1,0,1
29851,versionerna,0,0,1,1
29850,لسوء,0,0,1,1
29849,tidskriftsartiklar,0,0,1,1
29846,उसमें,0,0,1,1
29845,الإداريون،,0,0,1,1
29843,ബാൽക്കണിയിൽ,0,0,1,1
29842,المراجعة,0,0,1,1
29841,dotters,0,0,1,1
29840,presentador,0,0,1,1
29839,ومؤسس,0,0,1,1
29838,acceptere,0,0,1,1
29837,ക്ഷീണിതനാണോ,0,0,1,1
29875,метод,0,0,1,1
29876,καθένας,0,0,1,1
29878,मैक्स,0,0,1,1
29900,تجنب,0,0,1,1
29920,zhminnan •,0,0,1,1
29919,tendência,0,0,1,1
29916,ubrugeligt,0,0,1,1
29915,conditional,0,0,1,1
29912,النظرات,0,0,1,1
29911,assumant,0,0,1,1
29910,സാധ്യമാ‍വുകയുള്ളൂ,0,0,1,1
29909,innehöll,0,0,1,1
29908,dividido,0,0,1,1
29907,யூகிக்கிறீர்கள்,0,0,1,1
29905,heurísticas,0,0,1,1
29903,أشغال,0,0,1,1
29902,şikayetçi,0,0,1,1
29901,ഒരൊറ്റ,0,0,1,1
29898,démarche,0,0,1,1
29879,nouns,0,0,1,1
29896,يتعاونون,0,0,1,1
29894,resultantes,0,0,1,1
29893,മറികടന്നുവെന്നും,0,0,1,1
29892,കളയുന്നു,0,0,1,1
29891,ചുവടെ,0,0,1,1
29890,खातों,0,0,1,1
29888,ονείρων,0,0,1,1
2561,sportello,1,1,0,1
29885,يُنصح,0,0,1,1
29884,அடைய,0,0,1,1
29883,kasteel,0,0,1,1
29882,causadas,0,0,1,1
29881,primaria»​,0,0,1,1
29880,testament,0,0,1,1
29836,ingetrokken,0,0,1,1
29835,universitaria,0,0,1,1
29834,rulelearning,0,0,1,1
29770,είπα,0,0,1,1
29788,albert,0,0,1,1
29787,الأكبر,0,0,1,1
29786,bezighouden,0,0,1,1
29785,comprenez,0,0,1,1
29784,connectivity,0,0,1,1
2581,espresso,1,1,0,1
29782,métiers,0,0,1,1
2582,troverai,1,1,0,1
29780,введите,0,0,1,1
29777,vardera,0,0,1,1
29776,कमयूनिटीस,0,0,1,1
29774,مندهشة,0,0,1,1
29772,brauche,0,0,1,1
29771,malintencionadas,0,0,1,1
29769,échéance,0,0,1,1
29790,isimde,0,0,1,1
2583,animazione,1,1,0,1
29765,techniciens,0,0,1,1
29764,tide,0,0,1,1
29763,türkiye’den,0,0,1,1
2584,matematici,1,1,0,1
29760,bağlantı,0,0,1,1
29759,ಉತ್ಪ್ರೇಕ್ಷಿಸಲು,0,0,1,1
29757,потребность,0,0,1,1
29756,заморожен,0,0,1,1
2585,prendendo,1,1,0,1
29753,жарко,0,0,1,1
29752,mm,0,0,1,1
29748,منتديات,0,0,1,1
29747,learning”,0,0,1,1
29789,சொல்கிறது,0,0,1,1
29791,"
कज़ाख़",0,0,1,1
29833,reageren,0,0,1,1
29814,storlek,0,0,1,1
29832,söyleyen,0,0,1,1
29830,மூல,0,0,1,1
29829,криминального,0,0,1,1
29827,സമ്മതിച്ചാൽ,0,0,1,1
29826,traduzidos,0,0,1,1
29825,girilerek,0,0,1,1
29824,சிக்கல்களையும்,0,0,1,1
29822,சொல்லான,0,0,1,1
29821,συνεχίσει,0,0,1,1
29820,inedible,0,0,1,1
29819,ಸಲಹೆಯನ್ನು,0,0,1,1
29818,shells,0,0,1,1
29817,alimentador,0,0,1,1
2574,confusione,1,1,0,1
29813,എഴുതുന്നു,0,0,1,1
29792,إنشاؤها,0,0,1,1
29811,poser,0,0,1,1
29809,கண்ணீருக்கு,0,0,1,1
29808,नेगोशिएशन,0,0,1,1
29806,physicochimiques,0,0,1,1
29805,प्रविष्टियाॅं,0,0,1,1
29804,പദ്ധതിക്ക്,0,0,1,1
29801,lorsqu,0,0,1,1
29800,തമാശ,0,0,1,1
2578,irregolare»,1,1,0,1
29798,tapiz,0,0,1,1
29797,påbörjade,0,0,1,1
29796,selección,0,0,1,1
29794,уходить,0,0,1,1
29793,динамику,0,0,1,1
28806,gezicht,0,0,1,1
28803,sürümleri,0,0,1,1
27281,لمستخدمها,0,0,1,1
27794,ورائعًا,0,0,1,1
27786,atende,0,0,1,1
27787,നിർഭാഗ്യവശാൽ,0,0,1,1
27789,låst,0,0,1,1
27790,vikipedisine,0,0,1,1
27791,bahsetmişken,0,0,1,1
27793,تعلمون,0,0,1,1
27795,sebeple,0,0,1,1
27764,ಕೊಡುವಷ್ಟು,0,0,1,1
27796,djupintervjuer,0,0,1,1
27797,källförteckningens,0,0,1,1
27798,mêmes,0,0,1,1
27799,fundó,0,0,1,1
27800,ستساعدني,0,0,1,1
27803,fundamentalmente,0,0,1,1
27785,спроса,0,0,1,1
27784,बचना।,0,0,1,1
27783,நோக்கற்ற,0,0,1,1
27780,طورت,0,0,1,1
27779,välmenade,0,0,1,1
27778,ஒருவரைச்,0,0,1,1
27777,neatly,0,0,1,1
27776,continent,0,0,1,1
27775,ranches,0,0,1,1
27774,प्रारम्भ,0,0,1,1
27773,«bibliotecario»,0,0,1,1
2854,antiche,1,1,0,1
27771,acepto,0,0,1,1
27769,géants,0,0,1,1
27768,kanılara,0,0,1,1
27767,உரையாடலையும்,0,0,1,1
27766,المحايدة،,0,0,1,1
27804,отблагодарить,0,0,1,1
27805,الأمريكية،,0,0,1,1
27807,türk,0,0,1,1
27830,bekämpar,0,0,1,1
27848,عفوا؟,0,0,1,1
27847,pai,0,0,1,1
27845,raisonnement,0,0,1,1
27844,بليدًا,0,0,1,1
27842,τρομερός,0,0,1,1
27841,πλούσιος,0,0,1,1
27840,bemeducado,0,0,1,1
27838,juges,0,0,1,1
2847,incoraggia,1,1,0,1
27836,inherited,0,0,1,1
27835,chiques,0,0,1,1
2850,noioso,1,1,0,1
2851,commerciali,1,1,0,1
27831,ಸಾಮಾನ್ಯವಾಗಿ,0,0,1,1
27829,അടിച്ചേൽപ്പിക്കാൻ,0,0,1,1
27808,nationale,0,0,1,1
27828,فوقي,0,0,1,1
27827,ആവർത്തനം,0,0,1,1
27826,servrarna,0,0,1,1
27825,gepubliceerd,0,0,1,1
27823,niveles,0,0,1,1
27822,clásicas,0,0,1,1
27821,चेहरे,0,0,1,1
27818,esszimmer,0,0,1,1
27817,weggeschickt,0,0,1,1
27815,hemel,0,0,1,1
27813,whom,0,0,1,1
27812,ആവശ്യമാണെന്ന്,0,0,1,1
27810,oxfordsystemet,0,0,1,1
27809,ओ,0,0,1,1
2855,farebbe,1,1,0,1
27763,ಪ್ರಜ್ಞೆಯು,0,0,1,1
27852,totally,0,0,1,1
27703,плачете,0,0,1,1
27696,discrepancy,0,0,1,1
27698,தமக்கு,0,0,1,1
27699,secondaire,0,0,1,1
27700,вечер,0,0,1,1
27701,स्वयंसेवक,0,0,1,1
27702,κάποτε,0,0,1,1
27704,administrados,0,0,1,1
2856,dà,1,1,0,1
27705,wikipetan,0,0,1,1
27706,intelligens,0,0,1,1
27709,millennium,0,0,1,1
27712,processamento,0,0,1,1
27713,retener,0,0,1,1
27715,emocionamos,0,0,1,1
27695,euskera,0,0,1,1
27693,دعنى,0,0,1,1
27692,desfrutam,0,0,1,1
27691,gewaltig,0,0,1,1
27690,உள்ள,0,0,1,1
2860,riguardano,1,1,0,1
27687,polícia,0,0,1,1
2861,lamentele,1,1,0,1
27684,exceptions—most,0,0,1,1
27683,"
वोरो",0,0,1,1
2862,conoscerti,1,1,0,1
27681,आना,0,0,1,1
27680,regrouper,0,0,1,1
27679,उल्लेखनीय,0,0,1,1
27676,dessus,0,0,1,1
27675,reinvention,0,0,1,1
27674,टूटा,0,0,1,1
27716,vuil,0,0,1,1
27717,verschiedenen,0,0,1,1
27718,சந்திக்கிறீர்கள்,0,0,1,1
27741,inteiramente,0,0,1,1
2857,distribuita,1,1,0,1
2858,newsweek,1,1,0,1
27758,προσέχεις,0,0,1,1
27757,beleidigend,0,0,1,1
27755,दिखायी,0,0,1,1
27754,däremot,0,0,1,1
27752,envision,0,0,1,1
27751,தேர்வுகள்,0,0,1,1
27749,جوعا,0,0,1,1
27747,ψάχνετε,0,0,1,1
27746,pitts,0,0,1,1
27745,talimatları,0,0,1,1
27744,अमान्य,0,0,1,1
27743,d’extrapoler,0,0,1,1
27740,billions,0,0,1,1
27719,lezers,0,0,1,1
27739,totalités,0,0,1,1
27738,إفراغ,0,0,1,1
27737,bemærke,0,0,1,1
27736,encouraged,0,0,1,1
27735,fato,0,0,1,1
27733,ரூபி,0,0,1,1
27732,தோல்விகளுக்குப்,0,0,1,1
27730,மந்தமாகிவிட்டது,0,0,1,1
27727,cpus,0,0,1,1
27726,للطريقة,0,0,1,1
27725,değiştirmiştir,0,0,1,1
27724,ഉത്സാഹം,0,0,1,1
27723,kelimelerinin,0,0,1,1
27722,"
क्वैचुआ",0,0,1,1
27851,défendent,0,0,1,1
27853,recovery,0,0,1,1
28802,ошибаетесь,0,0,1,1
27975,മാന്ത്രികജീവികളായിരുന്നു,0,0,1,1
27968,வகைப்படுத்தப்படும்,0,0,1,1
27969,sayfasını,0,0,1,1
27970,hittade,0,0,1,1
27972,discern,0,0,1,1
27973,ряд,0,0,1,1
27974,grupparbeten,0,0,1,1
27976,molten,0,0,1,1
27942,حقوق,0,0,1,1
27977,karakter,0,0,1,1
27979,« ville,0,0,1,1
27980,τελειώσουν,0,0,1,1
27981,strategisk,0,0,1,1
27982,ചെയ്തിട്ടില്ലെങ്കിൽ,0,0,1,1
27984,f,0,0,1,1
27967,വിക്കിപീഡിയർക്കോ,0,0,1,1
27966,география,0,0,1,1
27964,houden,0,0,1,1
27963,вижу,0,0,1,1
27962,غدا؟,0,0,1,1
27959,guia,0,0,1,1
27958,أوباما,0,0,1,1
27957,झिझक,0,0,1,1
27956,soumises,0,0,1,1
27955,”the,0,0,1,1
27954,உட்பட்டுவரும்,0,0,1,1
27952,വേണ്ടത്ര,0,0,1,1
27951,cevap,0,0,1,1
27950,المقاومة,0,0,1,1
27949,الضابطة,0,0,1,1
27948,ஊமை,0,0,1,1
27947,förklara,0,0,1,1
27985,அன்றிலிருந்து,0,0,1,1
27986,ಹೇಳುತ್ತದೆ,0,0,1,1
27987,yaptığınız,0,0,1,1
28012,oviedo,0,0,1,1
28035,மார்ச்,0,0,1,1
28029,rechazado,0,0,1,1
28028,voorstel,0,0,1,1
28027,സുന്ദരിയാകാൻ,0,0,1,1
2821,indicizza,1,1,0,1
2822,fortunata,1,1,0,1
28023,fracaso,0,0,1,1
2823,vissuto,1,1,0,1
28021,arbejder,0,0,1,1
28020,പ്രമുഖ,0,0,1,1
28019,funções,0,0,1,1
28018,forumsnote,0,0,1,1
28016,yanındaki,0,0,1,1
28014,wordsense,0,0,1,1
28011,كاليفورنيا,0,0,1,1
27988,وبراون،,0,0,1,1
2827,accetta,1,1,0,1
28009,survival,0,0,1,1
28003,sevdiğin,0,0,1,1
28002,developing,0,0,1,1
27999,പരിഹരിക്കുന്നു,0,0,1,1
27998,اختباري,0,0,1,1
27997,हालांकि,0,0,1,1
27996,правилам,0,0,1,1
27995,ವಿಷಯವನ್ನು,0,0,1,1
27994,λογότυπο,0,0,1,1
27993,yapmamız,0,0,1,1
27991,detaljerat,0,0,1,1
27990,вреда,0,0,1,1
27989,قلت,0,0,1,1
27945,hangi,0,0,1,1
27941,الخيارات,0,0,1,1
27854,valet,0,0,1,1
27882,prit,0,0,1,1
27874,endless,0,0,1,1
27875,brusca,0,0,1,1
27876,இக்,0,0,1,1
27877,συνέχεια,0,0,1,1
27879,commandement,0,0,1,1
2839,distolse,1,1,0,1
2838,contrassegnato,1,1,0,1
27940,ಪಡುತ್ತಿದ್ದೆ,0,0,1,1
27884,requiring,0,0,1,1
27885,какуюлибо,0,0,1,1
27888,genoegen,0,0,1,1
27889,améliorait,0,0,1,1
27890,lleve,0,0,1,1
27891,математического,0,0,1,1
27873,имеешь,0,0,1,1
2840,editoriali,1,1,0,1
27871,എമ്മിൽ,0,0,1,1
27870,connecting,0,0,1,1
27869,herzlich,0,0,1,1
27868,कील,0,0,1,1
27867,anônima,0,0,1,1
27864,çıktı,0,0,1,1
27863,невозможную,0,0,1,1
2842,esterne,1,1,0,1
2843,intervista,1,1,0,1
2845,cercano,1,1,0,1
27859,ಹೆಣಗಾಡುತ್ತಿದ್ದ,0,0,1,1
27858,пересматривают,0,0,1,1
27857,മോശമായ,0,0,1,1
27856,ಪ್ರೀತಿಸುತ್ತಿಲ್ಲ,0,0,1,1
27855,وسأكون,0,0,1,1
27892,നേടിയിട്ടുണ്ടെങ്കിൽ,0,0,1,1
27893,eye,0,0,1,1
27894,जावानी,0,0,1,1
2834,deriva,1,1,0,1
27939,escolas,0,0,1,1
27938,crédito,0,0,1,1
2829,superavano,1,1,0,1
27936,भत्ते,0,0,1,1
27935,consideremos,0,0,1,1
27934,« violation,0,0,1,1
27933,நினைத்துப்,0,0,1,1
27932,rosário,0,0,1,1
2831,cinesi,1,1,0,1
27930,sauvegarde,0,0,1,1
27929,टर्म,0,0,1,1
27928,redigeringsgränssnitt,0,0,1,1
2833,iniziamo,1,1,0,1
27926,woordenschat,0,0,1,1
27924,yorker,0,0,1,1
27896,upptäckte,0,0,1,1
27920,αναζήτηση,0,0,1,1
27918,रेडियो,0,0,1,1
27917,nonwhite,0,0,1,1
27914,предлагаемой,0,0,1,1
2835,traffico,1,1,0,1
27912,шоу,0,0,1,1
27909,seront,0,0,1,1
27907,ಹೆಸರನ್ನು,0,0,1,1
27905,συνδυασμό,0,0,1,1
27904,feed,0,0,1,1
27903,ആദ്യത്തേത്,0,0,1,1
27902,использованием,0,0,1,1
27901,remunerado,0,0,1,1
27900,fragezeichen,0,0,1,1
27673,ख़बरों,0,0,1,1
27672,journalists,0,0,1,1
27669,kaçınmak,0,0,1,1
27409,certas,0,0,1,1
2897,integrata,1,1,0,1
27399,attorney,0,0,1,1
2896,sequenziamento,1,1,0,1
27401,végétaux,0,0,1,1
27405,wortnummer,0,0,1,1
27408,വരുത്തുവാൻ,0,0,1,1
27410,praticar,0,0,1,1
27375,helion,0,0,1,1
27412,gidelim,0,0,1,1
27413,miradas,0,0,1,1
27414,téléspectateurs,0,0,1,1
27415,adopción,0,0,1,1
27416,главной,0,0,1,1
27417,semibeskyttet,0,0,1,1
27396,serbian,0,0,1,1
27395,പക്ഷിയുടെതുപോലെയുള്ള,0,0,1,1
27394,فيوجد,0,0,1,1
2898,semplice,1,1,0,1
27392,breaks”,0,0,1,1
27390,പടയാളികളും,0,0,1,1
27389,gemensamt,0,0,1,1
27388,distinguant,0,0,1,1
27387,ಬೆಳ್ಳಿ,0,0,1,1
2900,commentato,1,1,0,1
27383,разведывательного,0,0,1,1
27382,«быстро»,0,0,1,1
27381,hackernoon,0,0,1,1
27380,agréable,0,0,1,1
27379,ಬಸವನ,0,0,1,1
27378,forem,0,0,1,1
27377,φυλακισμένοι,0,0,1,1
27421,إلكترونية,0,0,1,1
27422,citem,0,0,1,1
27423,விளக்குங்கள்,0,0,1,1
27447,excel,0,0,1,1
27469,meines,0,0,1,1
27468,டிரைவ்வேயை,0,0,1,1
27467,hapşırdığında,0,0,1,1
27463,landed,0,0,1,1
27461,движется,0,0,1,1
27460,живём,0,0,1,1
27459,siga,0,0,1,1
27458,sporen,0,0,1,1
27457,dichotomy,0,0,1,1
27456,tebrik,0,0,1,1
27455,empreinte,0,0,1,1
27451,dérange,0,0,1,1
27450,вечера,0,0,1,1
27449,frotté,0,0,1,1
27446,arkivversionen,0,0,1,1
27425,cümlenin,0,0,1,1
27445,scoren,0,0,1,1
27444,déplace,0,0,1,1
27443,தயாரித்தேன்,0,0,1,1
27442,recombined,0,0,1,1
27441,motsätter,0,0,1,1
27439,автоматизация,0,0,1,1
27437,retirados,0,0,1,1
27436,கேள்வியைக்,0,0,1,1
27434,ಮಾತನಾಡುತ್ತಾ,0,0,1,1
27432,llevas,0,0,1,1
27429,suggesties,0,0,1,1
27428,ಸಾಧ್ಯವಾಗದಿದ್ದರೆ,0,0,1,1
27427,विकिपिडियन,0,0,1,1
27426,திருமணத்திற்கு,0,0,1,1
27376,«быть,0,0,1,1
27374,ജനനം,0,0,1,1
27668,ahogarse,0,0,1,1
27317,crust,0,0,1,1
27311,erişime,0,0,1,1
27312,catalyst,0,0,1,1
27313,"
indonésio",0,0,1,1
27314,sağladı,0,0,1,1
27315,scenario,0,0,1,1
27316,formeel,0,0,1,1
27318,यूजमोडविकी,0,0,1,1
27373,கூட்டுப்,0,0,1,1
27320,жаловаться,0,0,1,1
27322,government,0,0,1,1
27323,étroites,0,0,1,1
27324,poängterar,0,0,1,1
27326,primeiras,0,0,1,1
27327,bloqué,0,0,1,1
27310,compraram,0,0,1,1
27309,анонимного,0,0,1,1
27305,الأغاني,0,0,1,1
27303,filho,0,0,1,1
27302,buysa,0,0,1,1
27299,الرسوم,0,0,1,1
27296,αδύνατη,0,0,1,1
27295,dissidents,0,0,1,1
27294,«активизируйте,0,0,1,1
27293,الأكبر،,0,0,1,1
27290,relations,0,0,1,1
27289,जीते।,0,0,1,1
27287,harsh,0,0,1,1
27286,«сообщить,0,0,1,1
27285,எழுதப்படுகின்றன,0,0,1,1
27284,vaincre,0,0,1,1
2909,necessità,1,1,0,1
27328,برقية,0,0,1,1
27329,частично,0,0,1,1
27330,இராணுவத்தால்,0,0,1,1
27349,tänt,0,0,1,1
27371,κρατήσουμε,0,0,1,1
2901,facessi,1,1,0,1
27369,നിർമ്മിക്കുവാനുള്ള,0,0,1,1
27366,умно,0,0,1,1
2902,piacessero,1,1,0,1
27363,ನಾರ್ಸಿಸಾದ,0,0,1,1
27362,konsultera,0,0,1,1
27361,έρχονται,0,0,1,1
27358,levens,0,0,1,1
27357,barnstars,0,0,1,1
27355,ಸಲಾಡ್,0,0,1,1
27354,بنهاية,0,0,1,1
27352,अंगूठा,0,0,1,1
27350,unbeschreiblich,0,0,1,1
27348,கிராமத்தில்,0,0,1,1
27331,inhoudelijke,0,0,1,1
27347,பொருள்படும்,0,0,1,1
27345,yiyecekler,0,0,1,1
27344,amérindiennes,0,0,1,1
27343,kino,0,0,1,1
27342,« aujourd,0,0,1,1
27341,solitude,0,0,1,1
27340,aldeia,0,0,1,1
27339,vérification,0,0,1,1
27338,pl •,0,0,1,1
27336,albümüdür,0,0,1,1
27335,categorize,0,0,1,1
27334,enganado,0,0,1,1
27333,अनजाने,0,0,1,1
2903,boccone,1,1,0,1
27470,हीरों,0,0,1,1
27471,γεωμετρία,0,0,1,1
27475,"
अरबी",0,0,1,1
27607,ആഗ്രഹിക്കുന്നതെന്തും,0,0,1,1
27598,begegnete,0,0,1,1
27599,ಜೋಸೆಫ್,0,0,1,1
27601,¿tienes,0,0,1,1
27602,пытался,0,0,1,1
27603,«зверство»,0,0,1,1
27605,michelle,0,0,1,1
27608,cierto,0,0,1,1
27476,marmeladen,0,0,1,1
2878,ringraziandoti,1,1,0,1
27612,पैमाने,0,0,1,1
27613,प्रेमिका,0,0,1,1
27614,ഭാഗമാണ്,0,0,1,1
27615,بالحيرة,0,0,1,1
27617,donatorer,0,0,1,1
27596,formerly,0,0,1,1
27595,πρώτη,0,0,1,1
27594,« instruction »,0,0,1,1
27590,الطب,0,0,1,1
27589,conselho,0,0,1,1
27587,الجامعات،,0,0,1,1
27583,comboio,0,0,1,1
27581,என்பதற்குப்,0,0,1,1
27580,parçasını,0,0,1,1
27579,البيانات،,0,0,1,1
27577,награды,0,0,1,1
27576,عزا,0,0,1,1
27575,للهوية,0,0,1,1
2880,inammissibili,1,1,0,1
2881,interventi,1,1,0,1
27572,semantisk,0,0,1,1
2882,eppure,1,1,0,1
27618,servrarb,0,0,1,1
2877,considerato,1,1,0,1
27622,ವಹಿಸಿ,0,0,1,1
27644,द्वितीय,0,0,1,1
27667,incompatíveis,0,0,1,1
2867,personale,1,1,0,1
27664,split,0,0,1,1
27662,constable,0,0,1,1
27660,मई,0,0,1,1
27659,jean,0,0,1,1
27657,ಡ್ರಿಂಕ್‌ನೊಂದಿಗೆ,0,0,1,1
27656,وترى,0,0,1,1
27655,domaine ,0,0,1,1
27654,أسئلة,0,0,1,1
27653,hoaxen,0,0,1,1
27650,derniers,0,0,1,1
2872,valore,1,1,0,1
27645,sanırım,0,0,1,1
27642,ಅಭಿನಂದನೆಗಳು,0,0,1,1
27623,empêchant,0,0,1,1
27641,konversation,0,0,1,1
2874,costituite,1,1,0,1
27638,lustres,0,0,1,1
27637,ചാടിയാൽ,0,0,1,1
27636,الجانب,0,0,1,1
27635,занимает,0,0,1,1
27632,"
बान्युमासन",0,0,1,1
27631,esforços,0,0,1,1
2875,momenti,1,1,0,1
27629,isimli,0,0,1,1
27627,ámsterdam,0,0,1,1
27626,specialistische,0,0,1,1
27625,falsedad,0,0,1,1
27624,memex,0,0,1,1
27569,التفاصيل,0,0,1,1
27568,importo,0,0,1,1
27564,नमस्ते,0,0,1,1
27497,olsam,0,0,1,1
27513,മാതൃകകളിൽ,0,0,1,1
27512,referendum,0,0,1,1
27511,உச்சரிப்பைக்,0,0,1,1
27510,parecía,0,0,1,1
27509,സംസാരിച്ചിരിക്കാം,0,0,1,1
27508,underholdende,0,0,1,1
27507,daarbij,0,0,1,1
27506,أراه,0,0,1,1
27505,mbh,0,0,1,1
27504,οικουμενικής,0,0,1,1
27503,contato,0,0,1,1
27502,hábitos,0,0,1,1
27500,diferencias,0,0,1,1
27499,остановить»,0,0,1,1
27495,ludique,0,0,1,1
27516,wordsworth,0,0,1,1
27493,سيئة,0,0,1,1
27492,политической,0,0,1,1
27491,खोये,0,0,1,1
27490,doğrulanabilecek,0,0,1,1
27489,probeert,0,0,1,1
27487,എസ്എംഎസ്,0,0,1,1
27486,വിവരസ്രോതസ്സുകളും,0,0,1,1
27485,geträumt,0,0,1,1
27484,problemáticos,0,0,1,1
27483,proíbem,0,0,1,1
27481,eski,0,0,1,1
27480,തിരഞ്ഞെടുപ്പുകളെക്കുറിച്ച്,0,0,1,1
27479,മുൻപുള്ള,0,0,1,1
27477,fing,0,0,1,1
27515,interesan,0,0,1,1
27517,humana,0,0,1,1
27563,μαριάν,0,0,1,1
27542,genera,0,0,1,1
27562,இலக்கணம்,0,0,1,1
2885,mandare,1,1,0,1
27560,எட்டு,0,0,1,1
27558,betroffen,0,0,1,1
27556,വെള്ളപ്പൊക്കം,0,0,1,1
2886,induttivi,1,1,0,1
27554,калифорнии,0,0,1,1
27552,ekmeme,0,0,1,1
27550,nivå,0,0,1,1
27547,anglaises,0,0,1,1
27546,കാര്യം,0,0,1,1
27545,устраняются,0,0,1,1
27544,നിന്നെക്കുറിച്ച്,0,0,1,1
27543,ಗೊಂದಲಕ್ಕೊಳಗಾಗಿದ್ದರೆ,0,0,1,1
2887,raddoppiate,1,1,0,1
27518,partner,0,0,1,1
27537,"
दक्षिण",0,0,1,1
27536,ನೋಡುತ್ತಿರುವಿರಿ,0,0,1,1
27534,energiebeispiel,0,0,1,1
27533,proveito,0,0,1,1
2888,glielo,1,1,0,1
27531,consacrés,0,0,1,1
27530,gøres,0,0,1,1
27528,ಐಸ್,0,0,1,1
27527,"
neerlandês",0,0,1,1
27523,implementar,0,0,1,1
27522,பணக்காரர்,0,0,1,1
27521,ಕಾರ್ಯನಿರತರಾಗಿರಬಹುದು,0,0,1,1
27520,yazılarına,0,0,1,1
27519,males,0,0,1,1
28036,உணர்த்தியது,0,0,1,1
28037,сидят,0,0,1,1
28038,undskylder,0,0,1,1
2745,valutato,1,1,0,1
28541,guldbröd,0,0,1,1
28542,karikatüründe,0,0,1,1
28543,devras,0,0,1,1
28544,zware,0,0,1,1
28545,достоинств,0,0,1,1
28546,schrijfsters,0,0,1,1
28548,durabilité,0,0,1,1
28518,introduce,0,0,1,1
28550,நினைக்கலாம்,0,0,1,1
28551,உணர்கிறேன்,0,0,1,1
28552,parmaklarımda,0,0,1,1
28554,toleransen,0,0,1,1
2744,culturali,1,1,0,1
28556,ذروته,0,0,1,1
28540,ಒಬ್ಬರು,0,0,1,1
2746,difendere,1,1,0,1
2747,«le,1,1,0,1
2748,incompleto,1,1,0,1
28533,tröskeln,0,0,1,1
28532,जनरल,0,0,1,1
2749,pretendenti,1,1,0,1
28530,naamwoord,0,0,1,1
28529,δυστυχώς,0,0,1,1
28528,herbert,0,0,1,1
28527,vitaliste,0,0,1,1
28526,gezegd,0,0,1,1
28525,ف,0,0,1,1
28524,σμαράγδια,0,0,1,1
2750,razionale,1,1,0,1
28522,السينما,0,0,1,1
28521,ആക്കി,0,0,1,1
28557,ಗಣಿತ,0,0,1,1
28559,alten,0,0,1,1
2743,addestrare,1,1,0,1
28592,ipadressen,0,0,1,1
2738,abbiano,1,1,0,1
2739,acquisita,1,1,0,1
28613,طبيعية,0,0,1,1
28612,verktygs,0,0,1,1
28611,erwähne,0,0,1,1
28609,ಉತ್ತರಿಸಬಹುದು,0,0,1,1
28605,respectivamente,0,0,1,1
28604,tg •,0,0,1,1
28599,qualifié,0,0,1,1
28598,подвержены,0,0,1,1
28597,abschied,0,0,1,1
28596,datagenerating,0,0,1,1
28595,s’est,0,0,1,1
28593,patentlerle,0,0,1,1
28591,enrichir,0,0,1,1
28561,« actif »,0,0,1,1
28590,متصل,0,0,1,1
28589,മനസ്സിലായില്ല,0,0,1,1
28587,belongs,0,0,1,1
28580,இலவசமா,0,0,1,1
28579,investigaciones,0,0,1,1
28578,gewerkt,0,0,1,1
28575,tallrik,0,0,1,1
28574,ವಿವರಿಸಿ,0,0,1,1
28573,флорида,0,0,1,1
28571,arcade,0,0,1,1
28569,pratiques »,0,0,1,1
28568,избранных,0,0,1,1
2740,blair»,1,1,0,1
28562,omöjlig,0,0,1,1
2751,webmasters,1,1,0,1
2752,egoista,1,1,0,1
2761,rimosso,1,1,0,1
2759,immaginassero,1,1,0,1
28457,ಶಾಲೆಯಿಂದ,0,0,1,1
28458,ತ್ರೈಮಾಸಿಕದಲ್ಲಿ,0,0,1,1
28459,nützliche,0,0,1,1
28460,بمقابلتك,0,0,1,1
28461,législatives,0,0,1,1
28462,والفرنسية,0,0,1,1
28464,preguiçosas,0,0,1,1
28516,டெல்லியில்,0,0,1,1
28465,correcta,0,0,1,1
28466,пальчиках,0,0,1,1
28467,إنترويكي،,0,0,1,1
28468,llamaba,0,0,1,1
2758,offra,1,1,0,1
2757,apporta,1,1,0,1
28456,സാമാന്യവത്കരണത്തെയും,0,0,1,1
28455,ஆழமாக,0,0,1,1
28454,«новости»,0,0,1,1
28452,sedento,0,0,1,1
28450,viss,0,0,1,1
28449,obligados,0,0,1,1
28448,fruit—topics,0,0,1,1
28447,профессионализму,0,0,1,1
28446,issu,0,0,1,1
2760,accadono,1,1,0,1
28444,avser,0,0,1,1
28443,ದುರದೃಷ್ಟವಶಾತ್,0,0,1,1
28442,personnesai,0,0,1,1
28440,enviada,0,0,1,1
28439,ka •,0,0,1,1
28438,достоверность,0,0,1,1
28436,oturup,0,0,1,1
28472,ape,0,0,1,1
28474,പ്രത്യേകം,0,0,1,1
28475,kullandıkları,0,0,1,1
28494,popcultuur,0,0,1,1
28515,शूरवीर,0,0,1,1
28514,kredisine,0,0,1,1
28513,svagheter,0,0,1,1
28511,hubo,0,0,1,1
28508,apologies,0,0,1,1
28507,ಹೇಳದೆ,0,0,1,1
28504,starting,0,0,1,1
28503,الإضافة,0,0,1,1
28502,ساعات,0,0,1,1
28501,maatschappij,0,0,1,1
28500,centralized,0,0,1,1
28499,computationally,0,0,1,1
2753,condivisibile,1,1,0,1
28497,ಸೂಕ್ತವಾಗಿದೆ,0,0,1,1
28493,зрения»,0,0,1,1
28476,anticonsensus,0,0,1,1
28492,വെയിൽ‌സ്,0,0,1,1
28491,nationaal,0,0,1,1
28490,chrétien,0,0,1,1
28489,கட்டுரையையும்,0,0,1,1
2754,stile,1,1,0,1
28487,qualify,0,0,1,1
28485,indispensables,0,0,1,1
28484,стоило,0,0,1,1
28483,disruptivas,0,0,1,1
2755,soldati,1,1,0,1
28481,aquifers,0,0,1,1
28480,rapporterade,0,0,1,1
28478,обсуждения,0,0,1,1
28477,kevin,0,0,1,1
28617,യാത്രയ്ക്കിടയിലോ,0,0,1,1
28618,fameux,0,0,1,1
28619,privileged,0,0,1,1
2718,karcher,1,1,0,1
28744,mönstret,0,0,1,1
28745,coule,0,0,1,1
28748,சாப்பிடமுடியாத,0,0,1,1
28749,mythique,0,0,1,1
28750,regulate,0,0,1,1
2719,carattere,1,1,0,1
28754,lavar,0,0,1,1
28620,छींक,0,0,1,1
28755,våldtäktsincidenterna,0,0,1,1
28756,désacralisé,0,0,1,1
28757,certifiquese,0,0,1,1
28758,geldiniz,0,0,1,1
28759,respekterar,0,0,1,1
28760,ಕಾಣುತ್ತಿದ್ದೀರಿ,0,0,1,1
28743,fantastiques,0,0,1,1
28742,archief,0,0,1,1
28741,ನೀವಿರಿ,0,0,1,1
28740,पुनः,0,0,1,1
28739,mentally,0,0,1,1
28737,touriste,0,0,1,1
28736,hänvisning,0,0,1,1
28733,llamaron,0,0,1,1
2722,prigionieri,1,1,0,1
28729,இணையத்தில்,0,0,1,1
28727,vibber,0,0,1,1
28726,transcendantalistes,0,0,1,1
2723,sbalordito,1,1,0,1
2725,lombardo,1,1,0,1
28722,ദിവസവും,0,0,1,1
28721,factibles,0,0,1,1
28720,impulsó,0,0,1,1
28761,ziyaret,0,0,1,1
2716,entrato,1,1,0,1
28764,acalmese,0,0,1,1
28783,ഉണ്ടായത്,0,0,1,1
28801,schmutz,0,0,1,1
28799,γίνουμε,0,0,1,1
28798,meegaan,0,0,1,1
28797,очереди,0,0,1,1
28796,haklarından,0,0,1,1
28792,japanse,0,0,1,1
28791,hulpmiddelen,0,0,1,1
28790,расстроен,0,0,1,1
28789,amaba,0,0,1,1
28788,sevk,0,0,1,1
28787,ടെലിഗ്രാം,0,0,1,1
2711,dimostrazione,1,1,0,1
28785,صرف,0,0,1,1
28784,accountability,0,0,1,1
28782,زمن,0,0,1,1
28766,denoting,0,0,1,1
28781,anarchism,0,0,1,1
28780,besöka,0,0,1,1
28779,محرك,0,0,1,1
28778,विकियात्रा,0,0,1,1
2713,detenuto,1,1,0,1
28776,κοχύλι,0,0,1,1
28775,случаются,0,0,1,1
28774,великобритании,0,0,1,1
28772,governamental,0,0,1,1
2714,diritto,1,1,0,1
2715,insufficienza,1,1,0,1
28769,बेहतरीन,0,0,1,1
28768,verschijnen,0,0,1,1
28767,സ്ഥാനക്കയറ്റം,0,0,1,1
28719,историография,0,0,1,1
28718,அவளை,0,0,1,1
28717,avantajları,0,0,1,1
28646,வழக்கமான,0,0,1,1
28664,خاطئًا,0,0,1,1
28662,teniendo,0,0,1,1
28660,планете,0,0,1,1
28659,разговор,0,0,1,1
28658,العادات,0,0,1,1
28657,γέλια,0,0,1,1
28656,conceitos,0,0,1,1
28655,kända,0,0,1,1
28654,αντιφατικούς,0,0,1,1
28653,تعقب,0,0,1,1
28652,fangst,0,0,1,1
28651,учреждений,0,0,1,1
28650,значительное,0,0,1,1
28648,biomedical,0,0,1,1
28645,transcendentalist,0,0,1,1
28668,ξεχνάει,0,0,1,1
28644,amateurwetenschappers,0,0,1,1
28642,resultados​,0,0,1,1
28641,чихнул,0,0,1,1
28633,anexadas,0,0,1,1
28632,formål,0,0,1,1
28631,tons,0,0,1,1
28630,contributrices,0,0,1,1
28628,समझाएं,0,0,1,1
2736,vettori,1,1,0,1
28626,corroborado,0,0,1,1
2737,inesistente,1,1,0,1
28624,udnytte,0,0,1,1
28623,modifiable,0,0,1,1
28622,centrase,0,0,1,1
28665,ta •,0,0,1,1
28669,recolección,0,0,1,1
2726,scopi»,1,1,0,1
28692,titta,0,0,1,1
28714,properly,0,0,1,1
28713,திரும்புவார்,0,0,1,1
28711,утонуть,0,0,1,1
28710,ενθουσιασμένοι,0,0,1,1
28707,добровольцев»,0,0,1,1
2728,conteneva,1,1,0,1
28703,സാദ്ധ്യതയുണ്ട്,0,0,1,1
28702,harboring,0,0,1,1
28701,extraordinaire,0,0,1,1
28699,uzlaşamamasına,0,0,1,1
28697,dönüşüyor,0,0,1,1
28696,ಪಡೆದಾಗ,0,0,1,1
28695,библиотеки»,0,0,1,1
28693,vivas,0,0,1,1
28691,கிளாஸ்,0,0,1,1
28670,хабрахабр,0,0,1,1
2731,lettori,1,1,0,1
2732,suona,1,1,0,1
28688,وحتى,0,0,1,1
28686,verificación,0,0,1,1
28685,unifiés ,0,0,1,1
28684,التعليمية,0,0,1,1
28683,ಕರೆದೊಯ್ಯಿರಿ,0,0,1,1
28682,wikipediawebbgränssnitt,0,0,1,1
28681,تصويره,0,0,1,1
28679,الأخطاء,0,0,1,1
28678,doutorado,0,0,1,1
28673,pessoalmente,0,0,1,1
28672,aménagés,0,0,1,1
28671,bence,0,0,1,1
28434,señalar,0,0,1,1
28431,negras,0,0,1,1
28040,опубликовавшими,0,0,1,1
28164,comparatif,0,0,1,1
28155,இதிலுள்ள,0,0,1,1
28157,бедной,0,0,1,1
28158,fotosafari,0,0,1,1
2809,originariamente,1,1,0,1
28162,ηρεμήσεις,0,0,1,1
28163,δημιουργηθεί,0,0,1,1
28166,ಜೈಲುಗಳಲ್ಲಿ,0,0,1,1
28127,glada,0,0,1,1
28168,pojkvän,0,0,1,1
28169,truthfulness,0,0,1,1
28170,доступен,0,0,1,1
28172,schatz,0,0,1,1
28173,confusion,0,0,1,1
28174,ούτε,0,0,1,1
28154,demuestre,0,0,1,1
28152,ದೂರುವುದು,0,0,1,1
28151,அனுப்புங்கள்,0,0,1,1
28150,diferença,0,0,1,1
28149,തടയാറുണ്ട്,0,0,1,1
28148,செய்யக்கூடாது,0,0,1,1
28147,élever,0,0,1,1
28146,företeelse,0,0,1,1
28145,gerenommeerde,0,0,1,1
28144,ചപ്പും,0,0,1,1
28141,basarak,0,0,1,1
28140,കേരളത്തിലുള്ളവർക്ക്,0,0,1,1
28138,выполнения,0,0,1,1
28137,reais,0,0,1,1
28134,activist,0,0,1,1
28132,kvalitestsbrister,0,0,1,1
28130,ಉಪಯುಕ್ತ,0,0,1,1
28175,मर्दानी,0,0,1,1
28176,equation,0,0,1,1
28177,بالضغط,0,0,1,1
28197,ethnologues,0,0,1,1
28214,değişti,0,0,1,1
28213,‘சியாகோமோ,0,0,1,1
28212,«cómo,0,0,1,1
28211,récentes »,0,0,1,1
2806,elaborare,1,1,0,1
28208,cessé,0,0,1,1
28207,taraškievica,0,0,1,1
2807,anticipa,1,1,0,1
28204,puedas,0,0,1,1
28203,finalités,0,0,1,1
28202,ஒப்புக்கொள்வது,0,0,1,1
28201,autopromoción»​,0,0,1,1
28199,udgaven,0,0,1,1
28198,robotisées,0,0,1,1
28196,सॉफ़्टवेयर,0,0,1,1
28178,sills,0,0,1,1
28195,исследовании,0,0,1,1
28193,importantly—it,0,0,1,1
28192,திட்டமிட்டுள்ளேன்,0,0,1,1
28191,laccoliths,0,0,1,1
28190,καθένα,0,0,1,1
28189,mirrors,0,0,1,1
28188,«уловка»,0,0,1,1
28186,instalan,0,0,1,1
28184,üzerime,0,0,1,1
28183,சென்றால்,0,0,1,1
28182,schienen,0,0,1,1
28181,книги,0,0,1,1
28180,фурор,0,0,1,1
28179,intelectualmente,0,0,1,1
28128,புரியாத,0,0,1,1
28126,കുറിപ്പുകളും,0,0,1,1
28430,السجناء,0,0,1,1
28068,waarvan,0,0,1,1
28062,होमवर्क,0,0,1,1
28063,اعتن,0,0,1,1
28064,çevreleyen,0,0,1,1
28065,overused,0,0,1,1
28066,продуктов,0,0,1,1
28067,विवाद,0,0,1,1
28069,يفسر,0,0,1,1
28125,boede,0,0,1,1
28072,പരിശീലിപ്പിക്കുകയാണെങ്കിൽ,0,0,1,1
28073,søde,0,0,1,1
2818,ripetere,1,1,0,1
28076,vision‏,0,0,1,1
28077,читаю,0,0,1,1
28080,arrastar,0,0,1,1
28061,പരിഹാരത്തിലായിരിക്കുമ്പോൾ,0,0,1,1
28060,cultivated,0,0,1,1
2819,stampati,1,1,0,1
28058,وهما,0,0,1,1
28056,സുവേ,0,0,1,1
28055,predesignated,0,0,1,1
2820,seymour,1,1,0,1
28053,защита,0,0,1,1
28052,conférences,0,0,1,1
28050,ಕಾಣಿಸುತ್ತಾನೆ,0,0,1,1
28049,المجاني,0,0,1,1
28048,sostienen,0,0,1,1
28046,kwaad,0,0,1,1
28045,ulteriores,0,0,1,1
28044,नार्सिसस,0,0,1,1
28042,jobs,0,0,1,1
28041,διεθνής,0,0,1,1
28081,conterem,0,0,1,1
28082,καροτσάκι,0,0,1,1
28083,μάθουμε,0,0,1,1
28105,electrónico,0,0,1,1
28124,പ്രവർത്തിച്ചവർ,0,0,1,1
28123,ചേർത്തുകൊള്ളണം,0,0,1,1
28122,ast •,0,0,1,1
28121, millions d,0,0,1,1
28120,ptmobilewikipediaorg,0,0,1,1
2812,puzzolente,1,1,0,1
28118,staten,0,0,1,1
28115,utilizó,0,0,1,1
28114,hovedet,0,0,1,1
28113,şövalye,0,0,1,1
28112,ಬೀಜಗಳನ್ನು,0,0,1,1
28111,oradaki,0,0,1,1
28109,occur,0,0,1,1
2814,tirare,1,1,0,1
2815,cancellano,1,1,0,1
28084,остановка,0,0,1,1
28101,கற்றுக்கொண்டோம்,0,0,1,1
28100,pratik,0,0,1,1
28099,лауреат,0,0,1,1
28098,எவ்வாறு,0,0,1,1
28097,paced,0,0,1,1
28096,nilsson,0,0,1,1
28095,വ്യവസ്ഥിതിയുടെ,0,0,1,1
28094,позиционирует,0,0,1,1
28093,synthetic,0,0,1,1
2816,sottoposti,1,1,0,1
28089,insan,0,0,1,1
28088,английского,0,0,1,1
28087,பிடிப்பு,0,0,1,1
28086,പുഞ്ചിരി,0,0,1,1
2805,portare,1,1,0,1
28216,comentando,0,0,1,1
28217,gamle,0,0,1,1
28362,كبيراً,0,0,1,1
28355,maximale,0,0,1,1
28356,geprägt,0,0,1,1
2773,subisce,1,1,0,1
28358,br •,0,0,1,1
28359,constitutional,0,0,1,1
28361,катализатор,0,0,1,1
2772,accettano,1,1,0,1
2803,diminuisce,1,1,0,1
28365,meleğiyim,0,0,1,1
28367,beheerd,0,0,1,1
28369,ihtiyacınız,0,0,1,1
28372,exacta,0,0,1,1
28373,nintendo,0,0,1,1
2770,wc,1,1,0,1
28353,ലേഖകരുടെ,0,0,1,1
28352,voies,0,0,1,1
2774,ondulatoria,1,1,0,1
28350,gebräuchliche,0,0,1,1
28348,ഐക്കണും,0,0,1,1
28347,γυναίκα,0,0,1,1
28344,страны,0,0,1,1
2776,cambiamento,1,1,0,1
28342,الطبعة،,0,0,1,1
28341,"में।
इसके",0,0,1,1
28338,ontmoet,0,0,1,1
28337,unterwegs,0,0,1,1
28336,интерфейс,0,0,1,1
28335,framtida,0,0,1,1
28334,normdatei,0,0,1,1
28333,البيانية,0,0,1,1
28331,coévolue,0,0,1,1
28375,продолжай,0,0,1,1
28378,définir,0,0,1,1
28379,aimait,0,0,1,1
28403,katılımcılar,0,0,1,1
28426,وdutch,0,0,1,1
28425,förväntas,0,0,1,1
28423,amerikanerne,0,0,1,1
28420,tremendously,0,0,1,1
28418,gösterilmez,0,0,1,1
28415,coola,0,0,1,1
2764,modellizzare,1,1,0,1
28412,സമവായത്തിലൂടെ,0,0,1,1
28411,consideró,0,0,1,1
2766,discussione,1,1,0,1
28409,adquirir,0,0,1,1
28408,bekleyin,0,0,1,1
28407,antártida,0,0,1,1
28404,существами,0,0,1,1
28402,hence,0,0,1,1
28380,صراحة,0,0,1,1
28401,learnt,0,0,1,1
28400,программ,0,0,1,1
28398,gordon,0,0,1,1
28396,выходных»,0,0,1,1
28394,overzicht,0,0,1,1
28392,samtal,0,0,1,1
2769,cattura,1,1,0,1
28388,kører,0,0,1,1
28387,berörde,0,0,1,1
28386,culture »,0,0,1,1
28385,ಬೇಕಾಗಿಲ್ಲ,0,0,1,1
28384,undergone,0,0,1,1
28383,ramené,0,0,1,1
28382,machte,0,0,1,1
28329,ανακάλυψη,0,0,1,1
28327,வாழ்க்கையை,0,0,1,1
2778,ripresa,1,1,0,1
28241,huang,0,0,1,1
28268,мышей,0,0,1,1
28267,ಹಾಳುಮಾಡಿದೆ,0,0,1,1
28266,ಇಳಿಸಿದರೆ,0,0,1,1
2788,itwiki,1,1,0,1
28262,lund,0,0,1,1
2790,sbalorditivo,1,1,0,1
28258,актов,0,0,1,1
28257,основных,0,0,1,1
28255,heerlijk,0,0,1,1
28253,புன்னகைக்கச்,0,0,1,1
28252,நாசீஸின்,0,0,1,1
2792,autonoma,1,1,0,1
28247,kontrol,0,0,1,1
28242,பயனற்றது,0,0,1,1
28240,categorisation,0,0,1,1
28270,brits,0,0,1,1
28238,സംഘം,0,0,1,1
28237,μεμονωμένο,0,0,1,1
28236,identifiant,0,0,1,1
28235,légitime,0,0,1,1
2795,puzzle,1,1,0,1
28231,зданий,0,0,1,1
28228,ediyorlarmış,0,0,1,1
2797,volontaria,1,1,0,1
28226,ಅರಿತುಕೊಳ್ಳಬೇಕಾದ,0,0,1,1
2799,esplicite,1,1,0,1
28223,углу,0,0,1,1
2801,analitiche,1,1,0,1
28221,व्युत्पन्न,0,0,1,1
2802,significato»,1,1,0,1
28269,ನಿಮ್ಮಂತೆಯೇ,0,0,1,1
28271,τακτικά,0,0,1,1
28323,tillykke,0,0,1,1
28299,الاغتصاب,0,0,1,1
28322,देशी,0,0,1,1
28321,front,0,0,1,1
28320,kvalitetssäkrade,0,0,1,1
28319,سيناريو,0,0,1,1
28318,المقابلة,0,0,1,1
28314,установлена,0,0,1,1
28313,refletir,0,0,1,1
28309,ravi,0,0,1,1
28307,arena,0,0,1,1
28306,strengthened,0,0,1,1
28305,colloquial,0,0,1,1
28303,اللغات،,0,0,1,1
2783,perdere,1,1,0,1
28300,nourris,0,0,1,1
28298,cardon,0,0,1,1
28274,ødelagt,0,0,1,1
28297,apelaram,0,0,1,1
2784,luminosi,1,1,0,1
28293,बुलाया,0,0,1,1
2785,esecuzione,1,1,0,1
28291,ordem,0,0,1,1
28289,astounding,0,0,1,1
28286,engelinin,0,0,1,1
28284,vienne,0,0,1,1
28283,പറഞ്ഞിട്ടുണ്ട്,0,0,1,1
28282,kontrollera,0,0,1,1
28280,proost,0,0,1,1
28277,അല്പം,0,0,1,1
28276,resultant,0,0,1,1
2786,volere,1,1,0,1
24168,تفعله,0,0,1,1
24167,تتعلم,0,0,1,1
3308,conseguono,1,1,0,1
20067,கட்டுப்பாடுகளைக்,0,0,1,1
20059,delicioso,0,0,1,1
3811,importara,0,0,1,1
20061,ovanför,0,0,1,1
20062,صرحت,0,0,1,1
3810,കുടുങ്ങുമ്പോൾ,0,0,1,1
20064,assumption,0,0,1,1
20069,connaissant,0,0,1,1
20033,പറയുന്നതുപോലെ,0,0,1,1
20070,официально,0,0,1,1
20071,உருவாக்கப்பட்டது,0,0,1,1
20072,es •,0,0,1,1
20073,lethargic,0,0,1,1
20074,bursts,0,0,1,1
20075,riskerar,0,0,1,1
20058,उतना,0,0,1,1
3812,الطعن,0,0,1,1
20055,teman,0,0,1,1
3813,ಕರೆಯಬಹುದು,0,0,1,1
20052,wikipediaartikelen,0,0,1,1
3814,தொகுப்பதன்,0,0,1,1
3815,പ്രവർത്തനത്തിലൂടെ,0,0,1,1
3817,गैरलाभ,0,0,1,1
20046,skikke,0,0,1,1
20045,அனுபவம்,0,0,1,1
20043,censurera,0,0,1,1
20042,ухожу,0,0,1,1
20040,dessin,0,0,1,1
20039,nun,0,0,1,1
20037,γαλλία,0,0,1,1
20036,αυξήθηκε,0,0,1,1
20035,otomatik,0,0,1,1
20079,disque,0,0,1,1
20080,غمرني,0,0,1,1
20081,τηλεφωνική,0,0,1,1
20103,сообщества,0,0,1,1
20122,politikendk,0,0,1,1
20121,dağarcığınızı,0,0,1,1
20120,ipucunu,0,0,1,1
20119,tevoorschijn,0,0,1,1
20116,likheter,0,0,1,1
20115,منسوبة,0,0,1,1
20114,хороший,0,0,1,1
3804,ಸ್ನೇಹಿತ,0,0,1,1
20112,anmen,0,0,1,1
20111,écosystémiques ,0,0,1,1
20110,εγωιστική,0,0,1,1
20109,идей,0,0,1,1
20107,சாப்பிடும்,0,0,1,1
20105,गुस्से,0,0,1,1
20102,rodríguez,0,0,1,1
20082,"गया।
जुलाई",0,0,1,1
20100,divulgar,0,0,1,1
3806,«страница,0,0,1,1
20097,provenían,0,0,1,1
3808,problemáticas,0,0,1,1
20092,« même,0,0,1,1
20091,रायटर्स,0,0,1,1
20090,derhâl,0,0,1,1
3809,ಕಷ್ಟವಾಯಿತು,0,0,1,1
20088,hjemmeside,0,0,1,1
20087,subspace,0,0,1,1
20086,japonés,0,0,1,1
20085,strategies,0,0,1,1
20084,hızlandırın,0,0,1,1
20083,pressure,0,0,1,1
20034,parodique,0,0,1,1
20031,cellular,0,0,1,1
20126,enfrenta,0,0,1,1
19974,groeien,0,0,1,1
19967,« vigilance,0,0,1,1
19968,sousdomaine,0,0,1,1
19969,rappelle,0,0,1,1
3821,dagbladet,0,0,1,1
19972,ومفتقدًا,0,0,1,1
19973,ಬಂದ,0,0,1,1
19976,discourages,0,0,1,1
20029,اثني,0,0,1,1
19977,ಮಹಾಯುದ್ಧದ,0,0,1,1
19979,biophysique,0,0,1,1
19980,посмотрел,0,0,1,1
19981,المادية,0,0,1,1
3820,цитируются,0,0,1,1
19984,oğlum,0,0,1,1
19966,सर्विस,0,0,1,1
3823,движение,0,0,1,1
3824,birleşiminden,0,0,1,1
19962,grob,0,0,1,1
19961,effrayé,0,0,1,1
19960,مركبة,0,0,1,1
19959,ಸ್ನೇಹಿತನನ್ನು,0,0,1,1
3826,исследованиями,0,0,1,1
19955,الاحتفاظ,0,0,1,1
19954,bidragsgivarna,0,0,1,1
3827,ತಿರಸ್ಕರಿಸಿದಳು,0,0,1,1
19951,eyaleti,0,0,1,1
19950,υποθέστε,0,0,1,1
19948,χρησιμοποιηθούν,0,0,1,1
19946,minimizing,0,0,1,1
19945,вышло,0,0,1,1
19944,престижны,0,0,1,1
19986,തെളിവുകളുണ്ടാകണം,0,0,1,1
19987,zh •,0,0,1,1
19989,décrivant,0,0,1,1
20009,cuja,0,0,1,1
20028,friare,0,0,1,1
20027,kalkylprogram,0,0,1,1
3818,получение,0,0,1,1
20024,असत्यापित,0,0,1,1
20023,incríveis,0,0,1,1
20022,напоминает,0,0,1,1
20021,desactualización,0,0,1,1
20020,navegador,0,0,1,1
20017,vardığında,0,0,1,1
20016,móviles,0,0,1,1
20015,утверждение,0,0,1,1
20014,ಎಳೆಯಬಹುದು,0,0,1,1
20013,δοκιμή,0,0,1,1
20010,vorbei,0,0,1,1
20007,सकारात्मक,0,0,1,1
19991,dispyter,0,0,1,1
20005,पकड़,0,0,1,1
20004,anoche,0,0,1,1
20003,ഓർമ്മിപ്പിക്കാൻ,0,0,1,1
20002,removing,0,0,1,1
20001,копии,0,0,1,1
20000,alleviate,0,0,1,1
19999,sürükleyebilir,0,0,1,1
19998,cömert,0,0,1,1
19997,уловкой,0,0,1,1
19996,dernière,0,0,1,1
19995,специалистами,0,0,1,1
19994,कर।,0,0,1,1
19993,ரொட்டியில்,0,0,1,1
19992,plug,0,0,1,1
20124,dérangetil,0,0,1,1
20127,дворце,0,0,1,1
19575,paquetes,0,0,1,1
20256,ofensivas,0,0,1,1
20248,kore,0,0,1,1
20249,إنك,0,0,1,1
20250,planerat,0,0,1,1
20252,அனைத்தும்,0,0,1,1
20253,mejores,0,0,1,1
20254,sortit,0,0,1,1
20257,оскорблением,0,0,1,1
20221,entiendo,0,0,1,1
3789,riesige,0,0,1,1
20260,മാസത്തെ,0,0,1,1
20261,connotaciones,0,0,1,1
20262,известны,0,0,1,1
20263,gangen,0,0,1,1
20265,выше,0,0,1,1
20247,സമയമില്ല,0,0,1,1
3790,enmobilewikipediaorg,0,0,1,1
20245,അഭിപ്രായമിടാൻ,0,0,1,1
20242,மென்மையாகவும்,0,0,1,1
20240,silber,0,0,1,1
20239,εθνικοτήτων,0,0,1,1
20238,وتعترف,0,0,1,1
20237,merken,0,0,1,1
3791,വ്യക്തിയുടെ,0,0,1,1
20235,gewijzigde,0,0,1,1
20233,भड़काने,0,0,1,1
20232,erkläre,0,0,1,1
20231,विकिस्केनर,0,0,1,1
20228,ويكيمانيا,0,0,1,1
20227,ljusa,0,0,1,1
20226,അമ്മേ,0,0,1,1
20225,marknadsundersökningsföretag,0,0,1,1
20266,vernuftig,0,0,1,1
20267,menge,0,0,1,1
20268,تضر,0,0,1,1
20293,parvenant,0,0,1,1
20316,pur,0,0,1,1
20315,ലഭിക്കില്ല,0,0,1,1
20313,منظر,0,0,1,1
20312,गिगल्स,0,0,1,1
20311,സംരക്ഷിക്കേണ്ട,0,0,1,1
3784,"വിജ്ഞാനശകലങ്ങൾ
ചേർക്കുന്നവർക്കുണ്ടായേക്കാവുന്ന",0,0,1,1
20306,بوت,0,0,1,1
20302,இப்பக்கத்தைப்,0,0,1,1
20301,иными,0,0,1,1
20300,ಎಲ್ಲಿಂದ,0,0,1,1
3786,πανεπιστήμιο,0,0,1,1
20298,zuerst,0,0,1,1
20297,ரகசியமான,0,0,1,1
20296,έβγαλα,0,0,1,1
20292,பொத்தானைக்,0,0,1,1
20269,вебсервера,0,0,1,1
20290,mediaservices,0,0,1,1
20289,नरसी,0,0,1,1
20288,ಕ್ರಿಯೆ,0,0,1,1
20287,aidezmoi,0,0,1,1
3788,русская —,0,0,1,1
20283,കരയുന്ന,0,0,1,1
20282,сотрудничестве,0,0,1,1
20280,matsalen,0,0,1,1
20279,tivéssemos,0,0,1,1
20277,allait,0,0,1,1
20276,race,0,0,1,1
20275,مرت,0,0,1,1
20273,vastzit,0,0,1,1
20272,kinesisk,0,0,1,1
20222,твоя,0,0,1,1
20219,ಭಾಗವೆಂದರೆ,0,0,1,1
20128,bröllopsklänning,0,0,1,1
20158,diyorlar,0,0,1,1
20149,рассказывалось,0,0,1,1
20150,appreciate,0,0,1,1
3797,अनुमानतः,0,0,1,1
20153,культуре,0,0,1,1
20155,«циркуляре,0,0,1,1
20157,ಸಲಹೆಗಳು,0,0,1,1
20159,والاختلاف,0,0,1,1
20218,gleiche,0,0,1,1
20160,présidentielle,0,0,1,1
20161,paso,0,0,1,1
20162,تُعرف,0,0,1,1
20163,тонет,0,0,1,1
20166,планах,0,0,1,1
20167,колледжа,0,0,1,1
20147,школы,0,0,1,1
3799,tarafsızlık,0,0,1,1
20145,exciting,0,0,1,1
20143,selfdriving,0,0,1,1
20142,dijera,0,0,1,1
20141,besançon,0,0,1,1
20140,кругу,0,0,1,1
20139,βρώσιμο,0,0,1,1
20138,compton,0,0,1,1
3800,लें,0,0,1,1
20136,censorship,0,0,1,1
20135,plasma,0,0,1,1
20134,विकिसूक्ति,0,0,1,1
20133,dilema,0,0,1,1
20132,erwähnt,0,0,1,1
3801,சஞ்சிகை,0,0,1,1
3802,acabó,0,0,1,1
20169,വാങ്ങിയ,0,0,1,1
20170,والدينية,0,0,1,1
20176,പ്രാധാന്യം,0,0,1,1
20200,atteignait,0,0,1,1
20217,σκοπός,0,0,1,1
20216,പരിശീലിപ്പിക്കാൻ,0,0,1,1
20215,ಮಾಡುತ್ತೀರಾ,0,0,1,1
20214,aparecem,0,0,1,1
20213,സംരക്ഷിക്കാൻ,0,0,1,1
20212,pruebas,0,0,1,1
20211,intervention ,0,0,1,1
20210,νοιάζεσαι,0,0,1,1
20209,الكريهة,0,0,1,1
20208,нынешнюю,0,0,1,1
20206,воспроизводимость,0,0,1,1
20205,lijkt,0,0,1,1
20204,beviste,0,0,1,1
20203,fakta,0,0,1,1
20198,βγήκε,0,0,1,1
20177,положительных,0,0,1,1
20197,ditesvous,0,0,1,1
20195,kafayı,0,0,1,1
20194,публикация,0,0,1,1
20193,देन,0,0,1,1
20192,ilan,0,0,1,1
3795,будете,0,0,1,1
20187,neutre,0,0,1,1
20186,ஆய்வாளரின்,0,0,1,1
20185,सटीकता,0,0,1,1
20184,intentan,0,0,1,1
20183,журналом,0,0,1,1
20182,नवीन,0,0,1,1
20181,составляла,0,0,1,1
20178,humide,0,0,1,1
19943,suriname,0,0,1,1
19941,ഒരാൾക്ക്,0,0,1,1
19940,تحديث،,0,0,1,1
19702,gradual,0,0,1,1
19693,contributos,0,0,1,1
19694,pouvoirs,0,0,1,1
19696,kennst,0,0,1,1
3847,oyla,0,0,1,1
3846,exercée,0,0,1,1
19701,пар,0,0,1,1
19705,logique ,0,0,1,1
19667,далее»,0,0,1,1
19706,αντέξτε,0,0,1,1
19707,копилефтлицензиями,0,0,1,1
19709,ciudad,0,0,1,1
19710,antwoorden,0,0,1,1
19711,яркие,0,0,1,1
19712,άρα,0,0,1,1
19692,അമേരിക്കക്കാരനായ,0,0,1,1
19691,bölümü,0,0,1,1
19690,ശാന്തമാക്കുക,0,0,1,1
19689,payant,0,0,1,1
19688,واسترجاعها،,0,0,1,1
19687,திகைத்துப்,0,0,1,1
19686,холодным,0,0,1,1
19685,nysede,0,0,1,1
19684,initié,0,0,1,1
19682,nära,0,0,1,1
19680,iluminado,0,0,1,1
19679,alemana,0,0,1,1
19677,представляют,0,0,1,1
19676,ലേഖനങ്ങളിലും,0,0,1,1
19674,நிமிடத்தில்,0,0,1,1
19671,многослойный,0,0,1,1
19670,تبكي,0,0,1,1
19713,ibmer,0,0,1,1
19714,فماذا,0,0,1,1
3845,subodh,0,0,1,1
19735,gepatenteerde,0,0,1,1
19751,несколькими,0,0,1,1
19750,बैंड,0,0,1,1
19749,hyperlink,0,0,1,1
19748,விக்கிப்பீடியாவிற்கு,0,0,1,1
19747,contribué,0,0,1,1
19746,парламента,0,0,1,1
19745,température,0,0,1,1
19744,flickvän,0,0,1,1
19743,patient,0,0,1,1
3844,remplacé,0,0,1,1
19740,harías,0,0,1,1
19739,inform,0,0,1,1
19738,deixar,0,0,1,1
19737,goût,0,0,1,1
19734,verzamelen,0,0,1,1
19716,möjliggjorde,0,0,1,1
19733,réalisait,0,0,1,1
19731,விற்றதை,0,0,1,1
19729,organismes,0,0,1,1
19728,இக்கொள்கைகளிலும்,0,0,1,1
19727,asturiëprijs,0,0,1,1
19726,dumb,0,0,1,1
19725,improvement,0,0,1,1
19723,rejser,0,0,1,1
19722,പദ്ധതികൾരൂപീകരിക്കുന്നു,0,0,1,1
19721,vermeniz,0,0,1,1
19720,просьбу,0,0,1,1
19719,تنظر,0,0,1,1
19718,ем,0,0,1,1
19717,direta,0,0,1,1
19669,atribuído,0,0,1,1
3848,dönmüş,0,0,1,1
19939,ಲಿಂಕ್,0,0,1,1
19609,comunitario,0,0,1,1
19602,προχωρήσεις,0,0,1,1
19604,склонны,0,0,1,1
19605,bevisa,0,0,1,1
19606,riguroso,0,0,1,1
3861,doctorandos,0,0,1,1
19608,научному,0,0,1,1
3860,भागीदारी,0,0,1,1
19665,kaynaklı,0,0,1,1
19611,அண்மையில்,0,0,1,1
19612,проступках,0,0,1,1
19613,systematisk,0,0,1,1
19615,censurerar,0,0,1,1
3858,rechazó,0,0,1,1
19619,constitué,0,0,1,1
19601,أصاب,0,0,1,1
19600,стилистических,0,0,1,1
19598,स्कॉट,0,0,1,1
19594,umkreisen,0,0,1,1
19593,« préjudice,0,0,1,1
19592,licorne,0,0,1,1
19590,peaking,0,0,1,1
19589,തൂങ്ങുക,0,0,1,1
19588,maind,0,0,1,1
19587,brotbrot,0,0,1,1
19586,ഉച്ചഭക്ഷണം,0,0,1,1
19585,противоположностью,0,0,1,1
19584,തിരുത്തൽ,0,0,1,1
3862,huit,0,0,1,1
19581,ಒಳ್ಳೆಯವರಾಗಿರಿ,0,0,1,1
19580,директор,0,0,1,1
3863,brugbarheden,0,0,1,1
3857,பதிலாகத்,0,0,1,1
3856,isterdim,0,0,1,1
19624,ಸ್ಥಳೀಯ,0,0,1,1
19645,kopieren,0,0,1,1
19664,ντυμένος,0,0,1,1
19663,использует,0,0,1,1
19661,ಕೋನ,0,0,1,1
19659,проверке,0,0,1,1
3849,meatspace,0,0,1,1
19657,وأكثر,0,0,1,1
3850,podcast,0,0,1,1
19655,subgrupos,0,0,1,1
19654,methane,0,0,1,1
19653,سعيدا,0,0,1,1
19652,അഭിനയിച്ചതിൽ,0,0,1,1
19650,ഉപയോഗപ്രദവുമായ,0,0,1,1
19648,divinité,0,0,1,1
3851,оспорено,0,0,1,1
19644,தேர்ந்தெடுக்கப்பட்ட,0,0,1,1
3854,ومعترف,0,0,1,1
19643,lese,0,0,1,1
19642,தொலைபேசி,0,0,1,1
19641,concebida,0,0,1,1
19640,betjänar,0,0,1,1
19639,يحرره،,0,0,1,1
3853,minimization,0,0,1,1
19635,classé,0,0,1,1
19634,nonsensical,0,0,1,1
19632,ಅನ್ವಯವಾಗುವ,0,0,1,1
19631,tabelldatafil,0,0,1,1
19630,ലഭ്യമായിരിക്കണം,0,0,1,1
19628,infobox,0,0,1,1
19627,neigen,0,0,1,1
19626,உணர்வு,0,0,1,1
19752,execute,0,0,1,1
19753,hayranlık,0,0,1,1
19754,romantique,0,0,1,1
3834,formation,0,0,1,1
19871,detecting,0,0,1,1
19872,δούμε,0,0,1,1
19873,مجهود,0,0,1,1
19874,organise,0,0,1,1
19875,сэнгеру,0,0,1,1
19876,запрещённых,0,0,1,1
19881,design,0,0,1,1
19755,exemples ,0,0,1,1
19883,нашу,0,0,1,1
19884,microscopic,0,0,1,1
19885,yapıyorum,0,0,1,1
19886,общественном,0,0,1,1
19889,الشرفة,0,0,1,1
19890,soto ,0,0,1,1
19870,ನೀಡೋಣ,0,0,1,1
19869,издателями,0,0,1,1
3835,seslendirilmiş,0,0,1,1
19865,جزيلاً,0,0,1,1
19864,ജീവനുള്ളവളായിരുന്നുവെന്ന്,0,0,1,1
19862,ακόμη,0,0,1,1
19861,representam,0,0,1,1
19860,bekendste,0,0,1,1
19859,yazdıklarını,0,0,1,1
19857,κέρδισε,0,0,1,1
19856,beskrive,0,0,1,1
19855,medir,0,0,1,1
19854,malı,0,0,1,1
19853,അതിനു,0,0,1,1
3836,connotations,0,0,1,1
19849,प्राथमिकता,0,0,1,1
19848,telaffuz,0,0,1,1
19892,iniciada,0,0,1,1
3833,красная,0,0,1,1
19894,மனச்சார்பு,0,0,1,1
19919,जोड़ेंविकिपीडिया,0,0,1,1
19938,ಹೊಂದಿದ್ದರು,0,0,1,1
19937,எல்லி,0,0,1,1
19935,மொழிக்,0,0,1,1
19933,പലപ്പൊഴും,0,0,1,1
19932,crenças,0,0,1,1
19931,traeré,0,0,1,1
19930,agente,0,0,1,1
3830,μηbrainer,0,0,1,1
3831,ಸರಿಯಾಗಿದೆ,0,0,1,1
19925,जोसेफ,0,0,1,1
19923,enriquecedor,0,0,1,1
19922,"
कन्नड़",0,0,1,1
19921,wikibased,0,0,1,1
19920,mei,0,0,1,1
19918,точный,0,0,1,1
19895,النظام،,0,0,1,1
19916,предыдущее,0,0,1,1
19915,complaint,0,0,1,1
19912,expliquez,0,0,1,1
19909,højttalerikon,0,0,1,1
19908,கிடைத்தால்,0,0,1,1
19907,ministère,0,0,1,1
19906,يظنون,0,0,1,1
19904,исходят,0,0,1,1
19903,französische,0,0,1,1
19901,anglocêntrica,0,0,1,1
19899,குறிப்பிட்டுள்ளது,0,0,1,1
19898,"
स्वीडिश",0,0,1,1
19897,البريد,0,0,1,1
19896,рубиновое,0,0,1,1
19846,χαίρομαι,0,0,1,1
19845,shapes,0,0,1,1
19844,duits,0,0,1,1
19779,keen,0,0,1,1
19794,phases,0,0,1,1
19793,sabrosas,0,0,1,1
19792,narsisizm,0,0,1,1
19791,betrouwbaar,0,0,1,1
3838,آراء,0,0,1,1
19789,preserving,0,0,1,1
19787,товарный,0,0,1,1
19786,residentes,0,0,1,1
19785,हैं।अमेरिकी,0,0,1,1
19784,താക്കീതു,0,0,1,1
19783,ذاهب,0,0,1,1
3839,حقول,0,0,1,1
19781,لمعرفة,0,0,1,1
19780,участника,0,0,1,1
19778,комментируя,0,0,1,1
19796,"
उदमुर्त",0,0,1,1
19775,ಕುತೂಹಲಕಾರಿ,0,0,1,1
19774,quartal,0,0,1,1
3840,préoccupations,0,0,1,1
19771,ಸಂತೋಷಪಡುತ್ತೇನೆ,0,0,1,1
19770,elmaslarla,0,0,1,1
19769,ദ്രുത,0,0,1,1
19768,intihal,0,0,1,1
19767,ansætte,0,0,1,1
19766,forneçam,0,0,1,1
3841,അമ്പരന്നു,0,0,1,1
19764,congrès,0,0,1,1
3842,മകളും,0,0,1,1
19760,onderwerpen,0,0,1,1
19757,accepteret,0,0,1,1
19795,ekleyerek,0,0,1,1
19797,competitor,0,0,1,1
19842,تماما,0,0,1,1
19821,λατινική,0,0,1,1
19841,nanotechnologies,0,0,1,1
19840,लायब्रेरी,0,0,1,1
19839,nécessitent,0,0,1,1
19838,остальная,0,0,1,1
19837,natuurwetenschap,0,0,1,1
19834,tratamiento,0,0,1,1
19833,வழங்கியதற்கு,0,0,1,1
19832,ಕೃತ್ಯವನ್ನು,0,0,1,1
19829,основными,0,0,1,1
19828,dolarımı,0,0,1,1
19827,biotechnologies,0,0,1,1
19824,vieil,0,0,1,1
3837,enkelte,0,0,1,1
19822,نرسيسا,0,0,1,1
19820,izliyorsunuz,0,0,1,1
19798,inräknade,0,0,1,1
19819,próprias,0,0,1,1
19818,dénuées,0,0,1,1
19816,«очень,0,0,1,1
19814,கடனைப்,0,0,1,1
19812,olman,0,0,1,1
19810,specialevenemang,0,0,1,1
19809,"
किर्घिज़",0,0,1,1
19807,hatten,0,0,1,1
19806,подготовился,0,0,1,1
19805,வாழ்க்கையைப்,0,0,1,1
19803,പ്രവർത്തിച്ചാണ്,0,0,1,1
19801,transação,0,0,1,1
19800,af •,0,0,1,1
19799,émeraudes,0,0,1,1
20317,защиты,0,0,1,1
20318,lyt,0,0,1,1
3783,ωστόσο,0,0,1,1
20866,répercussions,0,0,1,1
20857,tøjvask,0,0,1,1
20858,cerveaumachine ,0,0,1,1
20859,teceu,0,0,1,1
20860,تعاملت,0,0,1,1
20863,abandonaban,0,0,1,1
20864,സ്റ്റഫ്,0,0,1,1
3724,mandato,1,1,0,1
20822,atualizam,0,0,1,1
20868,ಒಳ್ಳೆಯವನಾಗಿದ್ದೆ,0,0,1,1
20869,imieliński,0,0,1,1
20870,reflektion,0,0,1,1
20871,enfades,0,0,1,1
20872,знания,0,0,1,1
20873,вопроса,0,0,1,1
20856,saldırıya,0,0,1,1
20855,добровольцами,0,0,1,1
20851,disagreements,0,0,1,1
20847,sítio,0,0,1,1
20846,указан,0,0,1,1
20841,servidas,0,0,1,1
20839,समझाते,0,0,1,1
3728,paritaria,1,1,0,1
20835,κάπου,0,0,1,1
20834,ευγενικός,0,0,1,1
20833,ஒப்புக்கொள்கிறேன்,0,0,1,1
20832,पीएचडी,0,0,1,1
20830,dummer,0,0,1,1
20829,kuralları,0,0,1,1
20826,biriyle,0,0,1,1
20825,ഉപയോക്താക്കളുടെ,0,0,1,1
20824,مؤتمر,0,0,1,1
20874,μήπως,0,0,1,1
20876,glace,0,0,1,1
20877,annoncée,0,0,1,1
20899,இணையக்,0,0,1,1
20916,music,0,0,1,1
20915,herum,0,0,1,1
20914,apariencias,0,0,1,1
3718,racconta,1,1,0,1
20911,catchsituatie,0,0,1,1
20910,некоторая,0,0,1,1
20909,secretos,0,0,1,1
20908,نافياً,0,0,1,1
20907,falantes,0,0,1,1
20904,falsedades,0,0,1,1
3719,minuscolo,1,1,0,1
20902,идею,0,0,1,1
20901,അഭ്യർത്ഥനകൾ,0,0,1,1
20900,സ്വതന്ത്രമല്ലാത്ത,0,0,1,1
20898,معالجة,0,0,1,1
20878,خطأك,0,0,1,1
3720,lettera,1,1,0,1
20896,വീഡിയോയിലെ,0,0,1,1
20894,ewigkeiten,0,0,1,1
20893,الأَشغال,0,0,1,1
20892,डायरेक्टर,0,0,1,1
20891,mécènes,0,0,1,1
20890,présents,0,0,1,1
3722,avverando,1,1,0,1
20888,negou,0,0,1,1
20887,सेवा,0,0,1,1
20886,clean,0,0,1,1
20885,आधिकारिक,0,0,1,1
20881,sonar,0,0,1,1
20879,голосованиях,0,0,1,1
20823,balans,0,0,1,1
20821,варианта,0,0,1,1
20716,ഓർമയോ,0,0,1,1
20749,zeneca,0,0,1,1
20740,descentralizada,0,0,1,1
20742,وذهب,0,0,1,1
20743,مناسبًا,0,0,1,1
20745,webbpubliceringssystem,0,0,1,1
3741,immagazzinare,1,1,0,1
20748,programmoduler,0,0,1,1
20750,καρφί,0,0,1,1
20820,beneficie,0,0,1,1
20752,раскритиковано,0,0,1,1
20753,வாழ்வாள்,0,0,1,1
20755,баллотироваться,0,0,1,1
20757,செய்யப்பட்டன,0,0,1,1
20758,كينيدي,0,0,1,1
20761,landlocked,0,0,1,1
3742,esci,1,1,0,1
20738,πρόσωπο,0,0,1,1
3743,affrontato,1,1,0,1
20736,attacker,0,0,1,1
3744,esercitati,1,1,0,1
20733,simplifier,0,0,1,1
20732,"start
पारंपरिक",0,0,1,1
20731,yolculuktan,0,0,1,1
20730,ವಸ್ತುಗಳು,0,0,1,1
20729,отца,0,0,1,1
20728,അതിനുമുമ്പും,0,0,1,1
20727,الذاتية,0,0,1,1
20725,léthargiques,0,0,1,1
20723,تبحث,0,0,1,1
20722,ಆಲೂಗಡ್ಡೆಗಳನ್ನು,0,0,1,1
20720,सिटीजेंडियम,0,0,1,1
20719,подумайте,0,0,1,1
20762,opportunités,0,0,1,1
20763,controvertidos,0,0,1,1
20765,ഗുണാങ്ക,0,0,1,1
3736,provino,1,1,0,1
20818,väl,0,0,1,1
20817,ഒരുക്കിയ,0,0,1,1
20812,undrade,0,0,1,1
20811,программные,0,0,1,1
20810,विकिज़नानी,0,0,1,1
20809,principper,0,0,1,1
20808,borttaget,0,0,1,1
20806,astonishing,0,0,1,1
20804,perdí,0,0,1,1
3733,elogi,1,1,0,1
3734,andando,1,1,0,1
20801,—bifurcaciones—,0,0,1,1
20800,പ്രശ്നത്തിന്റേയും,0,0,1,1
3735,soggetto,1,1,0,1
20796,görüşler,0,0,1,1
20768,lissés,0,0,1,1
20795,«cerrar,0,0,1,1
20793,haiti,0,0,1,1
20789,mnist,0,0,1,1
20788,высшая,0,0,1,1
20787,caller,0,0,1,1
20785,karin,0,0,1,1
20783,hispana,0,0,1,1
20781,l’esprit,0,0,1,1
20780,உணர்ந்தால்,0,0,1,1
20779,balansgång,0,0,1,1
20778,ζώνης,0,0,1,1
20775,totais,0,0,1,1
3739,aumentata,1,1,0,1
20770,बैठी,0,0,1,1
20918,أجرى,0,0,1,1
20920,compraron,0,0,1,1
20921,authorities,0,0,1,1
21044,ಕರೆದೊಯ್ಯುತ್ತೇನೆ,0,0,1,1
21037,baseadas,0,0,1,1
21038,രഹസ്യമുണ്ടായിരുന്നു,0,0,1,1
21039,traurig,0,0,1,1
21040,°′″n,0,0,1,1
21041,destaca,0,0,1,1
21042,διότι,0,0,1,1
21045,yanlışlar,0,0,1,1
20922,ಅವನಿಗೆ,0,0,1,1
21046,théologicopolitique,0,0,1,1
3705,inserita,1,1,0,1
21048,تغطية,0,0,1,1
3704,sostantivo,1,1,0,1
21050,refrendados,0,0,1,1
21051,βοηθήσει,0,0,1,1
21036,duydunuz,0,0,1,1
21035,içerdiğini,0,0,1,1
3706,vedrai,1,1,0,1
21033, تم,0,0,1,1
21029,ervoor,0,0,1,1
21027,редактирование,0,0,1,1
21026,beskrivningsrutan,0,0,1,1
21025,entendez,0,0,1,1
21024,accepterer,0,0,1,1
3708,purtroppo,1,1,0,1
21022,вопросах,0,0,1,1
21021,“சிஎசுஎசு”,0,0,1,1
3709,giudizio,1,1,0,1
21017,கடக்கிறீர்கள்,0,0,1,1
21015,milliarder,0,0,1,1
21014,hero,0,0,1,1
21013,automatiquement,0,0,1,1
21052,sınıfta,0,0,1,1
3703,riparazione,1,1,0,1
21054,attributable,0,0,1,1
21078,frança,0,0,1,1
21100,മായ്ച്ചുകളയാറുമുണ്ട്,0,0,1,1
21099,çalışır,0,0,1,1
21095,отражении,0,0,1,1
3696,provengano,1,1,0,1
21093,xanadu,0,0,1,1
21092,decírselo,0,0,1,1
21090,ആരംഭിക്കാം,0,0,1,1
21089,перейти,0,0,1,1
3697,cane,1,1,0,1
21086,ξεχνούν,0,0,1,1
21085,വാരാന്ത്യ,0,0,1,1
21084,खुली,0,0,1,1
21082,gepolijst,0,0,1,1
21079,duimen,0,0,1,1
21077,ganhando,0,0,1,1
21055,indicates,0,0,1,1
21076,responsável,0,0,1,1
21075,gardens,0,0,1,1
3699,finiti,1,1,0,1
21071,geoinformation,0,0,1,1
21070,сказано,0,0,1,1
21069,randevunuz,0,0,1,1
3700,sostituendo,1,1,0,1
21067,zeiden,0,0,1,1
3701,magici,1,1,0,1
21065,musées,0,0,1,1
21064,ലോക,0,0,1,1
21063,desanimadoras,0,0,1,1
21062,patrol,0,0,1,1
21060,مشاهدي,0,0,1,1
21011,использующие,0,0,1,1
21009,خارجية,0,0,1,1
21008,industrializados,0,0,1,1
20940,‘மைக்கேல்,0,0,1,1
20957,resmi,0,0,1,1
20956,अरबी,0,0,1,1
20955,банку,0,0,1,1
20954,υπενθυμίσω,0,0,1,1
20953,grundprincipen,0,0,1,1
20952,légèrement,0,0,1,1
20951,ಒಂದಕ್ಕಿಂತ,0,0,1,1
20950,bett,0,0,1,1
20948,kvinde,0,0,1,1
20947,ബ്യൂറോക്രാറ്റുകളേയും,0,0,1,1
3714,identificazione,1,1,0,1
20944,bloquées,0,0,1,1
20942,latijn,0,0,1,1
3715,atti,1,1,0,1
20938,underwater,0,0,1,1
20960,variáveis,0,0,1,1
20937,euh,0,0,1,1
20936,presides,0,0,1,1
20935,подарок,0,0,1,1
20934,goods,0,0,1,1
20932,glatt,0,0,1,1
20931,gegaan,0,0,1,1
20930,знаку,0,0,1,1
20929,bultin,0,0,1,1
3716,arrabbiata,1,1,0,1
3717,giocando,1,1,0,1
20926,rester,0,0,1,1
20925,dispensem,0,0,1,1
20924,भली,0,0,1,1
20923,പ്രദേശത്ത്,0,0,1,1
20958,descubiertos,0,0,1,1
20964,الاقتباسات،,0,0,1,1
21006,викимедиа» —,0,0,1,1
20986,вирджиния,0,0,1,1
21005,rohde,0,0,1,1
21002,sökverktyg,0,0,1,1
21001,பொதுவாக,0,0,1,1
21000,gerealiseerd,0,0,1,1
20999,മെച്ചപ്പെടുത്തുവാനും,0,0,1,1
20998,trait,0,0,1,1
20997,ஆண்களை,0,0,1,1
20996,beeton,0,0,1,1
20995,подвергаться,0,0,1,1
20993,ಹಹ್,0,0,1,1
20991,غدًا,0,0,1,1
20990,sonríe,0,0,1,1
20989,تقارير,0,0,1,1
3711,palmari,1,1,0,1
20985,للتغيير,0,0,1,1
20966,चीनी,0,0,1,1
20984,ثابتة,0,0,1,1
20983,ثالث,0,0,1,1
20982,düzeltilmesini,0,0,1,1
20981,appropriée,0,0,1,1
20980,പോർച്ചുഗീസ്,0,0,1,1
20978,herhaling,0,0,1,1
20977,compañía,0,0,1,1
20975,нужна,0,0,1,1
20974,يقترح,0,0,1,1
20973,afspiegeling,0,0,1,1
20972,–principalmente,0,0,1,1
3712,passaggio,1,1,0,1
20968,нидерландов,0,0,1,1
20967,बोल,0,0,1,1
20717,dérivée,0,0,1,1
20712,jungs,0,0,1,1
20320,princípio,0,0,1,1
20442,தேவதூதருடன்,0,0,1,1
20432,anzugeben,0,0,1,1
20433,inanamıyorum,0,0,1,1
20435,போதுமானதாக,0,0,1,1
20436,valuing,0,0,1,1
20439,kırmızı,0,0,1,1
20441,sitta,0,0,1,1
20444,யோசனை,0,0,1,1
20408,ചെയ്താണ്,0,0,1,1
20445,ಗಂಭೀರವಾಗಿ,0,0,1,1
20450,പഠന,0,0,1,1
20454,adressen,0,0,1,1
20455,meldden,0,0,1,1
20457,chemical,0,0,1,1
20459,vardagligt,0,0,1,1
20431,богат,0,0,1,1
20430,காலாண்டில்,0,0,1,1
20429,напугала,0,0,1,1
20428,apertura,0,0,1,1
3773,αργού,0,0,1,1
20426,studenters,0,0,1,1
20424,αφοσιωμένη,0,0,1,1
20423,ಅಮೆರಿಕಾದಲ್ಲಿ,0,0,1,1
3774,интеллекта,0,0,1,1
20420,manually,0,0,1,1
20418,разницы,0,0,1,1
20417,അതിനുപുറമേ,0,0,1,1
20416,atrás,0,0,1,1
3775,पैरों,0,0,1,1
20414,rigtige,0,0,1,1
20413,ಸಂದಿಗ್ಧತೆ,0,0,1,1
20410,चाहे,0,0,1,1
20460,تحياتي,0,0,1,1
20461,gusto,0,0,1,1
20462,"
सोमाली",0,0,1,1
20487,indiquait,0,0,1,1
20506,søvnen,0,0,1,1
20505,لأقول,0,0,1,1
3767,ನೀನೇನು,0,0,1,1
20502,españolas,0,0,1,1
3768,région,0,0,1,1
20499,igennem,0,0,1,1
20497,ജയിലുകളിൽ,0,0,1,1
20495,معروفًا,0,0,1,1
20494,بقراءة,0,0,1,1
3769,computation,0,0,1,1
20492,commit,0,0,1,1
20491,തടസ്സപ്പെടുത്തിയതിൽ,0,0,1,1
20489,تستطع,0,0,1,1
20488,zorundasın,0,0,1,1
20486,बिग,0,0,1,1
20463,consultores,0,0,1,1
20485,musée,0,0,1,1
20483,vigilant,0,0,1,1
20479,élaboration,0,0,1,1
20476,бегло,0,0,1,1
20475,εξυπηρετούν,0,0,1,1
3771,difficilement,0,0,1,1
20473,ru •,0,0,1,1
20471,ويتم,0,0,1,1
20470,camel,0,0,1,1
20469,yönleriyle,0,0,1,1
20468,والمتغيرات,0,0,1,1
20467,sentez,0,0,1,1
20465,surprend,0,0,1,1
3772,opencollaborative,0,0,1,1
20409,spridning,0,0,1,1
20407,fehlverhalten,0,0,1,1
20711,dieta,0,0,1,1
20350,muestran,0,0,1,1
20343,stumt,0,0,1,1
20344,yapmamıştım,0,0,1,1
20345,الخاطئة,0,0,1,1
20346,memcached,0,0,1,1
20347,influencia,0,0,1,1
20349,meant,0,0,1,1
20351,mote,0,0,1,1
3776,supervivencia,0,0,1,1
20352,unterbreche,0,0,1,1
20354,artikelredigeringar,0,0,1,1
20356,pointofsale,0,0,1,1
3782,verwijst,0,0,1,1
20358,மற்றவர்,0,0,1,1
20360,товарного,0,0,1,1
20342,ഇറ്റാലിയൻ,0,0,1,1
20340,bokkapitlet,0,0,1,1
20339,புவியியல்,0,0,1,1
20338,recently,0,0,1,1
20336,قيمة,0,0,1,1
20335,şifresini,0,0,1,1
20334,tegenstrijdige,0,0,1,1
20333,springe,0,0,1,1
20332,убита,0,0,1,1
20331,bevisar,0,0,1,1
20329,പോകുന്നുവെന്നത്,0,0,1,1
20327,sive,0,0,1,1
20325,அழகையும்,0,0,1,1
20324,அப்பட்டமானதைக்,0,0,1,1
20323,ഉണ്ടെന്നും,0,0,1,1
20322,cancerous,0,0,1,1
20321,falsamente,0,0,1,1
20361,brittiska,0,0,1,1
20362,اتخذتها,0,0,1,1
20363,ഉപയോഗിക്കാവുന്ന,0,0,1,1
20385,reescrevem,0,0,1,1
20404,بجانبها,0,0,1,1
20403,எதிர்மறை,0,0,1,1
20402,anlayabileceği,0,0,1,1
20401,വിക്കിപീഡിയയിലുണ്ടാകാറുണ്ട്,0,0,1,1
3777,தட்டில்,0,0,1,1
20399,industrielles,0,0,1,1
3778,içerikli,0,0,1,1
20396,regardons,0,0,1,1
3779,யூடியூப்,0,0,1,1
20393,tissues,0,0,1,1
20392,männen,0,0,1,1
20391,eliminaria,0,0,1,1
20389,animó,0,0,1,1
20388,vikisözlük,0,0,1,1
20384,versucht,0,0,1,1
20365,hâlen,0,0,1,1
20383,aradan,0,0,1,1
20381,criativa,0,0,1,1
20379,കാണുന്നില്ലെങ്കിൽ,0,0,1,1
20378,предпочел,0,0,1,1
20377,skapades,0,0,1,1
20376,прецедентов —,0,0,1,1
20375,ಯೋಜಿಸುತ್ತಿದ್ದೇನೆ,0,0,1,1
20374,ஆவார்,0,0,1,1
20373,gas,0,0,1,1
20370,variadas,0,0,1,1
20369,ಪ್ರಾಮಾಣಿಕವಾಗಿ,0,0,1,1
20368,сбалансированные,0,0,1,1
20367,добровольного,0,0,1,1
20366,अमीर,0,0,1,1
20507,ഷെല്ലിന്റെ,0,0,1,1
20509,comediante,0,0,1,1
20510,операционные,0,0,1,1
20653,вызванной,0,0,1,1
20643,duymuşsanız,0,0,1,1
20647,title,0,0,1,1
20649,पकड़ा।,0,0,1,1
20650,स्थिर,0,0,1,1
20651,desistindo,0,0,1,1
20652,verbazingwekkends,0,0,1,1
20654,grammaire,0,0,1,1
20512,सुवे,0,0,1,1
20656,ആദ്യവർഷത്തിൽ,0,0,1,1
20658,العلوم,0,0,1,1
20659,serbie,0,0,1,1
20660,ускоряющийся,0,0,1,1
20661,βικιθήκη,0,0,1,1
3752,svolgono,1,1,0,1
3753,trattava,1,1,0,1
20639,تقليدًا,0,0,1,1
20638,absurdos,0,0,1,1
20637,வாக்கிய,0,0,1,1
20636,ശ്രദ്ധിക്കൂ,0,0,1,1
20632,தாயைக்,0,0,1,1
20628,"
francês",0,0,1,1
20627,dediğinizde,0,0,1,1
20624,تكميلي,0,0,1,1
20623,daneben,0,0,1,1
20622,വലുതുമായ,0,0,1,1
3756,affermate,1,1,0,1
20619,നടത്തുന്നത്,0,0,1,1
20618,எங்கள்,0,0,1,1
20616,voyageaient,0,0,1,1
20613,விக்கிப்பீடியாவினுள்,0,0,1,1
20612,korean,0,0,1,1
3751,fattibile,1,1,0,1
20664,ίση,0,0,1,1
20669,cs •,0,0,1,1
20693,reliées,0,0,1,1
20710,takipsizliği,0,0,1,1
20709,hiermee,0,0,1,1
20708,correcto,0,0,1,1
20707,bate,0,0,1,1
20706,अर्थव्यवस्था,0,0,1,1
20705,φτιαγμένες,0,0,1,1
20703,അക്ഷരങ്ങളെയും,0,0,1,1
20702,ingeniero,0,0,1,1
3747,wikiˈpidja,1,1,0,1
20699,resultando,0,0,1,1
20698,disallowed,0,0,1,1
20697,حديقتهم,0,0,1,1
20695,ಬಂತು,0,0,1,1
20694,مطلوبة,0,0,1,1
20692,çıkmasına,0,0,1,1
20670,основатели,0,0,1,1
20690,تسلسلات,0,0,1,1
20689,solide,0,0,1,1
20687,aktiviteten,0,0,1,1
20683,lowquality,0,0,1,1
3748,conclusa,1,1,0,1
20681,gefangene,0,0,1,1
20680,يعتبر,0,0,1,1
20679,adicionados,0,0,1,1
20677,ஏற்றுக்கொள்ள,0,0,1,1
3749,giardino,1,1,0,1
20675,olursun,0,0,1,1
20674,kıyafet,0,0,1,1
20672,udtaler,0,0,1,1
20671,feks,0,0,1,1
20611,بنحو,0,0,1,1
20610,ouça,0,0,1,1
20605,parodiler,0,0,1,1
20534,அவனுடைய,0,0,1,1
20552,interprétés,0,0,1,1
20551,bereikt,0,0,1,1
20549,fondée,0,0,1,1
20548,اعمده,0,0,1,1
20547,ഉടൻ,0,0,1,1
20546,совместного,0,0,1,1
3762,"
minangkabau",0,0,1,1
20544,ಸ್ಥಳವಿಲ್ಲ,0,0,1,1
20543,originalforskning,0,0,1,1
20542,drôle,0,0,1,1
20541,aleatória,0,0,1,1
20540,открытым,0,0,1,1
3763,onderzoekers,0,0,1,1
20536,دارتموث,0,0,1,1
20533,ഇൻപുട്ടിൽ,0,0,1,1
20554,общество,0,0,1,1
20532,créatures,0,0,1,1
20527,نسوا,0,0,1,1
20526,lyfta,0,0,1,1
20524,وعمل,0,0,1,1
20523,आधुनिक,0,0,1,1
3766,calidad​,0,0,1,1
20521,affärer,0,0,1,1
20520,पानी,0,0,1,1
20519,குறிப்பிடத்தக்க,0,0,1,1
20518,الذكاء,0,0,1,1
20517,nail,0,0,1,1
20516,spaarnestad,0,0,1,1
20515,forked,0,0,1,1
20513,الحرب,0,0,1,1
20553,وتبدو,0,0,1,1
20555,undersöker,0,0,1,1
20604,mejorar,0,0,1,1
20575,üçü,0,0,1,1
20599,लिखता,0,0,1,1
20597,വാങ്ങില്ല,0,0,1,1
20595,expériences,0,0,1,1
20592,προστεθούν,0,0,1,1
20588,ಹೋಗುತ್ತದೆ,0,0,1,1
3758,cárceles,0,0,1,1
3759,ತಿಳಿದಿದೆಯೇ,0,0,1,1
20585,çamaşır,0,0,1,1
20584,repairing,0,0,1,1
20583,«подобное,0,0,1,1
20582,solle,0,0,1,1
20580,സൗകര്യമുണ്ട്,0,0,1,1
20579,ordu,0,0,1,1
20576,ചാനലായ,0,0,1,1
20574,feasibility,0,0,1,1
20556,dévie,0,0,1,1
20573,tsurko,0,0,1,1
20571,chico,0,0,1,1
20569,kanıtlamazsanız,0,0,1,1
20568,சிறைச்சாலைகளில்,0,0,1,1
20566,вкусно,0,0,1,1
20565,mucha,0,0,1,1
3761,océans,0,0,1,1
20563,salz,0,0,1,1
20562,voyager,0,0,1,1
20561,система,0,0,1,1
20560,eliminadores,0,0,1,1
20559,समझा,0,0,1,1
20558,valde,0,0,1,1
20557,évolutions,0,0,1,1
19578,koninkrijk,0,0,1,1
19574,باللغات,0,0,1,1
24165,klänningarna,0,0,1,1
18534,échappé,0,0,1,1
18526,بالخارج,0,0,1,1
18527,planlıyorum,0,0,1,1
4005,написан,0,0,1,1
4004,плохое,0,0,1,1
18531,ακόμα,0,0,1,1
18533,lacked,0,0,1,1
18535,പദ്ധതിയിടുന്നു,0,0,1,1
18502,sömnen,0,0,1,1
18537,sucedido,0,0,1,1
18538,microcurrents,0,0,1,1
18541,работ,0,0,1,1
18543,aumentando,0,0,1,1
18544,нах,0,0,1,1
18545,vertrekken,0,0,1,1
18525,replicadas,0,0,1,1
18522,affirmé,0,0,1,1
18521,رخصة,0,0,1,1
18520,പരിശീലനം,0,0,1,1
18519,arwid,0,0,1,1
18518,புத்தகத்தைப்,0,0,1,1
18517,будущая,0,0,1,1
18516,ಚಾನಲ್,0,0,1,1
18515,वापस,0,0,1,1
18513,ambas,0,0,1,1
18512,تهدئة,0,0,1,1
18511,спрашивал,0,0,1,1
18510,விரும்புகிறாள்,0,0,1,1
18508,yazın,0,0,1,1
4006,çocuğum,0,0,1,1
18506,wegwerken,0,0,1,1
18505,alemanha,0,0,1,1
18548,favoriser,0,0,1,1
4003,geophysiological,0,0,1,1
18554,ಬೇಡವೆಂದು,0,0,1,1
18575,faktamässigt,0,0,1,1
18598,என்பவர்,0,0,1,1
18596,минимизировать,0,0,1,1
18594,पकड़ते,0,0,1,1
18591,मास्टर,0,0,1,1
18589,fastest,0,0,1,1
18588,колонке,0,0,1,1
3999,noie,0,0,1,1
18585,mødested,0,0,1,1
18583,أحببت,0,0,1,1
18582,كذباً,0,0,1,1
18581,pouviez,0,0,1,1
18580,دانيال,0,0,1,1
18578,സ്തംഭിച്ചുപോകുന്നത്,0,0,1,1
18576,كتابه,0,0,1,1
18574,aristotélicienne,0,0,1,1
18555,retrata,0,0,1,1
18572,grubudur,0,0,1,1
18571,δάχτυλά,0,0,1,1
18570,авторского,0,0,1,1
18569,challenging,0,0,1,1
18568,vinklad,0,0,1,1
18567,βάλτου,0,0,1,1
18566,specifiek,0,0,1,1
18565,തണുത്തവരായിരിക്കാൻ,0,0,1,1
18564,базы,0,0,1,1
4000,любая,0,0,1,1
18560,dame,0,0,1,1
18559,предложено,0,0,1,1
4001,llamado,0,0,1,1
18556,privilégios,0,0,1,1
18504,терминами,0,0,1,1
18501,subversivos,0,0,1,1
18600,إخبارهم,0,0,1,1
18444,новой,0,0,1,1
18433,подвергавшихся,0,0,1,1
18434,måneden,0,0,1,1
18437,live,0,0,1,1
18439,mencionarse,0,0,1,1
18440,أخبرتك,0,0,1,1
18442,مثلا،,0,0,1,1
18445,ಚಲಿಸುವ,0,0,1,1
18500,falto,0,0,1,1
18446,ಯಾವಾಗ,0,0,1,1
18447,№ ,0,0,1,1
18451,forstå,0,0,1,1
18453,ومقاومته,0,0,1,1
18456,git,0,0,1,1
18457,bakgrund,0,0,1,1
18432,wikipediabron,0,0,1,1
18431,basisconcept,0,0,1,1
4014,feiten,0,0,1,1
18429,отмечены,0,0,1,1
4015,സ്ത്രീ,0,0,1,1
18427,ideological,0,0,1,1
18424,компьютерным,0,0,1,1
18423,мнений,0,0,1,1
18421,प्रविष्टियाँ,0,0,1,1
4017,okunulacak,0,0,1,1
4019,usagers,0,0,1,1
18417,financés,0,0,1,1
18416,മലയാളത്തിനു,0,0,1,1
18415,dussintal,0,0,1,1
18414,возможного,0,0,1,1
18411,ഒപ്റ്റിമൈസേഷൻ,0,0,1,1
18409,fullaste,0,0,1,1
18458,neus,0,0,1,1
18459,förhindrat,0,0,1,1
18461,foucault,0,0,1,1
18481,சலவை,0,0,1,1
18499,ehrlich,0,0,1,1
18498,пропустить,0,0,1,1
18497,kopiëren,0,0,1,1
18494,güvenilebilirliği,0,0,1,1
18493,بقليل,0,0,1,1
18492,« conservation,0,0,1,1
18490,teria,0,0,1,1
18488,buggy,0,0,1,1
18487,îlesréf,0,0,1,1
18486,valenciana,0,0,1,1
4007,böcker,0,0,1,1
18484,συλλογή,0,0,1,1
18483,inappropriée,0,0,1,1
4008,பிரிட்டானிக்கா,0,0,1,1
18479,slarvar,0,0,1,1
18462,σχολιάζοντας,0,0,1,1
18478,لتخريب,0,0,1,1
18477,ഡബ്ല്യു,0,0,1,1
18476,accomplish,0,0,1,1
18475,commençait,0,0,1,1
18474,chartes,0,0,1,1
4010,называемая,0,0,1,1
18471,நெரிசல்கள்,0,0,1,1
18469,subdomínio,0,0,1,1
4011,உள்ளதோடு,0,0,1,1
4012,التباطؤ,0,0,1,1
18466,അതിനർ‌ത്ഥം,0,0,1,1
18465,rapazes,0,0,1,1
18464,rules”,0,0,1,1
18463,നല്ലവനാണ്,0,0,1,1
18599,fint,0,0,1,1
3998,பீடியா,0,0,1,1
19573,compromis,0,0,1,1
3976,deyim,0,0,1,1
18727,മധുരമുള്ളതുമായ,0,0,1,1
18732,जाकर,0,0,1,1
18733,hoge,0,0,1,1
18734,என்னுடன்,0,0,1,1
18735,داخلية,0,0,1,1
18736,உருவாக்கினர்,0,0,1,1
3975,هكذا,0,0,1,1
18702,кэша,0,0,1,1
18744,lcs,0,0,1,1
18745,لمشروع,0,0,1,1
18747,utilisait,0,0,1,1
18748,vrijwel,0,0,1,1
3973,வாசிக்கும்,0,0,1,1
3972,данная,0,0,1,1
18725,عدت,0,0,1,1
18724,внимания,0,0,1,1
18721,ചെറുതും,0,0,1,1
3978,ಮಾಡುತ್ತದೆ,0,0,1,1
3979,dérive,0,0,1,1
18718,recurre,0,0,1,1
18717,செல்லத்,0,0,1,1
18716,"
इतालवी",0,0,1,1
18715,weerlegging,0,0,1,1
18714,conheço,0,0,1,1
3980,குழந்தைக்கோ,0,0,1,1
18712,paraît,0,0,1,1
3981,примеров,0,0,1,1
18710,kendileri,0,0,1,1
18708,ಬರಲಿದೆ,0,0,1,1
18707,nobelpristagare,0,0,1,1
18704,estrategia,0,0,1,1
18751,ಪರಿಣಾಮವನ್ನು,0,0,1,1
18754,begejstrede,0,0,1,1
18756,implicações,0,0,1,1
18780,i̇yiyim,0,0,1,1
18798,circulando,0,0,1,1
18797,ickeengelska,0,0,1,1
18794,والسلوك,0,0,1,1
3966,indian,0,0,1,1
18792,schwierigkeiten,0,0,1,1
18791,كونغرس,0,0,1,1
18790,сославшись,0,0,1,1
18789,vergisst,0,0,1,1
18788,haphazard,0,0,1,1
18787,sket,0,0,1,1
18786,administrativos,0,0,1,1
18784,zenginliği,0,0,1,1
18783,സ്രോതസ്സുകളെയും,0,0,1,1
18782,aprendiesen,0,0,1,1
18778,saladas,0,0,1,1
18757,typique,0,0,1,1
18777,المستقلة,0,0,1,1
18776,lyngfelt,0,0,1,1
18774,социологическое,0,0,1,1
3968,τέρρι,0,0,1,1
18772,enfade,0,0,1,1
3969,identity,0,0,1,1
18768,çarpıcı,0,0,1,1
18767,запросу,0,0,1,1
18766,bred,0,0,1,1
18765,"
min",0,0,1,1
18764,identifies,0,0,1,1
3970,aún,0,0,1,1
18759,zoet,0,0,1,1
18758,minuscule,0,0,1,1
3983,κοίταξα,0,0,1,1
18701,skeçler,0,0,1,1
18603,forskaren,0,0,1,1
18640,peso,0,0,1,1
18632,κυρίες,0,0,1,1
18633,അതിനടുത്തുള്ള,0,0,1,1
18634,قانونين,0,0,1,1
18636,olağan,0,0,1,1
18637,നിങ്ങൾക്കാവശ്യമുള്ളതെന്തും,0,0,1,1
18639,noncollege,0,0,1,1
3993,memoria,0,0,1,1
18700,собака,0,0,1,1
18642,collège,0,0,1,1
18643,மேலதிகமாக,0,0,1,1
18644,ولاحقًا,0,0,1,1
18645,இதனைப்,0,0,1,1
18646,озаглавленная,0,0,1,1
3991,недостоверная,0,0,1,1
18631,behövs,0,0,1,1
18630,беспокойтесь»,0,0,1,1
18629,أعرفها,0,0,1,1
18628,mediantid,0,0,1,1
18627,nouvel,0,0,1,1
3995,സ്വീകരിക്കാം,0,0,1,1
18625,обнять,0,0,1,1
18624,κατάλληλο,0,0,1,1
18623,"
आइसलैण्डी",0,0,1,1
18620,conclusion,0,0,1,1
3996,pænere,0,0,1,1
18618,பயனுள்ள,0,0,1,1
18617,ثمل,0,0,1,1
18614,leider,0,0,1,1
18613,«кто,0,0,1,1
18612,üretilen,0,0,1,1
3997,estompe,0,0,1,1
18649,ciencia,0,0,1,1
18651,wikipediametadata,0,0,1,1
18654,olduğuydu,0,0,1,1
18679,bildbank,0,0,1,1
18699,വൃദ്ധനായ,0,0,1,1
18698,विशेषाधिकृत,0,0,1,1
3984,नोब्रेनर,0,0,1,1
18693,बताओ।,0,0,1,1
18692,മാർഗമാണിത്,0,0,1,1
18691,ഒരോ,0,0,1,1
3986,axis,0,0,1,1
18688,ποιότητας,0,0,1,1
18686,inblick,0,0,1,1
18685,lättare,0,0,1,1
18683,einzige,0,0,1,1
18682,മുന്നിൽ,0,0,1,1
18681,transparency ,0,0,1,1
18680,σκληρός,0,0,1,1
18678,anticlaudianus,0,0,1,1
18655,بدت,0,0,1,1
18676,बिन्दु,0,0,1,1
18675,காட்டவும்,0,0,1,1
18673,skrevet,0,0,1,1
18671,интернетэнциклопедия,0,0,1,1
18670,tamam,0,0,1,1
18669,spejlet,0,0,1,1
18668,hänga,0,0,1,1
18665,doublingtime,0,0,1,1
18663,conseguirás,0,0,1,1
18662,носители,0,0,1,1
18661,нарцисе,0,0,1,1
18660,लक्ष्य,0,0,1,1
3988,ejakulation,0,0,1,1
18657,ലഭിക്കാത്ത,0,0,1,1
18408,vec •,0,0,1,1
4020,रोचक,0,0,1,1
18404,översättningen,0,0,1,1
18138,مهلا,0,0,1,1
18130,продала,0,0,1,1
18132,jedes,0,0,1,1
18133,superan,0,0,1,1
18135,suddenly,0,0,1,1
18136,rape,0,0,1,1
18137,സാധ്യമാക്കിയത്,0,0,1,1
18139,regularly,0,0,1,1
18104,confiança,0,0,1,1
18142,nuttige,0,0,1,1
18143,simplificadas,0,0,1,1
18144,المختلفة,0,0,1,1
18145,delivers,0,0,1,1
18146,alweer,0,0,1,1
18148,toptijdschriften,0,0,1,1
18128,سيفوليلي,0,0,1,1
18127,വാക്കുകൾക്കപ്പുറത്ത്,0,0,1,1
18126,ligeglad,0,0,1,1
18125,trataron,0,0,1,1
18124,bundestag,0,0,1,1
18123,रहना।,0,0,1,1
4059,ключевым,0,0,1,1
18121,മൂർച്ചയുള്ളതും,0,0,1,1
18120,traînes,0,0,1,1
18116,ಉಪ್ಪು,0,0,1,1
18115,langages,0,0,1,1
18114,killen,0,0,1,1
18113,overemphasis,0,0,1,1
18112,ದೇವದೂತನಂತೆ,0,0,1,1
18110,afslutte,0,0,1,1
4060,дэвидом,0,0,1,1
18108,iie siècle,0,0,1,1
18153,koymayı,0,0,1,1
18154,antigüedad,0,0,1,1
18155,ஆக்க,0,0,1,1
18181,författad,0,0,1,1
18203,நினைத்திருந்தது,0,0,1,1
18202,jefe,0,0,1,1
18201,fotos,0,0,1,1
18199,exagerarla,0,0,1,1
18197,capitalistas,0,0,1,1
18196,mühen,0,0,1,1
18194,ستنمو,0,0,1,1
18193,rouge,0,0,1,1
18192,إضافي,0,0,1,1
18190,utsätts,0,0,1,1
18187,அழைக்கப்படும்,0,0,1,1
18186,diskussionssida,0,0,1,1
18185,استخراج,0,0,1,1
18183,haklarında,0,0,1,1
18180,historik,0,0,1,1
18156,तीसरी,0,0,1,1
18179,perpetrator,0,0,1,1
18177,donnant,0,0,1,1
18176,നല്ലവരായിരുന്നു,0,0,1,1
18174,imputáveis,0,0,1,1
18171,കാര്യങ്ങൾക്ക്,0,0,1,1
18168,depth,0,0,1,1
4054,buscan,0,0,1,1
18165,जोड़ें,0,0,1,1
4055,संबंधित,0,0,1,1
18162,συνέβαινε,0,0,1,1
18161,написаны,0,0,1,1
18160,effectuées,0,0,1,1
18158,ஆண்டில்,0,0,1,1
18157,relaterade,0,0,1,1
18107,साक्षात्कारों,0,0,1,1
18102,فعلت,0,0,1,1
18403,उठाया,0,0,1,1
4066,naviguer,0,0,1,1
18036,выдать,0,0,1,1
18038,ഉണ്ടായേക്കാവുന്ന,0,0,1,1
18040,masculine,0,0,1,1
18041,सम्पूर्ण,0,0,1,1
18042,λεπτό,0,0,1,1
18043,φτιαγμένο,0,0,1,1
18047,nds •,0,0,1,1
18101,uygunluğu,0,0,1,1
18048,maldonado​,0,0,1,1
18050,religion,0,0,1,1
18051,नशा,0,0,1,1
18052,подчинённых,0,0,1,1
18053,नीतियां,0,0,1,1
18054,autorisation,0,0,1,1
18035,ജോലിയുണ്ട്,0,0,1,1
18032,disharmoni,0,0,1,1
18031,يسير؟,0,0,1,1
18029,текстом,0,0,1,1
18028,funciona,0,0,1,1
18027,മെല്ലിയെക്കുറിച്ച്,0,0,1,1
18025,ತೆಗೆದುಕೊಂಡರೆ,0,0,1,1
18024,borta,0,0,1,1
18023,sacolejou,0,0,1,1
18022,aplicadas,0,0,1,1
18021,nuire,0,0,1,1
18020,ഓർഗനൈസേഷൻ,0,0,1,1
4069,objectives,0,0,1,1
18017,engaging,0,0,1,1
18015,நேரமில்லை,0,0,1,1
18013,बहन,0,0,1,1
18012,snabbare,0,0,1,1
18055,çalışmasının,0,0,1,1
18057,højttaler,0,0,1,1
18058,unternehmen,0,0,1,1
18083,uddannede,0,0,1,1
18100,التنبيهات,0,0,1,1
18099,excuse,0,0,1,1
18098,udc,0,0,1,1
18097,ಕಾಯಲು,0,0,1,1
18096,неоднократно,0,0,1,1
18095,"
एस्टोनीयाई",0,0,1,1
18094,formuler,0,0,1,1
18093,произносится,0,0,1,1
18091,réalisable,0,0,1,1
18090,столом,0,0,1,1
18089,цене,0,0,1,1
4062,vergeten,0,0,1,1
18086,يخبار,0,0,1,1
18084,നല്ലവനാണോ,0,0,1,1
18081,dotées,0,0,1,1
18060,பெறும்போது,0,0,1,1
18080,luchó,0,0,1,1
18077,επαγγελματική,0,0,1,1
18076,парламентский,0,0,1,1
18075,distribuida,0,0,1,1
18074,ocasionalmente,0,0,1,1
4064,पैसे,0,0,1,1
18071,tt •,0,0,1,1
18070,சுவாரஸ்யமான,0,0,1,1
18069,ur •,0,0,1,1
18068,المصروفات,0,0,1,1
4065,توقفنا,0,0,1,1
18066,المزايا,0,0,1,1
18062,sensacional,0,0,1,1
18061,ಪಚ್ಚೆಗಳ,0,0,1,1
18204,ذكر,0,0,1,1
18206,استطعت,0,0,1,1
18209,substituída,0,0,1,1
18345,presidenciais,0,0,1,1
4028,abonnere,0,0,1,1
18338,korsar,0,0,1,1
18340,والعربية,0,0,1,1
18341,adopte,0,0,1,1
18342,गुजर,0,0,1,1
4027,سريعة,0,0,1,1
18346,देश,0,0,1,1
4050,irgendetwas,0,0,1,1
18347,സുന്ദരിയും,0,0,1,1
18348,أتساءل,0,0,1,1
18349,ತಮಾಷೆಯಾಗಿದೆ,0,0,1,1
18351,കുഴഞ്ഞുമറിഞ്ഞ,0,0,1,1
4026,länkas,0,0,1,1
18353,esboço,0,0,1,1
18334,compraría,0,0,1,1
4029,प्रोग्राम,0,0,1,1
18329,inferred,0,0,1,1
18328,majeur ,0,0,1,1
18327,şirket,0,0,1,1
18326,празднует,0,0,1,1
18323,университет,0,0,1,1
18320,visualiseringsverktyg,0,0,1,1
18319,techné« l,0,0,1,1
18318,grupper,0,0,1,1
18317,الماضية,0,0,1,1
18316,ശ്രമം,0,0,1,1
18315,संसदीय,0,0,1,1
18314,أطلقت,0,0,1,1
18313,constantly,0,0,1,1
18312,şarkı,0,0,1,1
18311,ventes,0,0,1,1
18354,"
गन",0,0,1,1
18355,berømte,0,0,1,1
18356,विकिपीडीयन्स,0,0,1,1
18378,"
गिलाकी",0,0,1,1
4021,arkadaşımı,0,0,1,1
18397,biologiques,0,0,1,1
18395,അഭിനന്ദിക്കുന്നതിനുള്ള,0,0,1,1
18394,discurso,0,0,1,1
18393,مسافة,0,0,1,1
18392,langage,0,0,1,1
18389,நாளும்,0,0,1,1
18387,babosa,0,0,1,1
18386,неявную,0,0,1,1
18385,участия,0,0,1,1
18384,सा,0,0,1,1
18383,förutsättningar,0,0,1,1
18382,politiques ,0,0,1,1
18379,புரிந்துகொள்வதில்,0,0,1,1
18377,ağlıyorsun,0,0,1,1
18358,ചെയ്തിരിക്കുന്ന,0,0,1,1
18376,தேவையற்ற,0,0,1,1
18374,ഇംഗ്ലീഷിലാണ്,0,0,1,1
18373,medication,0,0,1,1
18372,politikasıdır,0,0,1,1
18371,εκτεθούν,0,0,1,1
4022,refereras,0,0,1,1
4023,usaria,0,0,1,1
18367,«abrió,0,0,1,1
18365,идет,0,0,1,1
18364,måtte,0,0,1,1
18363,வலைதளத்துக்கு,0,0,1,1
18362,продвижение,0,0,1,1
4024,« notes,0,0,1,1
18359,adn ,0,0,1,1
18310,undersökningsgruppen,0,0,1,1
18308,ರೀತಿಗೆ,0,0,1,1
18307,принцип,0,0,1,1
18229,الويكيبيديون,0,0,1,1
18253,realizou,0,0,1,1
18252,freakade,0,0,1,1
18251,ശൈലി,0,0,1,1
18249,математика,0,0,1,1
18248,heltäckande,0,0,1,1
18244,небольшую,0,0,1,1
18243,pouca,0,0,1,1
18241,региональных,0,0,1,1
18240,അതോ,0,0,1,1
18238,trovärdiga,0,0,1,1
18235,принимаю,0,0,1,1
18233,قبولًا,0,0,1,1
18232,ബാധകമായ,0,0,1,1
18231,സ്ത്രീകൾക്ക്,0,0,1,1
18227,ಬಹಳಷ್ಟು,0,0,1,1
18257,closer,0,0,1,1
18226,structurées,0,0,1,1
18224,ഗണത്തിൽപ്പെടുന്നു,0,0,1,1
18223,recente,0,0,1,1
18222,कार्यक्षमता,0,0,1,1
18221,holder,0,0,1,1
18220,चिन्हित,0,0,1,1
18219,സമസ്ത,0,0,1,1
18218,öğreneceğiz,0,0,1,1
18217,ಶಾಸ್ತ್ರೀಯ,0,0,1,1
18216,प्रयास।,0,0,1,1
18215,посвящён,0,0,1,1
18214,aufschreiben,0,0,1,1
18213,pesquisando,0,0,1,1
18211,pares​,0,0,1,1
18255,substitutions,0,0,1,1
4045,wikizine,0,0,1,1
18304,κρυφά,0,0,1,1
4037,النقاد,0,0,1,1
18303,தேடுகிறீர்கள்,0,0,1,1
4031,الصلة,0,0,1,1
4032,schloss,0,0,1,1
18300,pointant,0,0,1,1
18298,accesserna,0,0,1,1
18297,sweetheart,0,0,1,1
18295,missnöje,0,0,1,1
18294,ಉದಾಹರಣೆಗಳು,0,0,1,1
18293,oftare,0,0,1,1
18292,пользователь,0,0,1,1
4036,prøver,0,0,1,1
18290,salutations,0,0,1,1
18288,modifié,0,0,1,1
18287,actualités,0,0,1,1
18285,усердной,0,0,1,1
18259,ತಲುಪಿತು,0,0,1,1
4038,ശൈലികളെയും,0,0,1,1
18282,spitzen,0,0,1,1
4040,ellesmêmes,0,0,1,1
18279,afviste,0,0,1,1
18277,பிரச்சனை,0,0,1,1
18275,enfiar,0,0,1,1
18274,lèvres,0,0,1,1
4041,skickade,0,0,1,1
18271,τερενς,0,0,1,1
18268,بكم,0,0,1,1
18267,bøger,0,0,1,1
18266,கருத்தை,0,0,1,1
18262,× kilograms,0,0,1,1
18260,ungenießbar,0,0,1,1
18799,poses,0,0,1,1
18800,науке,0,0,1,1
18802,والأفضل,0,0,1,1
19328,répartissent,0,0,1,1
19316,duydum,0,0,1,1
3900,പൊതുവായി,0,0,1,1
3898,خائفًا,0,0,1,1
3897,ഉണ്ടാക്കുമെന്ന്,0,0,1,1
19323,inondation,0,0,1,1
19327,मॉम,0,0,1,1
19329,التعليم,0,0,1,1
19295,بالأحجار,0,0,1,1
19333,തിരഞ്ഞെടുത്ത്,0,0,1,1
19334,geliştirin,0,0,1,1
19335,« chaque,0,0,1,1
19336,upprörda,0,0,1,1
19337,ಗೊಂದಲಕ್ಕೊಳಗಾದವು,0,0,1,1
19338,därefter,0,0,1,1
19315,упоминающимся,0,0,1,1
19314,وضعك,0,0,1,1
19312,κατάλαβα,0,0,1,1
19311,batholiths,0,0,1,1
19310,prinsen,0,0,1,1
19309,உணவகம்,0,0,1,1
19308,шекманом,0,0,1,1
19306,ಎಲ್ಲರೂ,0,0,1,1
19305,birbirinden,0,0,1,1
19304,hypertekst,0,0,1,1
19303,fusion,0,0,1,1
19302,éclairer,0,0,1,1
19301,മാറ്റിനിർത്തി,0,0,1,1
19300,perfekte,0,0,1,1
19299,implementación,0,0,1,1
19298,vermeld,0,0,1,1
19297,ಒತ್ತಿ,0,0,1,1
19339,ನಯವಾಗಿ,0,0,1,1
19340,einschließlich,0,0,1,1
19343,προσφορές,0,0,1,1
19368,"
मिंग्रिलियाई",0,0,1,1
19386,veriyorum,0,0,1,1
19385,destacan,0,0,1,1
19384,financial,0,0,1,1
19382,pålitlighet,0,0,1,1
19381,взаимодействию,0,0,1,1
19379,hurtig,0,0,1,1
19378,सिविल,0,0,1,1
19377,slaap,0,0,1,1
19375,αγαπημένο,0,0,1,1
19373,importarme,0,0,1,1
3893,orientados,0,0,1,1
19371,bilgileri,0,0,1,1
19370,ಮೂಲೆಯಲ್ಲಿಯೇ,0,0,1,1
19369,بثبات,0,0,1,1
19367,admiración,0,0,1,1
3894,verwende,0,0,1,1
19366,വിലയിരുത്തപ്പെട്ട,0,0,1,1
19365,pourront,0,0,1,1
19364,அலெக்சா,0,0,1,1
19362,banks,0,0,1,1
19360,« jouer »,0,0,1,1
19359,fokuseret,0,0,1,1
19358,полагается,0,0,1,1
19357,उठाया।,0,0,1,1
19356,ഉപ്പ്,0,0,1,1
19354,excelente,0,0,1,1
19353,papers,0,0,1,1
19352,seawater,0,0,1,1
19351,suivis,0,0,1,1
19350,سجلت,0,0,1,1
19296,शैक्षणिक,0,0,1,1
19294,gekümmert,0,0,1,1
19208,пародируются,0,0,1,1
19243,browser,0,0,1,1
19237,directmedia,0,0,1,1
19238,കണ്ടെത്തിയ,0,0,1,1
3907,narzissmus,0,0,1,1
19240,بمثل,0,0,1,1
19241,compactamiento,0,0,1,1
19242,popularisés,0,0,1,1
19244,സ്വരം,0,0,1,1
19293,പ്രവർത്തിക്കുന്നില്ലെങ്കിൽ,0,0,1,1
3906,أبعد,0,0,1,1
19248,ഗെയിം,0,0,1,1
19249,столько,0,0,1,1
19250,vraagteken,0,0,1,1
19251,செயற்பாடு’,0,0,1,1
19252,യു,0,0,1,1
19235,ഭാഗ്യം,0,0,1,1
19233,hp,0,0,1,1
19232,trouxe,0,0,1,1
19230,добавлять,0,0,1,1
19229,bulundurur,0,0,1,1
19228,edebilirler,0,0,1,1
19227,ಬಯಸಿದ,0,0,1,1
3909,välkommen,0,0,1,1
19224,explicitement,0,0,1,1
19223,ederken,0,0,1,1
19220,siri,0,0,1,1
19219,fournies,0,0,1,1
19218,തിരുത്താൻ,0,0,1,1
19216,जीटरेन,0,0,1,1
19214,chartier,0,0,1,1
19213,മാലാഖയാണ്,0,0,1,1
19212,"
सिसलीयाई",0,0,1,1
19253,liking,0,0,1,1
19254,konservativa,0,0,1,1
19255,lustigen,0,0,1,1
19278,"
नीपोलिटाई",0,0,1,1
19292,وأطلقت,0,0,1,1
19291,ædelstene,0,0,1,1
19290,التلاعب,0,0,1,1
3902,rubriker,0,0,1,1
19288,engelskspråkig,0,0,1,1
19287,beobachtete,0,0,1,1
19286,esclarecido,0,0,1,1
19285,डाला,0,0,1,1
19284,fortunes,0,0,1,1
19283,postagens,0,0,1,1
19282,rill,0,0,1,1
19281,forståelige,0,0,1,1
19280,tekrarı,0,0,1,1
19279,рассказала,0,0,1,1
19277,ignoreallrules,0,0,1,1
19256,betecknar,0,0,1,1
19275,forhåbentlig,0,0,1,1
19274,tarihin,0,0,1,1
19273,gfdl —,0,0,1,1
19272,aufgewacht,0,0,1,1
19271,ദേഷ്യപ്പെടുന്നുവെന്നത്,0,0,1,1
19269,डॉलर,0,0,1,1
19268,अनुमति।,0,0,1,1
19267,تحسَن,0,0,1,1
19265,çoğunluğu,0,0,1,1
19264,серверные,0,0,1,1
19263,προβλήματα,0,0,1,1
3904,regulamentações,0,0,1,1
3905,höger,0,0,1,1
19257,αυτού,0,0,1,1
3891,लाइब्रेरी,0,0,1,1
19389,cine,0,0,1,1
3890,stansifer,0,0,1,1
19516,draaiende,0,0,1,1
19507,anual,0,0,1,1
3868,écouter,0,0,1,1
19511,gebaseerd,0,0,1,1
19512,—término,0,0,1,1
19513,heyecan,0,0,1,1
19515,ಮಾಡದ,0,0,1,1
19517,affirmait,0,0,1,1
19392,especie,0,0,1,1
19518,уроков,0,0,1,1
19519,censar,0,0,1,1
19522,participer,0,0,1,1
19523,bristerna,0,0,1,1
19524,تخبر,0,0,1,1
19526,मुख,0,0,1,1
19505,انتحال,0,0,1,1
19503,fouilles,0,0,1,1
19502,horreur,0,0,1,1
19501,author,0,0,1,1
19500,universités,0,0,1,1
19498,έδωσε,0,0,1,1
19497,ervaring,0,0,1,1
19496,произносить,0,0,1,1
19495,obscurs,0,0,1,1
19494,séparent,0,0,1,1
19493,kaydını,0,0,1,1
19492,objectif,0,0,1,1
19491,sorabilirsiniz,0,0,1,1
3869,migrado,0,0,1,1
19489,touristen,0,0,1,1
19488,ആയിരുന്നെങ്കിൽ,0,0,1,1
19486,χρησιμοποιούσατε,0,0,1,1
19527,группе,0,0,1,1
19528,​​dem,0,0,1,1
19529,positief,0,0,1,1
19550,കെട്ടുറപ്പുള്ള,0,0,1,1
19572,நிறுவனத்திற்குச்,0,0,1,1
19571,नवम्बर,0,0,1,1
19570,മനസ്സിലാക്കേണ്ടതെല്ലാം,0,0,1,1
19567,मीडियाविकी,0,0,1,1
3864,penny,0,0,1,1
19565,forfremmet,0,0,1,1
19564,متطورًا,0,0,1,1
3865,üzgün,0,0,1,1
19560,fließender,0,0,1,1
19559,دراسات,0,0,1,1
19557,anlayabilirsiniz,0,0,1,1
19556,üzerindeki,0,0,1,1
19552,« machine,0,0,1,1
19551,குறிக்கிறீர்கள்,0,0,1,1
19548,acquire,0,0,1,1
19530,അവയെല്ലാം,0,0,1,1
19546,bijdraagt,0,0,1,1
19545,tactics,0,0,1,1
19544,أطلب,0,0,1,1
19543,ехали,0,0,1,1
19542,благонамеренных,0,0,1,1
19541,அனுபவங்களைத்,0,0,1,1
19540,sœur,0,0,1,1
19538,progresser,0,0,1,1
19537,பயன்படுத்தப்படலாம்,0,0,1,1
19536,insanlara,0,0,1,1
19535,перемещён,0,0,1,1
19534,kong,0,0,1,1
19533,parabenizar,0,0,1,1
19532,χρησιμότητα,0,0,1,1
19485,ελαφρώς,0,0,1,1
3873,ആഗ്രഹിക്കുകയും,0,0,1,1
19481,fdl,0,0,1,1
19411,fará,0,0,1,1
19427,அந்தக்,0,0,1,1
19426,substantia,0,0,1,1
19424,скажешь,0,0,1,1
19423,wapediatjänsten,0,0,1,1
19422,സഞ്ചരിക്കുന്ന,0,0,1,1
3885,dr,0,0,1,1
19420,siguieron,0,0,1,1
19419,уравновешенным,0,0,1,1
19418,منطقة,0,0,1,1
19417,consciemment,0,0,1,1
3887,liegst,0,0,1,1
19415,ದೌರ್ಜನ್ಯವನ್ನು,0,0,1,1
19414,yaptığınızı,0,0,1,1
19413,läxor,0,0,1,1
19410,pollueur,0,0,1,1
19435,волновалась,0,0,1,1
19409,sucré,0,0,1,1
19408,logístico,0,0,1,1
19407,തടയുന്നു,0,0,1,1
19406,இருந்ததுடன்,0,0,1,1
19403,வேர்,0,0,1,1
19402,hilf,0,0,1,1
19401,நண்பர்களிடம்,0,0,1,1
19400,vogels,0,0,1,1
19398,exercise,0,0,1,1
19397,ಮುಂದುವರೆಸು,0,0,1,1
19396,vandalizmle,0,0,1,1
3889,ατρόμητη,0,0,1,1
19394,ವಿನಂತಿಗಳನ್ನು,0,0,1,1
19393,sensíveis,0,0,1,1
3884,ales,0,0,1,1
19437,दुर्भाग्य,0,0,1,1
19480,удивлена,0,0,1,1
19458,കുറവുമുള്ളതായി,0,0,1,1
3874,اعتبار,0,0,1,1
19478,четвёртым,0,0,1,1
19477,kommentarfeltet,0,0,1,1
19476,amené,0,0,1,1
19474,ದೂರವಾಣಿ,0,0,1,1
19472,لتصنيف,0,0,1,1
19471,प्रगति,0,0,1,1
19470,создала,0,0,1,1
19469,utilidade,0,0,1,1
3877,συστήματα,0,0,1,1
3879,existência,0,0,1,1
19462,unmögliche,0,0,1,1
19460,ವಹಿಸಲಿಲ್ಲ,0,0,1,1
19459,derecede,0,0,1,1
19457,counterpart,0,0,1,1
19438,சூடாக,0,0,1,1
3880,الإداريين,0,0,1,1
19455,സഹിഷ്ണുക്കൾ,0,0,1,1
19454,ചിലരെ,0,0,1,1
3881,εχεις,0,0,1,1
19451,parodian,0,0,1,1
3882,lições,0,0,1,1
19449,disposez,0,0,1,1
19448,actuaciones,0,0,1,1
19447,destes,0,0,1,1
19446,mining‏,0,0,1,1
19445,areas—automatic,0,0,1,1
3883,toplamda,0,0,1,1
19441,ಭೇಟಿಯಾಗುತ್ತೀರಿ,0,0,1,1
19439,mermeladas,0,0,1,1
19210,செல்கிறேன்,0,0,1,1
19207,cuyo,0,0,1,1
18803,നല്ലവരായിരിക്കുക,0,0,1,1
18936,эпизодах,0,0,1,1
18927,tendrá,0,0,1,1
18928,sauvegardes,0,0,1,1
18929,объектом,0,0,1,1
3945,contestados,0,0,1,1
18934,μπορούσαν,0,0,1,1
18935,jehová,0,0,1,1
18937,narret,0,0,1,1
18903,consist,0,0,1,1
18938,fehlern,0,0,1,1
18939,olmadığı,0,0,1,1
18940,முறையே,0,0,1,1
18941,ناحية,0,0,1,1
18942,testimde,0,0,1,1
18943,குழப்பிவிட்டேன்,0,0,1,1
18926,ശ്രദ്ധിക്കുന്നവർ,0,0,1,1
18925,ونحتاج,0,0,1,1
18924,articlep,0,0,1,1
18923,hæng,0,0,1,1
3946,saludos,0,0,1,1
18920,διακόπτει,0,0,1,1
18919,dk,0,0,1,1
18918,использовался,0,0,1,1
18917,تميل,0,0,1,1
18916,مصطلح,0,0,1,1
18914,имея,0,0,1,1
18913,محل,0,0,1,1
18912,vinkling,0,0,1,1
3947,أعطيك,0,0,1,1
18909,partition,0,0,1,1
18908,egoist,0,0,1,1
18907,ajustes,0,0,1,1
18944,sommeil,0,0,1,1
18946,والمحللون,0,0,1,1
18947,anfangen,0,0,1,1
18974,நாட்டிற்கு,0,0,1,1
18996,trafic »,0,0,1,1
18995,ஏற்றுக்கொள்கிறேன்,0,0,1,1
3937,βλέπετε,0,0,1,1
18992,gibiler,0,0,1,1
18990,ba,0,0,1,1
18987,foulée,0,0,1,1
18986,வந்து,0,0,1,1
3938,многих,0,0,1,1
18984,छोटा,0,0,1,1
18981,ഭാ‍ഷകളിലെ,0,0,1,1
18980,speakers,0,0,1,1
3939,skrivstuga,0,0,1,1
18976,força,0,0,1,1
18975,ausgeglichen,0,0,1,1
18973,நிறுத்தினோம்,0,0,1,1
18948,традиционным,0,0,1,1
18971,ickevetenskaplig,0,0,1,1
18970,conectados,0,0,1,1
18968,uspiselig,0,0,1,1
18966,confiera,0,0,1,1
18964,ಸಂಭಾಷಣೆಯನ್ನು,0,0,1,1
18962,прямую,0,0,1,1
3940,soulignées,0,0,1,1
18959,présentation,0,0,1,1
18958,erhvervserfaring,0,0,1,1
18957,ರುಚಿಯ,0,0,1,1
18956,listou,0,0,1,1
18955,sentar,0,0,1,1
18953,студентов,0,0,1,1
18952,bloquaient,0,0,1,1
18904,लॉ,0,0,1,1
18902,птицы,0,0,1,1
19206,présentées,0,0,1,1
18842,manche,0,0,1,1
18835,nossas,0,0,1,1
18836,üyelik,0,0,1,1
3959,بموجب,0,0,1,1
18838,പദങ്ങൾ‌,0,0,1,1
18839,بأمان,0,0,1,1
18841,உருவாக்குதல்,0,0,1,1
18843,запущенная,0,0,1,1
3948,बाद।,0,0,1,1
18844,கொள்கைக்கு,0,0,1,1
18845,ഭക്ഷണങ്ങൾ,0,0,1,1
18846,ತಿಳಿದಿರುವ,0,0,1,1
18848,imaginez,0,0,1,1
18849,मिनटों,0,0,1,1
18850,தயாரிக்கப்படுகின்றன,0,0,1,1
18834,undersökts,0,0,1,1
18833,புன்னகைக்கிறாள்,0,0,1,1
18832,मधुर,0,0,1,1
18827,perfectionnement,0,0,1,1
18826,représentant,0,0,1,1
18823,ενθαρρύνεις,0,0,1,1
18818,इंतजार,0,0,1,1
18816,утром,0,0,1,1
18814,ठहराते,0,0,1,1
18813,enenciclopedia,0,0,1,1
18812,pegue,0,0,1,1
18811,लेखन,0,0,1,1
18810,community ,0,0,1,1
3963,சீரான,0,0,1,1
3964,தோற்றங்களைக்,0,0,1,1
18805,mueves,0,0,1,1
18804,ठोक,0,0,1,1
18851,обобщением,0,0,1,1
18852,"

विकिपीडिया",0,0,1,1
18853,prego,0,0,1,1
18878,klädkänsla,0,0,1,1
18899,newer,0,0,1,1
3949,excités,0,0,1,1
18896,நுட்பக்,0,0,1,1
18894,الزمرد,0,0,1,1
18893,görünecek,0,0,1,1
18892,ಸಹಾಯಕ್ಕಾಗಿ,0,0,1,1
18889,குறிக்க,0,0,1,1
18888,എന്നൊക്കെ,0,0,1,1
18887,appeared,0,0,1,1
18885,taber,0,0,1,1
18884,السرعة،,0,0,1,1
3951,virgil,0,0,1,1
18881,moderering,0,0,1,1
18879,türetilmiştir,0,0,1,1
18876,immuables ,0,0,1,1
18854,телефонного,0,0,1,1
18875,karıştırmak,0,0,1,1
18874,रेटिंग्स,0,0,1,1
3953,ഐ,0,0,1,1
18872,personalizar,0,0,1,1
3954,desinformação,0,0,1,1
18869,catalane,0,0,1,1
18868,apropriada,0,0,1,1
18867,نتعلم,0,0,1,1
18864,ágil,0,0,1,1
18863,ദിവസമാണെന്ന്,0,0,1,1
18860,subtiele,0,0,1,1
3956,obteniez,0,0,1,1
18857,ചുട്ടെടുക്കാൻ,0,0,1,1
18855,personuppgifter,0,0,1,1
18997,yeah,0,0,1,1
18998,определённое,0,0,1,1
19000,लिखने,0,0,1,1
19141,comum,0,0,1,1
19133,javascript,0,0,1,1
19135,വെളിപ്പെടുത്തുന്നു,0,0,1,1
19136,rundgång,0,0,1,1
19138,مقابل,0,0,1,1
19139,stimulustriggered,0,0,1,1
19140,प्रोटेस्टर,0,0,1,1
19143,usaría,0,0,1,1
19002,культурных,0,0,1,1
19144,கவனிப்பதில்லை,0,0,1,1
19146,filled,0,0,1,1
19147,agents,0,0,1,1
19148,хеллером,0,0,1,1
19149,начнем,0,0,1,1
19151,விருந்தில்,0,0,1,1
19131,dehşet,0,0,1,1
19129,tutuklular,0,0,1,1
19128,grouping,0,0,1,1
19127,காதலன்,0,0,1,1
19126,புரிந்துகொண்டிருந்தால்,0,0,1,1
3917,suites,0,0,1,1
19124,pesos,0,0,1,1
3918,ಅಲ್ಲವೇ,0,0,1,1
19121,έσπασαν,0,0,1,1
19120,scruté,0,0,1,1
19118,alegam,0,0,1,1
19117,emphase,0,0,1,1
19116,пределы,0,0,1,1
19113,закрыть,0,0,1,1
19112,நுபீடியாவும்,0,0,1,1
19111,надёжным,0,0,1,1
19108,kanalıma,0,0,1,1
19152,tomber,0,0,1,1
19155,abrazar,0,0,1,1
19157,syntaxe,0,0,1,1
3913,நோக்கம்,0,0,1,1
19205,ورمز,0,0,1,1
19203,crude,0,0,1,1
19200,"
मिनांगकाबाउ",0,0,1,1
19199,reverrais,0,0,1,1
19197,approprié,0,0,1,1
19196,biotope,0,0,1,1
19192,diyor,0,0,1,1
19191,ಡಿಗ್ರಿಗಿಂತ,0,0,1,1
19190,വിക്കിപീഡിയക്ക്,0,0,1,1
19189,jesucristo,0,0,1,1
19188,denkt,0,0,1,1
19185,huvudstad,0,0,1,1
19182,അനുഭവപ്പെട്ടേക്കാം,0,0,1,1
19181,έσπασε,0,0,1,1
19179,ciddiye,0,0,1,1
19159,heimlich,0,0,1,1
19178,hayal,0,0,1,1
19177,जोनाथन,0,0,1,1
19176,ходим,0,0,1,1
19175,“எச்டிஎம்எல்”,0,0,1,1
19174,лидер,0,0,1,1
19173,nonsexual,0,0,1,1
19172,bloodthirsty,0,0,1,1
19171,نشأتها,0,0,1,1
19170,anunciou,0,0,1,1
19169,عطس,0,0,1,1
19165,tillåts,0,0,1,1
19162,पुस्तकालय,0,0,1,1
19161,extend,0,0,1,1
19160,متاحًا,0,0,1,1
19107,مشروعا,0,0,1,1
19105,çaba,0,0,1,1
3919,இல்லாது,0,0,1,1
19031,comportementaux,0,0,1,1
3926,ಫಿಕ್ಸ್‌ನಲ್ಲಿ,0,0,1,1
19049,وسلبيًا,0,0,1,1
19048,പാകിസ്താൻ,0,0,1,1
19047,ஆவர்,0,0,1,1
3928,ουρανός,0,0,1,1
19044,قابلة,0,0,1,1
19043,അനുസരിച്ച്,0,0,1,1
19041,electronicawedstrijd,0,0,1,1
19040,മൊത്തത്തിൽ,0,0,1,1
19038,känsliga,0,0,1,1
19035,exceptionnellement,0,0,1,1
19034,കാമ്പ്,0,0,1,1
19033,prendstoi,0,0,1,1
19032,അടിച്ചു,0,0,1,1
3929,vandalizados,0,0,1,1
19053,сработает,0,0,1,1
19026,വിഷയത്തിൽ,0,0,1,1
19024,ljudet,0,0,1,1
19023,несогласия,0,0,1,1
19019,включения,0,0,1,1
19017,isn,0,0,1,1
19016,indonésie,0,0,1,1
19015,tijdlang,0,0,1,1
3933,quo,0,0,1,1
3934,താക്കീതുകൾ,0,0,1,1
19012,منفرجًا,0,0,1,1
19011,ചെയ്യുന്നതിലൂടെയാണ്,0,0,1,1
19010,none,0,0,1,1
19006,visite,0,0,1,1
19004,बेस्ट,0,0,1,1
3925,ಹಿಡಿಯಲಿಲ್ಲವೇ,0,0,1,1
19055,دليل,0,0,1,1
19098,கொண்டிருந்தால்,0,0,1,1
3924,скромной,0,0,1,1
19097,därigenom,0,0,1,1
19094,habitants,0,0,1,1
19093,வாங்கிய,0,0,1,1
19090,"
बुल्गारियाई",0,0,1,1
19089,управлялась,0,0,1,1
19087,kritiseret,0,0,1,1
19086,onvoldoende,0,0,1,1
19083,தடுக்கப்படுவதோடு,0,0,1,1
19081,mineral,0,0,1,1
19079,قريبًا,0,0,1,1
3923,полная,0,0,1,1
19077,franchecomté,0,0,1,1
19076,അവൾക്കറിയാമോ,0,0,1,1
19075,"
cebuano",0,0,1,1
19073,lokala,0,0,1,1
19056,glauben,0,0,1,1
19072,الخصوص،,0,0,1,1
19071,கட்டுரைகளைப்,0,0,1,1
19070,spacecraft,0,0,1,1
19068,eigenen,0,0,1,1
19066,moverse,0,0,1,1
19065,способов,0,0,1,1
19064,λίγες,0,0,1,1
19063,uge,0,0,1,1
19062,termes ,0,0,1,1
19061,högskolekurser,0,0,1,1
19060,ألذ,0,0,1,1
19059,nica en,0,0,1,1
19058,begränsades,0,0,1,1
19057,differing,0,0,1,1
21103,llegar,0,0,1,1
21106,بدون,0,0,1,1
21107,kapot,0,0,1,1
23165,беспокою,0,0,1,1
3442,obiezioni,1,1,0,1
23158,كاذبة,0,0,1,1
23159,حادثة,0,0,1,1
23160,annesine,0,0,1,1
3440,cancellando,1,1,0,1
23164,paralelos,0,0,1,1
23166,ممل,0,0,1,1
23128,læser,0,0,1,1
23167,وفهرسة,0,0,1,1
3438,carceri,1,1,0,1
23169,ചോദിക്കണമെങ്കിൽ,0,0,1,1
3437,guardato,1,1,0,1
23175,தொடர்வதற்கு,0,0,1,1
23176,மூழ்கிவிடும்,0,0,1,1
23156,oriente,0,0,1,1
3443,crescita,1,1,0,1
23150,humorísticas,0,0,1,1
23149,ക്രിയേറ്റീവ്,0,0,1,1
23148,jouait,0,0,1,1
23147,exceptionally,0,0,1,1
23145,முடிந்துவிடும்,0,0,1,1
3445,ugo,1,1,0,1
23142,øje,0,0,1,1
23141,ग्रह,0,0,1,1
3446,chicago,1,1,0,1
23139,ವೈಯಕ್ತಿಕವಾಗಿ,0,0,1,1
23137,مجلة أدبيات,0,0,1,1
23135,sevgili,0,0,1,1
23134,πεινάτε,0,0,1,1
23133,—deliberadamente,0,0,1,1
23132,കമ്പ്യൂട്ടറുകളെ,0,0,1,1
23177,controversiales,0,0,1,1
23178,мясо,0,0,1,1
3436,fiacca,1,1,0,1
3429,underfitting,1,1,0,1
23220,γεμίσουμε,0,0,1,1
3424,marchi,1,1,0,1
23218,yielded,0,0,1,1
3425,vestiti,1,1,0,1
23214,demektir,0,0,1,1
23213,middelen,0,0,1,1
3426,probabilmente,1,1,0,1
23211,unie,0,0,1,1
23210,प्राधिकरण,0,0,1,1
23208,jämförde,0,0,1,1
23206,серьезной,0,0,1,1
3428,cosiddetta,1,1,0,1
23204,wezens,0,0,1,1
23203,kararı,0,0,1,1
23201,ಗೊಂದಲಕ್ಕೊಳಗಾದ,0,0,1,1
3434,sostegno,1,1,0,1
23200,referencias,0,0,1,1
23198,ifrågasatts,0,0,1,1
23196,некоторое,0,0,1,1
23195,правильной,0,0,1,1
23194,നിർത്തിയപ്പോൾ,0,0,1,1
23193,¿tengo,0,0,1,1
23192,بنظرة,0,0,1,1
3430,trasduzione,1,1,0,1
23190,publicasse,0,0,1,1
23189,വിനീതവും,0,0,1,1
23188,lithosphere,0,0,1,1
23187,rápido»​,0,0,1,1
3432,intellettuale,1,1,0,1
23185,الشقيقة،,0,0,1,1
23131,librarianship,0,0,1,1
23127,oprindelse,0,0,1,1
23225,incorporate,0,0,1,1
23072,redistribuílo,0,0,1,1
23066,grüße,0,0,1,1
23067,зеландии,0,0,1,1
23068,concierto,0,0,1,1
23069,οποτεδήποτε,0,0,1,1
23070,preguntado,0,0,1,1
23071,प्रिंट,0,0,1,1
23074,فكل,0,0,1,1
23126,विकिकोटे,0,0,1,1
23075,уровней,0,0,1,1
23076,എഡിറ്റർമാർ,0,0,1,1
23078,പലരുണ്ടാവുംഅവരുടെ,0,0,1,1
23079,федеральный,0,0,1,1
23080,പ്രപഞ്ചത്തിലെ,0,0,1,1
23081,ذكي,0,0,1,1
23065,vente,0,0,1,1
23064,sr •,0,0,1,1
23063,intègrent,0,0,1,1
23062,fivethirtyeight,0,0,1,1
23060,pouce,0,0,1,1
23059,çarptığı,0,0,1,1
23058,αρέσει,0,0,1,1
23057,προσλάβουμε,0,0,1,1
23055,inland,0,0,1,1
23052,стиль,0,0,1,1
23051,avråder,0,0,1,1
23050,constara,0,0,1,1
23049,sistémica,0,0,1,1
23048,ειδικά,0,0,1,1
23047,ಹತ್ತು,0,0,1,1
23046,allmänt,0,0,1,1
23044,обоих,0,0,1,1
23082,rette,0,0,1,1
23083,brion,0,0,1,1
23084,अल्पकालिक,0,0,1,1
23106,знака,0,0,1,1
23125,ಬಳಿ,0,0,1,1
23124,jugée,0,0,1,1
23121,आगंतुक,0,0,1,1
23120,അവസാനം,0,0,1,1
23119,δροσερός,0,0,1,1
23118,رموز,0,0,1,1
23117,tersi,0,0,1,1
23116,actuación,0,0,1,1
23114,cryptologue,0,0,1,1
23113,kommentarbereich,0,0,1,1
23110,സ്വകാര്യലാഭത്തിനു,0,0,1,1
3448,rinforzo,1,1,0,1
23108,إدارة,0,0,1,1
23107,соответствующей,0,0,1,1
23105,intensivo,0,0,1,1
23085,wijd,0,0,1,1
23104,используем,0,0,1,1
23103,ಲಾಂಡ್ರಿಗೆ,0,0,1,1
23102,väluppfostrad,0,0,1,1
23101,مخاوف,0,0,1,1
23100,reversión,0,0,1,1
23099,பக்கங்களை,0,0,1,1
23098,klikken,0,0,1,1
3449,cedette,1,1,0,1
23095,nl,0,0,1,1
23094,limitações,0,0,1,1
23093,അർബുദം,0,0,1,1
23092,चयनित,0,0,1,1
23091,ಆಶಾದಾಯಕವಾಗಿ,0,0,1,1
23090,ആവാറുണ്ട്,0,0,1,1
23224,ಹೇಳುವದನ್ನು,0,0,1,1
23226,entities,0,0,1,1
21109,halvautomatiserade,0,0,1,1
23362,ψυχικά,0,0,1,1
23356,sauvages,0,0,1,1
3411,assistenza,1,1,0,1
23358,предполагает,0,0,1,1
23359,فموسوعة,0,0,1,1
23360,മെഷീൻ,0,0,1,1
23361,encontrarás,0,0,1,1
23363,llanto,0,0,1,1
23324,lv •,0,0,1,1
23365,mr •,0,0,1,1
23368,приходили,0,0,1,1
23369,നുഴഞ്ഞുകയറിയിട്ടുണ്ടായേക്കാവുന്ന,0,0,1,1
23370,« italie »,0,0,1,1
23371,नींद,0,0,1,1
23372,highend,0,0,1,1
23354,contradictory,0,0,1,1
23350,verkade,0,0,1,1
23349,propianota,0,0,1,1
23347,formuleringsarbetet,0,0,1,1
23343,alternativos,0,0,1,1
23341,customers,0,0,1,1
23340,contemporain,0,0,1,1
23339,retoma,0,0,1,1
23338,stocker,0,0,1,1
23337,"
बोस्नियाई",0,0,1,1
23336,لبعضهما,0,0,1,1
23334,prononcez,0,0,1,1
23333,äktenskap,0,0,1,1
23331,intellectuel,0,0,1,1
23330,guerel,0,0,1,1
23329,முரட்டுத்தனமாக,0,0,1,1
23327,செயற்பட,0,0,1,1
23374,примите,0,0,1,1
23376,என்சிச்லோபெடியா,0,0,1,1
23377,ومستدامًا,0,0,1,1
3408,congratulazioni,1,1,0,1
23424,disruptive,0,0,1,1
23422,ಹೋಗುವಾಗ,0,0,1,1
23419,подлог,0,0,1,1
23418,yasalara,0,0,1,1
3399,intrusioni,1,1,0,1
23411,ξύπνησα,0,0,1,1
23409,medewerkers,0,0,1,1
23408,tornadoes,0,0,1,1
23407,قارئ،,0,0,1,1
23406,lasting,0,0,1,1
3404,contestati,1,1,0,1
23404,meningsmotståndare,0,0,1,1
23403,désignait,0,0,1,1
23401,devez,0,0,1,1
23396,ನೋಡುತ್ತದೆ,0,0,1,1
23378,பயன்படுத்தினால்,0,0,1,1
23395,stoppet,0,0,1,1
23394,إذ,0,0,1,1
23393,وأصبحت,0,0,1,1
23392,общее,0,0,1,1
23391,بنصب,0,0,1,1
23390,tareas,0,0,1,1
23389,incompréhensible,0,0,1,1
23387,ställer,0,0,1,1
23386,neuronal,0,0,1,1
23385,ödmjuk,0,0,1,1
23384,aprenden,0,0,1,1
23382,viquipedia,0,0,1,1
23381,accessdatum,0,0,1,1
23379,март,0,0,1,1
3412,paradosso,1,1,0,1
23323,prejudices,0,0,1,1
23227,retirar,0,0,1,1
23264,appelle,0,0,1,1
23257,promouvoir,0,0,1,1
23259,talar,0,0,1,1
23260,mentionnez,0,0,1,1
23261,ಮಟ್ಟಿಗೆ,0,0,1,1
23262,company,0,0,1,1
23263,respondem,0,0,1,1
23265,inserida,0,0,1,1
23321,decisivas,0,0,1,1
23266,подборку,0,0,1,1
3418,apprezzo,1,1,0,1
23268,മാച്ചു,0,0,1,1
23269,لمجادلتهم,0,0,1,1
23271,दृश्य,0,0,1,1
23272,necesita,0,0,1,1
23256,அச்சுறுத்தல்,0,0,1,1
23253,engendra,0,0,1,1
23251,габриэлем,0,0,1,1
23250,cifras,0,0,1,1
23249,postlisterne,0,0,1,1
23242,ಬಳಸುವುದು,0,0,1,1
23241,अवधारणा,0,0,1,1
23240,பார்ப்போம்,0,0,1,1
23239,viande,0,0,1,1
23236,धीरे,0,0,1,1
23234,"
वॉलून",0,0,1,1
23233,"
लुम्बार्ट",0,0,1,1
23232,åttonde,0,0,1,1
23231,അവതരിപ്പിക്കുമ്പോൾ,0,0,1,1
23230,cotidiana,0,0,1,1
23229,ലഭിച്ചില്ല,0,0,1,1
23228,использована,0,0,1,1
23273,അസാധാരണമായി,0,0,1,1
23274,തലച്ചോറിനെ,0,0,1,1
23276,ought,0,0,1,1
23301,motivated,0,0,1,1
3414,lasciami,1,1,0,1
23319,voices,0,0,1,1
23318,vegetabilia,0,0,1,1
23315,отличие,0,0,1,1
3415,bisogna,1,1,0,1
23313,проснулся,0,0,1,1
23312,रुचि,0,0,1,1
23311,ಅಳಬೇಡ,0,0,1,1
23307,movida,0,0,1,1
23306,contribuem,0,0,1,1
23305,റിക്ക്,0,0,1,1
3416,sembra,1,1,0,1
23303,epostadress,0,0,1,1
23302,neutralt,0,0,1,1
23300,spécialisés,0,0,1,1
23277,«todo,0,0,1,1
23298,microsystems,0,0,1,1
23297,prisoners,0,0,1,1
23293,dispensés,0,0,1,1
23292,اكتسبت,0,0,1,1
23291,atarsa,0,0,1,1
23290,migrent,0,0,1,1
23289,preguntando,0,0,1,1
3417,aggiustare,1,1,0,1
23286,تتسكع,0,0,1,1
23283,பக்கத்தின்,0,0,1,1
23282,تجاوزت,0,0,1,1
23281,permanently,0,0,1,1
23280,приготовилась,0,0,1,1
23278,« livres »,0,0,1,1
23043,engajar,0,0,1,1
23039,fdims,0,0,1,1
23038,ನೋಡಬಹುದಾದ,0,0,1,1
22777,maravilloso,0,0,1,1
22769,സഹിക്കൂ,0,0,1,1
22771,duração,0,0,1,1
22772,géomagnétiqueréf,0,0,1,1
22774,grupparbetet,0,0,1,1
22775,schlimmer,0,0,1,1
22776,synker,0,0,1,1
22780,asegúrese,0,0,1,1
3493,addestrando,1,1,0,1
22782,भौतिक,0,0,1,1
22784,destinés,0,0,1,1
22785,londonien,0,0,1,1
22786,interactividad,0,0,1,1
22788,abstraite,0,0,1,1
22789,olmasın,0,0,1,1
22766,प्रसारण,0,0,1,1
22765,يحاول,0,0,1,1
22764,номинирована,0,0,1,1
22763,различного,0,0,1,1
22762,worstelde,0,0,1,1
3490,informali,1,1,0,1
22760,instrui,0,0,1,1
22759,ce •,0,0,1,1
22758,μικρά,0,0,1,1
22755,elk,0,0,1,1
22754,kontakten,0,0,1,1
22753,portuguese,0,0,1,1
22752,duidt,0,0,1,1
22749,ícono,0,0,1,1
22745,variedad,0,0,1,1
22744,अर्थशास्त्री,0,0,1,1
22743,للمقالات,0,0,1,1
22790,κοντά,0,0,1,1
22791,startsidan,0,0,1,1
22794,அழுவதைப்,0,0,1,1
22820,bayésien,0,0,1,1
22836,താൽ‌പ്പര്യമുണ്ടെങ്കിൽ‌,0,0,1,1
22835,fauna,0,0,1,1
3481,rilevare,1,1,0,1
22833,автобус,0,0,1,1
22830,tnr,0,0,1,1
22829,"​
sin",0,0,1,1
22828,τρελαθεί,0,0,1,1
22827,decimale,0,0,1,1
22826,kanıdır,0,0,1,1
22825,conexiones,0,0,1,1
22824,múnich,0,0,1,1
22823,skribenterna,0,0,1,1
3482,giudicare,1,1,0,1
22821,inzamelen,0,0,1,1
3483,inizio,1,1,0,1
22795,ödeviniz,0,0,1,1
22817,nere,0,0,1,1
22816,fusión,0,0,1,1
22815,användes,0,0,1,1
22814,سألتقي,0,0,1,1
22813,renewable,0,0,1,1
22810,—número,0,0,1,1
22808,bevæger,0,0,1,1
22807,உள்ளடக்கங்களும்,0,0,1,1
3484,averlo,1,1,0,1
3485,significato,1,1,0,1
22800,существенное,0,0,1,1
3487,gemme,1,1,0,1
22798,sedimentary,0,0,1,1
3489,divenute,1,1,0,1
3492,pensi,1,1,0,1
22740,ഗൃഹപാഠം,0,0,1,1
23037,कोने,0,0,1,1
22686,verlasse,0,0,1,1
22676,fakir,0,0,1,1
22677,номинациях,0,0,1,1
22678,jardin,0,0,1,1
22682,обработка,0,0,1,1
22684,शब्दजाल,0,0,1,1
22685,पठन,0,0,1,1
3499,lacrime,1,1,0,1
22739,«открытие,0,0,1,1
22689,coluna,0,0,1,1
22690,குறைவான,0,0,1,1
22691,ಕಾಣುತ್ತದೆ,0,0,1,1
22692,lastly,0,0,1,1
3498,decenni,1,1,0,1
22694,संकेतबद्ध,0,0,1,1
22675,cümleler,0,0,1,1
22674,скорости,0,0,1,1
22673,المشارك,0,0,1,1
22672,historiques,0,0,1,1
22670,general—,0,0,1,1
22669,интересуют,0,0,1,1
22668,vikipedistler,0,0,1,1
22667,obtaining,0,0,1,1
3500,sottolineare,1,1,0,1
22664,fejler,0,0,1,1
22663,ചോദ്യങ്ങൾക്ക്,0,0,1,1
22662,വന്നിട്ടുണ്ടെന്നും,0,0,1,1
22661,النسبة,0,0,1,1
22658,zaken,0,0,1,1
22657,матерью,0,0,1,1
22656,модифицировано,0,0,1,1
22655,"
दुनिया",0,0,1,1
22695,generality,0,0,1,1
22696,envis,0,0,1,1
22697,énumérées,0,0,1,1
22718,പൊതുവായതും,0,0,1,1
22738,voorbereid,0,0,1,1
3494,distinti,1,1,0,1
22736,mümkün,0,0,1,1
22735,απόψεων,0,0,1,1
3495,regressione,1,1,0,1
22733,höll,0,0,1,1
22732,rebellion,0,0,1,1
22729,eronder,0,0,1,1
22728,moléculas,0,0,1,1
22726,disparidad,0,0,1,1
22724,d’indifférenciation,0,0,1,1
22722,summarizing,0,0,1,1
22720,தவறாக,0,0,1,1
22719,allée,0,0,1,1
22717,टिप्पणीकारों,0,0,1,1
22698,ρουμπίνια,0,0,1,1
22716,forretning,0,0,1,1
22715,propensas,0,0,1,1
22714,интересных,0,0,1,1
22713,médicale,0,0,1,1
22712,confinée,0,0,1,1
22710,exposition,0,0,1,1
22707,எனும்,0,0,1,1
22706,ಕೊನೆಯಲ್ಲಿ,0,0,1,1
3497,approfondimento,1,1,0,1
22704,അയയ്ക്കും,0,0,1,1
22702,réaction,0,0,1,1
22701,wikimed,0,0,1,1
22700,добьетесь,0,0,1,1
22699,—cada,0,0,1,1
22837,മൃതമായി,0,0,1,1
22838,ചെയ്യാതെ,0,0,1,1
22840,добровольных,0,0,1,1
22971,காட்டாது,0,0,1,1
22963,pekala,0,0,1,1
22965,soupe,0,0,1,1
3460,scherzo,1,1,0,1
3459,innata,1,1,0,1
22969,تنشأ,0,0,1,1
22970,ചീത്തയായി,0,0,1,1
3458,verrebbe,1,1,0,1
22842,typographie,0,0,1,1
22975,håll,0,0,1,1
22976,brødet,0,0,1,1
3457,richiedono,1,1,0,1
22978,учтиво,0,0,1,1
22979,eclipsando,0,0,1,1
3455,attendibilità,1,1,0,1
22961,συνομιλίας,0,0,1,1
22960,berömmet,0,0,1,1
22959,"
मूल",0,0,1,1
22958,مجتمعية,0,0,1,1
3461,naturale,1,1,0,1
22955,चारों,0,0,1,1
22954,moderação,0,0,1,1
22950,rce,0,0,1,1
22948,acelerou,0,0,1,1
22947,desastrosas,0,0,1,1
22946,pedras,0,0,1,1
22945,oluşturacak,0,0,1,1
22944,गैलिक,0,0,1,1
3462,restando,1,1,0,1
22940,paseo,0,0,1,1
22939,kalınarak,0,0,1,1
22938,получивший,0,0,1,1
22983,திட்டங்களையும்,0,0,1,1
22984,reclamando,0,0,1,1
3454,catalano,1,1,0,1
23010,ഗ്രാമത്തിൽ,0,0,1,1
23036,året,0,0,1,1
23035,расследования,0,0,1,1
23030,आवाज़,0,0,1,1
23029,"
रोमानियाई",0,0,1,1
23028,avoid,0,0,1,1
23022,equator,0,0,1,1
3451,stabilendo,1,1,0,1
23020,sayede,0,0,1,1
23019,loi,0,0,1,1
3452,individuazione,1,1,0,1
23015,eqiad,0,0,1,1
23014,eqord,0,0,1,1
23013,فلنتحدث,0,0,1,1
23011,dimensionality,0,0,1,1
23009,wikipediaspecific,0,0,1,1
22987,véhicule,0,0,1,1
23006,കൂട്ടായ്മയിൽ,0,0,1,1
23005,chat,0,0,1,1
23004,promise,0,0,1,1
23003,هبوط,0,0,1,1
23002,ingick,0,0,1,1
23001,புத்தகமாகத்,0,0,1,1
22999,собравшей,0,0,1,1
22995,എൻസൈക്ലോപീഡിയ,0,0,1,1
22994,amie,0,0,1,1
22993,historiens »,0,0,1,1
22991,сделан,0,0,1,1
22990,élément,0,0,1,1
3453,chiamante,1,1,0,1
22988,överdriva,0,0,1,1
22937,prompts,0,0,1,1
22933,वेर्कस्टाट,0,0,1,1
22932,تخيل,0,0,1,1
22863,içeriğe,0,0,1,1
22888,igneous,0,0,1,1
22884,sahip,0,0,1,1
22883,ചോദ്യങ്ങളിൽ,0,0,1,1
22882,посмотрим,0,0,1,1
22880,министром,0,0,1,1
22877,पिछले,0,0,1,1
22876,закрывают,0,0,1,1
22872,«психбольницу,0,0,1,1
22871,apprentissage »,0,0,1,1
22870,நேரத்திலும்,0,0,1,1
3472,ristorante,1,1,0,1
22867,പത്രങ്ങൾ,0,0,1,1
22865,ошибаются,0,0,1,1
22864,ഏറെ,0,0,1,1
22861,injokes,0,0,1,1
22890,صنف,0,0,1,1
22859,grine,0,0,1,1
22858,приводят,0,0,1,1
22857,الحادث,0,0,1,1
22856,لويكيبيديا،,0,0,1,1
22855,traîner,0,0,1,1
22854,genererat,0,0,1,1
22853,شخص،,0,0,1,1
22852,analisado,0,0,1,1
3474,appartiene,1,1,0,1
3475,limitazioni,1,1,0,1
3476,neutralità,1,1,0,1
22847,ஆசிரியர்,0,0,1,1
3477,consegnato,1,1,0,1
3478,organizzato,1,1,0,1
22889,importar,0,0,1,1
22891,πλούτη,0,0,1,1
22929,cevaplamak,0,0,1,1
22910,αποθήκη,0,0,1,1
22928,mostrar,0,0,1,1
22927,നട്ടുപിടിപ്പിക്കാൻ,0,0,1,1
22925,tecnológico,0,0,1,1
22923,γράφεται,0,0,1,1
3464,guardò,1,1,0,1
22921,errónea,0,0,1,1
22920,பார்க்கும்,0,0,1,1
3465,balcone,1,1,0,1
22916,amerikansk,0,0,1,1
22915,отправиться,0,0,1,1
22914,agradável,0,0,1,1
22913,наплевать,0,0,1,1
22912,काल्पनिक,0,0,1,1
3467,impedito,1,1,0,1
22909,disproportionately,0,0,1,1
22892,« modes,0,0,1,1
22907,ativistas,0,0,1,1
22906,bootstrap,0,0,1,1
22905,എൻട്രോപ്പി,0,0,1,1
3469,umile,1,1,0,1
22903,ಜನರು,0,0,1,1
22902,credenciados,0,0,1,1
22901,relevantes,0,0,1,1
22900,kultiveret,0,0,1,1
22898,continuité,0,0,1,1
22897,بعدم,0,0,1,1
22896,impacta,0,0,1,1
22895,noncompliant,0,0,1,1
22894,ಇದಕ್ಕೆ,0,0,1,1
22893,बिन्दुओं,0,0,1,1
23425,χωριό,0,0,1,1
23426,الآخرين،,0,0,1,1
23429,habría,0,0,1,1
23914,«объект,0,0,1,1
23905,இதற்குப்,0,0,1,1
23907,quente,0,0,1,1
23908,возможных,0,0,1,1
3340,induttivo,1,1,0,1
23910,ചെയ്യാനാവുന്ന,0,0,1,1
23911,nationales,0,0,1,1
23915,udgiver,0,0,1,1
23883,σωστή,0,0,1,1
23918,aprèsmidi,0,0,1,1
23919,young,0,0,1,1
23920,onderzoeksresultaten,0,0,1,1
23921,secondaires,0,0,1,1
23923,eficientes,0,0,1,1
23924,innate,0,0,1,1
23904,brev,0,0,1,1
23903,പുനരാരംഭിക്കുകയും,0,0,1,1
23902,casarme,0,0,1,1
23900,koud,0,0,1,1
23899,चीजों,0,0,1,1
23898,temores,0,0,1,1
23897,licenciada,0,0,1,1
3342,ossia,1,1,0,1
23895,propriétaire,0,0,1,1
23894,மென்பொருளில்,0,0,1,1
23893,glimlachte,0,0,1,1
23892,soldiers,0,0,1,1
23891,"
योरूबा",0,0,1,1
3343,consigliando,1,1,0,1
23889,நகரத்தின்,0,0,1,1
23887,supplies,0,0,1,1
3344,equamente,1,1,0,1
23925,génome,0,0,1,1
23926,граффити,0,0,1,1
23927,grafo,0,0,1,1
23951,compositeur,0,0,1,1
23972,إضافية,0,0,1,1
23969,olduğunda,0,0,1,1
23968,प्राधिकृत,0,0,1,1
23967,φτιάξετε,0,0,1,1
23966,παρανόηση,0,0,1,1
3339,pezzi,1,1,0,1
23964,haftalarca,0,0,1,1
23963,उँगलियों,0,0,1,1
23961,tanıştığıma,0,0,1,1
23960,minderheidstalen,0,0,1,1
23959,d’individus,0,0,1,1
1,disponibilità,1,1,0,1
23954,മാർഗദർശിത,0,0,1,1
23953,उत्प्रेरक,0,0,1,1
23950,pride,0,0,1,1
23928,lenguajes,0,0,1,1
23949,местности,0,0,1,1
23948,गंभीरता,0,0,1,1
23947,savezvous,0,0,1,1
23946,indonesio,0,0,1,1
23943,വാക്യത്തിന്റെ,0,0,1,1
23942,خذ,0,0,1,1
23941,brandchannel,0,0,1,1
23938,نستخدم,0,0,1,1
23937,alıştırması,0,0,1,1
23935,ಭಾಷಿಕರು,0,0,1,1
23934,внешнему,0,0,1,1
23931,there’s,0,0,1,1
23930,alamazsınız,0,0,1,1
23929,bissen,0,0,1,1
23884,numarasını,0,0,1,1
23882,corporativas,0,0,1,1
23803,الفائدة,0,0,1,1
23832,وعليك,0,0,1,1
23825,engelsktalende,0,0,1,1
3353,disciplinate,1,1,0,1
23827,suspendre,0,0,1,1
23828,ün,0,0,1,1
23829,zorlandı,0,0,1,1
23830,ಫಿಕ್ಸ್‌ನಲ್ಲಿದೆ,0,0,1,1
23833,ವಹಿಸುತ್ತೇನೆ,0,0,1,1
23881,النيكل؛,0,0,1,1
23834,подавляющее,0,0,1,1
23835,വായനക്കാരുടേയും,0,0,1,1
3352,questione,1,1,0,1
23837,journalisme,0,0,1,1
23838,detectados,0,0,1,1
23839,dekken,0,0,1,1
23824,universele,0,0,1,1
23823,φανταχτερά,0,0,1,1
23822,¿podrías,0,0,1,1
23821,അല്ലയോ,0,0,1,1
23820,méritais,0,0,1,1
3354,generalizzare,1,1,0,1
23818,autónoma,0,0,1,1
23817,لاحقا,0,0,1,1
23816,തണുപ്പാണ്,0,0,1,1
23814,പേരുടെ,0,0,1,1
23813,ಫಿಕ್ಸ್‌ನ,0,0,1,1
3356,aprile,1,1,0,1
23810,soumise,0,0,1,1
23809,पब्लिक,0,0,1,1
23807,ускорить,0,0,1,1
23806,practica,0,0,1,1
23805,उन्हने,0,0,1,1
23840,muero,0,0,1,1
23841,palats,0,0,1,1
23842,kısık,0,0,1,1
23865,wikiform,0,0,1,1
23880,autobús,0,0,1,1
23879,pre,0,0,1,1
3345,inedite,1,1,0,1
23877,എന്നതിന്,0,0,1,1
23876,svensk,0,0,1,1
3346,autorevoli,1,1,0,1
23873,சாயங்காலம்,0,0,1,1
23872,sümüklüböcek,0,0,1,1
23871,seite,0,0,1,1
3347,replicato,1,1,0,1
23869,funny,0,0,1,1
23868,cometer,0,0,1,1
23867,removed,0,0,1,1
23866,ആവേശകരവും,0,0,1,1
23864,scenes,0,0,1,1
23843,creates,0,0,1,1
23861,erdoğan,0,0,1,1
23860,பிரமாதத்திற்கு,0,0,1,1
23858,manglende,0,0,1,1
23857,concluye,0,0,1,1
23856,pedanteri,0,0,1,1
23855,tarefas,0,0,1,1
23853,الطبيعية,0,0,1,1
3349,belli,1,1,0,1
23851,persona​,0,0,1,1
23850,sequência,0,0,1,1
3350,titoli,1,1,0,1
3351,selforganization,1,1,0,1
23846,ഉറപ്പുവരുത്തുവാൻ,0,0,1,1
23844,обращается,0,0,1,1
23973,outcomes,0,0,1,1
23976,scorpions—features,0,0,1,1
23977,couramment,0,0,1,1
24109,compete,0,0,1,1
24097,चीयर्स,0,0,1,1
24098,بعنوان,0,0,1,1
24101,स्वाहा,0,0,1,1
24102,വലിച്ചിടുക,0,0,1,1
24106,analyseras,0,0,1,1
24108,testigos,0,0,1,1
3320,connessa,1,1,0,1
23978,mattebok,0,0,1,1
24113,discuta,0,0,1,1
24114,muertas,0,0,1,1
24115,ligt,0,0,1,1
3318,specialistici,1,1,0,1
24117,ಅವರನ್ನು,0,0,1,1
24119,δελχί,0,0,1,1
24094,ಪ್ರಯತ್ನಕ್ಕೆ,0,0,1,1
24092,narsisa,0,0,1,1
24091,privée,0,0,1,1
24090,kartofler,0,0,1,1
24089,generalizations,0,0,1,1
24088,wonderful,0,0,1,1
24087,wurzelwörter,0,0,1,1
24086,مقاطعتك,0,0,1,1
24085,ಪುರುಷರನ್ನು,0,0,1,1
24083,παραπονεθεί,0,0,1,1
24082,suspicions,0,0,1,1
24081,recuperó,0,0,1,1
24079,।,0,0,1,1
24078,gelse,0,0,1,1
24077,использовано,0,0,1,1
24076,probieren,0,0,1,1
24075,achar,0,0,1,1
24120,текста,0,0,1,1
24121,इन्सटाल,0,0,1,1
24122,organizadas,0,0,1,1
24145,برنامجه،,0,0,1,1
24164,l’invention,0,0,1,1
24163,ശരിയാക്കി,0,0,1,1
24162,omission,0,0,1,1
24160,aktivera,0,0,1,1
24159,ಪ್ರಶ್ನೆಗೆ,0,0,1,1
24158,பரிந்துரைகள்,0,0,1,1
24157,தகவல்களை,0,0,1,1
24155,versuchen,0,0,1,1
24154,المتزايد,0,0,1,1
3310,aiutarmi,1,1,0,1
24152,aspects,0,0,1,1
3311,tettonica,1,1,0,1
24148,ಟವು,0,0,1,1
24146,παλιό,0,0,1,1
24144,fingrarna,0,0,1,1
24125,متاحة,0,0,1,1
24143,drunkna,0,0,1,1
24142,hazırlandığını,0,0,1,1
24140,തോന്നാത്ത,0,0,1,1
24138,runs,0,0,1,1
24137,утонченный,0,0,1,1
24136,ಹೋಗುವುದಿಲ್ಲ,0,0,1,1
24134,arrojó,0,0,1,1
24133,राष्ट्रीय,0,0,1,1
24132,filtro,0,0,1,1
24131,« naturelle »,0,0,1,1
3315,livelli,1,1,0,1
3316,dichiara,1,1,0,1
24127,formais,0,0,1,1
24126,bölgeden,0,0,1,1
24074,விளைவிக்கும்,0,0,1,1
24073,önümüzdeki,0,0,1,1
24072,तय,0,0,1,1
24000,mammals,0,0,1,1
24019,низкокачественной,0,0,1,1
24016,العقل,0,0,1,1
24015,efforcer,0,0,1,1
24013,sınıfın,0,0,1,1
24011,झुलस,0,0,1,1
24010,ಭಾಗವು,0,0,1,1
24009,какихлибо,0,0,1,1
24008,volop,0,0,1,1
24007,неизвестна,0,0,1,1
24006,enslashdot,0,0,1,1
24005,അംഗീകരിക്കാൻ,0,0,1,1
24004,കടം,0,0,1,1
3337,riuscire,1,1,0,1
24001,кнопка,0,0,1,1
23997,roten,0,0,1,1
24022,britisk,0,0,1,1
23996,αναφέρει,0,0,1,1
23995,атрибутированием,0,0,1,1
23994,gebrauch,0,0,1,1
23993,vardag,0,0,1,1
23992,permitió,0,0,1,1
23991,görebildiğim,0,0,1,1
23989,boşum,0,0,1,1
23986,πηδήσω,0,0,1,1
23985,ofrecerme,0,0,1,1
23984,போர்டல்,0,0,1,1
23983,ருசிக்கும்,0,0,1,1
23982,sürdürmelerini,0,0,1,1
23981,underutilized,0,0,1,1
3338,manderò,1,1,0,1
3333,dicesse,1,1,0,1
24023,språklänkar,0,0,1,1
24070,വാക്യ,0,0,1,1
24053,surprises,0,0,1,1
24069,utgår,0,0,1,1
24067,drawings,0,0,1,1
24066,زرع,0,0,1,1
24065,battleground,0,0,1,1
24064,குறைவாகவும்,0,0,1,1
24063,لله,0,0,1,1
24062,sunulmasındaki,0,0,1,1
24061,acceptée,0,0,1,1
24059,tiers,0,0,1,1
3324,musica,1,1,0,1
24057,interesaron,0,0,1,1
3325,veste,1,1,0,1
24055,θαυμαστικές,0,0,1,1
24054,взглянуть,0,0,1,1
24051,भाषी,0,0,1,1
24024,रफ्तार,0,0,1,1
24050,lasst,0,0,1,1
3329,stimolando,1,1,0,1
24043,மனம்,0,0,1,1
3331,proteina,1,1,0,1
24041,നിർമാതാവും,0,0,1,1
3332,rapidamente,1,1,0,1
24039,கட்டமைப்பு”க்கு,0,0,1,1
24038,valioso,0,0,1,1
24035,ytterligare,0,0,1,1
24033,मेलिस्सा,0,0,1,1
24032,നല്കുന്നതുമായ,0,0,1,1
24030,ಸಿಕ್ಕಿದ್ದೇನೆ,0,0,1,1
24029,çeyrekte,0,0,1,1
24028,countless,0,0,1,1
23804,வெளித்தொகுப்புக்களை,0,0,1,1
3357,classificandosi,1,1,0,1
23430,அழுகிறார்கள்,0,0,1,1
23562,സിനിമ,0,0,1,1
23555,cercana,0,0,1,1
23556,உறுதிப்படுத்தப்படுகின்றன,0,0,1,1
23557,tamamlanmış,0,0,1,1
23558,oceanography,0,0,1,1
23559,ടെറിയോടും,0,0,1,1
23561,tedbir,0,0,1,1
23563,llevan,0,0,1,1
23529,ستعيش,0,0,1,1
23564,പുഞ്ചിരിയായിരുന്നു,0,0,1,1
23565,arbetsdelning,0,0,1,1
23566,sabrosa,0,0,1,1
23567,spurgt,0,0,1,1
23568,albedo,0,0,1,1
23569,icat,0,0,1,1
23553,tryckt,0,0,1,1
3387,coordinati,1,1,0,1
23551,sorts,0,0,1,1
23550,rationnelles,0,0,1,1
23549,válida,0,0,1,1
23548,ओबामा,0,0,1,1
23545,വിഷയങ്ങളിലെ,0,0,1,1
3388,popolarità,1,1,0,1
23542,وكل,0,0,1,1
23541,யூகித்தாலும்,0,0,1,1
23540,அவர்களுக்கு,0,0,1,1
23536,usaj,0,0,1,1
23535,querría,0,0,1,1
23534,medieråd,0,0,1,1
23533,metrix,0,0,1,1
23532,träffat,0,0,1,1
23531,avons,0,0,1,1
23570,mrs,0,0,1,1
23572,ഒരാളെ,0,0,1,1
23573,отвечающие,0,0,1,1
23597,ethnographique,0,0,1,1
23616,partis,0,0,1,1
23615,incorporés,0,0,1,1
23614,“tax,0,0,1,1
3380,itō,1,1,0,1
23612,различных,0,0,1,1
23611,расходятся,0,0,1,1
23610,lämnat,0,0,1,1
23607,യഥാർത്ഥ,0,0,1,1
23606,மனிதன்,0,0,1,1
23604,يعتقد,0,0,1,1
23602,നിർവഹിക്കാൻ,0,0,1,1
23601,lisent,0,0,1,1
23600,പതാകവാഹക,0,0,1,1
23599,öbeğini,0,0,1,1
23593,जाऊँगा।,0,0,1,1
3385,contatto,1,1,0,1
23592,cavalgada,0,0,1,1
23591,gags,0,0,1,1
23590,ensaladas,0,0,1,1
23588,بروابط,0,0,1,1
3381,caricate,1,1,0,1
23586,photographie,0,0,1,1
23585,ಅಡ್ಡಿಪಡಿಸಲು,0,0,1,1
23584,rig,0,0,1,1
23583,ongeluk,0,0,1,1
23582,rigorosos,0,0,1,1
3384,muoversi,1,1,0,1
23579,സന്തോഷ,0,0,1,1
23578,defendido,0,0,1,1
23576,kanalen,0,0,1,1
23530,décomptant,0,0,1,1
23528,بناءً,0,0,1,1
23801,matematikbog,0,0,1,1
23462,yaşamınızda,0,0,1,1
23453,अश्लील,0,0,1,1
23454,agerade,0,0,1,1
23455,« or,0,0,1,1
23456,ஒப்புக்கொண்டால்,0,0,1,1
23458,«потрясающе,0,0,1,1
3396,ospitata,1,1,0,1
23463,ಬೇಕಾದುದಾದರೆ,0,0,1,1
23527,humanidad»,0,0,1,1
23464,обоим,0,0,1,1
23465,sales,0,0,1,1
23466,microsystem,0,0,1,1
23467,نوعًا,0,0,1,1
23469,wikipedia”,0,0,1,1
3395,attuò,1,1,0,1
23451,ഇവർ,0,0,1,1
23449,художник,0,0,1,1
23448,brook,0,0,1,1
23447,användargenererat,0,0,1,1
23446,lignendeknappen,0,0,1,1
23445,cuestiones,0,0,1,1
23444,kruist,0,0,1,1
23443,distribuciones,0,0,1,1
23441,रखा।,0,0,1,1
23440,تشغلها,0,0,1,1
23439,ελα,0,0,1,1
23438,بلا,0,0,1,1
23436,പ്രതിപാദനത്തെയും,0,0,1,1
23434,vele,0,0,1,1
23433,num,0,0,1,1
23432,phyla,0,0,1,1
23431,രണ്ടെണ്ണം,0,0,1,1
23472,الصعب,0,0,1,1
23473,krypteringen,0,0,1,1
23478,knutna,0,0,1,1
23501,décider,0,0,1,1
23526,coutumes,0,0,1,1
23523,مقالة،,0,0,1,1
23522,попадет,0,0,1,1
23519,friere,0,0,1,1
23518,ലക്ഷത്തിനടുത്ത്,0,0,1,1
23517,महाद्वीपों,0,0,1,1
23516,precedentes,0,0,1,1
23515,studier,0,0,1,1
23514,clicks,0,0,1,1
23511,والإحصاء,0,0,1,1
23510,भरा,0,0,1,1
23509,nachzudenken,0,0,1,1
23506,generel,0,0,1,1
23502,tidsperiod,0,0,1,1
23499,déclaraient,0,0,1,1
3394,mando,1,1,0,1
23498,dictionaries,0,0,1,1
23497,aka,0,0,1,1
23496,föreställ,0,0,1,1
23495,ದಿನನಿತ್ಯದ,0,0,1,1
23494,ನಡತೆ,0,0,1,1
23493,urbaines,0,0,1,1
23492,functie,0,0,1,1
23491,viagens,0,0,1,1
23490,taler,0,0,1,1
23489,bevorderd,0,0,1,1
23486,رأسه,0,0,1,1
23485,promueven,0,0,1,1
23484,مدى,0,0,1,1
23483,έμοιαζε,0,0,1,1
23617,haría,0,0,1,1
23618,dimension,0,0,1,1
23619,impossibilitadas,0,0,1,1
23740,சிறந்தவர்,0,0,1,1
23731,probeerde,0,0,1,1
23733,sucedidas,0,0,1,1
23734,ഗ്രോഡിയന്റേ,0,0,1,1
3367,farei,1,1,0,1
23738,تدور,0,0,1,1
23739,librenota,0,0,1,1
23741,представителя,0,0,1,1
23620,caractérise »,0,0,1,1
23742,بأدب,0,0,1,1
23744,eo •,0,0,1,1
23747,आश्चर्यचकित,0,0,1,1
23749,отклонениям,0,0,1,1
23753,recopier,0,0,1,1
23754,malodorante,0,0,1,1
23730,cep,0,0,1,1
23729,einverstanden,0,0,1,1
23728,işin,0,0,1,1
3370,svegliato,1,1,0,1
23725,whose,0,0,1,1
23724,benadrukken,0,0,1,1
23723,coopération,0,0,1,1
23721,lacunes,0,0,1,1
23720,trumps,0,0,1,1
23719,παραδώσει,0,0,1,1
23718,introduisit,0,0,1,1
23717,svälter,0,0,1,1
23716,uttal vɪkɪ,0,0,1,1
23714,borrando,0,0,1,1
23710,«неудобных»,0,0,1,1
23709,புத்தகத்தில்,0,0,1,1
23708,américaines,0,0,1,1
23755,வடிவமைக்கப்,0,0,1,1
23756,singapur,0,0,1,1
3365,definire,1,1,0,1
3361,acqua,1,1,0,1
23800,fnr,0,0,1,1
23799,vergadering,0,0,1,1
23798,soumis,0,0,1,1
3358,decidibile,1,1,0,1
3359,compilazione,1,1,0,1
3360,wafer,1,1,0,1
23792,അന്തരീക്ഷത്തിന്,0,0,1,1
23790,klas,0,0,1,1
23789,juge,0,0,1,1
23788,க்மாட்டை,0,0,1,1
23786,ವಿವರಿಸುವಾಗ,0,0,1,1
23784,kaçınılır,0,0,1,1
23781,accent,0,0,1,1
23780,करोड़,0,0,1,1
23778,unterschiedlichen,0,0,1,1
23760,förfrågningar,0,0,1,1
23777,processen,0,0,1,1
23776,моих,0,0,1,1
23775,önemlidir,0,0,1,1
23773,முடிவை,0,0,1,1
23771,aning,0,0,1,1
23770,അറിയില്ലെന്ന്,0,0,1,1
23769,dominerande,0,0,1,1
23768,étranger,0,0,1,1
23767,enforce,0,0,1,1
23766,அடையச்,0,0,1,1
3364,presso,1,1,0,1
23764,أكبرها،,0,0,1,1
23763,प्रस्तावना,0,0,1,1
23762,uppmärksammat,0,0,1,1
23707,« portail »réf,0,0,1,1
23706,للتحدث,0,0,1,1
23705,corrélation,0,0,1,1
23644,mensualmente,0,0,1,1
23661,threats,0,0,1,1
23660,filipino,0,0,1,1
23659,टैब्स,0,0,1,1
23657,numerical,0,0,1,1
23656,uddybende,0,0,1,1
23654,wikipediadag,0,0,1,1
23653,avsiktlig,0,0,1,1
23652,annenize,0,0,1,1
23651,gestionar,0,0,1,1
23649,hanımların,0,0,1,1
23648,isst,0,0,1,1
23647,wifetobe,0,0,1,1
23646,القليلة,0,0,1,1
23645,ademen,0,0,1,1
23643,बलात्कार,0,0,1,1
3374,attraversò,1,1,0,1
23641,நுழைந்தால்,0,0,1,1
3375,avvertiti,1,1,0,1
23637,«писатьправить,0,0,1,1
23635,государственную,0,0,1,1
23633,ഇന്റർപീഡിയ,0,0,1,1
23631,materiales,0,0,1,1
23630,boisson,0,0,1,1
23629,arbitraire,0,0,1,1
23627,diyorsun,0,0,1,1
23626,periodicidad,0,0,1,1
23625,spiegelsites,0,0,1,1
23624,irréductibles,0,0,1,1
23623,anthropomorphisme »,0,0,1,1
3379,definitivamente,1,1,0,1
23663,യാന്ത്രികമായാണ്,0,0,1,1
23666,പിന്നിൽ,0,0,1,1
23704,compañero,0,0,1,1
23684,സുഹൃത്തുക്കളോട്,0,0,1,1
23703,atmosphere—within,0,0,1,1
23702,ومتطور,0,0,1,1
23701,затопление,0,0,1,1
23700,убедитесь,0,0,1,1
3372,uragano,1,1,0,1
23698,юнлэ,0,0,1,1
23697,görüşleriniz,0,0,1,1
23695,attitudes,0,0,1,1
23694,reputação,0,0,1,1
23693,പകർത്താൻ,0,0,1,1
23691,ущербной,0,0,1,1
23690,новостях,0,0,1,1
23686,restringidas,0,0,1,1
23685,चाहें,0,0,1,1
23683,മലയാളത്തില്,0,0,1,1
23667,выглядишь,0,0,1,1
23682,منهجية,0,0,1,1
23681,διαφορετικές,0,0,1,1
3373,racchiuderne,1,1,0,1
23679,உபயோகிக்கப்படுகின்றது,0,0,1,1
23677,extremt,0,0,1,1
23676,lagged,0,0,1,1
23675,للقواعد,0,0,1,1
23674,samhället,0,0,1,1
23673,tryckfriheten,0,0,1,1
23672,telephone,0,0,1,1
23671,nomeados,0,0,1,1
23670,blur,0,0,1,1
23669,ಬೆರಳುಗಳ,0,0,1,1
23668,migrés,0,0,1,1
22654,tappar,0,0,1,1
22653,disminuyendo,0,0,1,1
22652,പരിശോധിച്ച,0,0,1,1
21618,podrias,0,0,1,1
21611,பிரச்சினைகள்,0,0,1,1
21612,கொடுமை,0,0,1,1
21613,экспоненциально,0,0,1,1
21614,oposto,0,0,1,1
21616,ಸಂಪತ್ತಿಗೆ,0,0,1,1
21617,teaching,0,0,1,1
21619,kafasına,0,0,1,1
21588,skrevs,0,0,1,1
21622,العلاجات,0,0,1,1
21624,linking,0,0,1,1
21625,situaban,0,0,1,1
3632,viaggiando,1,1,0,1
21629,spite,0,0,1,1
21630,ohyou,0,0,1,1
21610,ರೀತಿಯ,0,0,1,1
21609,vagonun,0,0,1,1
21608,oi,0,0,1,1
21607,öğrenin,0,0,1,1
21606,somado,0,0,1,1
21605,yann,0,0,1,1
21604,дышать,0,0,1,1
21602,vus,0,0,1,1
21600,جاءت,0,0,1,1
21599,halve,0,0,1,1
21598,ಬ್ರೆಡ್ನಿಂದ,0,0,1,1
21597,evermore,0,0,1,1
21596,പിടിച്ചുനിൽക്കാമോ,0,0,1,1
3634,quarto,1,1,0,1
21593,приходите,0,0,1,1
21592,சூழலில்,0,0,1,1
21590,opslagcapaciteit,0,0,1,1
21631,vriendinnen,0,0,1,1
3631,preparata,1,1,0,1
21635,व्यस्तता,0,0,1,1
21662,författares,0,0,1,1
21683,ಮಾಡಬಾರದು,0,0,1,1
21682,ಗೊತ್ತು,0,0,1,1
21679,porção,0,0,1,1
21678,كلهم,0,0,1,1
3626,spallanzani,1,1,0,1
21676,നല്കുന്ന,0,0,1,1
21673,அங்குள்ள,0,0,1,1
21670,abuso,0,0,1,1
21669,"है।
कुछ",0,0,1,1
21668,detenerte,0,0,1,1
21667,ಆಡುಮಾತಿನಂತಿದೆ,0,0,1,1
21666,incubator,0,0,1,1
3629,preparazione,1,1,0,1
21663,izlediyseniz,0,0,1,1
21661,sorvete,0,0,1,1
21636,scale,0,0,1,1
21660,മാറുന്നു,0,0,1,1
21658,ieder,0,0,1,1
21657,sange,0,0,1,1
21655,நாய்,0,0,1,1
21654,देंगे।,0,0,1,1
21652,zus,0,0,1,1
3630,similarità,1,1,0,1
21646,passwort,0,0,1,1
21645,genel,0,0,1,1
21642,πρότασή,0,0,1,1
21641,yunglo,0,0,1,1
21639,ஆக்கங்கள்,0,0,1,1
21638,olanak,0,0,1,1
21637,சொல்லவும்,0,0,1,1
21589,userinterface,0,0,1,1
21587,l’occident,0,0,1,1
21495,fotoğrafları,0,0,1,1
21525,связи,0,0,1,1
21519,आर्टिकल,0,0,1,1
3647,prendo,1,1,0,1
21521,sustenance,0,0,1,1
21522,dreng,0,0,1,1
21523,रिपोजिटरी,0,0,1,1
21524,मीटिंग,0,0,1,1
21526,गहराई,0,0,1,1
21586,αριθμού,0,0,1,1
21527,நிறுவனத்தால்,0,0,1,1
21528,ಸಾಲವಾಗಿ,0,0,1,1
3646,lamentandosi,1,1,0,1
21531,nähe,0,0,1,1
21532,réparation,0,0,1,1
21534,താല്പര്യമുള്ള,0,0,1,1
21518,inadéquation,0,0,1,1
21517,tanışın,0,0,1,1
21515,airspace,0,0,1,1
21514,gedrukt,0,0,1,1
21513,கவனிக்க,0,0,1,1
21511,μοναδική,0,0,1,1
21509,காரணம்,0,0,1,1
21507,ഞങ്ങളുമായി,0,0,1,1
21506,derhen,0,0,1,1
21505,sitter,0,0,1,1
21504,σύνθημα,0,0,1,1
21503,contribuciones,0,0,1,1
21502,egípcio,0,0,1,1
21500,सांख्यिकीय,0,0,1,1
21499,الواردة,0,0,1,1
21498,yenmez,0,0,1,1
21497,शुभकामना,0,0,1,1
21535,endemic,0,0,1,1
21536,nämligen,0,0,1,1
3644,otterresti,1,1,0,1
21564,αχνό,0,0,1,1
21585,frokosten,0,0,1,1
21584,funciones—,0,0,1,1
21583,salle,0,0,1,1
21582,tjek,0,0,1,1
3635,passi,1,1,0,1
21580,quitaría,0,0,1,1
21579,लगाना,0,0,1,1
3636,pronunce,1,1,0,1
21577,விரல்களில்,0,0,1,1
21576,തൽപരരായ,0,0,1,1
21574,«написание,0,0,1,1
21569,பிரஞ்சு,0,0,1,1
3638,adottano,1,1,0,1
21567,yakışıklıydı,0,0,1,1
21561,மொழிகள்,0,0,1,1
21538,золотом,0,0,1,1
21560,homogeneizando,0,0,1,1
21559,இடத்தை,0,0,1,1
21558,ഇബ്സൻ,0,0,1,1
21557,öyle,0,0,1,1
21555,förbryllade,0,0,1,1
21553,फर्स्ट,0,0,1,1
21552,customs,0,0,1,1
21550,അനുവദിക്കുക,0,0,1,1
21546,للبرنامج,0,0,1,1
21545,inclusionism,0,0,1,1
3642,limitate,1,1,0,1
21543,вторичный,0,0,1,1
21542,штата,0,0,1,1
21541,δυστυχισμένο,0,0,1,1
21684,bazıları,0,0,1,1
21685,bulunabilir,0,0,1,1
21687,कोटेशन्स,0,0,1,1
3601,antepongono,1,1,0,1
21809,ಸರಿಯಾಗಿರುತ್ತೇನೆ,0,0,1,1
21812,alberto,0,0,1,1
21816,konsensussökande,0,0,1,1
21817,സ്കൂളിനെ,0,0,1,1
21818,உரிமத்திற்கு,0,0,1,1
21819,εκθέτει,0,0,1,1
21821,huil,0,0,1,1
3623,uichipèdia,1,1,0,1
21823,инициировал,0,0,1,1
21825,suède,0,0,1,1
3600,riservato,1,1,0,1
21829,വിക്കിവിരുദ്ധരെ,0,0,1,1
21831,intensive,0,0,1,1
21832,descartan,0,0,1,1
21808,следующее,0,0,1,1
21807,തീരുമാനിച്ച്,0,0,1,1
21806,சேர்ந்த,0,0,1,1
21805,تثار,0,0,1,1
21804,المجهولين,0,0,1,1
21803,perfection,0,0,1,1
21801,للمنزل؟,0,0,1,1
21800,récit,0,0,1,1
21797,büyütmek,0,0,1,1
21795,played,0,0,1,1
3603,preferibile,1,1,0,1
21792,നൈട്രജൻ,0,0,1,1
21791,divulgada,0,0,1,1
21789,beyler,0,0,1,1
21788,утро,0,0,1,1
21787,collegiale,0,0,1,1
3604,qrpedia,1,1,0,1
21833,voel,0,0,1,1
21835,philosophyak,0,0,1,1
21836,வந்திருந்தார்,0,0,1,1
21858,markant,0,0,1,1
21878,petition,0,0,1,1
21877,farinha,0,0,1,1
21876,artifice,0,0,1,1
21874,skarpaste,0,0,1,1
21873,utility,0,0,1,1
21872,and—most,0,0,1,1
21870,threefold,0,0,1,1
21869,மாற்றம்,0,0,1,1
21868,يستطع,0,0,1,1
21867,ഇവർക്കാണ്,0,0,1,1
21864,книгах,0,0,1,1
21863,konuşabilir,0,0,1,1
21862,замене,0,0,1,1
21859,obtienen,0,0,1,1
21857,progressive,0,0,1,1
21838,break,0,0,1,1
21856,relatada,0,0,1,1
21855,trasfondo,0,0,1,1
21854,вобрал,0,0,1,1
21849,gain,0,0,1,1
3597,sorella,1,1,0,1
21847,cavalgando,0,0,1,1
21846,ostan,0,0,1,1
3598,fukushima,1,1,0,1
21844,newsletters,0,0,1,1
21843,выполнять,0,0,1,1
3599,widrow,1,1,0,1
21841,vittighed,0,0,1,1
21840,днем,0,0,1,1
21839,conjuntos,0,0,1,1
21785,héberger,0,0,1,1
21784,maldonado ,0,0,1,1
21783,ಯು,0,0,1,1
21713,अवार्ड,0,0,1,1
21731,convenues,0,0,1,1
21730,biliyorsanız,0,0,1,1
21729,universitários,0,0,1,1
21728,karşısında,0,0,1,1
3618,edicole,1,1,0,1
21725,bestknown,0,0,1,1
21722,मुख्यधारा,0,0,1,1
21720,submeterse,0,0,1,1
21719,അലസമോ,0,0,1,1
21718,finden,0,0,1,1
21717,gerektiğidir,0,0,1,1
21716,propietario,0,0,1,1
21715,binnenstapte,0,0,1,1
21714,утверждения,0,0,1,1
21712,ajudaria,0,0,1,1
21733,ناطقة,0,0,1,1
3619,banca,1,1,0,1
21708,gelenekleriyle,0,0,1,1
21707, k,0,0,1,1
21704,hemmelighed,0,0,1,1
21703,represalias,0,0,1,1
21700,റഫറൻസ്,0,0,1,1
21699,relatados,0,0,1,1
21698,dudosos,0,0,1,1
3621,preventivo,1,1,0,1
21696,webbversionen,0,0,1,1
21695,பார்வையிட,0,0,1,1
21693,يتزوجني,0,0,1,1
21692,knipogen,0,0,1,1
21691,wells,0,0,1,1
21732,tarif,0,0,1,1
21734,webbvyn,0,0,1,1
21782,onderverdeeld,0,0,1,1
21761,أسباب,0,0,1,1
21781,foresee,0,0,1,1
21780,കുറിക്കാൻ,0,0,1,1
21779,aback,0,0,1,1
3606,aver,1,1,0,1
21775,முறையை,0,0,1,1
21774,കണ്ടതുമുതൽ,0,0,1,1
21773,ladda,0,0,1,1
21772,ചെയ്യപ്പെടുന്നു,0,0,1,1
3608,tenere,1,1,0,1
3612,ipotetico,1,1,0,1
21766,trading,0,0,1,1
21764,nessa,0,0,1,1
21763,svenskt,0,0,1,1
21762,construite,0,0,1,1
21758,automatiserade,0,0,1,1
21735,offres,0,0,1,1
21756,finest,0,0,1,1
21755,yttrandefrihet,0,0,1,1
3615,auto,1,1,0,1
21752,"
सुन्दा",0,0,1,1
21749,geliebt,0,0,1,1
21748,глагольная,0,0,1,1
21747,அவர்களில்,0,0,1,1
21745,taxas,0,0,1,1
3616,riferimenti,1,1,0,1
3617,cresciute,1,1,0,1
21741,ನಮ್ಮೊಂದಿಗೆ,0,0,1,1
21740,downward,0,0,1,1
21737,açlıktan,0,0,1,1
21736,उर्फ,0,0,1,1
21496,ومتوازنًا,0,0,1,1
21492,вопросы,0,0,1,1
21881,celebrates,0,0,1,1
21246,​​beetje,0,0,1,1
21239,yazılmakta,0,0,1,1
3682,successivo,1,1,0,1
21242,motivation,0,0,1,1
21243,seng,0,0,1,1
21244,urging,0,0,1,1
21245,spawned,0,0,1,1
21247,erweitern,0,0,1,1
3683,tarantino,1,1,0,1
21252,fonge,0,0,1,1
21253,samentrekking,0,0,1,1
21254,ए,0,0,1,1
21255,неестественно,0,0,1,1
21257,colores,0,0,1,1
21258,أخطاء,0,0,1,1
21238,ilimitado,0,0,1,1
21237,péréa,0,0,1,1
21236,tradução,0,0,1,1
21234,« créées,0,0,1,1
21232,iyisi,0,0,1,1
21231,экзамене,0,0,1,1
21230,implement,0,0,1,1
21228,сбывается,0,0,1,1
21226,stavet,0,0,1,1
21223,توداي,0,0,1,1
21222,ജീവിതരേഖ,0,0,1,1
21220,vagonla,0,0,1,1
21219,energiedrank,0,0,1,1
21218,തിരുത്തലുകൾക്കൊടുവിൽ,0,0,1,1
21217,"
लिम्बुर्गियाई",0,0,1,1
21216,pourriezvous,0,0,1,1
21215,жестокий,0,0,1,1
21260,veuillez,0,0,1,1
21261,മികച്ചതാണ്,0,0,1,1
21262,заимствовано,0,0,1,1
21287,يبتسم,0,0,1,1
21305,stigmergic,0,0,1,1
21304,lida,0,0,1,1
21303,singular,0,0,1,1
3675,sims,1,1,0,1
21301,permise,0,0,1,1
21300,συμμετέχοντες,0,0,1,1
21299,lanceret,0,0,1,1
3676,dorato,1,1,0,1
21295,தாயும்,0,0,1,1
3677,segnalate,1,1,0,1
21292,passede,0,0,1,1
3678,stanno,1,1,0,1
21290,mera,0,0,1,1
21288,läste,0,0,1,1
21286,குறிப்பிடவில்லை,0,0,1,1
21263,महाकाव्य,0,0,1,1
21283,இருக்கிறாள்,0,0,1,1
21282,एकार्ट,0,0,1,1
21279,lägstanivå,0,0,1,1
21277,ಬಳಸುತ್ತಿತ್ತು,0,0,1,1
3681,tranne,1,1,0,1
21274,பாடல்களில்,0,0,1,1
21273,जाये।,0,0,1,1
21272,discontinued,0,0,1,1
21271,má,0,0,1,1
21270,internetanvändarna,0,0,1,1
21268,день»,0,0,1,1
21267,வெளியிடப்படும்,0,0,1,1
21266,activité,0,0,1,1
21265,commentators,0,0,1,1
21214,russa,0,0,1,1
21211,الشروع,0,0,1,1
21491,dürüst,0,0,1,1
21148,suprême,0,0,1,1
21137,«ссылки,0,0,1,1
3691,porta,1,1,0,1
21139,принес,0,0,1,1
21141,администрированию,0,0,1,1
21146,कामों,0,0,1,1
21147,inclui,0,0,1,1
21149,رفض,0,0,1,1
21210,പ്രണേതാവായ,0,0,1,1
3688,dimensione,1,1,0,1
3687,pamphlet,1,1,0,1
21153,വളർച്ച,0,0,1,1
21155,verdringen,0,0,1,1
21156,fluid,0,0,1,1
21159,സുന്ദരിയായിരുന്നതിനാൽ,0,0,1,1
21136,திருத்தங்களைப்,0,0,1,1
21135,enverrai,0,0,1,1
21132,trubbigt,0,0,1,1
21130,aplicálas,0,0,1,1
21129,ενημέρωσης,0,0,1,1
21127,അപ്പോൾ,0,0,1,1
21125,llama,0,0,1,1
21122,yanar,0,0,1,1
21121,пользоваться,0,0,1,1
21120,rencontrez,0,0,1,1
3692,prevede,1,1,0,1
21118,slutgiltig,0,0,1,1
3693,episodi,1,1,0,1
21116,சகோதரத்,0,0,1,1
21113,tonu,0,0,1,1
21111,metal,0,0,1,1
3695,settimo,1,1,0,1
21161,​​​​,0,0,1,1
21163,tendrás,0,0,1,1
21164,challenge,0,0,1,1
21190,parodiadas,0,0,1,1
21208,ಹುಡುಗರನ್ನು,0,0,1,1
21206,högtalarikon,0,0,1,1
21205,μεγάλο,0,0,1,1
21203,മാജിക്,0,0,1,1
21202,മിനുസമുള്ളതുമാണ്,0,0,1,1
3685,accurata,1,1,0,1
21200,heterotrophic,0,0,1,1
21199,പുഞ്ചിരിക്കാനും,0,0,1,1
21198,upptäcktes,0,0,1,1
21197,​​dette,0,0,1,1
21196,ಟಾಪ್,0,0,1,1
21194,bulunabilmesi,0,0,1,1
21193,dvdwikimediaorg,0,0,1,1
21191,मैनर्स,0,0,1,1
21188,tartışmanın,0,0,1,1
21165,നേരത്തെ,0,0,1,1
21187,തടയുന്നില്ല,0,0,1,1
21186,കൊണ്ടുവന്നിട്ടുണ്ട്,0,0,1,1
21185,индексации,0,0,1,1
21182,клетками,0,0,1,1
21181,போவது,0,0,1,1
21180,pace,0,0,1,1
21179,admites,0,0,1,1
21178,بلغ,0,0,1,1
21177,владимир,0,0,1,1
21174,اختصار,0,0,1,1
21173,télévisée,0,0,1,1
21170,milhares,0,0,1,1
21169,நண்பனைப்,0,0,1,1
21166,approfondie,0,0,1,1
21307,навестить,0,0,1,1
21309,विध्वंसप्रवण,0,0,1,1
21310,എല്ലാവരികൾക്കും,0,0,1,1
21440,“illegal,0,0,1,1
21429,soruyorsun,0,0,1,1
21430,hospedagem,0,0,1,1
21432,обозначает,0,0,1,1
21436,وجه,0,0,1,1
21437,പരാതിപ്പെടാൻ,0,0,1,1
21439,problematic,0,0,1,1
21443,definirse,0,0,1,1
21313,onaylamadıkları,0,0,1,1
3657,avveri,1,1,0,1
21445,استمع,0,0,1,1
21447,χαμογελούν,0,0,1,1
21448,aplicado,0,0,1,1
21449,வலைப்பக்க,0,0,1,1
21450,المتضاربين،,0,0,1,1
21427,plazo,0,0,1,1
21426,മുങ്ങാം,0,0,1,1
21425,weiteren,0,0,1,1
21424,scientist,0,0,1,1
21423,ക്ഷീണം,0,0,1,1
21422,grise,0,0,1,1
21421,decidir,0,0,1,1
21420,destinados,0,0,1,1
21418,registados,0,0,1,1
21417,escuchar,0,0,1,1
21416,بنظام,0,0,1,1
21415,amper,0,0,1,1
21414,ಮಾತನಾಡುವ,0,0,1,1
21413,успеха,0,0,1,1
21412,confuse,0,0,1,1
21411,perceptibles,0,0,1,1
21408,بل,0,0,1,1
21451,starka,0,0,1,1
21452,ಕರೆ,0,0,1,1
21454,وكنت,0,0,1,1
21476,വിക്കിപീഡിയരിൽ,0,0,1,1
21490,онлайнпроекта,0,0,1,1
21489,robot—,0,0,1,1
21488,başkalarına,0,0,1,1
21487,വിശ്വാസയോഗ്യമായ,0,0,1,1
21486,rigtighed,0,0,1,1
21485,square,0,0,1,1
21484,goldman,0,0,1,1
21483,இணையத்தளங்களின்,0,0,1,1
21482,parliamentary,0,0,1,1
21481,sorrisos,0,0,1,1
21480,истинность»,0,0,1,1
21479,മേഖലകളുണ്ട്,0,0,1,1
3652,chiedevo,1,1,0,1
21477,siffror,0,0,1,1
21474,ഇല്ലഅവലംബം,0,0,1,1
21455,chimiste,0,0,1,1
21473,verrait,0,0,1,1
21472,ontwikkeld,0,0,1,1
3653,conosco,1,1,0,1
21468,मुस्कुरा,0,0,1,1
21467,storbritannien,0,0,1,1
21466,τρως,0,0,1,1
21464,"
todos",0,0,1,1
21463,некоммерческим,0,0,1,1
21462,akademisk,0,0,1,1
21461,gratulieren,0,0,1,1
21460,وتحاول,0,0,1,1
21459,дорогой,0,0,1,1
3656,esservi,1,1,0,1
21456,valg,0,0,1,1
21407,indrømmer,0,0,1,1
21405,probabilities,0,0,1,1
3659,conduca,1,1,0,1
21333,ويكيبيديين,0,0,1,1
3670,colloquio,1,1,0,1
21347,spanska,0,0,1,1
21346,മനുഷ്യർക്കിടയിൽ,0,0,1,1
21344,voormalig,0,0,1,1
21343,geçmeniz,0,0,1,1
21342,rönt,0,0,1,1
21341,आंकडा,0,0,1,1
21340,пополнит,0,0,1,1
3671,veramente,1,1,0,1
21338,νωθρός,0,0,1,1
21337,வெளியிடப்பட்டு,0,0,1,1
21336,способствовало,0,0,1,1
21335,استقرارا,0,0,1,1
21334,நிபுணர்களால்,0,0,1,1
21332,principen,0,0,1,1
21351,«central»,0,0,1,1
21331,αισθάνεστε,0,0,1,1
21330,slogan ,0,0,1,1
21329,accounts,0,0,1,1
21327,eventually,0,0,1,1
21325,கட்டமைப்பும்,0,0,1,1
21324,toepassing,0,0,1,1
21323,компаниявладелец,0,0,1,1
21322,അർത്ഥമില്ലാത്ത,0,0,1,1
3672,mandargli,1,1,0,1
21320,നടത്തുന്നതിൽ,0,0,1,1
21319,nudity,0,0,1,1
21318,ചോദ്യത്തിന്,0,0,1,1
21315,ifadenin,0,0,1,1
3673,wikiˈpɛdja,1,1,0,1
21349,प्रश्नों,0,0,1,1
21352,sparqlen,0,0,1,1
21402,afi,0,0,1,1
3665,vorresti,1,1,0,1
21401,المرآة,0,0,1,1
21400,actuales,0,0,1,1
21399,pasas,0,0,1,1
21398,ആളുകളുടെ,0,0,1,1
21396,webportaal,0,0,1,1
21395,uncorrected,0,0,1,1
21393,pourrez,0,0,1,1
21392,paciência,0,0,1,1
21391,union,0,0,1,1
21388,sencillez,0,0,1,1
21387,झटके,0,0,1,1
21386,tolke,0,0,1,1
21385,кофе,0,0,1,1
21384,implementatie,0,0,1,1
21377,spirit,0,0,1,1
21353,χίλια,0,0,1,1
21376,разумность,0,0,1,1
21375,ряда,0,0,1,1
21374,interromper,0,0,1,1
21371,घंटी,0,0,1,1
21369,വിക്കിപീഡിയരുണ്ട്,0,0,1,1
21367,cent,0,0,1,1
21366,تقاس,0,0,1,1
21365,grundtanken,0,0,1,1
21364,रही।,0,0,1,1
21363,kokulu,0,0,1,1
21359,ರೂಪಿಸುತ್ತಿದ್ದೇನೆ,0,0,1,1
3667,gofai,1,1,0,1
21356,argumenta,0,0,1,1
21354,некоторыми,0,0,1,1
21880,d’enseignement ,0,0,1,1
21882,pés,0,0,1,1
22651,ತೋಟದಲ್ಲಿ,0,0,1,1
22390,ومنشورات,0,0,1,1
22380,கேட்கக்கூடிய,0,0,1,1
22381,oriental,0,0,1,1
22382,exposer,0,0,1,1
22383,സമ്പൂർണ്ണലേഖനം,0,0,1,1
22388,അസന്തുഷ്ടിയും,0,0,1,1
22389,tradutores,0,0,1,1
22391,adequadamente,0,0,1,1
22353,opretholde,0,0,1,1
22393,заболоченный,0,0,1,1
22395,दुविधा,0,0,1,1
22396,humanisme,0,0,1,1
22397,owe,0,0,1,1
22398,त्रुटियों,0,0,1,1
22399,फ्रांसिस्को,0,0,1,1
22379,சார்,0,0,1,1
22378,interrupt,0,0,1,1
22376,അർത്ഥമാണ്,0,0,1,1
22375,verrichten,0,0,1,1
22374,byen,0,0,1,1
22373,быстрые,0,0,1,1
22372,പ്രമുഖരുടെ,0,0,1,1
22371,الحادثة،,0,0,1,1
22370,вносимые,0,0,1,1
22366,मानचित्र,0,0,1,1
22365,മാതൃകയിൽപ്പോലും,0,0,1,1
22364,lançamento,0,0,1,1
3534,sufficiente,1,1,0,1
22361,inseriu,0,0,1,1
22359,discordo,0,0,1,1
22358,penses,0,0,1,1
22357,saxe,0,0,1,1
22400,corrió,0,0,1,1
22401,scales,0,0,1,1
22405,massornas,0,0,1,1
22430,specify,0,0,1,1
22450,പ്രവർത്തിക്കുന്നുണ്ടെങ്കിൽ,0,0,1,1
22449,março,0,0,1,1
22444,ತರುತ್ತೇನೆ,0,0,1,1
22443,breathe,0,0,1,1
22442,deixálos,0,0,1,1
22441,goldgoldenem,0,0,1,1
22440,contestada,0,0,1,1
22439,tillhör,0,0,1,1
22438,aprendan,0,0,1,1
22437,നിസ്സാരനായിരിക്കാം,0,0,1,1
22435,cobrir,0,0,1,1
22434,வாதங்களையும்,0,0,1,1
22433,ഭാര്യയായിരിക്കേണ്ട,0,0,1,1
22432,archive,0,0,1,1
3527,occhiata,1,1,0,1
3532,commenti,1,1,0,1
22426,difundiendo,0,0,1,1
22425,rough,0,0,1,1
22423,grof,0,0,1,1
3529,sostenuta,1,1,0,1
22421,είμαστε,0,0,1,1
22420,பெறுகிறேன்,0,0,1,1
3530,francesi,1,1,0,1
22417,أكله,0,0,1,1
22416,législateur,0,0,1,1
22415,maitrise,0,0,1,1
22412,الشكوك,0,0,1,1
22411,أوصلك,0,0,1,1
22410,immangeable,0,0,1,1
22408,arkadaşlarınızdan,0,0,1,1
22354,birçoğunu,0,0,1,1
22352,அனுமதி,0,0,1,1
22259,разработанная,0,0,1,1
3545,berkeley,1,1,0,1
22282,høre,0,0,1,1
22284,கலைக்களஞ்சியங்களைப்,0,0,1,1
22286,beds,0,0,1,1
22290,ஆள்களப்,0,0,1,1
3547,legate,1,1,0,1
3546,riesco,1,1,0,1
22294,векторы,0,0,1,1
22351,السبب,0,0,1,1
22295,—mediante,0,0,1,1
22296,έστειλε,0,0,1,1
22297,onmogelijke,0,0,1,1
22298,bulunmamaktadır,0,0,1,1
3543,basare,1,1,0,1
22300,écritures,0,0,1,1
22281,editörü,0,0,1,1
22280,താഴേയ്‌ക്ക്,0,0,1,1
22279,overturned,0,0,1,1
3548,formasse,1,1,0,1
22276,military,0,0,1,1
22274,അതത്,0,0,1,1
22273,cravejada,0,0,1,1
22272,gefangen,0,0,1,1
22271,baseret,0,0,1,1
22270,வேகமாக,0,0,1,1
22269,хлебом,0,0,1,1
22268,λέγω,0,0,1,1
22267,tese,0,0,1,1
22266,lointain,0,0,1,1
22263,കണ്ണാടിയിലോ,0,0,1,1
22262,inferences,0,0,1,1
22261,francepresse,0,0,1,1
22302,assignment,0,0,1,1
22305,tonfalls,0,0,1,1
22306,soep,0,0,1,1
22329,миллион,0,0,1,1
22350,следовали,0,0,1,1
22346,ಕೋನವಾಗಿದೆ,0,0,1,1
22343,சுட,0,0,1,1
22342,yemelisin,0,0,1,1
22341,périodes,0,0,1,1
22340,possuíam,0,0,1,1
22339,ಪ್ರತಿಕ್ರಿಯೆಯೊಂದಿಗೆ,0,0,1,1
3538,completa,1,1,0,1
22337,يسألك,0,0,1,1
22336,« dépassé,0,0,1,1
22335,velho,0,0,1,1
22334,migration,0,0,1,1
22331,narciss,0,0,1,1
3539,trattavi,1,1,0,1
22328,பரிசைக்,0,0,1,1
22307,إيجابيًا,0,0,1,1
22327,irresponsible,0,0,1,1
22325,دروسي,0,0,1,1
22324,كمقالات,0,0,1,1
22322,additions,0,0,1,1
22321,geïntensiveerd,0,0,1,1
22320,നാല്പത്തഞ്ച്,0,0,1,1
22318,ಫಿಕ್ಸ್,0,0,1,1
22316,visent,0,0,1,1
22315,ഉപയോഗശൂന്യമായിരുന്നു,0,0,1,1
22314,серьёзных,0,0,1,1
22313,لتهنئة,0,0,1,1
22312,bahsederken,0,0,1,1
22311,brødbrød,0,0,1,1
22310,vivent,0,0,1,1
22451,cruels,0,0,1,1
22454,ನೋಡಲು,0,0,1,1
22456,determinar,0,0,1,1
22587,ഇതൊരു,0,0,1,1
3513,fondatori,1,1,0,1
22580,parmakları,0,0,1,1
22582,deciden,0,0,1,1
22583,biographical,0,0,1,1
22584,izleyebilirler,0,0,1,1
22586,semestermånader,0,0,1,1
3511,umida,1,1,0,1
22457,spiegel,0,0,1,1
3510,adorabili,1,1,0,1
3509,trattate,1,1,0,1
3508,simboleggiare,1,1,0,1
22595,utvecklad,0,0,1,1
22598,dammit,0,0,1,1
22599,ماي,0,0,1,1
22577,basisgroeten,0,0,1,1
22576,préadolescente,0,0,1,1
22574,cuides,0,0,1,1
22573,yalan,0,0,1,1
22572,distribute,0,0,1,1
22571,вошли,0,0,1,1
22570,பாடத்தில்,0,0,1,1
22567,популярным,0,0,1,1
22566,roumain,0,0,1,1
22565,ಟೀಕಿಸಿ,0,0,1,1
22564,fiscale,0,0,1,1
22562,entourent,0,0,1,1
22561,άγγελος,0,0,1,1
22560,تتزوجني,0,0,1,1
22557,താഴെയുമാണ്,0,0,1,1
22556,امتحان,0,0,1,1
22555,fødder,0,0,1,1
22601,plaignants,0,0,1,1
22602,துல்லியமின்மை,0,0,1,1
22605,φόρμας,0,0,1,1
3503,adatta,1,1,0,1
22649,suavizando,0,0,1,1
3501,presenziare,1,1,0,1
22647,respond,0,0,1,1
22646,kullandığında,0,0,1,1
22644,déisme ,0,0,1,1
22643,assimilable,0,0,1,1
22642,traduit,0,0,1,1
22641,уровне,0,0,1,1
22640,മറ്റേയാൾ,0,0,1,1
22639,kurier,0,0,1,1
22638,вышедших,0,0,1,1
3502,fissavano,1,1,0,1
22636,чей,0,0,1,1
22635,"
alemão",0,0,1,1
22632,दोहराएंगे,0,0,1,1
22607,pannotia,0,0,1,1
22631,внезапно,0,0,1,1
22628,اعتمادها,0,0,1,1
22627,пожелать,0,0,1,1
22626,எப்போதுமே,0,0,1,1
22623,ദുഷ്പ്രവൃത്തി,0,0,1,1
22621,обед,0,0,1,1
22620,married,0,0,1,1
22619,எழுத்துப்பிழைகளைத்,0,0,1,1
22616,எனக்,0,0,1,1
22614,ориентирован,0,0,1,1
22613,karaktäriseras,0,0,1,1
22611,petición,0,0,1,1
22610,നിന്നുള്ള,0,0,1,1
22609,ಮಾಡಬೇಕಾಗಿದೆ,0,0,1,1
22554,robôs,0,0,1,1
22553,nærmede,0,0,1,1
3515,elettronica,1,1,0,1
22481,bakken,0,0,1,1
22502,promu,0,0,1,1
22501,informaticien,0,0,1,1
22499,пиццы,0,0,1,1
22497,officially,0,0,1,1
22495,skyldiga,0,0,1,1
22494,wereldoorlog,0,0,1,1
22492,webbliknande,0,0,1,1
22490,ಪದದಿಂದ,0,0,1,1
22489,heurística,0,0,1,1
22488,terço,0,0,1,1
22487,identidad,0,0,1,1
22485,hoes,0,0,1,1
22483,posse,0,0,1,1
22482,pnb •,0,0,1,1
22479,discouraged,0,0,1,1
22505,സന്തോഷവാനാണ്,0,0,1,1
22478,tabulated,0,0,1,1
22477,preocupação,0,0,1,1
3519,distribuibile,1,1,0,1
22475,കാഴ്ചപ്പാടുകളെ,0,0,1,1
22472,πηγή,0,0,1,1
22470,novio,0,0,1,1
22466,"
पैन्सिलवेनियाई",0,0,1,1
22464,uppfarten,0,0,1,1
22463,βοηθούσες,0,0,1,1
22462,carona,0,0,1,1
22461,ويبكي,0,0,1,1
22460,vigtigste,0,0,1,1
22459,consommation,0,0,1,1
3525,semisupervisionato,1,1,0,1
22503,воплощение,0,0,1,1
22507,interrogation,0,0,1,1
22551,правка,0,0,1,1
22532,ഒന്ന്,0,0,1,1
22548,küçücük,0,0,1,1
22547, milhões,0,0,1,1
22546,klass,0,0,1,1
22545,haus,0,0,1,1
22544,своим,0,0,1,1
22543,woordgroepen,0,0,1,1
22542,பொம்மை,0,0,1,1
22541,horrific,0,0,1,1
22538,beskrivande,0,0,1,1
22537,attracts,0,0,1,1
22536,ಕೇಳದಿದ್ದಾಗ,0,0,1,1
22535,lister,0,0,1,1
22534,дедуктивное,0,0,1,1
22533,версию,0,0,1,1
22530,слизняк,0,0,1,1
22509,двойных,0,0,1,1
22528,മകൾ,0,0,1,1
22526,разрешён,0,0,1,1
22525,അമർത്തിക്കൊണ്ട്,0,0,1,1
22524,damen,0,0,1,1
22522,فربما,0,0,1,1
22521,uğramasını,0,0,1,1
22519,çeviri,0,0,1,1
22518,тема,0,0,1,1
22517,адекватному,0,0,1,1
22514,performansı,0,0,1,1
22513,общенаучных,0,0,1,1
22512,editorial​​,0,0,1,1
22511,അതിനുപകരം,0,0,1,1
22510,பயனாளிகள்,0,0,1,1
22260,скопировать,0,0,1,1
22258,infinito,0,0,1,1
21884,infinie,0,0,1,1
22016,மாற்றங்களுக்கான,0,0,1,1
22009,touristique,0,0,1,1
22010,phpвикидвижке,0,0,1,1
22011,कोरिया,0,0,1,1
22013,يستخدمون,0,0,1,1
22014,rubinen,0,0,1,1
22015,donzelas,0,0,1,1
22017,recourir,0,0,1,1
21984,banned,0,0,1,1
22018,статистическим,0,0,1,1
22019,планов,0,0,1,1
22020,ongewild,0,0,1,1
22021,فامنحه,0,0,1,1
22022,winkten,0,0,1,1
22023,relecture,0,0,1,1
22008,предсказывать,0,0,1,1
22007,वीलेन,0,0,1,1
22006,поставив,0,0,1,1
22004,ciencias,0,0,1,1
22003,أخيرًا،,0,0,1,1
22001,“பல்நிலை,0,0,1,1
22000,المضحك,0,0,1,1
21999,ah,0,0,1,1
21998,meddelelse,0,0,1,1
21997,egyptian,0,0,1,1
21996,párrafo,0,0,1,1
21995,sevimlisin,0,0,1,1
21994,നീക്കം,0,0,1,1
21993,ಚೆನ್ನಾಗಿರುತ್ತೇನೆ,0,0,1,1
21991,posicionó,0,0,1,1
21990,broadcast,0,0,1,1
21988,ಪ್ರಾಣಿ,0,0,1,1
22024,допустил,0,0,1,1
22025,ഘട്ടത്തിൽ,0,0,1,1
22026,deserved,0,0,1,1
22050,permitidas,0,0,1,1
22069,burnu,0,0,1,1
22068,présentait,0,0,1,1
3572,inevitabile,1,1,0,1
22065,नाय्नोर्स्क,0,0,1,1
22064,voici,0,0,1,1
22061,kullanılarak,0,0,1,1
22059,حار,0,0,1,1
22058,teklif,0,0,1,1
22057,പാസ്‌വേഡ്,0,0,1,1
22056,உருவாக்கியிருப்பர்,0,0,1,1
22055,« bots »,0,0,1,1
22054,कहीं,0,0,1,1
22053,வரிசை’யில்,0,0,1,1
22052,"

",0,0,1,1
22049,സന്തോഷമായിരിക്കാനും,0,0,1,1
3579,spontaneamente,1,1,0,1
22048,smelly,0,0,1,1
22047,дитя,0,0,1,1
22046,என்சைக்ளோபீடியாவிலிருந்து,0,0,1,1
22045,असंगत,0,0,1,1
22044,തനതുവ്യക്തിത്വമുള്ള,0,0,1,1
22043,официальной,0,0,1,1
22040,примечательно,0,0,1,1
22038,multinacionales,0,0,1,1
22036,bezaaid,0,0,1,1
22034,έλα,0,0,1,1
22033,zangado,0,0,1,1
22030,placed,0,0,1,1
22029,avançados,0,0,1,1
22028,سفراء,0,0,1,1
21987,recusado,0,0,1,1
21983,جوجل,0,0,1,1
22257,hyldede,0,0,1,1
21920,വിചാരിച്ചു,0,0,1,1
21911,gulfs,0,0,1,1
21912,arbetssättet,0,0,1,1
21915,வழிமுறைகளைப்,0,0,1,1
21917,şatodan,0,0,1,1
21918,uitgeroepen,0,0,1,1
21919,"हैं।
विशेष",0,0,1,1
21922,مصدري,0,0,1,1
21982,стран,0,0,1,1
21923,καταλάβω,0,0,1,1
21924,बाढ़,0,0,1,1
21925,قضمة,0,0,1,1
21926,behandlede,0,0,1,1
21927,faktarutor,0,0,1,1
21928,wedding,0,0,1,1
21909,погружение,0,0,1,1
21908,erkennen,0,0,1,1
3589,manipolare,1,1,0,1
21905,मैली,0,0,1,1
21903,لاستخدام,0,0,1,1
3590,vicino,1,1,0,1
21900,nieste,0,0,1,1
21899,manquant,0,0,1,1
21898,réunis,0,0,1,1
21897,ഉറപ്പാക്കപ്പെടുന്നത്‌,0,0,1,1
21896,அனைவரையும்,0,0,1,1
3591,meraviglioso,1,1,0,1
3592,compact,1,1,0,1
21892,syrie,0,0,1,1
21890,പരസ്പരബന്ധമില്ലാത്ത,0,0,1,1
3594,brossura,1,1,0,1
3595,lineare,1,1,0,1
21930,geduld,0,0,1,1
21932,ಆಸಕ್ತಿಯಿಲ್ಲ,0,0,1,1
21933,enregistrées,0,0,1,1
21958,bulmuştur,0,0,1,1
21980,நபர்,0,0,1,1
21977,ಹಿಸಿದರೂ,0,0,1,1
21975,оказаться,0,0,1,1
21974,«истина,0,0,1,1
21973,semelhanças,0,0,1,1
21970,conséquent,0,0,1,1
21969,aclamados,0,0,1,1
21968,possíveis,0,0,1,1
21967,barely,0,0,1,1
21965,മാറ്റുക,0,0,1,1
3580,perde,1,1,0,1
21962,apresentados,0,0,1,1
21961,बताओ,0,0,1,1
21960,готовы,0,0,1,1
21957,தொடங்க,0,0,1,1
21934,анализа,0,0,1,1
21954,ಫಿಕ್ಸ್‌ನಲ್ಲಿದ್ದೀರಿ,0,0,1,1
21952,kingdom,0,0,1,1
21951,rejeitando,0,0,1,1
21950,блюд,0,0,1,1
21949,reeditado,0,0,1,1
21948,நாளைக்கு,0,0,1,1
21947,കേൾക്കാതെ,0,0,1,1
3582,concentrando,1,1,0,1
21941,നൽകാം,0,0,1,1
3583,selezionate,1,1,0,1
21938,ലേഖകരും,0,0,1,1
21937,понятия,0,0,1,1
21936,liever,0,0,1,1
21935,اختلاف,0,0,1,1
22071,पत्रकारों,0,0,1,1
22072,hogere,0,0,1,1
22073,girişi,0,0,1,1
22197,revolución,0,0,1,1
22186,kontroversiell,0,0,1,1
22187,сложно,0,0,1,1
22188,fingern,0,0,1,1
22189,loin,0,0,1,1
3555,indiano,1,1,0,1
22196,прекрасных,0,0,1,1
22198,σκληροί,0,0,1,1
22074,ضد,0,0,1,1
22199,ഉപയോക്താക്കളും,0,0,1,1
22200,sveriges,0,0,1,1
22202,éditoriaux,0,0,1,1
22203,débuts,0,0,1,1
22204,imposible,0,0,1,1
22205,rörde,0,0,1,1
22184,பெண்கள்,0,0,1,1
22183,नगरीय,0,0,1,1
22182,теме»,0,0,1,1
22181,knop,0,0,1,1
22180,مضى,0,0,1,1
3556,palazzo,1,1,0,1
22178,anlamamı,0,0,1,1
22177,"
चैचन",0,0,1,1
22175,ولكي,0,0,1,1
22173,अनुवाद,0,0,1,1
22172,anlatsaydı,0,0,1,1
3557,utilizzare,1,1,0,1
22169,تملي,0,0,1,1
22167,٬٬,0,0,1,1
22166,нос,0,0,1,1
22165,കഷ്ണം,0,0,1,1
22164,октябрю,0,0,1,1
22206,usamos,0,0,1,1
22207,yeterince,0,0,1,1
22208,حافلتنا,0,0,1,1
22235,reliance,0,0,1,1
3551,riassunte,1,1,0,1
22250,reutilizar,0,0,1,1
22249,இருந்திருந்தால்,0,0,1,1
22247,gleich,0,0,1,1
22246,pronouncing,0,0,1,1
22245,ಡ್ರೈವಾಲ್,0,0,1,1
22244,வெள்ளம்,0,0,1,1
22243,parlementaires,0,0,1,1
3552,corpi,1,1,0,1
22241,universitario,0,0,1,1
22240,sou,0,0,1,1
22239,garagem,0,0,1,1
3553,immagina,1,1,0,1
22236,пообщаться,0,0,1,1
22233,coordinación,0,0,1,1
22209,предназначенная,0,0,1,1
22231,zil,0,0,1,1
22230,majorité,0,0,1,1
22229,permitiendo,0,0,1,1
3554,individuare,1,1,0,1
22226,significativos,0,0,1,1
22225,sängmamma,0,0,1,1
22224,matematiska,0,0,1,1
22223,வேலையும்,0,0,1,1
22221,sanmıyorum,0,0,1,1
22220,ಒಳ್ಳೆಯವರಾಗಿದ್ದರು,0,0,1,1
22215,acusála,0,0,1,1
22214,हेलर,0,0,1,1
22212,വഴിക്കുള്ള,0,0,1,1
22210,βικιφθέγματα,0,0,1,1
22163,വസ്ത്രം,0,0,1,1
22162,neutres,0,0,1,1
22161,kullanmıyorsunuz,0,0,1,1
22093,كذلك؟,0,0,1,1
22114,marcando,0,0,1,1
22113,ಹೇಳಿದಾಗ,0,0,1,1
22112,begrijpen,0,0,1,1
22108,الصباح,0,0,1,1
3564,sconcertata,1,1,0,1
22106,верификации,0,0,1,1
22105,பெறும்,0,0,1,1
22104,исследователь,0,0,1,1
22103,utilizando,0,0,1,1
3565,basti,1,1,0,1
22099,bibliothèques,0,0,1,1
22098,mau,0,0,1,1
22096,मूल्य,0,0,1,1
22094,dokümanların,0,0,1,1
22092,persa,0,0,1,1
22116,beiden,0,0,1,1
22090,أساسي,0,0,1,1
22089,الأحياء,0,0,1,1
22088,helft,0,0,1,1
22086,бриллиантами,0,0,1,1
3566,uichipìdia,1,1,0,1
22084,caída,0,0,1,1
22083,внесённые,0,0,1,1
22082,கண்டறியப்பட்டது,0,0,1,1
22081,நடவு,0,0,1,1
22080,أصليًا,0,0,1,1
3567,utilizzo,1,1,0,1
22078,artful,0,0,1,1
3568,consulente,1,1,0,1
3571,visitano,1,1,0,1
22115,لبعض,0,0,1,1
22117,أنهم,0,0,1,1
22160,nesta,0,0,1,1
22139,золотым,0,0,1,1
22159,मूलभूत,0,0,1,1
22158,வெளிப்படையான,0,0,1,1
3558,lucio,1,1,0,1
22153,xviiie siècles,0,0,1,1
22152,amoreel,0,0,1,1
22151,രാജകുമാരനെയോ,0,0,1,1
22150,"ഒരു
വീട്ടമ്മ",0,0,1,1
22149,accordait,0,0,1,1
22147,الفكرية,0,0,1,1
22145,spelkonsoler,0,0,1,1
22144,അമ്മയെക്കുറിച്ച്,0,0,1,1
22142,hiperligações,0,0,1,1
22141,കൂടാതെ,0,0,1,1
22140,ஆச்சரியமான,0,0,1,1
22138,συναντάς,0,0,1,1
3563,curati,1,1,0,1
22137,miroitements,0,0,1,1
22136,comente,0,0,1,1
22135,வைக்கிறது,0,0,1,1
22134,exhibit,0,0,1,1
3561,obbligatoria,1,1,0,1
22131,polegar,0,0,1,1
22129,réponses,0,0,1,1
22128,धीमी,0,0,1,1
3562,diagnosi,1,1,0,1
22126,proprietary,0,0,1,1
22124,lua,0,0,1,1
22123,vies,0,0,1,1
22121,geçip,0,0,1,1
22120,gubernamentales,0,0,1,1
47909,aconsejando,0,0,1,1
