,Word,where,Count_ita,Count_other,Total_count
17469,de,0,0,3480,3480
0,,2,135,1953,2088
2932,a,2,198,1670,1868
619,the,2,4,1605,1609
32989,en,0,0,1514,1514
2326,la,2,243,1213,1456
13073,que,0,0,1287,1287
1863,in,2,281,943,1224
2456,of,2,3,1125,1128
1827,and,2,2,844,846
2778,wikipedia,2,132,689,821
12945,du,0,0,802,802
1395,e,2,372,406,778
2677,to,2,1,753,754
1449,un,2,228,515,743
2709,di,1,679,0,679
2618,i,2,93,558,651
3270,le,2,145,471,616
695,o,2,106,500,606
7983,et,0,0,582,582
34999,के,0,0,563,563
18795,is,0,0,542,542
23761,je,0,0,502,502
703,se,2,87,408,495
36954,à,0,0,472,472
34148,att,0,0,435,435
2339,da,2,114,310,424
20842,y,0,0,415,415
47945,por,0,0,409,409
47359,des,0,0,406,406
32406,में,0,0,395,395
41383,that,0,0,389,389
38794,les,0,0,388,388
7529,в,0,0,386,386
27115,det,0,0,385,385
43699,el,0,0,385,385
37298,wikipédia,0,0,385,385
20426,och,0,0,384,384
1915,no,2,12,345,357
41672,for,0,0,353,353
20706,as,0,0,351,351
39782,है,0,0,342,342
41802,para,0,0,337,337
2194,una,2,146,186,332
4403,som,0,0,325,325
2790,che,1,325,0,325
1249,you,2,1,313,314
39323,em,0,0,313,313
13313,और,0,0,313,313
1460,il,2,226,84,310
34759,at,0,0,308,308
15192,في,0,0,300,300
17468,kan,0,0,297,297
21232,и,0,0,296,296
47033,er,0,0,295,295
13424,να,0,0,292,292
25215,är,0,0,284,284
46918,es,0,0,282,282
49240,het,0,0,277,277
13404,vous,0,0,268,268
33648,um,0,0,263,263
18345,एक,0,0,262,262
2008,.,2,17,244,261
27645,på,0,0,259,259
5556,من,0,0,259,259
42522,om,0,0,256,256
44237,est,0,0,254,254
26534,como,0,0,254,254
34660,was,0,0,253,253
3855,è,1,252,0,252
4797,को,0,0,251,251
48638,une,0,0,249,249
3478,on,2,1,248,249
30779,você,0,0,247,247
50925,،,0,0,246,246
44487,ou,0,0,246,246
4765,dans,0,0,246,246
45381,कि,0,0,244,244
37538,een,0,0,244,244
16280,har,0,0,243,243
6524,sie,0,0,238,238
489,si,2,66,170,236
46998,से,0,0,233,233
33590,हैं,0,0,228,228
49375,los,0,0,223,223
7525,par,0,0,217,217
1308,non,2,188,23,211
29047,van,0,0,211,211
30908,bir,0,0,210,210
13871,ನೀವು,0,0,210,210
530,con,2,85,125,210
7823,are,0,0,208,208
43613,av,0,0,204,204
29407,jag,0,0,203,203
2193,nature,2,10,193,203
2517,te,2,18,182,200
31107,ik,0,0,197,197
16541,आप,0,0,197,197
2420,del,2,83,114,197
38106,og,0,0,196,196
5214,jeg,0,0,195,195
40648,uma,0,0,195,195
39434,και,0,0,194,194
3048,per,2,179,15,194
4170,do,2,1,193,194
41805,by,0,0,193,193
7084,den,0,0,192,192
43273,dat,0,0,190,190
12275,ich,0,0,190,190
44618,ve,0,0,189,189
30935,não,0,0,189,189
30151,की,0,0,188,188
14568,or,0,0,186,186
3322,w,2,1,184,185
34925,है।,0,0,185,185
2538,qui,2,13,172,185
50929,med,0,0,183,183
18641, ·,0,0,182,182
47139,நீங்கள்,0,0,182,182
24381,что,0,0,174,174
16545,लिए,0,0,173,173
30634,with,0,0,171,171
32240,το,0,0,170,170
31222,विकिपीडिया,0,0,169,169
20519,أن,0,0,169,169
775,me,2,8,161,169
42968,pour,0,0,167,167
1871,an,2,1,166,167
22016,не,0,0,167,167
628,learning,2,2,164,166
2951,su,2,61,104,165
47432,för,0,0,165,165
50715,é,0,0,162,162
41225,ನಾನು,0,0,162,162
25862,it,0,0,162,162
47676,pas,0,0,161,161
20153,का,0,0,157,157
1732,ne,2,21,136,157
47136,я,0,0,155,155
33803,على,0,0,155,155
36186,så,0,0,153,153
37985,вы,0,0,152,152
48994,var,0,0,150,150
5009,यह,0,0,150,150
1030,wikimedia,2,12,137,149
26428,dig,0,0,149,149
32168,be,0,0,149,149
43939,नहीं,0,0,149,149
45022,from,0,0,149,149
34847,நான்,0,0,149,149
35322,на,0,0,149,149
20351,can,0,0,148,148
16745,und,0,0,148,148
9995,ಮತ್ತು,0,0,146,146
21418,sur,0,0,146,146
32090,inte,0,0,145,145
3769,lo,2,35,110,145
654,sono,2,144,1,145
28021,have,0,0,143,143
44117,die,0,0,142,142
51734,las,0,0,142,142
5288,mais,0,0,140,140
13021,ഒരു,0,0,138,138
46023,com,0,0,137,137
2069,ce,2,1,135,136
17703,os,0,0,130,130
2200,narcisa,2,13,117,130
4568,das,0,0,130,130
6443,this,0,0,129,129
20492,eller,0,0,129,129
2620,come,2,116,13,129
42326,son,0,0,127,127
35982,bu,0,0,127,127
633,al,2,59,68,127
46471,​,0,0,126,126
46364,это,0,0,126,126
3078,',2,11,114,125
40983,είναι,0,0,125,125
25051,als,0,0,125,125
16195,till,0,0,124,124
19872,ஒரு,0,0,123,123
48384,पर,0,0,121,121
28350,which,0,0,120,120
924,ha,2,71,49,120
44988,ويكيبيديا,0,0,120,120
12507,നിങ്ങൾ,0,0,120,120
50033,मैं,0,0,119,119
5078,που,0,0,118,118
17525,sobre,0,0,117,117
2739,oh,2,15,102,117
311,so,2,4,113,117
9607,plus,0,0,115,115
30818,ഞാൻ,0,0,115,115
37002,articles,0,0,114,114
16820,na,0,0,112,112
27691,ikke,0,0,111,111
13984,eu,0,0,111,111
29389,niet,0,0,110,110
25021,not,0,0,110,110
36656,has,0,0,110,110
23161,για,0,0,107,107
1006,machine,2,3,102,105
18544,op,0,0,104,104
45393,ಎಂದು,0,0,102,102
48450,der,0,0,102,102
1815,data,2,11,91,102
18366,с,0,0,101,101
21768,está,0,0,101,101
35736,comme,0,0,101,101
46632,au,0,0,100,100
45392,δεν,0,0,100,100
48301,как,0,0,99,99
28819,zu,0,0,98,98
16089,ser,0,0,97,97
33286,किया,0,0,96,96
19425,ist,0,0,96,96
48277,என்று,0,0,95,95
13914,कर,0,0,95,95
1181,web,2,19,75,94
16644,हैं।,0,0,94,94
6394,ότι,0,0,92,92
46022,sont,0,0,91,91
3141, ,2,9,80,89
13159,നിങ്ങൾക്ക്,0,0,88,88
1989,wales,2,7,81,88
42024,ett,0,0,88,88
7739,ما,0,0,87,87
16358,also,0,0,87,87
17240,over,0,0,86,86
30653,nicht,0,0,86,86
2359,nel,1,86,0,86
18214,सकते,0,0,85,85
5162,لا,0,0,85,85
2485,-,2,5,80,85
2474,dire,2,37,48,85
1326,tu,2,19,66,85
488,significa,2,27,57,84
41059,been,0,0,84,84
41103,σε,0,0,83,83
1342,sua,2,26,56,82
21591,إلى,0,0,82,82
42507,met,0,0,81,81
46205,dass,0,0,81,81
8843,википедии,0,0,81,81
39695,men,0,0,80,80
12021,mig,0,0,80,80
27007,pode,0,0,79,79
23524,avec,0,0,79,79
3295,wiki,2,15,64,79
8340,til,0,0,79,79
38092,أو,0,0,78,78
44472,entre,0,0,77,77
46016,some,0,0,77,77
10217,هذا,0,0,77,77
19409,más,0,0,77,77
32781,if,0,0,76,76
20824,или,0,0,76,76
5983,such,0,0,76,76
40672,από,0,0,75,75
35632,other,0,0,75,75
7423,são,0,0,75,75
3618,era,2,27,47,74
20335,its,0,0,74,74
21778,af,0,0,74,74
14187,या,0,0,73,73
37575,artigos,0,0,73,73
51550,θα,0,0,73,73
15379,μια,0,0,73,73
49645,मुझे,0,0,73,73
35085,cette,0,0,73,73
20357,जो,0,0,72,72
22359,dit,0,0,72,72
48241,artículos,0,0,72,72
50338,σας,0,0,71,71
10303,με,0,0,71,71
29167,ord,0,0,71,71
582,catch-,2,6,65,71
25437,but,0,0,71,71
38082,भी,0,0,71,71
39256,करने,0,0,70,70
26403,कुछ,0,0,70,70
42975,dos,0,0,70,70
866,wikipedia.,2,9,60,69
2332,più,1,69,0,69
49750,zijn,0,0,69,69
2129,internet,2,4,65,69
47317,all,0,0,68,68
44121,este,0,0,68,68
23327,η,0,0,68,68
41792,one,0,0,67,67
50862,для,0,0,67,67
24630,foi,0,0,66,66
33391,han,0,0,66,66
26584,ने,0,0,66,66
2918,terry,2,7,59,66
28714,about,0,0,65,65
46155,more,0,0,65,65
16059,ты,0,0,65,65
3929,puoi,1,65,0,65
1639,parte,2,18,47,65
36768,wenn,0,0,64,64
19385,गया,0,0,64,64
14967,wat,0,0,64,64
1397,quando,2,34,30,64
46833,article,0,0,63,63
20592,bien,0,0,63,63
16855,esta,0,0,63,63
13208,يمكنك,0,0,63,63
1958,della,1,63,0,63
17998,आपको,0,0,62,62
1613,use,2,2,60,62
4759,αυτό,0,0,62,62
1651,foundation,2,5,56,61
2139,questo,1,61,0,61
859,ma,2,51,10,61
33597,çok,0,0,61,61
40521,were,0,0,61,61
7460,बहुत,0,0,60,60
6056,her,0,0,60,60
3036,alla,2,38,22,60
37016,ഈ,0,0,59,59
44965,എനിക്ക്,0,0,59,59
37,sanger,2,9,50,59
12461,voor,0,0,59,59
40844,उपयोग,0,0,59,59
2693,mi,2,33,26,59
1192,voci,1,58,0,58
30376,için,0,0,58,58
3935,essere,1,58,0,58
50742,aux,0,0,58,58
32232,had,0,0,57,57
24306,hvis,0,0,56,56
2205,video,2,8,48,56
3634,jimmy,2,4,52,56
41342,sin,0,0,56,56
5976,रूप,0,0,56,56
27890,इस,0,0,56,56
42840,если,0,0,56,56
46897,andere,0,0,56,56
19395,ನಿಮಗೆ,0,0,55,55
24044,été,0,0,55,55
11826,their,0,0,55,55
19505,they,0,0,55,55
41353,по,0,0,55,55
7878,ze,0,0,55,55
20534,அல்லது,0,0,55,55
26509,साथ,0,0,55,55
2249,suave,2,1,53,54
10904,life,0,0,54,54
50635,तो,0,0,54,54
15390,c'est,0,0,54,54
13087,ya,0,0,54,54
40642,αν,0,0,54,54
36168,التي,0,0,54,54
1543,ti,2,44,10,54
9608,pouvez,0,0,54,54
12546,о,0,0,54,54
44611,μπορείτε,0,0,54,54
47632,из,0,0,54,54
18112,mot,0,0,53,53
35415,क्या,0,0,53,53
51195,muito,0,0,53,53
24626,betyder,0,0,53,53
27693,மிகவும்,0,0,53,53
14813,fait,0,0,53,53
14833,ഇത്,0,0,53,53
8658,like,0,0,53,53
13943,था,0,0,53,53
18184,إذا,0,0,52,52
48836,sus,0,0,52,52
5704,ή,0,0,52,52
38397,under,0,0,52,52
3992,enciclopedia,2,11,41,52
26164,these,0,0,52,52
35753,he,0,0,52,52
6379,रहा,0,0,52,52
44425,πολύ,0,0,52,52
35202,किसी,0,0,51,51
45948,года,0,0,51,51
12324,लेख,0,0,51,51
1896,nupedia,2,7,44,51
28595,ein,0,0,51,51
50983,i'm,0,0,50,50
28994,site,0,0,50,50
4092,software,2,6,44,50
3132,dei,1,50,0,50
51462,википедия,0,0,50,50
30435,elle,0,0,50,50
31833,there,0,0,49,49
43422,كان,0,0,49,49
46386,new,0,0,49,49
25966,may,0,0,49,49
9292,used,0,0,49,49
30746,editors,0,0,49,49
41414,kunt,0,0,48,48
32666,say,0,0,48,48
41027,так,0,0,48,48
661,training,2,2,46,48
46160,शब्द,0,0,48,48
38176,être,0,0,48,48
39152,ένα,0,0,48,48
14720,ces,0,0,48,48
42860,της,0,0,48,48
30196,वह,0,0,48,48
22945,ήταν,0,0,48,48
12814,ses,0,0,48,48
32438,द्वारा,0,0,47,47
7342,hvad,0,0,47,47
8357,d'une,0,0,47,47
5017,μου,0,0,47,47
2195,frase,2,16,31,47
22233,algo,0,0,47,47
4822,when,0,0,47,47
1183,ad,2,43,4,47
44576,example,0,0,47,47
30074,what,0,0,47,47
27590,ಅಥವಾ,0,0,47,47
48680,можете,0,0,47,47
11201,puedes,0,0,47,47
9396,mit,0,0,47,47
39401,than,0,0,47,47
32330,மற்றும்,0,0,47,47
20553,isso,0,0,46,46
3922,google,2,2,44,46
33388,അത്,0,0,46,46
47826,oder,0,0,46,46
4173,war,2,1,45,46
22163,word,0,0,46,46
370,libre,2,1,45,46
38070,vez,0,0,46,46
35811,tem,0,0,45,45
4984,sagen,0,0,45,45
35448,हो,0,0,45,45
39294,här,0,0,45,45
20310,número,0,0,45,45
29382,aussi,0,0,45,45
48900,vara,0,0,45,45
11126,wie,0,0,45,45
25611,eine,0,0,45,45
40383,mas,0,0,45,45
27478,nummer,0,0,44,44
41834,zo,0,0,44,44
17248,we,0,0,44,44
471,time,2,1,43,44
19788,min,0,0,44,44
13372,к,0,0,43,43
51228,number,0,0,43,43
49322,man,0,0,43,43
17270,ಅದು,0,0,43,43
2341,cui,1,43,0,43
32501,इसे,0,0,43,43
47145,vad,0,0,43,43
4052,ben,2,2,41,43
26250,från,0,0,43,43
33496,ही,0,0,43,43
42120,part,0,0,43,43
49461,τη,0,0,43,43
29357,nu,0,0,43,43
13669,ನಿಮ್ಮ,0,0,43,43
29408,todo,0,0,42,42
44800,ela,0,0,41,41
13601,τον,0,0,41,41
11752,இது,0,0,41,41
14628,iyi,0,0,41,41
46421,vil,0,0,41,41
45950,était,0,0,41,41
7921,também,0,0,41,41
49390,dem,0,0,41,41
19003,هذه,0,0,41,41
48904,säga,0,0,41,41
270,mellie,2,4,37,41
39345,она,0,0,41,41
36283,usar,0,0,41,41
39246,version,0,0,41,41
38093,någon,0,0,41,41
21228,english,0,0,41,41
22174,heb,0,0,41,41
37383,algorithms,0,0,40,40
26587,tout,0,0,40,40
35400,στο,0,0,40,40
40848,ಈ,0,0,40,40
1178,anche,1,40,0,40
34509,many,0,0,40,40
24323,ನನ್ನ,0,0,40,40
1689,forma,2,4,36,40
3632,modo,2,29,11,40
7346,only,0,0,40,40
3166,delle,1,40,0,40
3469,solo,2,18,22,40
45894,dizer,0,0,40,40
5369,а,0,0,40,40
1920,gli,1,40,0,40
44350,दिया,0,0,40,40
9059,andra,0,0,39,39
33299,wikipedia's,0,0,39,39
2994,automatico,1,39,0,39
41100,my,0,0,39,39
8685,seu,0,0,39,39
1456,molto,1,39,0,39
30094,τα,0,0,39,39
19964,smart,0,0,39,39
9621,عن,0,0,39,39
34249,wikipedias,0,0,39,39
6302,situation,0,0,39,39
6406,мне,0,0,39,39
21154,mijn,0,0,39,39
34617,വളരെ,0,0,39,39
35790,most,0,0,39,39
34957,sige,0,0,39,39
34859,kom,0,0,38,38
10805,कह,0,0,38,38
5475,können,0,0,38,38
15636,कोई,0,0,38,38
10025,cada,0,0,38,38
47983,det.,0,0,38,38
42650,എന്റെ,0,0,38,38
24765,இந்த,0,0,38,38
4009,alle,2,17,21,38
33561,был,0,0,38,38
31929,அது,0,0,38,38
999,larry,2,5,33,38
17169,было,0,0,38,38
17110,would,0,0,38,38
50902,உங்களுக்கு,0,0,38,38
41730,maar,0,0,38,38
22609,alors,0,0,37,37
31361,noget,0,0,37,37
1016,rendezvous,2,7,30,37
1753,ho,2,36,1,37
25658,hun,0,0,37,37
43417,wikipédia.,0,0,37,37
15094,cuando,0,0,37,37
620,flummox,2,3,34,37
30869,content,0,0,37,37
36524,была,0,0,37,37
29672,എന്ന്,0,0,37,37
33999,any,0,0,37,37
41296,την,0,0,37,37
1041,encyclopedia,2,1,36,37
19305,ont,0,0,37,37
25236,aprendizaje,0,0,37,37
18096,meget,0,0,37,37
16091,zeggen,0,0,36,36
16886,todos,0,0,36,36
39683,artiklar,0,0,36,36
17021,रहे,0,0,36,36
1105,online,2,7,29,36
16181,sites,0,0,36,36
36910,leur,0,0,36,36
35742,जैसे,0,0,36,36
46565,olika,0,0,36,36
19398,ele,0,0,36,36
20161,ejemplo,0,0,36,36
11998,pero,0,0,36,36
31855,très,0,0,36,36
49513,up,0,0,36,36
28285,human,0,0,36,36
25697,culture,0,0,36,36
50549,deze,0,0,36,36
2498,sa,2,1,34,35
30914,water,0,0,35,35
41440,usuarios,0,0,35,35
14626,كنت,0,0,35,35
20085,page,0,0,35,35
21117,editores,0,0,35,35
33708,iemand,0,0,35,35
371,terrence,2,4,31,35
38112,अपने,0,0,35,35
24282,तरह,0,0,35,35
24096,então,0,0,35,35
2968,sei,2,28,7,35
19521,así,0,0,35,35
39211,door,0,0,35,35
6879,также,0,0,35,35
45335,ತುಂಬಾ,0,0,35,35
14012,nogen,0,0,35,35
25320,exemplo,0,0,35,35
24924,habe,0,0,35,35
30145,شخص,0,0,35,35
49891,même,0,0,34,34
7717,sens,0,0,34,34
27611,conteúdo,0,0,34,34
20588,något,0,0,34,34
1525,base,2,14,20,34
1203,qualcuno,1,34,0,34
20765,sig,0,0,34,34
39456,сказать,0,0,34,34
660,information,2,1,33,34
6438,donc,0,0,34,34
31362,your,0,0,34,34
23591,von,0,0,34,34
2285,britannica,2,6,28,34
39521,selon,0,0,34,34
23033,into,0,0,34,34
12543,dan,0,0,34,34
41018,sido,0,0,34,34
18012,también,0,0,34,34
9419,ನನಗೆ,0,0,34,34
33463,mich,0,0,34,34
36259,suis,0,0,34,34
1063,tempo,2,19,15,34
44805,все,0,0,34,34
48967,vill,0,0,34,34
3218,uno,2,17,17,34
31297,don't,0,0,33,33
7178,quelqu'un,0,0,33,33
35942,alguien,0,0,33,33
42805,വിക്കിപീഡിയ,0,0,33,33
9334,του,0,0,33,33
8522,between,0,0,33,33
51610,set,0,0,33,33
11541,aan,0,0,33,33
26462,när,0,0,33,33
3730,commons,2,3,30,33
2524,hai,1,33,0,33
27131,когда,0,0,33,33
2870,vista,2,14,19,33
18792,ao,0,0,33,33
31212,även,0,0,33,33
17784,очень,0,0,33,33
15133,सकता,0,0,33,33
10688,woord,0,0,33,33
20098,അല്ലെങ്കിൽ,0,0,33,33
28938,ved,0,0,33,33
1892,vi,2,5,28,33
31685,alguém,0,0,33,33
12680,d'un,0,0,33,33
11492,अगर,0,0,32,32
26325,decir,0,0,32,32
6243,j'ai,0,0,32,32
33616,इसके,0,0,32,32
40899,données,0,0,32,32
48367,nombre,0,0,32,32
43571,muy,0,0,32,32
21191,naar,0,0,32,32
20903,peut,0,0,32,32
28253,palabra,0,0,32,32
23500,palavra,0,0,32,32
42261,كانت,0,0,32,32
21242,usuários,0,0,32,32
23745,бы,0,0,32,32
22271,hon,0,0,32,32
12947,करते,0,0,32,32
24672,phrase,0,0,32,32
25379,जा,0,0,32,32
22546,går,0,0,32,32
47266,deux,0,0,32,32
981,due,2,20,12,32
1592,uso,2,6,26,32
44570,person,0,0,32,32
245,parola,1,32,0,32
41279,language,0,0,32,32
11028,например,0,0,32,32
25372,mycket,0,0,32,32
37345,two,0,0,32,32
38144,ook,0,0,32,32
39185,ಇದು,0,0,32,32
1661,realmente,2,1,30,31
24085,fix,0,0,31,31
2837,quindi,1,31,0,31
11069,etwas,0,0,31,31
9669,genom,0,0,31,31
1315,test,2,6,25,31
35257,вам,0,0,31,31
26038,mir,0,0,31,31
44297,ο,0,0,31,31
11385,dus,0,0,31,31
40220,another,0,0,31,31
11978,einen,0,0,31,31
16808,detta,0,0,31,31
37368,qualquer,0,0,31,31
20352,you're,0,0,31,31
17360,சில,0,0,31,31
3760,marian,2,3,28,31
48280,skulle,0,0,31,31
44154,model,0,0,31,31
7213,auf,0,0,31,31
19875,നിങ്ങളുടെ,0,0,31,31
32434,porque,0,0,31,31
43747,often,0,0,31,31
49429,edições,0,0,31,31
174,così,1,31,0,31
27872,عام,0,0,31,31
42436,signifie,0,0,31,31
935,science,2,4,26,30
5803,bin,0,0,30,30
10705,lugar,0,0,30,30
30927,være,0,0,30,30
3723,mediawiki,2,3,27,30
24943,لقد,0,0,30,30
38283,means,0,0,30,30
48044,hur,0,0,30,30
6215,artigo,0,0,30,30
31320,هل,0,0,30,30
15744,called,0,0,30,30
3521,ai,2,12,18,30
2865,mobile,2,4,26,30
9562,fue,0,0,30,30
45209,want,0,0,30,30
26311,но,0,0,30,30
13382,partir,0,0,30,30
42514,बारे,0,0,30,30
31753,ಅದನ್ನು,0,0,30,30
20633,general,0,0,30,30
43875,how,0,0,30,30
11659,أنا,0,0,30,30
42564,هي,0,0,29,29
49549,जाता,0,0,29,29
42583,लेकिन,0,0,29,29
51459,чтобы,0,0,29,29
23061,उस,0,0,29,29
4950,estou,0,0,29,29
2617,dette,2,1,28,29
8273,will,0,0,29,29
27765,वे,0,0,29,29
20169,तक,0,0,29,29
32817,she,0,0,29,29
32931,अधिक,0,0,29,29
1979,work,2,1,28,29
6752,അതിനാൽ,0,0,29,29
2434,apprendimento,1,29,0,29
39010,l'homme,0,0,29,29
41081,faire,0,0,29,29
23699,där,0,0,29,29
9548,fazer,0,0,29,29
2253,persona,2,10,19,29
30851,hebt,0,0,29,29
45234,contenu,0,0,29,29
45336,goed,0,0,29,29
38382,он,0,0,29,29
10042,ça,0,0,29,29
50127,لم,0,0,29,29
5801,आपके,0,0,29,29
298,grande,2,8,21,29
20152,статьи,0,0,29,29
1905,tipo,2,9,19,28
1101,nella,1,28,0,28
46705,apenas,0,0,28,28
3807,tra,1,28,0,28
33302,then,0,0,28,28
8133,tan,0,0,28,28
9320,study,0,0,28,28
40092,λέξη,0,0,28,28
40261,πείτε,0,0,28,28
10248,project,0,0,28,28
10736,ordet,0,0,28,28
366,loro,1,28,0,28
25474,ainsi,0,0,28,28
47344,которые,0,0,28,28
21161,हूं,0,0,28,28
16328,chose,0,0,28,28
5451,well,0,0,28,28
30980,several,0,0,28,28
1541,editor,2,1,27,28
38654,natural,0,0,28,28
6192,earth,0,0,28,28
14267,உங்கள்,0,0,28,28
39516,dir,0,0,28,28
30772,ಆದ್ದರಿಂದ,0,0,28,28
6499,din,0,0,28,28
20656,dich,0,0,28,28
48086,puede,0,0,28,28
286,perché,1,28,0,28
19256,zou,0,0,27,27
24105,σημαίνει,0,0,27,27
15957,while,0,0,27,27
40908,τι,0,0,27,27
40874,за,0,0,27,27
40448,revista,0,0,27,27
16982,free,0,0,27,27
37961,estoy,0,0,27,27
38221,good,0,0,27,27
22982,ಒಂದು,0,0,27,27
31454,പറയാൻ,0,0,27,27
29596,يمكن,0,0,27,27
32775,hier,0,0,27,27
34505,الذي,0,0,27,27
31540,στην,0,0,27,27
31379,otros,0,0,27,27
2856,lui,2,3,24,27
27214,artificial,0,0,27,27
4038,esempio,1,27,0,27
43890,who,0,0,27,27
11673,sich,0,0,27,27
29653,அதை,0,0,27,27
10520,مثل,0,0,27,27
51941,exempel,0,0,27,27
32969,exemple,0,0,27,27
5909,هو,0,0,27,27
11316,because,0,0,27,27
15002,páginas,0,0,27,27
6303,research,0,0,27,27
49012,dont,0,0,27,27
27705,get,0,0,27,27
15586,τους,0,0,26,26
17654,än,0,0,26,26
909,sia,1,26,0,26
21689,gå,0,0,26,26
46235,ediciones,0,0,26,26
23520,जब,0,0,26,26
25993,known,0,0,26,26
48583,d'autres,0,0,26,26
19011,τόσο,0,0,26,26
12747,μην,0,0,26,26
43155,projeto,0,0,26,26
27851,करता,0,0,26,26
51658,aber,0,0,26,26
27556,έχετε,0,0,26,26
4916,daha,0,0,26,26
50679,ذلك,0,0,26,26
50166,seus,0,0,26,26
27269,ಆದರೆ,0,0,26,26
28178,أنه,0,0,26,26
35660,åh,0,0,26,26
21585,تم,0,0,26,26
29323,अच्छा,0,0,26,26
46825,كل,0,0,26,26
40343,very,0,0,26,26
35089,είμαι,0,0,26,26
966,l'apprendimento,1,26,0,26
756,sistema,2,12,14,26
11112,быть,0,0,26,26
42152,αλλά,0,0,26,26
21725,für,0,0,26,26
47743,olduğunu,0,0,26,26
41199,بعض,0,0,25,25
4161,voce,1,25,0,25
6614,artículo,0,0,25,25
21084,quelque,0,0,25,25
1009,qualcosa,1,25,0,25
16801,both,0,0,25,25
24997,bem,0,0,25,25
1177,quanto,2,15,10,25
13261,بشكل,0,0,25,25
22774,amigos,0,0,25,25
22753,था।,0,0,25,25
38445,encyclopædia,0,0,25,25
16764,betekent,0,0,25,25
5241,вас,0,0,25,25
45291,उदाहरण,0,0,25,25
33099,कई,0,0,25,25
8104,could,0,0,25,25
27098,ஆனால்,0,0,25,25
51665,place,0,0,25,25
9806,dessa,0,0,25,25
825,dal,1,25,0,25
10527,autre,0,0,25,25
40708,sehr,0,0,25,25
38862,eles,0,0,25,25
42095,iets,0,0,25,25
15108,எனவே,0,0,25,25
15266,contenido,0,0,25,25
31328,after,0,0,25,25
12839,pela,0,0,24,24
40117,अन्य,0,0,24,24
12640,الإنجليزية,0,0,24,24
44435,प्राप्त,0,0,24,24
36901,desde,0,0,24,24
47851,bland,0,0,24,24
42277,bra,0,0,24,24
32543,waren,0,0,24,24
9980,annat,0,0,24,24
51492,у,0,0,24,24
6812,efter,0,0,24,24
195,problema,2,10,14,24
9406,sous,0,0,24,24
15755,меня,0,0,24,24
46339,s,0,0,24,24
32219,ama,0,0,24,24
9822,estar,0,0,24,24
553,cosa,2,23,1,24
30268,outra,0,0,24,24
30554,within,0,0,24,24
3659,stata,1,24,0,24
15124,werd,0,0,24,24
2757,madre,2,12,12,24
29772,gibi,0,0,24,24
36280,system,0,0,24,24
2728,tre,2,11,13,24
47660,tous,0,0,24,24
21072,somebody,0,0,24,24
8999,wort,0,0,24,24
37034,få,0,0,24,24
8325,made,0,0,24,24
20219,estaba,0,0,24,24
41073,ofta,0,0,24,24
51214,found,0,0,24,24
47052,அவள்,0,0,24,24
45583,diferentes,0,0,24,24
37729,where,0,0,24,24
33700,them,0,0,24,24
40596,alguns,0,0,24,24
13375,using,0,0,24,24
3374,fare,1,24,0,24
32484,अंग्रेजी,0,0,24,24
23417,knowledge,0,0,24,24
6112,really,0,0,23,23
45147,статей,0,0,23,23
45298,tiene,0,0,23,23
2203,disse,2,1,22,23
6023,each,0,0,23,23
10798,menos,0,0,23,23
18135,inglés,0,0,23,23
28491,meer,0,0,23,23
40724,أخرى,0,0,23,23
36977,votre,0,0,23,23
3507,caso,2,7,16,23
11977,sans,0,0,23,23
38292,including,0,0,23,23
38466,pages,0,0,23,23
10336,kommer,0,0,23,23
17984,through,0,0,23,23
16526,أي,0,0,23,23
30884,ಯಾರಾದರೂ,0,0,23,23
751,posso,2,11,12,23
38747,செய்ய,0,0,23,23
36250,слово,0,0,23,23
39760,years,0,0,23,23
16559,हूँ,0,0,23,23
29518,podem,0,0,23,23
21025,nous,0,0,23,23
7579,something,0,0,23,23
37732,sätt,0,0,23,23
36707,هناك,0,0,23,23
34711,nos,0,0,23,23
7944,tão,0,0,23,23
47492,bedeutet,0,0,23,23
2686,fatto,1,23,0,23
35375,κάτι,0,0,23,23
6431,geen,0,0,23,23
1327,hey,2,2,21,23
1995,stato,1,23,0,23
12439,notamment,0,0,23,23
18866,nature.,0,0,23,23
32594,विकिमीडिया,0,0,23,23
47954,first,0,0,23,23
3836,via,2,3,20,23
374,tanto,2,6,17,23
42165,ಅವರು,0,0,23,23
19388,sem,0,0,23,23
30157,eso,0,0,22,22
39235,methods,0,0,22,22
3849,nome,2,13,9,22
20422,versions,0,0,22,22
39004,otra,0,0,22,22
47962,denne,0,0,22,22
24449,gnu,0,0,22,22
20796,even,0,0,22,22
2177,va,2,10,12,22
49903,то,0,0,22,22
46236,от,0,0,22,22
47523,​​,0,0,22,22
38951,были,0,0,22,22
9596,मेरे,0,0,22,22
40156,way,0,0,22,22
21272,include,0,0,22,22
25101,images,0,0,22,22
40018,başka,0,0,22,22
38483,esto,0,0,22,22
30793,использовать,0,0,22,22
52021,काम,0,0,22,22
21583,his,0,0,22,22
28871,estava,0,0,22,22
51154,शुरू,0,0,22,22
10339,anglais,0,0,22,22
29445,question,0,0,22,22
39602,വിക്കിപീഡിയയിൽ,0,0,22,22
20854,alles,0,0,22,22
27208,vikipedi,0,0,22,22
11059,enciclopédia,0,0,22,22
34476,κάποιος,0,0,22,22
33893,out,0,0,22,22
11421,monde,0,0,22,22
2595,rock,2,1,21,22
45133,является,0,0,22,22
22170,uit,0,0,22,22
2520,dalla,1,22,0,22
31079,kadar,0,0,22,22
42297,ಬಗ್ಗೆ,0,0,22,22
31338,ville,0,0,22,22
11996,según,0,0,22,22
42866,l'encyclopédie,0,0,22,22
49274,kann,0,0,22,22
43823,विश्वकोश,0,0,22,22
662,parole,2,21,1,22
2631,sempre,2,13,9,22
35086,थे,0,0,22,22
37166,också,0,0,22,22
37616,sind,0,0,22,22
45173,información,0,0,22,22
12912,என்ன,0,0,22,22
49697,veya,0,0,22,22
2478,tutto,1,22,0,22
27658,bara,0,0,22,22
27194,much,0,0,22,22
813,quello,1,22,0,22
31020,لك,0,0,22,22
13288,hij,0,0,22,22
28428,just,0,0,22,22
49530,hade,0,0,22,22
22834,yüzden,0,0,21,21
47857,använda,0,0,21,21
12435,ನಿಜವಾಗಿಯೂ,0,0,21,21
43694,words,0,0,21,21
19602,quand,0,0,21,21
34439,haar,0,0,21,21
5089,times,0,0,21,21
31309,dag,0,0,21,21
6670,generally,0,0,21,21
39431,otras,0,0,21,21
13199,foram,0,0,21,21
25198,என்,0,0,21,21
1504,bene,1,21,0,21
5112,utan,0,0,21,21
26536,hoe,0,0,21,21
40113,تقول,0,0,21,21
44058,şey,0,0,21,21
41677,sorry,0,0,21,21
29854,том,0,0,21,21
22610,അവൾ,0,0,21,21
6559,journal,0,0,21,21
3034,world,2,1,20,21
24346,करना,0,0,21,21
3629,university,2,1,20,21
3051,],2,1,20,21
27480,விக்கிப்பீடியா,0,0,21,21
19093,reported,0,0,21,21
9078,എന്നെ,0,0,21,21
42766,olarak,0,0,21,21
9493,ಅವಳು,0,0,21,21
15199,നിങ്ങളെ,0,0,21,21
36002,έχω,0,0,21,21
48279,gerçekten,0,0,21,21
21482,related,0,0,21,21
43252,automatique,0,0,21,21
51508,المقالات,0,0,21,21
21886,projet,0,0,21,21
8280,ska,0,0,21,21
48274,depuis,0,0,21,21
48273,sources,0,0,21,21
10729,edição,0,0,21,21
22426,blev,0,0,21,21
52102,artikelen,0,0,21,21
38332,hem,0,0,21,21
44893,tal,0,0,21,21
45218,nej,0,0,21,21
3358,quel,2,13,8,21
3349,creative,2,2,19,21
15580,kun,0,0,21,21
42390,अपनी,0,0,21,21
48879,peuvent,0,0,21,21
6833,haben,0,0,21,21
26814,mundo,0,0,21,21
21897,ese,0,0,21,21
5446,anlamına,0,0,21,21
25775,go,0,0,21,21
50462,qué,0,0,21,21
31381,know,0,0,21,21
28141,എന്തെങ്കിലും,0,0,21,21
26204,എന്ന,0,0,21,21
37958,até,0,0,21,21
32041,it's,0,0,21,21
12106,inglês,0,0,21,21
18325,أكثر,0,0,21,21
18395,kelime,0,0,21,21
14799,परियोजना,0,0,21,21
17490,palabras,0,0,21,21
23616,it.,0,0,21,21
47473,being,0,0,21,21
21934,wirklich,0,0,21,21
7179,οι,0,0,21,21
6442,يا,0,0,20,20
50136,suas,0,0,20,20
22412,algunas,0,0,20,20
42016,estado,0,0,20,20
22441,മറ്റൊരു,0,0,20,20
3787,casa,2,6,14,20
38762,estás,0,0,20,20
38854,également,0,0,20,20
38780,στη,0,0,20,20
14740,ആ,0,0,20,20
47180,kannst,0,0,20,20
968,video.,2,4,16,20
40828,gøre,0,0,20,20
3562,importa,2,5,15,20
17952,mots,0,0,20,20
11102,भाषा,0,0,20,20
11063,certaines,0,0,20,20
24386,व्यक्ति,0,0,20,20
45195,heeft,0,0,20,20
38260,godt,0,0,20,20
32105,यदि,0,0,20,20
24375,användare,0,0,20,20
10530,عندما,0,0,20,20
20443,manera,0,0,20,20
46032,similar,0,0,20,20
1021,edizioni,1,20,0,20
5463,mer,0,0,20,20
51142,verwenden,0,0,20,20
49113,outros,0,0,20,20
4332,göra,0,0,20,20
34897,surface,0,0,20,20
6252,inteligente,0,0,20,20
31337,थी,0,0,20,20
31547,क्योंकि,0,0,20,20
48546,travail,0,0,20,20
42546,fantastisk,0,0,20,20
15374,classification,0,0,20,20
51328,vraiment,0,0,20,20
15943,får,0,0,20,20
26623,είσαι,0,0,20,20
36025,avez,0,0,20,20
8019,этого,0,0,20,20
41984,hay,0,0,19,19
7303,वास्तव,0,0,19,19
41969,proyecto,0,0,19,19
31724,anden,0,0,19,19
42918,όταν,0,0,19,19
39506,meu,0,0,19,19
4001,numero,1,19,0,19
20117,fundación,0,0,19,19
30106,qu'il,0,0,19,19
36620,எப்படி,0,0,19,19
30347,مع,0,0,19,19
29061,nogle,0,0,19,19
5836,cela,0,0,19,19
587,dati,1,19,0,19
40886,moet,0,0,19,19
12722,êtes,0,0,19,19
10902,certain,0,0,19,19
18154,её,0,0,19,19
12636,give,0,0,19,19
36693,palavras,0,0,19,19
2158,mamma,2,7,12,19
4114,sul,1,19,0,19
28444,जिसका,0,0,19,19
3107,utenti,1,19,0,19
9730,पास,0,0,19,19
25930,finns,0,0,19,19
45090,projets,0,0,19,19
556,gfdl,2,2,17,19
45656,பற்றி,0,0,19,19
17328,jemand,0,0,19,19
18268,based,0,0,19,19
594,inglese,1,19,0,19
33399,संस्करण,0,0,19,19
45422,obtuse,0,0,19,19
19295,rules,0,0,19,19
17949,u,0,0,19,19
23780,different,0,0,19,19
4271,problem,0,0,19,19
14182,skal,0,0,19,19
8338,engelskspråkiga,0,0,19,19
43695,mor,0,0,19,19
8510,mesmo,0,0,19,19
51631,hast,0,0,19,19
6825,peu,0,0,19,19
5691,gör,0,0,19,19
32345,gut,0,0,19,19
52140,hat,0,0,19,19
1509,edit,2,1,18,19
49948,गया।,0,0,19,19
24050,vezes,0,0,19,19
1514,media,2,6,13,19
36824,شيء,0,0,19,19
6258,comment,0,0,19,19
21719,weet,0,0,18,18
49739,кто-то,0,0,18,18
23864,field,0,0,18,18
20856,algorithm,0,0,18,18
1550,source,2,1,17,18
23528,american,0,0,18,18
20688,text,0,0,18,18
5233,bias,0,0,18,18
38638,означает,0,0,18,18
20726,embora,0,0,18,18
23149,хорошо,0,0,18,18
5124,vilket,0,0,18,18
6625,através,0,0,18,18
30860,naturel,0,0,18,18
32446,im,0,0,18,18
6441,bruge,0,0,18,18
31857,ಆ,0,0,18,18
22434,où,0,0,18,18
1475,altri,1,18,0,18
21219,process,0,0,18,18
34972,يعني,0,0,18,18
9028,पता,0,0,18,18
19914,सभी,0,0,18,18
1913,suo,1,18,0,18
19552,गए,0,0,18,18
39812,size,0,0,18,18
840,sms,2,1,17,18
2891,ricerca,1,18,0,18
26244,take,0,0,18,18
9032,ಸ್ಮಾರ್ಟ್,0,0,18,18
34520,atroz,0,0,18,18
2960,punto,2,11,7,18
33348,tudo,0,0,18,18
27526,automático,0,0,18,18
29127,आपने,0,0,18,18
2020,computer,2,3,15,18
19024,form,0,0,18,18
18871,они,0,0,18,18
27956,utiliser,0,0,18,18
46141,säger,0,0,18,18
27966,millions,0,0,18,18
51669,उन,0,0,18,18
28090,although,0,0,18,18
3151,essa,2,5,13,18
10682,എല്ലാ,0,0,18,18
50454,يجب,0,0,18,18
40701,могут,0,0,18,18
45450,trabalho,0,0,18,18
44956,users,0,0,18,18
25526,sitio,0,0,18,18
28376,einer,0,0,18,18
11441,gaat,0,0,18,18
47357,поэтому,0,0,18,18
11298,அந்த,0,0,18,18
15864,mon,0,0,18,18
32986,personas,0,0,18,18
39385,without,0,0,18,18
2649,tutti,1,18,0,18
7232,particular,0,0,18,18
51237,चाहते,0,0,18,18
3938,mining,2,7,11,18
32674,manier,0,0,18,18
1806,insieme,1,18,0,18
26705,façon,0,0,18,18
16111,году,0,0,18,18
29975,algunos,0,0,18,18
15757,pelo,0,0,18,18
39195,vie,0,0,18,18
2563,degli,1,18,0,18
5342,λέξεις,0,0,17,17
49613,biraz,0,0,17,17
5253,artikel,0,0,17,17
25975,gebruiken,0,0,17,17
17303,मैंने,0,0,17,17
5138,எனக்கு,0,0,17,17
17394,tiempo,0,0,17,17
17305,सबसे,0,0,17,17
31990,existe,0,0,17,17
2321,melissa,2,2,15,17
28191,ja,0,0,17,17
12094,அவர்,0,0,17,17
1559,dell'apprendimento,1,17,0,17
4514,बाद,0,0,17,17
41110,dois,0,0,17,17
42428,wordt,0,0,17,17
15550,hej,0,0,17,17
42381,going,0,0,17,17
40905,changes,0,0,17,17
35505,ligne,0,0,17,17
4834,några,0,0,17,17
22711,только,0,0,17,17
957,questa,1,17,0,17
37768,since,0,0,17,17
22592,large,0,0,17,17
42044,न,0,0,17,17
4836,есть,0,0,17,17
22575,lors,0,0,17,17
49453,स्मार्ट,0,0,17,17
22464,ನಿಮ್ಮನ್ನು,0,0,17,17
43148,akıllı,0,0,17,17
16367,его,0,0,17,17
37756,σαν,0,0,17,17
16430,mãe,0,0,17,17
4885,över,0,0,17,17
37923,ஸ்மார்ட்,0,0,17,17
2370,systems,2,1,16,17
27021,d'articles,0,0,17,17
16008,those,0,0,17,17
37727,كلمة,0,0,17,17
1507,erano,1,17,0,17
37252,eram,0,0,17,17
37715,later,0,0,17,17
22688,ಹೇಳಬಹುದು,0,0,17,17
13132,wir,0,0,17,17
3014,sulla,1,17,0,17
2374,atroce,2,9,8,17
37457,já,0,0,17,17
37363,however,0,0,17,17
43299,among,0,0,17,17
3965,deve,2,2,15,17
45278,learning.,0,0,17,17
10019,लेखों,0,0,17,17
51993,mismo,0,0,17,17
18718,flera,0,0,17,17
29049,lad,0,0,17,17
9433,york,0,0,17,17
46585,cualquier,0,0,17,17
1084,grazie,1,17,0,17
30758,plusieurs,0,0,17,17
32301,public,0,0,17,17
3672,comunità,1,17,0,17
24918,väldigt,0,0,17,17
32375,يتم,0,0,17,17
38758,ihnen,0,0,17,17
19614,इसका,0,0,17,17
30586,ಎಂದರೆ,0,0,17,17
20985,différentes,0,0,17,17
292,momento,2,7,10,17
30581,bunu,0,0,17,17
52067,woorden,0,0,17,17
51595,doen,0,0,17,17
7455,during,0,0,17,17
20303,livre,0,0,17,17
32774,estão,0,0,17,17
1171,alcuni,1,17,0,17
39203,என்பது,0,0,17,17
6694,same,0,0,17,17
1026,durante,2,4,13,17
24983,många,0,0,17,17
32200,people,0,0,17,17
18217,kunne,0,0,17,17
33747,various,0,0,17,17
10730,vers,0,0,17,17
45552,इसलिए,0,0,17,17
4229,million,0,0,16,16
48363,see,0,0,16,16
20108,έχει,0,0,16,16
42110,uns,0,0,16,16
44939,நன்றாக,0,0,16,16
47485,contributors,0,0,16,16
4752,சொல்,0,0,16,16
10997,их,0,0,16,16
42825,fois,0,0,16,16
4776,время,0,0,16,16
3795,lingua,1,16,0,16
38209,όπως,0,0,16,16
19766,editions,0,0,16,16
42188,ويكيبيديا.,0,0,16,16
7653,eftersom,0,0,16,16
47621,പക്ഷേ,0,0,16,16
47652,पहले,0,0,16,16
3949,–,2,1,15,16
1766,bbc,2,1,15,16
18007,होता,0,0,16,16
17697,ici,0,0,16,16
4516,mellan,0,0,16,16
4345,मुफ्त,0,0,16,16
1737,quali,1,16,0,16
4585,fick,0,0,16,16
7446,l'apprentissage,0,0,16,16
21890,há,0,0,16,16
38237,vikipedi'nin,0,0,16,16
42241,शामिल,0,0,16,16
45006,समय,0,0,16,16
5799,español,0,0,16,16
47739,features,0,0,16,16
48379,οπότε,0,0,16,16
8445,låt,0,0,16,16
38195,может,0,0,16,16
2355,metodi,1,16,0,16
45856,ചില,0,0,16,16
48541,models,0,0,16,16
2013,davvero,1,16,0,16
18991,stupendous,0,0,16,16
5105,nach,0,0,16,16
41389,sedan,0,0,16,16
51069,articles.,0,0,16,16
21673,என்னை,0,0,16,16
9709,غير,0,0,16,16
6036,കഴിയും,0,0,16,16
18294,arbejde,0,0,16,16
12286,now,0,0,16,16
5185,job,0,0,16,16
18507,heel,0,0,16,16
16736,ഇപ്പോൾ,0,0,16,16
41657,antal,0,0,16,16
2113,narcis,2,2,14,16
17406,τώρα,0,0,16,16
3184,progetti,1,16,0,16
14508,bij,0,0,16,16
1948,vuoi,1,16,0,16
8600,according,0,0,16,16
22987,original,0,0,16,16
51152,rendez-vous,0,0,16,16
14238,website,0,0,16,16
19356,अब,0,0,16,16
14158,ഏറ്റവും,0,0,16,16
21999,ഇംഗ്ലീഷ്,0,0,16,16
44598,ಹೇಗೆ,0,0,16,16
5747,ആരെങ്കിലും,0,0,16,16
1971,foundation.,2,1,15,16
38701,वाले,0,0,16,16
1571,input,2,1,15,16
40771,då,0,0,16,16
90,cita,2,1,15,16
27463,bent,0,0,16,16
30553,antes,0,0,16,16
51974,того,0,0,16,16
36700,january,0,0,16,16
24615,center,0,0,16,16
37375,மீண்டும்,0,0,16,16
23379,വിക്കിപീഡിയർ,0,0,16,16
31213,еще,0,0,16,16
23547,conception,0,0,16,16
28478,нет,0,0,16,16
35930,erg,0,0,16,16
28274,texto,0,0,16,16
33936,ऐसा,0,0,16,16
28607,बार,0,0,16,16
27864,agora,0,0,16,16
31101,license,0,0,16,16
28637,got,0,0,16,16
27697,chaque,0,0,16,16
31336,puis,0,0,16,16
25722,said,0,0,16,16
499,altre,1,16,0,16
37318,πρέπει,0,0,16,16
33755,mucho,0,0,16,16
28352,zin,0,0,16,16
35618,partie,0,0,16,16
52027,κάνει,0,0,16,16
31433,tid,0,0,16,16
33524,ನಾವು,0,0,16,16
20428,सब,0,0,15,15
14995,μπορείς,0,0,15,15
42717,otro,0,0,15,15
31058,γιατί,0,0,15,15
34082,होती,0,0,15,15
20364,ahora,0,0,15,15
1535,poco,2,3,12,15
34701,obtuso,0,0,15,15
29523,αυτή,0,0,15,15
12090,इसकी,0,0,15,15
42356,могу,0,0,15,15
45878,andre,0,0,15,15
24720,learn,0,0,15,15
13125,community,0,0,15,15
36345,além,0,0,15,15
37953,केवल,0,0,15,15
35163,peux,0,0,15,15
39523,वाक्यांश,0,0,15,15
6208,എങ്ങനെ,0,0,15,15
30812,ένας,0,0,15,15
41690,portal,0,0,15,15
1338,narciso,2,5,10,15
690,alcune,1,15,0,15
14645,ಮಾಡಲು,0,0,15,15
23858,ಏನು,0,0,15,15
37519,editing,0,0,15,15
46611,januari,0,0,15,15
31284,material,0,0,15,15
21207,år,0,0,15,15
36827,hvor,0,0,15,15
378,mio,1,15,0,15
27468,forme,0,0,15,15
13951,janeiro,0,0,15,15
43859,modifications,0,0,15,15
21369,ter,0,0,15,15
34479,end,0,0,15,15
13016,அவர்கள்,0,0,15,15
34364,bana,0,0,15,15
2982,progetto,1,15,0,15
21024,vet,0,0,15,15
34235,wilt,0,0,15,15
420,examples,2,1,14,15
51283,comunidade,0,0,15,15
5585,हम,0,0,15,15
43134,considered,0,0,15,15
31431,pouco,0,0,15,15
35396,अर्थ,0,0,15,15
14235,había,0,0,15,15
14220,जिसे,0,0,15,15
44343,wil,0,0,15,15
34232,இப்போது,0,0,15,15
36684,mest,0,0,15,15
38897,políticas,0,0,15,15
37042,certains,0,0,15,15
3519,data.,2,1,14,15
31993,العديد,0,0,15,15
27935,echt,0,0,15,15
864,usare,1,15,0,15
50836,estados,0,0,15,15
9609,statistical,0,0,15,15
48136,utilisé,0,0,15,15
23193,இல்லை,0,0,15,15
40676,lista,0,0,15,15
7452,себя,0,0,15,15
11173,supervised,0,0,15,15
36000,vida,0,0,15,15
4645,others,0,0,15,15
40707,माँ,0,0,15,15
17440,trabajo,0,0,15,15
48173,रही,0,0,15,15
2295,nelle,1,15,0,15
478,importante,2,3,12,15
33819,art,0,0,15,15
37337,mindre,0,0,15,15
19198,zoals,0,0,15,15
6928,percent,0,0,15,15
2014,fonte,2,9,6,15
17696,pessoa,0,0,15,15
40263,ga,0,0,15,15
28454,flummoxed,0,0,15,15
1039,molti,1,15,0,15
37462,environment,0,0,15,15
47989,جدًا,0,0,15,15
40244,ನನ್ನನ್ನು,0,0,15,15
217,lavoro,1,15,0,15
48218,كما,0,0,15,15
31570,comunidad,0,0,15,15
35990,måste,0,0,15,15
18289,keine,0,0,15,15
18566,कैसे,0,0,15,15
47630,todas,0,0,15,15
40618,moment,0,0,15,15
11729,ಅದ್ಭುತ,0,0,15,15
26001,einem,0,0,15,15
2128,tua,1,15,0,15
3364,intelligente,2,10,5,15
32792,ut,0,0,15,15
463,create,2,1,14,15
905,lento,2,2,13,15
10774,youtube,0,0,15,15
29952,n'est,0,0,15,15
51164,frases,0,0,15,15
14062,sein,0,0,14,14
43388,ella,0,0,14,14
13628,википедию,0,0,14,14
18525,pueden,0,0,14,14
23957,diesem,0,0,14,14
46697,next,0,0,14,14
24267,χρησιμοποιήσετε,0,0,14,14
682,secondo,1,14,0,14
14200,embargo,0,0,14,14
6995,qualité,0,0,14,14
3001,visto,2,4,10,14
24276,ذلك.,0,0,14,14
198,principe,2,3,11,14
9597,किये,0,0,14,14
18087,sometimes,0,0,14,14
29316,geweldig,0,0,14,14
18762,système,0,0,14,14
34532,मतलब,0,0,14,14
2079,invece,1,14,0,14
38719,hecho,0,0,14,14
13537,же,0,0,14,14
6583,أنني,0,0,14,14
1671,momento.,2,5,9,14
2892,ci,1,14,0,14
21114,allt,0,0,14,14
35897,make,0,0,14,14
18180,procent,0,0,14,14
35950,யாராவது,0,0,14,14
1007,alto,2,5,9,14
18284,ingen,0,0,14,14
9083,εδώ,0,0,14,14
30336,types,0,0,14,14
43577,feature,0,0,14,14
32873,maintenant,0,0,14,14
49034,space,0,0,14,14
47958,toda,0,0,14,14
8413,zit,0,0,14,14
15395, million,0,0,14,14
15397,página,0,0,14,14
39362,ihre,0,0,14,14
30060,total,0,0,14,14
26818,تكون,0,0,14,14
24659,hakkında,0,0,14,14
5999,fra,0,0,14,14
3886,september,2,1,13,14
29629,hvordan,0,0,14,14
19418,hacer,0,0,14,14
15974,satz,0,0,14,14
39474,stated,0,0,14,14
2544,lei,2,10,4,14
4086,algoritmi,1,14,0,14
39501,மற்றொரு,0,0,14,14
41502,इन,0,0,14,14
3806,può,1,14,0,14
52065,موسوعة,0,0,14,14
30874,muitas,0,0,14,14
16906,phrases,0,0,14,14
41699,devam,0,0,14,14
7728,حقًا,0,0,14,14
16894,making,0,0,14,14
39743,العمل,0,0,14,14
36456,type,0,0,14,14
4071,modello,1,14,0,14
7412,jetzt,0,0,14,14
30124,before,0,0,14,14
48403,لذا,0,0,14,14
14370,onde,0,0,14,14
5528,annan,0,0,14,14
33242,veel,0,0,14,14
17925,இருக்கிறேன்,0,0,14,14
19575,θέλετε,0,0,14,14
952,open,2,1,13,14
20577,outras,0,0,14,14
50729,possible,0,0,14,14
32346,என்ற,0,0,14,14
8640,ಈಗ,0,0,14,14
1174,vai,2,5,9,14
24508,विकी,0,0,14,14
20468,ओह,0,0,14,14
1784,sciences,2,1,13,14
5739,ir,0,0,14,14
2697,stati,1,14,0,14
29474,ويكيبيديا،,0,0,14,14
27088,शब्दों,0,0,14,14
42747,omdat,0,0,14,14
19217,autres,0,0,14,14
1165,informazioni,1,14,0,14
742,news,2,1,13,14
743,fin,2,1,13,14
43026,bijvoorbeeld,0,0,14,14
2103,contenuto,1,14,0,14
4753,når,0,0,14,14
22391,wäre,0,0,14,14
11370,hvilket,0,0,14,14
28414,estupendo,0,0,14,14
5021,notion,0,0,14,14
10511,അവർ,0,0,14,14
3064,bomis,2,2,12,14
9856,देते,0,0,14,14
44273,pays,0,0,14,14
4712,oss,0,0,14,14
38293,ver,0,0,14,14
4963,अच्छी,0,0,14,14
45853,tenho,0,0,14,14
1483,usa,2,3,11,14
33552,¿qué,0,0,14,14
497,t,2,2,12,14
37935,temas,0,0,14,14
12655,ocean,0,0,14,14
49792,review,0,0,14,14
44764,न्यूपीडिया,0,0,14,14
45915,όχι,0,0,14,14
12581,ta,0,0,14,14
12559,этом,0,0,14,14
44685,last,0,0,14,14
12211,helt,0,0,14,14
28190,قد,0,0,14,14
28119,projetos,0,0,14,14
9994,daar,0,0,14,14
1443,possono,1,14,0,14
11726,ലേഖനങ്ങൾ,0,0,14,14
9930,måde,0,0,14,14
4354,μπορώ,0,0,14,14
28626,can't,0,0,14,14
45660,أنك,0,0,14,14
44093,संस्थान,0,0,14,14
38455,ماذا,0,0,14,14
11245,dar,0,0,14,14
4394,رقم,0,0,14,14
45586,algumas,0,0,14,14
11036,administradores,0,0,14,14
49671,point,0,0,14,14
33846,более,0,0,14,14
31603,species,0,0,14,14
1389,campo,2,9,5,14
37632,använder,0,0,14,14
22825,»,0,0,14,14
42374,vamos,0,0,13,13
23946,important,0,0,13,13
32194,active,0,0,13,13
29583,grandes,0,0,13,13
18603,حول,0,0,13,13
22297,sonra,0,0,13,13
51929,ഓ,0,0,13,13
20033,colbert,0,0,13,13
33783,exempelvis,0,0,13,13
30920,लाइसेंस,0,0,13,13
15995,amis,0,0,13,13
51611,bread,0,0,13,13
16068,melhor,0,0,13,13
7992,small,0,0,13,13
49666,ли,0,0,13,13
47441,tasks,0,0,13,13
39387,agudo,0,0,13,13
48799,bunun,0,0,13,13
3186,whatsapp,2,1,12,13
31005,versión,0,0,13,13
20600,riktigt,0,0,13,13
27186,quieres,0,0,13,13
21992,sana,0,0,13,13
14758,എന്താണ്,0,0,13,13
28870,brood,0,0,13,13
47030,दो,0,0,13,13
23497,july,0,0,13,13
14934,τις,0,0,13,13
560,joseph,2,1,12,13
15075,estas,0,0,13,13
5754,κάποιον,0,0,13,13
26819,servidores,0,0,13,13
12274,major,0,0,13,13
36497,están,0,0,13,13
42608,слова,0,0,13,13
6664,يناير,0,0,13,13
36454,dizendo,0,0,13,13
36452,decision,0,0,13,13
8429,think,0,0,13,13
42552,access,0,0,13,13
52164,networks,0,0,13,13
33158,ಅನ್ನು,0,0,13,13
26438,última,0,0,13,13
40093,द,0,0,13,13
47474,bazı,0,0,13,13
41812,ಸ್ವಲ್ಪ,0,0,13,13
37328,web.,0,0,13,13
17206,tellement,0,0,13,13
25534,given,0,0,13,13
3258,spesso,1,13,0,13
25949,friends,0,0,13,13
47976,política,0,0,13,13
35582,essen,0,0,13,13
4654,номер,0,0,13,13
50971,ihr,0,0,13,13
3903,vandalismo,2,1,12,13
19268,كيف,0,0,13,13
51721,venner,0,0,13,13
41171,modelo,0,0,13,13
7405,popular,0,0,13,13
17461,lite,0,0,13,13
18888,numéro,0,0,13,13
51717,encyclopedias,0,0,13,13
17581,artikeln,0,0,13,13
243,quale,1,13,0,13
2266,performance,2,3,10,13
25731,estudo,0,0,13,13
25689,об,0,0,13,13
36052,that's,0,0,13,13
26025,analysis,0,0,13,13
45029,όλα,0,0,13,13
24934,global,0,0,13,13
37314,diğer,0,0,13,13
52068,help,0,0,13,13
25182,بين,0,0,13,13
35334,registrados,0,0,13,13
7788,olan,0,0,13,13
7778,dock,0,0,13,13
41717,contributeurs,0,0,13,13
11918,alt,0,0,13,13
40697,licence,0,0,13,13
10354,moeder,0,0,13,13
41619,varios,0,0,13,13
14594,eğer,0,0,13,13
39864,próxima,0,0,13,13
16947,ψωμί,0,0,13,13
10651,tell,0,0,13,13
520,esse,2,4,9,13
16979,संख्या,0,0,13,13
35406,svenskspråkiga,0,0,13,13
39826,tarafından,0,0,13,13
7572,സ്മാർട്ട്,0,0,13,13
4043,magazine,2,1,12,13
41442,pan,0,0,13,13
36222,largest,0,0,13,13
29856,method,0,0,13,13
4392,कार्य,0,0,13,13
9165,über,0,0,13,13
4240,rather,0,0,13,13
1683,hanno,1,13,0,13
34498,tüm,0,0,13,13
21083,dieses,0,0,13,13
38232,vandalism,0,0,13,13
29344,mars,0,0,13,13
21974,mysql,0,0,13,13
33295,sí,0,0,13,13
49377,datos,0,0,13,13
41,ora,1,13,0,13
607,marion,2,1,12,13
43647,بالإنجليزية,0,0,13,13
43658,mère,0,0,13,13
8917,comer,0,0,13,13
13471,l'ensemble,0,0,13,13
3617,oltre,1,13,0,13
46729,vários,0,0,13,13
14278,हूं।,0,0,13,13
44412,எனது,0,0,13,13
9285,vänner,0,0,13,13
3083,extra,2,1,12,13
34530,biri,0,0,13,13
31968,فقط,0,0,13,13
43304,därför,0,0,13,13
5496,எனக்குத்,0,0,13,13
20794,morgen,0,0,13,13
8842,который,0,0,13,13
29225,zaman,0,0,13,13
49867,حتى,0,0,13,13
14525,чем,0,0,13,13
33297,voulez,0,0,13,13
49841,right,0,0,13,13
13030,sendo,0,0,13,13
1570,gmat,2,1,12,13
9076,parce,0,0,13,13
1568,dopo,1,13,0,13
43893,inteligentes,0,0,13,13
49002,common,0,0,13,13
1745,britannica.,2,3,10,13
12669,pão,0,0,13,13
19809,നിന്ന്,0,0,12,12
17285,wird,0,0,12,12
35528,informações,0,0,12,12
48482,trop,0,0,12,12
28724,pain,0,0,12,12
5280,grand,0,0,12,12
16531,действительно,0,0,12,12
39651,güzel,0,0,12,12
37292,terme,0,0,12,12
20957,stor,0,0,12,12
41248,ಓಹ್,0,0,12,12
48565,طريقة,0,0,12,12
27906,edits,0,0,12,12
38703,thank,0,0,12,12
23263,long,0,0,12,12
45032,plants,0,0,12,12
7478,artikler,0,0,12,12
865,dia,2,1,11,12
39895,encontro,0,0,12,12
36743,lakes,0,0,12,12
39786,होने,0,0,12,12
44954,statistics,0,0,12,12
7648,എന്നാൽ,0,0,12,12
47566,देने,0,0,12,12
34567,linguistiques,0,0,12,12
36257,varit,0,0,12,12
33305,después,0,0,12,12
49403,عبارة,0,0,12,12
37406,unidos,0,0,12,12
13990,mother,0,0,12,12
6209,mal,0,0,12,12
9170,सर्वर,0,0,12,12
41427,ile,0,0,12,12
46680,[nota,0,0,12,12
36758,хотите,0,0,12,12
26051,dig.,0,0,12,12
41380,σου,0,0,12,12
43649,poderia,0,0,12,12
29284,earth's,0,0,12,12
24990,fut,0,0,12,12
3224,heller,2,1,11,12
25794,nom,0,0,12,12
3415,pane,1,12,0,12
41189,muazzam,0,0,12,12
11103,proyectos,0,0,12,12
28530,afin,0,0,12,12
33523,വിക്കിപീഡിയയിലെ,0,0,12,12
177,casi,2,4,8,12
6908,souvent,0,0,12,12
45394,aquí,0,0,12,12
18013,الكلمات,0,0,12,12
12997,growth,0,0,12,12
48160,misin,0,0,12,12
987,pronuncia,2,11,1,12
50382,dieser,0,0,12,12
25256,वीडियो,0,0,12,12
5195,created,0,0,12,12
52229,δουλειά,0,0,12,12
18196,manière,0,0,12,12
51668,worden,0,0,12,12
3338,prima,1,12,0,12
18616,nem,0,0,12,12
21432,ευχαριστώ,0,0,12,12
31308,फिर,0,0,12,12
10710,favor,0,0,12,12
10867,should,0,0,12,12
13222,december,0,0,12,12
31687,مما,0,0,12,12
2997,tale,2,8,4,12
6684,nasıl,0,0,12,12
29029,algoritmos,0,0,12,12
1040,vale,2,4,8,12
31960,الآن,0,0,12,12
32632,வேண்டும்,0,0,12,12
34288,forms,0,0,12,12
28383,वेल्स,0,0,12,12
46189,जाते,0,0,12,12
45155,mayor,0,0,12,12
45161,άλλο,0,0,12,12
9240,स्रोत,0,0,12,12
32315,другие,0,0,12,12
23157,name,0,0,12,12
19190,sætning,0,0,12,12
21265,bom,0,0,12,12
41069,vrienden,0,0,12,12
9348,उपलब्ध,0,0,12,12
5026,മികച്ച,0,0,12,12
29165,idiomas,0,0,12,12
38623,zum,0,0,12,12
1441,primo,1,12,0,12
23860,جيدًا,0,0,12,12
25679,angle,0,0,12,12
228,conoscenza,1,12,0,12
17827,milhões,0,0,12,12
51661,redigeringar,0,0,12,12
49610,पृष्ठ,0,0,12,12
30273,comida,0,0,12,12
35779,eten,0,0,12,12
2039,prix,2,1,11,12
3400,completamente,2,6,6,12
31588,потому,0,0,12,12
80,ed,1,12,0,12
44053,tak,0,0,12,12
42525,twee,0,0,12,12
15876,उपयोगकर्ताओं,0,0,12,12
23690,stop,0,0,12,12
439,libro,2,7,5,12
40523,virkelig,0,0,12,12
47118,encyclopédie,0,0,12,12
37240,siger,0,0,12,12
27951,informatie,0,0,12,12
27047,ठीक,0,0,12,12
717,dai,1,12,0,12
12389,നമ്പർ,0,0,12,12
31808,കഴിയുന്ന,0,0,12,12
39475,dies,0,0,12,12
42950,lado,0,0,12,12
36676,sob,0,0,12,12
46139,теперь,0,0,12,12
34882,casos,0,0,12,12
33156,ചെയ്യാൻ,0,0,12,12
782,dici,1,12,0,12
10334,bidrag,0,0,12,12
6022,animals,0,0,12,12
24639,सॉफ्टवेयर,0,0,12,12
21928,जाने,0,0,12,12
9012,enquanto,0,0,12,12
42382,мы,0,0,12,12
32137,под,0,0,12,12
12024,upp,0,0,12,12
28840,vais,0,0,12,12
42348,concept,0,0,12,12
33107,cool,0,0,12,12
34009,leurs,0,0,12,12
28005,مقالات,0,0,12,12
14203,أفضل,0,0,12,12
12348,continue,0,0,12,12
33213,less,0,0,12,12
51251,du.,0,0,12,12
16014,auch,0,0,12,12
19990,mejor,0,0,12,12
26384,puedo,0,0,12,12
46792,issues,0,0,12,12
7942,généralement,0,0,12,12
9960,muchas,0,0,12,12
14066,links,0,0,12,12
12466,documentation,0,0,12,12
16305,تريد,0,0,12,12
15202,hayır,0,0,12,12
9879,unsupervised,0,0,12,12
34724,उन्हें,0,0,12,12
8056,techniques,0,0,12,12
8004,saying,0,0,12,12
105,tuo,1,12,0,12
47447,editorial,0,0,12,12
110,mentre,1,12,0,12
2492,ottuso,1,12,0,12
20885,നിങ്ങളോട്,0,0,12,12
14353,resultado,0,0,12,12
36302,disso,0,0,12,12
42109,også,0,0,12,12
41863,havde,0,0,12,12
43099,watch,0,0,12,12
36478,development,0,0,12,12
42955,इंटरनेट,0,0,12,12
8867,vinkel,0,0,12,12
46763,structure,0,0,12,12
8032,beaucoup,0,0,12,12
20882,cas,0,0,12,12
24506,немного,0,0,12,12
17744,langues,0,0,11,11
10095,حيث,0,0,11,11
10641,ശരിക്കും,0,0,11,11
32700,समुदाय,0,0,11,11
33649,querida,0,0,11,11
10176,written,0,0,11,11
2791,economist,2,1,10,11
11142,laten,0,0,11,11
2685,anni,1,11,0,11
29122,tot,0,0,11,11
7144,ಹೇಳಬಹುದು.,0,0,11,11
44586,فإن,0,0,11,11
32641,للغاية,0,0,11,11
35764,पूरी,0,0,11,11
27042,informations,0,0,11,11
3481,sotto,1,11,0,11
8461,depois,0,0,11,11
33862,würde,0,0,11,11
6994,travers,0,0,11,11
14913,ραντεβού,0,0,11,11
34493,mutter,0,0,11,11
28025,nombreux,0,0,11,11
11003,though,0,0,11,11
18267,لكن,0,0,11,11
28089,nein,0,0,11,11
2986,support,2,1,10,11
3555,youtube.,2,1,10,11
466,mai,2,8,3,11
2134,qualche,1,11,0,11
6743,nombreuses,0,0,11,11
6712,phase,0,0,11,11
712,quelle,2,5,6,11
46939,tack,0,0,11,11
9633,тебе,0,0,11,11
40615,இல்லை.,0,0,11,11
48251,யாரோ,0,0,11,11
27184,எண்,0,0,11,11
29420,kind,0,0,11,11
13289,உங்களிடம்,0,0,11,11
44575,class,0,0,11,11
44512,became,0,0,11,11
14394,mes,0,0,11,11
25519,did,0,0,11,11
3484,fine,2,9,2,11
11068,πραγματικά,0,0,11,11
10007,सुस्त,0,0,11,11
27471,l'article,0,0,11,11
50182,quality,0,0,11,11
28567,zorgen,0,0,11,11
8576,அதாவது,0,0,11,11
43905,medan,0,0,11,11
6819,ഞങ്ങൾ,0,0,11,11
46842,toen,0,0,11,11
11044,tror,0,0,11,11
29441,rna,0,0,11,11
35908,ನಂತರ,0,0,11,11
47852,cuenta,0,0,11,11
33694,zich,0,0,11,11
2798,contenuti,1,11,0,11
948,po,1,11,0,11
12756,nee,0,0,11,11
3236,enorme,2,3,8,11
50322,conditions,0,0,11,11
44280,enligt,0,0,11,11
10478,berätta,0,0,11,11
15979,संस्करणों,0,0,11,11
35412,aus,0,0,11,11
41450,şeyi,0,0,11,11
28943,gold,0,0,11,11
11634,règles,0,0,11,11
798,altro,1,11,0,11
2363,pattern,2,6,5,11
13741,tres,0,0,11,11
13731,biases,0,0,11,11
15925,परियोजनाओं,0,0,11,11
7567,zal,0,0,11,11
43338,realizado,0,0,11,11
41595,discussão,0,0,11,11
44938,कम,0,0,11,11
26529,أنت,0,0,11,11
3211,me.,2,3,8,11
26356,après,0,0,11,11
2463,vengono,1,11,0,11
35261,altın,0,0,11,11
7900,day,0,0,11,11
41736,researchers,0,0,11,11
9037,red,0,0,11,11
9042,الكلمة,0,0,11,11
26248,مقال,0,0,11,11
10409,obtus,0,0,11,11
26240,هنا,0,0,11,11
2525,microsoft,2,2,9,11
50444,देता,0,0,11,11
16666,года.,0,0,11,11
3072,toefl,2,1,10,11
41684,سبيل,0,0,11,11
14572,cc-by-sa,0,0,11,11
27964,représentation,0,0,11,11
8284,परेशान,0,0,11,11
17213,ಜೌಗು,0,0,11,11
47112,internal,0,0,11,11
26359,real,0,0,11,11
44402,കൂടുതൽ,0,0,11,11
7361,sujet,0,0,11,11
7356,ನಾರ್ಸಿಸಾ,0,0,11,11
25767,problems,0,0,11,11
35681,burada,0,0,11,11
9313,great,0,0,11,11
41047,करें,0,0,11,11
44714,estudio,0,0,11,11
9354,atrocious,0,0,11,11
50772,normal,0,0,11,11
41024,principal,0,0,11,11
17668,जानते,0,0,11,11
12121,stump,0,0,11,11
3536,national,2,1,10,11
43827,παράδειγμα,0,0,11,11
28770,toutes,0,0,11,11
43707,استخدام,0,0,11,11
10322,edición,0,0,11,11
15614,personne,0,0,11,11
50814,entanto,0,0,11,11
41323,haciendo,0,0,11,11
50958,toujours,0,0,11,11
13692,climate,0,0,11,11
9853,ni,0,0,11,11
50964,april,0,0,11,11
33580,मूल,0,0,11,11
30071,أيضًا,0,0,11,11
11424,fueron,0,0,11,11
34962,ditt,0,0,11,11
34674,maneira,0,0,11,11
2622,dvd,2,3,8,11
33123,soit,0,0,11,11
42412,grupo,0,0,11,11
12596,usually,0,0,11,11
15529,जानकारी,0,0,11,11
3691,proprio,1,11,0,11
45608,شيئًا,0,0,11,11
1988,algoritmo,2,3,8,11
20748,слов,0,0,11,11
39221,सामग्री,0,0,11,11
6530,देख,0,0,11,11
37280,perform,0,0,11,11
22269,beispiel,0,0,11,11
1365,suoi,1,11,0,11
40090,permet,0,0,11,11
37435,gaan,0,0,11,11
30764,tun,0,0,11,11
31121,hele,0,0,11,11
36971,ஓ,0,0,11,11
22261,must,0,0,11,11
4094,dato,2,8,3,11
6244,मदद,0,0,11,11
5774,bist,0,0,11,11
51392,reste,0,0,11,11
48491,часто,0,0,11,11
22693,रोटी,0,0,11,11
40346,تعني,0,0,11,11
1969,nei,1,11,0,11
40062,மேலும்,0,0,11,11
31037,aqui,0,0,11,11
18696,एवं,0,0,11,11
31408,around,0,0,11,11
5034,diese,0,0,11,11
30668,food,0,0,11,11
39687,modifier,0,0,11,11
1883,argomenti,1,11,0,11
39816,один,0,0,11,11
1481,melli,2,1,10,11
48677,pedir,0,0,11,11
22423,matter,0,0,11,11
23909,cerca,0,0,11,11
49786,narcissus,0,0,11,11
39803,además,0,0,11,11
23915,cependant,0,0,11,11
1170,michael,2,1,10,11
32386,grymt,0,0,11,11
32392,sen,0,0,11,11
49017,harika,0,0,11,11
38487,tip,0,0,11,11
36239,വാക്കുകൾ,0,0,11,11
31559,மூலம்,0,0,11,11
20717,wörter,0,0,11,11
37944,having,0,0,11,11
38503,ولكن,0,0,11,11
39075,..,0,0,11,11
1936,natura,2,6,5,11
39025,உங்களை,0,0,11,11
39088,pesquisa,0,0,11,11
1494,[...],2,1,10,11
4562,ويلز,0,0,11,11
19377,βικιπαίδεια,0,0,11,11
30546,alexa,0,0,11,11
25067,mig.,0,0,11,11
1561,processo,2,6,5,11
24596,score,0,0,11,11
5949,través,0,0,11,11
31881,обучения,0,0,11,11
5350,websites,0,0,11,11
18542,best,0,0,11,11
37568,várias,0,0,11,11
4852,métodos,0,0,11,11
37562,यहाँ,0,0,11,11
21034,instead,0,0,11,11
23703,samma,0,0,11,11
30891,modèle,0,0,11,11
1864,consenso,2,2,9,11
20521,சொல்ல,0,0,11,11
4863,innehåll,0,0,11,11
40477,français,0,0,11,11
22036,approach,0,0,11,11
40508,πεις,0,0,11,11
36308,gjort,0,0,11,11
24460,dictionary,0,0,11,11
19333,few,0,0,11,11
23325,थे।,0,0,11,11
40408,avait,0,0,11,11
48837,care,0,0,11,11
21883,enero,0,0,11,11
37671,tidigare,0,0,11,11
38958,siempre,0,0,11,11
1423,everything,2,1,10,11
19719,prendre,0,0,11,11
51327,here,0,0,11,11
1772,international,2,1,10,11
36175,eksempel,0,0,11,11
35120,मुख्य,0,0,10,10
44444,trouve,0,0,10,10
39496,millones,0,0,10,10
35166,étaient,0,0,10,10
41242,വിക്കിപീഡിയയുടെ,0,0,10,10
7497,versões,0,0,10,10
41317,l'objet,0,0,10,10
6266,países,0,0,10,10
34336,استخدامها,0,0,10,10
15959,вместо,0,0,10,10
44162,നന്നായി,0,0,10,10
17242,us,0,0,10,10
41470,feito,0,0,10,10
3503,amici,1,10,0,10
901,giorno,1,10,0,10
36196,gracias,0,0,10,10
29992,denk,0,0,10,10
48936,இங்கே,0,0,10,10
25968,final,0,0,10,10
21750,mis,0,0,10,10
27160,negative,0,0,10,10
34206,engelska,0,0,10,10
4077,state,2,5,5,10
17120,rigtig,0,0,10,10
30053,processus,0,0,10,10
36343,too,0,0,10,10
46899,लगभग,0,0,10,10
27965,création,0,0,10,10
33541,mein,0,0,10,10
9814,ki,0,0,10,10
8099,الأخرى,0,0,10,10
35463,three,0,0,10,10
24998,അങ്ങനെ,0,0,10,10
1125,l'enciclopedia,2,9,1,10
46118,tinha,0,0,10,10
49918,الذكية,0,0,10,10
12932,källor,0,0,10,10
19433,nicht.,0,0,10,10
50792,ist.,0,0,10,10
9715,تحرير,0,0,10,10
38912,came,0,0,10,10
29838,november,0,0,10,10
51619,waar,0,0,10,10
38753,medical,0,0,10,10
7929,உங்களுக்குத்,0,0,10,10
7809,जिन्हें,0,0,10,10
24099,बात,0,0,10,10
21165,نيوبيديا,0,0,10,10
43672,aunque,0,0,10,10
36809,которую,0,0,10,10
21227,έτσι,0,0,10,10
6207,منذ,0,0,10,10
29217,m,0,0,10,10
36859,serait,0,0,10,10
27460,कहा,0,0,10,10
13549,hommes,0,0,10,10
26455,istället,0,0,10,10
51292,communauté,0,0,10,10
36664,مرة,0,0,10,10
46590,что-то,0,0,10,10
36712,ಬಳಸಬಹುದಾದ,0,0,10,10
50656,vue,0,0,10,10
27365,tengo,0,0,10,10
9106,değil,0,0,10,10
16403,информации,0,0,10,10
24797,history,0,0,10,10
1223,scientifiche,1,10,0,10
41864,häpnadsväckande,0,0,10,10
20961,mere,0,0,10,10
29260,detection,0,0,10,10
13836,होगा,0,0,10,10
2887,usando,2,2,8,10
26363,ancak,0,0,10,10
49859,हालाँकि,0,0,10,10
2851,reti,1,10,0,10
26458,afschuwelijk,0,0,10,10
16645,represented,0,0,10,10
16110,υπάρχει,0,0,10,10
351,usato,1,10,0,10
41635,gehen,0,0,10,10
27530,certeza,0,0,10,10
29068,φράση,0,0,10,10
50584,участники,0,0,10,10
16806,nouvelle,0,0,10,10
27217,gang,0,0,10,10
35381,questions,0,0,10,10
32866,خلال,0,0,10,10
9984,almost,0,0,10,10
16858,можно,0,0,10,10
39032,അടുത്ത,0,0,10,10
34377,வேறு,0,0,10,10
34372,cuya,0,0,10,10
13076,dollars,0,0,10,10
28635,nada,0,0,10,10
36886,why,0,0,10,10
1932,fair,2,2,8,10
27252,layer,0,0,10,10
20767,അവൻ,0,0,10,10
29206,lack,0,0,10,10
4100,obama,2,1,9,10
16663,l’idée,0,0,10,10
50608,ഉപയോഗിക്കാൻ,0,0,10,10
2943,hg,2,1,9,10
38657,sure,0,0,10,10
26461,வேலை,0,0,10,10
1642,frasi,1,10,0,10
5478,wrote,0,0,10,10
20787,тебя,0,0,10,10
23982,चिंता,0,0,10,10
43856,neural,0,0,10,10
49041,tog,0,0,10,10
46404,nur,0,0,10,10
9494,तुम,0,0,10,10
7651,atmosphere,0,0,10,10
40000,acesso,0,0,10,10
11646,nas,0,0,10,10
47191,own,0,0,10,10
40294,is.,0,0,10,10
45114,விரும்பினால்,0,0,10,10
3416,studio,1,10,0,10
28378,şimdi,0,0,10,10
11444,दी,0,0,10,10
45164,search,0,0,10,10
2683,pizza,2,1,9,10
10585,بعد,0,0,10,10
11755,दिन,0,0,10,10
36370,во,0,0,10,10
28443,англ.,0,0,10,10
10615,janvier,0,0,10,10
33878,learned,0,0,10,10
2172,narcisse,2,1,9,10
45247,يكون,0,0,10,10
11222,सम्बंधित,0,0,10,10
20079,toute,0,0,10,10
49579,maioria,0,0,10,10
50341,cansado,0,0,10,10
37783,ಬ್ರೆಡ್,0,0,10,10
2220,golden,2,1,9,10
42290,ويكي,0,0,10,10
48402,contributions,0,0,10,10
37875,ऑनलाइन,0,0,10,10
24740,مقالة,0,0,10,10
8500,πώς,0,0,10,10
22492,têm,0,0,10,10
170,guardian,2,3,7,10
46947,തന്നെ,0,0,10,10
50024,php,0,0,10,10
4705,reference,0,0,10,10
11591,demander,0,0,10,10
2048,volta,1,10,0,10
50340,merci,0,0,10,10
28370,både,0,0,10,10
5793,onder,0,0,10,10
48705,outer,0,0,10,10
4338,body,0,0,10,10
30519,मिला,0,0,10,10
40434,varför,0,0,10,10
18305,philosophie,0,0,10,10
20286,preocupe,0,0,10,10
26957,μητέρα,0,0,10,10
42413,enkele,0,0,10,10
37500,निर्माण,0,0,10,10
33760,plaats,0,0,10,10
18363,pendant,0,0,10,10
1828,output,2,2,8,10
462,qual,2,3,7,10
18387,നന്ദി,0,0,10,10
4012,today,2,1,9,10
4404,nouveaux,0,0,10,10
23004,día,0,0,10,10
30403,ಕೆಲವು,0,0,10,10
113,programming,2,1,9,10
473,un'enciclopedia,1,10,0,10
11160,liv,0,0,10,10
45445,sina,0,0,10,10
24499,चाहता,0,0,10,10
27003,свою,0,0,10,10
36508,inglesa,0,0,10,10
35909,некоторые,0,0,10,10
3326,d'oro,1,10,0,10
25399,order,0,0,10,10
33109,view,0,0,10,10
2615,propose,2,1,9,10
18618,جميع,0,0,10,10
453,award,2,1,9,10
774,poi,1,10,0,10
45427,start,0,0,10,10
40631,अंत,0,0,10,10
45443,outro,0,0,10,10
20340,stedet,0,0,10,10
18962,communautés,0,0,10,10
7904,deras,0,0,10,10
38031,covered,0,0,10,10
2707,esempi,1,10,0,10
17501,είστε,0,0,10,10
26676,intelligent,0,0,10,10
8259,développement,0,0,10,10
19062,можешь,0,0,10,10
442,stesso,1,10,0,10
14859,मेरी,0,0,10,10
2566,webby,2,2,8,10
8539,स्थिति,0,0,10,10
23366,energy,0,0,10,10
17691,imagens,0,0,10,10
27146,بدلاً,0,0,10,10
12311,fondation,0,0,10,10
10254,ಬಯಸಿದರೆ,0,0,10,10
6414,premier,0,0,10,10
6397,πιο,0,0,10,10
44734,werk,0,0,10,10
35641,teşekkür,0,0,10,10
35094,ob,0,0,10,10
7390,veces,0,0,10,10
156,narcisa.,2,1,9,10
28221,வேண்டும்.,0,0,10,10
47832,ಪದವನ್ನು,0,0,10,10
25789,वेब,0,0,10,10
38049,facebook,0,0,10,10
15806,i'll,0,0,10,10
15883,network,0,0,10,10
41086,fras,0,0,10,10
28328,encore,0,0,10,10
23462,möte,0,0,10,10
17844,பயன்படுத்தக்கூடிய,0,0,10,10
42280,μαζί,0,0,10,10
50980,technology,0,0,10,10
12392,viel,0,0,10,10
44861,france,0,0,10,10
3155,seria,2,1,9,10
36551,நன்றி,0,0,10,10
42269,dados,0,0,10,10
44832,آسف,0,0,10,10
33,sarebbe,1,10,0,10
12388,பின்னர்,0,0,10,10
29633,isso.,0,0,10,10
37946,social,0,0,10,10
25066,tienes,0,0,10,10
14951,έξυπνη,0,0,10,10
3208,termini,1,10,0,10
25782,ಅದರ,0,0,10,10
2298,ricerche,1,10,0,10
44824,முடியுமா,0,0,10,10
15910,ils,0,0,10,10
5663,forskare,0,0,9,9
48801,τρόπος,0,0,9,9
32017,described,0,0,9,9
32178,vou,0,0,9,9
26960,ಯಾವುದೇ,0,0,9,9
34726,veux,0,0,9,9
46971,ip,0,0,9,9
2733,barack,2,1,8,9
47117,ओर,0,0,9,9
20243,alemán,0,0,9,9
6667,available,0,0,9,9
38868,കഴിയും.,0,0,9,9
34645,united,0,0,9,9
14747,third,0,0,9,9
15445,traag,0,0,9,9
49133,المحتوى,0,0,9,9
5658,typically,0,0,9,9
1788,meno,1,9,0,9
42604,hand,0,0,9,9
36530,especially,0,0,9,9
46722,которое,0,0,9,9
14946,disponible,0,0,9,9
2780,neurali,1,9,0,9
31140,i've,0,0,9,9
14283,vision,0,0,9,9
48877,लगता,0,0,9,9
14309,wikipediaartiklar,0,0,9,9
14942,seguro,0,0,9,9
43183,living,0,0,9,9
33174,situação,0,0,9,9
49007,seni,0,0,9,9
14952,fazla,0,0,9,9
29467,subject,0,0,9,9
20451,lidt,0,0,9,9
27081,со,0,0,9,9
24324,ഉള്ള,0,0,9,9
8625,permite,0,0,9,9
42691,møde,0,0,9,9
43361,feliz,0,0,9,9
29435,voir,0,0,9,9
14841,siento,0,0,9,9
48880,अद्भुत,0,0,9,9
697,factor,2,3,6,9
20404,wiki.,0,0,9,9
14692,latin,0,0,9,9
20415,date,0,0,9,9
43003,designed,0,0,9,9
27060,των,0,0,9,9
14197,let's,0,0,9,9
20586,anne,0,0,9,9
42703,juste,0,0,9,9
2764,potrebbe,1,9,0,9
31116,μερικές,0,0,9,9
25286,اليوم,0,0,9,9
13981,kanal,0,0,9,9
37305,wide,0,0,9,9
4742,ليس,0,0,9,9
33703,ponto,0,0,9,9
3440,questi,1,9,0,9
11824,linux,0,0,9,9
10424,qu'elle,0,0,9,9
10426,leven,0,0,9,9
51937,cet,0,0,9,9
533,un'altra,1,9,0,9
10452,persoon,0,0,9,9
51418,الرغم,0,0,9,9
37850,politique,0,0,9,9
4322,started,0,0,9,9
22505,சொல்லலாம்,0,0,9,9
22540,applications,0,0,9,9
44816,traditional,0,0,9,9
10325,இருக்க,0,0,9,9
45108,land,0,0,9,9
44597,raison,0,0,9,9
22116,jemanden,0,0,9,9
38084,ஏன்,0,0,9,9
44572,still,0,0,9,9
22158,നാർസിസ,0,0,9,9
33637,things,0,0,9,9
4796,данных,0,0,9,9
51922,dess,0,0,9,9
4746,போல,0,0,9,9
10115,фраза,0,0,9,9
12200,författarna,0,0,9,9
45982,erreurs,0,0,9,9
44683,avant,0,0,9,9
28231,moi,0,0,9,9
45867,palo,0,0,9,9
33713,situación,0,0,9,9
37758,bots,0,0,9,9
31462,avoir,0,0,9,9
45502,versiones,0,0,9,9
4481,warum,0,0,9,9
45447,s'il,0,0,9,9
10683,program,0,0,9,9
22895,vraagt,0,0,9,9
45642,கட்டுரைகள்,0,0,9,9
45500,licença,0,0,9,9
33765,sætninger,0,0,9,9
31616,better,0,0,9,9
4456,fortælle,0,0,9,9
10887,plant,0,0,9,9
4432,раз,0,0,9,9
22963,им,0,0,9,9
37507,जाना,0,0,9,9
31656,где,0,0,9,9
37482,estupenda,0,0,9,9
22819,kunde,0,0,9,9
45720,flora,0,0,9,9
45685,waarom,0,0,9,9
33907,mij,0,0,9,9
11397,bajo,0,0,9,9
33897,ω,0,0,9,9
37445,إن,0,0,9,9
45222,υπέροχο,0,0,9,9
1444,sue,2,6,3,9
28469,страниц,0,0,9,9
49773,/,0,0,9,9
22720,machines,0,0,9,9
22721,esa,0,0,9,9
11156,estos,0,0,9,9
31589,personen,0,0,9,9
33838,aos,0,0,9,9
11071,ഉദാഹരണത്തിന്,0,0,9,9
33618,svenska,0,0,9,9
12355,بها,0,0,9,9
13915,этих,0,0,9,9
27614,تعرف,0,0,9,9
38626,physical,0,0,9,9
49845,pourquoi,0,0,9,9
67,ellie,2,1,8,9
27506,तरीका,0,0,9,9
5196,ചെയ്യുന്നു.,0,0,9,9
27580,имеет,0,0,9,9
44004,average,0,0,9,9
13432,echter,0,0,9,9
44011,público,0,0,9,9
13186,அற்புதமான,0,0,9,9
13174,zeggen.,0,0,9,9
52207,usado,0,0,9,9
397,vita,1,9,0,9
49303,mathematical,0,0,9,9
21298,ಇನ್ನೊಂದು,0,0,9,9
5236,. million,0,0,9,9
404,licenza,1,9,0,9
2901,chiedere,1,9,0,9
46651,vetenskapliga,0,0,9,9
43529,pas.,0,0,9,9
13874,anstelle,0,0,9,9
24151,எந்த,0,0,9,9
2898,link,2,2,7,9
34564,critiques,0,0,9,9
24143,sagen.,0,0,9,9
46452,falta,0,0,9,9
5345,الكثير,0,0,9,9
1664,quella,1,9,0,9
52013,stumpf,0,0,9,9
2936,oxford,2,1,8,9
13524,bien.,0,0,9,9
9367,créer,0,0,9,9
21576,interview,0,0,9,9
23904,vidéo,0,0,9,9
1316,italiano,2,3,6,9
23583,slim,0,0,9,9
3520,viene,1,9,0,9
50527,ask,0,0,9,9
21975,languages,0,0,9,9
44438,sitios,0,0,9,9
9953,этот,0,0,9,9
44445,organização,0,0,9,9
50502,signal,0,0,9,9
46159,hasta,0,0,9,9
9973,logiciel,0,0,9,9
49451,become,0,0,9,9
28085,अवयवों,0,0,9,9
9985,ಹೇಳಲು,0,0,9,9
28097,undskyld,0,0,9,9
12383,நன்றி.,0,0,9,9
414,grado,2,8,1,9
38264,areas,0,0,9,9
3033,io,1,9,0,9
9800,function,0,0,9,9
34352,sitt,0,0,9,9
36938,تعديل,0,0,9,9
12891,gebruikt,0,0,9,9
15516,क्यों,0,0,9,9
28971,قبل,0,0,9,9
5039,моя,0,0,9,9
27840,muchos,0,0,9,9
34240,l'air,0,0,9,9
44246,næste,0,0,9,9
46171,moins,0,0,9,9
38325,projects,0,0,9,9
31399,igen,0,0,9,9
9865,fontes,0,0,9,9
40,già,1,9,0,9
28976,publicados,0,0,9,9
7621,deep,0,0,9,9
26852,look,0,0,9,9
36336,principales,0,0,9,9
29732,eran,0,0,9,9
36050,descartes,0,0,9,9
16133,désolé,0,0,9,9
25715,application,0,0,9,9
818,c'è,1,9,0,9
16155,held,0,0,9,9
7979,didn't,0,0,9,9
25096,mina,0,0,9,9
822,riviste,1,9,0,9
1050,logo,2,1,8,9
19152,time.,0,0,9,9
40038,published,0,0,9,9
47422,været,0,0,9,9
40024,नाम,0,0,9,9
7945,zegt,0,0,9,9
930,catch-.,2,1,8,9
48672,nupedia.,0,0,9,9
26445,passe,0,0,9,9
47858,policy,0,0,9,9
33030,bidragsgivare,0,0,9,9
48159,χρυσό,0,0,9,9
32604,mine,0,0,9,9
2060,mondo,1,9,0,9
2192,intelligence,2,1,8,9
39464,improve,0,0,9,9
32419,vídeo,0,0,9,9
32599,june,0,0,9,9
33069,ellos,0,0,9,9
48083,langue,0,0,9,9
15987,havia,0,0,9,9
215,dire.,2,3,6,9
19958,जाती,0,0,9,9
17954,association,0,0,9,9
18938,जनवरी,0,0,9,9
32206,своей,0,0,9,9
299,fu,1,9,0,9
40165,ಇಲ್ಲಿ,0,0,9,9
36033,tag,0,0,9,9
30637,ibland,0,0,9,9
30205,nästa,0,0,9,9
51132,am,0,0,9,9
32311,لأي,0,0,9,9
6368,ஆம்,0,0,9,9
16989,report,0,0,9,9
30031,хлеб,0,0,9,9
26048,थी।,0,0,9,9
2362,milioni,1,9,0,9
32804,overspoeld,0,0,9,9
50105,hvorfor,0,0,9,9
16631,interest,0,0,9,9
16641,klotter,0,0,9,9
30813,दोस्तों,0,0,9,9
6233,image,0,0,9,9
19262,நாங்கள்,0,0,9,9
16965,disputas,0,0,9,9
16698,ಕ್ಷಮಿಸಿ,0,0,9,9
16705,ಚಿನ್ನದ,0,0,9,9
6247,yerine,0,0,9,9
41509,لديك,0,0,9,9
39793,தங்க,0,0,9,9
26228,മലയാളം,0,0,9,9
41637,parfois,0,0,9,9
26253,states,0,0,9,9
41343,bonne,0,0,9,9
1966,seigenthaler,2,2,7,9
1970,group,2,1,8,9
2495,volte,1,9,0,9
48466,способ,0,0,9,9
41957,विशेष,0,0,9,9
25821,gentil,0,0,9,9
41910,incrível,0,0,9,9
26409,दूसरे,0,0,9,9
1067,marian.,2,1,8,9
3896,premio,2,7,2,9
7883,seen,0,0,9,9
25881,creación,0,0,9,9
39942,topic,0,0,9,9
19835,ಏಕೆಂದರೆ,0,0,9,9
30762,quelques,0,0,9,9
25001,ഇവിടെ,0,0,9,9
35536,ked,0,0,9,9
17256,algorithmes,0,0,9,9
17246,şekilde,0,0,9,9
39458,inhoud,0,0,9,9
7311,izin,0,0,9,9
40679,fler,0,0,9,9
310,rete,1,9,0,9
36403,manger,0,0,9,9
29610,verkligen,0,0,9,9
26756,dices,0,0,9,9
6000,நல்ல,0,0,9,9
25335,i̇ngilizce,0,0,9,9
35973,करें।,0,0,9,9
26753,serveurs,0,0,9,9
47207,olmak,0,0,9,9
25313,addition,0,0,9,9
18323,lieu,0,0,9,9
33116,लोग,0,0,9,9
39389,bort,0,0,9,9
40465,diz,0,0,9,9
18164,anyone,0,0,9,9
42403,ஏதாவது,0,0,9,9
26691,beste,0,0,9,9
2126,posto,1,9,0,9
51792,आवश्यकता,0,0,9,9
40429,debido,0,0,9,9
2592,sta,1,9,0,9
42411,முடியும்,0,0,9,9
25326,smarta,0,0,9,9
8227,maior,0,0,9,9
42327,وهذا,0,0,9,9
2065,regole,1,9,0,9
40553,policies,0,0,9,9
2144,ciò,1,9,0,9
18425,ಯಾರನ್ನಾದರೂ,0,0,9,9
8322,ge,0,0,9,9
18142,ما.,0,0,9,9
40373,site.,0,0,9,9
30543,let,0,0,9,9
40709,arbete,0,0,9,9
12593,étant,0,0,8,8
21783,alterações,0,0,8,8
19299,நர்சிசா,0,0,8,8
45462,सोने,0,0,8,8
1983,&,2,1,7,8
33736,genetic,0,0,8,8
37579,increasing,0,0,8,8
44457,gemaakt,0,0,8,8
2137,cultura,2,3,5,8
6335,cache,0,0,8,8
21810,ಕೆಲಸ,0,0,8,8
12476,വാചകം,0,0,8,8
47723,çünkü,0,0,8,8
6589,لو,0,0,8,8
12773,प्रकार,0,0,8,8
17369,daily,0,0,8,8
34134,recherche,0,0,8,8
44256,गयी,0,0,8,8
7549,grâce,0,0,8,8
31910,fonctionnement,0,0,8,8
35607,pourrait,0,0,8,8
32563,early,0,0,8,8
1286,oro,2,1,7,8
4917,θέλω,0,0,8,8
37076,scientific,0,0,8,8
38214,उसे,0,0,8,8
18281,ആണ്,0,0,8,8
46145,ಧನ್ಯವಾದಗಳು.,0,0,8,8
23679,عدد,0,0,8,8
44439,ας,0,0,8,8
36150,neurons,0,0,8,8
25905,misschien,0,0,8,8
30066,pensar,0,0,8,8
21900,academic,0,0,8,8
28046,e.g.,0,0,8,8
51507,βίντεο,0,0,8,8
39913,योगदानकर्ता,0,0,8,8
23727,dedos,0,0,8,8
49949,saber,0,0,8,8
4883,ರೆಂಡೆಜ್ವಸ್,0,0,8,8
51377,будто,0,0,8,8
6607,zeker,0,0,8,8
6633,modelos,0,0,8,8
47744,முடியாது,0,0,8,8
30550,الذين,0,0,8,8
12822,sabe,0,0,8,8
6279,d'être,0,0,8,8
36237,видео,0,0,8,8
24905,approximately,0,0,8,8
28630,top,0,0,8,8
9641,പദം,0,0,8,8
38463,videon,0,0,8,8
40563,kanske,0,0,8,8
9623,yo,0,0,8,8
6682,لدي,0,0,8,8
16908,control,0,0,8,8
2392,ogni,1,8,0,8
21532,человека,0,0,8,8
15528,results,0,0,8,8
13141,क्षमा,0,0,8,8
47624,quero,0,0,8,8
35405,அதைப்,0,0,8,8
16883,laquelle,0,0,8,8
19535,volgende,0,0,8,8
38531,enlaces,0,0,8,8
3377,avere,1,8,0,8
24893,ताकि,0,0,8,8
44009,guld,0,0,8,8
26186,تفعل,0,0,8,8
27630,rosenzweig,0,0,8,8
13221,smarte,0,0,8,8
56,infatti,1,8,0,8
35366,rate,0,0,8,8
52204,maddelerin,0,0,8,8
44098,ಎಂಬ,0,0,8,8
38448,dream,0,0,8,8
10817,sorry.,0,0,8,8
26087,εκεί,0,0,8,8
3354,confuso,2,2,6,8
17106,просто,0,0,8,8
32488,term,0,0,8,8
38359,humaine,0,0,8,8
32767,κάνω,0,0,8,8
6271,peut-être,0,0,8,8
24915,okay,0,0,8,8
6269,brot,0,0,8,8
12902,höflich,0,0,8,8
27812,கொடூரமான,0,0,8,8
44191,без,0,0,8,8
47672,lige,0,0,8,8
3037,sapere,2,7,1,8
9662,ναρκίσσα,0,0,8,8
17033,voiture,0,0,8,8
32839,regression,0,0,8,8
45548,много,0,0,8,8
49321,μου.,0,0,8,8
19492,हमेशा,0,0,8,8
3548,liste,2,1,7,8
21612,loss,0,0,8,8
41487,l'un,0,0,8,8
18349,section,0,0,8,8
610,acceso,2,3,5,8
52208,denna,0,0,8,8
13032,  ,0,0,8,8
47770,¿cómo,0,0,8,8
11031,വാക്ക്,0,0,8,8
51381,самых,0,0,8,8
10640,हुए,0,0,8,8
45263,أستطيع,0,0,8,8
45792,weather,0,0,8,8
17905,أريد,0,0,8,8
2224,fonti,1,8,0,8
30266,sadece,0,0,8,8
3942,principalmente,2,1,7,8
17840,extinction,0,0,8,8
18752,أنها,0,0,8,8
44930,första,0,0,8,8
953,situazione,1,8,0,8
22717,fordi,0,0,8,8
10396,hans,0,0,8,8
37893,கேட்க,0,0,8,8
40906,सहयोग,0,0,8,8
37897,erros,0,0,8,8
47936,elles,0,0,8,8
22379,tais,0,0,8,8
31544,asking,0,0,8,8
6554,википедии.,0,0,8,8
17797,लोगों,0,0,8,8
1049,commons.,2,1,7,8
17769,kullanabileceğiniz,0,0,8,8
22718,inundado,0,0,8,8
30191,vissa,0,0,8,8
51018,sluggish,0,0,8,8
18714,hennes,0,0,8,8
36045,ее,0,0,8,8
2218,libera,1,8,0,8
48394,بواسطة,0,0,8,8
40240,unique,0,0,8,8
35830,таких,0,0,8,8
3409,artificiale,1,8,0,8
31782,animal,0,0,8,8
25507,choses,0,0,8,8
49592,artiklar.,0,0,8,8
18031,parmi,0,0,8,8
37410,novos,0,0,8,8
52109,üzgünüm,0,0,8,8
40784,μετά,0,0,8,8
35849,críticas,0,0,8,8
512,forte,2,7,1,8
35863,μπορεί,0,0,8,8
36014,المثال,0,0,8,8
979,sé,2,3,5,8
6498,языковых,0,0,8,8
18837,आया,0,0,8,8
51045,säker,0,0,8,8
4036,casa.,2,3,5,8
11312,n'a,0,0,8,8
23123,arbeta,0,0,8,8
3296,fosse,2,6,2,8
28705,god,0,0,8,8
48038,bueno,0,0,8,8
25439,bli,0,0,8,8
47998,laws,0,0,8,8
11639,lang,0,0,8,8
45754,спасибо,0,0,8,8
1495,gran,2,2,6,8
22290,всех,0,0,8,8
2307,tramite,1,8,0,8
28250,sea,0,0,8,8
22769,கனவு,0,0,8,8
36132,στον,0,0,8,8
47810,ويكيميديا,0,0,8,8
31489,maddeleri,0,0,8,8
31845,أكبر,0,0,8,8
35654,vid,0,0,8,8
2078,statistica,1,8,0,8
17495,ലേഖനം,0,0,8,8
10660,area,0,0,8,8
50386,घर,0,0,8,8
4842,നിങ്ങൾ‌ക്ക്,0,0,8,8
44567,mientras,0,0,8,8
48200,പുതിയ,0,0,8,8
46061,ரொட்டி,0,0,8,8
28105,सच,0,0,8,8
22783,etc.,0,0,8,8
37637,καλά,0,0,8,8
2293,normalmente,2,2,6,8
19214,current,0,0,8,8
4532,referência,0,0,8,8
6763,benim,0,0,8,8
11381,إنه,0,0,8,8
10681,പോലെ,0,0,8,8
7421,naam,0,0,8,8
44523,car,0,0,8,8
12405,smaller,0,0,8,8
22035,സ്വയം,0,0,8,8
1524,cluster,2,2,6,8
40022,influence,0,0,8,8
10109,andrew,0,0,8,8
38012,leren,0,0,8,8
11997,εάν,0,0,8,8
22280,conjunto,0,0,8,8
22275,дела,0,0,8,8
17718,trained,0,0,8,8
35714,ml,0,0,8,8
32335,tijd,0,0,8,8
36081,धन्यवाद,0,0,8,8
4763,λίγο,0,0,8,8
25107,эти,0,0,8,8
10241,ക്യാച്ച്,0,0,8,8
37241,past,0,0,8,8
16792,trois,0,0,8,8
44703,всего,0,0,8,8
33826,больше,0,0,8,8
28486,ago,0,0,8,8
38015,आज,0,0,8,8
17643,bruger,0,0,8,8
51004,என்னால்,0,0,8,8
41055,нарцисса,0,0,8,8
30117,vu,0,0,8,8
4770,kunnen,0,0,8,8
12218,rêve,0,0,8,8
25419,ದೌರ್ಜನ್ಯ,0,0,8,8
37677,புதிய,0,0,8,8
23438,vertellen,0,0,8,8
18207,cadre,0,0,8,8
16800,lost,0,0,8,8
52000,dank,0,0,8,8
20730,universidade,0,0,8,8
38910,sûr,0,0,8,8
8194,nya,0,0,8,8
5441,ऑफ़,0,0,8,8
27284,स्थापना,0,0,8,8
46679,against,0,0,8,8
24223,oversvømmet,0,0,8,8
19924,étude,0,0,8,8
39528,bei,0,0,8,8
14042,بما,0,0,8,8
50179,mange,0,0,8,8
14061,الشخص,0,0,8,8
46872,ज्यादा,0,0,8,8
15779,വലിയ,0,0,8,8
24182,சொற்கள்,0,0,8,8
27271,अक्सर,0,0,8,8
1750,logic,2,1,7,8
20917,variations,0,0,8,8
8256,सामान्य,0,0,8,8
43110,onlara,0,0,8,8
9035,crear,0,0,8,8
14089,primeira,0,0,8,8
14098,grausam,0,0,8,8
43395,lunch,0,0,8,8
46863,ಸಂಖ್ಯೆ,0,0,8,8
16274,ekmek,0,0,8,8
8521,universidad,0,0,8,8
26698,últimos,0,0,8,8
16323,sicher,0,0,8,8
39488,aberta,0,0,8,8
39576,صفحة,0,0,8,8
5359,neutral,0,0,8,8
33241,eat,0,0,8,8
30905,अध्ययन,0,0,8,8
30886,birçok,0,0,8,8
15726,liberté,0,0,8,8
13855,quer,0,0,8,8
43544,stort,0,0,8,8
33106,quiser,0,0,8,8
26377,सन्दर्भ,0,0,8,8
15031,contenidos,0,0,8,8
41877,பதிலாக,0,0,8,8
2691,sto,1,8,0,8
27094,ಅವನು,0,0,8,8
41895,அடுத்த,0,0,8,8
41900,done,0,0,8,8
35219,you've,0,0,8,8
34611,déjà,0,0,8,8
36531,always,0,0,8,8
9099,along,0,0,8,8
21010,banco,0,0,8,8
13962,às,0,0,8,8
675,libero,1,8,0,8
24271,theory,0,0,8,8
20646,സ്വർണ്ണ,0,0,8,8
14146,you.,0,0,8,8
2812,aveva,1,8,0,8
8581,возможность,0,0,8,8
4124,cd,2,1,7,8
8008,ತಾಯಿ,0,0,8,8
20042,simple,0,0,8,8
42884,ice,0,0,8,8
34700,gång,0,0,8,8
47232,meine,0,0,8,8
27198,विकास,0,0,8,8
14321,slimme,0,0,8,8
8836,άλλη,0,0,8,8
51570,biography,0,0,8,8
20506,äta,0,0,8,8
20678,sonho,0,0,8,8
16118,сделать,0,0,8,8
42200,birisi,0,0,8,8
1736,sogno,1,8,0,8
1199,problemi,1,8,0,8
1738,server,2,3,5,8
8013,imagen,0,0,8,8
33249,n'avez,0,0,8,8
46827,specific,0,0,8,8
24749,problemas,0,0,8,8
14389,mediante,0,0,8,8
29700,gave,0,0,8,8
5582,cümle,0,0,8,8
27097,ging,0,0,8,8
34689,stora,0,0,8,8
19928,organización,0,0,8,8
34666,wikidata,0,0,8,8
43349,weil,0,0,8,8
8633,análisis,0,0,8,8
34763,två,0,0,8,8
16204,noch,0,0,8,8
42829,represent,0,0,8,8
3653,super,2,1,7,8
9013,numaralı,0,0,8,8
20821,information.,0,0,8,8
7974,lequel,0,0,8,8
42017,bon,0,0,8,8
9001,coverage,0,0,8,8
51253,l'utilisation,0,0,8,8
8628,sehen,0,0,8,8
43139,swamped,0,0,8,8
43140,ouro,0,0,8,8
14243,المحررين,0,0,8,8
26525,tut,0,0,8,8
32979,അവളുടെ,0,0,8,8
34753,interaction,0,0,8,8
2573,né,2,7,1,8
14262,و,0,0,8,8
50740,mitt,0,0,8,8
24183,avril,0,0,8,8
669,computing,2,6,2,8
49848,variables,0,0,8,8
806,school,2,1,7,8
7713,देखा,0,0,8,8
23980,d'or,0,0,8,8
42142,accuracy,0,0,8,8
39349,muitos,0,0,8,8
29173,demande,0,0,8,8
26236,klar,0,0,8,8
767,pena,2,2,6,8
4095,detto,1,8,0,8
29875,തിരുത്തലുകൾ,0,0,8,8
30798,lass,0,0,8,8
26901,goal,0,0,8,8
13468,dann,0,0,8,8
38670,geven,0,0,8,8
33044,अनुसार,0,0,8,8
20247,cosas,0,0,8,8
9373,defined,0,0,8,8
7762,происходит,0,0,8,8
29643,சொல்லலாம்.,0,0,8,8
36863,septembre,0,0,8,8
27167,fik,0,0,8,8
24388,programa,0,0,8,8
47484,voluntários,0,0,8,8
38615,गाड़ी,0,0,8,8
34510,life.,0,0,8,8
42994,incluindo,0,0,8,8
43896,несколько,0,0,8,8
29534,existen,0,0,8,8
34442,разделов,0,0,8,8
51626,verschillende,0,0,8,8
36432,ಸಾಧ್ಯವಿಲ್ಲ,0,0,8,8
3857,weekend,2,2,6,8
33132,med.,0,0,8,8
9514,colaboradores,0,0,8,8
16751,computers,0,0,8,8
15432,bazen,0,0,8,8
14718,प्रवृति,0,0,8,8
4241,obrigado,0,0,8,8
13386,धन्यवाद।,0,0,8,8
33059,wikimédia,0,0,8,8
8391,здесь,0,0,8,8
47599,ledsen,0,0,8,8
7692,മറ്റ്,0,0,8,8
42988,ഉപയോക്താക്കൾ,0,0,8,8
39339,tradition,0,0,8,8
16020,« nature »,0,0,8,8
5860,dites,0,0,8,8
7701,temps,0,0,8,8
47126,ഇന്ന്,0,0,8,8
47162,washington,0,0,8,8
20173,fragen,0,0,8,8
2929,mia,1,8,0,8
15147,दुनिया,0,0,8,8
27458,которая,0,0,8,8
34538,لذلك,0,0,8,8
52159,false,0,0,8,8
42948,кого-то,0,0,8,8
43049,ಏನನ್ನಾದರೂ,0,0,8,8
20106,gelir,0,0,8,8
35280,erstaunlich,0,0,8,8
41793,fri,0,0,8,8
2459,medio,2,1,7,8
39634,professor,0,0,8,8
34553,प्रयोग,0,0,8,8
13744,relatively,0,0,8,8
15662,able,0,0,8,8
33355,மன்னிக்கவும்,0,0,8,8
32949,quiero,0,0,8,8
367,enciclopedie,1,8,0,8
1191,gratuita,2,3,5,8
51835,хочу,0,0,8,8
1752,es.,2,1,7,8
15095,criticada,0,0,8,8
13778,ಮೇಲೆ,0,0,8,8
9176,κάνεις,0,0,8,8
20032,мать,0,0,8,8
26770,sueño,0,0,8,8
36375,limited,0,0,8,8
2759,rivista,1,8,0,8
5259,επίσης,0,0,8,8
19700,engelstalige,0,0,8,8
749,senza,1,8,0,8
42565,basic,0,0,8,8
15316,ஆங்கில,0,0,8,8
20327,कहने,0,0,8,8
36418,readers,0,0,8,8
1126,sulle,1,8,0,8
1768,lenta,2,1,7,8
15936,செல்ல,0,0,8,8
9253,harvard,0,0,8,8
8319,igen.,0,0,8,8
43197,comprendre,0,0,8,8
5262,सवाल,0,0,8,8
26775,humans,0,0,8,8
24680,book,0,0,8,8
30999,άτομο,0,0,8,8
39650,minha,0,0,8,8
41774,будет,0,0,8,8
8460,وأنت,0,0,8,8
3780,street,2,1,6,7
8193,können.,0,0,7,7
28670,droits,0,0,7,7
47271,bot,0,0,7,7
8117,उसकी,0,0,7,7
10575,upset,0,0,7,7
172,ovvero,1,7,0,7
4687,observations,0,0,7,7
8670,έξυπνες,0,0,7,7
49976,முடியும்.,0,0,7,7
3410,considera,2,2,5,7
5854,brød,0,0,7,7
49772,submergé,0,0,7,7
6773,n'y,0,0,7,7
47077,alltid,0,0,7,7
33730,permettent,0,0,7,7
47091,ಪದಗಳು,0,0,7,7
32452,collaboration,0,0,7,7
29520,laat,0,0,7,7
28649,engels,0,0,7,7
3387,piuttosto,1,7,0,7
32179,examen,0,0,7,7
50358,reino,0,0,7,7
48157,मीडिया,0,0,7,7
3736,autori,1,7,0,7
30428,sistemas,0,0,7,7
45627,தனது,0,0,7,7
6708,home,0,0,7,7
48264,أمي,0,0,7,7
28642,мама,0,0,7,7
5855,användas,0,0,7,7
45616,अधिकांश,0,0,7,7
30400,ذات,0,0,7,7
8384,virtual,0,0,7,7
48198,junho,0,0,7,7
48193,numbers,0,0,7,7
8286,editors.,0,0,7,7
47067,scholarpedia,0,0,7,7
4131,email,2,2,5,7
6850,meus,0,0,7,7
48360,ihm,0,0,7,7
5723,idag,0,0,7,7
45705,उनके,0,0,7,7
6841,ξέρετε,0,0,7,7
10605,étudiants,0,0,7,7
47017,два,0,0,7,7
47021,began,0,0,7,7
48887,которой,0,0,7,7
47225,¿por,0,0,7,7
10618,συγνώμη,0,0,7,7
100,dati.,1,7,0,7
8278,mening,0,0,7,7
6814,alsof,0,0,7,7
30357,know.,0,0,7,7
4542,him,0,0,7,7
49774,visar,0,0,7,7
30358,leder,0,0,7,7
47199,مليون,0,0,7,7
8497,முறை,0,0,7,7
10500,doen.,0,0,7,7
31953,droom,0,0,7,7
47338,அழகாக,0,0,7,7
5330,статей.,0,0,7,7
47674,doesn't,0,0,7,7
9756,सेंगर,0,0,7,7
33530,introduced,0,0,7,7
9265,développé,0,0,7,7
3535,sai,2,6,1,7
46550,dine,0,0,7,7
5272,reinforcement,0,0,7,7
7557,usage,0,0,7,7
6289,donner,0,0,7,7
31970,одна,0,0,7,7
9207,vær,0,0,7,7
48494,wikipedians,0,0,7,7
46582,parece,0,0,7,7
30037,مشروع,0,0,7,7
10493,ayant,0,0,7,7
47710,håller,0,0,7,7
49376,devient,0,0,7,7
4966,നന്ദി.,0,0,7,7
7804,aardig,0,0,7,7
6168,estivesse,0,0,7,7
47503,commercial,0,0,7,7
50068,сегодня,0,0,7,7
4282,makes,0,0,7,7
4923,sammen,0,0,7,7
48587,carriage,0,0,7,7
48612,cofundador,0,0,7,7
9158,donne,0,0,7,7
49431,बता,0,0,7,7
5258,ಪದಗಳನ್ನು,0,0,7,7
30817,fantastiskt,0,0,7,7
46239,अगली,0,0,7,7
6222,टिप्पणी,0,0,7,7
29075,policyer,0,0,7,7
31306,alemão,0,0,7,7
9569,bank,0,0,7,7
3570,settembre,1,7,0,7
33467,يوم,0,0,7,7
47613,مجموعة,0,0,7,7
29096,बजाय,0,0,7,7
9598,helemaal,0,0,7,7
9498,maak,0,0,7,7
141,sito,1,7,0,7
29106,vikipedi'de,0,0,7,7
46406,رائعة,0,0,7,7
5084,zeit,0,0,7,7
46411,pense,0,0,7,7
30778,decline,0,0,7,7
32875,seulement,0,0,7,7
46298,einige,0,0,7,7
9428,down,0,0,7,7
9425,sker,0,0,7,7
9414,jour,0,0,7,7
7597,basis,0,0,7,7
5068,setembro,0,0,7,7
3847,linee,1,7,0,7
29872,post,0,0,7,7
48530,ಇಲ್ಲ,0,0,7,7
50101,ദൈനംദിന,0,0,7,7
46481,बना,0,0,7,7
49440,hela,0,0,7,7
9135,studie,0,0,7,7
46135,при,0,0,7,7
30135,provide,0,0,7,7
238,arrabbiato,1,7,0,7
45924,ಮುಂದಿನ,0,0,7,7
8974,കഴിക്കാൻ,0,0,7,7
8952,செய்து,0,0,7,7
5522,कहते,0,0,7,7
52094,beter,0,0,7,7
45883,जिस,0,0,7,7
5548,meses,0,0,7,7
29400,händer,0,0,7,7
7265,ಅವರಿಗೆ,0,0,7,7
10326,ಹೆಚ್ಚು,0,0,7,7
8795,yolu,0,0,7,7
4721,κάνετε,0,0,7,7
45842,σπίτι,0,0,7,7
7183,φίλους,0,0,7,7
45824,cual,0,0,7,7
46908,ensuite,0,0,7,7
32675,bare,0,0,7,7
46913,وهو,0,0,7,7
5595,καθώς,0,0,7,7
10446,willen,0,0,7,7
30270,german,0,0,7,7
30621,marca,0,0,7,7
10483,estilo,0,0,7,7
6493,particulier,0,0,7,7
5642,linguistique,0,0,7,7
7123,gün,0,0,7,7
46353,sätze,0,0,7,7
47384,μαμά,0,0,7,7
49446,across,0,0,7,7
28775,такие,0,0,7,7
6111,nieuwe,0,0,7,7
7890,संपादन,0,0,7,7
33308,haben.,0,0,7,7
7436,dieu,0,0,7,7
3821,prossima,1,7,0,7
421,delhi,2,1,6,7
49104,tree,0,0,7,7
6062,deutschland,0,0,7,7
32011,somebody's,0,0,7,7
47783,fonds,0,0,7,7
7406,consulter,0,0,7,7
3496,allora,1,7,0,7
9036,comparison,0,0,7,7
33613,hög,0,0,7,7
46050,escrito,0,0,7,7
284,fornisce,1,7,0,7
47801,already,0,0,7,7
10087,умное,0,0,7,7
29337,tener,0,0,7,7
28833,potential,0,0,7,7
49956,دائمًا,0,0,7,7
7975,भोजन,0,0,7,7
31504,gewoon,0,0,7,7
5500,ತಿಳಿದಿದೆ,0,0,7,7
48448,gode,0,0,7,7
5511,πάντα,0,0,7,7
31505,nog,0,0,7,7
5665,качестве,0,0,7,7
22999,അതിനർത്ഥം,0,0,7,7
27375,seja,0,0,7,7
26867,vragen,0,0,7,7
15735,которых,0,0,7,7
20096,നല്ല,0,0,7,7
36401,وقت,0,0,7,7
15674,processes,0,0,7,7
36422,denken,0,0,7,7
42342,വേഡ്,0,0,7,7
15626,போன்ற,0,0,7,7
39381,monde.,0,0,7,7
15589,επόμενη,0,0,7,7
34959,conhecimento,0,0,7,7
36431,difícil,0,0,7,7
15503,result,0,0,7,7
1825,forse,1,7,0,7
42268,materials,0,0,7,7
36445,diffusion,0,0,7,7
50777,फाउंडेशन,0,0,7,7
34853,gemacht,0,0,7,7
20401,gebruik,0,0,7,7
15183,uses,0,0,7,7
15176,mise,0,0,7,7
39228,semana,0,0,7,7
34787,தெரியும்,0,0,7,7
15043,ಪದ,0,0,7,7
27083,meio,0,0,7,7
1167,programmazione,1,7,0,7
2698,possa,2,3,4,7
35006,engel,0,0,7,7
36365,encyclopedia.,0,0,7,7
36823,contrôle,0,0,7,7
39570,लाख,0,0,7,7
26468,статья,0,0,7,7
2513,alan,2,2,5,7
16166,usemodwiki,0,0,7,7
16157,fundação,0,0,7,7
26474,उसने,0,0,7,7
1909,diverse,2,4,3,7
26476,conversation,0,0,7,7
26480,carruaje,0,0,7,7
35176,tenía,0,0,7,7
24811,sexual,0,0,7,7
19834,collaborative,0,0,7,7
16034,começou,0,0,7,7
19862,cause,0,0,7,7
36361,verbete,0,0,7,7
16001,increasingly,0,0,7,7
50850,case,0,0,7,7
15952,likely,0,0,7,7
26604,programas,0,0,7,7
2561,wikipedia.org,2,1,6,7
50840,true,0,0,7,7
26626,qu'ils,0,0,7,7
19946,traum,0,0,7,7
19947,status,0,0,7,7
19966,werken,0,0,7,7
39476,android,0,0,7,7
20041,καλή,0,0,7,7
20448,सपना,0,0,7,7
51823,tels,0,0,7,7
20462,boos,0,0,7,7
14016,espèces,0,0,7,7
51271,nett,0,0,7,7
20736,स्थान,0,0,7,7
14234,января,0,0,7,7
24325,mostly,0,0,7,7
43330,administrators,0,0,7,7
51281,following,0,0,7,7
43339,êtres,0,0,7,7
14132,நடக்கிறது,0,0,7,7
43393,ಮೂಲಕ,0,0,7,7
14079,vilken,0,0,7,7
14067,opinión,0,0,7,7
20819,konsensus,0,0,7,7
43446,intelligents,0,0,7,7
14933,терри,0,0,7,7
14002,अच्छे,0,0,7,7
1700,inductive,2,1,6,7
20998,ولا,0,0,7,7
27327,complex,0,0,7,7
2875,sommerso,1,7,0,7
43534,associated,0,0,7,7
2877,dove,1,7,0,7
21002,शादी,0,0,7,7
1690,lento.,2,1,6,7
38774,allowing,0,0,7,7
43604,ಕ್ಯಾಚ್,0,0,7,7
43606,llamada,0,0,7,7
14344,pessoas,0,0,7,7
14360,medida,0,0,7,7
24357,maddeler,0,0,7,7
43214,moyens,0,0,7,7
34761,почему,0,0,7,7
20474,criticized,0,0,7,7
51827,weißt,0,0,7,7
20486,सुंदर,0,0,7,7
42878,trög,0,0,7,7
34752,effect,0,0,7,7
27121,año,0,0,7,7
42914,إنشاء,0,0,7,7
39174,upon,0,0,7,7
20528,случае,0,0,7,7
42952,contributeur,0,0,7,7
27155,mode,0,0,7,7
42978,αντί,0,0,7,7
24459,arbeit,0,0,7,7
2758,umm.,2,1,6,7
2760,prestazioni,1,7,0,7
25407,ikke.,0,0,7,7
14541,changed,0,0,7,7
20573,students,0,0,7,7
701,interesse,2,2,5,7
24382,waren.,0,0,7,7
14432,hoek,0,0,7,7
2789,ottenuto,1,7,0,7
39072,sejam,0,0,7,7
2793,modifiche,1,7,0,7
26467,يمكنني,0,0,7,7
2507,carrozza,1,7,0,7
51622,biological,0,0,7,7
17742,ver.,0,0,7,7
25287,originally,0,0,7,7
2214,inoltre,1,7,0,7
40534,investigación,0,0,7,7
18446,cruel,0,0,7,7
960,marion.,2,1,6,7
25637,altijd,0,0,7,7
958,stai,1,7,0,7
51023,référence,0,0,7,7
18538,find,0,0,7,7
17808,drie,0,0,7,7
40962,üzgünüm.,0,0,7,7
17750,अत्याचारी,0,0,7,7
2090,presenti,1,7,0,7
41143,следующий,0,0,7,7
40427,contre,0,0,7,7
35709,talk,0,0,7,7
18595,neden,0,0,7,7
40417,rapport,0,0,7,7
51094,principes,0,0,7,7
35682,positive,0,0,7,7
17600,publicado,0,0,7,7
41071,votación,0,0,7,7
2083,qualità,1,7,0,7
35659,ربما,0,0,7,7
25258,acordo,0,0,7,7
2073,robot,2,1,6,7
2213,riconoscimento,1,7,0,7
25599,stating,0,0,7,7
25291,विषय,0,0,7,7
17953,சதுப்பு,0,0,7,7
40700,properties,0,0,7,7
25429,tekrar,0,0,7,7
40650,quoi,0,0,7,7
40647,inom,0,0,7,7
18149,serie,0,0,7,7
35867,federal,0,0,7,7
35847,الفيديو,0,0,7,7
18093,target,0,0,7,7
40645,ആരെയെങ്കിലും,0,0,7,7
40639,ഇല്ല,0,0,7,7
25332,mom,0,0,7,7
18030,donde,0,0,7,7
40793,kelimeyi,0,0,7,7
2191,so.,2,2,5,7
25529,mobila,0,0,7,7
40796,ഇത്തരം,0,0,7,7
51072,artículos.,0,0,7,7
40805,δύο,0,0,7,7
972,john,2,1,6,7
18327,hatte,0,0,7,7
25556,всегда,0,0,7,7
35795,led,0,0,7,7
35781,revisión,0,0,7,7
2120,guida,1,7,0,7
25296,வேண்டாம்,0,0,7,7
17546,உன்னை,0,0,7,7
2294,voglio,1,7,0,7
1107,copyright,2,2,5,7
51638,проекты,0,0,7,7
26201,list,0,0,7,7
26202,três,0,0,7,7
16737,lucene,0,0,7,7
16730,കാരണം,0,0,7,7
51753,möchte,0,0,7,7
19292,عمل,0,0,7,7
1981,sistemi,2,6,1,7
26238,موعد,0,0,7,7
41709,விக்கிப்பீடியாவின்,0,0,7,7
2438,intelligenti,1,7,0,7
19322,presque,0,0,7,7
41721,decirle,0,0,7,7
19401,ಟೆರ್ರಿ,0,0,7,7
41186,apprentissage,0,0,7,7
36213,liquid,0,0,7,7
19452,verstanden,0,0,7,7
2468,materiale,2,6,1,7
26371,नहीं।,0,0,7,7
39751,أعتقد,0,0,7,7
39733,citizendium,0,0,7,7
16335,hendes,0,0,7,7
26435,escritos,0,0,7,7
19634,problem.,0,0,7,7
16260,launched,0,0,7,7
16256,sería,0,0,7,7
36269,जिमी,0,0,7,7
1065,negli,1,7,0,7
19211,джимми,0,0,7,7
16829,tar,0,0,7,7
877,temo,2,2,5,7
40322,энциклопедии,0,0,7,7
18770,ihrer,0,0,7,7
40288,c'est-à-dire,0,0,7,7
2052,oh.,2,1,6,7
51110,என்பதை,0,0,7,7
17350,left,0,0,7,7
2047,iphone,2,1,6,7
51726,जिसमें,0,0,7,7
41277,γωνία,0,0,7,7
25902,ello,0,0,7,7
41280,spørger,0,0,7,7
25929,टेरी,0,0,7,7
18937,используется,0,0,7,7
17171,sein.,0,0,7,7
26056,വളരെയധികം,0,0,7,7
26062,sagde,0,0,7,7
35451,regions,0,0,7,7
41445,pris,0,0,7,7
41488,ud,0,0,7,7
2009,controversia,2,2,5,7
40050,cited,0,0,7,7
19209,ವ್ಯಕ್ತಿಯನ್ನು,0,0,7,7
16949,años,0,0,7,7
2388,opera,2,4,3,7
880,approccio,1,7,0,7
36789,चाहिए,0,0,7,7
18166,podría,0,0,7,7
36828,நல்லது,0,0,7,7
37967,niveau,0,0,7,7
38116,fuente,0,0,7,7
23484,central,0,0,7,7
23476,performing,0,0,7,7
28095,objetivo,0,0,7,7
12380,société,0,0,7,7
12370,तब,0,0,7,7
12344,ऐसी,0,0,7,7
12333,collection,0,0,7,7
23451,amount,0,0,7,7
28116,david,0,0,7,7
22188,worry,0,0,7,7
23357,nuevo,0,0,7,7
3113,versione,1,7,0,7
12295,मुक्त,0,0,7,7
12292,verärgert,0,0,7,7
34099,சிறந்த,0,0,7,7
37289,dina,0,0,7,7
34086,carruagem,0,0,7,7
23346,d'apprentissage,0,0,7,7
22387,première,0,0,7,7
1349,nell'ambito,1,7,0,7
37861,compte,0,0,7,7
23304,contribuições,0,0,7,7
37790,table,0,0,7,7
12491,autor,0,0,7,7
23508,amazing,0,0,7,7
28224,proceso,0,0,7,7
36993,neste,0,0,7,7
36963,sound,0,0,7,7
12878,library,0,0,7,7
3046,user,2,1,6,7
34300,liens,0,0,7,7
51360,இடத்தில்,0,0,7,7
23807,منها,0,0,7,7
21791,meinen,0,0,7,7
1582,quasi,1,7,0,7
38298,série,0,0,7,7
12823,revisão,0,0,7,7
3057,siti,1,7,0,7
23763,आपकी,0,0,7,7
37126,आगे,0,0,7,7
21849,ocasiones,0,0,7,7
21879,bra.,0,0,7,7
21893,जीवन,0,0,7,7
44276,textos,0,0,7,7
12720,dessutom,0,0,7,7
1553,queste,1,7,0,7
12634,समीक्षा,0,0,7,7
12628,المقالات،,0,0,7,7
27986,எப்போதும்,0,0,7,7
37078,usuário,0,0,7,7
37113,inputs,0,0,7,7
28214,résultat,0,0,7,7
28229,every,0,0,7,7
23854,present,0,0,7,7
11318,voire,0,0,7,7
11523,fez,0,0,7,7
23082,imágenes,0,0,7,7
45112,अमेरिकी,0,0,7,7
33924,february,0,0,7,7
37617,ber,0,0,7,7
11455,vos,0,0,7,7
28395,делать,0,0,7,7
3275,scientifica,1,7,0,7
11423,moment.,0,0,7,7
28438,وفقًا,0,0,7,7
23027,act,0,0,7,7
28461,tarde,0,0,7,7
516,basato,1,7,0,7
28485,niet.,0,0,7,7
11105,approaches,0,0,7,7
45396,भाषाओँ,0,0,7,7
33817,disputes,0,0,7,7
33802,business,0,0,7,7
33788,acadêmicos,0,0,7,7
22913,thus,0,0,7,7
10993,sabes,0,0,7,7
22950,spise,0,0,7,7
45504,secret,0,0,7,7
23006,changement,0,0,7,7
45091,once,0,0,7,7
22810,ജോലി,0,0,7,7
22614,dezembro,0,0,7,7
33978,σας.,0,0,7,7
44742,bang,0,0,7,7
12004,sparse,0,0,7,7
22653,började,0,0,7,7
34022,значит,0,0,7,7
44790,oceans,0,0,7,7
28266,idea,0,0,7,7
11971,കാര്യങ്ങൾ,0,0,7,7
44830,gør,0,0,7,7
44842,ಧನ್ಯವಾದಗಳು,0,0,7,7
1434,varie,2,6,1,7
11841,تقلق,0,0,7,7
37690,до,0,0,7,7
45072,العبارة,0,0,7,7
28319,पहला,0,0,7,7
11795,début,0,0,7,7
11784,сказать.,0,0,7,7
11775,anderen,0,0,7,7
526,internet.,2,1,6,7
37681,tatlı,0,0,7,7
11733,constante,0,0,7,7
23096,situatie,0,0,7,7
1426,difficile,2,1,6,7
23087,யாரையாவது,0,0,7,7
11640,servers,0,0,7,7
36951,संचालित,0,0,7,7
12453,-നു,0,0,7,7
13473,örneğin,0,0,7,7
36916,hause,0,0,7,7
38482,mad,0,0,7,7
43711,god.,0,0,7,7
13083,zinnen,0,0,7,7
2971,scusa,1,7,0,7
13091,हुआ,0,0,7,7
13446,developed,0,0,7,7
21431,luego,0,0,7,7
13579,estiver,0,0,7,7
43907,εαυτό,0,0,7,7
44047,involves,0,0,7,7
36835,systemic,0,0,7,7
50619,far,0,0,7,7
2952,facile,2,5,2,7
13465,frågar,0,0,7,7
21430,الخبز,0,0,7,7
34526,fácil,0,0,7,7
13589,topics,0,0,7,7
13140,l’apprentissage,0,0,7,7
44028,heute,0,0,7,7
653,vector,2,1,6,7
3020,gennaio,1,7,0,7
2964,fase,2,2,5,7
27733,forfærdeligt,0,0,7,7
43792,فظيعة,0,0,7,7
34534,posibilidad,0,0,7,7
43706,ως,0,0,7,7
38556,первоначально,0,0,7,7
13383,المعلومات,0,0,7,7
36921,ord.,0,0,7,7
2953,dentro,2,1,6,7
43967,യന്ത്രപഠന,0,0,7,7
27678,لـ,0,0,7,7
21353,mensagem,0,0,7,7
36869,trafic,0,0,7,7
13561,contain,0,0,7,7
13393,दोस्त,0,0,7,7
21361,zwei,0,0,7,7
31585,करती,0,0,6,6
25240,غارق,0,0,6,6
24307,uw,0,0,6,6
37682,résultats,0,0,6,6
48332,kelimeler,0,0,6,6
18783,labeled,0,0,6,6
48348,upprörd,0,0,6,6
18756,meeting,0,0,6,6
48351,científicos,0,0,6,6
25249,αυτά,0,0,6,6
20740,gut.,0,0,6,6
37686,أقول,0,0,6,6
49218,só,0,0,6,6
24328,cuanto,0,0,6,6
31937,pass,0,0,6,6
22704,années,0,0,6,6
19002,fall,0,0,6,6
48442,net,0,0,6,6
21387,endast,0,0,6,6
40064,அம்மா,0,0,6,6
22651,usan,0,0,6,6
4636,change,0,0,6,6
40070,voy,0,0,6,6
19106,message,0,0,6,6
6421,مؤسسة,0,0,6,6
36063,particularmente,0,0,6,6
20672,wo,0,0,6,6
40102,icke,0,0,6,6
19027,auteurs,0,0,6,6
39050,uppslagsverket,0,0,6,6
4611,جيمي,0,0,6,6
18918,нарциса,0,0,6,6
18910,désolé.,0,0,6,6
36032,सैक्सन,0,0,6,6
4628,coisa,0,0,6,6
40223,vandalismos,0,0,6,6
36621,ελεύθερης,0,0,6,6
31159,repetir,0,0,6,6
18894,egen,0,0,6,6
18872,criar,0,0,6,6
36019,frères,0,0,6,6
24336,आपका,0,0,6,6
18855,andet,0,0,6,6
37415,gjorde,0,0,6,6
31961,«нупедии»,0,0,6,6
5489,formas,0,0,6,6
21251,поскольку,0,0,6,6
31639,l'encyclopédie.,0,0,6,6
32551,generalization,0,0,6,6
25309,conoce,0,0,6,6
49107,numérique,0,0,6,6
49698,vagnen,0,0,6,6
32009,surface.,0,0,6,6
30391,разных,0,0,6,6
30378,φορά,0,0,6,6
49701,virgin,0,0,6,6
24207,ஒருவர்,0,0,6,6
24198,göre,0,0,6,6
18295,innehållet,0,0,6,6
24158,вашей,0,0,6,6
49191,ക്ഷമിക്കണം,0,0,6,6
36786,उसके,0,0,6,6
40638,incluso,0,0,6,6
24097,günlük,0,0,6,6
4442,språkversioner,0,0,6,6
21194,teşekkürler.,0,0,6,6
4424,сша,0,0,6,6
4421,was.,0,0,6,6
22979,tant,0,0,6,6
18228,instances,0,0,6,6
37516,five,0,0,6,6
37523,disponibles,0,0,6,6
6693,maison,0,0,6,6
22868,whole,0,0,6,6
21358,på.,0,0,6,6
4484,representation,0,0,6,6
5483,نهاية,0,0,6,6
6595,turn,0,0,6,6
6606,லாரி,0,0,6,6
40411,four,0,0,6,6
22787,методов,0,0,6,6
25270,initially,0,0,6,6
30445,deste,0,0,6,6
38971,buna,0,0,6,6
24255,freunden,0,0,6,6
20908,boris,0,0,6,6
49650,இரண்டு,0,0,6,6
31292,harder,0,0,6,6
37623,tema,0,0,6,6
25283,geld,0,0,6,6
21269,doing,0,0,6,6
20958,wall,0,0,6,6
32541,second,0,0,6,6
40526,जून,0,0,6,6
37613,ಅವಳ,0,0,6,6
36855,bekommen,0,0,6,6
49085,realizada,0,0,6,6
40557,sábado,0,0,6,6
22858,algorithms.,0,0,6,6
6689,différents,0,0,6,6
21264,utilizada,0,0,6,6
32320,खुश,0,0,6,6
24364,வீட்டிற்கு,0,0,6,6
37395,затем,0,0,6,6
31329,واحد,0,0,6,6
38535,debe,0,0,6,6
37046,clusters,0,0,6,6
48673,؟.,0,0,6,6
23676,угол,0,0,6,6
19927,άλλες,0,0,6,6
21936,ಬಾರಿ,0,0,6,6
39534,κατάσταση,0,0,6,6
4914,obtusa,0,0,6,6
48893,rapports,0,0,6,6
48666,snart,0,0,6,6
36327,crying,0,0,6,6
48645,funciones,0,0,6,6
36312,gick,0,0,6,6
21954,conocimiento,0,0,6,6
36547,herhangi,0,0,6,6
21461,¿te,0,0,6,6
37102,கேட்ச்,0,0,6,6
21968,effort,0,0,6,6
32126,devices,0,0,6,6
24804,danske,0,0,6,6
48605,ಉದಾಹರಣೆಗೆ,0,0,6,6
24807,между,0,0,6,6
6162,ಇತರ,0,0,6,6
31055,εκ,0,0,6,6
39649,organisms,0,0,6,6
30849,رائع,0,0,6,6
23566,redigera,0,0,6,6
19967,déjame,0,0,6,6
19997,αμβλεία,0,0,6,6
21516,στα,0,0,6,6
39330,kritik,0,0,6,6
36517,modern,0,0,6,6
38408,कवर,0,0,6,6
36956,لغة,0,0,6,6
20350,unido,0,0,6,6
32159,stream,0,0,6,6
30960,organizations,0,0,6,6
24587,पसंद,0,0,6,6
36446,rätt,0,0,6,6
39300,تمامًا,0,0,6,6
5054,याद,0,0,6,6
5064,статье,0,0,6,6
20413,rien,0,0,6,6
31380,later.,0,0,6,6
5088,zijn.,0,0,6,6
5877,गलत,0,0,6,6
23827,importantes,0,0,6,6
5901,είπε,0,0,6,6
31387,αργή,0,0,6,6
39368,local,0,0,6,6
4979,दो।,0,0,6,6
24493,fields,0,0,6,6
24695,describe,0,0,6,6
39199,escreveu,0,0,6,6
36911,bodies,0,0,6,6
36534,outside,0,0,6,6
48696,hallo,0,0,6,6
31330,mehr,0,0,6,6
39172,celui,0,0,6,6
31123,naturels,0,0,6,6
21459,stomp,0,0,6,6
24947,الطعام,0,0,6,6
31809,cobertura,0,0,6,6
30767,daniel,0,0,6,6
20570,él,0,0,6,6
22303,страницы,0,0,6,6
24987,projecten,0,0,6,6
5653,хотя,0,0,6,6
19313,corriger,0,0,6,6
5647,telefon,0,0,6,6
49520,викимедиа,0,0,6,6
25061,desarrollo,0,0,6,6
21425,legal,0,0,6,6
22310,tarde.,0,0,6,6
6338,wikiscanner,0,0,6,6
21415,jeu,0,0,6,6
6359,altid,0,0,6,6
4729,difficult,0,0,6,6
5603,वर्णन,0,0,6,6
20617,должны,0,0,6,6
19264,yanı,0,0,6,6
5206,वर्तमान,0,0,6,6
39240,yardım,0,0,6,6
37848,ortaklaşa,0,0,6,6
49557,argued,0,0,6,6
23285,terwijl,0,0,6,6
38575,controversial,0,0,6,6
19199,multimedia,0,0,6,6
19443,segunda,0,0,6,6
39852,इस्तेमाल,0,0,6,6
31827,mim,0,0,6,6
24868,huh,0,0,6,6
39153,وفي,0,0,6,6
5308,terrible,0,0,6,6
19742,الخاصة,0,0,6,6
49260,comunicación,0,0,6,6
39667,عليها,0,0,6,6
38555,formed,0,0,6,6
23475,universe,0,0,6,6
5671,बेहतर,0,0,6,6
36270,définition,0,0,6,6
31478,forbløffende,0,0,6,6
37204,пока,0,0,6,6
31500,ise,0,0,6,6
19668,வரை,0,0,6,6
39840,അവരുടെ,0,0,6,6
36554,rédaction,0,0,6,6
23424,другой,0,0,6,6
24434,datum,0,0,6,6
24872,éditions,0,0,6,6
22175,examples.,0,0,6,6
19592,cours,0,0,6,6
36252,تحصل,0,0,6,6
19554,d’un,0,0,6,6
23412,آسف.,0,0,6,6
19508,शानदार,0,0,6,6
24913,actions,0,0,6,6
30770,ജനുവരി,0,0,6,6
5654,ángulo,0,0,6,6
45565,कोण,0,0,6,6
6823,decisions,0,0,6,6
43839,deixe-me,0,0,6,6
46348,однако,0,0,6,6
27639,lorsque,0,0,6,6
13245,aantal,0,0,6,6
43944,لي,0,0,6,6
29078,algorithme,0,0,6,6
13374,titled,0,0,6,6
27484,snabbt,0,0,6,6
27482,further,0,0,6,6
13392,rapidement,0,0,6,6
29180,referred,0,0,6,6
43714,quais,0,0,6,6
13454,ಕೆಲವೊಮ್ಮೆ,0,0,6,6
13501,நிச்சயமாக,0,0,6,6
43761,nah.,0,0,6,6
46483,haven't,0,0,6,6
13568,είχε,0,0,6,6
43741,comenzó,0,0,6,6
9307,dochter,0,0,6,6
29224,environment.,0,0,6,6
46547,лучше,0,0,6,6
29065,wikipedistas,0,0,6,6
9589,cases,0,0,6,6
13189,apache,0,0,6,6
44020,error,0,0,6,6
46203,assim,0,0,6,6
34289,produce,0,0,6,6
9778,iki,0,0,6,6
46219,solar,0,0,6,6
27802,radio,0,0,6,6
34337,används,0,0,6,6
46258,ಕೇಳಲು,0,0,6,6
12974,δείτε,0,0,6,6
12982,ಯಾವಾಗಲೂ,0,0,6,6
12989,använde,0,0,6,6
9705,bliver,0,0,6,6
46274,അവിടെ,0,0,6,6
9667,roll,0,0,6,6
13042,tekst,0,0,6,6
27720,sample,0,0,6,6
27715,probabilistic,0,0,6,6
44061,goede,0,0,6,6
27703,resto,0,0,6,6
29044,máquinas,0,0,6,6
46549,മറ്റു,0,0,6,6
34529,الأمر,0,0,6,6
12870,ഗണിത,0,0,6,6
8944,prata,0,0,6,6
34668,ನುಡಿಗಟ್ಟು,0,0,6,6
46708,வார்த்தையை,0,0,6,6
14202,senare,0,0,6,6
46714,حصلت,0,0,6,6
27224,dahaki,0,0,6,6
43288,criação,0,0,6,6
43278,wilderness,0,0,6,6
43256,методы,0,0,6,6
43237,amerika,0,0,6,6
8938,yavaş,0,0,6,6
13656,meilleur,0,0,6,6
14356,produit,0,0,6,6
14358,discussion,0,0,6,6
8884,->,0,0,6,6
14373,zei,0,0,6,6
14380,plan,0,0,6,6
14423,ಕ್ಷಣ,0,0,6,6
43166,anses,0,0,6,6
34702,ಸಹಾಯ,0,0,6,6
14483,രസകരമായ,0,0,6,6
14134,demasiado,0,0,6,6
34647,popularidad,0,0,6,6
43426,λες,0,0,6,6
9054,smuk,0,0,6,6
9202,ಏನಾದರೂ,0,0,6,6
13663,vestido,0,0,6,6
13763,contra,0,0,6,6
46598,уверен,0,0,6,6
9177,together,0,0,6,6
43601,english-language,0,0,6,6
43580,nice,0,0,6,6
43574,sikker,0,0,6,6
43569,créé,0,0,6,6
13829,completely,0,0,6,6
13848,ಕನಸು,0,0,6,6
29251,currents,0,0,6,6
13866,என்றால்,0,0,6,6
9123,set.,0,0,6,6
13905,rule,0,0,6,6
9084,ಸಾಧ್ಯವಿಲ್ಲ.,0,0,6,6
43474,latest,0,0,6,6
27316,иногда,0,0,6,6
14032,distribution,0,0,6,6
44215,resultados,0,0,6,6
12854,λέτε,0,0,6,6
8764,اللغات,0,0,6,6
10338,tenha,0,0,6,6
28357,ನಿಧಾನಗತಿಯ,0,0,6,6
44991,प्रयास,0,0,6,6
28349,такой,0,0,6,6
33953,ίσως,0,0,6,6
11790,φίλοι,0,0,6,6
11800,boa,0,0,6,6
45843,часть,0,0,6,6
28294,views,0,0,6,6
11895,மன்னிக்கவும்.,0,0,6,6
11924,tinham,0,0,6,6
45967,búsqueda,0,0,6,6
44815,moyen,0,0,6,6
44785,могли,0,0,6,6
44784,behavior,0,0,6,6
28761,variety,0,0,6,6
45912,grad,0,0,6,6
12062,factors,0,0,6,6
33673,yani,0,0,6,6
10220,train,0,0,6,6
12083,soms,0,0,6,6
11549,ಅಂದರೆ,0,0,6,6
10510,états-unis,0,0,6,6
45094,επιδιόρθωση,0,0,6,6
11516,ചിലർ,0,0,6,6
45532,ларри,0,0,6,6
10721,؛,0,0,6,6
45521,ever,0,0,6,6
10884,κάτω,0,0,6,6
45488,modification,0,0,6,6
45473,recent,0,0,6,6
10965,കഴിയില്ല,0,0,6,6
45463,författare,0,0,6,6
45424,முடியாது.,0,0,6,6
28534,lide,0,0,6,6
28474,protection,0,0,6,6
11257,process.,0,0,6,6
45235,sefere,0,0,6,6
10603,ಮರಿಯನ್,0,0,6,6
10588,üzerine,0,0,6,6
33887,mettre,0,0,6,6
10562,entries,0,0,6,6
10546,യന്ത്രപഠനം,0,0,6,6
11493,இருக்கும்,0,0,6,6
44697,dear,0,0,6,6
44673,около,0,0,6,6
28958,wagen,0,0,6,6
44339,terms,0,0,6,6
9979,beskriver,0,0,6,6
44450,siden,0,0,6,6
12516,alguna,0,0,6,6
46113,दोनों,0,0,6,6
9942,பிழைத்திருத்தத்தில்,0,0,6,6
34149,explica,0,0,6,6
46119,lih,0,0,6,6
44436,उपयोगकर्ता,0,0,6,6
12551,μόνο,0,0,6,6
44331,redigeras,0,0,6,6
33657,жизни,0,0,6,6
27939,sera,0,0,6,6
12684,críticos,0,0,6,6
12690,james,0,0,6,6
12792,programs,0,0,6,6
12802,projektet,0,0,6,6
12806,allemaal,0,0,6,6
12807,certaine,0,0,6,6
9839,कल,0,0,6,6
44233,obtenu,0,0,6,6
44471,fortsätt,0,0,6,6
34129,சாங்கர்,0,0,6,6
44533,conducted,0,0,6,6
12362,required,0,0,6,6
12198,musst,0,0,6,6
10142,dispositivos,0,0,6,6
10139,ಚೆನ್ನಾಗಿ,0,0,6,6
12208,relacionados,0,0,6,6
34059,обучение,0,0,6,6
28817,നിമിഷം,0,0,6,6
44587,artificielle,0,0,6,6
34101,begon,0,0,6,6
46031,individual,0,0,6,6
12312,definition,0,0,6,6
12313,തവണ,0,0,6,6
10075,कभी,0,0,6,6
10070,εντάξει,0,0,6,6
10062,இன்று,0,0,6,6
12315,عبر,0,0,6,6
10036,riktlinjer,0,0,6,6
46057,eve,0,0,6,6
33610,vergeet,0,0,6,6
46070,brugere,0,0,6,6
43104,horrible,0,0,6,6
43082,maman,0,0,6,6
30350,quase,0,0,6,6
7507,meaning,0,0,6,6
41418,looked,0,0,6,6
26052,werde,0,0,6,6
26027,snel,0,0,6,6
47702,six,0,0,6,6
47705,kära,0,0,6,6
17189,conservapedia,0,0,6,6
26013,മന്ദഗതിയിലുള്ള,0,0,6,6
41324,måske,0,0,6,6
47712,बेटी,0,0,6,6
41302,सही,0,0,6,6
17378,эта,0,0,6,6
41286,വീണ്ടും,0,0,6,6
35585,gouden,0,0,6,6
7469,deres,0,0,6,6
41254,onu,0,0,6,6
41250,fortæller,0,0,6,6
41249,ಜೀವನದಲ್ಲಿ,0,0,6,6
35604,после,0,0,6,6
41227,νούμερο,0,0,6,6
7431,personnes,0,0,6,6
10840,portanto,0,0,6,6
47663,mesa,0,0,6,6
17022,vikipedi'deki,0,0,6,6
32844,edition,0,0,6,6
26262,obter,0,0,6,6
41739,minutes,0,0,6,6
16617,hjælp,0,0,6,6
41723,அவளுடைய,0,0,6,6
47535,gik,0,0,6,6
7767,montre,0,0,6,6
41711,etmek,0,0,6,6
7745,little,0,0,6,6
16665,particulière,0,0,6,6
16672,predictions,0,0,6,6
16674,beauty,0,0,6,6
41665,kære,0,0,6,6
16731,supervisado,0,0,6,6
16816,التعلم,0,0,6,6
32868,به,0,0,6,6
41584,içinde,0,0,6,6
47640,majority,0,0,6,6
41493,emin,0,0,6,6
7618,विध्वंस,0,0,6,6
41222,weiß,0,0,6,6
35627,differences,0,0,6,6
26339,beni,0,0,6,6
32606,चाहिए।,0,0,6,6
25612,vem,0,0,6,6
7153,regras,0,0,6,6
47969,gentage,0,0,6,6
47970,sorte,0,0,6,6
47971,बिना,0,0,6,6
17955,desculpe,0,0,6,6
7118,internautes,0,0,6,6
17980,river,0,0,6,6
40811,werden,0,0,6,6
48027,hace,0,0,6,6
7417,αγγλικά,0,0,6,6
25543,partes,0,0,6,6
25536,valeur,0,0,6,6
18005,culturelle,0,0,6,6
48125,dagelijks,0,0,6,6
6872,n’est,0,0,6,6
48146,λάθος,0,0,6,6
40775,критики,0,0,6,6
18080,capacité,0,0,6,6
35892,visade,0,0,6,6
40856,freunde,0,0,6,6
17913,secreto,0,0,6,6
47947,problèmes,0,0,6,6
32651,regarding,0,0,6,6
41188,നിന്നും,0,0,6,6
47781,largement,0,0,6,6
41165,работы,0,0,6,6
17548,diciendo,0,0,6,6
7369,εσάς,0,0,6,6
7365,nødt,0,0,6,6
41101,upprepa,0,0,6,6
47820,linear,0,0,6,6
17645,المنزل,0,0,6,6
25740,that.,0,0,6,6
7331,país,0,0,6,6
41031,contrast,0,0,6,6
41028,ordnung,0,0,6,6
30168,ദിവസം,0,0,6,6
40976,gezien,0,0,6,6
30178,الويكي,0,0,6,6
17734,тем,0,0,6,6
17738,машинного,0,0,6,6
17828,society,0,0,6,6
26317,doğru,0,0,6,6
7816,mamá,0,0,6,6
46904,ಮತ್ತೊಂದು,0,0,6,6
15409,need,0,0,6,6
42638,விரும்புகிறேன்,0,0,6,6
15228,शायद,0,0,6,6
34833,समाचार,0,0,6,6
42523,créée,0,0,6,6
26880,möchten,0,0,6,6
42519,https,0,0,6,6
15389,separate,0,0,6,6
34919,samt,0,0,6,6
26874,jam,0,0,6,6
47135,mil,0,0,6,6
35042,rédacteurs,0,0,6,6
15446,mind,0,0,6,6
26825,utilisée,0,0,6,6
15559,therefore,0,0,6,6
26810,flesta,0,0,6,6
26789,enkelt,0,0,6,6
15610,coisas,0,0,6,6
8301,eerste,0,0,6,6
15677,ger,0,0,6,6
42325,ನಾರ್ಸಿಸಸ್,0,0,6,6
15163,lit,0,0,6,6
27073,humains,0,0,6,6
8502,neutralité,0,0,6,6
42783,characteristic,0,0,6,6
27193,permettant,0,0,6,6
8718,mannen,0,0,6,6
29410,obras,0,0,6,6
46922,tur,0,0,6,6
46931,previously,0,0,6,6
42925,yok.,0,0,6,6
33222,i'd,0,0,6,6
27149,അനേകം,0,0,6,6
8642,nearly,0,0,6,6
27123,n'importe,0,0,6,6
14818,científica,0,0,6,6
14839,ऐसे,0,0,6,6
14865,context,0,0,6,6
42867,buena,0,0,6,6
8568,ponds,0,0,6,6
42824,única,0,0,6,6
42819,canal,0,0,6,6
29459,alguma,0,0,6,6
27095,पाठ,0,0,6,6
15708,له,0,0,6,6
15820,eens,0,0,6,6
16522,blevet,0,0,6,6
47443,instance,0,0,6,6
16073,plutôt,0,0,6,6
16149,تعلم,0,0,6,6
16171,سيكون,0,0,6,6
32975,regler,0,0,6,6
41991,större,0,0,6,6
29798,ângulo,0,0,6,6
16245,آخر,0,0,6,6
16255,καθημερινή,0,0,6,6
32961,volunteer,0,0,6,6
47446,говорите,0,0,6,6
47215,கொள்ளுங்கள்.,0,0,6,6
16341,contribuintes,0,0,6,6
26425,impacts,0,0,6,6
16376,belki,0,0,6,6
16427,bilder,0,0,6,6
32950,avaient,0,0,6,6
41838,varias,0,0,6,6
41800,fiabilité,0,0,6,6
32947,until,0,0,6,6
16521,hitta,0,0,6,6
26512,veut,0,0,6,6
8025,இருந்தால்,0,0,6,6
8028,учтивый,0,0,6,6
42102,artiklarnas,0,0,6,6
15840,kişiyi,0,0,6,6
8257,mach,0,0,6,6
15849,prodigieux,0,0,6,6
42215,calidad,0,0,6,6
29624,sais,0,0,6,6
8233,noite,0,0,6,6
35075,tus,0,0,6,6
15881,detect,0,0,6,6
15887,gelir.,0,0,6,6
47258,रिपोर्ट,0,0,6,6
15938,hör,0,0,6,6
35100,привет,0,0,6,6
26588,glad,0,0,6,6
29660,बीच,0,0,6,6
26538,ни,0,0,6,6
35149,हूँ।,0,0,6,6
8052,ζωή,0,0,6,6
16041,आपसे,0,0,6,6
33038,aynı,0,0,6,6
17060,optimization,0,0,6,6
15846,നാർസിസസ്,0,0,6,6
1250,idea.,2,2,4,6
1431,libre.,2,1,5,6
3485,teoria,1,6,0,6
3427,categoria,2,4,2,6
1531,tuttavia,1,6,0,6
51561,खेद,0,0,6,6
194,funzione,1,6,0,6
1628,motivo,2,1,5,6
870,decisione,1,6,0,6
2452,italiana,2,5,1,6
1967,causa,2,5,1,6
50447,சாப்பிட,0,0,6,6
50548,kendini,0,0,6,6
3813,meglio,1,6,0,6
2854,dell'enciclopedia,1,6,0,6
51728,keer,0,0,6,6
4159,dispiace,1,6,0,6
848,mezzo,1,6,0,6
2695,e.,2,2,4,6
2273,wiktionary,2,1,5,6
81,ok,2,2,4,6
50378,области,0,0,6,6
51468,increase,0,0,6,6
49883,skarp,0,0,6,6
513,estremamente,1,6,0,6
3873,attraverso,1,6,0,6
51230,l'autre,0,0,6,6
1106,dio,2,2,4,6
975,male,2,1,5,6
2708,dilemma,2,1,5,6
1219,troppo,1,6,0,6
50212,தொகுப்புக்கள்,0,0,6,6
2432,science.,2,2,4,6
50907,بطريقة,0,0,6,6
3337,narcissa.,2,1,5,6
2899,seconda,1,6,0,6
1822,propria,1,6,0,6
2440,figure,2,1,5,6
1589,lavorare,1,6,0,6
50893,videnskabelige,0,0,6,6
961,miei,1,6,0,6
852,acuto,1,6,0,6
3195,wikiquote,2,1,5,6
51526,future,0,0,6,6
50864,gebruiken.,0,0,6,6
2493,macchina,1,6,0,6
50566,que.,0,0,6,6
1521,paradigmi,1,6,0,6
1151,basati,1,6,0,6
236,encarta,2,2,4,6
50762,jemandem,0,0,6,6
1876,continuare,1,6,0,6
2215,stessa,1,6,0,6
2874,cool.,2,1,5,6
334,successo,1,6,0,6
2985,facendo,1,6,0,6
2097,soave,1,6,0,6
3248,oggi,1,6,0,6
2532,anno,2,5,1,6
454,cose,1,6,0,6
3611,amo,2,3,3,6
51396,содержания,0,0,6,6
1647,ars,2,1,5,6
3619,maggior,1,6,0,6
51220,ಮನೆಗೆ,0,0,6,6
51183,பிறகு,0,0,6,6
50589,droit,0,0,6,6
3204,alta,2,1,5,6
51037,europe,0,0,6,6
1845,citata,1,6,0,6
51704,simplement,0,0,6,6
3178,angolo,1,6,0,6
50641,കഴിയില്ല.,0,0,6,6
55,macchine,1,6,0,6
3961,cibo,1,6,0,6
52055,തിരഞ്ഞെടുത്ത,0,0,6,6
50160,değil.,0,0,6,6
51797,مكان,0,0,6,6
2514,computational,2,1,5,6
51311,slowly,0,0,6,6
68,accurate,2,1,5,6
50713,chamado,0,0,6,6
2390,gentile,1,6,0,6
4087,corso,2,5,1,6
1453,fuori,1,6,0,6
2361,preso,2,4,2,6
2364,termine,1,6,0,6
2035,pubblicata,1,6,0,6
1369,tuoi,1,6,0,6
3384,by-sa,2,1,5,6
51248,reports,0,0,6,6
1352,lavori,1,6,0,6
3152,tecniche,1,6,0,6
50800,അതിൽ,0,0,6,6
2000,consiste,2,2,4,6
1186,controllo,1,6,0,6
4010,dunque,1,6,0,6
377,errori,1,6,0,6
1035,discipline,2,2,4,6
3225,imparare,1,6,0,6
4276,leuk,0,0,6,6
51887,show,0,0,6,6
1252,l'edizione,1,6,0,6
721,guerra,2,1,5,6
52046,plupart,0,0,6,6
50700,acho,0,0,6,6
623,turing,2,3,3,6
2330,automaticamente,2,3,3,6
722,principale,1,6,0,6
51255,specifically,0,0,6,6
3832,qualsiasi,1,6,0,6
3514,rendezvous.,2,1,5,6
1897,nuovo,1,6,0,6
51833,leben,0,0,6,6
50380,yine,0,0,6,6
360,tom,2,1,5,6
51458,enciclopédias,0,0,6,6
2720,negativo,2,2,4,6
1173,compiti,1,6,0,6
2408,stupendo,1,6,0,6
49808,predict,0,0,6,6
51908,vier,0,0,6,6
51432,quatre,0,0,6,6
50743,randevu,0,0,6,6
51320,amerikaner,0,0,6,6
52103,parler,0,0,6,6
3217,dispute,2,2,4,6
3120,«wikipedia,2,1,5,6
2396,quelli,1,6,0,6
3697,andare,1,6,0,6
904,wikireader,2,4,2,6
94,agosto,2,1,5,6
2945,disponibili,1,6,0,6
906,particolare,1,6,0,6
51676,ಏಕೆ,0,0,6,6
3794,formato,2,1,4,5
32982,جيد,0,0,5,5
47372,market,0,0,5,5
13609,الآلي,0,0,5,5
36785,sugerem,0,0,5,5
24018,-இல்,0,0,5,5
2883,domanda,1,5,0,5
43570,arbeiten,0,0,5,5
2920,categorie,2,4,1,5
34779,പലപ്പോഴും,0,0,5,5
8021,ಇದರರ್ಥ,0,0,5,5
43565,sidevisninger,0,0,5,5
39639,ευγενικό,0,0,5,5
48946,tak.,0,0,5,5
19725,ανησυχείτε,0,0,5,5
29788,पाया,0,0,5,5
43655,забудьте,0,0,5,5
19691,bästa,0,0,5,5
3786,fantastico,1,5,0,5
50126,വിവിധ,0,0,5,5
39709,руки,0,0,5,5
19699,geht,0,0,5,5
49885,você.,0,0,5,5
13767,cinco,0,0,5,5
31045,attrition,0,0,5,5
43667,receives,0,0,5,5
39673,leid.,0,0,5,5
27005,issue,0,0,5,5
26988,versão,0,0,5,5
13686,terre,0,0,5,5
2896,triste,2,1,4,5
43668,अप्रैल,0,0,5,5
43669,gesehen,0,0,5,5
31065,πήρε,0,0,5,5
39723,asked,0,0,5,5
5619,génial,0,0,5,5
32108,correct,0,0,5,5
26995,källa,0,0,5,5
24079,थीं,0,0,5,5
279,suoni,1,5,0,5
24061,കുറച്ച്,0,0,5,5
4369,refers,0,0,5,5
5681,frage,0,0,5,5
1233,susning.nu,2,1,4,5
14359,zie,0,0,5,5
26708,parts,0,0,5,5
7818,invés,0,0,5,5
43243,restaurant,0,0,5,5
30957,μας,0,0,5,5
19260,उसी,0,0,5,5
47496,siguientes,0,0,5,5
36666,वाक्य,0,0,5,5
47495,anderes,0,0,5,5
19280,словами,0,0,5,5
3830,contrario,2,3,2,5
29918,send,0,0,5,5
47486,сентября,0,0,5,5
43282,quien,0,0,5,5
1215,palude,1,5,0,5
2815,fai,1,5,0,5
43294,संपादकों,0,0,5,5
30969,ದಯವಿಟ್ಟು,0,0,5,5
39938,wikis,0,0,5,5
40006,تلك,0,0,5,5
5831,engelse,0,0,5,5
14363,lassen,0,0,5,5
14413,educado,0,0,5,5
14450,qualidade,0,0,5,5
40075,compris,0,0,5,5
48788,milhão,0,0,5,5
7770,beder,0,0,5,5
19126,pouvez-vous,0,0,5,5
48793,projeto.,0,0,5,5
43176,ಓ,0,0,5,5
19129,claimed,0,0,5,5
5859,n'oubliez,0,0,5,5
48813,процессе,0,0,5,5
5853,killer,0,0,5,5
14390,hiç,0,0,5,5
30938,താളുകളിൽ,0,0,5,5
47522,verwendet,0,0,5,5
19188,divided,0,0,5,5
14374,segundo,0,0,5,5
2794,sui,1,5,0,5
32862,ರಾತ್ರಿ,0,0,5,5
48847,love,0,0,5,5
14201,ഇന്ത്യൻ,0,0,5,5
14157,added,0,0,5,5
43498,works,0,0,5,5
4167,mangiare,1,5,0,5
13961,lagras,0,0,5,5
43488,पार,0,0,5,5
43489,καταπληκτική,0,0,5,5
7970,भर,0,0,5,5
13946,ficar,0,0,5,5
13940,такими,0,0,5,5
34884,measure,0,0,5,5
19510,χωρίς,0,0,5,5
43475,geography,0,0,5,5
3804,applicazioni,1,5,0,5
3803,william,2,1,4,5
7987,objects,0,0,5,5
32138,سأكون,0,0,5,5
24122,αυτός,0,0,5,5
2878,hard,2,3,2,5
29833,οποία,0,0,5,5
19573,للمحررين,0,0,5,5
13968,ihren,0,0,5,5
39834,fangede,0,0,5,5
50670,avez-vous,0,0,5,5
2846,festival,2,1,4,5
36698,дорогая,0,0,5,5
26843,response,0,0,5,5
7899,cells,0,0,5,5
47448,информация,0,0,5,5
43403,philosophy,0,0,5,5
7912,değişiklikler,0,0,5,5
14076,എല്ലായ്പ്പോഴും,0,0,5,5
5755,resulting,0,0,5,5
43416,ligesom,0,0,5,5
24171,गयी।,0,0,5,5
36716,longtemps,0,0,5,5
14038,richard,0,0,5,5
29870,george,0,0,5,5
36725,എന്നത്,0,0,5,5
39862,должна,0,0,5,5
29864,mellon,0,0,5,5
50657,вами,0,0,5,5
19450,bijna,0,0,5,5
34916,ಫ್ಲಮ್ಮಾಕ್ಸ್,0,0,5,5
43841,பல,0,0,5,5
51825,office,0,0,5,5
49149,गैर,0,0,5,5
39296,എന്നീ,0,0,5,5
8440,aldım,0,0,5,5
5344,exists,0,0,5,5
8444,ibm,0,0,5,5
8447,വീഡിയോ,0,0,5,5
12780,encyclopedie,0,0,5,5
44271,components,0,0,5,5
49147,कोमन्स,0,0,5,5
49148,språket,0,0,5,5
12770,बातचीत,0,0,5,5
43734,सर्च,0,0,5,5
12754,blir,0,0,5,5
51878,principaux,0,0,5,5
44295,ему,0,0,5,5
27539,участников,0,0,5,5
12715,essas,0,0,5,5
23747,വിഷമിക്കേണ്ട,0,0,5,5
29585,personal,0,0,5,5
5315,göbl,0,0,5,5
31226,свои,0,0,5,5
20290,தெரியும்.,0,0,5,5
23771,continuer,0,0,5,5
39299,മാറ്റങ്ങൾ,0,0,5,5
23772,recursos,0,0,5,5
50165,either,0,0,5,5
44193,errors,0,0,5,5
51864,see.,0,0,5,5
44198,share,0,0,5,5
20220,oroa,0,0,5,5
23797,റെൻഡെജൂസ്,0,0,5,5
23790,الآخر,0,0,5,5
29619,month,0,0,5,5
34508,wel,0,0,5,5
44225,الشيء,0,0,5,5
20251,yeni,0,0,5,5
20255,pergunta,0,0,5,5
12827,core,0,0,5,5
5362,categories,0,0,5,5
23781,ensemble,0,0,5,5
37003,பயன்படுத்தும்,0,0,5,5
23774,personer,0,0,5,5
12801,eso.,0,0,5,5
29608,article.,0,0,5,5
39258,рандеву,0,0,5,5
39252,principalement,0,0,5,5
12665,vocês,0,0,5,5
27643,florida,0,0,5,5
20481,ஆண்டு,0,0,5,5
39184,utilizar,0,0,5,5
23673,category,0,0,5,5
50504,inicialmente,0,0,5,5
8573,позволяет,0,0,5,5
27681,stephen,0,0,5,5
27682,geben,0,0,5,5
47002,тупым,0,0,5,5
39144,изменения,0,0,5,5
34376,licencias,0,0,5,5
3705,metodo,1,5,0,5
27708,commonly,0,0,5,5
44526,seninle,0,0,5,5
23642,versie,0,0,5,5
49844,focus,0,0,5,5
8609,الموسوعة,0,0,5,5
23626,chance,0,0,5,5
12382,literalmente,0,0,5,5
8619,trend,0,0,5,5
8551,bedankt,0,0,5,5
626,neutrale,1,5,0,5
27574,meet,0,0,5,5
12566,gedaan,0,0,5,5
8498,prince,0,0,5,5
20397,fatigué,0,0,5,5
8506,useful,0,0,5,5
27585,التحرير,0,0,5,5
37038,content.,0,0,5,5
51880,usuario,0,0,5,5
23712,initial,0,0,5,5
20420,editoriais,0,0,5,5
27591,produced,0,0,5,5
1794,logica,1,5,0,5
47051,suite,0,0,5,5
39210,released,0,0,5,5
1293,lucro,2,1,4,5
27595,hjälp,0,0,5,5
39205,şeyler,0,0,5,5
39204,comigo,0,0,5,5
52047,zag,0,0,5,5
37052,ಅವನ,0,0,5,5
37057,billion,0,0,5,5
20195,filha,0,0,5,5
8389,uniquement,0,0,5,5
29637,παραδείγματα,0,0,5,5
34708,bedankt.,0,0,5,5
14464,geniş,0,0,5,5
23959,grupp,0,0,5,5
39557,possuem,0,0,5,5
5538,huilen,0,0,5,5
39553,संग्रह,0,0,5,5
700,pronto,2,1,4,5
19908,rädd,0,0,5,5
33018,geliyor.,0,0,5,5
8214,आश्चर्यजनक,0,0,5,5
33021,കഴിയുമോ,0,0,5,5
13362,snälla,0,0,5,5
47233,anglophone,0,0,5,5
19935,कहाँ,0,0,5,5
19938,colaboración,0,0,5,5
5515,træg,0,0,5,5
1013,possibilità,1,5,0,5
27245,dólares,0,0,5,5
32070,arquivos,0,0,5,5
19949,мелли,0,0,5,5
27189,paid,0,0,5,5
8184,bruges,0,0,5,5
49035,siento.,0,0,5,5
27166,cebuano,0,0,5,5
50620,bloquear,0,0,5,5
29766,tillsammans,0,0,5,5
13571,abril,0,0,5,5
19779,هم,0,0,5,5
13569,dorado,0,0,5,5
43752,moeten,0,0,5,5
49879,sidan,0,0,5,5
13555,डेटाबेस,0,0,5,5
34750,carnegie,0,0,5,5
39611,kiwix,0,0,5,5
43781,daran,0,0,5,5
13515,mundo.,0,0,5,5
5571,तरीके,0,0,5,5
19816,उद्देश्य,0,0,5,5
39598,korkunç,0,0,5,5
4188,svm,2,2,3,5
1899,portale,1,5,0,5
33003,might,0,0,5,5
32088,prins,0,0,5,5
49873,بطيئًا,0,0,5,5
19953,καλύτερα,0,0,5,5
1835,raggiunto,1,5,0,5
31147,puntos,0,0,5,5
44091,zonder,0,0,5,5
34581,പോകാൻ,0,0,5,5
31157,बताया,0,0,5,5
34574,et.,0,0,5,5
8343,बस,0,0,5,5
13039,does,0,0,5,5
5425,محرري,0,0,5,5
5422,moderne,0,0,5,5
8352,meta-wiki,0,0,5,5
8363,construction,0,0,5,5
23839,olması,0,0,5,5
5412,colaborar,0,0,5,5
51215,знаешь,0,0,5,5
29647,trött,0,0,5,5
47150,reliable,0,0,5,5
44170,service,0,0,5,5
33075,ontzagwekkend,0,0,5,5
12943,répéter,0,0,5,5
20171,сайт,0,0,5,5
47178,direitos,0,0,5,5
8314,noche,0,0,5,5
51845,جملة,0,0,5,5
3010,generalmente,2,4,1,5
13307,رسالة,0,0,5,5
13285,juin,0,0,5,5
31124,गुणवत्ता,0,0,5,5
47220,تمت,0,0,5,5
43965,pregunta,0,0,5,5
43983,telif,0,0,5,5
29695,anthropologies,0,0,5,5
23900,contains,0,0,5,5
13215,ander,0,0,5,5
44005,bem.,0,0,5,5
47200,n'ai,0,0,5,5
49054,eines,0,0,5,5
27330,groups,0,0,5,5
13166,मेरा,0,0,5,5
32058,بدأت,0,0,5,5
13151,खाना,0,0,5,5
1859,messenger,2,1,4,5
51204,खुद,0,0,5,5
3009,creazione,1,5,0,5
7765,remaining,0,0,5,5
24454,hija,0,0,5,5
35066,again,0,0,5,5
7011,cuál,0,0,5,5
32565,ഉപയോഗിക്കുന്ന,0,0,5,5
16395,träge,0,0,5,5
35717,meinem,0,0,5,5
40924,ça.,0,0,5,5
16360,ainda,0,0,5,5
16315,بالنسبة,0,0,5,5
48433,अनुसंधान,0,0,5,5
35684,photos,0,0,5,5
49960,свой,0,0,5,5
7013,तहत,0,0,5,5
40955,nästan,0,0,5,5
32584,britannicas,0,0,5,5
32374,dacht,0,0,5,5
16257,സാധാരണ,0,0,5,5
30346,misma,0,0,5,5
30345,повезло,0,0,5,5
17855,സ്വന്തം,0,0,5,5
6393,लिखा,0,0,5,5
30661,അതിനെക്കുറിച്ച്,0,0,5,5
17863,simplemente,0,0,5,5
2239,centro,2,1,4,5
48419,eres,0,0,5,5
4065,sconcertato,1,5,0,5
50018,şimdiden,0,0,5,5
16548,خوادم,0,0,5,5
25054,exist,0,0,5,5
41790,verwirrt,0,0,5,5
48110,interfaz,0,0,5,5
2457,verso,1,5,0,5
41008,وأنا,0,0,5,5
48399,zien,0,0,5,5
51008,நண்பர்களுடன்,0,0,5,5
48404,lead,0,0,5,5
6930,continents,0,0,5,5
6964,bange,0,0,5,5
2466,comunque,1,5,0,5
16500,lent,0,0,5,5
25034,ذلك،,0,0,5,5
16479,πω,0,0,5,5
30379,हों,0,0,5,5
25014,الثاني,0,0,5,5
48087,нужно,0,0,5,5
50019,cuales,0,0,5,5
3971,seguito,1,5,0,5
48447,minutos.,0,0,5,5
16211,अलावा,0,0,5,5
43141,applied,0,0,5,5
15953,say.,0,0,5,5
25893,завален,0,0,5,5
18033,sorgen,0,0,5,5
24873,nível,0,0,5,5
6326,этим,0,0,5,5
40774,вандализма,0,0,5,5
18049,såsom,0,0,5,5
48492,responder,0,0,5,5
18056,использования,0,0,5,5
912,futuro,2,1,4,5
4080,lentamente,2,3,2,5
16012,siguiente,0,0,5,5
24865,почти,0,0,5,5
3954,favore,1,5,0,5
42173,siendo,0,0,5,5
25935,ಪದದ,0,0,5,5
50838,concerning,0,0,5,5
7157,francesa,0,0,5,5
25943,intended,0,0,5,5
18101,rule-based,0,0,5,5
18104,wouldn't,0,0,5,5
18023,अतिरिक्त,0,0,5,5
16013,selv,0,0,5,5
17874,это.,0,0,5,5
24921,ಮತ್ತೆ,0,0,5,5
9713,работой,0,0,5,5
35652,lavet,0,0,5,5
17893,serviço,0,0,5,5
17895,html,0,0,5,5
40857,عليك,0,0,5,5
48012,പല,0,0,5,5
40849,درجة,0,0,5,5
24922,സ്വപ്നം,0,0,5,5
48007,wikipedia.org.,0,0,5,5
16107,jämfört,0,0,5,5
24888,explain,0,0,5,5
17944,attention,0,0,5,5
35617,técnicas,0,0,5,5
17968,да,0,0,5,5
25836,ثم,0,0,5,5
7087,होकर,0,0,5,5
2206,pagina,2,4,1,5
17991,ಮಾಡಿದ್ದೇನೆ,0,0,5,5
35596,मत,0,0,5,5
42112,entrada,0,0,5,5
41782,känner,0,0,5,5
50017,σήμερα,0,0,5,5
2263,grandi,1,5,0,5
32492,hjælpe,0,0,5,5
16988,ayrıca,0,0,5,5
1000,mediawiki.,2,1,4,5
6738,nouvelles,0,0,5,5
17341,små,0,0,5,5
41498,ധാരാളം,0,0,5,5
41499,hiçbir,0,0,5,5
1042,novembre,2,2,3,5
17351,tendance,0,0,5,5
41240,नए,0,0,5,5
17383,liten,0,0,5,5
41467,تبدو,0,0,5,5
17393,realidad,0,0,5,5
48324,travaille,0,0,5,5
2389,supervisionato,1,5,0,5
41187,जबकि,0,0,5,5
16940,rates,0,0,5,5
36055,pasar,0,0,5,5
41181,squid.,0,0,5,5
16922,القول,0,0,5,5
41528,beautiful,0,0,5,5
36011,utilisateurs,0,0,5,5
41466,mı,0,0,5,5
41764,tretikov,0,0,5,5
17245,step,0,0,5,5
17186,даже,0,0,5,5
17187,största,0,0,5,5
17190,anonymous,0,0,5,5
35963,ejemplos,0,0,5,5
25324,¿puedes,0,0,5,5
17205,இதன்,0,0,5,5
51674,अकादमिक,0,0,5,5
4013,programma,2,4,1,5
25278,fråga,0,0,5,5
32469,सकता।,0,0,5,5
6611,müde,0,0,5,5
32471,gyllene,0,0,5,5
30540,hors,0,0,5,5
6629,रात,0,0,5,5
25262,λέει,0,0,5,5
17062,américains,0,0,5,5
17052,effet,0,0,5,5
41448,vanliga,0,0,5,5
41282,வாழ்க்கையில்,0,0,5,5
1034,chiedendo,1,5,0,5
17437,domaine,0,0,5,5
35894,நினைவில்,0,0,5,5
2296,sbagliato,1,5,0,5
41700,fortsæt,0,0,5,5
51695,lucky,0,0,5,5
17551,ledsen.,0,0,5,5
50009,इसने,0,0,5,5
16687,दे,0,0,5,5
16671,എണ്ണം,0,0,5,5
48156,referencia,0,0,5,5
30432,तर्क,0,0,5,5
30603,reached,0,0,5,5
17580,rédacteur,0,0,5,5
30608,lot,0,0,5,5
48339,mieux,0,0,5,5
16628,atlantic,0,0,5,5
41722,أحيانًا,0,0,5,5
17606,القيام,0,0,5,5
41058,रखें,0,0,5,5
16604,जर्मन,0,0,5,5
41745,sida,0,0,5,5
6486,aprender,0,0,5,5
965,clic,2,2,3,5
1061,pensare,1,5,0,5
6522,должен,0,0,5,5
35829,problemet,0,0,5,5
48175,diyebilirsin.,0,0,5,5
17542,practice,0,0,5,5
16902,writing,0,0,5,5
41559,μέρα,0,0,5,5
41568,ನಿಮ್ಮೊಂದಿಗೆ,0,0,5,5
41569,representations,0,0,5,5
36074,economic,0,0,5,5
17488,ಸಂಪೂರ್ಣವಾಗಿ,0,0,5,5
16824,talvez,0,0,5,5
51690,tradicionais,0,0,5,5
30459,التخريب,0,0,5,5
32510,दलदल,0,0,5,5
30453,المرة,0,0,5,5
16777,component,0,0,5,5
6538,कमी,0,0,5,5
36091,كثيرًا,0,0,5,5
16765,weinen,0,0,5,5
41121,உங்களுடன்,0,0,5,5
17528,heldig,0,0,5,5
36097,explicitly,0,0,5,5
17538,inc.,0,0,5,5
7167,passou,0,0,5,5
48509,bewerkers,0,0,5,5
15875,അവന്റെ,0,0,5,5
6010,तीन,0,0,5,5
15026,carr,0,0,5,5
4132,bene.,1,5,0,5
35244,difficulté,0,0,5,5
42775,கொள்ளுங்கள்,0,0,5,5
48690,critics,0,0,5,5
35239,അവരോട്,0,0,5,5
2061,mente,2,2,3,5
15001,ಪದಗುಚ್,0,0,5,5
30073,« wikipédia »,0,0,5,5
7547,blive,0,0,5,5
26361,όλη,0,0,5,5
26392,നിങ്ങൾ‌,0,0,5,5
251,generale,1,5,0,5
35227,arbetet,0,0,5,5
26422,depending,0,0,5,5
40284,சந்திப்பு,0,0,5,5
14924,lange,0,0,5,5
7577,لست,0,0,5,5
14909,bouton,0,0,5,5
14904,complexity,0,0,5,5
6027,തങ്ങളുടെ,0,0,5,5
51763,இருக்கிறீர்கள்,0,0,5,5
18609,सम्पादकीय,0,0,5,5
15193,إنني,0,0,5,5
30126,الصفحات,0,0,5,5
42636,handling,0,0,5,5
18625,willst,0,0,5,5
47755,bedste,0,0,5,5
32740,άλλος,0,0,5,5
30805,artículo.,0,0,5,5
42639,भाग,0,0,5,5
24590,communication,0,0,5,5
26281,birinin,0,0,5,5
2672,pae,2,1,4,5
18713,selection,0,0,5,5
18658,características,0,0,5,5
18662,ನಡೆಯುತ್ತಿದೆ,0,0,5,5
32266,تقديم,0,0,5,5
42667,emellertid,0,0,5,5
36469,naquele,0,0,5,5
7481,question.,0,0,5,5
15145,url,0,0,5,5
15116,പറയുന്നു.,0,0,5,5
26331,empresa,0,0,5,5
18835,anomaly,0,0,5,5
14871,abrumado,0,0,5,5
40262,após,0,0,5,5
26606,золотого,0,0,5,5
7668,نيويورك,0,0,5,5
14661,பெரிய,0,0,5,5
52163,apuros,0,0,5,5
14657,publications,0,0,5,5
14629,chine,0,0,5,5
43040,sett,0,0,5,5
35106,முற்றிலும்,0,0,5,5
14588,vielleicht,0,0,5,5
14581,substance,0,0,5,5
24393,नीचे,0,0,5,5
5981,हर,0,0,5,5
43097,system.,0,0,5,5
26622,systèmes,0,0,5,5
36598,manner,0,0,5,5
51787,ಮೆಲ್ಲಿ,0,0,5,5
43107,normas,0,0,5,5
14502,ಹಾಗೆ,0,0,5,5
43133,successful,0,0,5,5
40097,built,0,0,5,5
32204,πράγμα,0,0,5,5
36570,geral,0,0,5,5
42999,chez,0,0,5,5
14713,femmes,0,0,5,5
24447,minutes.,0,0,5,5
50081,этом.,0,0,5,5
14853,ये,0,0,5,5
821,stanford,2,1,4,5
35180,yer,0,0,5,5
7605,ederim,0,0,5,5
14825,أين,0,0,5,5
7610,ligga,0,0,5,5
35157,نفس,0,0,5,5
18897,peur,0,0,5,5
18901,многие,0,0,5,5
42933,തീർച്ചയായും,0,0,5,5
7626,प्रस्तुत,0,0,5,5
26517,juillet,0,0,5,5
20598,línea,0,0,5,5
40209,पुस्तक,0,0,5,5
14756,matière,0,0,5,5
47633,वर्णित,0,0,5,5
50086,main,0,0,5,5
26526,inloggade,0,0,5,5
36447,desenvolvimento,0,0,5,5
42614,എല്ലാം,0,0,5,5
15871,biology,0,0,5,5
47876,people.,0,0,5,5
24760,experts,0,0,5,5
2141,maggio,1,5,0,5
18274,الأولى,0,0,5,5
15670,doit,0,0,5,5
7257,उपयुक्त,0,0,5,5
18277,bilgi,0,0,5,5
36334,whether,0,0,5,5
35461,studied,0,0,5,5
26072,visual,0,0,5,5
50808,gehört,0,0,5,5
7244,crescimento,0,0,5,5
35443,discovery,0,0,5,5
15615,analysera,0,0,5,5
1129,sicuro,1,5,0,5
2611,giro,2,4,1,5
884,robert,2,2,3,5
15604,excuses.,0,0,5,5
42392,seul,0,0,5,5
18339,நண்பர்கள்,0,0,5,5
35422,historical,0,0,5,5
18264,leading,0,0,5,5
2147,capo,1,5,0,5
32733,सहमत,0,0,5,5
40710,remains,0,0,5,5
3945,linea,1,5,0,5
25967,möglichkeit,0,0,5,5
15829,geluk,0,0,5,5
15828,ಎರಡು,0,0,5,5
15814,træt,0,0,5,5
18138,ഉപയോഗിച്ച്,0,0,5,5
15805,units,0,0,5,5
47927,ακούγεται,0,0,5,5
7201,prêmio,0,0,5,5
24827,our,0,0,5,5
50813,drøm,0,0,5,5
7205,كانوا,0,0,5,5
15787,повседневной,0,0,5,5
3939,sviluppo,1,5,0,5
18188,стороны,0,0,5,5
35495,law,0,0,5,5
894,awards,2,1,4,5
26030,http,0,0,5,5
42323,சொற்றொடரை,0,0,5,5
32659,require,0,0,5,5
18361,بينما,0,0,5,5
32687,gesagt,0,0,5,5
15505,υπέροχη,0,0,5,5
40460,beetje,0,0,5,5
18498,propre,0,0,5,5
40471,أفعل,0,0,5,5
7382,truth,0,0,5,5
35346,mayoría,0,0,5,5
30161,ability,0,0,5,5
143,partire,1,5,0,5
26231,الأساسية,0,0,5,5
50053,fem,0,0,5,5
15301,page.,0,0,5,5
6118,forskarna,0,0,5,5
26138,peter,0,0,5,5
7411,работу,0,0,5,5
24631,மந்தமான,0,0,5,5
32281,രീതിയിൽ,0,0,5,5
32280,olmadığını,0,0,5,5
42590,celle,0,0,5,5
24625,являются,0,0,5,5
50770,lütfen,0,0,5,5
42605,किया।,0,0,5,5
15251,millón,0,0,5,5
7378,rüya,0,0,5,5
40481,wurde,0,0,5,5
15351,vielen,0,0,5,5
47812,aujourd'hui,0,0,5,5
15486,project's,0,0,5,5
30754,gained,0,0,5,5
18383,questões,0,0,5,5
15475,native,0,0,5,5
6179,wikimedia.,0,0,5,5
26150,innebär,0,0,5,5
36376,idiomas.,0,0,5,5
6173,egna,0,0,5,5
18410,tales,0,0,5,5
875,segreto,1,5,0,5
47829,फॉर,0,0,5,5
15408,நாள்,0,0,5,5
30187,shown,0,0,5,5
2104,community.,2,1,4,5
3921,appuntamento,1,5,0,5
42520,ήρθε,0,0,5,5
30181,πού,0,0,5,5
18457,labels,0,0,5,5
18458,कारण,0,0,5,5
27730,plats,0,0,5,5
2973,digitale,2,2,3,5
23617,pueda,0,0,5,5
9136,humaines,0,0,5,5
23097,menar,0,0,5,5
45329,eckart,0,0,5,5
21644,taille,0,0,5,5
11095,allí,0,0,5,5
28346,கட்டுரைகளின்,0,0,5,5
45386,لن,0,0,5,5
29276,enorm,0,0,5,5
3323,tutte,1,5,0,5
28277,ഭാഷകളിൽ,0,0,5,5
46628,gracias.,0,0,5,5
31507,qu'à,0,0,5,5
23057,least,0,0,5,5
23049,ಒಳ್ಳೆಯದು,0,0,5,5
21700,premiers,0,0,5,5
33922,γι,0,0,5,5
4757,अपना,0,0,5,5
4805,τότε,0,0,5,5
3640,tedesca,1,5,0,5
34036,patrimoine,0,0,5,5
31844,участниками,0,0,5,5
21514,bus,0,0,5,5
50224,d'autre,0,0,5,5
51927,aigu,0,0,5,5
21528,l'accès,0,0,5,5
542,ceo,2,1,4,5
4832,particulièrement,0,0,5,5
38467,learns,0,0,5,5
21560,vraag,0,0,5,5
38432,comuns,0,0,5,5
50404,मिलियन,0,0,5,5
11301,dröm,0,0,5,5
31486,d'avoir,0,0,5,5
11283,أخرى.,0,0,5,5
4816,veta,0,0,5,5
3300,fondo,2,3,2,5
38434,πάω,0,0,5,5
38358,hafta,0,0,5,5
52018,maakt,0,0,5,5
50377,entry,0,0,5,5
37531,l'intelligence,0,0,5,5
10892,نفسك,0,0,5,5
28451,ذكية,0,0,5,5
38275,start.,0,0,5,5
31546,please,0,0,5,5
45551,frente,0,0,5,5
9246,वेबसाईट,0,0,5,5
1575,cara,2,4,1,5
21857,എന്നതാണ്,0,0,5,5
49517,undskyld.,0,0,5,5
28473,maio,0,0,5,5
1573,cyberarts,2,1,4,5
1572,dicendo,1,5,0,5
21884,exact,0,0,5,5
29209,nye,0,0,5,5
10787,estrutura,0,0,5,5
9271,night,0,0,5,5
21799,allons,0,0,5,5
21793,प्रस्ताव,0,0,5,5
10936,presence,0,0,5,5
4715,إنها,0,0,5,5
3339,siano,1,5,0,5
31815,αυτές,0,0,5,5
50375,hjälpa,0,0,5,5
45456,nourriture,0,0,5,5
46597,sind.,0,0,5,5
4733,diesen,0,0,5,5
1384,agli,1,5,0,5
46593,wanneer,0,0,5,5
3348,là,2,1,4,5
33901,pobre,0,0,5,5
49539,significant,0,0,5,5
23016,level,0,0,5,5
21775,знаете,0,0,5,5
23010,ദയവായി,0,0,5,5
1386,apprende,1,5,0,5
37424,друзьями,0,0,5,5
37414,начала,0,0,5,5
29204,содержит,0,0,5,5
11713,atolado,0,0,5,5
51479,தெரியாது,0,0,5,5
34150,similarity,0,0,5,5
49373,chamada,0,0,5,5
23315,cannot,0,0,5,5
11738,savez,0,0,5,5
21198,fille,0,0,5,5
46789,wees,0,0,5,5
28058,maybe,0,0,5,5
33244,شخصًا,0,0,5,5
46778,всю,0,0,5,5
21240,другими,0,0,5,5
4949,வார்த்தையின்,0,0,5,5
31414,ದೈನಂದಿನ,0,0,5,5
11682,nächsten,0,0,5,5
21259,bayesian,0,0,5,5
4943,universal,0,0,5,5
11751,vanaf,0,0,5,5
50206,شكرا,0,0,5,5
37413,الإنترنت,0,0,5,5
21082,исследований,0,0,5,5
1335,stupenda,1,5,0,5
34218,milieu,0,0,5,5
21057,ಹೇಳಿ.,0,0,5,5
51901,получите,0,0,5,5
38812,het.,0,0,5,5
44841,ihrem,0,0,5,5
38800,tack.,0,0,5,5
21085,βάλτο,0,0,5,5
21145,lernen,0,0,5,5
11894,حماية,0,0,5,5
46831,rijtuig,0,0,5,5
46829,necesidad,0,0,5,5
44890,novembro,0,0,5,5
8848,classified,0,0,5,5
34195,quem,0,0,5,5
11819,streams,0,0,5,5
8919,black,0,0,5,5
21263,savoir,0,0,5,5
23277,moe,0,0,5,5
38546,सूची,0,0,5,5
3260,chiunque,1,5,0,5
8980,nu.,0,0,5,5
11515,ಅತ್ಯಂತ,0,0,5,5
38558,بطيئة,0,0,5,5
3264,senso,2,4,1,5
21434,travailler,0,0,5,5
4876,canım,0,0,5,5
11476,कार्यक्रम,0,0,5,5
38671,cover,0,0,5,5
45135,work.,0,0,5,5
28170,develop,0,0,5,5
30,farlo,1,5,0,5
11432,aí,0,0,5,5
21472,leitores,0,0,5,5
34051,diskussioner,0,0,5,5
31852,पूछा,0,0,5,5
23211,प्रारंभ,0,0,5,5
21382,nature »,0,0,5,5
34092,வெவ்வேறு,0,0,5,5
28128,sopa,0,0,5,5
45003,основном,0,0,5,5
38648,деле,0,0,5,5
8926,autorais,0,0,5,5
4925,delar,0,0,5,5
23248,ej,0,0,5,5
38629,существует,0,0,5,5
11626,ಉತ್ತಮ,0,0,5,5
38616,ευχαριστώ.,0,0,5,5
23234,daarom,0,0,5,5
49412,معلومات,0,0,5,5
3664,collaboratori,1,5,0,5
35,electronica,2,1,4,5
558,interne,2,3,2,5
37371,announced,0,0,5,5
23223,editing.,0,0,5,5
4669,mañana,0,0,5,5
10775,δώσω,0,0,5,5
44833,geology,0,0,5,5
49687,onderzoek,0,0,5,5
31633,assunto,0,0,5,5
49680,forskellige,0,0,5,5
28807,träffar,0,0,5,5
28809,språk,0,0,5,5
46015,ट्रेडमार्क,0,0,5,5
49767,uppge,0,0,5,5
432,preoccuparti,1,5,0,5
22348,ongoing,0,0,5,5
49676,repeat,0,0,5,5
3486,volontari,1,5,0,5
394,wikipedia.com,2,1,4,5
10047,ചെയ്യുന്നത്,0,0,5,5
22364,طلب,0,0,5,5
28838,раздел,0,0,5,5
429,pigro,1,5,0,5
10013,ಸಮಯದಲ್ಲಿ,0,0,5,5
10140,iş,0,0,5,5
9529,priori,0,0,5,5
10216,illustrations,0,0,5,5
37672,salt,0,0,5,5
29088,health,0,0,5,5
9501,utilisant,0,0,5,5
3465,apprendimento.,1,5,0,5
3578,line,2,1,4,5
29085,ಹೇಗಾದರೂ,0,0,5,5
9507,científicas,0,0,5,5
9508,конечно,0,0,5,5
22761,män,0,0,5,5
4496,भयानक,0,0,5,5
29082,programme,0,0,5,5
51405,yemek,0,0,5,5
10165,rivers,0,0,5,5
22750,went,0,0,5,5
9524,वाला,0,0,5,5
1491,nell'edizione,1,5,0,5
4499,пожалуйста,0,0,5,5
4358,அதன்,0,0,5,5
10002,contrairement,0,0,5,5
9592,ಕ್ಷಮಿಸಿ.,0,0,5,5
22571,random,0,0,5,5
9651,ಮಾಡುತ್ತಿದ್ದೀರಿ,0,0,5,5
9657,forvirret,0,0,5,5
22528,samen,0,0,5,5
37801,remember,0,0,5,5
4367,καλύτερο,0,0,5,5
9786,رقيق,0,0,5,5
46278,ചിലപ്പോൾ,0,0,5,5
22572,populaire,0,0,5,5
9990,ಸ್ನೇಹಿತರೊಂದಿಗೆ,0,0,5,5
37754,engine,0,0,5,5
22585,geralmente,0,0,5,5
31697,no-brainer,0,0,5,5
9743,increased,0,0,5,5
46266,sim,0,0,5,5
37769,décembre,0,0,5,5
46265,bitte,0,0,5,5
46153,overall,0,0,5,5
50296,पूछ,0,0,5,5
9897,l'université,0,0,5,5
22493,இருக்கிறது,0,0,5,5
46085,adams,0,0,5,5
49709,φράσεις,0,0,5,5
28863,responsabilité,0,0,5,5
9601,förlåt,0,0,5,5
3504,migliori,1,5,0,5
9975,उन्होंने,0,0,5,5
33603,hold,0,0,5,5
33596,emot,0,0,5,5
22455,goed.,0,0,5,5
3511,bello,1,5,0,5
37847,ತಾಯಿಗೆ,0,0,5,5
46128,सूचना,0,0,5,5
33586,evidence,0,0,5,5
22486,गूगल,0,0,5,5
22660,polynomial,0,0,5,5
49660,entradas,0,0,5,5
10230,μία,0,0,5,5
10769,correctif,0,0,5,5
50346,മരിയൻ,0,0,5,5
10647,المساهمين,0,0,5,5
31574,julho,0,0,5,5
46491,കാര്യങ്ങളും,0,0,5,5
28566,அன்றாட,0,0,5,5
50347,honom,0,0,5,5
46484,brain,0,0,5,5
37589,научных,0,0,5,5
49605,presse,0,0,5,5
31572,القادمة,0,0,5,5
28576,encuentran,0,0,5,5
29159,entendi,0,0,5,5
37597,حوالي,0,0,5,5
10554,ret,0,0,5,5
50254,requires,0,0,5,5
13,testi,1,5,0,5
28602,ganze,0,0,5,5
45667,range,0,0,5,5
10650,شكرًا,0,0,5,5
29091,நேரம்,0,0,5,5
9315,editar,0,0,5,5
46534,கவலைப்பட,0,0,5,5
1557,stavi,1,5,0,5
21933,easily,0,0,5,5
45612,ಕಾಳಜಿ,0,0,5,5
9301,root,0,0,5,5
9303,मामले,0,0,5,5
28516,appropriate,0,0,5,5
49584,experiencia,0,0,5,5
50249,meilleure,0,0,5,5
33835,इतना,0,0,5,5
10699,माध्यम,0,0,5,5
22914,comes,0,0,5,5
21983,ரெண்டெஸ்வஸ்,0,0,5,5
38172,complètement,0,0,5,5
10687,معظم,0,0,5,5
28533,kan.,0,0,5,5
45738,year,0,0,5,5
10533,surveillance,0,0,5,5
22863,varje,0,0,5,5
45897,உதாரணமாக,0,0,5,5
45858,terrestrial,0,0,5,5
31609,लायक,0,0,5,5
4546,innan,0,0,5,5
3451,concetto,1,5,0,5
29111,worden.,0,0,5,5
28710,easy,0,0,5,5
28722,يستخدم,0,0,5,5
444,pagine,1,5,0,5
9381,indo,0,0,5,5
10266,widely,0,0,5,5
9477,concerns,0,0,5,5
50319,jezelf,0,0,5,5
3459,tutta,1,5,0,5
51393,fim,0,0,5,5
38006,الذهبي,0,0,5,5
29094,продолжайте,0,0,5,5
33716,china,0,0,5,5
46424,πάνω,0,0,5,5
45847,geheime,0,0,5,5
37635,istiyorsanız,0,0,5,5
469,figlia,1,5,0,5
22086,wieder,0,0,5,5
10517,ತಿಳಿದಿಲ್ಲ,0,0,5,5
22099,oficial,0,0,5,5
22850,tired,0,0,5,5
4583,comscore,0,0,5,5
3592,paideia,2,2,3,5
51968,values,0,0,5,5
10450,orden,0,0,5,5
38068,φαγητό,0,0,5,5
22150,novo,0,0,5,5
10427,этому,0,0,5,5
33430,príncipe,0,0,5,5
28674,sinto,0,0,5,5
45833,പോയി,0,0,5,5
21054,amable,0,0,5,5
17167,named,0,0,5,5
20747,plans,0,0,5,5
20620,livro,0,0,5,5
5079,thought,0,0,5,5
37186,controle,0,0,5,5
37203,γεια,0,0,5,5
8725,hora,0,0,5,5
37128,entirely,0,0,5,5
34261,prochaine,0,0,5,5
38869,думаю,0,0,5,5
44712,उपयोगी,0,0,5,5
44649,organization,0,0,5,5
1747,dice,2,3,2,5
1707,mchenry,2,1,4,5
31293,kon,0,0,5,5
74,wired,2,1,4,5
37187,كلمات,0,0,5,5
3702,eh,2,3,2,5
27875,neutro,0,0,5,5
8651,затруднительном,0,0,5,5
46926,själv,0,0,5,5
51304,पल,0,0,5,5
46946,predictions.,0,0,5,5
31924,منك,0,0,5,5
5099,française,0,0,5,5
20844,polar,0,0,5,5
20943,libres,0,0,5,5
38933,säga.,0,0,5,5
27734,хочет,0,0,5,5
8707,மேலே,0,0,5,5
37182,ಕೆಲಸವನ್ನು,0,0,5,5
29476,தொகுப்பாளர்கள்,0,0,5,5
46932,undersökning,0,0,5,5
27798,absence,0,0,5,5
5178,immer,0,0,5,5
38985,mean,0,0,5,5
33162,संपादित,0,0,5,5
8771,القواعد,0,0,5,5
23517,associations,0,0,5,5
8737,maintain,0,0,5,5
5130,جاء,0,0,5,5
31931,unos,0,0,5,5
49298,naast,0,0,5,5
12322,allemand,0,0,5,5
51267,precisão,0,0,5,5
20793,വ്യക്തിയെ,0,0,5,5
4247,الإصلاح,0,0,5,5
44775,समर्थन,0,0,5,5
8780,yorgun,0,0,5,5
29499,στιγμή,0,0,5,5
3148,persone,1,5,0,5
592,chi,1,5,0,5
12015,call,0,0,5,5
49827,उनकी,0,0,5,5
20909,elemento,0,0,5,5
34313,autores,0,0,5,5
29475,rare,0,0,5,5
23569,directly,0,0,5,5
34257,algorithmic,0,0,5,5
51303,vivant,0,0,5,5
23556,octobre,0,0,5,5
8724,tools,0,0,5,5
34267,catch,0,0,5,5
34316,प्रत्येक,0,0,5,5
12047,unknown,0,0,5,5
44791,λήμματα,0,0,5,5
12086,manchmal,0,0,5,5
4244,debes,0,0,5,5
34298,menudo,0,0,5,5
50474,director,0,0,5,5
49333,ميلي,0,0,5,5
34237,ജീവിതത്തിൽ,0,0,5,5
29432,revistas,0,0,5,5
44738,சொல்வது,0,0,5,5
49287,birini,0,0,5,5
5106,kennis,0,0,5,5
38940,चल,0,0,5,5
586,enciclopedia.,2,1,4,5
27865,yourself,0,0,5,5
44736,stykke,0,0,5,5
11965,nergis,0,0,5,5
1724,clustering,2,2,3,5
5149,efforts,0,0,5,5
38944,τρόπο,0,0,5,5
12105,डर,0,0,5,5
44663,täglichen,0,0,5,5
12089,conocida,0,0,5,5
39030,അതിശയകരമായ,0,0,5,5
3696,dispiace.,1,5,0,5
27817,वाली,0,0,5,5
27784,deseja,0,0,4,4
12678,perto,0,0,4,4
29119,وغير,0,0,4,4
44305,notably,0,0,4,4
31693,espero,0,0,4,4
45837,weten,0,0,4,4
45727,sueco,0,0,4,4
33779,product,0,0,4,4
34470,نعم,0,0,4,4
16097,radiation,0,0,4,4
9397,freaked,0,0,4,4
10455,pesar,0,0,4,4
25982,regional,0,0,4,4
25963,classifier,0,0,4,4
319,dna,2,1,3,4
47946,बौद्धिक,0,0,4,4
42071,معك,0,0,4,4
42210,resolução,0,0,4,4
29500,gesprek,0,0,4,4
35614,محتوى,0,0,4,4
44323,pensée,0,0,4,4
47059,imagine,0,0,4,4
7189,correction,0,0,4,4
28605,இதை,0,0,4,4
50524,fast,0,0,4,4
33403,allmänhet,0,0,4,4
7117,lentement,0,0,4,4
42260,llegó,0,0,4,4
50336,ακούσει,0,0,4,4
30261,modificaciones,0,0,4,4
12213,fråga.,0,0,4,4
10479,dotter,0,0,4,4
44290,includes,0,0,4,4
12656,وتريد,0,0,4,4
48004,أصدقائي,0,0,4,4
42259,quoted,0,0,4,4
15802,medios,0,0,4,4
35619,σελίδα,0,0,4,4
45711,pântano,0,0,4,4
10576,caractéristiques,0,0,4,4
42252,हाल,0,0,4,4
35509,vandalism.,0,0,4,4
10569,entendí,0,0,4,4
12740,samarbete,0,0,4,4
42149,traits,0,0,4,4
25957,ಹೌದು,0,0,4,4
10487,répondre,0,0,4,4
27550,him.,0,0,4,4
12676,അത്ഭുതകരമായ,0,0,4,4
10425,आसान,0,0,4,4
25876,செய்யப்பட்ட,0,0,4,4
50841,founded,0,0,4,4
25928,huge,0,0,4,4
9390,alright,0,0,4,4
46460,терренс,0,0,4,4
12691,ആരംഭിച്ചു.,0,0,4,4
50842,lisans,0,0,4,4
2558,addestramento,1,4,0,4
28619,enstaka,0,0,4,4
33770,olur,0,0,4,4
7133,planer,0,0,4,4
15944,الجيد,0,0,4,4
44332,begyndte,0,0,4,4
602,adesso,1,4,0,4
33748,विश्वसनीय,0,0,4,4
12702,съесть,0,0,4,4
50025,privacy,0,0,4,4
25918,présence,0,0,4,4
3956,formale,1,4,0,4
33763,effective,0,0,4,4
44621,भिन्न,0,0,4,4
35560,l'espace,0,0,4,4
47070,уже,0,0,4,4
28676,layers,0,0,4,4
33115,chateado,0,0,4,4
47071,waarin,0,0,4,4
10391,новые,0,0,4,4
35537,término,0,0,4,4
45786,voluntarios,0,0,4,4
25855,s.,0,0,4,4
8678,previous,0,0,4,4
9409,миллионов,0,0,4,4
32618,hoy,0,0,4,4
42134,guys,0,0,4,4
7160,datos.,0,0,4,4
45818,ajudar,0,0,4,4
9386,feitas,0,0,4,4
45815,arts,0,0,4,4
46464,propios,0,0,4,4
7094,code,0,0,4,4
32631,ಚಿಂತಿಸಬೇಡಿ,0,0,4,4
35548,ಮಾಡಿದ,0,0,4,4
3588,principi,1,4,0,4
7119,letzte,0,0,4,4
3599,mass,2,1,3,4
26007,présente,0,0,4,4
26183,लगा,0,0,4,4
51751,¿no,0,0,4,4
12833,மெதுவாக,0,0,4,4
45580,ടെറിയും,0,0,4,4
44666,senaste,0,0,4,4
12821,ರಾಕ್,0,0,4,4
50784,الصفحة,0,0,4,4
376,futura,2,2,2,4
28490,possibly,0,0,4,4
44247,ensayo,0,0,4,4
35369,i.e.,0,0,4,4
7347,oktober,0,0,4,4
32696,فيه,0,0,4,4
15415,തന്റെ,0,0,4,4
30192,alligevel,0,0,4,4
26182,برنامج,0,0,4,4
26140,كبيرة,0,0,4,4
50789,historique,0,0,4,4
29203,совет,0,0,4,4
26169,اعتبارًا,0,0,4,4
230,all'interno,1,4,0,4
640,avanti,1,4,0,4
35390,altına,0,0,4,4
15469,ceci,0,0,4,4
33378,connue,0,0,4,4
45600,études,0,0,4,4
15471,contributed,0,0,4,4
10748,சரளமாக,0,0,4,4
10743,ಮಾಡಬಹುದು,0,0,4,4
34488,highly,0,0,4,4
30201,aprendizagem,0,0,4,4
26205,текст,0,0,4,4
15371,различные,0,0,4,4
26211,gespräch,0,0,4,4
35351,يبدو,0,0,4,4
42584,உள்ளது,0,0,4,4
30146,estraguei,0,0,4,4
33875,perguntas,0,0,4,4
26239,vendiste,0,0,4,4
42579,vapor,0,0,4,4
3366,primi,1,4,0,4
27826,ξανά,0,0,4,4
50368,ದಿನ,0,0,4,4
42575,américaine,0,0,4,4
28463,sabor,0,0,4,4
10833,propos,0,0,4,4
42573,acontecendo,0,0,4,4
35341,ಇದನ್ನು,0,0,4,4
2658,samuel,2,2,2,4
45554,வழி,0,0,4,4
15325,беспокойтесь,0,0,4,4
12853,sige.,0,0,4,4
10828,முறையில்,0,0,4,4
47797,ಕೇಳಿದಾಗ,0,0,4,4
26221,semana.,0,0,4,4
46554,मुलाकात,0,0,4,4
50367,حقًا.,0,0,4,4
32710,genre,0,0,4,4
47804,lévi-strauss,0,0,4,4
42547,soin,0,0,4,4
8426,denke,0,0,4,4
45573,tråkigt,0,0,4,4
3609,marzo,2,2,2,4
26217,έναν,0,0,4,4
12183,தவறு,0,0,4,4
9299,creado,0,0,4,4
30257,örnek,0,0,4,4
42313,ശേഷം,0,0,4,4
7254,distinguished,0,0,4,4
42337,soort,0,0,4,4
2601,probabilità,1,4,0,4
47888,diga,0,0,4,4
44268,ciertas,0,0,4,4
12204,usam,0,0,4,4
47890,werkstatt,0,0,4,4
10622,gender,0,0,4,4
12779,he's,0,0,4,4
10612,வருத்தப்பட,0,0,4,4
7071,இரவு,0,0,4,4
46937,بأي,0,0,4,4
893,facilmente,2,2,2,4
47903,encyclopedieën,0,0,4,4
15714,प्रक्रिया,0,0,4,4
44261,closely,0,0,4,4
32655,материалы,0,0,4,4
42308,side,0,0,4,4
42307,walsh,0,0,4,4
15731,умных,0,0,4,4
10602,phone,0,0,4,4
2589,stava,1,4,0,4
15752,видео.,0,0,4,4
15764,nächste,0,0,4,4
51962,especificamente,0,0,4,4
15771,ಪದವು,0,0,4,4
12205,dica,0,0,4,4
8686,numerous,0,0,4,4
42272,imod,0,0,4,4
15778,them.,0,0,4,4
29604,सकती,0,0,4,4
33182,mot.,0,0,4,4
10664,visitas,0,0,4,4
27805,solve,0,0,4,4
35407,fiabilidad,0,0,4,4
47844,usada,0,0,4,4
15521,madde,0,0,4,4
46521,langsam,0,0,4,4
42435,fungi,0,0,4,4
15526,noticias,0,0,4,4
15527,desconcertado,0,0,4,4
45623,चुके,0,0,4,4
42407,sélection,0,0,4,4
3385,parlare,1,4,0,4
35436,तुम्हें,0,0,4,4
8701,francés,0,0,4,4
42387,atualmente,0,0,4,4
33389,وظيفة,0,0,4,4
33186,favorita,0,0,4,4
33836,materiais,0,0,4,4
44646,hetzelfde,0,0,4,4
47871,ورائعة,0,0,4,4
34307,அன்று,0,0,4,4
12794,части,0,0,4,4
47879,tycker,0,0,4,4
7264,prosa,0,0,4,4
26067,tillförlitlighet,0,0,4,4
35457,ecosystem,0,0,4,4
15653,venlig,0,0,4,4
32668,sikkert,0,0,4,4
33096,först,0,0,4,4
45658,изображений,0,0,4,4
28538,φορές,0,0,4,4
48008,देना,0,0,4,4
11954,الوقت,0,0,4,4
50325,vooral,0,0,4,4
46117,médias,0,0,4,4
9628,வேடிக்கையான,0,0,4,4
29033,files,0,0,4,4
48214,μερικά,0,0,4,4
6769,फर्क,0,0,4,4
27683,hoje,0,0,4,4
9935,protect,0,0,4,4
25435,évidence,0,0,4,4
30484,декабре,0,0,4,4
9937,ομορφιά,0,0,4,4
9622,faible,0,0,4,4
3560,mirror,2,3,1,4
35872,ಬಳಸಬಹುದು.,0,0,4,4
9939,tiden,0,0,4,4
41575,divine,0,0,4,4
3512,mantiene,2,1,3,4
25423,advocacy,0,0,4,4
41523,verir.,0,0,4,4
46124,mí,0,0,4,4
35898,домой,0,0,4,4
12345,bedre,0,0,4,4
27700,weg,0,0,4,4
12419,बुरा,0,0,4,4
41505,जिनमें,0,0,4,4
50276,comité,0,0,4,4
6750,indicate,0,0,4,4
34356,d’autres,0,0,4,4
41504,opinions,0,0,4,4
41501,increíble,0,0,4,4
9895,claro,0,0,4,4
12353,länge,0,0,4,4
41500,знаю,0,0,4,4
46116,तैयार,0,0,4,4
6796,насчет,0,0,4,4
12452,leitor,0,0,4,4
25517,gange,0,0,4,4
28853,ужасное,0,0,4,4
41662,രണ്ട്,0,0,4,4
325,sembrare,1,4,0,4
16715,adam,0,0,4,4
50271,drei,0,0,4,4
33477,بأن,0,0,4,4
41654,sak,0,0,4,4
12489,золотой,0,0,4,4
41646,xixe siècle,0,0,4,4
12486,users',0,0,4,4
9594,diversos,0,0,4,4
16739,lawrence,0,0,4,4
34395,läser,0,0,4,4
12330,تسمح,0,0,4,4
41643,winkel,0,0,4,4
988,dataset,2,2,2,4
3567,dell'intelligenza,1,4,0,4
3566,publishing,2,1,3,4
12474,ஆண்டின்,0,0,4,4
12332,उचित,0,0,4,4
16774,lío,0,0,4,4
28864,devenue,0,0,4,4
48183,имеют,0,0,4,4
50498,باللغة,0,0,4,4
29545,إصلاح,0,0,4,4
28872,लिए।,0,0,4,4
3140,semplicemente,1,4,0,4
28881,nehmen,0,0,4,4
3993,no.,2,1,3,4
422,basa,2,2,2,4
30483,exatamente,0,0,4,4
49999,одно,0,0,4,4
51722,повторить,0,0,4,4
41423,puissance,0,0,4,4
28970,году.,0,0,4,4
12387,licensed,0,0,4,4
33528,भाषाओं,0,0,4,4
41415,héberge,0,0,4,4
28965,mevcuttur.,0,0,4,4
8612,toch,0,0,4,4
44545,identified,0,0,4,4
48229,سياسات,0,0,4,4
34367,сказал,0,0,4,4
48260,कानून,0,0,4,4
12391,word.,0,0,4,4
33537,बदल,0,0,4,4
25363,pew,0,0,4,4
9785,журналах,0,0,4,4
33514,முதலில்,0,0,4,4
6679,redigering,0,0,4,4
17136,источника,0,0,4,4
25334,periódico,0,0,4,4
17140,schön,0,0,4,4
46990,gibi.,0,0,4,4
32459,ಹೆದರುತ್ತೇನೆ.,0,0,4,4
50948,coined,0,0,4,4
9745,प्रविष्टियों,0,0,4,4
46989,العلمية,0,0,4,4
33152,रखने,0,0,4,4
50488,trabalhe,0,0,4,4
25321,σου.,0,0,4,4
29529,estudantes,0,0,4,4
406,basata,1,4,0,4
49986,qu'un,0,0,4,4
51996,होते,0,0,4,4
17073,quatro,0,0,4,4
17061,action,0,0,4,4
17055,yarın,0,0,4,4
417,devono,1,4,0,4
12399,योजना,0,0,4,4
612,critica,1,4,0,4
46161,मान्यता,0,0,4,4
9870,ഇതുവരെ,0,0,4,4
46162,studien,0,0,4,4
998,precisa,2,1,3,4
9854,பொதுவான,0,0,4,4
41485,licencia,0,0,4,4
30488,särskilt,0,0,4,4
3529,sentito,1,4,0,4
6730,बेहद,0,0,4,4
16992,]​,0,0,4,4
16993,tijdens,0,0,4,4
48240,dir.,0,0,4,4
9831,focused,0,0,4,4
3138,pranzo,1,4,0,4
16997,مستخدمي,0,0,4,4
9829,fazendo,0,0,4,4
29007,работе,0,0,4,4
50290,logical,0,0,4,4
6716,مصادر,0,0,4,4
25381,discovering,0,0,4,4
17038,anders,0,0,4,4
9811,ranked,0,0,4,4
35931,над,0,0,4,4
3534,dello,1,4,0,4
41449,журнала,0,0,4,4
6709,वाणिज्यिक,0,0,4,4
12393,других,0,0,4,4
9787,sum,0,0,4,4
3495,mio.,2,3,1,4
2430,fortunato,1,4,0,4
396,capito,1,4,0,4
44588,standard,0,0,4,4
28762,यकीन,0,0,4,4
8652,однажды,0,0,4,4
16351,büyük,0,0,4,4
41912,lieber,0,0,4,4
16346,प्रविष्टि,0,0,4,4
25725,ക്ഷമിക്കണം.,0,0,4,4
35690,générale,0,0,4,4
41691,contexte,0,0,4,4
16292,गई,0,0,4,4
8656,d’apprentissage,0,0,4,4
41954,σίγουρα,0,0,4,4
45947,experience,0,0,4,4
34443,peine,0,0,4,4
3581,redattore,1,4,0,4
16379,présenter,0,0,4,4
30367,ലേഖനങ്ങളുടെ,0,0,4,4
29570,ಸ್ಥಳದಲ್ಲಿ,0,0,4,4
12602,birlikte,0,0,4,4
41878,точки,0,0,4,4
50885,പകരം,0,0,4,4
25674,английская,0,0,4,4
48075,impacto,0,0,4,4
12600,lära,0,0,4,4
6966,jaar,0,0,4,4
41854,ടെക്സ്റ്റ്,0,0,4,4
9510,hacerlo,0,0,4,4
51980,πήρα,0,0,4,4
34432,البيانات,0,0,4,4
10188,multiples,0,0,4,4
48085,kelimesinin,0,0,4,4
45964,серверов,0,0,4,4
46961,सितंबर,0,0,4,4
12627,shows,0,0,4,4
48041,mee,0,0,4,4
12254,özellikle,0,0,4,4
8503,места,0,0,4,4
33120,بذلك,0,0,4,4
25798,estadounidenses,0,0,4,4
44613,långsamt,0,0,4,4
7056,wales.,0,0,4,4
12249,fingers,0,0,4,4
25796,ecosystem.,0,0,4,4
2511,nuove,1,4,0,4
50320,underlättar,0,0,4,4
25792,viele,0,0,4,4
42019,பார்க்க,0,0,4,4
48024,emotions,0,0,4,4
48025,what's,0,0,4,4
8509,момент,0,0,4,4
29105,slashdot,0,0,4,4
44592,nombres,0,0,4,4
3720,vedi,1,4,0,4
10864,версии,0,0,4,4
16214,beyond,0,0,4,4
7033,begrepp,0,0,4,4
44595,kez,0,0,4,4
41992,слишком,0,0,4,4
16238,محمل,0,0,4,4
45916,verb,0,0,4,4
12629,propio,0,0,4,4
41977,kvar,0,0,4,4
9484,británica,0,0,4,4
25758,primeiro,0,0,4,4
12268,az,0,0,4,4
46960,seven,0,0,4,4
12575,inanılmaz,0,0,4,4
28777,ήμουν,0,0,4,4
16465,processos,0,0,4,4
8566,ναι,0,0,4,4
6901,جيدة,0,0,4,4
8556,إضافة,0,0,4,4
51700,actually,0,0,4,4
29064,फ्लोरिडा,0,0,4,4
12518,natural.,0,0,4,4
28824,एकमात्र,0,0,4,4
10077,ಮಗಳು,0,0,4,4
44562,αξίζει,0,0,4,4
50897,danke,0,0,4,4
9564,sagst,0,0,4,4
41727,ಸಾಕಷ್ಟು,0,0,4,4
12508,internationale,0,0,4,4
3489,darò,1,4,0,4
41718,tuvo,0,0,4,4
10041,sorun,0,0,4,4
50188,कैच,0,0,4,4
2445,permanente,2,1,3,4
3711,niente,1,4,0,4
2439,redattori,1,4,0,4
30426,larger,0,0,4,4
16649,vertel,0,0,4,4
33471,use.,0,0,4,4
29552,ചിലർക്ക്,0,0,4,4
2436,creare,1,4,0,4
41695,self-learning,0,0,4,4
29051,совершенно,0,0,4,4
10028,obvious,0,0,4,4
10027,respectively,0,0,4,4
10024,members,0,0,4,4
12502,meningar,0,0,4,4
3479,messaggio,1,4,0,4
16558,perçue,0,0,4,4
16470,>,0,0,4,4
44415,goud,0,0,4,4
16474,விரும்பவில்லை,0,0,4,4
27623,projekt,0,0,4,4
12567,facts,0,0,4,4
16490,daughter,0,0,4,4
6946,features.,0,0,4,4
29517,ಬಳಸಲಾಗುತ್ತದೆ,0,0,4,4
30384,مجتمع,0,0,4,4
16493,überfüllt,0,0,4,4
16507,traffic,0,0,4,4
9525,حياتك,0,0,4,4
2465,certo,2,3,1,4
44413,कहता,0,0,4,4
3470,possibili,1,4,0,4
390,consiglio,1,4,0,4
2464,generali,1,4,0,4
41779,pasa,0,0,4,4
10151,gråta,0,0,4,4
2458,scritte,1,4,0,4
27632,texte,0,0,4,4
46372,ana,0,0,4,4
6920,bureau,0,0,4,4
434,sugli,1,4,0,4
3146,overfitting,2,1,3,4
48112,incroyable,0,0,4,4
12526,haber,0,0,4,4
41788,lovely,0,0,4,4
32546,फिक्स,0,0,4,4
8553,വർഷം,0,0,4,4
32545,الأخيرة,0,0,4,4
44440,move,0,0,4,4
42586,cc,0,0,4,4
42621,article's,0,0,4,4
47111,ಭಯಾನಕ,0,0,4,4
3005,offre,2,1,3,4
47410,aldrig,0,0,4,4
47409,creó,0,0,4,4
52069,ഞാൻ‌,0,0,4,4
3754,utenti.,1,4,0,4
13952,vikipedi'ye,0,0,4,4
45065,razón,0,0,4,4
45056,independent,0,0,4,4
12035,сон,0,0,4,4
13142,decisiones,0,0,4,4
3253,gruppo,1,4,0,4
34883,بي,0,0,4,4
28106,spijt,0,0,4,4
11600,d'y,0,0,4,4
47397,ranking,0,0,4,4
13138,www.wikipedia.com,0,0,4,4
43480,específicas,0,0,4,4
47413,الأشياء,0,0,4,4
33271,éxito,0,0,4,4
50573,fit,0,0,4,4
11553,d'images,0,0,4,4
13982,reçu,0,0,4,4
44048,genau,0,0,4,4
29861,कहना,0,0,4,4
13994,comparando,0,0,4,4
8307,ämnen,0,0,4,4
34907,πολλά,0,0,4,4
2860,survey,2,1,3,4
14009,hjem,0,0,4,4
28133,verbe,0,0,4,4
8968,nova,0,0,4,4
50420,steeds,0,0,4,4
43509,योगदानकर्ताओं,0,0,4,4
44035,algemeen,0,0,4,4
11619,versionen,0,0,4,4
13860,wrong,0,0,4,4
2889,esperienza,1,4,0,4
33256,niveaux,0,0,4,4
11662,copy,0,0,4,4
300,pregiudizi,1,4,0,4
8774,accuracy.,0,0,4,4
46767,कौन,0,0,4,4
26981,temel,0,0,4,4
45019,peer,0,0,4,4
11647,этой,0,0,4,4
3247,miglioramento,1,4,0,4
3249,contributori,1,4,0,4
29450,बटन,0,0,4,4
34857,विश्व,0,0,4,4
28087,co-founder,0,0,4,4
50646,ತಪ್ಪು,0,0,4,4
13900,പറയുക.,0,0,4,4
2880,wikibooks,2,1,3,4
8005,ஏனென்றால்,0,0,4,4
8288,fått,0,0,4,4
45031,тупой,0,0,4,4
34256,zowel,0,0,4,4
2876,cima,2,1,3,4
43531,niets,0,0,4,4
34607,labor,0,0,4,4
43530,वैसे,0,0,4,4
45033,legais,0,0,4,4
7995,dele,0,0,4,4
43526,wikipédias,0,0,4,4
29841,relève,0,0,4,4
52066,gingen,0,0,4,4
14015,المرتبة,0,0,4,4
14020,ചെറിയ,0,0,4,4
35011,πράγματα,0,0,4,4
32884,carlos,0,0,4,4
7859,എന്നു,0,0,4,4
34980,ferramenta,0,0,4,4
14224,jobb,0,0,4,4
27368,editores.,0,0,4,4
26786,dicho,0,0,4,4
28167,correspondant,0,0,4,4
14212,острый,0,0,4,4
45092,vídeo.,0,0,4,4
34063,மகள்,0,0,4,4
14205,orientação,0,0,4,4
8321,لويكيبيديا,0,0,4,4
34965,списке,0,0,4,4
43341,fantastiske,0,0,4,4
7881,sun,0,0,4,4
9005,onion,0,0,4,4
2821,utilizza,1,4,0,4
777,multilingue,2,1,3,4
45149,unless,0,0,4,4
51796,вместе,0,0,4,4
350,evitando,2,1,3,4
44080,chinese,0,0,4,4
27370,mudanças,0,0,4,4
27373,theoretical,0,0,4,4
26752,address,0,0,4,4
14288,редакторов,0,0,4,4
3654,mitchell,2,3,1,4
11419,impossible,0,0,4,4
26744,تغييرات,0,0,4,4
29923,στις,0,0,4,4
45171,næsten,0,0,4,4
12049,female,0,0,4,4
47465,άρχισε,0,0,4,4
3824,records,2,1,3,4
27366,μπορούσα,0,0,4,4
34080,citou,0,0,4,4
2855,versioni,1,4,0,4
34091,κείμενο,0,0,4,4
7936,darwin,0,0,4,4
44052,اللغة,0,0,4,4
11533,videoyu,0,0,4,4
11532,college,0,0,4,4
11522,обычно,0,0,4,4
26870,qu'on,0,0,4,4
43427,vaak,0,0,4,4
26868,looking,0,0,4,4
11520,isto,0,0,4,4
45103,tochter,0,0,4,4
552,vandalismi,1,4,0,4
14072,finalidad,0,0,4,4
7913,सहकर्मी,0,0,4,4
27358,boundaries,0,0,4,4
3011,generalizzazione,1,4,0,4
26856,vandalismes,0,0,4,4
8766,método,0,0,4,4
29348,all.,0,0,4,4
51803,gute,0,0,4,4
3820,denota,2,1,3,4
50666,yet,0,0,4,4
8988,gehoord,0,0,4,4
14108,करे,0,0,4,4
11484,хочешь,0,0,4,4
8315,estabas,0,0,4,4
26833,ссылок,0,0,4,4
33281,relacionado,0,0,4,4
34953,​​​,0,0,4,4
13818,damit,0,0,4,4
13808,filosofía,0,0,4,4
8922,январе,0,0,4,4
43791,nerede,0,0,4,4
11843,enciclopedias,0,0,4,4
8796,يحدث,0,0,4,4
50205,europa,0,0,4,4
2977,consulta,2,1,3,4
43788,w.,0,0,4,4
11864,altından,0,0,4,4
8152,انخفاض,0,0,4,4
50149,रखता,0,0,4,4
29748,nacht,0,0,4,4
47278,permettre,0,0,4,4
44876,zone,0,0,4,4
29743,gånger,0,0,4,4
27164,ആംഗിൾ,0,0,4,4
47272,environments,0,0,4,4
13516,vidéo.,0,0,4,4
3220,felice,1,4,0,4
8136,ഉപയോഗിക്കുന്നു,0,0,4,4
11839,problemen,0,0,4,4
8792,higher,0,0,4,4
50137,employ,0,0,4,4
34193,ಹೇಳಿದರೆ,0,0,4,4
8131,mam,0,0,4,4
27899,simonite,0,0,4,4
44778,big,0,0,4,4
342,fortuna,2,2,2,4
11797,schönheit,0,0,4,4
2980,vandalismo.,2,1,3,4
8868,essentiellement,0,0,4,4
28008,ವೀಡಿಯೊದಲ್ಲಿ,0,0,4,4
29401,einfach,0,0,4,4
43748,wiederholen,0,0,4,4
44873,vaya,0,0,4,4
8237,fundador,0,0,4,4
11876,мог,0,0,4,4
51844,hein,0,0,4,4
43892,χρησιμοποιείται,0,0,4,4
47235,employed,0,0,4,4
27920,bättre,0,0,4,4
8217,αριθμός,0,0,4,4
13341,berkman,0,0,4,4
51839,bother,0,0,4,4
2965,esperti,1,4,0,4
693,bella,1,4,0,4
43865,amplamente,0,0,4,4
27915,handsome,0,0,4,4
8208,செய்த,0,0,4,4
13394,excepción,0,0,4,4
27207,græde,0,0,4,4
33015,gud.,0,0,4,4
8804,emprego,0,0,4,4
44868,creation,0,0,4,4
13413,cd-rom,0,0,4,4
46838,ध्वनि,0,0,4,4
11905,dollar,0,0,4,4
34705,connected,0,0,4,4
47254,devoirs,0,0,4,4
8236,sense,0,0,4,4
27952,afable,0,0,4,4
43830,occurs,0,0,4,4
50605,நுபீடியா,0,0,4,4
44859,ಬಟನ್,0,0,4,4
13449,ആഗ്രഹിക്കുന്നുണ്ടോ,0,0,4,4
34716,συμβαίνει,0,0,4,4
50139,pontos,0,0,4,4
27173,est-ce,0,0,4,4
44929,marriage,0,0,4,4
46806,perl,0,0,4,4
50586,digital,0,0,4,4
43618,nunca,0,0,4,4
8080,worth,0,0,4,4
50427,diye,0,0,4,4
50630,away,0,0,4,4
27044,mensaje,0,0,4,4
33037,மில்லியன்,0,0,4,4
43654,januar,0,0,4,4
13709,possível,0,0,4,4
27037,espacio,0,0,4,4
28064,परिवर्तन,0,0,4,4
43645,спасибо.,0,0,4,4
13719,menor,0,0,4,4
32965,لدى,0,0,4,4
11683,يبكي,0,0,4,4
43620,donné,0,0,4,4
13754,citing,0,0,4,4
43666,ഭക്ഷണം,0,0,4,4
47352,विचार,0,0,4,4
33253,mår,0,0,4,4
13755,söylemek,0,0,4,4
27012,സമയം,0,0,4,4
50637,حد,0,0,4,4
43989,clifford,0,0,4,4
47354,visiteurs,0,0,4,4
8047,francisco,0,0,4,4
11680,تذكر,0,0,4,4
27008,пользователей,0,0,4,4
44013,கிட்டத்தட்ட,0,0,4,4
13182,falar,0,0,4,4
13175,ஜிம்மி,0,0,4,4
43590,yapılan,0,0,4,4
8908,الرئيسية,0,0,4,4
34639,brödet,0,0,4,4
727,dale,2,1,3,4
13648,room,0,0,4,4
13271,vrouwen,0,0,4,4
28040,happy,0,0,4,4
13599,أخشى,0,0,4,4
2923,aumento,2,1,3,4
46798,institute,0,0,4,4
34773,आमतौर,0,0,4,4
47312,சூழ்நிலையில்,0,0,4,4
8885,skriva,0,0,4,4
27281,tâche,0,0,4,4
11739,frei,0,0,4,4
43703,hemen,0,0,4,4
13637,прежде,0,0,4,4
33247,ഗുരുതരമായ,0,0,4,4
27282,ordinateur,0,0,4,4
737,cercando,1,4,0,4
33250,الغرق,0,0,4,4
32981,välja,0,0,4,4
13657,प्रभाव,0,0,4,4
8095,errores,0,0,4,4
27055,الزاوية,0,0,4,4
46795,منه,0,0,4,4
50144,சென்று,0,0,4,4
13674,verbazingwekkend,0,0,4,4
11736,dynamic,0,0,4,4
43674,estaré,0,0,4,4
29393,положении,0,0,4,4
11727,phusis,0,0,4,4
12009,αστείο,0,0,4,4
33217,पुरस्कार,0,0,4,4
43973,dumps,0,0,4,4
43251,task,0,0,4,4
26736,klein,0,0,4,4
15280,clasificación,0,0,4,4
45432,अलग-अलग,0,0,4,4
3342,approcci,1,4,0,4
46605,സ്വതന്ത്ര,0,0,4,4
50236,concerned,0,0,4,4
14994,översvämmad,0,0,4,4
45434,പറഞ്ഞു,0,0,4,4
47689,inga,0,0,4,4
33919,kluges,0,0,4,4
47719,engelsk,0,0,4,4
12939,terrain,0,0,4,4
2699,soluzione,1,4,0,4
3879,massa,2,1,3,4
837,usati,1,4,0,4
26407,وإذا,0,0,4,4
2703,feedback,2,1,3,4
50551,existing,0,0,4,4
28399,update],0,0,4,4
10984,guess,0,0,4,4
9179,opinion,0,0,4,4
35246,akademiska,0,0,4,4
42762,zeer,0,0,4,4
9183,rocks,0,0,4,4
15035,incident,0,0,4,4
15036,அவை,0,0,4,4
50239,şaşırtıcı,0,0,4,4
47708,främst,0,0,4,4
12909,τρία,0,0,4,4
42736,dix,0,0,4,4
42729,popularity,0,0,4,4
7513,fragen.,0,0,4,4
42726,αυτό.,0,0,4,4
42722,ಸ್ನೇಹಿತರು,0,0,4,4
47138,usadas,0,0,4,4
12940,l’anthropologie,0,0,4,4
33338,populares,0,0,4,4
51774,apportées,0,0,4,4
35162,código,0,0,4,4
50084,agree,0,0,4,4
42910,തെറ്റുകൾ,0,0,4,4
35174,volontaires,0,0,4,4
9132,akıcı,0,0,4,4
47651,før,0,0,4,4
29275,själva,0,0,4,4
27427,குறிப்பிட்ட,0,0,4,4
666,stanco,1,4,0,4
14842,ಅಲ್ಲಿ,0,0,4,4
27439,conseil,0,0,4,4
33929,vereceğim.,0,0,4,4
28373,vanligt,0,0,4,4
514,complessità,1,4,0,4
42876,ഉപയോഗിക്കുന്നു.,0,0,4,4
47673,पॉलिश,0,0,4,4
12123,αναστατωμένος,0,0,4,4
45416,أقل,0,0,4,4
29269,ಯಾಕೆ,0,0,4,4
30049,பெற,0,0,4,4
2718,dita,1,4,0,4
46619,habitat,0,0,4,4
27843,initiatives,0,0,4,4
26439,outlier,0,0,4,4
831,statistici,1,4,0,4
11042,जारी,0,0,4,4
51770,paar,0,0,4,4
27841,रखते,0,0,4,4
833,potresti,1,4,0,4
30057,ಕೆಲಸದಲ್ಲಿ,0,0,4,4
52091,artigos.,0,0,4,4
32758,hola,0,0,4,4
26735,conversation.,0,0,4,4
10913,komme,0,0,4,4
46577,diversas,0,0,4,4
11947,sprogversioner,0,0,4,4
15231,laatste,0,0,4,4
8719,كانون,0,0,4,4
33358,गलती,0,0,4,4
28431,tamamen,0,0,4,4
47116,equinix,0,0,4,4
15089,मूर्खतापूर्ण,0,0,4,4
42627,fsf,0,0,4,4
42635,pays.,0,0,4,4
45499,verder,0,0,4,4
9211,inquiétez,0,0,4,4
45497,neem,0,0,4,4
45492,δω,0,0,4,4
42610,vrije,0,0,4,4
42609,البرنامج,0,0,4,4
2664,d'accordo.,1,4,0,4
503,popolazione,1,4,0,4
46574,clear,0,0,4,4
3902,dell'informatica,1,4,0,4
10899,ait,0,0,4,4
34512,helfen,0,0,4,4
35330,diskussionssidor,0,0,4,4
3905,superando,2,2,2,4
35335,sucesso,0,0,4,4
47771,earth.,0,0,4,4
30138,multimédia,0,0,4,4
33083,مركز,0,0,4,4
3689,problema.,2,2,2,4
15276,जापानी,0,0,4,4
50058,ai.,0,0,4,4
15206,άρεσε,0,0,4,4
12877,sommige,0,0,4,4
7457,bleek,0,0,4,4
10944,मिलने,0,0,4,4
12147,мире,0,0,4,4
26332,apart,0,0,4,4
33904,buluşma,0,0,4,4
12905,channel,0,0,4,4
849,alcun,1,4,0,4
42693,e-mail,0,0,4,4
15140,நேரங்களில்,0,0,4,4
851,ottieni,1,4,0,4
45468,japanese,0,0,4,4
26305,substantially,0,0,4,4
10952,doe,0,0,4,4
35295,someone,0,0,4,4
15155,stompe,0,0,4,4
244,bravo,2,2,2,4
29632,друзья,0,0,4,4
28425,проект,0,0,4,4
44204,networking,0,0,4,4
2673,ward,2,2,2,4
7473,κουμπί,0,0,4,4
7472,datter,0,0,4,4
3895,classe,2,1,3,4
26295,आम,0,0,4,4
10942,зрения,0,0,4,4
42657,algum,0,0,4,4
3044,dieci,1,4,0,4
15175,inmiddels,0,0,4,4
12890,descobriu,0,0,4,4
10941,aberto,0,0,4,4
44206,katherine,0,0,4,4
599,colto,1,4,0,4
12122,suficiente.,0,0,4,4
8738,متعبًا,0,0,4,4
33196,favorit,0,0,4,4
14410,visitors,0,0,4,4
47539,services,0,0,4,4
11303,baan,0,0,4,4
27391,потрясающий,0,0,4,4
44723,appelée,0,0,4,4
789,economia,2,1,3,4
9055,vide,0,0,4,4
28242,keinen,0,0,4,4
45379,spanish,0,0,4,4
26681,afraid,0,0,4,4
35044,parle,0,0,4,4
14398,όμορφος,0,0,4,4
35043,celles,0,0,4,4
12075,تحتوي,0,0,4,4
34017,grader,0,0,4,4
43175,clasificar,0,0,4,4
43174,തുടങ്ങിയ,0,0,4,4
7771,estimated,0,0,4,4
34568,signification,0,0,4,4
46681,वाक्यांशों,0,0,4,4
3643,ciffolilli,2,1,3,4
43168,statistik,0,0,4,4
28252,hope,0,0,4,4
47545,கவலையும்,0,0,4,4
47164,özgür,0,0,4,4
13015,dakika,0,0,4,4
26655,habe.,0,0,4,4
7756,دراسة,0,0,4,4
11279,பெற்றேன்,0,0,4,4
14486,snällt,0,0,4,4
11278,сэнгер,0,0,4,4
7749,téléphone,0,0,4,4
26690,broke,0,0,4,4
29940,obtenir,0,0,4,4
541,se.,2,1,3,4
47173,heureux,0,0,4,4
47505,चरण,0,0,4,4
3281,bayesiana,2,1,3,4
33293,fraser,0,0,4,4
26732,σχεδόν,0,0,4,4
547,fluente,2,2,2,4
2803,definizione,1,4,0,4
14327,dessas,0,0,4,4
35019,man-made,0,0,4,4
45193,الإنجليزية،,0,0,4,4
35020,språk.,0,0,4,4
35024,duas,0,0,4,4
3284,scoperta,1,4,0,4
45208,krijgt,0,0,4,4
13053,dynamique,0,0,4,4
26702,fluent,0,0,4,4
50698,нескольких,0,0,4,4
46691,« le,0,0,4,4
14369,प्यार,0,0,4,4
2795,automatico.,1,4,0,4
8337,одним,0,0,4,4
35036,соответствии,0,0,4,4
11357,mentioned,0,0,4,4
11353,neler,0,0,4,4
11335,zeg,0,0,4,4
50158,solución,0,0,4,4
14381,haft,0,0,4,4
3021,struttura,1,4,0,4
26695,വാൻഡലിസം,0,0,4,4
7798,ρίζες,0,0,4,4
14386,plannen,0,0,4,4
34000,fish,0,0,4,4
7747,half,0,0,4,4
14490,lenguas,0,0,4,4
47620,συγγνώμη.,0,0,4,4
26569,non-linear,0,0,4,4
47606,lyser,0,0,4,4
33316,intervju,0,0,4,4
12367,mesaj,0,0,4,4
46653,värt,0,0,4,4
11186,novas,0,0,4,4
26553,ten,0,0,4,4
14680,vilka,0,0,4,4
32808,sålde,0,0,4,4
9102,follow,0,0,4,4
14683,той,0,0,4,4
11184,skicka,0,0,4,4
50721,ألا,0,0,4,4
14694,glas,0,0,4,4
14696,viendo,0,0,4,4
14633,sägs,0,0,4,4
26541,создания,0,0,4,4
3307,database,2,1,3,4
42970,points,0,0,4,4
50230,durum,0,0,4,4
11167,വഴി,0,0,4,4
45356,verkauft,0,0,4,4
11132,உதவ,0,0,4,4
27425,vendu,0,0,4,4
14757,mesure,0,0,4,4
11121,होना,0,0,4,4
45373,ξέρω,0,0,4,4
26522,streek,0,0,4,4
45374,welke,0,0,4,4
30035,сообщество,0,0,4,4
14634,lecteurs,0,0,4,4
32820,technologie,0,0,4,4
26642,início,0,0,4,4
43090,kallas,0,0,4,4
11258,संगठन,0,0,4,4
47558,vragen.,0,0,4,4
50707,  articles,0,0,4,4
29968,rendre,0,0,4,4
43120,قواعد,0,0,4,4
50708,πρόσβασης,0,0,4,4
34275,tage,0,0,4,4
50097,ninguna,0,0,4,4
13013,исправлении,0,0,4,4
44718,முடியவில்லை,0,0,4,4
11254,episode,0,0,4,4
13002,ihåg,0,0,4,4
26618,universelle,0,0,4,4
29298,ഭയപ്പെടുന്നു.,0,0,4,4
3851,rispetto,1,4,0,4
45314,التغييرات,0,0,4,4
12999,mejora,0,0,4,4
7712,диск,0,0,4,4
11228,tittade,0,0,4,4
11221,مواقع,0,0,4,4
43058,korkarım,0,0,4,4
14592,போகிறீர்கள்,0,0,4,4
14597,वेबसाइट,0,0,4,4
33986,publica,0,0,4,4
14605,reality,0,0,4,4
51935,bonito,0,0,4,4
14618,சொற்றொடர்,0,0,4,4
7689,non-english,0,0,4,4
14623,permitir,0,0,4,4
32823,പ്രധാന,0,0,4,4
46654,fram,0,0,4,4
46259,ano,0,0,4,4
6015,éventuellement,0,0,4,4
21449,sold,0,0,4,4
2034,sociale,2,2,2,4
32225,правильно,0,0,4,4
24451,இருக்கிறது.,0,0,4,4
32230,olumsuz,0,0,4,4
18914,centaines,0,0,4,4
21448,rapid,0,0,4,4
40221,measured,0,0,4,4
49433,அதற்கு,0,0,4,4
21450,genial,0,0,4,4
18902,aquela,0,0,4,4
2041,ragazzi,1,4,0,4
21463,अलग,0,0,4,4
24468,deu,0,0,4,4
31,filosofia,2,2,2,4
38561,event,0,0,4,4
4890,honom.,0,0,4,4
51119,entender,0,0,4,4
32220,mostrou,0,0,4,4
38606,cabo,0,0,4,4
36579,τυχερός,0,0,4,4
24418,studies,0,0,4,4
38601,dort,0,0,4,4
24421,википедии ,0,0,4,4
21371,ಎಲ್ಲವೂ,0,0,4,4
30890,raised,0,0,4,4
24432,говоря,0,0,4,4
31439,предложений,0,0,4,4
31868,button,0,0,4,4
5933,budget,0,0,4,4
37379,bilgiler,0,0,4,4
40181,sehen.,0,0,4,4
38577,bit,0,0,4,4
31460,difference,0,0,4,4
32235,жаль.,0,0,4,4
1617,spazio,1,4,0,4
1608,cinque,1,4,0,4
37436,ελεύθερου,0,0,4,4
18810,experter,0,0,4,4
21549,primeros,0,0,4,4
40289,dieu.,0,0,4,4
21556,تايمز,0,0,4,4
30842,políticos,0,0,4,4
31841,administratorer,0,0,4,4
24484,vrij,0,0,4,4
18797,risk,0,0,4,4
51105,conocidos,0,0,4,4
18785,hombres,0,0,4,4
4823,w ·,0,0,4,4
18784,ಸರಿ,0,0,4,4
32253,incluyendo,0,0,4,4
49465,لأنني,0,0,4,4
30847,ലേഖനങ്ങളെ,0,0,4,4
4840,വേണം,0,0,4,4
23155,evet,0,0,4,4
4136,stessi,1,4,0,4
1163,riferimento,1,4,0,4
48710,بعتني,0,0,4,4
40275,mois,0,0,4,4
5990,elas,0,0,4,4
36523,initiative,0,0,4,4
23162,تقوله,0,0,4,4
4851,lesquels,0,0,4,4
18836,lugares,0,0,4,4
18838,flest,0,0,4,4
40256,из-за,0,0,4,4
2050,uso.,2,2,2,4
24485,cambio,0,0,4,4
36581,contigo,0,0,4,4
21346,അതെ,0,0,4,4
30831,entendu,0,0,4,4
23329,citando,0,0,4,4
36640,kvinnor.,0,0,4,4
19177,diskussionssidorna,0,0,4,4
51316,delen,0,0,4,4
24313,farklı,0,0,4,4
40031,दस,0,0,4,4
19167,പൂർണ്ണമായും,0,0,4,4
21170,amigo,0,0,4,4
23330,stable,0,0,4,4
19153,aristote,0,0,4,4
52172,industrial,0,0,4,4
19139,dépend,0,0,4,4
19138,trata,0,0,4,4
2007,posso.,2,2,2,4
21173,disponíveis,0,0,4,4
38739,over.,0,0,4,4
5840,этого.,0,0,4,4
36582,எதையாவது,0,0,4,4
21133,पश्चिमी,0,0,4,4
21112,சொற்களை,0,0,4,4
51564,namnet,0,0,4,4
5813,diciembre,0,0,4,4
21118,hear,0,0,4,4
19257,crianças,0,0,4,4
39977,ಬಳಸುವ,0,0,4,4
23342,elkaar,0,0,4,4
23331,ind,0,0,4,4
19234,empresas,0,0,4,4
36657,എന്നാണ്.,0,0,4,4
36654,ataques,0,0,4,4
21150,റൊട്ടി,0,0,4,4
36646,soi-même,0,0,4,4
19202,фонда,0,0,4,4
49370,kwam,0,0,4,4
40061,स्रोतों,0,0,4,4
42,en.wikipedia.org,2,1,3,4
40136,sommes,0,0,4,4
49395,multiple,0,0,4,4
24383,للحصول,0,0,4,4
23270,ஜனவரி,0,0,4,4
5904,لهم,0,0,4,4
23257,identify,0,0,4,4
23256,significantly,0,0,4,4
24398,l'anglais,0,0,4,4
1195,wikinfo,2,1,3,4
19015,cancer,0,0,4,4
21315,neutralitet,0,0,4,4
23250,kelimenin,0,0,4,4
40147,ting,0,0,4,4
37358,latter,0,0,4,4
4284,மட்டுமே,0,0,4,4
40118,sah,0,0,4,4
21241,ആഗ്രഹിക്കുന്നുവെങ്കിൽ,0,0,4,4
19058,छोटे,0,0,4,4
19059,reasons,0,0,4,4
21237,فقد,0,0,4,4
21229,moon,0,0,4,4
38707,अनुमति,0,0,4,4
19070,pardon,0,0,4,4
19071,dafür,0,0,4,4
24370,tend,0,0,4,4
19079,буду,0,0,4,4
38715,botão,0,0,4,4
40077,civil,0,0,4,4
40076,consejo,0,0,4,4
19111,single,0,0,4,4
23318,कैसा,0,0,4,4
37306,إجراؤها,0,0,4,4
30833,രാത്രി,0,0,4,4
1602,buona,1,4,0,4
32176,fürchte,0,0,4,4
18408,разными,0,0,4,4
6165,disagreement,0,0,4,4
36393,hypothesis,0,0,4,4
6167,enlightenment,0,0,4,4
36391,indicated,0,0,4,4
6169,chorando,0,0,4,4
49534,travaux,0,0,4,4
21758,oluyor,0,0,4,4
18432,detectar,0,0,4,4
38328,imagem,0,0,4,4
31802,namn,0,0,4,4
18378,tipos,0,0,4,4
151,biografia,2,2,2,4
51362,occurred,0,0,4,4
19,falso,2,3,1,4
40527,अ,0,0,4,4
48586,amsterdam,0,0,4,4
18506,сейчас,0,0,4,4
18459,leute,0,0,4,4
48600,इंजन,0,0,4,4
4743,τελευταία,0,0,4,4
24654,septiembre,0,0,4,4
21735,spelar,0,0,4,4
18481,working,0,0,4,4
1382,arthur,2,2,2,4
49525,लग,0,0,4,4
49531,spørge,0,0,4,4
38340,ஒவ்வொரு,0,0,4,4
48592,composed,0,0,4,4
48591,herhalen,0,0,4,4
49528,muito.,0,0,4,4
4735,formal,0,0,4,4
24676,dado,0,0,4,4
6186,एनसाइक्लोपीडिया,0,0,4,4
40571,português,0,0,4,4
37512,mantener,0,0,4,4
2142,ilp,2,2,2,4
1574,proprie,1,4,0,4
2135,dell'ia,1,4,0,4
21865,परेशानी,0,0,4,4
18276,наиболее,0,0,4,4
18271,பல்வேறு,0,0,4,4
30735,claim,0,0,4,4
48547,wikivoyage,0,0,4,4
48568,happen,0,0,4,4
38240,दैनिक,0,0,4,4
21887,sıra,0,0,4,4
18248,okej,0,0,4,4
4671,investigation,0,0,4,4
36313,நர்சிஸஸ்,0,0,4,4
24787,शांत,0,0,4,4
38267,answer,0,0,4,4
4689,مستخدم,0,0,4,4
21843,caching,0,0,4,4
38274,içindeyim,0,0,4,4
51073,ल्युसेन,0,0,4,4
40617,planer.,0,0,4,4
2125,egli,1,4,0,4
40606,वितरित,0,0,4,4
4694,समर्पित,0,0,4,4
40602,исследование,0,0,4,4
48562,french,0,0,4,4
4695,conditions.,0,0,4,4
6200,beck,0,0,4,4
22991,geweldige,0,0,4,4
48564,bush,0,0,4,4
40582,livres,0,0,4,4
40577,temperature,0,0,4,4
18495,άμαξα,0,0,4,4
48607,पारंपरिक,0,0,4,4
21597,طويل,0,0,4,4
21631,публикации,0,0,4,4
23086,அவர்களிடம்,0,0,4,4
36476,¿puedo,0,0,4,4
2074,difficoltà,1,4,0,4
36474,took,0,0,4,4
40370,organizações,0,0,4,4
30816,distinction,0,0,4,4
18676,crítica,0,0,4,4
40357,l'environnement,0,0,4,4
52220,font,0,0,4,4
4120,nata,1,4,0,4
40385,لطف,0,0,4,4
21637,pantano,0,0,4,4
18646,mama,0,0,4,4
18643,شركة,0,0,4,4
18700,bekymre,0,0,4,4
40356,comments,0,0,4,4
51355,завтра,0,0,4,4
18729,ceux,0,0,4,4
30828,pesquisas,0,0,4,4
23099,sharp,0,0,4,4
6031,أفهم,0,0,4,4
36495,trovärdighet,0,0,4,4
40332,organisms.,0,0,4,4
21610,заявил,0,0,4,4
36486, billion,0,0,4,4
48675,wissen,0,0,4,4
36481,requests,0,0,4,4
24556,ತಿನ್ನಲು,0,0,4,4
23093,couldn't,0,0,4,4
36479,φρικτό,0,0,4,4
23088,activamente,0,0,4,4
49800,क्रिएटिव,0,0,4,4
18632,إجراء,0,0,4,4
6073,continued,0,0,4,4
40400,consists,0,0,4,4
40455,solgte,0,0,4,4
1597,decisioni,1,4,0,4
18554,तीव्र,0,0,4,4
38381,chaîne,0,0,4,4
40449,reglas,0,0,4,4
18543,san,0,0,4,4
6115,einmal,0,0,4,4
36423,daglige,0,0,4,4
18629,benimle,0,0,4,4
18524,जगह,0,0,4,4
21688,இனிமையான,0,0,4,4
6128,जिसके,0,0,4,4
40466,ನೀಡಲು,0,0,4,4
40468,ways,0,0,4,4
23043,sentido,0,0,4,4
21672,deben,0,0,4,4
18568,परिणाम,0,0,4,4
30794,nenhum,0,0,4,4
18570,defining,0,0,4,4
4780,डाल,0,0,4,4
21651,sidorna,0,0,4,4
6094,air,0,0,4,4
40421,colaboração,0,0,4,4
36440,фонд,0,0,4,4
24606,первой,0,0,4,4
38401,sinds,0,0,4,4
18606,simply,0,0,4,4
18607,diriez-vous,0,0,4,4
37470,resources,0,0,4,4
18620,கட்டற்ற,0,0,4,4
18624,dónde,0,0,4,4
30804,incluir,0,0,4,4
23358,derechos,0,0,4,4
1678,importanti,1,4,0,4
51058,autonome,0,0,4,4
23930,functions,0,0,4,4
4199,beschikbaar,0,0,4,4
5256,среди,0,0,4,4
20494,mu,0,0,4,4
37064,soir,0,0,4,4
4197,canto,2,3,1,4
5512,on.,0,0,4,4
19943,digo,0,0,4,4
31125,позвольте,0,0,4,4
23672,eerder,0,0,4,4
37066,øjeblik,0,0,4,4
19926,أوه,0,0,4,4
23669,நினைக்கிறேன்.,0,0,4,4
1774,allo,1,4,0,4
19922,dicha,0,0,4,4
23680,कभी-कभी,0,0,4,4
19972,दृष्टिकोण,0,0,4,4
20012,position,0,0,4,4
49851,editable,0,0,4,4
20005,lois,0,0,4,4
20002,outubro,0,0,4,4
20461,أذهب,0,0,4,4
1785,andrea,2,1,3,4
23903,d'auteur,0,0,4,4
23687,stallman,0,0,4,4
19998,solid,0,0,4,4
39504,इसमें,0,0,4,4
1868,abstract,2,2,2,4
32066,books,0,0,4,4
19996,coming,0,0,4,4
39486,culture.,0,0,4,4
39497,fantastiska,0,0,4,4
4230,tillräckligt,0,0,4,4
23938,diverses,0,0,4,4
39533,μπορούσες,0,0,4,4
1773,computazionale,1,4,0,4
39125,βικιπαίδειας,0,0,4,4
31269,विश्वसनीयता,0,0,4,4
49212,بسبب,0,0,4,4
36880,नशीली,0,0,4,4
39586,πως,0,0,4,4
31094,guapo,0,0,4,4
20563,såg,0,0,4,4
1759,p,2,2,2,4
20508,constituye,0,0,4,4
39114,programmed,0,0,4,4
5205,franco,0,0,4,4
19824,बैठक,0,0,4,4
49220,dirigido,0,0,4,4
36872,gpl.,0,0,4,4
31275,complexe,0,0,4,4
23644,mudança,0,0,4,4
39571,bis,0,0,4,4
92,suffisso,1,4,0,4
39565,statut,0,0,4,4
23961,согласно,0,0,4,4
37079,arkadaşlarımla,0,0,4,4
23956,senden,0,0,4,4
5230,key,0,0,4,4
20535,motores,0,0,4,4
5234,بالتأكيد,0,0,4,4
23659,уэйлс,0,0,4,4
20520,ό,0,0,4,4
19893,gekommen,0,0,4,4
39545,sanger.,0,0,4,4
49875,толку,0,0,4,4
5238,языке,0,0,4,4
5240,ഹേയ്,0,0,4,4
31248,чего,0,0,4,4
20013,kommentar,0,0,4,4
39606,focuses,0,0,4,4
5407,हुई,0,0,4,4
82,fammi,1,4,0,4
5403,dizem,0,0,4,4
5404,brandchannel.com,0,0,4,4
36965,élevé,0,0,4,4
20321,understood,0,0,4,4
39284,ديسمبر,0,0,4,4
5326,ಕಡಿಮೆ,0,0,4,4
31177,julio,0,0,4,4
20156,وجهة,0,0,4,4
39390,stomverbaasd,0,0,4,4
31167,diferente,0,0,4,4
49088,recommendation,0,0,4,4
39402,اليومية,0,0,4,4
31224,nouveau,0,0,4,4
20309,வார,0,0,4,4
5341,áreas,0,0,4,4
1865,compito,1,4,0,4
20278,tegen,0,0,4,4
4215,अमेरिका,0,0,4,4
32026,hebben,0,0,4,4
31199,rond,0,0,4,4
20257,riquezas,0,0,4,4
39318,hellre,0,0,4,4
20276,l'humanité,0,0,4,4
5384,mayores,0,0,4,4
1278,devi,1,4,0,4
23773,besser,0,0,4,4
1279,pulsante,1,4,0,4
36981,stället,0,0,4,4
39352,respeito,0,0,4,4
23769,telegram,0,0,4,4
31208,там,0,0,4,4
20114,ली,0,0,4,4
5313,பகுதி,0,0,4,4
31160,يقرب,0,0,4,4
39219,minute,0,0,4,4
31237,speech,0,0,4,4
39226,கடந்து,0,0,4,4
5461,использование,0,0,4,4
31142,dur,0,0,4,4
1862,ragazzo,1,4,0,4
52188,extremamente,0,0,4,4
20430,typ,0,0,4,4
20091,بشأن,0,0,4,4
51244,himlen,0,0,4,4
39206,besoin,0,0,4,4
5467,получил,0,0,4,4
20023,ಸಾಮಾನ್ಯ,0,0,4,4
31136,recognition,0,0,4,4
36925,corrigés,0,0,4,4
1801,modi,1,4,0,4
5452,ciertos,0,0,4,4
20398,jonathan,0,0,4,4
4208,schwierigen,0,0,4,4
23884,translation,0,0,4,4
31235,eux,0,0,4,4
23881,planet,0,0,4,4
20391,لها,0,0,4,4
20385,nuevas,0,0,4,4
37026,பயப்படுகிறேன்.,0,0,4,4
39249,told,0,0,4,4
39250,देखते,0,0,4,4
20076,publicidad,0,0,4,4
20078,ராக்,0,0,4,4
1854,soft,1,4,0,4
39260,back,0,0,4,4
20084,делает,0,0,4,4
37100,senin,0,0,4,4
20618,champ,0,0,4,4
19284,determine,0,0,4,4
23421,kullanıcılar,0,0,4,4
20959,имя,0,0,4,4
39827,attempt,0,0,4,4
39830,unten,0,0,4,4
19472,dedicado,0,0,4,4
19464,रोक,0,0,4,4
36735,zelf,0,0,4,4
39859,ouvir,0,0,4,4
32147,файлов,0,0,4,4
20975,détectés,0,0,4,4
51486,direito,0,0,4,4
5063,åka,0,0,4,4
1956,gioco,1,4,0,4
30996,passer,0,0,4,4
5746,allowed,0,0,4,4
20949,förvirrade,0,0,4,4
48898,العالم,0,0,4,4
48908,heard,0,0,4,4
37221,εγώ,0,0,4,4
58,li,2,2,2,4
24140,ziet,0,0,4,4
20914,aparecer,0,0,4,4
23453,चीज,0,0,4,4
49300,وتيري,0,0,4,4
5706,நாம்,0,0,4,4
19509,domesday,0,0,4,4
32146,wants,0,0,4,4
37224,لماذا,0,0,4,4
38895,தொந்தரவு,0,0,4,4
19502,некоторых,0,0,4,4
53,diventare,1,4,0,4
38892,formes,0,0,4,4
31016,poor,0,0,4,4
23411,één,0,0,4,4
5055,ecological,0,0,4,4
23410,चलो,0,0,4,4
38807,recentes,0,0,4,4
19343,उनसे,0,0,4,4
31371,store,0,0,4,4
24243,gjordes,0,0,4,4
21052,geben.,0,0,4,4
23378,insider,0,0,4,4
24245,института,0,0,4,4
24248,ongeveer,0,0,4,4
36717,औपचारिक,0,0,4,4
19316,devem,0,0,4,4
1980,cielo,2,2,2,4
39948,lembre-se,0,0,4,4
38787,actual,0,0,4,4
1982,campi,1,4,0,4
21101,பிற,0,0,4,4
19344,escrita,0,0,4,4
39914,زر,0,0,4,4
21028,എന്തായാലും,0,0,4,4
19370,ജോലിയിൽ,0,0,4,4
52177,ಇಂದು,0,0,4,4
24220,βρίσκεστε,0,0,4,4
38845,അമ്മ,0,0,4,4
31360,şu,0,0,4,4
30985,bekend,0,0,4,4
39891,considéré,0,0,4,4
1220,inglesi,1,4,0,4
48867,jusqu'à,0,0,4,4
31927,«нупедии».,0,0,4,4
51301,l'informatique,0,0,4,4
1962,mano,2,2,2,4
24203,अक्टूबर,0,0,4,4
30991,försökt,0,0,4,4
24129,analyse,0,0,4,4
19550,καλό,0,0,4,4
20625,प्रारंभिक,0,0,4,4
51543,ambos,0,0,4,4
48966,genoemd,0,0,4,4
39663,trabajar,0,0,4,4
51179,historial,0,0,4,4
39669,je.,0,0,4,4
48958,d'accord,0,0,4,4
5624,அன்பே,0,0,4,4
39679,всё,0,0,4,4
36848,children,0,0,4,4
39013,എന്നോട്,0,0,4,4
5634,stilig,0,0,4,4
48949,noget.,0,0,4,4
20758,aparecen,0,0,4,4
48947,കാണുന്നു.,0,0,4,4
48945,paul,0,0,4,4
19738,बनाने,0,0,4,4
39643,länkar,0,0,4,4
32139,पृष्ठों,0,0,4,4
49236,gars,0,0,4,4
39083,açı,0,0,4,4
36865,língua,0,0,4,4
23996,धाराप्रवाह,0,0,4,4
39061,मिनट,0,0,4,4
39617,poäng,0,0,4,4
24005,всем,0,0,4,4
39629,നമുക്ക്,0,0,4,4
49882,connaissance,0,0,4,4
39630,извините,0,0,4,4
51268,promover,0,0,4,4
19765,nécessaire],0,0,4,4
5597,പദ്ധതികൾ,0,0,4,4
5600,description,0,0,4,4
32103,sociala,0,0,4,4
36820,vandalisme,0,0,4,4
38994,falsas,0,0,4,4
24057,سانجر,0,0,4,4
39753,falando,0,0,4,4
36793,neredeyse,0,0,4,4
19603,protocole,0,0,4,4
5673,உணவு,0,0,4,4
49281,tam,0,0,4,4
19599,anterior,0,0,4,4
39752,إزالة,0,0,4,4
1710,bancario,2,2,2,4
20795,s'est,0,0,4,4
37192,uppslagsverk,0,0,4,4
19583,continuous,0,0,4,4
38936,जांच,0,0,4,4
49290,vloeiend,0,0,4,4
48915,l'année,0,0,4,4
31944,மொழிகளில்,0,0,4,4
19618,année,0,0,4,4
37188,tio,0,0,4,4
31319,développer,0,0,4,4
1713,narciso.,2,1,3,4
24081,adopted,0,0,4,4
49276,لأن,0,0,4,4
20836,सर्वरों,0,0,4,4
49273,самым,0,0,4,4
1318,voci.,1,4,0,4
24072,स्वतंत्र,0,0,4,4
32122,certa,0,0,4,4
1717,punteggio,1,4,0,4
1241,chiamato,1,4,0,4
31048,помочь,0,0,4,4
39714,près,0,0,4,4
5132,поддерживает,0,0,4,4
39703,உண்மையில்,0,0,4,4
48537,glück,0,0,4,4
20242,particularly,0,0,4,4
24793,pedindo,0,0,4,4
6424,désigner,0,0,4,4
36165,extension,0,0,4,4
17757,skribenter,0,0,4,4
25006,doctor,0,0,4,4
25003,quadriga,0,0,4,4
49652,primera,0,0,4,4
51642,médio,0,0,4,4
38027,العربة,0,0,4,4
22203,vognen,0,0,4,4
1516,sarà,1,4,0,4
22198,skapa,0,0,4,4
1077,positivo,2,1,3,4
48439,greater,0,0,4,4
36183,sonu,0,0,4,4
49649,navn,0,0,4,4
30647,laissez-moi,0,0,4,4
4060,provenienti,1,4,0,4
17829,लिखे,0,0,4,4
30650,बाहर,0,0,4,4
32376,δωρεάν,0,0,4,4
51442,liebe,0,0,4,4
38050,baidu,0,0,4,4
38051,period,0,0,4,4
30632,homem,0,0,4,4
1515,chiamati,1,4,0,4
17728,samme,0,0,4,4
22796,அவரது,0,0,4,4
22315,maher,0,0,4,4
41043,tipp,0,0,4,4
51406,ofte,0,0,4,4
36135,aumentar,0,0,4,4
17659,agrupamiento,0,0,4,4
37959,prize,0,0,4,4
51398,komt,0,0,4,4
25049,जिससे,0,0,4,4
32396,सम्बन्धी,0,0,4,4
4518,βίντεο.,0,0,4,4
17688,கோபமாக,0,0,4,4
30623,வண்டியில்,0,0,4,4
22258,любой,0,0,4,4
25044,jamais,0,0,4,4
22256,கூடுதல்,0,0,4,4
40996,fail,0,0,4,4
36151,июня,0,0,4,4
6451,en.,0,0,4,4
6450,vaut,0,0,4,4
48409,predictive,0,0,4,4
22229,neerlandés,0,0,4,4
4563,fredag,0,0,4,4
17848,technique,0,0,4,4
18065,नार्सीसा,0,0,4,4
22883,दिल,0,0,4,4
40813,dizer.,0,0,4,4
2204,rispondere,1,4,0,4
38122,ней,0,0,4,4
4602,unutmayın.,0,0,4,4
37602,عزيزي,0,0,4,4
1098,relativamente,2,2,2,4
31769,publicerar,0,0,4,4
6340,preocupada,0,0,4,4
38139,förklarar,0,0,4,4
2198,film,2,1,3,4
22884,«википедии»,0,0,4,4
17856,mim.,0,0,4,4
22893,grupos,0,0,4,4
4620,letterlijk,0,0,4,4
49598,modos,0,0,4,4
40777,frequently,0,0,4,4
22014,дам,0,0,4,4
48490,distribución,0,0,4,4
18052,thing,0,0,4,4
38160,pelos,0,0,4,4
49593,inklusive,0,0,4,4
24866,endişelenme,0,0,4,4
1534,comportamento,2,3,1,4
52227,статью,0,0,4,4
22861,इतिहास,0,0,4,4
17951,تأخذ,0,0,4,4
22832,this.,0,0,4,4
1526,c'era,1,4,0,4
38074,responsible,0,0,4,4
6386,самом,0,0,4,4
24948,الأكثر,0,0,4,4
17879,tussen,0,0,4,4
37624,notre,0,0,4,4
40879,pläne,0,0,4,4
24946,कॉपीराइट,0,0,4,4
40871,मिल,0,0,4,4
17894,версия,0,0,4,4
22121,yanlış,0,0,4,4
48457,progrès,0,0,4,4
4578,antar,0,0,4,4
24935,बताने,0,0,4,4
17928,டெர்ரி,0,0,4,4
38104,المستخدمين,0,0,4,4
49953,εκπληκτικό,0,0,4,4
40840,όσο,0,0,4,4
30676,tras,0,0,4,4
31766,bakış,0,0,4,4
22322,visas,0,0,4,4
30615,creada,0,0,4,4
22328,വാക്കിന്റെ,0,0,4,4
17379,côté,0,0,4,4
41268,δεδομένων,0,0,4,4
1036,apprendere,1,4,0,4
22645,wasn't,0,0,4,4
37818,வீடியோவில்,0,0,4,4
6600,law.,0,0,4,4
41251,mantenimiento,0,0,4,4
37733,محرر,0,0,4,4
25206,concern,0,0,4,4
17376,വീട്ടിലേക്ക്,0,0,4,4
50978,vê,0,0,4,4
1448,nota,2,2,2,4
22330,يوجد,0,0,4,4
1051,indica,2,1,3,4
37830,octubre,0,0,4,4
22661,vendeu,0,0,4,4
32433,أظهرت,0,0,4,4
49977,frequentemente,0,0,4,4
4362,карета,0,0,4,4
6564,anderer,0,0,4,4
22666,faz,0,0,4,4
32427,المنفرجة,0,0,4,4
37849,சொல்லுங்கள்.,0,0,4,4
17312,botón,0,0,4,4
2323,genere,2,1,3,4
22532,activos,0,0,4,4
41281,dios,0,0,4,4
22604,котором,0,0,4,4
37767,പരിഹാരത്തിലാണ്,0,0,4,4
6656,jij,0,0,4,4
17198,screwed,0,0,4,4
41344,team,0,0,4,4
17209,knap,0,0,4,4
2347,induttiva,1,4,0,4
1457,biblioteca,2,1,3,4
31696,योगदान,0,0,4,4
186,lingue,1,4,0,4
22582,réalisée,0,0,4,4
37787,económico,0,0,4,4
37751,slow,0,0,4,4
2335,nica,2,1,3,4
17274,മുതൽ,0,0,4,4
22547,función,0,0,4,4
1029,amministratori,1,4,0,4
22636,чрезвычайно,0,0,4,4
185,m.,2,1,3,4
37806,निम्न,0,0,4,4
17293,खा,0,0,4,4
22674,आधारित,0,0,4,4
48341,incluem,0,0,4,4
37713,editada,0,0,4,4
50993,committee,0,0,4,4
1435,andiamo,1,4,0,4
6520,pratique,0,0,4,4
17552,höfling,0,0,4,4
17553,fake,0,0,4,4
6516,mann,0,0,4,4
22724,പറയുകയും,0,0,4,4
22363,ಹೇ,0,0,4,4
22730,entschuldigung,0,0,4,4
25116,correspond,0,0,4,4
22732,sentences,0,0,4,4
6503,боюсь,0,0,4,4
31734,μένα,0,0,4,4
31636,வேண்டாம்.,0,0,4,4
48378,hålla,0,0,4,4
37931,تمانع,0,0,4,4
17595,café,0,0,4,4
41067,présentée,0,0,4,4
37937,realize,0,0,4,4
37683,χρησιμοποιώ,0,0,4,4
1430,cell,2,1,3,4
22333,catégories,0,0,4,4
41104,junto,0,0,4,4
37696,dernier,0,0,4,4
22690,الحصول,0,0,4,4
22716,hørt,0,0,4,4
25150,भाग्यशाली,0,0,4,4
51415,ಮಾಡುವ,0,0,4,4
17494,പ്രവർത്തിക്കുന്ന,0,0,4,4
31655,sucede,0,0,4,4
22695,goda,0,0,4,4
41139,küçük,0,0,4,4
25144,venligt,0,0,4,4
31653,text.,0,0,4,4
4447,lektioner,0,0,4,4
37883,கணம்,0,0,4,4
41132,आदमी,0,0,4,4
37894,ब्रिटेन,0,0,4,4
51411,हिस्सा,0,0,4,4
31649,κλαίει,0,0,4,4
22396,sister,0,0,4,4
6537,références,0,0,4,4
4459,получила,0,0,4,4
48357,behöver,0,0,4,4
17529,നഷ്ടം,0,0,4,4
36099,aften,0,0,4,4
41108,غالبًا,0,0,4,4
22011,வேல்ஸ்,0,0,4,4
36157,कितना,0,0,4,4
6275,महत्वपूर्ण,0,0,4,4
18199,tyska,0,0,4,4
1555,buon,2,3,1,4
40747,titre,0,0,4,4
6283,ಇಂಗ್ಲಿಷ್,0,0,4,4
2157,trimestre,2,1,3,4
40727,servir,0,0,4,4
22004,இருக்கும்.,0,0,4,4
40753,schon,0,0,4,4
21997,environ,0,0,4,4
38182,पाठ्य,0,0,4,4
4649,artiklarna,0,0,4,4
21948,toe,0,0,4,4
40690,കാണാൻ,0,0,4,4
32334,вклад,0,0,4,4
4090,nuovi,1,4,0,4
6296,überflutet,0,0,4,4
40732,ತನ್ನ,0,0,4,4
24800,вопрос,0,0,4,4
36271,सुना,0,0,4,4
2182,ricercatori,1,4,0,4
40736,الاتصال,0,0,4,4
21960,सहयोगी,0,0,4,4
49781,अनुरोध,0,0,4,4
18105,gabriel.,0,0,4,4
49945,мило,0,0,4,4
40737,dagliga,0,0,4,4
51043,ವೀಡಿಯೊವನ್ನು,0,0,4,4
36304,réponse,0,0,4,4
4659,جامعة,0,0,4,4
21945,tú,0,0,4,4
51047,entrou,0,0,4,4
40758,genoeg,0,0,4,4
49946,flere,0,0,4,4
18202,настолько,0,0,4,4
24835,interactive,0,0,4,4
22714,midt,0,0,3,3
28434,изменений,0,0,3,3
27776,ner,0,0,3,3
23539,trabaja,0,0,3,3
1579,esiste,1,3,0,3
22712,بطلاقة,0,0,3,3
22994,ಬದಲು,0,0,3,3
44608,atroz.,0,0,3,3
20576,estimates,0,0,3,3
10021,விக்கிப்பீடியாவில்,0,0,3,3
20609,essayez,0,0,3,3
1440,mentalmente,2,1,2,3
44601,ozone,0,0,3,3
37150,صفحات,0,0,3,3
33605,ഇതാണ്,0,0,3,3
20742,evaluation,0,0,3,3
37904,rica,0,0,3,3
51276,telles,0,0,3,3
39117,thanks.,0,0,3,3
1729,identifica,2,2,1,3
1730,modelli,1,3,0,3
39027,venu,0,0,3,3
428,perplesso,1,3,0,3
20723,nicholas,0,0,3,3
20581,दोपहर,0,0,3,3
38296,graphic,0,0,3,3
44589,devons,0,0,3,3
22430,laisse,0,0,3,3
44628,volumes,0,0,3,3
1722,tali,1,3,0,3
38306,മുമ്പ്,0,0,3,3
20781,söyleyebilirsiniz.,0,0,3,3
20780,биологии,0,0,3,3
38304,revelou,0,0,3,3
45609,buitengewoon,0,0,3,3
38998,malgré,0,0,3,3
50473,kanaal,0,0,3,3
23529,aquele,0,0,3,3
1581,mie,1,3,0,3
44609,bloqueios,0,0,3,3
20554,n'écoutais,0,0,3,3
39138,distintas,0,0,3,3
3491,thomas,2,1,2,3
10903,मिडिया,0,0,3,3
37878,flydende,0,0,3,3
20756,значение,0,0,3,3
23636,ചിത്രങ്ങൾ,0,0,3,3
33625,हे,0,0,3,3
10737,reprenant,0,0,3,3
12243,receio,0,0,3,3
50475,работает,0,0,3,3
502,bisogno,1,3,0,3
33886,devenues,0,0,3,3
45535,dourado,0,0,3,3
20679,söyleyebilir,0,0,3,3
20676,बैंक,0,0,3,3
22419,மதிய,0,0,3,3
1744,mangiarlo,1,3,0,3
39060,lançou,0,0,3,3
20594,universe.,0,0,3,3
12334,amerikanen,0,0,3,3
12336,vriend,0,0,3,3
51454,प्रयुक्त,0,0,3,3
44556,climat,0,0,3,3
44542,vão,0,0,3,3
22941,канал,0,0,3,3
10746,lake,0,0,3,3
45531,кроме,0,0,3,3
20639,criança,0,0,3,3
37111,kvinnor,0,0,3,3
34357,abierta,0,0,3,3
9987,наличие,0,0,3,3
3500,emigh,2,2,1,3
20621,gekomen,0,0,3,3
3365,propri,1,3,0,3
23610,suggère,0,0,3,3
44544,melhores,0,0,3,3
22415,другое,0,0,3,3
22701,நுபீடியாவிற்கு,0,0,3,3
39034,buy,0,0,3,3
28447,foundation's,0,0,3,3
22696,அடிக்கடி,0,0,3,3
20712,expert,0,0,3,3
20707,wahr,0,0,3,3
50476,мотивации,0,0,3,3
28505,അവസാന,0,0,3,3
604,copyleft,2,1,2,3
39041,ann,0,0,3,3
10888,решение,0,0,3,3
46091,ordre,0,0,3,3
37699,contrarié,0,0,3,3
10856,encontrar,0,0,3,3
39048,вещи,0,0,3,3
427,domani,1,3,0,3
39113,фраз,0,0,3,3
27729,throughout,0,0,3,3
38993,prática,0,0,3,3
20689,dia.,0,0,3,3
10876,consideraba,0,0,3,3
33609,ഒബ്ട്യൂസ്,0,0,3,3
10872,ஏற்கனவே,0,0,3,3
20687,सीखने,0,0,3,3
3498,blue,2,1,2,3
39053,zacht,0,0,3,3
38391,idée,0,0,3,3
27804,zusammen,0,0,3,3
20789,konu,0,0,3,3
22935,വിവരങ്ങൾ,0,0,3,3
22331,cofondateur,0,0,3,3
45480,மிக,0,0,3,3
28791,ഉള്ളടക്കം,0,0,3,3
22743,sizin,0,0,3,3
10134,volgens,0,0,3,3
10133,പറയാം.,0,0,3,3
21760,computadoras,0,0,3,3
44708,शिकायत,0,0,3,3
46008,hoofdredacteur,0,0,3,3
1385,ripeterlo,1,3,0,3
12116,التخريب،,0,0,3,3
37219,«wikipedia»,0,0,3,3
38909,verifiability,0,0,3,3
37228,ваше,0,0,3,3
22341,खोज,0,0,3,3
27844,acute,0,0,3,3
50310,möjligt,0,0,3,3
21779,சற்று,0,0,3,3
20897,«фаза,0,0,3,3
33640,мои,0,0,3,3
20890,πριν,0,0,3,3
33638,dress,0,0,3,3
12130,tells,0,0,3,3
27837,dediğini,0,0,3,3
12138,informação,0,0,3,3
46020,ಪಡೆದಿದ್ದೇನೆ,0,0,3,3
1328,«una,2,1,2,3
45985,yorum,0,0,3,3
1312,articoli,1,3,0,3
28781,словам,0,0,3,3
20980,advertising,0,0,3,3
10179,μέση,0,0,3,3
10174,मन,0,0,3,3
10963,fais,0,0,3,3
20972,seinen,0,0,3,3
45978,condición,0,0,3,3
593,wikisource,2,1,2,3
22751,सवार,0,0,3,3
44744,எந்தவொரு,0,0,3,3
33900,domains,0,0,3,3
20966,alemã,0,0,3,3
20964,ஆச்சரியமாக,0,0,3,3
23426,dichotomie,0,0,3,3
10728,खींचते,0,0,3,3
12071,blandt,0,0,3,3
45474,يريد,0,0,3,3
44733,bekymret,0,0,3,3
595,persona.,2,1,2,3
51437,تيري,0,0,3,3
28416,समायोजित,0,0,3,3
44729,überhaupt,0,0,3,3
12081,spielt,0,0,3,3
28783,ക്ഷമിക്കൂ.,0,0,3,3
21943,kijken.,0,0,3,3
12087,गुस्सा,0,0,3,3
20948,ur,0,0,3,3
28816,الألمانية,0,0,3,3
44686,liberdade,0,0,3,3
38929,άσε,0,0,3,3
38307,πείτε.,0,0,3,3
3487,stampate,1,3,0,3
33844,område,0,0,3,3
44647,raderas.,0,0,3,3
22357,позднее,0,0,3,3
10059,mich.,0,0,3,3
1583,affermato,1,3,0,3
20829,publicar,0,0,3,3
27806,принимайте,0,0,3,3
10058,skrivandet,0,0,3,3
3170,presto,1,3,0,3
22362,verktyg,0,0,3,3
28835,kelimesini,0,0,3,3
22729,understand,0,0,3,3
37685,unas,0,0,3,3
51282,oraciones,0,0,3,3
38974,emploi,0,0,3,3
22723,ficou,0,0,3,3
20815,ಮೊದಲು,0,0,3,3
46054,netflix,0,0,3,3
39140,ethical,0,0,3,3
27803,слышали,0,0,3,3
37175,gemensam,0,0,3,3
3490,migliorare,1,3,0,3
50373,value,0,0,3,3
28507,hört,0,0,3,3
1313,quegli,1,3,0,3
46038,structural,0,0,3,3
21786,ಪ್ರಾರಂಭಿಸಿದಳು,0,0,3,3
44654,souligne,0,0,3,3
28826,പറഞ്ഞാൽ,0,0,3,3
23471,ಕ್ಷಮಿಸು.,0,0,3,3
27832,rama,0,0,3,3
20877,عما,0,0,3,3
34292,εντελώς,0,0,3,3
21785,cour,0,0,3,3
10090,caa,0,0,3,3
33634,kjole,0,0,3,3
12155,நபரை,0,0,3,3
20873,no-brainer.,0,0,3,3
20866,kenmerken,0,0,3,3
12167,dil,0,0,3,3
33843,mondial,0,0,3,3
3482,comunità.,1,3,0,3
44664,saturday,0,0,3,3
20855,fragt,0,0,3,3
21940,ಮಾಡಿ,0,0,3,3
600,piacere,1,3,0,3
34301,wireless,0,0,3,3
22350,normalt,0,0,3,3
10920,citações,0,0,3,3
38954,மேல்,0,0,3,3
37689,pop,0,0,3,3
10074,geometri,0,0,3,3
10072,தானியங்கிகள்,0,0,3,3
44655,frasen,0,0,3,3
12398,ediciones.,0,0,3,3
45541,मार्क,0,0,3,3
9963,கொஞ்சம்,0,0,3,3
9810,serai,0,0,3,3
45592,referências,0,0,3,3
37022,المثيرة,0,0,3,3
9809,covers,0,0,3,3
28480,matérialistes,0,0,3,3
1808,vero,1,3,0,3
33857,сообществе,0,0,3,3
45579,éditions ,0,0,3,3
27558,actúan,0,0,3,3
20360,ajouts,0,0,3,3
12696,الحادة,0,0,3,3
12698,नंबर,0,0,3,3
44317,countries,0,0,3,3
33547,बन,0,0,3,3
22632,पोशाक,0,0,3,3
22629,enojado,0,0,3,3
22625,olhos,0,0,3,3
20354,diyebilirsiniz,0,0,3,3
46211,former,0,0,3,3
1287,strettamente,1,3,0,3
44315,oración,0,0,3,3
27551,diyebilirsin,0,0,3,3
51234,ονομάζεται,0,0,3,3
23749,chamados,0,0,3,3
37553,obra,0,0,3,3
20346,artikler.,0,0,3,3
39268,birine,0,0,3,3
27542,language.,0,0,3,3
39254,sunulmaktadır.,0,0,3,3
12663,computacional,0,0,3,3
12400,नकारात्मक,0,0,3,3
21878,вечером,0,0,3,3
37541,annesi,0,0,3,3
1290,lì,1,3,0,3
21919,contar.,0,0,3,3
9844,लेरी,0,0,3,3
9842,पोर्टल,0,0,3,3
22527,издание,0,0,3,3
46178,वहाँ,0,0,3,3
37039,clase,0,0,3,3
20403,virginia,0,0,3,3
44361,øjeblik.,0,0,3,3
28926,ആണ്.,0,0,3,3
20402,old,0,0,3,3
44356,lição,0,0,3,3
10811,allow,0,0,3,3
22946,लाभ,0,0,3,3
22639,provided,0,0,3,3
27582,മുന്നോട്ട്,0,0,3,3
33854,oxygen,0,0,3,3
37807,money,0,0,3,3
22541,başladı,0,0,3,3
34449,bibliotecarios,0,0,3,3
44346,ಹೋಗಿ,0,0,3,3
23726,gelip,0,0,3,3
10806,आए,0,0,3,3
28476,состоянию,0,0,3,3
37029,kovitz,0,0,3,3
33556,swamp,0,0,3,3
44301,básicas,0,0,3,3
27540,исследования,0,0,3,3
50284,पहुँच,0,0,3,3
39269,இருக்கிறார்,0,0,3,3
28487,auktoritativa,0,0,3,3
12790,него,0,0,3,3
22600,gruwelijke,0,0,3,3
12795,mellem,0,0,3,3
9734,ಯಾರಿಗಾದರೂ,0,0,3,3
20293,общего,0,0,3,3
22956,vardı,0,0,3,3
39303,estudiantes,0,0,3,3
28977,primeiros,0,0,3,3
27511,läuft,0,0,3,3
3375,credo,1,3,0,3
28978,yaygın,0,0,3,3
46251,verdade,0,0,3,3
28981,أحدث,0,0,3,3
20273,लिया,0,0,3,3
3060,penso,2,2,1,3
34492,souhaitée].,0,0,3,3
39311,ببطء,0,0,3,3
3059,veloce,1,3,0,3
21905,besøgt,0,0,3,3
21914,waardoor,0,0,3,3
20246,сми,0,0,3,3
34502,थोड़ी,0,0,3,3
12849,percent.,0,0,3,3
20245,தமிழ்,0,0,3,3
1400,potrebbero,1,3,0,3
28492,нам,0,0,3,3
46244,γίνεται,0,0,3,3
12787,events,0,0,3,3
3544,distribuito,1,3,0,3
50535,എന്തിനാണ്,0,0,3,3
20337,traditionele,0,0,3,3
23756,सोचना,0,0,3,3
27535,konsensus.,0,0,3,3
9763,gramática,0,0,3,3
10789,licenças,0,0,3,3
12745,cómo,0,0,3,3
9761,feitos,0,0,3,3
22960,teste,0,0,3,3
9758,juan,0,0,3,3
9753,unlabeled,0,0,3,3
37778,أنواع,0,0,3,3
44284,αυτήν,0,0,3,3
27525,ваши,0,0,3,3
20297,другим,0,0,3,3
27523,النرجس,0,0,3,3
22588,contribuer,0,0,3,3
20318,κανόνες,0,0,3,3
37772,seule,0,0,3,3
3068,accademici,1,3,0,3
37771,board,0,0,3,3
20313,دعني,0,0,3,3
20311,stationära,0,0,3,3
46238,submit,0,0,3,3
20306,claims,0,0,3,3
34484,filtros,0,0,3,3
27516,через,0,0,3,3
9845,levou,0,0,3,3
28921,ಹೊಸ,0,0,3,3
22524,πουλήσατε,0,0,3,3
46136,prijs,0,0,3,3
22460,إلهي.,0,0,3,3
45603,lugar.,0,0,3,3
34399,يؤدي,0,0,3,3
38217,يستحق,0,0,3,3
27660,नया,0,0,3,3
10848,தங்கத்தால்,0,0,3,3
39165,പ്രിയപ്പെട്ട,0,0,3,3
22669,trabajo.,0,0,3,3
10846,longer,0,0,3,3
3115,rende,2,2,1,3
28496,réseaux,0,0,3,3
22476,बच्चे,0,0,3,3
9926,fevereiro,0,0,3,3
23667,diaria,0,0,3,3
20503,d'eau,0,0,3,3
10839,detección,0,0,3,3
3112,che.,1,3,0,3
46126,linterweb,0,0,3,3
50503,utilización,0,0,3,3
45549,وهم,0,0,3,3
22480,verbaasd,0,0,3,3
34409,determinados,0,0,3,3
12510,advanced,0,0,3,3
22484,noyau,0,0,3,3
50505,पूछने,0,0,3,3
28898,remis,0,0,3,3
38270,klage,0,0,3,3
37719,manual,0,0,3,3
37859,orlowski,0,0,3,3
51419,തുടർന്ന്,0,0,3,3
33593,y.,0,0,3,3
22692,mener,0,0,3,3
12416,l'apparition,0,0,3,3
9956,അതിന്റെ,0,0,3,3
22432,eux-mêmes,0,0,3,3
23645,собственном,0,0,3,3
38866,servere,0,0,3,3
9949,contenant,0,0,3,3
12421,ಸ್ಕೋರ್,0,0,3,3
37083,cumplen,0,0,3,3
23647,brown,0,0,3,3
44494,ينزعج,0,0,3,3
3124,succedendo,1,3,0,3
20543,torno,0,0,3,3
37075,ஏதேனும்,0,0,3,3
34386,διόρθωση,0,0,3,3
3509,oggetto,1,3,0,3
12446,suivent,0,0,3,3
37080,outputs,0,0,3,3
50496,وقد,0,0,3,3
12450,تعديلات,0,0,3,3
50297,davon,0,0,3,3
485,revisione,1,3,0,3
37862,αδελφικά,0,0,3,3
45542,connaissances.,0,0,3,3
12455,extrêmement,0,0,3,3
20531,skaffa,0,0,3,3
27649,денег,0,0,3,3
9908,мой,0,0,3,3
51245,publié,0,0,3,3
3515,portato,1,3,0,3
46149,match,0,0,3,3
45562,مشاريع,0,0,3,3
1466,considerata,1,3,0,3
22944,navnet,0,0,3,3
28908,location,0,0,3,3
3523,lungo,1,3,0,3
50517,decir.,0,0,3,3
37824,tendens,0,0,3,3
23692,vietnamita,0,0,3,3
12585,पैदा,0,0,3,3
44393,lisansı,0,0,3,3
44385,അധികം,0,0,3,3
34435,مجلة,0,0,3,3
1398,occhi,1,3,0,3
22514,സുഹൃത്തുക്കളുമായി,0,0,3,3
33864,الأحيان,0,0,3,3
20455,जहाँ,0,0,3,3
12604,संशोधन,0,0,3,3
12610,neuron,0,0,3,3
9866,फिल्मों,0,0,3,3
3526,disciplina,2,2,1,3
20453,ക്രൂരമായ,0,0,3,3
33863,ess,0,0,3,3
1789,insulto,2,1,2,3
9855,helpen,0,0,3,3
44375,acquis,0,0,3,3
12617,deliver,0,0,3,3
12562,frågor,0,0,3,3
9886,секретный,0,0,3,3
46146,डिग्री,0,0,3,3
12547,பார்க்கிறேன்.,0,0,3,3
3516,fame,1,3,0,3
20484,sequence,0,0,3,3
50508,ವಿದಾಯ,0,0,3,3
20482,l'analyse,0,0,3,3
38269,similarly,0,0,3,3
1779,risposta,1,3,0,3
44433,программного,0,0,3,3
9898,gidiyor,0,0,3,3
45597,ആർക്കും,0,0,3,3
12539,reading,0,0,3,3
34420,daarmee,0,0,3,3
44419,results.,0,0,3,3
12548,onunla,0,0,3,3
50514,acuerdo,0,0,3,3
10766,قاموس,0,0,3,3
9896,propres,0,0,3,3
10768,haut,0,0,3,3
12552,women,0,0,3,3
37060,ಇರುವ,0,0,3,3
21858,विकिबुक्स,0,0,3,3
20476,ήθελα,0,0,3,3
22501,объектами,0,0,3,3
22973,оно,0,0,3,3
44414,decisão,0,0,3,3
22503,ഒപ്പം,0,0,3,3
20475,لديهم,0,0,3,3
44755,आई,0,0,3,3
22755,सितम्बर,0,0,3,3
10180,relativement,0,0,3,3
1527,semi,1,3,0,3
10491,democrática,0,0,3,3
1530,dvd.,2,1,2,3
51923,magnifique,0,0,3,3
23051,automática,0,0,3,3
37619,sério,0,0,3,3
38517,духе,0,0,3,3
11412,episódio,0,0,3,3
33761,portent,0,0,3,3
11413,pidiendo,0,0,3,3
37620,меня.,0,0,3,3
45417,समूह,0,0,3,3
45172,libros,0,0,3,3
37488,टिप,0,0,3,3
38523,rey,0,0,3,3
50412,प्रेरित,0,0,3,3
3279,servizio,1,3,0,3
21704,hem.,0,0,3,3
38524,propias,0,0,3,3
28185,killar,0,0,3,3
11430,الحظ,0,0,3,3
23169,weight,0,0,3,3
1364,accademica,1,3,0,3
11434,indépendamment,0,0,3,3
45156,يكن,0,0,3,3
3273,intende,1,3,0,3
21469,നല്ലതാണ്,0,0,3,3
45153,fallen,0,0,3,3
11406,متأكد,0,0,3,3
45760,cultural,0,0,3,3
11404,στιγμή.,0,0,3,3
10503,लागू,0,0,3,3
11323,problems.,0,0,3,3
21543,insanların,0,0,3,3
10509,prevent,0,0,3,3
37432,inaccuracies,0,0,3,3
28228,inte.,0,0,3,3
21519,αργά,0,0,3,3
28615,ഫ്രഞ്ച്,0,0,3,3
37610,أيضا,0,0,3,3
33767,användning,0,0,3,3
38498,fritt,0,0,3,3
1615,bradley,2,1,2,3
51924,olacağım,0,0,3,3
28213,αιχμηρή,0,0,3,3
34046,machst,0,0,3,3
34034,special,0,0,3,3
10502,τίποτα,0,0,3,3
28206,acquisition,0,0,3,3
38511,eliminar,0,0,3,3
38098,जिम्मी,0,0,3,3
21498,instalación,0,0,3,3
21494,особенно,0,0,3,3
28618,خبرة,0,0,3,3
22107,могу.,0,0,3,3
1411,mancanza,1,3,0,3
3283,nello,1,3,0,3
45182,करो।,0,0,3,3
23046,speciellt,0,0,3,3
511,ragione,1,3,0,3
20988,pesquisa.,0,0,3,3
23172,entendeu,0,0,3,3
23201,ಧನ್ಯವಾದ,0,0,3,3
21411,conseguiu,0,0,3,3
11530,développée,0,0,3,3
38571,s'agit,0,0,3,3
38573,showed,0,0,3,3
50332,ذهبية,0,0,3,3
37631,மிக்க,0,0,3,3
10418,beide,0,0,3,3
23040,പറയാനുള്ള,0,0,3,3
38588,πλημμυρίσει,0,0,3,3
11539,العشر,0,0,3,3
22159,gråter,0,0,3,3
38055,maddesi,0,0,3,3
45648,ಸುವ್,0,0,3,3
21380,seres,0,0,3,3
23219,функционирование,0,0,3,3
34093,heilman,0,0,3,3
45085,régression,0,0,3,3
45809,devido,0,0,3,3
37373,شيوعًا,0,0,3,3
10411,جديدة,0,0,3,3
21724,heat,0,0,3,3
3435,origine,2,1,2,3
1632,significa.,2,1,2,3
34100,almindelige,0,0,3,3
11564,таким,0,0,3,3
21994,بالمائة,0,0,3,3
38564,nå,0,0,3,3
34084,pessoal,0,0,3,3
22835,exemples,0,0,3,3
38551,voorbeelden,0,0,3,3
45140,trabalhos,0,0,3,3
1594,contributi,1,3,0,3
11465,κάποιο,0,0,3,3
464,cioè,1,3,0,3
11466,gelukkig,0,0,3,3
461,successivamente,1,3,0,3
11033,chino,0,0,3,3
45781,obtuve,0,0,3,3
10457,cumartesi,0,0,3,3
22838,விரைவில்,0,0,3,3
45128,உறுதியாக,0,0,3,3
38548,biotic,0,0,3,3
23186,generate,0,0,3,3
21716,atroces,0,0,3,3
21713,jay,0,0,3,3
34070,മാർഗ്ഗം,0,0,3,3
11489,linda,0,0,3,3
10453,penge,0,0,3,3
45120,हार्वर्ड,0,0,3,3
34071,ona,0,0,3,3
37397,تمامًا.,0,0,3,3
21427,nio,0,0,3,3
11494,garçon,0,0,3,3
45650,التعديلات,0,0,3,3
21426,എനിക്കറിയാം,0,0,3,3
23194,característica,0,0,3,3
23053,sump,0,0,3,3
23131,biomass,0,0,3,3
11313,palabra.,0,0,3,3
23055,natuurlijk,0,0,3,3
45340,ലോഗിൻ,0,0,3,3
3309,notizie,1,3,0,3
10663,разделы,0,0,3,3
45331,countries.,0,0,3,3
45395,före,0,0,3,3
45330,författaren,0,0,3,3
21634,bilmiyorum,0,0,3,3
1407,l'uomo,1,3,0,3
38164,espaces,0,0,3,3
22026,skrivna,0,0,3,3
21633,cases.,0,0,3,3
11181,थोड़ा,0,0,3,3
23084,verbetes,0,0,3,3
33801,αυτόν,0,0,3,3
10589,états-unis.,0,0,3,3
23065,skett,0,0,3,3
21629,என்னவென்றால்,0,0,3,3
28300,compute,0,0,3,3
38152,deine,0,0,3,3
45320,fichier,0,0,3,3
33935,معينة,0,0,3,3
28360,buen,0,0,3,3
22049,கீழே,0,0,3,3
28298,album,0,0,3,3
38165,கேட்டால்,0,0,3,3
22881,كبير,0,0,3,3
22054,ಅವರ,0,0,3,3
45341,ಹೃದಯಕ್ಕೆ,0,0,3,3
22017,confiáveis,0,0,3,3
10608,dedicados,0,0,3,3
527,raggiungere,1,3,0,3
45666,egal,0,0,3,3
22010,tittar,0,0,3,3
33942,criticou,0,0,3,3
37472,divertida,0,0,3,3
10656,experiência,0,0,3,3
11107,передать,0,0,3,3
10661,marmelade,0,0,3,3
11081,दिया।,0,0,3,3
21647,existencia,0,0,3,3
21646,familiar,0,0,3,3
45670,afspraak,0,0,3,3
480,bibliotecario,2,2,1,3
45672,φρικτή,0,0,3,3
45342,केन्द्रित,0,0,3,3
10635,sammenlignet,0,0,3,3
38402,automatically,0,0,3,3
10628,ocupado.,0,0,3,3
28555,do.,0,0,3,3
45350,perplexo,0,0,3,3
33963,ഇതിനകം,0,0,3,3
21670,വെബ്,0,0,3,3
518,riguardo,1,3,0,3
33806,importance,0,0,3,3
11078,därmed,0,0,3,3
28562,നിലവിൽ,0,0,3,3
33966,wochenende,0,0,3,3
38412,bisschen,0,0,3,3
45315,verlegenheit,0,0,3,3
22001,πειράζει,0,0,3,3
23119,السبت,0,0,3,3
38113,connection,0,0,3,3
11273,week,0,0,3,3
51350,writers,0,0,3,3
33827,üzerinde,0,0,3,3
38449,dominante,0,0,3,3
10525,meiner,0,0,3,3
1606,hoiberg,2,1,2,3
23113,bununla,0,0,3,3
37450,visste,0,0,3,3
11287,വിലകൾ,0,0,3,3
11290,realizan,0,0,3,3
540,basso,1,3,0,3
44224,επαναλάβετε,0,0,3,3
23105,distingue,0,0,3,3
22084,feet,0,0,3,3
10519,fica,0,0,3,3
45653,ಸಂಭಾಷಣೆಯಲ್ಲಿ,0,0,3,3
21679,आसानी,0,0,3,3
37447,huvudsak,0,0,3,3
51460,responsáveis,0,0,3,3
10676,scott,0,0,3,3
1532,california.,2,1,2,3
28611,américain,0,0,3,3
11045,بضع,0,0,3,3
45245,ومن,0,0,3,3
22094,ಮಾಡುತ್ತೀರಿ,0,0,3,3
51932,التحرير.,0,0,3,3
10529,இறுதியில்,0,0,3,3
28584,trotzdem,0,0,3,3
28361,снова,0,0,3,3
50397,lördag,0,0,3,3
37465,tarafsız,0,0,3,3
45306,mayo,0,0,3,3
11212,समान,0,0,3,3
3413,fino,2,2,1,3
45300,perguntar,0,0,3,3
3328,qualcuno.,1,3,0,3
38421,vingers,0,0,3,3
11224,estes,0,0,3,3
23095,lema,0,0,3,3
38128,tonto,0,0,3,3
45294,yakında,0,0,3,3
11232,प्रिय,0,0,3,3
21604,needed,0,0,3,3
22068,используются,0,0,3,3
11065,debate,0,0,3,3
33931,perguntando,0,0,3,3
3394,hardware,2,1,2,3
28280,rejeitou,0,0,3,3
11060,treffen,0,0,3,3
37479,seek,0,0,3,3
28276,النرجسية,0,0,3,3
28273,aviso,0,0,3,3
38428,കഠിനാധ്വാനം,0,0,3,3
38115,grote,0,0,3,3
33996,områden.,0,0,3,3
45070,voz,0,0,3,3
38604,விட,0,0,3,3
28113,ലാറ്റിൻ,0,0,3,3
22932,declaraciones,0,0,3,3
38781,എന്നോട്,0,0,3,3
44872,northern,0,0,3,3
37656,കഴിഞ്ഞില്ല.,0,0,3,3
21098,jantar,0,0,3,3
577,linguistiche,1,3,0,3
21752,حال,0,0,3,3
38003,establecidas,0,0,3,3
22240,fins,0,0,3,3
45936,wikikod,0,0,3,3
11888,संस्कृति,0,0,3,3
21093,εξαιρετικά,0,0,3,3
21092,économiques,0,0,3,3
38788,automatique.,0,0,3,3
51308,συμβουλή,0,0,3,3
37275,envoyer,0,0,3,3
38805,forklarer,0,0,3,3
11906,grillini,0,0,3,3
11908,tribunal,0,0,3,3
27949,källbeskrivning,0,0,3,3
27948,successfully,0,0,3,3
50440,sverige,0,0,3,3
21753,junio,0,0,3,3
33685,അധിക,0,0,3,3
50441,hello,0,0,3,3
33684,mat,0,0,3,3
11925,إدخال,0,0,3,3
27940,busca,0,0,3,3
45929,शनिवार,0,0,3,3
10240,വന്നു,0,0,3,3
3462,mondiale.,2,1,2,3
34196,கொள்க.,0,0,3,3
11802,läsarna,0,0,3,3
44916,låter,0,0,3,3
34179,clara,0,0,3,3
3457,stavo,1,3,0,3
44909,βλέπω,0,0,3,3
23340,कोलबर्ट,0,0,3,3
11821,போல்,0,0,3,3
51457,officielle,0,0,3,3
38011,automated,0,0,3,3
3222,maggiore,1,3,0,3
38756,lå,0,0,3,3
10257,düzelme,0,0,3,3
22948,incluant,0,0,3,3
11872,assigned,0,0,3,3
45917,اسم,0,0,3,3
10979,moved,0,0,3,3
1340,migliaia,1,3,0,3
44892,плакать,0,0,3,3
21125,störa,0,0,3,3
10978,deuxième,0,0,3,3
21116,εκείνη,0,0,3,3
45919,potentially,0,0,3,3
45921,penser,0,0,3,3
21115,readership,0,0,3,3
22235,ಯೋಜನೆಗಳನ್ನು,0,0,3,3
44877,ужасно,0,0,3,3
38814,требует,0,0,3,3
38000,bilgilerin,0,0,3,3
27936,liked,0,0,3,3
33674,ganhou,0,0,3,3
3383,sì,1,3,0,3
10723,majeure,0,0,3,3
21008,ವಾರಾಂತ್ಯದಲ್ಲಿ,0,0,3,3
27895,محيرة,0,0,3,3
22279,nivel,0,0,3,3
38851,المقال,0,0,3,3
37249,face,0,0,3,3
51439,människor,0,0,3,3
23406,करो,0,0,3,3
12016,இருக்கிறேன்.,0,0,3,3
10197,évolution,0,0,3,3
37962,мечта,0,0,3,3
37247,بدأ,0,0,3,3
37253,yes,0,0,3,3
27889,самое,0,0,3,3
3190,piaciuto,1,3,0,3
34253,jan,0,0,3,3
12028,ನಿನ್ನನ್ನು,0,0,3,3
21652,al.,0,0,3,3
44765,modellen,0,0,3,3
3350,idee,2,1,2,3
33842,போகிறேன்.,0,0,3,3
51404,തമ്മിൽ,0,0,3,3
22309,सप्ताहांत,0,0,3,3
38863,weekend.,0,0,3,3
33670,inget,0,0,3,3
27896,دقائق.,0,0,3,3
45624,c'était,0,0,3,3
45945,sürümü,0,0,3,3
38836,sırasında,0,0,3,3
11938,أليس,0,0,3,3
22250,probleem,0,0,3,3
23381,utrymme,0,0,3,3
37263,ಸಿಹಿ,0,0,3,3
27922,barn,0,0,3,3
1684,usarlo,2,1,2,3
37991,pull,0,0,3,3
38833,spécifiques,0,0,3,3
38834,ഏത്,0,0,3,3
28409,επειδή,0,0,3,3
21031,d'ordre,0,0,3,3
38835,intento,0,0,3,3
38838,lastige,0,0,3,3
23399,l'aide,0,0,3,3
3201,arrivò,1,3,0,3
50449,studenten,0,0,3,3
11982,d’une,0,0,3,3
45952,accept,0,0,3,3
1686,piangere,1,3,0,3
33840,кто,0,0,3,3
590,spiega,1,3,0,3
21023,μυστική,0,0,3,3
11991,ಬಯಸುವುದಿಲ್ಲ,0,0,3,3
10967,लगाने,0,0,3,3
1506,varietà,1,3,0,3
12002,culturels.,0,0,3,3
1669,yongle,2,1,2,3
22804,redigeringskrig,0,0,3,3
38054,νέα,0,0,3,3
38199,semble,0,0,3,3
22183,husk,0,0,3,3
28689,argue,0,0,3,3
28690,aman,0,0,3,3
34123,amounts,0,0,3,3
28078,seis,0,0,3,3
28077,enklare,0,0,3,3
38647,चैनल,0,0,3,3
22816,representing,0,0,3,3
23259,assez,0,0,3,3
21297,रास्ता,0,0,3,3
11668,plate-forme,0,0,3,3
11006,klagen,0,0,3,3
3244,associazione,1,3,0,3
33831,pleurer,0,0,3,3
38666,умные,0,0,3,3
45852,lyde,0,0,3,3
50329,понял,0,0,3,3
38681,primordial,0,0,3,3
34132,reunión,0,0,3,3
38686,स्क्वीड,0,0,3,3
22815,op.,0,0,3,3
21239,skönhet,0,0,3,3
10343,anderson,0,0,3,3
3341,guinness,1,3,0,3
37640,خبز,0,0,3,3
37327,ಇಲ್ಲ.,0,0,3,3
44990,തുടങ്ങി,0,0,3,3
21731,person.,0,0,3,3
10690,skrev,0,0,3,3
11650,d'accord.,0,0,3,3
11608,قائمة,0,0,3,3
11579,membros,0,0,3,3
1416,prese,1,3,0,3
10398,desafios,0,0,3,3
21354,ojos,0,0,3,3
23230,godt.,0,0,3,3
10395,elde,0,0,3,3
45054,ടിപ്പ്,0,0,3,3
33728,characteristics,0,0,3,3
38607,résoudre,0,0,3,3
51356,αγαπητέ,0,0,3,3
34111,ecology,0,0,3,3
38349,geweest,0,0,3,3
11613,nedenle,0,0,3,3
37355,ocak,0,0,3,3
11616,badstof,0,0,3,3
22171,freedom,0,0,3,3
23236,catégorie,0,0,3,3
23240,cabida,0,0,3,3
11628,toutefois,0,0,3,3
21334,sine,0,0,3,3
28678,റോന്ദേവൂ,0,0,3,3
51913,enough,0,0,3,3
28679,succès,0,0,3,3
1520,caratteristica,1,3,0,3
38639,திருமணம்,0,0,3,3
22177,baixo,0,0,3,3
22190,الآن.,0,0,3,3
28060,खुला,0,0,3,3
1658,diversi,1,3,0,3
22200,φαινόταν,0,0,3,3
3455,prenderlo,1,3,0,3
10301,видели,0,0,3,3
38729,доступны,0,0,3,3
21738,slate,0,0,3,3
11760,വചനം,0,0,3,3
45886,error.,0,0,3,3
10291,rejse,0,0,3,3
45453,προτάσεις,0,0,3,3
38734,شعبية,0,0,3,3
34162,chorar,0,0,3,3
44946,l'intérieur,0,0,3,3
44941,हों।,0,0,3,3
50433,relação,0,0,3,3
3454,politiche,1,3,0,3
22928,acuerdo.,0,0,3,3
28726,racines,0,0,3,3
28727,digits,0,0,3,3
10269,voice,0,0,3,3
33908,regression.,0,0,3,3
28519,passar,0,0,3,3
38337,flytande,0,0,3,3
45909,esperanto,0,0,3,3
21163,भूगोल,0,0,3,3
508,ciao,1,3,0,3
51315,tillgänglig,0,0,3,3
11794,off,0,0,3,3
37565,просмотра,0,0,3,3
11740,conta,0,0,3,3
11697,देखने,0,0,3,3
21202,citizen,0,0,3,3
44986,grands,0,0,3,3
28702,cambios,0,0,3,3
38038,saisi,0,0,3,3
448,differenti,1,3,0,3
21212,contas,0,0,3,3
45872,நீ,0,0,3,3
34139,kabul,0,0,3,3
21208,viewed,0,0,3,3
11714,أعمال,0,0,3,3
34142,बनाती,0,0,3,3
28050,മാത്രമേ,0,0,3,3
34143,disputed,0,0,3,3
11723,l'ordinateur,0,0,3,3
10311,wikinews,0,0,3,3
44969,obrigado.,0,0,3,3
28709,दूसरा,0,0,3,3
38717,ಪ್ರಿಯ,0,0,3,3
11728,perdido,0,0,3,3
11730,administrador,0,0,3,3
38037,ifade,0,0,3,3
37311,созданию,0,0,3,3
22918,продали,0,0,3,3
51317,مشكلة,0,0,3,3
21188,trabalho.,0,0,3,3
21186,அவற்றின்,0,0,3,3
45875,sætningen,0,0,3,3
17183,знаю.,0,0,3,3
19870,عند,0,0,3,3
12860,parecia,0,0,3,3
42234,जाम,0,0,3,3
1114,premi,1,3,0,3
18183,tatsächlich,0,0,3,3
15772,பொத்தானை,0,0,3,3
42276,दावा,0,0,3,3
18192,μπήκε,0,0,3,3
15760,ತಮ್ಮ,0,0,3,3
42284,говорить,0,0,3,3
35489,όνομα,0,0,3,3
18203,moteurs,0,0,3,3
2155,interessante,2,1,2,3
15718,результаты,0,0,3,3
18219,माइकल,0,0,3,3
42314,they're,0,0,3,3
36315,capítulo,0,0,3,3
15704,statistiques,0,0,3,3
18229,مارس,0,0,3,3
35470,fact,0,0,3,3
2162,vinto,1,3,0,3
26003,week-end,0,0,3,3
40691,dünya,0,0,3,3
40718,research.,0,0,3,3
18136,обучающей,0,0,3,3
18137,açıklayan,0,0,3,3
35516,básicos,0,0,3,3
25985,позже,0,0,3,3
15821,álbum,0,0,3,3
18139,gorillas,0,0,3,3
900,creati,1,3,0,3
35506,entered,0,0,3,3
15789,plaît,0,0,3,3
36284,ubuntu.,0,0,3,3
40713,खराब,0,0,3,3
36287,εγχειρήματα,0,0,3,3
18151,nederlands,0,0,3,3
2170,quotidiana,1,3,0,3
50826,modificar,0,0,3,3
24813,проблема,0,0,3,3
40654,للجدل,0,0,3,3
15693,olma,0,0,3,3
15690,falsk,0,0,3,3
2610,alcuna,1,3,0,3
18299,नीति,0,0,3,3
42366,öka,0,0,3,3
42368,delas,0,0,3,3
42369,danke.,0,0,3,3
50807,ven,0,0,3,3
15619,hvem,0,0,3,3
26084,inútil,0,0,3,3
50804,reconnaître,0,0,3,3
42361,दौरान,0,0,3,3
2123,vuole,1,3,0,3
2122,wikispecies,2,1,2,3
26090,humano,0,0,3,3
2614,comitato,1,3,0,3
15587,expressions,0,0,3,3
42399,tager,0,0,3,3
2621,famoso,2,1,2,3
18298,apprend,0,0,3,3
36340,conçu,0,0,3,3
51738,propia,0,0,3,3
24758,wikiproject,0,0,3,3
24769,científico,0,0,3,3
15682,game,0,0,3,3
15681,комментариев,0,0,3,3
15679,additional,0,0,3,3
36331,dela,0,0,3,3
15678,कॉल,0,0,3,3
2602,ragionamento,1,3,0,3
15669,kamen,0,0,3,3
51070,കാണും.,0,0,3,3
18280,belleza,0,0,3,3
15660,fonctions,0,0,3,3
2140,ideatori,1,3,0,3
18283,s'en,0,0,3,3
18286,days.,0,0,3,3
40626,yapmak.,0,0,3,3
15648,bas,0,0,3,3
15831,nor,0,0,3,3
42230,langsomt,0,0,3,3
51871,vandaag,0,0,3,3
24836,μήνυμα,0,0,3,3
42117,όλοι,0,0,3,3
16022,vidste,0,0,3,3
16021,ويمكن,0,0,3,3
51727,förstå,0,0,3,3
18010,dersin,0,0,3,3
18011,quelqu'un.,0,0,3,3
50854,свидание,0,0,3,3
2196,fatti,1,3,0,3
25888,hemliga,0,0,3,3
15997,ജാം,0,0,3,3
18019,işe,0,0,3,3
36260,rend,0,0,3,3
25899,ஒன்றாக,0,0,3,3
2185,corretta,1,3,0,3
42145,xkcd,0,0,3,3
35570,keek,0,0,3,3
40772,menées,0,0,3,3
42113,£,0,0,3,3
16032,ശനിയാഴ്ച,0,0,3,3
40797,mcpherson,0,0,3,3
17981,[note,0,0,3,3
921,l'hai,1,3,0,3
51033,கொள்ள,0,0,3,3
35616,diskussion,0,0,3,3
40820,кнопку,0,0,3,3
24902,supuesto,0,0,3,3
2527,lui.,2,1,2,3
17977,gehad,0,0,3,3
16084,σαββατοκύριακο,0,0,3,3
50860,tecnología,0,0,3,3
25849,vinden,0,0,3,3
16057,pasado,0,0,3,3
40810,semelhante,0,0,3,3
40801,suffer,0,0,3,3
42101,зависимость,0,0,3,3
42104,direkt,0,0,3,3
35595,autour,0,0,3,3
25904,replaced,0,0,3,3
15969,langzaam,0,0,3,3
40765,dereceden,0,0,3,3
18102,dernières,0,0,3,3
40742,express,0,0,3,3
35543,looks,0,0,3,3
15900,lançado,0,0,3,3
40740,hårdare,0,0,3,3
15899,beginnen.,0,0,3,3
42192,cientistas,0,0,3,3
15891,miriam,0,0,3,3
25951,سمعت,0,0,3,3
35547,esteja,0,0,3,3
2571,succede,1,3,0,3
24847,بالإضافة,0,0,3,3
15873,zones,0,0,3,3
18119,tron,0,0,3,3
18122,verpest,0,0,3,3
24837,aquellas,0,0,3,3
18130,högst,0,0,3,3
15907,vor,0,0,3,3
18085,merhaba,0,0,3,3
15963,hak,0,0,3,3
36264,origin,0,0,3,3
2554,perceptrons,2,1,2,3
15956,еда,0,0,3,3
42158,months.,0,0,3,3
40764,системы,0,0,3,3
25912,beim,0,0,3,3
35561,gece,0,0,3,3
18064,attributed,0,0,3,3
36265,général,0,0,3,3
15926,völlig,0,0,3,3
25919,horizontal,0,0,3,3
15940,scherp,0,0,3,3
15939,powers,0,0,3,3
18074,yapamam.,0,0,3,3
35555,leve,0,0,3,3
36268,volcanic,0,0,3,3
18083,لديها,0,0,3,3
35431,shift,0,0,3,3
15570,läsare,0,0,3,3
15569,editör,0,0,3,3
42406,outil,0,0,3,3
24616,additionally,0,0,3,3
18597,historia,0,0,3,3
42612,организация,0,0,3,3
15233,recupera,0,0,3,3
24605,وصلت,0,0,3,3
2081,inventata,1,3,0,3
26266,редактирования,0,0,3,3
35320,n'implique,0,0,3,3
24595,olduğu,0,0,3,3
26276,نارسسا,0,0,3,3
35311,कॉमन्स,0,0,3,3
2669,offline,2,1,2,3
15181,elsker,0,0,3,3
15179,رائع.,0,0,3,3
24586,esos,0,0,3,3
40389,gerne,0,0,3,3
36462,élus,0,0,3,3
18582,வீடியோ,0,0,3,3
42607,rockst,0,0,3,3
2092,siete,2,2,1,3
51755,தங்கள்,0,0,3,3
42577,schoonheid,0,0,3,3
36427,olá,0,0,3,3
861,l'origine,2,1,2,3
26241,j'utilise,0,0,3,3
15286,duitstalige,0,0,3,3
1145,citate,1,3,0,3
18550,colaborativos,0,0,3,3
15277,lent.,0,0,3,3
24621,ofensivo,0,0,3,3
18557,ordinateurs,0,0,3,3
18558,remove,0,0,3,3
1146,usi,1,3,0,3
40438,குழப்பமான,0,0,3,3
18565,पाठ्यक्रम,0,0,3,3
15267,ഫ്ലമ്മോക്സ്,0,0,3,3
42603,व्याख्या,0,0,3,3
35298,continuar,0,0,3,3
18668,gente,0,0,3,3
18677,καλό.,0,0,3,3
24534,feita,0,0,3,3
18719,κόρη,0,0,3,3
18726,istiyorsan,0,0,3,3
42727,sparsely,0,0,3,3
35265,biais,0,0,3,3
42745,hayek,0,0,3,3
18754,edições.,0,0,3,3
42752,встретиться,0,0,3,3
15042,ஒலிக்க,0,0,3,3
42719,три,0,0,3,3
42757,प्रणाली,0,0,3,3
15038,nodig,0,0,3,3
15037,बिल्कुल,0,0,3,3
36501,schaltfläche,0,0,3,3
40315,characters,0,0,3,3
26366,ट्रेफिक,0,0,3,3
50757,الذهب,0,0,3,3
35268,उनका,0,0,3,3
15083,πάμε,0,0,3,3
18683,redan,0,0,3,3
40352,arg,0,0,3,3
42668,wütend,0,0,3,3
15158,fifth,0,0,3,3
40369,पूछते,0,0,3,3
24566,reuters,0,0,3,3
36475,there's,0,0,3,3
15139,ami,0,0,3,3
35284,നോക്കി,0,0,3,3
35277,प्यारे,0,0,3,3
42714,ortega,0,0,3,3
15110,نص,0,0,3,3
40350,время.,0,0,3,3
26333,स्वीकार,0,0,3,3
42710,dem.,0,0,3,3
15100,محتويات,0,0,3,3
15099,എഴുതുന്ന,0,0,3,3
2681,probabilistico,1,3,0,3
42576,relationships,0,0,3,3
26237,இத்திட்டம்,0,0,3,3
1144,testo,1,3,0,3
36381,vermasselt,0,0,3,3
42459,estatísticas,0,0,3,3
42460,الويكيبيديا,0,0,3,3
15478,discussões,0,0,3,3
24710,doivent,0,0,3,3
35397,photographic,0,0,3,3
1134,poche,1,3,0,3
18393,κανάλι,0,0,3,3
15468,sidor,0,0,3,3
26142,रख,0,0,3,3
15464,juntamente,0,0,3,3
24692,بالفعل.,0,0,3,3
24691,escrever,0,0,3,3
15425,dez,0,0,3,3
18429,nuevos,0,0,3,3
40524,lyder,0,0,3,3
24678,ചെയ്യുക.,0,0,3,3
42454,préalablement,0,0,3,3
15499,challenges,0,0,3,3
40518,right.,0,0,3,3
15539,wikipedianer,0,0,3,3
36359,creo,0,0,3,3
42408,koets,0,0,3,3
15561,balansen,0,0,3,3
40585,pornografia,0,0,3,3
15557,حالة,0,0,3,3
26111,boek,0,0,3,3
26115,relevanta,0,0,3,3
26119,νομίζω,0,0,3,3
40569,तुलना,0,0,3,3
26126,sections,0,0,3,3
40579,going.,0,0,3,3
15512,watson,0,0,3,3
18365,പോലുള്ള,0,0,3,3
18367,ham.,0,0,3,3
18372,образом,0,0,3,3
42443,rendering,0,0,3,3
15405,brought,0,0,3,3
15402,ξέρεις,0,0,3,3
15305,फोन,0,0,3,3
40467,திறந்த,0,0,3,3
42548,qu'est-ce,0,0,3,3
15344,بالفعل,0,0,3,3
42553,será,0,0,3,3
26223,प्रोजेक्ट,0,0,3,3
18515,sabe.,0,0,3,3
26224,cobertos,0,0,3,3
15331,décision,0,0,3,3
18518,утверждал,0,0,3,3
40472,konflikter.,0,0,3,3
15326,எனினும்,0,0,3,3
42561,machen.,0,0,3,3
15321,நுபீடியாவின்,0,0,3,3
42563,fears,0,0,3,3
18521,науки.,0,0,3,3
18522,நடுவில்,0,0,3,3
40464,sollte,0,0,3,3
15346,krijgen,0,0,3,3
2101,guide,2,1,2,3
42516,extremadamente,0,0,3,3
18462,matrix,0,0,3,3
36398,विकसित,0,0,3,3
2647,creando,2,1,2,3
26199,потрясающе,0,0,3,3
50781,vilja,0,0,3,3
18452,ഉപയോക്താക്കൾക്ക്,0,0,3,3
15381,جون,0,0,3,3
869,dovrei,1,3,0,3
42531,ничего,0,0,3,3
42545,இருக்கும்போது,0,0,3,3
18472,गति,0,0,3,3
15368,என்றால்.,0,0,3,3
42536,συγγνώμη,0,0,3,3
18486,சொந்த,0,0,3,3
40486,sigan,0,0,3,3
15352,சவாரி,0,0,3,3
26220,റോക്ക്,0,0,3,3
40837,älskar,0,0,3,3
16104,estimé,0,0,3,3
2523,matematica,1,3,0,3
25098,observed,0,0,3,3
25467,kendi,0,0,3,3
16830,punktzahl,0,0,3,3
2400,parola.,1,3,0,3
2401,redazione,1,3,0,3
25469,unseen,0,0,3,3
17489,videon.,0,0,3,3
41588,பிஸியாக,0,0,3,3
16818,mala,0,0,3,3
17496,acquérir,0,0,3,3
35865,appearing,0,0,3,3
2405,d'altro,1,3,0,3
41135,alternative,0,0,3,3
41598,которым,0,0,3,3
17508,ಬಹುಶಃ,0,0,3,3
16798,ಅಳುವುದು,0,0,3,3
25484,schrecklich,0,0,3,3
16787,conflict,0,0,3,3
41577,pontuação,0,0,3,3
17475,sweet,0,0,3,3
16847,συνάντηση,0,0,3,3
16888,durumda,0,0,3,3
16915,समकक्ष,0,0,3,3
17444,ángel,0,0,3,3
992,ricordati,1,3,0,3
36062,entire,0,0,3,3
50984,pegar,0,0,3,3
2394,devo,2,2,1,3
25440,lag,0,0,3,3
35885,rolle,0,0,3,3
25461,grundläggande,0,0,3,3
41551,പൊതുവേ,0,0,3,3
41554,ಮಾತ್ರ,0,0,3,3
25449,distributed,0,0,3,3
41160,rede,0,0,3,3
16856,चलने,0,0,3,3
17470,അവരെ,0,0,3,3
41153,chercheurs,0,0,3,3
16785,model.,0,0,3,3
25492,traitement,0,0,3,3
25494,вандализм,0,0,3,3
25115,bunların,0,0,3,3
16688,modified,0,0,3,3
17554,others.,0,0,3,3
16679,इससे,0,0,3,3
16678,ലേഖനങ്ങളെഴുതുക,0,0,3,3
2277,americani,1,3,0,3
17559,bygger,0,0,3,3
25559,innehåller,0,0,3,3
36106,tek,0,0,3,3
41673,சொல்லுங்கள்,0,0,3,3
17569,ஆகிய,0,0,3,3
25109,горит,0,0,3,3
17573,l'histoire,0,0,3,3
41084,surtei,0,0,3,3
41703,drawn,0,0,3,3
16653,نطاق,0,0,3,3
41080,« la,0,0,3,3
2427,primaria,2,2,1,3
16703,gedaan.,0,0,3,3
41131,meest,0,0,3,3
25131,ஒன்று,0,0,3,3
17512,décontenancé,0,0,3,3
25498,ಹೋಗೋಣ,0,0,3,3
41126,follows,0,0,3,3
16766,выглядела,0,0,3,3
25509,parte.,0,0,3,3
2413,capire,1,3,0,3
35833,querer,0,0,3,3
25520,olmayan,0,0,3,3
974,significativo,2,2,1,3
41106,tenderar,0,0,3,3
35832,ലേഖനത്തിനു,0,0,3,3
980,l'altra,1,3,0,3
36102,representative,0,0,3,3
25532,يطلب,0,0,3,3
25537,abone,0,0,3,3
35822,इतालवी,0,0,3,3
16918,φάτε,0,0,3,3
17436,क्षेत्र,0,0,3,3
25424,അടുത്തേക്ക്,0,0,3,3
25362,idé.,0,0,3,3
51680,robotskapade,0,0,3,3
25274,m'as,0,0,3,3
41313,gama,0,0,3,3
35938,classique,0,0,3,3
17083,chacun,0,0,3,3
41310,reveal,0,0,3,3
41431,chris,0,0,3,3
1027,o.,2,1,2,3
17103,ഓരോ,0,0,3,3
17262,sprechen,0,0,3,3
25367,plans.,0,0,3,3
25368,står,0,0,3,3
41291,exibido,0,0,3,3
50942,obtener,0,0,3,3
17056,criado,0,0,3,3
17283,पर्याप्त,0,0,3,3
17098,cher,0,0,3,3
2340,avanti.,1,3,0,3
25252,oorspronkelijke,0,0,3,3
25288,вопросу,0,0,3,3
25315,вот,0,0,3,3
1014,elementi,1,3,0,3
2349,lunga,1,3,0,3
41377,பார்த்துக்,0,0,3,3
35979,लिखते,0,0,3,3
51677,exemplos,0,0,3,3
41333,فوق,0,0,3,3
17227,lockyer.,0,0,3,3
25277,estudos,0,0,3,3
17134,nedan.,0,0,3,3
51678,wikileaks,0,0,3,3
35956,cargos,0,0,3,3
51671,மட்டும்,0,0,3,3
17125,dag.,0,0,3,3
51679,хорошо.,0,0,3,3
35988,software.,0,0,3,3
1032,metà,1,3,0,3
41453,importe,0,0,3,3
36057,hören,0,0,3,3
17407,counterproductive,0,0,3,3
25225,build,0,0,3,3
25224,mooi,0,0,3,3
41226,भेज,0,0,3,3
17372,huis,0,0,3,3
41217,collected,0,0,3,3
36039,ಒಟ್ಟಿಗೆ,0,0,3,3
16956,pengar,0,0,3,3
16952,negotiation,0,0,3,3
50968,estarei,0,0,3,3
17411,desarrollar,0,0,3,3
16946,necesario,0,0,3,3
41190,мое,0,0,3,3
35903,bidrar,0,0,3,3
41516,currently,0,0,3,3
17426,substantiv,0,0,3,3
17432,பதிவு,0,0,3,3
17339,participation,0,0,3,3
41486,incluidos,0,0,3,3
36004,meddelande,0,0,3,3
17315,ವಿಭಿನ್ನ,0,0,3,3
50939,reviewed,0,0,3,3
17306,അവൾക്ക്,0,0,3,3
17025,പോകണം.,0,0,3,3
17019,driven,0,0,3,3
41465,gäller,0,0,3,3
25386,yapabilirsin,0,0,3,3
17007,houdt,0,0,3,3
41477,pesquisador,0,0,3,3
2381,libera.,1,3,0,3
17323,sådana,0,0,3,3
17325,ನಂಬರ್,0,0,3,3
41256,είχα,0,0,3,3
17333,mag,0,0,3,3
25397,visa,0,0,3,3
41483,staat,0,0,3,3
25230,roughly,0,0,3,3
17586,composition,0,0,3,3
35800,southern,0,0,3,3
36228,डच,0,0,3,3
16636,الحقيقة,0,0,3,3
2489,concentra,1,3,0,3
35692,lille,0,0,3,3
35691,posteriormente,0,0,3,3
40909,cambió,0,0,3,3
2233,aperta,1,3,0,3
41947,j'aime,0,0,3,3
25741,task.,0,0,3,3
940,knowledge-based,2,2,1,3
36198,artikelen.,0,0,3,3
24965,ವ್ಯಕ್ತಿ,0,0,3,3
17841,عملية,0,0,3,3
2228,light,2,1,2,3
25744,taken,0,0,3,3
2496,grazie.,1,3,0,3
41962,vacker,0,0,3,3
40901,вялый,0,0,3,3
35677,nsa,0,0,3,3
41920,aspect,0,0,3,3
25717,सहायता,0,0,3,3
2487,carne,2,1,2,3
1079,opere,1,3,0,3
41860,பேச,0,0,3,3
35726,örnekleri,0,0,3,3
16412,نمو,0,0,3,3
36180,realidade,0,0,3,3
16400,árboles,0,0,3,3
41885,αλλιώς,0,0,3,3
17799,निर्मित,0,0,3,3
16378,يقوم,0,0,3,3
35702,считается,0,0,3,3
41893,helst.,0,0,3,3
16370,चीजें,0,0,3,3
40919,passed,0,0,3,3
16356,ഇവരെ,0,0,3,3
35705,genug,0,0,3,3
25711,الاشتراك,0,0,3,3
17822,evolved,0,0,3,3
35676,nécessaire].,0,0,3,3
2499,vari,1,3,0,3
16259,dinero,0,0,3,3
16140,elbette,0,0,3,3
42027,facilement,0,0,3,3
35645,creating,0,0,3,3
17904,único,0,0,3,3
1086,comune,1,3,0,3
16159,suggest,0,0,3,3
2516,verbo,2,1,2,3
16148,самой,0,0,3,3
36223,verkocht,0,0,3,3
25795,notions,0,0,3,3
25814,reconnaissance,0,0,3,3
25818,эту,0,0,3,3
16126,mantém,0,0,3,3
36224,rejected,0,0,3,3
16119,weer,0,0,3,3
35624,kategorier,0,0,3,3
16114,δει,0,0,3,3
42026,akzeptiere,0,0,3,3
36214,comptes,0,0,3,3
17846,आधार,0,0,3,3
40883,कृपया,0,0,3,3
24963,வேலையில்,0,0,3,3
40896,изображения,0,0,3,3
16253,usarse,0,0,3,3
36206,मिलता,0,0,3,3
16227,publication,0,0,3,3
35662,pollution,0,0,3,3
17858,lycklig,0,0,3,3
16217,சொற்றொடர்கள்,0,0,3,3
2508,academy,2,1,2,3
16216,liées,0,0,3,3
934,l'obiettivo,1,3,0,3
42005,सफलता,0,0,3,3
51636,περιεχομένου,0,0,3,3
16193,polaco,0,0,3,3
16192,pratiques,0,0,3,3
16184,கடைசி,0,0,3,3
36178,videoda,0,0,3,3
17780,tiden.,0,0,3,3
25673,subsets,0,0,3,3
2264,analogamente,1,3,0,3
41050,uppgifter,0,0,3,3
25602,ögonblick.,0,0,3,3
25603,जिसने,0,0,3,3
41762,पूरे,0,0,3,3
25604,ആരോടെങ്കിലും,0,0,3,3
25605,जर्नल,0,0,3,3
41768,لأنك,0,0,3,3
25609,ποια,0,0,3,3
16584,mouvement,0,0,3,3
51701,negativ,0,0,3,3
17647,raíz,0,0,3,3
16554,encontrados,0,0,3,3
51649,ánimo,0,0,3,3
17657,fora,0,0,3,3
25618,representa,0,0,3,3
2258,impact,2,1,2,3
41052,फ़्रिसियाई,0,0,3,3
25596,δάχτυλα,0,0,3,3
41021,herramienta,0,0,3,3
41731,never,0,0,3,3
41076,ಮುಂಚಿತವಾಗಿ,0,0,3,3
25092,doğruluğu,0,0,3,3
25577,بحاجة,0,0,3,3
35794,actividades,0,0,3,3
17601,jou,0,0,3,3
51698,taget,0,0,3,3
25585,ಎಲ್ಲಾ,0,0,3,3
41732,consecuencia,0,0,3,3
41752,رائعًا,0,0,3,3
25587,aider,0,0,3,3
36124,والمعلوماتية,0,0,3,3
17620,construção,0,0,3,3
16603,favor.,0,0,3,3
2268,pubblicate,1,3,0,3
35783,kunna,0,0,3,3
16589,முன்கூட்டியே,0,0,3,3
25058,பொருள்,0,0,3,3
50895,примеры,0,0,3,3
40950,présentes,0,0,3,3
16468,contenidos.,0,0,3,3
17717,الإطلاق,0,0,3,3
25029,kocaman,0,0,3,3
25639,keskin,0,0,3,3
25640,ontving,0,0,3,3
41816,steadily,0,0,3,3
17723,ترخيص,0,0,3,3
40977,desk,0,0,3,3
40972,composé,0,0,3,3
17708,träffa,0,0,3,3
40969,கடினமாக,0,0,3,3
955,hegel,2,2,1,3
16449,constant,0,0,3,3
17768,vanavond,0,0,3,3
41856,உங்களைப்,0,0,3,3
16429,позже.,0,0,3,3
16428,എന്നിരുന്നാലും,0,0,3,3
16491,വിക്കിപീഡിയ.,0,0,3,3
16494,kullanmak,0,0,3,3
41786,beschrijven,0,0,3,3
40999,dilde,0,0,3,3
17677,topics.,0,0,3,3
36144,river.,0,0,3,3
41010,നല്ലത്,0,0,3,3
16536,പോകുന്നു,0,0,3,3
41005,wap,0,0,3,3
50892,करके,0,0,3,3
25040,edwin,0,0,3,3
16518,källa.,0,0,3,3
41811,reach,0,0,3,3
1069,largo,2,1,2,3
16515,vår,0,0,3,3
35760,sagt,0,0,3,3
16508,söyleyebileceğin,0,0,3,3
35759,அதைச்,0,0,3,3
35758,licens,0,0,3,3
35757,του.,0,0,3,3
18766,संपादक,0,0,3,3
40311,réalise,0,0,3,3
35243,cinq,0,0,3,3
702,commerciale,2,2,1,3
27109,móveis,0,0,3,3
19775,scientists,0,0,3,3
24002,όμορφη,0,0,3,3
27114,mätte,0,0,3,3
39622,lätt,0,0,3,3
19786,igång,0,0,3,3
39616,المتحدة,0,0,3,3
23997,കയറി,0,0,3,3
27125,källor.,0,0,3,3
19800,første,0,0,3,3
13542,അവ,0,0,3,3
13536,ಅದ್ಭುತವಾದ,0,0,3,3
13534,production,0,0,3,3
43771,suene,0,0,3,3
13525,yoğun,0,0,3,3
34740,palácio,0,0,3,3
27139,vikipedilerin,0,0,3,3
36860,düzeltme,0,0,3,3
34765,mysql.,0,0,3,3
13588,முன்பு,0,0,3,3
43689,asusté,0,0,3,3
13670,worldwide,0,0,3,3
43681,किस,0,0,3,3
2912,copie,2,1,2,3
36842,tivesse,0,0,3,3
27058,onun,0,0,3,3
50627,jaffe,0,0,3,3
13654,العلماء,0,0,3,3
36847,dérivé,0,0,3,3
24008,எல்லா,0,0,3,3
24017,effekt,0,0,3,3
13641,ton,0,0,3,3
13639,allerede,0,0,3,3
39641,ولم,0,0,3,3
39638,இருந்தார்கள்,0,0,3,3
19758,línguas,0,0,3,3
19759,നൽകും.,0,0,3,3
23989,ко,0,0,3,3
36870,أكن,0,0,3,3
43783,ಒಳ್ಳೆಯದು.,0,0,3,3
13433,ejercicio,0,0,3,3
13460,الويكي،,0,0,3,3
19856,baike,0,0,3,3
19858,puan,0,0,3,3
34715,venus,0,0,3,3
19866,سيجنثالر,0,0,3,3
51536,പേര്,0,0,3,3
43837,growing,0,0,3,3
50950,vred,0,0,3,3
19852,கவனித்துக்,0,0,3,3
50603,उससे,0,0,3,3
13427,preocupe.,0,0,3,3
13426,carefully,0,0,3,3
13425,whatever,0,0,3,3
23960,filmer,0,0,3,3
51535,ίδρυμα,0,0,3,3
43843,svårt,0,0,3,3
1898,molte,1,3,0,3
13466,administratörerna,0,0,3,3
13513,samstag,0,0,3,3
51832,ham,0,0,3,3
39597,ഒക്കെ,0,0,3,3
13502,criterios,0,0,3,3
34734,regulares,0,0,3,3
43793,beauty.,0,0,3,3
13499,ответ,0,0,3,3
34732,extremes.,0,0,3,3
13489,بوابة,0,0,3,3
23981,neuronas,0,0,3,3
39578,contributeurs.,0,0,3,3
13482,l'interaction,0,0,3,3
19830,ändå,0,0,3,3
711,terabyte,2,1,2,3
13479,observable,0,0,3,3
710,fortemente,2,1,2,3
43809,fiche,0,0,3,3
19837,ακριβώς,0,0,3,3
34795,occidentale,0,0,3,3
19724,numerosas,0,0,3,3
27051,ekstra,0,0,3,3
13856,bist.,0,0,3,3
43538,प्रकल्प,0,0,3,3
19558,своих,0,0,3,3
2879,informatica,2,2,1,3
24119,καλός,0,0,3,3
19567,الخاص,0,0,3,3
19570,வார்த்தையைப்,0,0,3,3
13859,θέση,0,0,3,3
19584,فأنت,0,0,3,3
13877,editados,0,0,3,3
19588,extremely,0,0,3,3
13844,derfor,0,0,3,3
13839,anything,0,0,3,3
13838,सहित,0,0,3,3
34846,maanden,0,0,3,3
19600,darte,0,0,3,3
34840,واحدة,0,0,3,3
19555,quickly,0,0,3,3
26955,twitter,0,0,3,3
19613,نصية,0,0,3,3
43515,уловка-,0,0,3,3
13924,ಅತ್ಯುತ್ತಮ,0,0,3,3
34875,अवयव,0,0,3,3
13919,വ്യത്യസ്ത,0,0,3,3
39806,bibliothèque,0,0,3,3
19520,stockholm,0,0,3,3
19524,വാക്യം,0,0,3,3
13916,racine,0,0,3,3
13901,используют,0,0,3,3
36770,seção,0,0,3,3
24133,termos,0,0,3,3
24131,söka,0,0,3,3
34866,mallar,0,0,3,3
26949,atividades,0,0,3,3
34865,അതൊരു,0,0,3,3
39780,patterns,0,0,3,3
19551,கேட்கிறது.,0,0,3,3
36791,wist,0,0,3,3
1923,poiché,1,3,0,3
19712,തെറ്റ്,0,0,3,3
43640,geographic,0,0,3,3
43624,studenterna,0,0,3,3
13735,précise,0,0,3,3
19676,وليس,0,0,3,3
13734,despite,0,0,3,3
34811,двое,0,0,3,3
27028,istemiyorum,0,0,3,3
27030,tendencia,0,0,3,3
19682,angry,0,0,3,3
13747,kwaliteit,0,0,3,3
43642,matematik,0,0,3,3
43650,हमारे,0,0,3,3
24049,முடிவில்,0,0,3,3
2908,herring,2,2,1,3
19685,actualmente,0,0,3,3
39686,स्कूल्स,0,0,3,3
19692,non-profit,0,0,3,3
13743,education,0,0,3,3
13751,gaf,0,0,3,3
13805,बनी,0,0,3,3
2895,costo,1,3,0,3
43588,träsk,0,0,3,3
36799,capa,0,0,3,3
13794,خبراء,0,0,3,3
19632,ಅದೇ,0,0,3,3
13791,vous.,0,0,3,3
26999,sous-jacente,0,0,3,3
43600,agradecer,0,0,3,3
36805,الموسوعة،,0,0,3,3
36815,förvånad,0,0,3,3
36808,энциклопедией,0,0,3,3
27009,يونيو,0,0,3,3
13764,transaction,0,0,3,3
39715,перед,0,0,3,3
39712,अमेरिकन,0,0,3,3
19655,alstublieft,0,0,3,3
36814,istemek,0,0,3,3
704,ricevuto,1,3,0,3
34703,планы,0,0,3,3
19507,lokalt,0,0,3,3
36887,leid,0,0,3,3
39412,βιβλίο,0,0,3,3
3022,pochi,1,3,0,3
13031,அம்மாவிடம்,0,0,3,3
34571,aller,0,0,3,3
36953,seit,0,0,3,3
20120,ആളുകൾ,0,0,3,3
20122,comportements,0,0,3,3
20132,toll,0,0,3,3
44127,dijo,0,0,3,3
13008,mutually,0,0,3,3
13003,fel,0,0,3,3
39399,यात्रा,0,0,3,3
39394,جيدة.,0,0,3,3
36961,സ്വതന്ത്രവും,0,0,3,3
12984,எடுத்துக்,0,0,3,3
34548,som.,0,0,3,3
23836,corpus,0,0,3,3
20100,fundadores,0,0,3,3
20088,जनमत,0,0,3,3
34576,ബ്രെഡ്,0,0,3,3
34587,dingen,0,0,3,3
27360,ಮಾರ್ಗವೆಂದರೆ,0,0,3,3
20057,список,0,0,3,3
27367,escuela,0,0,3,3
39446,trevliga,0,0,3,3
23879,അമേരിക്കക്കാർ,0,0,3,3
20065,engelske,0,0,3,3
20068,σκορ,0,0,3,3
51205,présent,0,0,3,3
13047,dejligt,0,0,3,3
36941,друг,0,0,3,3
13079,décisions,0,0,3,3
34582,goldene,0,0,3,3
44100,flórida,0,0,3,3
20083,unit,0,0,3,3
34578,advance,0,0,3,3
36944,информации.,0,0,3,3
12965,каждой,0,0,3,3
34540,हमें,0,0,3,3
44159,vanligaste,0,0,3,3
51224,enviarle,0,0,3,3
27464,consequence,0,0,3,3
34519,день,0,0,3,3
27467,செய்கிறீர்கள்,0,0,3,3
20212,الجديدة,0,0,3,3
51222,repetidas,0,0,3,3
20214,lhe,0,0,3,3
12884,eliminan,0,0,3,3
39337,പറഞ്ഞു.,0,0,3,3
39353,sentence,0,0,3,3
20235,überrascht,0,0,3,3
39331,universel,0,0,3,3
36990,utilizado,0,0,3,3
12869,toward,0,0,3,3
34511,தோழர்களே,0,0,3,3
20239,नरसीसा,0,0,3,3
12866,contribuinte,0,0,3,3
51865,sagte,0,0,3,3
44194,praten,0,0,3,3
44166,proyecto.,0,0,3,3
20185,किए,0,0,3,3
36966,политики,0,0,3,3
44168,array,0,0,3,3
12952,spørgsmål,0,0,3,3
27444,thèmes,0,0,3,3
20163,long-term,0,0,3,3
1277,originale,1,3,0,3
20180,വിക്കിമീഡിയ,0,0,3,3
12938,highest,0,0,3,3
20202,sequences,0,0,3,3
12937,jullie,0,0,3,3
12931,sanki,0,0,3,3
12928,akıllıca,0,0,3,3
34528,lektion.,0,0,3,3
23820,posição,0,0,3,3
23816,என்னிடம்,0,0,3,3
39358,cité,0,0,3,3
44063,них,0,0,3,3
44062,γουέιλς,0,0,3,3
13113,comercial,0,0,3,3
36909,discusiones,0,0,3,3
43888,बड़े,0,0,3,3
19941,actuellement,0,0,3,3
27242,ampla,0,0,3,3
27249,वृत्तचित्र,0,0,3,3
1881,consultazione,1,3,0,3
13314,prensa,0,0,3,3
36908,первый,0,0,3,3
39513,primary,0,0,3,3
13357,θυμηθείτε,0,0,3,3
27253,belangrijk,0,0,3,3
19962,preserve,0,0,3,3
43932,давай,0,0,3,3
2978,conversazione,1,3,0,3
50587,fossil,0,0,3,3
34655,स्वतंत्रता,0,0,3,3
23921,helst,0,0,3,3
39524,لهذا,0,0,3,3
1886,'più,1,3,0,3
27277,connu,0,0,3,3
23942,ಚಿಂತಿಸಬೇಡಿ.,0,0,3,3
39548,phuein,0,0,3,3
51836,engineering,0,0,3,3
27200,miljoner,0,0,3,3
43862,try,0,0,3,3
27209,επιτρέψτε,0,0,3,3
13391,получаете,0,0,3,3
19905,critères,0,0,3,3
19911,близко,0,0,3,3
1889,randy,1,3,0,3
19912,gånger.,0,0,3,3
19913,how's,0,0,3,3
27218,hambre,0,0,3,3
51840,alguém.,0,0,3,3
50592,உதாரணம்,0,0,3,3
43879,கருத்து,0,0,3,3
43880,dartmouth,0,0,3,3
23920,jusqu'en,0,0,3,3
43957,förekommer,0,0,3,3
20049,बेच,0,0,3,3
13146,discover,0,0,3,3
3002,pubblicazioni,1,3,0,3
34606,realm,0,0,3,3
39465,आ,0,0,3,3
20029,பணிகள்,0,0,3,3
27341,παιδιά,0,0,3,3
27342,vardır.,0,0,3,3
27343,utilizadas,0,0,3,3
44042,अंतिम,0,0,3,3
36924,cartoon,0,0,3,3
1860,repository,2,2,1,3
39461,खुले,0,0,3,3
13128,minder,0,0,3,3
3008,aperto,1,3,0,3
20038,ausgeflippt,0,0,3,3
20044,kleine,0,0,3,3
1856,serio,2,1,2,3
44025,indem,0,0,3,3
39477,bloggar,0,0,3,3
36918,mutlu,0,0,3,3
13223,скажите,0,0,3,3
13252,justo,0,0,3,3
13247,разделе,0,0,3,3
43970,nommée,0,0,3,3
27289,eliminación,0,0,3,3
13238,bald,0,0,3,3
43977,والدتها,0,0,3,3
19999,utiles,0,0,3,3
13220,возможно,0,0,3,3
27329,вики,0,0,3,3
23901,kaynak,0,0,3,3
34628,πάει,0,0,3,3
2990,fine.,2,1,2,3
20006,hermosa,0,0,3,3
13194,fundada,0,0,3,3
2995,soldi,1,3,0,3
23897,reason,0,0,3,3
24149,gizli,0,0,3,3
39813,commun,0,0,3,3
42771,nothing,0,0,3,3
40106,sitting,0,0,3,3
18968,march,0,0,3,3
43016,mathématiques,0,0,3,3
50719,automatisch,0,0,3,3
35122,गुप्त,0,0,3,3
26572,يهم,0,0,3,3
14639,betydligt,0,0,3,3
43028,सार्वजनिक,0,0,3,3
24419,. billion,0,0,3,3
40167,serious,0,0,3,3
35119,работать,0,0,3,3
43032,juntos,0,0,3,3
36580,explains,0,0,3,3
24413,люди,0,0,3,3
24409,गए।,0,0,3,3
35112,pois,0,0,3,3
43044,уловил,0,0,3,3
2761,attivi,1,3,0,3
35129,an.,0,0,3,3
26561,രജിസ്റ്റർ,0,0,3,3
24423,dinheiro,0,0,3,3
42992,seviyorum,0,0,3,3
42979,l'avez,0,0,3,3
24442,newspaper,0,0,3,3
42984,l'œuvre,0,0,3,3
14703,visit,0,0,3,3
26546,போது,0,0,3,3
18941,usas,0,0,3,3
24438,encyklopædi,0,0,3,3
18951,മുഴുവൻ,0,0,3,3
14667,contraire,0,0,3,3
26549,οποίο,0,0,3,3
24431,redes,0,0,3,3
14682,graag,0,0,3,3
40177,l’enseignement,0,0,3,3
18963,உரையாடலில்,0,0,3,3
35135,polémica,0,0,3,3
26555,ചോദിക്കുന്നു.,0,0,3,3
14603,легко,0,0,3,3
43053,sabía,0,0,3,3
18995,tillgång,0,0,3,3
26632,οξεία,0,0,3,3
19039,aandacht,0,0,3,3
43101,överbelastad,0,0,3,3
1188,miglior,1,3,0,3
19046,passiert,0,0,3,3
43112,€,0,0,3,3
14518,grund,0,0,3,3
26631,ഒബ്‌ട്യൂസ്,0,0,3,3
2024,stesso.,1,3,0,3
19032,மனதில்,0,0,3,3
40109,heures,0,0,3,3
35080,يقدم,0,0,3,3
14504,чего-то,0,0,3,3
24374,говоришь,0,0,3,3
14495,والتي,0,0,3,3
35077,جدًا.,0,0,3,3
43130,komma,0,0,3,3
14537,ولكني,0,0,3,3
26620,effets,0,0,3,3
36583,trabalhar,0,0,3,3
43066,erklärt,0,0,3,3
18998,verblüfft,0,0,3,3
2029,educato,1,3,0,3
43059,ದೊಡ್ಡ,0,0,3,3
2028,totale,1,3,0,3
26596,hyperliens,0,0,3,3
14584,wetenschappelijke,0,0,3,3
43065,tard,0,0,3,3
43070,τραβήξτε,0,0,3,3
26617,ಫಿಕ್ಸ್‌ನಲ್ಲಿದ್ದೇನೆ,0,0,3,3
797,l'attività,1,3,0,3
43072,العالم.,0,0,3,3
26613,रोने,0,0,3,3
43086,assim.,0,0,3,3
2026,unicamente,1,3,0,3
43088,رؤية,0,0,3,3
24394,entrées,0,0,3,3
42977,resolver,0,0,3,3
35146,individuele,0,0,3,3
42965,behavioral,0,0,3,3
42831,tacka,0,0,3,3
2704,numerosi,1,3,0,3
50751,vinklat,0,0,3,3
1162,distribuzione,1,3,0,3
42823,πηγαίνετε,0,0,3,3
18816,ಆಹಾರ,0,0,3,3
14928,akşam,0,0,3,3
35207,நல்லது.,0,0,3,3
40282,received,0,0,3,3
835,latine,2,1,2,3
24505,skønhed,0,0,3,3
40276,systems.,0,0,3,3
14908,devenu,0,0,3,3
14907,droeg,0,0,3,3
50747,φάω,0,0,3,3
42841,enciclopédia.,0,0,3,3
35201,हिस्से,0,0,3,3
35218,harcèlement,0,0,3,3
14953,[needs,0,0,3,3
18834,d'écriture,0,0,3,3
14982,muestra,0,0,3,3
42774,nichts,0,0,3,3
36505,libraries,0,0,3,3
15009,önce,0,0,3,3
24525,концу,0,0,3,3
14993,viki,0,0,3,3
26387,constituent,0,0,3,3
40290,oui,0,0,3,3
26395,mitten,0,0,3,3
18813,απλά,0,0,3,3
26396,planeta,0,0,3,3
14971,tahmin,0,0,3,3
40287,uit.,0,0,3,3
14962,चार,0,0,3,3
14961,style,0,0,3,3
36520,வகையில்,0,0,3,3
26405,duro,0,0,3,3
24500,liefste,0,0,3,3
2715,-.,2,1,2,3
18931,konnte,0,0,3,3
40217,forget,0,0,3,3
14796,ജിമ്മി,0,0,3,3
814,potrei,1,3,0,3
18889,déclare,0,0,3,3
14782,erstaunliche,0,0,3,3
18903,ελεύθερος,0,0,3,3
42934,ಚಿನ್ನದಿಂದ,0,0,3,3
42935,samedi,0,0,3,3
42944,là-bas,0,0,3,3
2730,incomplete,2,1,2,3
42945,όνειρό,0,0,3,3
26519,इन्टरनेट,0,0,3,3
40207,يعمل,0,0,3,3
35152,kendine,0,0,3,3
18926,എന്നതാണ്.,0,0,3,3
42954,prose,0,0,3,3
51779,थीं।,0,0,3,3
26498,remainder,0,0,3,3
35169,contar,0,0,3,3
40266,tráfego,0,0,3,3
2044,venduto,1,3,0,3
36532,حسب,0,0,3,3
24488,ಕೊನೆಯ,0,0,3,3
2721,circa,2,2,1,3
14845,правила,0,0,3,3
36535,fluide.,0,0,3,3
51111,visat,0,0,3,3
24480,annonce,0,0,3,3
40236,besökare,0,0,3,3
36545,लगाया,0,0,3,3
816,routine,2,1,2,3
35175,kritiserats,0,0,3,3
40235,arruiné,0,0,3,3
14820,ನಿಧಾನವಾಗಿ,0,0,3,3
14814,vogn,0,0,3,3
36541,aparece,0,0,3,3
26490,confundir,0,0,3,3
40107,suficiente,0,0,3,3
2774,prendi,1,3,0,3
13947,ஆமாம்,0,0,3,3
2775,pubblicazione,1,3,0,3
19364,narcisses,0,0,3,3
50669,onze,0,0,3,3
26830,levar,0,0,3,3
43373,дочь,0,0,3,3
14121,هؤلاء,0,0,3,3
43389,tadić,0,0,3,3
36701,vegetation,0,0,3,3
19376,большой,0,0,3,3
43396,странице,0,0,3,3
14100,firm,0,0,3,3
34936,بـ,0,0,3,3
39892,représentations,0,0,3,3
43398,norman,0,0,3,3
43399,logiciels,0,0,3,3
39890,subset,0,0,3,3
43405,october,0,0,3,3
19389,ran,0,0,3,3
764,sabato,1,3,0,3
26823,protected,0,0,3,3
51143,luisterde,0,0,3,3
19330,anjo,0,0,3,3
50681,richtig,0,0,3,3
19323,ಮಾರಿದ್ದೀರಿ,0,0,3,3
43318,φοβάμαι,0,0,3,3
43319,pesquisadores,0,0,3,3
1216,permette,1,3,0,3
14210,utilisés,0,0,3,3
43321,camelcase,0,0,3,3
39925,نظام,0,0,3,3
43360,l’aa,0,0,3,3
2830,radice,1,3,0,3
43340,rocker,0,0,3,3
14177,laver,0,0,3,3
36688,इतने,0,0,3,3
43344, .,0,0,3,3
19346,farvel,0,0,3,3
43352,घटनाओं,0,0,3,3
24212,अनुरोधों,0,0,3,3
39887,желание,0,0,3,3
34929,запрос,0,0,3,3
19477,wikipédiens,0,0,3,3
1953,strumento,1,3,0,3
39849,hablar,0,0,3,3
34908,universitaires,0,0,3,3
39843,όσα,0,0,3,3
24167,implicitly,0,0,3,3
43460,dames,0,0,3,3
26907,background,0,0,3,3
36748,artigo.,0,0,3,3
50659,scherpe,0,0,3,3
26915,economía,0,0,3,3
39820,relation,0,0,3,3
24157,रोना,0,0,3,3
26918,gentils,0,0,3,3
43485,ஒருவரை,0,0,3,3
51158,पड़ता,0,0,3,3
19494,manning,0,0,3,3
1226,prestito,1,3,0,3
19428,அமெரிக்கர்கள்,0,0,3,3
14069,båda,0,0,3,3
19415,beauté,0,0,3,3
43415,ನೋಡೋಣ.,0,0,3,3
14064,græder,0,0,3,3
2849,chiesto,1,3,0,3
762,parlando,1,3,0,3
14057,abonnieren,0,0,3,3
761,narcisismo,2,1,2,3
14051,tidskriften,0,0,3,3
14043,aprendizaje.,0,0,3,3
19427,vyn,0,0,3,3
39870,وكان,0,0,3,3
39869,எப்படியும்,0,0,3,3
14035,offensive,0,0,3,3
19422,tornar,0,0,3,3
43434,l'esprit,0,0,3,3
43437,plaindre,0,0,3,3
758,derivati,1,3,0,3
14225,beleza,0,0,3,3
14226,dåligt,0,0,3,3
19315,عامة,0,0,3,3
1202,pena.,2,1,2,3
40058,-е,0,0,3,3
35048,ängeln,0,0,3,3
40051,ഓൺ‌ലൈൻ,0,0,3,3
14414,crecimiento,0,0,3,3
26685,nécessaire,0,0,3,3
43193,ವನ್ನು,0,0,3,3
19145,réaliser,0,0,3,3
14395,citation,0,0,3,3
14430,silver,0,0,3,3
19157,английский,0,0,3,3
24318,παρακαλώ,0,0,3,3
35040,takke,0,0,3,3
2004,solamente,2,1,2,3
40019,ನೀಡಲಿದ್ದೇನೆ.,0,0,3,3
786,abbastanza,1,3,0,3
43207,conocimientos,0,0,3,3
36624,allumé,0,0,3,3
14434,synonyme,0,0,3,3
1207,costruzione,1,3,0,3
24359,साईट,0,0,3,3
43138,ನಾಳೆ,0,0,3,3
24366,مقالة.,0,0,3,3
14477,pedidos,0,0,3,3
19085,वर्ष,0,0,3,3
26654,എത്ര,0,0,3,3
36609,anônimos,0,0,3,3
19089,sprog,0,0,3,3
1194,prova,2,2,1,3
43169,nimm,0,0,3,3
14461,пользователи,0,0,3,3
43154,zelfs,0,0,3,3
2781,provenienza,1,3,0,3
43156,instellingen,0,0,3,3
43167,uden,0,0,3,3
2015,ufficiale,1,3,0,3
40072,degree,0,0,3,3
40014,множество,0,0,3,3
19203,باسم,0,0,3,3
19314,utilisent,0,0,3,3
51793,pond,0,0,3,3
39963,विशेषज्ञ,0,0,3,3
43262,letar,0,0,3,3
24264,hårdere,0,0,3,3
43270,vient,0,0,3,3
39953,सुंदरता,0,0,3,3
39951,colaborativa.,0,0,3,3
43272,inglés.,0,0,3,3
39943,कार्यों,0,0,3,3
51138,oldukça,0,0,3,3
24251,concurso,0,0,3,3
39939,എനിക്കറിയില്ല,0,0,3,3
34983,πάρα,0,0,3,3
1977,breiman,2,1,2,3
14233,posible,0,0,3,3
34981,millioner,0,0,3,3
26784,عديدة,0,0,3,3
39968,anında,0,0,3,3
26742,methodes,0,0,3,3
24303,alguien.,0,0,3,3
36659,well.,0,0,3,3
36647,copiar,0,0,3,3
19220,incapable,0,0,3,3
14357,grec,0,0,3,3
24293,tipset,0,0,3,3
35030,निश्चित,0,0,3,3
19225,communities,0,0,3,3
14332,depends,0,0,3,3
39981,items,0,0,3,3
2806,schekman,1,3,0,3
39980,knowledge.,0,0,3,3
39978,c’est-à-dire,0,0,3,3
26733,नीतियों,0,0,3,3
14310,revert,0,0,3,3
43246,شبه,0,0,3,3
1990,globale,2,1,2,3
19263,बनाना।,0,0,3,3
16208,μιας,0,0,3,3
37763,principles,0,0,3,3
32874,ardından,0,0,3,3
8726,ενός,0,0,3,3
33065,أعرف,0,0,3,3
47955,модели,0,0,3,3
31492,faktiskt,0,0,3,3
7158,ಒಳ್ಳೆಯ,0,0,3,3
29471,quotidienne,0,0,3,3
31490,siz,0,0,3,3
6848,básicamente,0,0,3,3
4189,centinaia,1,3,0,3
46638,fyra,0,0,3,3
32628,aucune,0,0,3,3
4811,моем,0,0,3,3
33063,klaga,0,0,3,3
48809,locais,0,0,3,3
46637,தருகிறேன்.,0,0,3,3
6598,πραγματικότητα,0,0,3,3
32442,entrevista,0,0,3,3
3952,va.,2,1,2,3
6851,البداية,0,0,3,3
30557,multicellular,0,0,3,3
7796,равно,0,0,3,3
9416,sesgo,0,0,3,3
29723,أشار,0,0,3,3
30430,intelligence.,0,0,3,3
50106,listen,0,0,3,3
29134,waarop,0,0,3,3
8745,rubis,0,0,3,3
6859,uzun,0,0,3,3
5182,respect,0,0,3,3
4819,मल्टीमीडिया,0,0,3,3
30279,documents,0,0,3,3
7783,основе,0,0,3,3
6603,elegidos,0,0,3,3
29951,kullanılır,0,0,3,3
49798,conduit,0,0,3,3
31099,olurdu,0,0,3,3
29123,प्रश्न,0,0,3,3
114,zona,2,2,1,3
7175,машинное,0,0,3,3
8199,incluye,0,0,3,3
31280,ഉദാഹരണങ്ങൾ,0,0,3,3
5554,alvo,0,0,3,3
49004,kennen.,0,0,3,3
5558,البعض,0,0,3,3
29126,magnus,0,0,3,3
7172,barnpornografi,0,0,3,3
47948,स्थानांतरित,0,0,3,3
7776,अत्याचार,0,0,3,3
30666,σύντομα,0,0,3,3
7170,grundades,0,0,3,3
29477,bons,0,0,3,3
48455,करेंगे,0,0,3,3
32192,சிறிது,0,0,3,3
33257,roy,0,0,3,3
25,brockhaus,2,2,1,3
6604,collective,0,0,3,3
49494,உரை,0,0,3,3
32191,व्यस्त,0,0,3,3
33429,surtout,0,0,3,3
5847,hadi,0,0,3,3
46771,प्रशासक,0,0,3,3
48804,suppose,0,0,3,3
9131,zien.,0,0,3,3
46447,árabe,0,0,3,3
31840,hablando,0,0,3,3
33205,merci.,0,0,3,3
48828,стал,0,0,3,3
8907,suggested,0,0,3,3
8216,skriver,0,0,3,3
4059,quattro,1,3,0,3
4847,ei,0,0,3,3
46622,ಕುರಿತು,0,0,3,3
31850,பிடிக்கவில்லை,0,0,3,3
7985,maj,0,0,3,3
32095,classement,0,0,3,3
46468,ouverte,0,0,3,3
49458,വിരലുകൾ,0,0,3,3
4854,posé,0,0,3,3
48319,forms.,0,0,3,3
29388,méthode,0,0,3,3
47511,объясняет,0,0,3,3
29456,analytique,0,0,3,3
5581,αμερικανοί,0,0,3,3
8323,κουρασμένοι,0,0,3,3
6426,bed,0,0,3,3
30962,ampliar,0,0,3,3
7103,memory,0,0,3,3
50014,ιδέα.,0,0,3,3
47506,каждого,0,0,3,3
47395,ذلك؟,0,0,3,3
7096,பயனர்,0,0,3,3
48983,conseguir,0,0,3,3
31300,απλώς,0,0,3,3
7829,материалов,0,0,3,3
7111,saker,0,0,3,3
31472,economics,0,0,3,3
52056,kernel,0,0,3,3
9139,bunlar,0,0,3,3
32621,hombre,0,0,3,3
7805,अलविदा,0,0,3,3
7132,skrivs,0,0,3,3
46633,पंजीकृत,0,0,3,3
33424,redo,0,0,3,3
7130,propósito,0,0,3,3
47516,automatiskt,0,0,3,3
47974,coordenar,0,0,3,3
29664,getan,0,0,3,3
46451,சிறிய,0,0,3,3
8750,pasando,0,0,3,3
46631,فعل,0,0,3,3
4833,komen,0,0,3,3
7127,κοίταξε,0,0,3,3
7114,havalı,0,0,3,3
49241,moral,0,0,3,3
9400,fortsätta,0,0,3,3
9143,connaissances,0,0,3,3
8212,gott.,0,0,3,3
5574,croyance,0,0,3,3
8756,επιπλέον,0,0,3,3
8329,возьми,0,0,3,3
29842,globo-rompecabezas,0,0,3,3
8215,décrire,0,0,3,3
33251,skriven,0,0,3,3
3833,l'ex,1,3,0,3
48988,ബട്ടൺ,0,0,3,3
30303,apoyo,0,0,3,3
47251,deus.,0,0,3,3
49842,ettiğim,0,0,3,3
33409,google.,0,0,3,3
49506,طريق,0,0,3,3
30902,llorando,0,0,3,3
48480,söylemenin,0,0,3,3
5907,daumen,0,0,3,3
33176,निर्माता,0,0,3,3
6342,internautes.,0,0,3,3
46407,wusste,0,0,3,3
7724,громадно,0,0,3,3
5906,கற்றுக்,0,0,3,3
4698,inspired,0,0,3,3
5905,vind,0,0,3,3
9469,females,0,0,3,3
5225,apple,0,0,3,3
31545,നിങ്ങൾക്കറിയാം.,0,0,3,3
48479,journalism,0,0,3,3
5223,उद्धरण,0,0,3,3
48478,moeras,0,0,3,3
47904,ons,0,0,3,3
33261,casar,0,0,3,3
32657,அல்ல,0,0,3,3
33074,træk,0,0,3,3
30685,المقالة.,0,0,3,3
31346,charge,0,0,3,3
3695,noi,1,3,0,3
4702,وتقول,0,0,3,3
33178,hellere,0,0,3,3
9464,பிரமாதமானது,0,0,3,3
49213,намного,0,0,3,3
30249,തോന്നുന്നു.,0,0,3,3
8372,gonna,0,0,3,3
6813,இருந்தபோது,0,0,3,3
47570,βρίσκεται,0,0,3,3
30238,tvärtom,0,0,3,3
48486,faktisk,0,0,3,3
47267,inspirados,0,0,3,3
281,significativa,2,1,2,3
47363,alternativas,0,0,3,3
6802,الولايات,0,0,3,3
48487,tourist,0,0,3,3
32833,மரியன்,0,0,3,3
7708,länder,0,0,3,3
47874,doigts,0,0,3,3
4235,ideia,0,0,3,3
8665,humanos,0,0,3,3
9100,शीर्षक,0,0,3,3
9489,strength,0,0,3,3
4672,deelnemers,0,0,3,3
29981,üben,0,0,3,3
32212,kullanılmaktadır.,0,0,3,3
5918,låta,0,0,3,3
29507,மேற்பட்ட,0,0,3,3
31982,páginas.,0,0,3,3
8947,verklaart,0,0,3,3
6332,любом,0,0,3,3
50164,afirmou,0,0,3,3
47264,ellas,0,0,3,3
30233,baseada,0,0,3,3
49874,orolig,0,0,3,3
7715,contained,0,0,3,3
32080,थक,0,0,3,3
30687,знать,0,0,3,3
3742,c't,2,2,1,3
8943,قام,0,0,3,3
49214,وبالتالي,0,0,3,3
6624,déplacer,0,0,3,3
5864,«нупедия»,0,0,3,3
29482,piece,0,0,3,3
49221,مزعج,0,0,3,3
47928,atual,0,0,3,3
48789,natürlich,0,0,3,3
29958,awesome,0,0,3,3
29957,പോലും,0,0,3,3
6615,wikiwand,0,0,3,3
29374,zoveel,0,0,3,3
30448,ആയിരുന്നു,0,0,3,3
9119,pequeña,0,0,3,3
32519,l'identité,0,0,3,3
49010,inteligencia,0,0,3,3
5866,ещё,0,0,3,3
49516,assise,0,0,3,3
4072,rilevanti,1,3,0,3
30267,wikipedias.,0,0,3,3
46917,äußerst,0,0,3,3
30269,தவறுகள்,0,0,3,3
49512,ഭാഷയിൽ,0,0,3,3
47940,vijf,0,0,3,3
52105,críticas.,0,0,3,3
32361,utöver,0,0,3,3
31823,ಸೌಂದರ್ಯವನ್ನು,0,0,3,3
46430,आलोचकों,0,0,3,3
4192,principio,2,2,1,3
48170,ரகசிய,0,0,3,3
31277,onto,0,0,3,3
48462,subscribe,0,0,3,3
47923,kelimeden,0,0,3,3
31272,mío.,0,0,3,3
6622,grammatik,0,0,3,3
8185,сообщение,0,0,3,3
47910,l'information,0,0,3,3
5893,откуда,0,0,3,3
5215,കുറച്ചുകൂടി,0,0,3,3
33072,أحدهم,0,0,3,3
6621,लोकप्रिय,0,0,3,3
5535,eksik,0,0,3,3
5889,algae,0,0,3,3
29736,июле,0,0,3,3
8700,nam,0,0,3,3
5212,लिखी,0,0,3,3
50005,moves,0,0,3,3
9455,لديه,0,0,3,3
29822,declaró,0,0,3,3
47151,affirme,0,0,3,3
8189,record,0,0,3,3
46645,стала,0,0,3,3
7742,ഡാറ്റ,0,0,3,3
6620,मेहनत,0,0,3,3
32357,employé,0,0,3,3
47259,अंतर,0,0,3,3
7217,espanhol,0,0,3,3
30917,verdad,0,0,3,3
29962,उत्तरी,0,0,3,3
20,l'uso,1,3,0,3
5878,afbeeldingen,0,0,3,3
30677,بخير,0,0,3,3
7209,commencé,0,0,3,3
3585,xx,2,1,2,3
4869,ಹೇಳುವ,0,0,3,3
30639,contient,0,0,3,3
6799,λάβετε,0,0,3,3
30579,şeyin,0,0,3,3
29198,ios,0,0,3,3
49289,l'usage,0,0,3,3
49291,americans,0,0,3,3
29694,красив,0,0,3,3
31901,വാക്കുകളും,0,0,3,3
8238,middle,0,0,3,3
5707,pares,0,0,3,3
9284,originalmente,0,0,3,3
31902,போலவே,0,0,3,3
5098,अनुभव,0,0,3,3
7949,aqueles,0,0,3,3
60,sei.,2,1,2,3
31904,ಅಮೆರಿಕನ್ನರು,0,0,3,3
9275,combatir,0,0,3,3
102,presupposto,1,3,0,3
4995,कपड़े,0,0,3,3
30382,moyenne,0,0,3,3
4996,comunidade.,0,0,3,3
48906,peki,0,0,3,3
29698,व्यापक,0,0,3,3
48093,ohne,0,0,3,3
49967,जुलाई,0,0,3,3
9269,прямо,0,0,3,3
31906,effects,0,0,3,3
176,turista,2,1,2,3
5699,buscar,0,0,3,3
47455,italien,0,0,3,3
8265,dedicada,0,0,3,3
3608,usano,1,3,0,3
50147,olabilir,0,0,3,3
4987,confused,0,0,3,3
46530,inden,0,0,3,3
48894,course,0,0,3,3
6477,branches,0,0,3,3
8824,विकिस्रोत,0,0,3,3
47464,கொண்ட,0,0,3,3
9308,ಎಲ್ಲಿದ್ದೇವೆ,0,0,3,3
48040,ഔട്പുട്ട്,0,0,3,3
29421,nasılsın,0,0,3,3
48042,l'emploi,0,0,3,3
6927,ನೀಡುತ್ತೇನೆ.,0,0,3,3
49285,lørdag,0,0,3,3
9200,bugün,0,0,3,3
6932,நீண்ட,0,0,3,3
31010,மெல்லி,0,0,3,3
4166,jordan,2,2,1,3
32112,нравится,0,0,3,3
49363,சொன்னது,0,0,3,3
6935,falsa,0,0,3,3
50240,हाँ,0,0,3,3
47462,d'après,0,0,3,3
4976,ante,0,0,3,3
6937,нейросети,0,0,3,3
46804,biases.,0,0,3,3
49368,ouvert,0,0,3,3
33380,भ्रमित,0,0,3,3
46834,இருப்பேன்.,0,0,3,3
6940,سوف,0,0,3,3
7006,ನಿರರ್ಗಳವಾಗಿ,0,0,3,3
4983,aplicación,0,0,3,3
5714,betydelse,0,0,3,3
5003,இருப்பதாக,0,0,3,3
5698,campaña,0,0,3,3
46548,ലേഖനങ്ങളും,0,0,3,3
32417,algo.,0,0,3,3
5652,probability,0,0,3,3
48082,redigerats,0,0,3,3
48368,данные,0,0,3,3
5027,запущенным,0,0,3,3
4174,fare.,1,3,0,3
5030,முடியவில்லை.,0,0,3,3
6521,அதிக,0,0,3,3
31919,sert,0,0,3,3
29868,lyttede,0,0,3,3
29880,सामने,0,0,3,3
9236,özür,0,0,3,3
46563,«un,0,0,3,3
29232,некоторым,0,0,3,3
6977,d'importance,0,0,3,3
8869,gefragt,0,0,3,3
5045,مثير,0,0,3,3
33362,knew,0,0,3,3
5049,vrouw,0,0,3,3
29877,dons,0,0,3,3
6965,ചെയ്യുന്നു,0,0,3,3
46567,teve,0,0,3,3
46811,yakışıklı,0,0,3,3
6975,सुन,0,0,3,3
48078,fazladan,0,0,3,3
31936,aceso,0,0,3,3
7930,elke,0,0,3,3
49830,добросовестного,0,0,3,3
5060,aquellos,0,0,3,3
32128,investigadores,0,0,3,3
5075,complexes,0,0,3,3
32140,narcis.,0,0,3,3
4257,лучший,0,0,3,3
4255,ஏய்,0,0,3,3
3970,vocale,2,2,1,3
5007,lieve,0,0,3,3
49823,planète,0,0,3,3
47453,المشروع,0,0,3,3
30584,média,0,0,3,3
5690,योग्य,0,0,3,3
29216,άπταιστα,0,0,3,3
6501,parti,0,0,3,3
47423,लेने,0,0,3,3
9255,fully,0,0,3,3
48090,परवाह,0,0,3,3
4181,brand,2,1,2,3
6988,مشاكل,0,0,3,3
6512,الموقع.,0,0,3,3
3812,prove,2,1,2,3
7910,appel,0,0,3,3
5680,تناول,0,0,3,3
5016,केचे,0,0,3,3
9215,procesos,0,0,3,3
32901,réduire,0,0,3,3
32130,несмотря,0,0,3,3
29218,değişiklik,0,0,3,3
9248,ವರ್ಡ್,0,0,3,3
5018,freund,0,0,3,3
31335,narcissus.,0,0,3,3
9244,ago.,0,0,3,3
5022,lärare,0,0,3,3
9312,machen,0,0,3,3
32550,inputs.,0,0,3,3
47501,provient,0,0,3,3
33353,الثانية,0,0,3,3
8310,ótimo,0,0,3,3
33218,решений,0,0,3,3
29163,opgericht,0,0,3,3
5150,court,0,0,3,3
6440,mídia,0,0,3,3
32537,utvalda,0,0,3,3
8308,tópico,0,0,3,3
49423,evaluated,0,0,3,3
5148,sumpf,0,0,3,3
32167,artık,0,0,3,3
5780,full,0,0,3,3
47234,tool,0,0,3,3
7073,host,0,0,3,3
48850,beschreiben,0,0,3,3
8305,большинство,0,0,3,3
30975,external,0,0,3,3
9352,давайте,0,0,3,3
29168,enseignants,0,0,3,3
8304,comment.,0,0,3,3
48011,sannolikt,0,0,3,3
8303,torna,0,0,3,3
5601,ಈಗಾಗಲೇ,0,0,3,3
3808,scritta,1,3,0,3
335,pratici,1,3,0,3
6444,fome,0,0,3,3
6577,mistake,0,0,3,3
6894,sidste,0,0,3,3
29394,learner,0,0,3,3
7064,λυπάμαι,0,0,3,3
31957,ruim,0,0,3,3
4893,получить,0,0,3,3
48978,ansiklopedisi,0,0,3,3
49435,gebeurt,0,0,3,3
49253,debajo,0,0,3,3
33210,நான்கு,0,0,3,3
33408,gostaria,0,0,3,3
49810,दोहरान,0,0,3,3
52135,agit,0,0,3,3
31452,ماريان,0,0,3,3
30312,vinieron,0,0,3,3
31861,comunes,0,0,3,3
50153,développe,0,0,3,3
46477,lsjbot,0,0,3,3
46879,знал,0,0,3,3
47181,सुनिश्चित,0,0,3,3
30416,पकड़ा,0,0,3,3
5796,рядом,0,0,3,3
46609,ಅನೇಕ,0,0,3,3
33212,put,0,0,3,3
32536,kızı,0,0,3,3
4884,учёными,0,0,3,3
29921,மதிப்பெண்,0,0,3,3
49432,till.,0,0,3,3
33405,thématique,0,0,3,3
5155,лет,0,0,3,3
32171,परीक्षा,0,0,3,3
48844,şaşkın,0,0,3,3
47182,hemmelige,0,0,3,3
301,pubblica,1,3,0,3
33215,فقدت,0,0,3,3
9364,observaciones,0,0,3,3
4285,authors,0,0,3,3
30407,தயவு,0,0,3,3
30406,masse,0,0,3,3
31882,och.,0,0,3,3
31316,recognized,0,0,3,3
38,paura,1,3,0,3
9328,importancia,0,0,3,3
48030,bacteria,0,0,3,3
46506,значения,0,0,3,3
46507,பெரும்பாலும்,0,0,3,3
48878,palavra.,0,0,3,3
8285,شكرا.,0,0,3,3
46849,capable,0,0,3,3
9180,mensen,0,0,3,3
32430,प्रसिद्ध,0,0,3,3
7034,believed,0,0,3,3
30397,έκανε,0,0,3,3
48111,задачи,0,0,3,3
5133,içeriğini,0,0,3,3
33026,arkadaşlarınız,0,0,3,3
46845,فيها,0,0,3,3
7956,kontroversiella,0,0,3,3
5122,movement,0,0,3,3
8820,frecuentemente,0,0,3,3
46801,opposition,0,0,3,3
49275,diária,0,0,3,3
49817,approche,0,0,3,3
49818,ലേഖനങ്ങളിൽ,0,0,3,3
31887,forskning,0,0,3,3
29423,صحيفة,0,0,3,3
33229,θεέ,0,0,3,3
46516,bröd,0,0,3,3
30339,ನೋಡುತ್ತೀರಿ.,0,0,3,3
48121,esfuerzo,0,0,3,3
46860,gemiddeld,0,0,3,3
30988,np-hard,0,0,3,3
31954,august,0,0,3,3
6899,changes.,0,0,3,3
29172,अंग्रेज़ी,0,0,3,3
50152,donnée,0,0,3,3
8805,നാളെ,0,0,3,3
7856,refer,0,0,3,3
32162,جدية,0,0,3,3
6457,provides,0,0,3,3
46498,мечты,0,0,3,3
29431,sad,0,0,3,3
336,l'ultima,1,3,0,3
178,canale,1,3,0,3
30986,σκληρότερα,0,0,3,3
7864,ಸಾಧ್ಯವಾಗಲಿಲ್ಲ.,0,0,3,3
31420,sabia,0,0,3,3
5759,américa,0,0,3,3
29683,puis-je,0,0,3,3
48869,weinberger.,0,0,3,3
8291,ಮುಂದೆ,0,0,3,3
29395,ಗಾಡಿಯಲ್ಲಿ,0,0,3,3
46602,internacional,0,0,3,3
50237,colère,0,0,3,3
7870,activities,0,0,3,3
7045,banklån,0,0,3,3
9333,interesses,0,0,3,3
29685,l’encontre,0,0,3,3
6467,कुल,0,0,3,3
29686,preocupes,0,0,3,3
48196,fournir,0,0,3,3
48184,कवरेज़,0,0,3,3
49570,adaptation,0,0,3,3
29592,included,0,0,3,3
46313,ലഭ്യമായ,0,0,3,3
31152,lincoln,0,0,3,3
31626,americanos,0,0,3,3
6218,ud.,0,0,3,3
7430,одном,0,0,3,3
30740,joke,0,0,3,3
46687,wikipediasidor,0,0,3,3
6224,erreur,0,0,3,3
4509,croate,0,0,3,3
33105,रखा,0,0,3,3
239,chiamata,1,3,0,3
52190,referendo,0,0,3,3
3908,necessariamente,2,2,1,3
7608,ursprung,0,0,3,3
48230,ലേഖകർ,0,0,3,3
9626,sekund.,0,0,3,3
256,stasera,1,3,0,3
46730,mission,0,0,3,3
7413,atmospheric,0,0,3,3
48224,அதிர்ஷ்டசாலி,0,0,3,3
32722,artikeln.,0,0,3,3
8462,robots,0,0,3,3
237,luogo,1,3,0,3
49924,நாளை,0,0,3,3
49923,sino,0,0,3,3
47009,systematic,0,0,3,3
46323,vikipedi'yi,0,0,3,3
4500,açık,0,0,3,3
48557,फ्रेंच,0,0,3,3
3999,ehi,1,3,0,3
46312,വിക്കി,0,0,3,3
31732,actes,0,0,3,3
52232,نيوبيديا.,0,0,3,3
47757,información.,0,0,3,3
29759,följande,0,0,3,3
46723,nou,0,0,3,3
49858,guidelines,0,0,3,3
4105,incredibile,1,3,0,3
49690,माफ,0,0,3,3
7445,говорил,0,0,3,3
4478,πολλές,0,0,3,3
49988,volonté,0,0,3,3
46303,kullandığım,0,0,3,3
29346,بأنه,0,0,3,3
32487,американцы,0,0,3,3
49857,wikipediaartikel,0,0,3,3
46305,faire.,0,0,3,3
9644,puntuación,0,0,3,3
32047,provenant,0,0,3,3
49681,проекта,0,0,3,3
49987,இருந்தது,0,0,3,3
4491,tänka,0,0,3,3
46728,सुनहरी,0,0,3,3
8093,asturias,0,0,3,3
33494,üç,0,0,3,3
47078,fyre,0,0,3,3
29590,раздела,0,0,3,3
32049,marais,0,0,3,3
47008,innefattar,0,0,3,3
4099,totalmente.,2,1,2,3
8073,würden,0,0,3,3
46332,εγκυκλοπαίδεια,0,0,3,3
30477,år.,0,0,3,3
49061,fortfarande,0,0,3,3
30729,kein,0,0,3,3
9590,दिए,0,0,3,3
7375,cheer,0,0,3,3
8597,правок,0,0,3,3
313,venuto,1,3,0,3
6760,chefredaktör,0,0,3,3
31139,conocimiento.,0,0,3,3
4538,lijst,0,0,3,3
32707,fréquemment,0,0,3,3
49163,chaos,0,0,3,3
4539,ಮಾರ್ಗವಾಗಿದೆ,0,0,3,3
47638,trek,0,0,3,3
31613,derece,0,0,3,3
3998,notte,1,3,0,3
5466,play,0,0,3,3
32970,ಹೋಗಬೇಕು.,0,0,3,3
3731,bellezza,1,3,0,3
31752,contribution,0,0,3,3
49940,यूट्यूब,0,0,3,3
4551,publicatie,0,0,3,3
30177,asturian,0,0,3,3
33150,verbluffend,0,0,3,3
7636,chicos,0,0,3,3
287,perdita,1,3,0,3
8442,nadat,0,0,3,3
9593,دخلت,0,0,3,3
30036,apporter,0,0,3,3
6050,لإنشاء,0,0,3,3
9599,devenir,0,0,3,3
46326,boas,0,0,3,3
8589,للتخريب,0,0,3,3
6049,zuilen,0,0,3,3
48543,remercier,0,0,3,3
6753,problemática,0,0,3,3
8141,tiempo.,0,0,3,3
4520,considerada,0,0,3,3
32263,minnesota,0,0,3,3
49199,संग्रहण,0,0,3,3
8593,dra,0,0,3,3
49661,obstante,0,0,3,3
49065,عرض,0,0,3,3
33480,maten,0,0,3,3
48676,alleen,0,0,3,3
3563,oppure,1,3,0,3
4526,ελεύθερη,0,0,3,3
6757,jimbo,0,0,3,3
9606,l’algorithme,0,0,3,3
32496,capacités,0,0,3,3
31748,l'économie,0,0,3,3
8456,türkiye,0,0,3,3
7386,чувствую,0,0,3,3
4347,verá,0,0,3,3
9053,opposite,0,0,3,3
6038,знаний,0,0,3,3
32993,sujets,0,0,3,3
30825,« les,0,0,3,3
9044,härter,0,0,3,3
33111,considérés,0,0,3,3
50277,color,0,0,3,3
31682,पाठक,0,0,3,3
30774,swedish,0,0,3,3
6701,understanding,0,0,3,3
8529,one.,0,0,3,3
46713,работал,0,0,3,3
29329,density,0,0,3,3
28997,இருந்தார்,0,0,3,3
4397,løsning,0,0,3,3
33512,instant.,0,0,3,3
32296,अधिकार,0,0,3,3
31679,acımasız,0,0,3,3
29773,experience.,0,0,3,3
31179,أستخدمها,0,0,3,3
47722,afirma,0,0,3,3
31181,rahatsız,0,0,3,3
31705,analyses,0,0,3,3
8532,marché,0,0,3,3
29000,espere,0,0,3,3
3889,maniera,1,3,0,3
150,vedere,1,3,0,3
47724,bör,0,0,3,3
31182,जवाब,0,0,3,3
49110,strongly,0,0,3,3
187,contro,1,3,0,3
48253,juridique,0,0,3,3
5383,istiyorum,0,0,3,3
9681,शब्दकोष,0,0,3,3
48617,vergelijking,0,0,3,3
49930,símbolos,0,0,3,3
46703,marque,0,0,3,3
241,tedesco,1,3,0,3
48257,receiving,0,0,3,3
28988,मीड़याविकी,0,0,3,3
352,chiunque.,1,3,0,3
147,nessun,1,3,0,3
6148,recuerda,0,0,3,3
8516,ಪರೀಕ್ಷೆಯಲ್ಲಿ,0,0,3,3
4375,entschuldigen,0,0,3,3
32766,эй,0,0,3,3
47700,équivalent,0,0,3,3
3717,tradizionali,1,3,0,3
29334,considers,0,0,3,3
7543,toc,0,0,3,3
7531,أربعة,0,0,3,3
49749,ಹೆಚ್ಚುವರಿ,0,0,3,3
47046,weiter.,0,0,3,3
3719,russo,2,1,2,3
8114,usados,0,0,3,3
8525,beau,0,0,3,3
8526,possui,0,0,3,3
6160,edebilir,0,0,3,3
30090,الرجل,0,0,3,3
5398,keep,0,0,3,3
3887,latina,2,1,2,3
32291,passive,0,0,3,3
46270,उच्चारण,0,0,3,3
51997,φαίνεται,0,0,3,3
30067,विकिसमाचार,0,0,3,3
29573,fuentes,0,0,3,3
31674,മനോഹരമായ,0,0,3,3
8536,presenta,0,0,3,3
30061,الفيديو.,0,0,3,3
33126,όνειρο,0,0,3,3
47664,نارسيس,0,0,3,3
47297,நிலத்தில்,0,0,3,3
6674,ஒருவருக்கு,0,0,3,3
6198,σίγουρος,0,0,3,3
8132,ocupado,0,0,3,3
8552,films,0,0,3,3
8997,zero,0,0,3,3
3554,markup,2,2,1,3
8484,machinaal,0,0,3,3
31203,flawed,0,0,3,3
4453,വിവാഹം,0,0,3,3
33298,marcas,0,0,3,3
4454,archaea,0,0,3,3
49134,sujet.,0,0,3,3
52048,مرحباً,0,0,3,3
48637,tidsskrift,0,0,3,3
49135,fantastisch,0,0,3,3
48639,ലഭിച്ചു,0,0,3,3
30119,ಏನೂ,0,0,3,3
29557,haga,0,0,3,3
47023,ಕೇಳಿದ್ದೀರಿ,0,0,3,3
6722,ஒன்றை,0,0,3,3
31205,allez,0,0,3,3
5354,परीक्षण,0,0,3,3
6086,brug,0,0,3,3
5432,italian,0,0,3,3
7591,englisch,0,0,3,3
31660,тоже,0,0,3,3
8549,ocean.,0,0,3,3
48631,petite,0,0,3,3
7487,servidor,0,0,3,3
4415,tienen,0,0,3,3
3715,america,2,1,2,3
50076,fort,0,0,3,3
29566,മിക്കവാറും,0,0,3,3
4420,miyim,0,0,3,3
30103,ситуацию,0,0,3,3
47038,nós,0,0,3,3
5378,ಕೇಳುತ್ತೀರಿ.,0,0,3,3
48571,estimation,0,0,3,3
29762,registered,0,0,3,3
49724,narrow,0,0,3,3
32046,buscador,0,0,3,3
4427,στείλω,0,0,3,3
8108,கேட்கவில்லை.,0,0,3,3
31161,gerçek,0,0,3,3
33114,καλά.,0,0,3,3
7486,hé,0,0,3,3
47064,δοκιμάστε,0,0,3,3
4360,extended,0,0,3,3
48566,fout,0,0,3,3
50221,field.,0,0,3,3
50067,woher,0,0,3,3
48627,unglaublich,0,0,3,3
49126,χρήματα,0,0,3,3
47740,ಕೆಳಗೆ,0,0,3,3
9671,encompasses,0,0,3,3
7357,zaterdag,0,0,3,3
47645,floricic,0,0,3,3
32567,phénomènes,0,0,3,3
46978,стоит,0,0,3,3
5942,officiel,0,0,3,3
46979,variable,0,0,3,3
6314,संस्थापक,0,0,3,3
4600,secreta,0,0,3,3
5252,времени,0,0,3,3
5986,المثال،,0,0,3,3
4233,название,0,0,3,3
5985,lohnt,0,0,3,3
30707,chose.,0,0,3,3
52139,kwamen,0,0,3,3
5492,child,0,0,3,3
5950,καταπληκτικό,0,0,3,3
392,speciale,2,1,2,3
9518,взаимодействия,0,0,3,3
9542,प्रतिपादन,0,0,3,3
33004,d'intelligence,0,0,3,3
132,intelligente.,1,3,0,3
32453,ol,0,0,3,3
8171,miljoen,0,0,3,3
4225,l'être,0,0,3,3
48516,fortalte,0,0,3,3
48746,облажался,0,0,3,3
4607,prêt,0,0,3,3
5251,приятно,0,0,3,3
9554,lucrativos,0,0,3,3
8428,security,0,0,3,3
8950,conversación,0,0,3,3
6647,n'en,0,0,3,3
49628,ребята,0,0,3,3
8622,сделали,0,0,3,3
6270,biosphere,0,0,3,3
6272,modeling,0,0,3,3
7330,науки,0,0,3,3
52154,serves,0,0,3,3
47619,بكل,0,0,3,3
48288,utvecklas,0,0,3,3
33080,reiß,0,0,3,3
49582,ಬಳಿಗೆ,0,0,3,3
7328,जरुरत,0,0,3,3
4632,либо,0,0,3,3
52052,partido,0,0,3,3
5491,incorporado,0,0,3,3
47347,comparable,0,0,3,3
32803,sexuellt,0,0,3,3
48718,poursuit,0,0,3,3
30862,güzelliği,0,0,3,3
46962,αναμμένο,0,0,3,3
47109,வீட்டில்,0,0,3,3
31122,सम्पादन,0,0,3,3
49038,bastante,0,0,3,3
6638,l'artisan,0,0,3,3
47846,vá,0,0,3,3
8050,sista,0,0,3,3
30868,विश्वविद्यालय,0,0,3,3
9527,herramientas,0,0,3,3
48730,expertos,0,0,3,3
5266,débat,0,0,3,3
48729,спросить,0,0,3,3
33002,possessed,0,0,3,3
32682,ഡിഗ്രിയിൽ,0,0,3,3
5267,udgivet,0,0,3,3
9533,aparte,0,0,3,3
30536,مصنوع,0,0,3,3
49594,escreve,0,0,3,3
29364,primero,0,0,3,3
46752,studenter,0,0,3,3
4082,sembrava,1,3,0,3
29621,raise,0,0,3,3
33088,കുറഞ്ഞ,0,0,3,3
33458,ശൈലികൾ,0,0,3,3
30012,bede,0,0,3,3
48500,दी।,0,0,3,3
31581,கூறலாம்.,0,0,3,3
47610,शीर्ष,0,0,3,3
47594,aslında,0,0,3,3
4612,d'origine,0,0,3,3
48499,пришли,0,0,3,3
46366,uppmärksamhet,0,0,3,3
3790,scopo,1,3,0,3
5977,angel,0,0,3,3
8424,potencialmente,0,0,3,3
4083,presente,2,1,2,3
8647,أصدقاؤك,0,0,3,3
49192,vond,0,0,3,3
46973,historically,0,0,3,3
32818,ίδιο,0,0,3,3
5972,perspektiv,0,0,3,3
391,norma,2,2,1,3
33475,conversa,0,0,3,3
30216,editörlerin,0,0,3,3
8639,organisations,0,0,3,3
29625,beauté.,0,0,3,3
6648,статьях,0,0,3,3
6787,فهي,0,0,3,3
8153,títulos,0,0,3,3
5486,வாக்கியங்கள்,0,0,3,3
46350,moi.,0,0,3,3
7279,σημασία,0,0,3,3
4327,anunció,0,0,3,3
46742,activités,0,0,3,3
9561,episódios,0,0,3,3
5477,diferenças,0,0,3,3
47128,gift,0,0,3,3
7276,προσπάθεια,0,0,3,3
31988,scientifiques,0,0,3,3
49573,مصدر,0,0,3,3
8432,paniqué,0,0,3,3
32254,täcka,0,0,3,3
52096,geef,0,0,3,3
49638,criteria,0,0,3,3
307,proprietà,1,3,0,3
47628,സംസാരിക്കാൻ,0,0,3,3
47867,espécie,0,0,3,3
8608,misstag,0,0,3,3
4569,russian,0,0,3,3
9499,frygtelig,0,0,3,3
4565,सहमति,0,0,3,3
31236,üzülmemesini,0,0,3,3
4572,раньше,0,0,3,3
48213,encourage,0,0,3,3
29752,foutieve,0,0,3,3
46991,n’a,0,0,3,3
30195,πόσο,0,0,3,3
5297,давно,0,0,3,3
8970,मूर्ख,0,0,3,3
5474,razões,0,0,3,3
46349,أعلم,0,0,3,3
47866,anos,0,0,3,3
48750,അർത്ഥമാക്കുന്നത്,0,0,3,3
29293,serem,0,0,3,3
50087,செல்லுங்கள்.,0,0,3,3
47865,resolution,0,0,3,3
4664,φιλικός,0,0,3,3
30533,कड़ी,0,0,3,3
47582,ಭಾವಿಸುತ್ತೇನೆ.,0,0,3,3
9495,bonjour,0,0,3,3
6265,karar,0,0,3,3
5473,reverting,0,0,3,3
31598,narcissism,0,0,3,3
31232,മെല്ലിയും,0,0,3,3
29089,ज्ञान,0,0,3,3
46385,ثلاثة,0,0,3,3
49046,criador,0,0,3,3
47872,ಟದ,0,0,3,3
7284,somme,0,0,3,3
46354,devices.,0,0,3,3
4564,أصدقائك,0,0,3,3
5935,faites,0,0,3,3
49633,മാത്രം,0,0,3,3
30225,underlying,0,0,3,3
32998,अभ्यास,0,0,3,3
6256,العام,0,0,3,3
47361,mismos.,0,0,3,3
6774,sjov,0,0,3,3
17093,விளையாடுகிறீர்கள்,0,0,2,2
25336,contagens,0,0,2,2
17277,ಬೇರೆ,0,0,2,2
48350,représente,0,0,2,2
36066,file,0,0,2,2
17092,scoring,0,0,2,2
48294,правок.,0,0,2,2
25265,scharf,0,0,2,2
41134,centenas,0,0,2,2
17505,réside,0,0,2,2
17497,ήδη,0,0,2,2
41397,rechaza,0,0,2,2
17456,anglaise,0,0,2,2
17452,вопросов,0,0,2,2
17515,وشكك,0,0,2,2
35995,veces.,0,0,2,2
4032,conosci,1,2,0,2
48354,relevancia,0,0,2,2
41166,folk,0,0,2,2
35941,adelante,0,0,2,2
17135,catalan,0,0,2,2
41393,civilisation.,0,0,2,2
6639,بالطبع,0,0,2,2
25141,gav,0,0,2,2
17129,prevención,0,0,2,2
4037,collegamenti,1,2,0,2
41395,absoluto,0,0,2,2
4023,società,1,2,0,2
41396,ஆடம்பரமான,0,0,2,2
51654,அதிர்ஷ்டம்,0,0,2,2
41163,ചെയ്യാത്ത,0,0,2,2
36064,सर्वोत्तम,0,0,2,2
25276,സംരംഭത്തിന്റെ,0,0,2,2
25275,speaker,0,0,2,2
25353,participação,0,0,2,2
48342,ii»,0,0,2,2
41159,சிக்கலான,0,0,2,2
48270,itibarıyla,0,0,2,2
41408,pergunto,0,0,2,2
35949,страница,0,0,2,2
17477,நினைக்கவில்லை.,0,0,2,2
1025,universalmente,2,1,1,2
49983,altitude.,0,0,2,2
6545,veracidad,0,0,2,2
36073,स्थापित,0,0,2,2
41149,houve,0,0,2,2
36077,പ്രധാനമായും,0,0,2,2
17267,ന്റെ,0,0,2,2
6685,graças,0,0,2,2
17105,प्रतिष्ठा,0,0,2,2
6632,rör,0,0,2,2
41410,lágrimas.,0,0,2,2
25352,mantêm,0,0,2,2
41300,can't.,0,0,2,2
6549,بلغة,0,0,2,2
25263,motsats,0,0,2,2
32464,bedöms,0,0,2,2
41297,frequentes,0,0,2,2
35993,eens.,0,0,2,2
41138,κόσμο,0,0,2,2
17257,speed,0,0,2,2
50989,espèce,0,0,2,2
17272,أحلامه,0,0,2,2
2334,fornito,1,2,0,2
17498,kitabı,0,0,2,2
36084,harte,0,0,2,2
25272,piada,0,0,2,2
49975,importaría,0,0,2,2
35946,notícias,0,0,2,2
6634,lessen,0,0,2,2
2333,vedere.,1,2,0,2
17261,வணக்கம்,0,0,2,2
17504,graves.,0,0,2,2
17464,விஷயங்கள்,0,0,2,2
2366,composto,1,2,0,2
17258,விஷயம்,0,0,2,2
17123,époque,0,0,2,2
25142,begrepen,0,0,2,2
17122,éditée,0,0,2,2
17492,midden,0,0,2,2
30539,sorgen.,0,0,2,2
2360,possibile,1,2,0,2
25164,объявил,0,0,2,2
41303,gesteld,0,0,2,2
17275,إمكانية,0,0,2,2
41301,سألك,0,0,2,2
32467,latinas,0,0,2,2
17119,படிப்பினைகளை,0,0,2,2
17266,finesser,0,0,2,2
41404,gratis,0,0,2,2
6555,şanslı,0,0,2,2
17115,الموسوعات,0,0,2,2
25160,valor,0,0,2,2
17114,blodget,0,0,2,2
6626,ótima,0,0,2,2
30558,ಸಂದೇಶವನ್ನು,0,0,2,2
6675,increíblemente,0,0,2,2
179,cancellati,1,2,0,2
25201,découvertes,0,0,2,2
17324,توجد,0,0,2,2
41360,நிமிடங்களில்,0,0,2,2
17385,founder,0,0,2,2
51675,vestir,0,0,2,2
35969,savais,0,0,2,2
36012,καταλάβατε,0,0,2,2
17178,skarpt,0,0,2,2
35968,मतभेद,0,0,2,2
25310,geçti.,0,0,2,2
32439,സന്ദേശം,0,0,2,2
32454,സ്വാതന്ത്ര്യവും,0,0,2,2
17180,query,0,0,2,2
41219,utformning,0,0,2,2
25234,produire,0,0,2,2
41220,நினைப்பீர்களா,0,0,2,2
41215,പദങ്ങളുടെ,0,0,2,2
25200,வருந்துகிறேன்,0,0,2,2
41392,reçel,0,0,2,2
41209,climates,0,0,2,2
17400,малых,0,0,2,2
41205,teksten,0,0,2,2
41208,ಹೇಳುತ್ತೀರಿ.,0,0,2,2
41335,hallan,0,0,2,2
6662,ήσουν,0,0,2,2
41266,തീരുമാനിക്കപ്പെടുന്നു.,0,0,2,2
30526,bordet,0,0,2,2
17214,ഹലോ,0,0,2,2
6605,desacuerdos,0,0,2,2
41363,pilares,0,0,2,2
25196,matter.,0,0,2,2
41210,kararıyla,0,0,2,2
41339,ಸರಿಯಾಗಿ,0,0,2,2
6660,encyklopedi.,0,0,2,2
4026,android.,2,1,1,2
25239,graphical,0,0,2,2
50966,мнения,0,0,2,2
30531,खाते,0,0,2,2
35977,கட்டுரைகளில்,0,0,2,2
50973,wurzeln,0,0,2,2
4029,formali,1,2,0,2
25301,colère.,0,0,2,2
41246,tchèque,0,0,2,2
36028,¿estás,0,0,2,2
25214,historiador,0,0,2,2
41238,connection.,0,0,2,2
30560,maintenance,0,0,2,2
48313,contribute,0,0,2,2
17181,வந்தேன்,0,0,2,2
30528,producir,0,0,2,2
30559,σωστά,0,0,2,2
6655,beleza.,0,0,2,2
50951,يرجع,0,0,2,2
25305,ಹುಡುಗ,0,0,2,2
25303,lieverd,0,0,2,2
1015,coronation,2,1,1,2
17343,yeux,0,0,2,2
41347,flagged,0,0,2,2
17370,igår,0,0,2,2
6587,boa.,0,0,2,2
1037,conosciuta,1,2,0,2
6602,display,0,0,2,2
25231,l'encyclopédie ,0,0,2,2
30563,springer,0,0,2,2
41357,punkt,0,0,2,2
48317,sofisticado.,0,0,2,2
30530,конце,0,0,2,2
6596,mahkemesi,0,0,2,2
6659,सुझाव,0,0,2,2
17201,sturen,0,0,2,2
2309,venne,1,2,0,2
35970,skapas,0,0,2,2
36035,fransızca,0,0,2,2
48283,स्पेनिश,0,0,2,2
50970,afecta,0,0,2,2
25316,l'espèce,0,0,2,2
41334,gjorda,0,0,2,2
41203,confirmed,0,0,2,2
48333,faço,0,0,2,2
25175,yaptın,0,0,2,2
25176,object,0,0,2,2
30544,yiyeceklere,0,0,2,2
6618,moderate,0,0,2,2
25284,केंद्र,0,0,2,2
41177,«bibliotecarios»,0,0,2,2
25328,eight,0,0,2,2
41179,enough.,0,0,2,2
41381,сбит,0,0,2,2
25285,official,0,0,2,2
2346,ovviamente,1,2,0,2
50947,episch,0,0,2,2
25250,അറിവു,0,0,2,2
17297,चट्टान,0,0,2,2
2327,dominio,2,1,1,2
25327,référence.,0,0,2,2
17234,dedicated,0,0,2,2
2297,tardi,1,2,0,2
41285,biográficos,0,0,2,2
17145,army,0,0,2,2
25253,χθες,0,0,2,2
17451,méthodes.,0,0,2,2
17448,ಮಾಡಬೇಕೆಂದು,0,0,2,2
17446,seiner,0,0,2,2
17445,കഴിഞ്ഞ,0,0,2,2
25173,adopté,0,0,2,2
6673,விரும்புவதை,0,0,2,2
41173,हिन्दी,0,0,2,2
48275,регистрации,0,0,2,2
35959,verte,0,0,2,2
41386,jefferson,0,0,2,2
36058,ग्रस्त,0,0,2,2
6641,traité,0,0,2,2
35987,deja,0,0,2,2
17235,प्रावधान,0,0,2,2
41325,அனுப்புவேன்,0,0,2,2
17430,hypothetical,0,0,2,2
41366,kvaliteten,0,0,2,2
30534,φίλος,0,0,2,2
32445,आँखें,0,0,2,2
41273,gördüğü,0,0,2,2
17221,प्रतिबंधित,0,0,2,2
30569,ζητώντας,0,0,2,2
1012,nostro,1,2,0,2
2303,regalo,2,1,1,2
35964,suédois,0,0,2,2
41272,teléfono,0,0,2,2
6642,equatorial,0,0,2,2
25243,ಸಂಧಿಸುವಿಕೆಯನ್ನು,0,0,2,2
41367,maiores,0,0,2,2
48278,آي,0,0,2,2
2304,proposti,1,2,0,2
32435,metapedia,0,0,2,2
17218,mereço,0,0,2,2
30552,καλύψεις,0,0,2,2
17413,mittagessen,0,0,2,2
41331,anyway.,0,0,2,2
183,incarichi,1,2,0,2
41193,научиться,0,0,2,2
30573,dedica,0,0,2,2
48328,négative,0,0,2,2
17299,редактировать,0,0,2,2
17151,conversa.,0,0,2,2
36053,ανησυχείτε.,0,0,2,2
6669,nieuws,0,0,2,2
17156,vital,0,0,2,2
2299,bellezza.,1,2,0,2
51656,ερώτηση,0,0,2,2
6575,sollten.,0,0,2,2
2324,immagini,1,2,0,2
41375,இதன்மூலம்,0,0,2,2
41192,vocabulaire,0,0,2,2
6644,memória,0,0,2,2
6666,zoek,0,0,2,2
41180,كتابة,0,0,2,2
9711,நிறைய,0,0,2,2
17516,языкового,0,0,2,2
48517,protección,0,0,2,2
24844,أستطيع.,0,0,2,2
30706,nosotros,0,0,2,2
24843,dudas,0,0,2,2
36279,ಇತ್ತೀಚಿನ,0,0,2,2
18127,неважно,0,0,2,2
2178,inglese.,1,2,0,2
18131,சோர்வடையவில்லை,0,0,2,2
1118,pensavo,1,2,0,2
40721,œuvre,0,0,2,2
30711,cold,0,0,2,2
2175,livello,1,2,0,2
48520,crowds,0,0,2,2
2174,miglia,1,2,0,2
40716,continual,0,0,2,2
24845,couvrir,0,0,2,2
18114,perguntar.,0,0,2,2
2179,indicare,1,2,0,2
18109,poucos,0,0,2,2
40739,alain,0,0,2,2
18106,ahead,0,0,2,2
30703,ನಾಲ್ಕು,0,0,2,2
6293,ತಿಳಿದಿದೆ.,0,0,2,2
18103,durgun,0,0,2,2
6294,demander.,0,0,2,2
24849,привести,0,0,2,2
6299,വായ്പ,0,0,2,2
30699,nåede,0,0,2,2
18089,boğuldum,0,0,2,2
18088,binden,0,0,2,2
18086,सामान,0,0,2,2
4081,ministro,2,1,1,2
24831,[förtydliga],0,0,2,2
6267,religieuses,0,0,2,2
49944,ಯೋಚಿಸುವುದಿಲ್ಲ.,0,0,2,2
6254,agua,0,0,2,2
48536,nosso,0,0,2,2
18205,builds,0,0,2,2
18201,recognition‏,0,0,2,2
36305,l'interprétation,0,0,2,2
30723,അടിസ്ഥാനം.,0,0,2,2
18198,υπέροχα,0,0,2,2
51056,ideas,0,0,2,2
24799,passieren.,0,0,2,2
40678,προφορά,0,0,2,2
6250,region.,0,0,2,2
48532,ಬೆಳಗಿದೆ,0,0,2,2
18190,تريده,0,0,2,2
18189,senha,0,0,2,2
1116,previsioni,1,2,0,2
48529,பின்,0,0,2,2
6264,تأكل,0,0,2,2
36299,χρησιμοποιώντας,0,0,2,2
40687,enheder,0,0,2,2
40692,पक्ष,0,0,2,2
24812,kam,0,0,2,2
6260,como.,0,0,2,2
2163,modifiche.,1,2,0,2
24815,repositorio,0,0,2,2
24816,increíble.,0,0,2,2
24817,unser,0,0,2,2
24821,sourire,0,0,2,2
24822,federated,0,0,2,2
36291,decirme,0,0,2,2
52142,கட்டுரைகளும்,0,0,2,2
48525,शिक्षाविद,0,0,2,2
24855,അതേ,0,0,2,2
6304,d'entre,0,0,2,2
51623,undersökningar,0,0,2,2
2197,manifesta,1,2,0,2
24875,remplacement,0,0,2,2
48485,pregunta.,0,0,2,2
4370,här.,0,0,2,2
1102,computing.,1,2,0,2
24878,അതുകൊണ്ടുതന്നെ,0,0,2,2
40783,ചതുപ്പുനിലമാണ്,0,0,2,2
24881,ആഗ്രഹിക്കുന്നു,0,0,2,2
24882,publicações,0,0,2,2
36254,trolls,0,0,2,2
40792,المنزل.,0,0,2,2
6334,awarded,0,0,2,2
2190,dell'università,1,2,0,2
49950,പക്ഷെ,0,0,2,2
18008,pouvais,0,0,2,2
48481,d'aller,0,0,2,2
24874,अपाचे,0,0,2,2
2199,curriculum,2,1,1,2
18004,estaban,0,0,2,2
17999,زيارة,0,0,2,2
51035,रखाव,0,0,2,2
36245,falun,0,0,2,2
17988,alias,0,0,2,2
6345,опубликованы,0,0,2,2
6348,നിങ്ങൾക്കറിയില്ല.,0,0,2,2
48475,försöker,0,0,2,2
2207,occorrenze,1,2,0,2
17978,diversity,0,0,2,2
6350,writes,0,0,2,2
24903,स्वयं,0,0,2,2
17973,casamento,0,0,2,2
18034,biliyordum,0,0,2,2
48488,ഉച്ചാരണം,0,0,2,2
40751,பார்த்த,0,0,2,2
18059,release,0,0,2,2
6305,incorpora,0,0,2,2
48502,obtive,0,0,2,2
30697,supervisé.,0,0,2,2
18077,dedim,0,0,2,2
18075,envolve,0,0,2,2
24860,mogelijkheden,0,0,2,2
24861,какой,0,0,2,2
30696,write,0,0,2,2
40760,отсутствие,0,0,2,2
18066,italie,0,0,2,2
52138,participación,0,0,2,2
6313,موضوع,0,0,2,2
18061,wünschen,0,0,2,2
6317,d’aa,0,0,2,2
18058,significados,0,0,2,2
1103,passo,2,1,1,2
6318,heißt,0,0,2,2
6319,redor,0,0,2,2
18055,இணையத்தளத்தில்,0,0,2,2
40767,அப்படி,0,0,2,2
30692,marked,0,0,2,2
1104,cervello,1,2,0,2
24870,quejarme,0,0,2,2
18047,частности,0,0,2,2
51041,അറിയിക്കുക.,0,0,2,2
6323,distinguish,0,0,2,2
6324,serio.,0,0,2,2
18041,ಹೇಳುತ್ತೀರಿ,0,0,2,2
18040,редко,0,0,2,2
18039,härligt,0,0,2,2
24794,критикуют,0,0,2,2
40668,проекта.,0,0,2,2
36234,mache,0,0,2,2
18373,uppfyllelse,0,0,2,2
40576,видеть,0,0,2,2
24718,prédominance,0,0,2,2
6189,agriculture,0,0,2,2
18369,l'expérience,0,0,2,2
18370,inserted,0,0,2,2
48570,ಪಡೆಯಲು,0,0,2,2
40570,использоваться,0,0,2,2
18216,சொற்றொடர்களை,0,0,2,2
30755,seconde,0,0,2,2
40568,بكثير,0,0,2,2
40566,requiere,0,0,2,2
24712,telefoon,0,0,2,2
48576,egoistisk,0,0,2,2
24711,etmektedir.,0,0,2,2
48567,  images,0,0,2,2
51608,constraint,0,0,2,2
36362,th,0,0,2,2
51609,ಕೈ,0,0,2,2
24724,abaixo,0,0,2,2
6197,leis,0,0,2,2
40586,vy,0,0,2,2
36360,assumptions,0,0,2,2
51076,معرفة,0,0,2,2
40589,ಸ್ಪೀಕರ್,0,0,2,2
2119,dico,1,2,0,2
40591,noviembre,0,0,2,2
40592,detinha,0,0,2,2
40594,matin,0,0,2,2
36355,кому-нибудь,0,0,2,2
18337,включая,0,0,2,2
36354,myspace,0,0,2,2
2115,differenza,1,2,0,2
2114,discussioni,1,2,0,2
40561,j.,0,0,2,2
6166,പിൻബലത്തോടെ,0,0,2,2
18453,coisa.,0,0,2,2
1138,l'intera,1,2,0,2
30765,относить,0,0,2,2
18445,സൗകര്യവും,0,0,2,2
49929,ಹೇಳುತ್ತಿರುವುದನ್ನು,0,0,2,2
40519,rolig,0,0,2,2
18441,ब्रेड,0,0,2,2
6159,kolay,0,0,2,2
51604,ferais,0,0,2,2
2107,produrre,1,2,0,2
18433,प्रकरणों,0,0,2,2
4111,probabilità.,1,2,0,2
18430,സ്കൂളിൽ,0,0,2,2
149,visto.,2,1,1,2
40530,diskussionssidor.,0,0,2,2
48578,группа,0,0,2,2
40533,fließend,0,0,2,2
2109,maggiori,1,2,0,2
36386,الأيمن,0,0,2,2
6171,λοιπόν,0,0,2,2
40542,oorsprong,0,0,2,2
40543,fejl,0,0,2,2
32297,سهل,0,0,2,2
6174,विपरीत,0,0,2,2
36382,riken,0,0,2,2
18400,conocido,0,0,2,2
40554,citoyens,0,0,2,2
40555,idee.,0,0,2,2
18394,മൂന്നാം,0,0,2,2
40559,издание.,0,0,2,2
24732,métaphysique,0,0,2,2
18334,drygt,0,0,2,2
18333,finds,0,0,2,2
18243,origen,0,0,2,2
32317,servent,0,0,2,2
4101,leo,2,1,1,2
18266,بداية,0,0,2,2
18263,sandheder,0,0,2,2
30732,databases.,0,0,2,2
24763,étymologiquement,0,0,2,2
18257,लगते,0,0,2,2
51614,बल,0,0,2,2
18252,تقدم,0,0,2,2
18250,होगी।,0,0,2,2
18249,статьи.,0,0,2,2
36324,velopdragen,0,0,2,2
51064,είχαν,0,0,2,2
40646,доступными,0,0,2,2
36320,siehst,0,0,2,2
18270,violación,0,0,2,2
18238,focal,0,0,2,2
40651,وصف,0,0,2,2
18236,encontrou,0,0,2,2
18234,kommentar.,0,0,2,2
40653,другом.,0,0,2,2
6236,любое,0,0,2,2
24780,الإسبانية,0,0,2,2
40657,റൊട്ടിയും,0,0,2,2
24783,fingrar,0,0,2,2
6239,cognitives,0,0,2,2
51615,vars,0,0,2,2
32321,нередко,0,0,2,2
30727,права,0,0,2,2
24789,répandue,0,0,2,2
18269,കാഴ്ചപ്പാട്,0,0,2,2
49937,दिसम्बर,0,0,2,2
24733,தெரியுமா,0,0,2,2
49935,printed,0,0,2,2
24734,actos,0,0,2,2
18330,sociétés,0,0,2,2
40601,ξέρω.,0,0,2,2
6202,scientifique.,0,0,2,2
6204,vamos.,0,0,2,2
6205,кредит,0,0,2,2
1130,sostentamento,1,2,0,2
18318,perry,0,0,2,2
18317,organisé,0,0,2,2
24742,സ്കോർ‌,0,0,2,2
6206,βόλτα,0,0,2,2
152,lettore,1,2,0,2
1128,valutare,1,2,0,2
18307,документальный,0,0,2,2
2130,machinery,2,1,1,2
18278,fundamental,0,0,2,2
40620,estuviera,0,0,2,2
18301,wikcionário,0,0,2,2
18300,ಬೇಕಾದುದನ್ನು,0,0,2,2
6210,« principal »,0,0,2,2
6211,gases,0,0,2,2
18296,शुक्र,0,0,2,2
32308,മുൻകൂട്ടി,0,0,2,2
48559,läggas,0,0,2,2
18291,χρησιμοποιείτε,0,0,2,2
32310,davantage,0,0,2,2
18287,[noot,0,0,2,2
1122,occupa,2,1,1,2
36335,vermijden.,0,0,2,2
18282,annually.,0,0,2,2
17966,måder,0,0,2,2
24911,വീട്ടിൽ,0,0,2,2
48355,ενώ,0,0,2,2
32398,seinem,0,0,2,2
6475,முடியாமல்,0,0,2,2
17660,செல்லலாம்.,0,0,2,2
25062,welches,0,0,2,2
2260,sviluppate,1,2,0,2
2259,utile,2,1,1,2
41026,κοινή,0,0,2,2
36140,prueba,0,0,2,2
17733,പ്രകൃതി,0,0,2,2
4050,continuò,1,2,0,2
6471,dark,0,0,2,2
25057,ಯಾವ,0,0,2,2
41019,порядке,0,0,2,2
36141,όλων,0,0,2,2
17675,stumpe,0,0,2,2
17656,libertad,0,0,2,2
17655,söyle.,0,0,2,2
2262,norme,1,2,0,2
17653,oefenen,0,0,2,2
41032,service.,0,0,2,2
51648,d'orthographe,0,0,2,2
6476,ब्रिटेनिका,0,0,2,2
41036,steht,0,0,2,2
6478,bedeutet.,0,0,2,2
48391,குளிர்ச்சியாக,0,0,2,2
17644,investigação,0,0,2,2
32400,habla,0,0,2,2
25071,behavior.,0,0,2,2
25072,κουρασμένος,0,0,2,2
41042,encyclopaedia,0,0,2,2
6481,википедии»,0,0,2,2
32401,compétences,0,0,2,2
6469,blague,0,0,2,2
17680,സഹകരണത്തോടെ,0,0,2,2
6468,mythologie,0,0,2,2
6452,الموقع,0,0,2,2
4056,contribuito,1,2,0,2
40978,thumbs,0,0,2,2
36160,ಅಡಿಯಲ್ಲಿ,0,0,2,2
4055,sai.,1,2,0,2
40981,humble,0,0,2,2
49963,تغييرات.,0,0,2,2
17722,critiques.,0,0,2,2
25027,« ont,0,0,2,2
48412,publicly,0,0,2,2
25030,valores,0,0,2,2
40987,süredir,0,0,2,2
25031,πιάσατε,0,0,2,2
40990,amanhã,0,0,2,2
36152,தவறான,0,0,2,2
25038,l'intermédiaire,0,0,2,2
51646,home.,0,0,2,2
51010,спрашиваете,0,0,2,2
168,contenenti,1,2,0,2
36149,broad,0,0,2,2
25042,conventions,0,0,2,2
32393,υποθέτω,0,0,2,2
2254,perciò,1,2,0,2
25045,vän,0,0,2,2
32394,åren,0,0,2,2
17693,appear,0,0,2,2
48401,словарный,0,0,2,2
6463,pais,0,0,2,2
36145,écologique,0,0,2,2
17686,जल्दी,0,0,2,2
25050,şanslısın,0,0,2,2
25075,أحضر,0,0,2,2
41048,. مليون,0,0,2,2
17631,نظرًا,0,0,2,2
2279,mesi,1,2,0,2
25105,nachrichten,0,0,2,2
48374,sensibilité,0,0,2,2
25108,expressed,0,0,2,2
41091,devriez,0,0,2,2
30600,ದಿನಾಂಕವನ್ನು,0,0,2,2
36105,natifs,0,0,2,2
25114,accepteer,0,0,2,2
30599,større,0,0,2,2
41098,يحررها,0,0,2,2
6513,poderem,0,0,2,2
17558,ausmachen,0,0,2,2
6514,ಮೆಲಿಸ್ಸಾ,0,0,2,2
25117,ووجدوا,0,0,2,2
6515,लैरी,0,0,2,2
36103,large-scale,0,0,2,2
51651,motor,0,0,2,2
49971,ವೀಡಿಯೊದ,0,0,2,2
32414,ordinary,0,0,2,2
36101,ಸುಲಭವಾದ,0,0,2,2
6528,sets,0,0,2,2
25125,faut,0,0,2,2
25126,licenses,0,0,2,2
4039,singole,1,2,0,2
48358,waray,0,0,2,2
41120,extremes,0,0,2,2
6534,عبارات,0,0,2,2
2283,unici,1,2,0,2
36092,udgave,0,0,2,2
48356,απασχολημένος,0,0,2,2
17522,боже,0,0,2,2
30604,noção,0,0,2,2
36113,l'équipe,0,0,2,2
25077,erzogen,0,0,2,2
17610,credit,0,0,2,2
17629,rigdom,0,0,2,2
32402,capaz,0,0,2,2
17627,يكتب,0,0,2,2
17625,criaram,0,0,2,2
48386,проекте,0,0,2,2
25079,böylece,0,0,2,2
6487,kollektivt,0,0,2,2
48385,].,0,0,2,2
36127,préoccupation,0,0,2,2
36126,klik,0,0,2,2
6489,nøjagtigt,0,0,2,2
32403,формате,0,0,2,2
17614,görs,0,0,2,2
36121,fer,0,0,2,2
25088,εσύ,0,0,2,2
41079,experientes,0,0,2,2
17605,خبزًا,0,0,2,2
17604,yapmalıyım,0,0,2,2
48382,αργότερα.,0,0,2,2
6494,базой,0,0,2,2
36117,ediyorum,0,0,2,2
41072,geldi,0,0,2,2
17594,लाईसेन्स,0,0,2,2
171,direttore,1,2,0,2
51650,buenas,0,0,2,2
25097,राजकुमार,0,0,2,2
4046,tende,2,1,1,2
17589,περιγράφουν,0,0,2,2
30607,percebe,0,0,2,2
17587,நேற்று,0,0,2,2
25022,daglig,0,0,2,2
51645,பார்த்து,0,0,2,2
40826,إليك,0,0,2,2
40868,ചെയ്തിട്ടുണ്ടെങ്കിൽ,0,0,2,2
40875,சுவையான,0,0,2,2
24942,nadruk,0,0,2,2
40872,للصفحة,0,0,2,2
17890,judges',0,0,2,2
48458,மூலமும்,0,0,2,2
40869,lösning,0,0,2,2
17898,حالك؟,0,0,2,2
25020,subsequent,0,0,2,2
24940,размещения,0,0,2,2
48459,pm.,0,0,2,2
40862, millions,0,0,2,2
30673,planalto,0,0,2,2
40859,pacientemente,0,0,2,2
17910,accepterar,0,0,2,2
30669,сообщила,0,0,2,2
49954,móvel,0,0,2,2
17881,செய்யும்,0,0,2,2
17878,tomar,0,0,2,2
17877,cümleyi,0,0,2,2
40881,αριθμό,0,0,2,2
17875,شهرة,0,0,2,2
6384,edities,0,0,2,2
6388,rostro,0,0,2,2
40884,changé,0,0,2,2
17866,almacenamiento,0,0,2,2
17865,yolunda,0,0,2,2
24953,മാസവും,0,0,2,2
30664,कहना।,0,0,2,2
17860,varmt,0,0,2,2
32367,elegir,0,0,2,2
32368,tung,0,0,2,2
40858,mijl,0,0,2,2
2222,ciascuna,1,2,0,2
51029,jaarlijkse,0,0,2,2
24919,എവിടെയായിരുന്നുവെന്ന്,0,0,2,2
17961,статистики,0,0,2,2
17960,μικρό,0,0,2,2
40827,പദമായ,0,0,2,2
2208,nuova,1,2,0,2
17957,cruzados,0,0,2,2
2209,percentuale,1,2,0,2
2210,istanze,1,2,0,2
51034,именно,0,0,2,2
1091,password,2,1,1,2
36232,changements,0,0,2,2
24916,लिंक्स,0,0,2,2
17945,plante,0,0,2,2
1089,giapponese,1,2,0,2
40836,сайта,0,0,2,2
17938,வெள்ளி,0,0,2,2
17915,الجد.,0,0,2,2
6360,അജ്ഞാത,0,0,2,2
40841,decisión,0,0,2,2
6361,inicial,0,0,2,2
6363,l'encyclopædia,0,0,2,2
24923,странах,0,0,2,2
51633,எளிதான,0,0,2,2
6365,ليست,0,0,2,2
17927,tekniskt,0,0,2,2
17924,patronen,0,0,2,2
17923,portable,0,0,2,2
48464,confiável.,0,0,2,2
40850,потрясающую,0,0,2,2
40852,simples,0,0,2,2
4069,consolidata,1,2,0,2
6395,witz,0,0,2,2
36202,funding,0,0,2,2
6402,wortels,0,0,2,2
17767,olurdu.,0,0,2,2
17790,nomes,0,0,2,2
17789,almoço,0,0,2,2
40937,limites,0,0,2,2
51020,структура,0,0,2,2
40940,passieren,0,0,2,2
40941,évidents,0,0,2,2
1075,linguaggio,1,2,0,2
24996,sade,0,0,2,2
40947,vikipedi’ye,0,0,2,2
1074,piangendo,1,2,0,2
40949,exclusivamente,0,0,2,2
30641,βράδυ,0,0,2,2
32383,долю,0,0,2,2
30638,humanity,0,0,2,2
17761,கலைக்களஞ்சியமாக,0,0,2,2
36181,andelen,0,0,2,2
17756,faveur,0,0,2,2
17755,учёных,0,0,2,2
25010,расстраивался,0,0,2,2
30513,amigo.,0,0,2,2
2241,scoperte,1,2,0,2
25011,الأول,0,0,2,2
167,verbale,2,1,1,2
40968,oficiosas,0,0,2,2
49962,पागल,0,0,2,2
48413,النقر,0,0,2,2
25015,மிகச்சிறந்த,0,0,2,2
25016,reagle,0,0,2,2
17741,correio,0,0,2,2
40974,ತೆಗೆದುಕೊಳ್ಳಬೇಡಿ,0,0,2,2
6422,similitud,0,0,2,2
2237,pubblicati,1,2,0,2
6403,पंजीकरण,0,0,2,2
36197,απόφαση,0,0,2,2
40902,quinto,0,0,2,2
6404,permanence,0,0,2,2
163,criticata,1,2,0,2
17839,enerji,0,0,2,2
36199,வருந்துகிறேன்.,0,0,2,2
17837,سؤال,0,0,2,2
2230,inutile,2,1,1,2
17835,kâr,0,0,2,2
2232,automatica,1,2,0,2
6409,fortæl,0,0,2,2
17831,sensitive,0,0,2,2
30651,bild,0,0,2,2
2234,rubini,1,2,0,2
51022,çalışmasını,0,0,2,2
17824,final.,0,0,2,2
32380,habitualmente,0,0,2,2
17823,a.,0,0,2,2
40913,floras,0,0,2,2
17819,verificabilidade,0,0,2,2
36190,wer,0,0,2,2
30646,lincoln's,0,0,2,2
17811,känd,0,0,2,2
40921,situationen,0,0,2,2
17809,rift,0,0,2,2
24977,improves,0,0,2,2
40923,enciclopédica.,0,0,2,2
17805,الأعمال,0,0,2,2
32379,meses.,0,0,2,2
40925,dachte,0,0,2,2
6419,resumen,0,0,2,2
4008,messo,1,2,0,2
25502,grausame,0,0,2,2
25358,russe,0,0,2,2
42328,complexité,0,0,2,2
30241,सवेव,0,0,2,2
15694,kritikerna,0,0,2,2
32660,general.,0,0,2,2
50815,examined,0,0,2,2
47900,cama,0,0,2,2
15700,istediğin,0,0,2,2
15701,lägga,0,0,2,2
42321,comunidades,0,0,2,2
47901,കൈകാര്യം,0,0,2,2
47902,watching,0,0,2,2
35477,undvika,0,0,2,2
3937,chiedi,1,2,0,2
15715,trægt,0,0,2,2
42310,ابنتي,0,0,2,2
32656,devait,0,0,2,2
35469,presentó,0,0,2,2
42330,compétence,0,0,2,2
35414,موسوعات,0,0,2,2
42334,تحريرها,0,0,2,2
26063,medidas,0,0,2,2
15657,πιθανούς,0,0,2,2
15658,tornou-se,0,0,2,2
15659,riches,0,0,2,2
2604,perspectives,1,2,0,2
35460,demandez,0,0,2,2
51740,maart,0,0,2,2
35465,εξαιτίας,0,0,2,2
26053,hareket,0,0,2,2
15673,olumlu,0,0,2,2
30234,história.,0,0,2,2
15675,ändringar,0,0,2,2
7252,gerekirse,0,0,2,2
7251,abend,0,0,2,2
30235,thuis,0,0,2,2
42309,மூன்று,0,0,2,2
15720,d'avance,0,0,2,2
15722,émissions,0,0,2,2
15723,الأصل،,0,0,2,2
42288,poli,0,0,2,2
50821,शब्दकोश,0,0,2,2
42285,pegou,0,0,2,2
7220,short,0,0,2,2
7219,गणित,0,0,2,2
35491,yahoo,0,0,2,2
47914,സാധാരണയായി,0,0,2,2
42273,تعمل,0,0,2,2
47918,αύριο,0,0,2,2
15776,мультимедийных,0,0,2,2
15777,transform,0,0,2,2
32648,νόμιζα,0,0,2,2
2584,lumaca,1,2,0,2
35498,encyclopedia's,0,0,2,2
50824,proposent,0,0,2,2
15751,géographiques,0,0,2,2
30250,connais,0,0,2,2
26022,part.,0,0,2,2
15732,banklening,0,0,2,2
15724,degrés,0,0,2,2
2594,pollice,1,2,0,2
42305,statuts,0,0,2,2
26033,usuários.,0,0,2,2
26032,área,0,0,2,2
7226,രാഷ്ട്രീയ,0,0,2,2
50817,उल्लेख,0,0,2,2
26023,बाप।,0,0,2,2
15736,ήθελε,0,0,2,2
15737,когда-либо,0,0,2,2
42300,partielle,0,0,2,2
7224,caractères,0,0,2,2
26026,deinen,0,0,2,2
50819,pillars,0,0,2,2
26065,diez,0,0,2,2
42351,lake.,0,0,2,2
32670,наукам,0,0,2,2
7290,لإزعاجك,0,0,2,2
15564,físico,0,0,2,2
15566,स्कोर,0,0,2,2
32678,май,0,0,2,2
3933,associazioni,1,2,0,2
32677,fungerar,0,0,2,2
30219,considerado,0,0,2,2
42405,αγόρι,0,0,2,2
47860,रे,0,0,2,2
15575,maneira.,0,0,2,2
15576,المتخصصين,0,0,2,2
15577,sorunlu,0,0,2,2
15579,animé,0,0,2,2
32676,assis,0,0,2,2
26099,स्त्रोत,0,0,2,2
227,radici,1,2,0,2
15562,волнуйтесь,0,0,2,2
32679,просят,0,0,2,2
50799,considerar,0,0,2,2
15545,धीमे,0,0,2,2
35417,μπορώ.,0,0,2,2
42429,act.,0,0,2,2
42424,summer,0,0,2,2
3930,retrieval.,2,1,1,2
35421,proposal,0,0,2,2
42421,मेली,0,0,2,2
26112,structurale,0,0,2,2
7301,significativamente,0,0,2,2
30213,सिर्फ,0,0,2,2
35423,naquela,0,0,2,2
2628,assicurati,1,2,0,2
35427,samareño,0,0,2,2
2626,visualeditor.,2,1,1,2
15556,ಬಂದಿದ್ದೀರಿ,0,0,2,2
42397,വലിയൊരു,0,0,2,2
7289,visualeditor,0,0,2,2
7263,जाना।,0,0,2,2
26095,ساهم,0,0,2,2
35445,misión,0,0,2,2
42372,ಕೋನವು,0,0,2,2
42371,lært,0,0,2,2
7274,sinceramente,0,0,2,2
15627,libertés,0,0,2,2
47873,britânica,0,0,2,2
7272,dirigentes,0,0,2,2
15631,allons-y,0,0,2,2
26078,adaptan,0,0,2,2
47875,aparición,0,0,2,2
886,dovresti,1,2,0,2
47878,ملاحظة,0,0,2,2
35455,trække,0,0,2,2
15647,mij.,0,0,2,2
3936,grammatica,2,1,1,2
50806,.flummoxed,0,0,2,2
15621,स्टालमेन,0,0,2,2
42376,നാല്,0,0,2,2
15598,beings,0,0,2,2
26094,determinado,0,0,2,2
15591,panorama.,0,0,2,2
15592,existence,0,0,2,2
15593,προτάσεων,0,0,2,2
42393,ذي,0,0,2,2
226,esperimento,1,2,0,2
26091,εμφάνιση,0,0,2,2
47869,சொர்க்கம்,0,0,2,2
7285,respektive,0,0,2,2
15602,comentario,0,0,2,2
42383,diário,0,0,2,2
35441,الجد,0,0,2,2
42380,இல்லாமல்,0,0,2,2
15613,perception,0,0,2,2
51733,später,0,0,2,2
15790,kullanmaktadır.,0,0,2,2
42263,øve,0,0,2,2
42130,categorías,0,0,2,2
42148,family,0,0,2,2
15975,publicaties,0,0,2,2
15976,acte,0,0,2,2
7122,लिख,0,0,2,2
7121,koruma,0,0,2,2
15980,थका,0,0,2,2
50026,bancário,0,0,2,2
35572,satın,0,0,2,2
25894,موقف,0,0,2,2
42139,εικονίδιο,0,0,2,2
32615,üye,0,0,2,2
15990,correcteur,0,0,2,2
25891,about.,0,0,2,2
42135,ميزات,0,0,2,2
32614,സ്ഥലത്താണ്,0,0,2,2
15971,بنفسك,0,0,2,2
47977,quite,0,0,2,2
42151,standing,0,0,2,2
15954,ലേഖനങ്ങളെഴുതിയ,0,0,2,2
30292,metres,0,0,2,2
35559,டெரன்ஸ்,0,0,2,2
7140,förstod,0,0,2,2
25917,تأثير,0,0,2,2
7136,parks,0,0,2,2
25915,милая,0,0,2,2
7131,situations,0,0,2,2
35567,കൈ,0,0,2,2
25910,morning,0,0,2,2
35564,fiz,0,0,2,2
42155,pourrais-tu,0,0,2,2
15962,απόγευμα,0,0,2,2
15964,huset,0,0,2,2
35566,فظيعًا,0,0,2,2
16000,لأنه,0,0,2,2
42129,வகையானது,0,0,2,2
30291,قل,0,0,2,2
35579,السماح,0,0,2,2
35597,bans,0,0,2,2
2533,settore,1,2,0,2
16045,vi',0,0,2,2
7095,xxi,0,0,2,2
918,tendono,1,2,0,2
42097,inferencias,0,0,2,2
25860,ஏனெனில்,0,0,2,2
16052,ξεχάσετε,0,0,2,2
16054,tendem,0,0,2,2
25856,gemakkelijke,0,0,2,2
919,letteralmente,1,2,0,2
25851,besværlig,0,0,2,2
16065,കമ്പ്യൂട്ടർ,0,0,2,2
16066,രഹസ്യ,0,0,2,2
25850,planets,0,0,2,2
47992,fantastisk.,0,0,2,2
30311,عربة,0,0,2,2
16036,gamla,0,0,2,2
7108,maintained,0,0,2,2
16005,ഇതിനു,0,0,2,2
50855,dominant,0,0,2,2
914,richiede,1,2,0,2
16010,scientifique,0,0,2,2
32612,editorial.,0,0,2,2
2542,contengono,1,2,0,2
25879,طوال,0,0,2,2
42111,proposed,0,0,2,2
16018,voorbaat,0,0,2,2
25878,devenant,0,0,2,2
7106,अर्न्तगत,0,0,2,2
7105,reliability,0,0,2,2
7104,ചേർത്ത്,0,0,2,2
35588,سيرة,0,0,2,2
7143,கொடூரமானது,0,0,2,2
15935,какое-то,0,0,2,2
15792,экспертных,0,0,2,2
35533,conscience,0,0,2,2
47942,menée,0,0,2,2
15843,utseende,0,0,2,2
25970,produto,0,0,2,2
42226,tive,0,0,2,2
50831,internets,0,0,2,2
42225,l'écologie,0,0,2,2
25969,encuentre,0,0,2,2
903,tecnologia,2,1,1,2
3943,milione,1,2,0,2
15854,வாழ்த்துக்கள்,0,0,2,2
3944,esso,1,2,0,2
42220,ിത്തമാണ്,0,0,2,2
42216,conclusiones,0,0,2,2
15863,remain,0,0,2,2
50833,days,0,0,2,2
15841,ثلث,0,0,2,2
35523,الرجال,0,0,2,2
15838,padrão,0,0,2,2
7195,üzere,0,0,2,2
47924,இதனை,0,0,2,2
32645,or.,0,0,2,2
15798,aren't,0,0,2,2
15799,viernes,0,0,2,2
7198,year.,0,0,2,2
50827,സ്ഥലത്ത്,0,0,2,2
30264,മനോഹരമായി,0,0,2,2
15834,californië.,0,0,2,2
35510,promovido,0,0,2,2
15812,الجدد,0,0,2,2
15816,സബ്‌സ്‌ക്രൈബ്,0,0,2,2
42244,employs,0,0,2,2
25986,γεύμα,0,0,2,2
47935,character,0,0,2,2
15867,devagar,0,0,2,2
42209,अध्यक्ष,0,0,2,2
15931,qualidade.,0,0,2,2
32636,bientôt,0,0,2,2
35545,ഉണ്ട്.,0,0,2,2
216,organizzate,1,2,0,2
42186,വിക്കിപീഡിയയെ,0,0,2,2
50031,leisure,0,0,2,2
15913,extrameile,0,0,2,2
15914,τεράστιο,0,0,2,2
42182,logistic,0,0,2,2
35550,verici,0,0,2,2
15918,conclusions,0,0,2,2
15920,editam,0,0,2,2
25931,alma,0,0,2,2
42176,डोमस्डे,0,0,2,2
7149,bases,0,0,2,2
30287,ಅದ್ಭುತವಾಗಿದೆ.,0,0,2,2
32627,vorm,0,0,2,2
15904,வந்தது.,0,0,2,2
15903,essential,0,0,2,2
32634,இதற்காக,0,0,2,2
50835,scorpions,0,0,2,2
25954,беспокойство,0,0,2,2
907,l'analisi,1,2,0,2
25952,κάνοντας,0,0,2,2
15880,stuk,0,0,2,2
32635,doce,0,0,2,2
47951,madrid,0,0,2,2
7165,incroyablement,0,0,2,2
25945,naturalisme,0,0,2,2
908,minimizzare,1,2,0,2
2567,all'apprendimento,1,2,0,2
15888,higher-dimensional,0,0,2,2
42199,activity,0,0,2,2
15890,مضاء,0,0,2,2
47952,culto,0,0,2,2
26121,sustenta,0,0,2,2
47847,ligger,0,0,2,2
2367,tecnica,1,2,0,2
42658,realizar,0,0,2,2
26290,فكرة,0,0,2,2
30114,متأكدا,0,0,2,2
15185,прошла,0,0,2,2
42651,beleefd,0,0,2,2
50766,സാങറും,0,0,2,2
15188,सेना,0,0,2,2
15189,предоставляет,0,0,2,2
35308,mesma,0,0,2,2
30118,concerne,0,0,2,2
35312,कला,0,0,2,2
42642,ನುಡಿಗಟ್ಟುಗಳನ್ನು,0,0,2,2
2667,impiegato,1,2,0,2
15205,mailing,0,0,2,2
32741,അമ്മയും,0,0,2,2
15208,கேட்கும்போது,0,0,2,2
7468,ऊपर,0,0,2,2
26292,२००६,0,0,2,2
15525,confiabilidade,0,0,2,2
42661,esses,0,0,2,2
26308,حالات,0,0,2,2
47737,sexta-feira,0,0,2,2
26302,लेता,0,0,2,2
42672,consultée,0,0,2,2
7479,الحال,0,0,2,2
15157,bewerkt,0,0,2,2
26298,croissance,0,0,2,2
30107,ലാരി,0,0,2,2
15162,amerikanska,0,0,2,2
32749,halsiz,0,0,2,2
15164,balkon,0,0,2,2
35297,साथ।,0,0,2,2
7470,നടത്തുന്നു.,0,0,2,2
32748,encanta,0,0,2,2
26294,സ്ഥലം,0,0,2,2
15209,motion,0,0,2,2
15210,narzissenmutter,0,0,2,2
15211,bias.,0,0,2,2
42637,डीलीट,0,0,2,2
42613,parada,0,0,2,2
32735,neurosciences,0,0,2,2
30132,equilibradas,0,0,2,2
32734,problemas.,0,0,2,2
7437,ಬುದ್ದಿವಂತನಲ್ಲ,0,0,2,2
15253,поводу,0,0,2,2
47768,ressaisis-toi,0,0,2,2
7432,думал,0,0,2,2
15258,dining,0,0,2,2
42602,публикует,0,0,2,2
15260,меньше,0,0,2,2
35329,nela,0,0,2,2
35332,ഇല്ല.,0,0,2,2
854,cena,2,1,1,2
35333,beschäftigt,0,0,2,2
15244,app,0,0,2,2
15243,contrato,0,0,2,2
7443,αγοράσω,0,0,2,2
32739,பயங்கரமான,0,0,2,2
30123,варенье,0,0,2,2
35317,hel,0,0,2,2
15218,تاريخ,0,0,2,2
7451,cópia,0,0,2,2
35321,bebida,0,0,2,2
15224,ഇതിൽ,0,0,2,2
30127,anser,0,0,2,2
42616,खेल,0,0,2,2
42624,varied,0,0,2,2
50769,könnte,0,0,2,2
42623,especial,0,0,2,2
42622,famous,0,0,2,2
15235,स्कूल,0,0,2,2
15237,ci-dessous,0,0,2,2
35288,அங்கே,0,0,2,2
47735,diffuser,0,0,2,2
26312,comerlo,0,0,2,2
42723,ലേഖനത്തിന്റെ,0,0,2,2
15049,entier,0,0,2,2
2688,faccia,1,2,0,2
42744,образ,0,0,2,2
845,aiutarti,1,2,0,2
15061,konflikter,0,0,2,2
26348,chosen,0,0,2,2
47713,zfs.,0,0,2,2
42735,återställa,0,0,2,2
42733,besef,0,0,2,2
42732,reducing,0,0,2,2
30091,draußen,0,0,2,2
47716,удалить,0,0,2,2
30093,verilir.,0,0,2,2
50759,становятся,0,0,2,2
35267,«la,0,0,2,2
30089,ومنع,0,0,2,2
26360,artikelns,0,0,2,2
7523,fördröjs,0,0,2,2
30082,arkadaşınız,0,0,2,2
15008,handlar,0,0,2,2
32768,explique,0,0,2,2
35242,gylden,0,0,2,2
15014,помощью,0,0,2,2
42769,большая,0,0,2,2
35245,pide,0,0,2,2
15022,allows,0,0,2,2
47706,totalt,0,0,2,2
15027,independently,0,0,2,2
15029,sustaining,0,0,2,2
35250,tenzij,0,0,2,2
3882,informativa,2,1,1,2
15033,yapmak,0,0,2,2
3884,sorprende,2,1,1,2
26342,trabajando,0,0,2,2
7510,dynasty,0,0,2,2
42684,inse,0,0,2,2
30096,repetirlo,0,0,2,2
35276,anladım,0,0,2,2
15113,huilt,0,0,2,2
32754,लिये,0,0,2,2
42700,publications.,0,0,2,2
15118,κλαίνε,0,0,2,2
26326,ορισμένους,0,0,2,2
47732,l'application,0,0,2,2
2678,giugno,1,2,0,2
15125,benzeri,0,0,2,2
7489,августа,0,0,2,2
47734,друзей,0,0,2,2
26319,еды,0,0,2,2
35285,vectores,0,0,2,2
35286,smile,0,0,2,2
26313,அதனை,0,0,2,2
35275,αργό,0,0,2,2
7495,surpresa,0,0,2,2
2680,tue,2,1,1,2
7501,tour,0,0,2,2
42720,bestaan,0,0,2,2
15084,nenhuma,0,0,2,2
42718,pourraient,0,0,2,2
15088,saindo,0,0,2,2
15090,глупый,0,0,2,2
2682,personalmente,2,1,1,2
15097,kimmel,0,0,2,2
50069,flows,0,0,2,2
42711,مختلفة,0,0,2,2
47725,harassment,0,0,2,2
47726,случая,0,0,2,2
15101,കഴിഞ്ഞാൽ,0,0,2,2
30098,σένα,0,0,2,2
15105,experimentos,0,0,2,2
856,ricchezze,1,2,0,2
7428,φύσις,0,0,2,2
30139,paramos,0,0,2,2
42465,grusom,0,0,2,2
7337,நிலத்தின்,0,0,2,2
15447,रखती,0,0,2,2
26163,ഇൻപുട്ട്,0,0,2,2
42481,സഹായി,0,0,2,2
26159,appris,0,0,2,2
15454,llevamos,0,0,2,2
42475,verdi.,0,0,2,2
26156,positivt,0,0,2,2
42473,عدم,0,0,2,2
35394,naissance,0,0,2,2
32693,huis.,0,0,2,2
15465,conteúdos.,0,0,2,2
15467,sender,0,0,2,2
47834,följa,0,0,2,2
47835,hänger,0,0,2,2
2638,caro,1,2,0,2
7338,школе,0,0,2,2
26170,قوله,0,0,2,2
42506,distribuído,0,0,2,2
15411,இருந்ததால்,0,0,2,2
7348,atrozes,0,0,2,2
15413,வேண்டிய,0,0,2,2
15416,promotion,0,0,2,2
15417,बेलारूसी,0,0,2,2
15418,cœur.,0,0,2,2
30193,எல்லாவற்றையும்,0,0,2,2
874,proposito,1,2,0,2
35372,नॉर्वेजियाई,0,0,2,2
35374,star,0,0,2,2
873,contiene,1,2,0,2
15429,جدا,0,0,2,2
7340,escola,0,0,2,2
42493,eventos,0,0,2,2
15473,estimer,0,0,2,2
42464,material.,0,0,2,2
15401,പോകുന്നത്,0,0,2,2
35398,pourrais,0,0,2,2
26139,undo,0,0,2,2
7318,те,0,0,2,2
7317,private,0,0,2,2
51746,أجريت,0,0,2,2
881,frequenti,1,2,0,2
15508,настоящее,0,0,2,2
26134,सीजेनथेलर,0,0,2,2
7316,fichiers,0,0,2,2
7315,etnologiämnet,0,0,2,2
15514,parís,0,0,2,2
42439,متفرغ,0,0,2,2
15520,homme,0,0,2,2
26127,कुंद,0,0,2,2
15523,abordagem,0,0,2,2
7310,schémas,0,0,2,2
15501,ويكيميديا،,0,0,2,2
32688,சோதனையில்,0,0,2,2
26141,situation.,0,0,2,2
51747,συνεχίσουν,0,0,2,2
7326,உடையில்,0,0,2,2
42462,revealed,0,0,2,2
35399,выглядеть,0,0,2,2
15481,उम्मीदवार,0,0,2,2
15483,oké,0,0,2,2
47838,multimídia,0,0,2,2
47839,esas,0,0,2,2
42452,जीवनी,0,0,2,2
42456,ροκ,0,0,2,2
15489,τεστ,0,0,2,2
15491,i̇letişim,0,0,2,2
15492,langsamer,0,0,2,2
7322,ശല്യപ്പെടുത്തുന്ന,0,0,2,2
15494,avisos,0,0,2,2
15410,parecer,0,0,2,2
15399,πραγματικότητα.,0,0,2,2
32727,കൂടിക്കാഴ്‌ച,0,0,2,2
15338,'wikipedia,0,0,2,2
26235,കാര്യങ്ങൾക്കോ,0,0,2,2
30154,ilustrativo,0,0,2,2
42569,encarga,0,0,2,2
42567,chanserna,0,0,2,2
15315,хотел,0,0,2,2
15319,celular,0,0,2,2
30158,देखना,0,0,2,2
7397,κάποια,0,0,2,2
26229,sagst.,0,0,2,2
7396,entonces,0,0,2,2
30160,основные,0,0,2,2
15328,manhã,0,0,2,2
32715,suena,0,0,2,2
32714,ख्याल,0,0,2,2
42555,सिद्धांत,0,0,2,2
51754,succès.,0,0,2,2
15307,richesses,0,0,2,2
15306,geografia,0,0,2,2
15290,extérieur,0,0,2,2
35340,manipulate,0,0,2,2
2660,confronto,1,2,0,2
15285,indicar,0,0,2,2
7416,google's,0,0,2,2
15288,பயன்படுத்தி,0,0,2,2
860,domande,1,2,0,2
32723,فيها.,0,0,2,2
15304,l’étude,0,0,2,2
15296,constitue,0,0,2,2
15297,krijg,0,0,2,2
47784,ipod,0,0,2,2
15300,أخذت,0,0,2,2
3912,servono,1,2,0,2
15303,puisse,0,0,2,2
42551,préféré,0,0,2,2
15339,namen,0,0,2,2
26194,here's,0,0,2,2
42549,здорово,0,0,2,2
26212,plantar,0,0,2,2
26210,segundo.,0,0,2,2
7366,clarke,0,0,2,2
35355,поводу.,0,0,2,2
42528,forfærdelige,0,0,2,2
233,ipotesi,1,2,0,2
47813,നല്ലതാണ്.,0,0,2,2
30180,ನಮಗೆ,0,0,2,2
15384,fundamentales,0,0,2,2
3920,rappresentazione,1,2,0,2
15391,скоро,0,0,2,2
26197,traces,0,0,2,2
7354,praktik,0,0,2,2
50785,llamados,0,0,2,2
2643,enhanced,1,2,0,2
30174,verdien,0,0,2,2
26213,золотая,0,0,2,2
15363,இருப்பேன்,0,0,2,2
7377,excepcionalmente,0,0,2,2
15342,пишут,0,0,2,2
15343,junge,0,0,2,2
235,sviluppa,1,2,0,2
47802,clasificadores,0,0,2,2
7379,gitmeye,0,0,2,2
50776,afirmaba,0,0,2,2
32709,λέω,0,0,2,2
35352,opdrachten,0,0,2,2
30171,öppenhet,0,0,2,2
15355,zetten.,0,0,2,2
15356,dis,0,0,2,2
15357,पुराने,0,0,2,2
32708,صغيرة,0,0,2,2
15359,ആരോ,0,0,2,2
30315,proportion,0,0,2,2
16069,söyleyebilirsiniz,0,0,2,2
35606,बढ़ें।,0,0,2,2
50006,викимедиа»,0,0,2,2
41641,wollen,0,0,2,2
2416,andarono,1,2,0,2
48179,மெல்லியாக,0,0,2,2
41638,الإعجاب,0,0,2,2
41636,s'ils,0,0,2,2
2414,attenzione,1,2,0,2
41634,laissé,0,0,2,2
35838,typical,0,0,2,2
41629,интернете.,0,0,2,2
48180,hyperlinks,0,0,2,2
48181,इनमें,0,0,2,2
35844,насколько,0,0,2,2
16768,क्लिक,0,0,2,2
41622,visitar,0,0,2,2
24670,month.,0,0,2,2
41642,ولاري,0,0,2,2
48178,privatisation,0,0,2,2
16072,மாற,0,0,2,2
16740,θυμωμένος,0,0,2,2
30441,संदेश,0,0,2,2
48167,शेष,0,0,2,2
30442,क्रूर,0,0,2,2
16717,अर्थशास्त्र,0,0,2,2
35825,crimson,0,0,2,2
25531,recommended,0,0,2,2
41653,मूल्यांकन,0,0,2,2
50008,നിന്നാണ്,0,0,2,2
16729,längre,0,0,2,2
52124,വിവാഹത്തിൽ,0,0,2,2
2419,sogni,1,2,0,2
25522,ചെയ്യുക,0,0,2,2
982,dì,1,2,0,2
25518,bloqueo,0,0,2,2
32518,fanns,0,0,2,2
41616,ആൺകുട്ടി,0,0,2,2
32515,credited,0,0,2,2
51691,ertesi,0,0,2,2
35850,സംഭാഷണത്തിൽ,0,0,2,2
51689,εξηγεί,0,0,2,2
6797,arrasa,0,0,2,2
3994,analisi,1,2,0,2
16827,موقفًا,0,0,2,2
6794,छवि,0,0,2,2
30465,ønske,0,0,2,2
30466,ಕನಸುಗಳ,0,0,2,2
25468,caractère,0,0,2,2
16832,publicou,0,0,2,2
41582,weekly,0,0,2,2
41580,gärna,0,0,2,2
41578,ಪುನರಾವರ್ತಿಸಲು,0,0,2,2
30468,anda,0,0,2,2
16840,എന്നാണ്,0,0,2,2
6789,குறித்து,0,0,2,2
16822,tusentals,0,0,2,2
25472,θέλει,0,0,2,2
35864,dumm,0,0,2,2
41599,costs,0,0,2,2
35852,معه.,0,0,2,2
6811,portion,0,0,2,2
41607,αόριστος,0,0,2,2
41605,интересные,0,0,2,2
41604,पीढ़ी,0,0,2,2
25485,pronunciando,0,0,2,2
16802,गतिविधियों,0,0,2,2
16812,eua,0,0,2,2
35859,agradeciendo,0,0,2,2
16804,below,0,0,2,2
41596,nariz,0,0,2,2
25481,मजाक,0,0,2,2
16807,representar,0,0,2,2
16809,രണ്ടു,0,0,2,2
25540,clearly,0,0,2,2
41669,बच्चों,0,0,2,2
25541,soutien,0,0,2,2
970,esse.,2,1,1,2
30417,ανανέωση,0,0,2,2
35788,ಅದಕ್ಕೆ,0,0,2,2
48141,ആവശ്യമായ,0,0,2,2
30419,जुड़ा,0,0,2,2
35791,aggregated,0,0,2,2
6876,التقاء,0,0,2,2
16620,işi,0,0,2,2
35793,consultés,0,0,2,2
25579,пример,0,0,2,2
50900,சோர்வாக,0,0,2,2
30420,தெரியாது.,0,0,2,2
32533,locales,0,0,2,2
50013,planes,0,0,2,2
25576,bijvoorbeeld.,0,0,2,2
6871,ചർച്ച,0,0,2,2
41735,средства,0,0,2,2
2450,comprensiva,2,1,1,2
41737,kalde,0,0,2,2
16593,leçons,0,0,2,2
25598,soldados,0,0,2,2
48132,solução,0,0,2,2
41754,aient,0,0,2,2
6889,vemos,0,0,2,2
16588,worried,0,0,2,2
41751,macs,0,0,2,2
41748,σχεδίου,0,0,2,2
41738,يشجع,0,0,2,2
41747,wikification,0,0,2,2
16596,wysiwyg,0,0,2,2
30414,ഏവർക്കും,0,0,2,2
25589,الموجود,0,0,2,2
6883,viktigt,0,0,2,2
25588,miles,0,0,2,2
2444,dispositivi,1,2,0,2
16634,considérablement,0,0,2,2
30438,കൊള്ളാം,0,0,2,2
6868,एडम्स,0,0,2,2
16676,minutos,0,0,2,2
41689,أراك,0,0,2,2
3982,mobili,1,2,0,2
2428,meccanismo,1,2,0,2
6847,фразы.,0,0,2,2
35817,எடுத்துக்காட்டு,0,0,2,2
16690,hadden,0,0,2,2
25548,novamente,0,0,2,2
41679,açısını,0,0,2,2
25547,പരിശോധിച്ച്,0,0,2,2
16696,beror,0,0,2,2
41675,പ്രായം,0,0,2,2
50910,भूखा,0,0,2,2
16699,sorduğunda,0,0,2,2
30437,requer,0,0,2,2
16675,الإناث,0,0,2,2
971,informazione,1,2,0,2
6852,forbindelse,0,0,2,2
193,coprirmi,1,2,0,2
16643,அனைவரும்,0,0,2,2
6867,ಕ್ರೂರ,0,0,2,2
25567,спросить.,0,0,2,2
41708,вроде,0,0,2,2
6864,precisam,0,0,2,2
25565,political,0,0,2,2
16655,yapalım.,0,0,2,2
30433,முழுவதும்,0,0,2,2
41701,aprender.,0,0,2,2
6860,फैसला,0,0,2,2
41697,ولكنها,0,0,2,2
41696,domínio,0,0,2,2
50906,pedido,0,0,2,2
3980,ascoltando,1,2,0,2
41574,comentou,0,0,2,2
16843,asombroso,0,0,2,2
16845,جميلة,0,0,2,2
2376,valutate,1,2,0,2
25391,contó,0,0,2,2
35919,lectores,0,0,2,2
17001,cuma,0,0,2,2
17004,रंग,0,0,2,2
50938,aucun,0,0,2,2
188,ascolta,1,2,0,2
17009,l'époque,0,0,2,2
17010,άγγελο,0,0,2,2
48243,anonymt,0,0,2,2
17012,exist.,0,0,2,2
30496,au-delà,0,0,2,2
17015,readily,0,0,2,2
17017,nok.,0,0,2,2
17018,progression,0,0,2,2
17020,बढ़ने,0,0,2,2
16998,نوفمبر,0,0,2,2
30493,бизнесе,0,0,2,2
35918,ruby,0,0,2,2
50935,ಮುಂದುವರಿಯಿರಿ.,0,0,2,2
41496,zichzelf,0,0,2,2
16968,أشعر,0,0,2,2
41494,العملية,0,0,2,2
41492,drøm.,0,0,2,2
35912,ಹೆಸರಿನ,0,0,2,2
2383,dell'ipotesi,1,2,0,2
48234,kommentera,0,0,2,2
6725,elegido,0,0,2,2
16980,विवाह,0,0,2,2
25400,village,0,0,2,2
6732,approches,0,0,2,2
6731,doute,0,0,2,2
25396,нейросетей,0,0,2,2
16991,проектов,0,0,2,2
2377,resa,2,1,1,2
17023,सोच,0,0,2,2
6741,myntat,0,0,2,2
35924,xbox,0,0,2,2
17058,выпущен,0,0,2,2
6702,പറയുന്നതെന്ന്,0,0,2,2
17063,क्षमता,0,0,2,2
41441,inondé,0,0,2,2
25369,höre,0,0,2,2
17069,विकि,0,0,2,2
25365,décidé,0,0,2,2
48258,أجراها,0,0,2,2
17074,usual,0,0,2,2
6695,எல்லோரும்,0,0,2,2
25361,grundare,0,0,2,2
17079,conferences,0,0,2,2
25360,setting.,0,0,2,2
25359,elements,0,0,2,2
41428,ходе,0,0,2,2
17057,primárias,0,0,2,2
30504,संभव,0,0,2,2
41446,contents,0,0,2,2
17034,moteur,0,0,2,2
17027,സമവാക്യത്തിലെ,0,0,2,2
17028,и.,0,0,2,2
41460,goldenen,0,0,2,2
17031,शब्दावली,0,0,2,2
17032,ಸಭೆಗೆ,0,0,2,2
32480,تعرفه,0,0,2,2
48249,déjeuner,0,0,2,2
17050,இன்னும்,0,0,2,2
35929,répertoire,0,0,2,2
41452,profundamente,0,0,2,2
41451,lagen,0,0,2,2
17045,ഒന്നും,0,0,2,2
6711,abarcaba,0,0,2,2
35932,merleau-ponty,0,0,2,2
2385,esistono,1,2,0,2
48226,تشمل,0,0,2,2
16848,بعيدًا,0,0,2,2
48210,கோணத்திலும்,0,0,2,2
25446,eşit,0,0,2,2
41549,stum,0,0,2,2
35884,entière,0,0,2,2
6778,classifying,0,0,2,2
50928,hoş,0,0,2,2
25442,södertörns,0,0,2,2
41544,एंड,0,0,2,2
6777,presença,0,0,2,2
6775,retrieval,0,0,2,2
16891,altered,0,0,2,2
16892,फाइलें,0,0,2,2
16895,magische,0,0,2,2
32498,എളുപ്പത്തിൽ,0,0,2,2
16899,marry,0,0,2,2
16900,hjärtat.,0,0,2,2
48208,flattening,0,0,2,2
16876,வழியில்,0,0,2,2
16875,പറയുന്നത്,0,0,2,2
2398,campana,2,1,1,2
16849,жаль,0,0,2,2
16851,மொழிப்,0,0,2,2
32502,shachaf,0,0,2,2
6785,refiriéndose,0,0,2,2
6784,hata,0,0,2,2
2399,dicembre,1,2,0,2
25459,collectie,0,0,2,2
48207,diamanter,0,0,2,2
16860,krijgt.,0,0,2,2
35876,dourada,0,0,2,2
25456,авторитетных,0,0,2,2
25455,होगा।,0,0,2,2
35881,gerekiyor,0,0,2,2
6781,exactement,0,0,2,2
16901,ваш,0,0,2,2
25432,сидела,0,0,2,2
50933,ಹೊಂದಿದೆ,0,0,2,2
25431,periodistas,0,0,2,2
51686,consacrée,0,0,2,2
995,gradi,1,2,0,2
16932,narzisse,0,0,2,2
35901,desconcertada,0,0,2,2
25414,содержимого,0,0,2,2
41513,धीमा,0,0,2,2
16942,jusqu’à,0,0,2,2
6754,remover,0,0,2,2
41508,utvecklade,0,0,2,2
25410,yeterli,0,0,2,2
41507,بأكملها,0,0,2,2
16951,ಸರಿಯಾದ,0,0,2,2
35906,fancy,0,0,2,2
16954,habertürk,0,0,2,2
6751,interdire,0,0,2,2
16928,ρωτήσετε,0,0,2,2
41524,pensais,0,0,2,2
35896,katılmıyorum.,0,0,2,2
35895,dışında,0,0,2,2
48211,horizontale,0,0,2,2
993,qualcosa.,1,2,0,2
16909,ação,0,0,2,2
16910,فبراير,0,0,2,2
16912,druk,0,0,2,2
30475,skiftede,0,0,2,2
25425,mısın,0,0,2,2
16924,enig,0,0,2,2
16917,oprette,0,0,2,2
48215,bloomberg,0,0,2,2
16919,holen,0,0,2,2
48217,skolan,0,0,2,2
3997,raggiunse,1,2,0,2
6762,உம்,0,0,2,2
16580,quantidade,0,0,2,2
35780,comunidad.,0,0,2,2
16576,лицензиями,0,0,2,2
41974,d'utilisateurs,0,0,2,2
7030,crocker.,0,0,2,2
16228,besten,0,0,2,2
16230,significado,0,0,2,2
16233,intellectuelle,0,0,2,2
16235,demandé,0,0,2,2
16237,inteligente.,0,0,2,2
7029,hoffe,0,0,2,2
16239,minutter.,0,0,2,2
16241,അതായത്,0,0,2,2
25762,medo,0,0,2,2
41979,influences,0,0,2,2
25761,எங்கிருந்து,0,0,2,2
2502,diamo,1,2,0,2
16246,привело,0,0,2,2
32585,γρήγορη,0,0,2,2
16226,nature ,0,0,2,2
16224,ഉദാഹരണത്തിൽ,0,0,2,2
16221,ele.,0,0,2,2
2505,abbastanza.,1,2,0,2
35648,maintains,0,0,2,2
25787,eftermiddagen,0,0,2,2
48028,απόψεις,0,0,2,2
931,edizione.,1,2,0,2
42004,jugées,0,0,2,2
42001,events.,0,0,2,2
7039,встречи,0,0,2,2
937,copyright.,2,1,1,2
41996,automático.,0,0,2,2
32589,തിരഞ്ഞെടുക്കുന്നു.,0,0,2,2
32588,πατήσει,0,0,2,2
41993,próprio,0,0,2,2
48034,deus,0,0,2,2
7032,ರೀತಿ,0,0,2,2
41975,demais,0,0,2,2
16252,milliards,0,0,2,2
16186,voordat,0,0,2,2
7027,care.,0,0,2,2
25743,concevoir,0,0,2,2
16284,beginning,0,0,2,2
41952,male.,0,0,2,2
48050,ಗೊತ್ತು.,0,0,2,2
48051,tel,0,0,2,2
7007,νέες,0,0,2,2
7005,veräppeln,0,0,2,2
16293,extraction,0,0,2,2
35686,række,0,0,2,2
41942,descending,0,0,2,2
16298,பெருமை,0,0,2,2
16299,earlier,0,0,2,2
25734,dezelfde,0,0,2,2
41940,чем-нибудь,0,0,2,2
16303,políticas.,0,0,2,2
16282,amorality,0,0,2,2
30352,inherently,0,0,2,2
207,proposte,1,2,0,2
48043,remained,0,0,2,2
48037,fantásticas,0,0,2,2
2500,check,2,1,1,2
25756,densité,0,0,2,2
7020,முந்தைய,0,0,2,2
41968,funcionar.,0,0,2,2
16264,попробуйте,0,0,2,2
35678,مراجعة,0,0,2,2
25745,incapazes,0,0,2,2
25749,terabytes,0,0,2,2
16273,informou,0,0,2,2
7015,формального,0,0,2,2
41959,loan,0,0,2,2
51714,enjoy,0,0,2,2
2494,farina,2,1,1,2
42013,droom.,0,0,2,2
35646,soient,0,0,2,2
41935,بأكثر,0,0,2,2
35629,pornográficos.,0,0,2,2
16103,researched,0,0,2,2
30322,grupos.,0,0,2,2
16105,сердцу.,0,0,2,2
16106,ಹೋಗುತ್ತಿದ್ದೇನೆ.,0,0,2,2
35620,evlilikte,0,0,2,2
16109,língua.,0,0,2,2
50866,ತಿಳಿದಿಲ್ಲ.,0,0,2,2
42062,grundlegende,0,0,2,2
16113,bonne.,0,0,2,2
35623,வீடியோவின்,0,0,2,2
30325,ಮನಸ್ಸಿಲ್ಲವೇ,0,0,2,2
7068,collegehumor,0,0,2,2
35625,acceptées.,0,0,2,2
25820,математической,0,0,2,2
7066,άντρας,0,0,2,2
30320,zamandır,0,0,2,2
16099,descrita,0,0,2,2
25834,البكاء,0,0,2,2
7088,épico,0,0,2,2
2529,nulla,1,2,0,2
42080,conflicts,0,0,2,2
25844,editor-chefe,0,0,2,2
16080,έπιασα,0,0,2,2
25842,needed],0,0,2,2
16082,सलाह,0,0,2,2
42074,erkänner,0,0,2,2
7081,ಇರುತ್ತೇನೆ,0,0,2,2
16087,answered,0,0,2,2
3962,dalle,1,2,0,2
16092,hoovering,0,0,2,2
3963,legge,1,2,0,2
7083,место,0,0,2,2
42069,enviaré,0,0,2,2
16127,professeur,0,0,2,2
7065,സൗന്ദര്യം,0,0,2,2
2509,complementari,1,2,0,2
16130,contradictoires,0,0,2,2
7059,பொருட்டல்ல.,0,0,2,2
16163,semanal,0,0,2,2
25799,minuten.,0,0,2,2
30330,உலகளவில்,0,0,2,2
7055,ಸೂಚಿಸಲು,0,0,2,2
42028,materiaal,0,0,2,2
7054,വിജ്ഞാനകോശം,0,0,2,2
30331,खाद्य,0,0,2,2
32595,contributors.,0,0,2,2
42023,latitude,0,0,2,2
928,dirlo,1,2,0,2
16176,കേരളത്തിനുള്ളിൽ,0,0,2,2
25793,comparten,0,0,2,2
42018,administratorer.,0,0,2,2
50872,காலமாக,0,0,2,2
927,credibilità,1,2,0,2
16156,plads,0,0,2,2
32597,eigenlijk,0,0,2,2
16142,webby.,0,0,2,2
16131,tectonic,0,0,2,2
35630,'i,0,0,2,2
16134,доступ,0,0,2,2
51720,begann,0,0,2,2
25811,ρωτάει,0,0,2,2
2519,letture,1,2,0,2
16143,dirigida,0,0,2,2
25806,എളുപ്പമുള്ള,0,0,2,2
16144,illustrer,0,0,2,2
42043,korrekt,0,0,2,2
42042,ಪರಿಸ್ಥಿತಿ,0,0,2,2
35635,renderização,0,0,2,2
30327,επί,0,0,2,2
35636,friday,0,0,2,2
2491,iniziato,1,2,0,2
41932,виды,0,0,2,2
16575,reflection,0,0,2,2
41806,tropical,0,0,2,2
25643,verscheen,0,0,2,2
25642,curso,0,0,2,2
16481,ആഗ്രഹിക്കുന്നു.,0,0,2,2
41820,பயன்படுத்தலாம்.,0,0,2,2
41819,donaciones.,0,0,2,2
16484,sofisticado,0,0,2,2
41817,må,0,0,2,2
25638,place.,0,0,2,2
32557,चाहती,0,0,2,2
6942,பேசிக்கொண்டிருக்கலாம்,0,0,2,2
16497,तुमसे,0,0,2,2
16498,öğrenmeye,0,0,2,2
35756,nature ».,0,0,2,2
32555,translated,0,0,2,2
16503,bak,0,0,2,2
25645,मराठी,0,0,2,2
6953,assurez-vous,0,0,2,2
16473,व्यवस्थित,0,0,2,2
35746,technologies,0,0,2,2
16442,voitures,0,0,2,2
25662,pesado,0,0,2,2
25661,അതുപോലെ,0,0,2,2
16448,pedi,0,0,2,2
16450,rubiner,0,0,2,2
16456,exchange,0,0,2,2
35748,இனிமேல்,0,0,2,2
25649,bristande,0,0,2,2
2470,fossi,1,2,0,2
16462,student,0,0,2,2
41831,sens ,0,0,2,2
48088,individus,0,0,2,2
41830,वेब्बी,0,0,2,2
25650,полностью,0,0,2,2
25633,considérer,0,0,2,2
6936,شعرت,0,0,2,2
35738,trabajos,0,0,2,2
6934,devrais,0,0,2,2
48116,известна,0,0,2,2
52120,ipucu,0,0,2,2
30401,brugeres,0,0,2,2
25617,لكنها,0,0,2,2
6906,universitaire,0,0,2,2
48122,διαγραφών.,0,0,2,2
35776,interested,0,0,2,2
6904,المزيد,0,0,2,2
962,iscrizione,1,2,0,2
52121,ആയിരിക്കും.,0,0,2,2
16564,बताता,0,0,2,2
25608,അക്യൂട്ട്,0,0,2,2
6900,propuesto,0,0,2,2
25606,listening,0,0,2,2
48126,ehe,0,0,2,2
41783,journaux,0,0,2,2
41785,helgen,0,0,2,2
35770,começar,0,0,2,2
16525,tilsammen,0,0,2,2
6933,programmes,0,0,2,2
16512,windows,0,0,2,2
16517,cuentas,0,0,2,2
16520,l'action,0,0,2,2
16523,gagne,0,0,2,2
41797,قليلاً,0,0,2,2
41794,tråkig,0,0,2,2
2455,rappresenta,1,2,0,2
16530,dominate,0,0,2,2
35767,النمو,0,0,2,2
6923,техас,0,0,2,2
16535,tratando,0,0,2,2
48109,derived,0,0,2,2
16537,അവനോട്,0,0,2,2
41848,allemande,0,0,2,2
41857,يستخدمها,0,0,2,2
41931,profesionales,0,0,2,2
35716,visitados,0,0,2,2
51710,encuentro,0,0,2,2
16343,says,0,0,2,2
35701,ദൈവമേ.,0,0,2,2
48060,fraude,0,0,2,2
50880,porém,0,0,2,2
32573,ಮಾಂತ್ರಿಕ,0,0,2,2
35703,constituyen,0,0,2,2
6990,domain,0,0,2,2
16355,работу.,0,0,2,2
35706,registrerade,0,0,2,2
2484,piccola,1,2,0,2
35707,പെട്ടെന്നു,0,0,2,2
35708,mesmo.,0,0,2,2
16365,ഏതെങ്കിലും,0,0,2,2
35713,ಅದೃಷ್ಟದ,0,0,2,2
35699,tarea,0,0,2,2
16336,comparaison,0,0,2,2
50879,diskussioner.,0,0,2,2
16324,contexto,0,0,2,2
16313,σπίτι.,0,0,2,2
16316,interés,0,0,2,2
16317,manutenção,0,0,2,2
16318,steps,0,0,2,2
16321,റൂട്ട്,0,0,2,2
50878,பயனர்கள்,0,0,2,2
25723,бесконечно,0,0,2,2
16334,enda,0,0,2,2
51711,लेते,0,0,2,2
41924,ley,0,0,2,2
6999,idée.,0,0,2,2
16330,विकिक्वोट,0,0,2,2
16332,контроля,0,0,2,2
25719,strict,0,0,2,2
48064,wel.,0,0,2,2
50883,cult,0,0,2,2
50888,glaciers,0,0,2,2
16374,visitado,0,0,2,2
35722,ಬೆರಳುಗಳನ್ನು,0,0,2,2
41879,quão,0,0,2,2
6978,personnel,0,0,2,2
41876,lanserades,0,0,2,2
16407,implies,0,0,2,2
35725,использования.,0,0,2,2
25684,അറിയപ്പെടുന്ന,0,0,2,2
41873,graden,0,0,2,2
41872,jour.,0,0,2,2
41869,eerst,0,0,2,2
25680,ഇനി,0,0,2,2
2476,divertente,1,2,0,2
16422,ocho,0,0,2,2
25675,blivit,0,0,2,2
48074,divisions,0,0,2,2
41882,kızgın,0,0,2,2
16397,periódicos,0,0,2,2
949,consente,1,2,0,2
16384,consensus,0,0,2,2
41894,beschweren.,0,0,2,2
2480,tony,2,1,1,2
48066,viewers,0,0,2,2
30366,conduta,0,0,2,2
6982,directed,0,0,2,2
16383,simbolizando,0,0,2,2
16385,குறிக்கிறது,0,0,2,2
48070,gérée,0,0,2,2
41889,selvom,0,0,2,2
16388,bekymringer,0,0,2,2
41887,указания,0,0,2,2
16390,rápidas,0,0,2,2
16391,ಸಣ್ಣ,0,0,2,2
25691,japonesa,0,0,2,2
51603,knappt,0,0,2,2
18819,körs,0,0,2,2
6151,vandaan,0,0,2,2
37343,autoridad,0,0,2,2
38658,battlestar,0,0,2,2
21290,recogen,0,0,2,2
1644,prevedere,1,2,0,2
21294,gnu/linux,0,0,2,2
21296,कथित,0,0,2,2
4935,porque.,0,0,2,2
1356,singola,1,2,0,2
37352,während,0,0,2,2
21302,indse,0,0,2,2
49400,boy,0,0,2,2
31421,parodied,0,0,2,2
4931,garden,0,0,2,2
4930,തോന്നുന്നതിനുള്ള,0,0,2,2
21310,الليلة؟,0,0,2,2
21311,وجد,0,0,2,2
37346,mundo​,0,0,2,2
21283,सुबह,0,0,2,2
31883,बनाए,0,0,2,2
23272,ഉറപ്പില്ല.,0,0,2,2
1354,gentili,1,2,0,2
21262,l'ange,0,0,2,2
1652,faccio,1,2,0,2
23281,kdd,0,0,2,2
38678,hudong,0,0,2,2
38677,ultimately,0,0,2,2
31418,ಒಳ್ಳೆಯದನ್ನು,0,0,2,2
23279,اكتشاف,0,0,2,2
1646,telefono,1,2,0,2
4939,ಯಾವುದನ್ನಾದರೂ,0,0,2,2
4938,completo,0,0,2,2
1645,minsky,1,2,0,2
23274,resultaat,0,0,2,2
23273,മാറ്റി,0,0,2,2
38665,sylt,0,0,2,2
23254,don,0,0,2,2
4928,nederland,0,0,2,2
38640,vælges,0,0,2,2
4927,demain,0,0,2,2
49411,انت,0,0,2,2
23232,ouvindo,0,0,2,2
38610,verbets,0,0,2,2
23231,ögonblick,0,0,2,2
21350,achieving,0,0,2,2
38608,полной,0,0,2,2
4286,sidder,0,0,2,2
49413,интернет-пользователей,0,0,2,2
4911,talen,0,0,2,2
21356,banken,0,0,2,2
38605,ήρθαν,0,0,2,2
1634,cinema,2,1,1,2
31873,என்னைப்,0,0,2,2
21360,findings,0,0,2,2
49417,organized,0,0,2,2
23235,διαφορετικά,0,0,2,2
52215,helhet,0,0,2,2
37365,ನೆನಪಿಡಿ.,0,0,2,2
37359,ستة,0,0,2,2
37357,seguida,0,0,2,2
31424,dump,0,0,2,2
38636,tillfälliga,0,0,2,2
31425,नार्किसा,0,0,2,2
38634,आहार,0,0,2,2
38633,rompecabezas,0,0,2,2
23246,soru,0,0,2,2
37364,notícia,0,0,2,2
31427,പഠനം,0,0,2,2
38628,elliot,0,0,2,2
1638,legato,1,2,0,2
1637,cartacee,1,2,0,2
23241,ну,0,0,2,2
31876,\{\mathrm,0,0,2,2
4944,அடிப்படையிலும்,0,0,2,2
21254,gaan.,0,0,2,2
4800,themselves,0,0,2,2
38750,uppfattning,0,0,2,2
38748,continue.,0,0,2,2
31393,ligne.,0,0,2,2
38745,useless,0,0,2,2
21157,påverkade,0,0,2,2
37300,essentially,0,0,2,2
31899,arbeitet,0,0,2,2
49365,சனிக்கிழமையன்று,0,0,2,2
21166,género,0,0,2,2
31898,ಗಾಡಿ,0,0,2,2
23328,pratade,0,0,2,2
1345,distribuite,1,2,0,2
4273,verrai,0,0,2,2
31896,enviados,0,0,2,2
21178,pekar,0,0,2,2
49372,utifrån,0,0,2,2
21148,الكلمة.,0,0,2,2
23338,korta,0,0,2,2
21253,« res,0,0,2,2
38752,efeitos,0,0,2,2
23355,गुमनाम,0,0,2,2
31907,indesejáveis,0,0,2,2
23354,bielorrusso,0,0,2,2
43,segnale,1,2,0,2
49356,contribuyentes,0,0,2,2
23351,بشخص,0,0,2,2
38770,அனைத்து,0,0,2,2
23350,см.,0,0,2,2
38767,savaşlarına,0,0,2,2
51482,pasaron,0,0,2,2
21134,grundlæggende,0,0,2,2
38761,deluged,0,0,2,2
51313,otherwise,0,0,2,2
4991,region,0,0,2,2
1672,lezioni,1,2,0,2
49821,natuurwetenschappelijke,0,0,2,2
31894,diamantes,0,0,2,2
4968,yapacak,0,0,2,2
38721,tidsskriftet,0,0,2,2
21220,evitar,0,0,2,2
21221,mobiltelefon,0,0,2,2
1659,ringraziare,1,2,0,2
37322,implicit,0,0,2,2
31410,dispose,0,0,2,2
38698,hebt.,0,0,2,2
38696,mathématique,0,0,2,2
38695,وتعديل,0,0,2,2
49387,muestras,0,0,2,2
23293,качество,0,0,2,2
37329,исправления,0,0,2,2
21243,partout,0,0,2,2
38691,graphs,0,0,2,2
21245,dum,0,0,2,2
38687,siabra,0,0,2,2
21216,portaal,0,0,2,2
1350,presentate,1,2,0,2
49383,narcissemor,0,0,2,2
31890,круто,0,0,2,2
31402,العمل.,0,0,2,2
37312,février,0,0,2,2
1663,atto,1,2,0,2
4278,l'absence,0,0,2,2
23310,aprobación,0,0,2,2
37315,crescido,0,0,2,2
38711,manter,0,0,2,2
4959,இணைய,0,0,2,2
21204,ലേഖനങ്ങളാവാൻ,0,0,2,2
21205,presentar,0,0,2,2
21206,granskning,0,0,2,2
21209,deposition,0,0,2,2
38710,reduction,0,0,2,2
38709,maddesini,0,0,2,2
21365,வெளியிட்டது.,0,0,2,2
23224,investigators,0,0,2,2
49421,hago,0,0,2,2
38488,combination,0,0,2,2
1612,passare,1,2,0,2
1370,.la,2,1,1,2
4835,rays,0,0,2,2
1611,numerose,1,2,0,2
37437,объёмом,0,0,2,2
38481,amerikanere,0,0,2,2
38480,improved,0,0,2,2
23135,yerime,0,0,2,2
37439,اعتقدت,0,0,2,2
23130,kopiera,0,0,2,2
31479,figura,0,0,2,2
21551,ನೋಟ,0,0,2,2
38470,домой.,0,0,2,2
31480,മൈൽ,0,0,2,2
4829,തുടരാൻ,0,0,2,2
51346,أحب,0,0,2,2
23140,menade,0,0,2,2
23222,warring.,0,0,2,2
31477,دولار,0,0,2,2
4845,visible,0,0,2,2
37425,क़िताबें,0,0,2,2
21511,anteriormente,0,0,2,2
21513,आने,0,0,2,2
21515,cambiar,0,0,2,2
4298,ഇഷ്‌ടപ്പെട്ടെങ്കിൽ,0,0,2,2
38499,örneği,0,0,2,2
31847,قرار,0,0,2,2
31846,ändå.,0,0,2,2
37427,clicking,0,0,2,2
37428,nature's,0,0,2,2
37429,வாங்க,0,0,2,2
37430,brutes,0,0,2,2
21524,i̇nternet,0,0,2,2
38491,ações,0,0,2,2
1609,nascita,1,2,0,2
23124,разговоре.,0,0,2,2
38464,ister,0,0,2,2
1372,diritti,1,2,0,2
21592,couch.,0,0,2,2
21593,فلا,0,0,2,2
4813,saudiarabien,0,0,2,2
38437,pasó,0,0,2,2
4812,resposta,0,0,2,2
21598,enciclopédica,0,0,2,2
23102,लगी,0,0,2,2
38433,vandalizme,0,0,2,2
49478,largely,0,0,2,2
38430,बेवकूफ़,0,0,2,2
49480,fuera,0,0,2,2
1375,capacità,1,2,0,2
1600,garanzia,1,2,0,2
51461,நேரத்தில்,0,0,2,2
49484,കരുതുന്നു.,0,0,2,2
38440,объектах,0,0,2,2
23107,സുഹൃത്തുക്കൾ,0,0,2,2
38442,പറയുന്നു,0,0,2,2
49475,skolen,0,0,2,2
23122,டிகிரிக்கு,0,0,2,2
4824,stel,0,0,2,2
37449,mudar,0,0,2,2
4821,separates,0,0,2,2
38451,وسط,0,0,2,2
37453,debated,0,0,2,2
4817,sektioner,0,0,2,2
38443,αναθέσεις,0,0,2,2
21578,consulted,0,0,2,2
21579,positivos,0,0,2,2
1605,dall'altra,1,2,0,2
37455,abonner,0,0,2,2
49476,importaria,0,0,2,2
23108,länge.,0,0,2,2
23152,ground,0,0,2,2
37423,utformas,0,0,2,2
4846,livet,0,0,2,2
51469,கையை,0,0,2,2
21401,القائمة,0,0,2,2
21402,φαγητά,0,0,2,2
21403,samarbetet,0,0,2,2
4892,anomalies,0,0,2,2
21405,ஆற்றல்,0,0,2,2
23204,professores,0,0,2,2
31445,சோதனை,0,0,2,2
37390,falschen,0,0,2,2
37392,पूरक,0,0,2,2
21422,herkes,0,0,2,2
49811,informação.,0,0,2,2
31448,videregive,0,0,2,2
1627,ultimi,1,2,0,2
31862,ಮಾಡುತ್ತಿದ್ದಳು,0,0,2,2
1361,mille,2,1,1,2
23206,foco,0,0,2,2
23207,включён,0,0,2,2
21397,kring,0,0,2,2
31441,especialmente,0,0,2,2
37374,soporte,0,0,2,2
4901,vrijgegeven,0,0,2,2
38591,ஒருவேளை,0,0,2,2
38590,datadump,0,0,2,2
21379,juger,0,0,2,2
4897,sereno,0,0,2,2
38587,fångst-,0,0,2,2
38581,tyler,0,0,2,2
37378,प्रमुख,0,0,2,2
1631,spagnolo,1,2,0,2
31867,praticamente,0,0,2,2
21389,adelante.,0,0,2,2
37380,invloed,0,0,2,2
37381,habitats,0,0,2,2
21429,الأصابع,0,0,2,2
1623,sostenuto,1,2,0,2
38508,hoog,0,0,2,2
4879,पदार्थ,0,0,2,2
49452,تأكد,0,0,2,2
38529,प्यारी,0,0,2,2
21474,भंडार,0,0,2,2
21476,todo.,0,0,2,2
38527,onlar,0,0,2,2
38525,مكبر,0,0,2,2
49455,recognize,0,0,2,2
31466,worries,0,0,2,2
21483,ಪ್ರಿಯನು,0,0,2,2
21488,enfatizar,0,0,2,2
21491,age,0,0,2,2
37420,അതിശയകരമാണ്,0,0,2,2
31471,donnent,0,0,2,2
21500,déterminer,0,0,2,2
37421,فهمتك,0,0,2,2
31463,രുചികരമായ,0,0,2,2
31461,biosphere.,0,0,2,2
31856,heavens,0,0,2,2
38544,anti-social,0,0,2,2
31450,berättar,0,0,2,2
21439,d'internet,0,0,2,2
21441,récemment,0,0,2,2
38547,seguir,0,0,2,2
38545,féliciter,0,0,2,2
34,formazione.,1,2,0,2
23183,لفترة,0,0,2,2
23173,worte,0,0,2,2
23178,biblioteket,0,0,2,2
21460,change.,0,0,2,2
51342,സൗജന്യവും,0,0,2,2
38536,tell.,0,0,2,2
21465,suivant,0,0,2,2
37409,δουλέψει,0,0,2,2
21113,στους,0,0,2,2
21111,limite,0,0,2,2
38775,μαθήματα,0,0,2,2
23557,വിളിക്കുന്നു.,0,0,2,2
20720,награда,0,0,2,2
20721,objectionable,0,0,2,2
23553,endroit,0,0,2,2
31298,जैसा,0,0,2,2
49840,natuurwetenschappelijk,0,0,2,2
20725,molecules,0,0,2,2
37144,πρωί,0,0,2,2
23550,συναντήσω,0,0,2,2
69,errore,1,2,0,2
23549,आदि,0,0,2,2
20732,semiprotegidos,0,0,2,2
20734,correcting,0,0,2,2
51497,philosophers,0,0,2,2
23546,വിഡ്,0,0,2,2
37147,увидите,0,0,2,2
20715,modifiées,0,0,2,2
20713,ತಿಳಿಸಿ.,0,0,2,2
20813,personales,0,0,2,2
23559,geschikt,0,0,2,2
51269,fenômeno,0,0,2,2
20691,skämt,0,0,2,2
49243,«фонд,0,0,2,2
20693,उंगलियों,0,0,2,2
23568,elle.,0,0,2,2
20695,hemskt,0,0,2,2
37137,civilization,0,0,2,2
1307,adatte,1,2,0,2
20698,جميعًا,0,0,2,2
20700,doğal,0,0,2,2
23563,κόρης,0,0,2,2
39039,मतदान,0,0,2,2
23561,interação,0,0,2,2
20708,escuchado,0,0,2,2
23560,cumulative,0,0,2,2
20739,gap,0,0,2,2
49255,mænd,0,0,2,2
20741,solaire,0,0,2,2
31302,aktiva,0,0,2,2
5144,proposa,0,0,2,2
37164,desired,0,0,2,2
20785,statistics.,0,0,2,2
31311,κάνουμε,0,0,2,2
31313,νάρκισσα,0,0,2,2
5136,politikartiklar,0,0,2,2
20797,construir,0,0,2,2
23513,رأيك,0,0,2,2
37170,glem,0,0,2,2
5134,poetry,0,0,2,2
20803,tanrım.,0,0,2,2
23509,promedio,0,0,2,2
38980,history.,0,0,2,2
37174,comprar,0,0,2,2
38977,കരുതുക.,0,0,2,2
51496,paintings,0,0,2,2
20777,μεσημεριανό,0,0,2,2
37161,contou,0,0,2,2
20763,सूत्रों,0,0,2,2
23541,ocorreu,0,0,2,2
49257,duración,0,0,2,2
20749,klingen.,0,0,2,2
39017,идти,0,0,2,2
20759,düzeltmede,0,0,2,2
1726,iniziò,1,2,0,2
20766,geliştirmesine,0,0,2,2
20775,الهندسة,0,0,2,2
23530,sites.,0,0,2,2
5147,корень,0,0,2,2
1723,liberi,1,2,0,2
1310,tornare,1,2,0,2
23526,secteur,0,0,2,2
20774,muhammad,0,0,2,2
20677,endişelenme.,0,0,2,2
49233,daré,0,0,2,2
20675,вас.,0,0,2,2
23612,auktoritet,0,0,2,2
20585,مني,0,0,2,2
4239,ಮೂಲವನ್ನು,0,0,2,2
1758,risoluzione,1,2,0,2
23623,myntades,0,0,2,2
20595,matemáticas,0,0,2,2
23620,रहना,0,0,2,2
39111,interesting,0,0,2,2
31276,أشتري,0,0,2,2
39110,weile,0,0,2,2
39108,songs,0,0,2,2
20603,പദമാണ്,0,0,2,2
5199,nada.,0,0,2,2
1301,importasse.,2,1,1,2
5198,up.,0,0,2,2
37101,krävs,0,0,2,2
23624,ഉദാഹരണമാണ്.,0,0,2,2
23625,കഴിയില്ലെന്ന്,0,0,2,2
20582,архитектуры,0,0,2,2
23637,ermee,0,0,2,2
1763,libri,1,2,0,2
5218,vet.,0,0,2,2
20557,राजनीतिज्ञ,0,0,2,2
23641,spinoza,0,0,2,2
37085,aussprache,0,0,2,2
37086,voix,0,0,2,2
5213,उसका,0,0,2,2
5209,descriptions,0,0,2,2
23634,мелисса,0,0,2,2
37091,caracol.,0,0,2,2
51260,estudios,0,0,2,2
20574,والكلمة,0,0,2,2
37093,третье,0,0,2,2
51261,descreveu,0,0,2,2
20608,relying,0,0,2,2
20613,proper,0,0,2,2
37131,sex,0,0,2,2
23609,yasseri,0,0,2,2
39081,rico,0,0,2,2
51500,pares.,0,0,2,2
51266,konversationen,0,0,2,2
23589,birkaç,0,0,2,2
20655,overlying,0,0,2,2
1746,-pedìa,1,2,0,2
20657,ಬಯಸುತ್ತೀರಿ,0,0,2,2
20658,بشيء,0,0,2,2
23582,winkels,0,0,2,2
51498,ativas,0,0,2,2
23579,derivadas,0,0,2,2
4246,d'encyclopédie,0,0,2,2
5184,м,0,0,2,2
5183,ρήμα,0,0,2,2
37130,videre.,0,0,2,2
20643,experter.,0,0,2,2
39084,syfte,0,0,2,2
31973,الأسئلة,0,0,2,2
23604,amateur,0,0,2,2
1755,impara,1,2,0,2
31975,precisamos,0,0,2,2
31974,kelimesi,0,0,2,2
39096,ange,0,0,2,2
5191,पुर्तगाली,0,0,2,2
20626,akademik,0,0,2,2
37108,shapiro,0,0,2,2
20637,d'ailleurs,0,0,2,2
39091,крупным,0,0,2,2
20631,aaron,0,0,2,2
31281,സാധിക്കുന്നു.,0,0,2,2
1751,markov,2,1,1,2
37112,kullandığı,0,0,2,2
51501,policyer.,0,0,2,2
38976,boundary,0,0,2,2
49271,അല്ലെങ്കിൽ‌,0,0,2,2
23356,нов,0,0,2,2
23408,omhoog,0,0,2,2
31355,geçmiş,0,0,2,2
37250,krijgen.,0,0,2,2
21009,introducir,0,0,2,2
31925,possess,0,0,2,2
1334,bayesiano,1,2,0,2
38842,iğrençti,0,0,2,2
37257,erfarne,0,0,2,2
23395,meerderheid,0,0,2,2
21022,soluções,0,0,2,2
51305,teacher,0,0,2,2
31920,νάρκισα,0,0,2,2
5032,intensifique,0,0,2,2
38830,voyez,0,0,2,2
38829,photographs,0,0,2,2
21041,geçebilirsin,0,0,2,2
51302,akademiske,0,0,2,2
5053,चुनाव,0,0,2,2
5127,tekniken,0,0,2,2
20996,araba,0,0,2,2
20963,desarrollada,0,0,2,2
49310,traitant,0,0,2,2
23422,duim,0,0,2,2
38875,conmigo,0,0,2,2
51,i.,2,1,1,2
20971,मित्र,0,0,2,2
1331,malapena,1,2,0,2
20981,மெதுவான,0,0,2,2
38865,журналов,0,0,2,2
20986,നിർമ്മിച്ച,0,0,2,2
23413,संशोधित,0,0,2,2
49317,ಚೂಪಾದ,0,0,2,2
20992,decisões,0,0,2,2
38860,понятие,0,0,2,2
20994,...,0,0,2,2
38824,rejste,0,0,2,2
38822,vergiss,0,0,2,2
23385,consigues,0,0,2,2
23384,oraya,0,0,2,2
21081,you'll,0,0,2,2
5013,ಸಮಯದವರೆಗೆ,0,0,2,2
1680,porterà,1,2,0,2
49346,последним,0,0,2,2
21086,математике,0,0,2,2
38792,diretrizes,0,0,2,2
51484,naziksiniz.,0,0,2,2
47,lascia,1,2,0,2
38785,vida.,0,0,2,2
21099,par-delà,0,0,2,2
23360,വിശ്വസിക്കുന്നത്.,0,0,2,2
44,notato,1,2,0,2
21102,നൂപീഡിയ,0,0,2,2
38782,banque,0,0,2,2
5004,بالكاد,0,0,2,2
1336,coloro,1,2,0,2
23367,نرجس,0,0,2,2
38795,عشر,0,0,2,2
38808,environnementaux,0,0,2,2
4267,biliyorsun.,0,0,2,2
31372,ലേഖനങ്ങളുള്ള,0,0,2,2
37269,kişi,0,0,2,2
5023,सपनों,0,0,2,2
31373,प्रोत्साहित,0,0,2,2
38810,grew,0,0,2,2
4269,revisões.,0,0,2,2
21077,männer,0,0,2,2
38804,skaffe,0,0,2,2
31376,desculpas.,0,0,2,2
51306,മാർഗങ്ങൾ,0,0,2,2
37276,birbirlerine,0,0,2,2
23370,содержание,0,0,2,2
37277,கூர்மையான,0,0,2,2
31341,ஆபத்துடைய,0,0,2,2
5071,deveria,0,0,2,2
37237,moquez,0,0,2,2
5101,presentes,0,0,2,2
38950,gerade,0,0,2,2
31947,caché,0,0,2,2
49284,berättade,0,0,2,2
37193,இதுதான்,0,0,2,2
20858,funktioner,0,0,2,2
20859,लिह,0,0,2,2
37195,uygun,0,0,2,2
20862,обозначения,0,0,2,2
5109,പാഠങ്ങൾ,0,0,2,2
20864,everything.,0,0,2,2
20867,donationer,0,0,2,2
38941,dedican,0,0,2,2
49835,geometrie,0,0,2,2
20872,encontrarse,0,0,2,2
38938,tıpkı,0,0,2,2
51287,reuse,0,0,2,2
38952,semi-supervised,0,0,2,2
37190,சொன்னாள்,0,0,2,2
38965,l'historien,0,0,2,2
37179,biologie,0,0,2,2
37180,değilim.,0,0,2,2
37181,buscas,0,0,2,2
5126,फरवरी,0,0,2,2
20827,उच्च,0,0,2,2
4252,redigeringen,0,0,2,2
20831,drainage,0,0,2,2
20847,கவனிப்புப்,0,0,2,2
20833,الواقع,0,0,2,2
38963,princípios,0,0,2,2
23493,absolutamente,0,0,2,2
49277,stichting,0,0,2,2
23490,değişikliklerin,0,0,2,2
49282,hiring,0,0,2,2
1321,anticipo,1,2,0,2
37201,décrivent,0,0,2,2
38883,retomar,0,0,2,2
20883,систем,0,0,2,2
20920,ಭವ್ಯವಾದ,0,0,2,2
38907,പറഞ്ഞത്,0,0,2,2
20926,στείλετε,0,0,2,2
20929,λέξη.,0,0,2,2
20930,hvilken,0,0,2,2
20931,yaptığı,0,0,2,2
38901,மக்கள்,0,0,2,2
1699,pedia,2,1,1,2
31340,funcionar,0,0,2,2
49307,चित्रों,0,0,2,2
5073,contexts.,0,0,2,2
49308,उदाहरणों,0,0,2,2
37232,webbläsare.,0,0,2,2
38885,contracción,0,0,2,2
20952,بهذا,0,0,2,2
31333,χαρούμενη,0,0,2,2
1325,criticò,1,2,0,2
23452,january [update],0,0,2,2
20898,verdiene.,0,0,2,2
31943,intelligenten,0,0,2,2
38930,dein,0,0,2,2
5093,format,0,0,2,2
20893,महीनों,0,0,2,2
20894,bloque,0,0,2,2
5091,derakhshan,0,0,2,2
38921,telle,0,0,2,2
20915,ചുവടുവപ്പ്,0,0,2,2
51489,işle,0,0,2,2
23460,عكس,0,0,2,2
1705,classificare,1,2,0,2
20911,will.,0,0,2,2
37215,minhas,0,0,2,2
23454,basin,0,0,2,2
4801,obtenez,0,0,2,2
38417,eugene,0,0,2,2
5219,ശരാശരി,0,0,2,2
37983,verificar,0,0,2,2
22268,generellt,0,0,2,2
4519,классических,0,0,2,2
22773,χρόνο,0,0,2,2
22772,usted,0,0,2,2
22273,colombiano,0,0,2,2
37669,olup,0,0,2,2
22770,hämtar,0,0,2,2
22768,ടെറൻസ്,0,0,2,2
22767,betyder.,0,0,2,2
4515,vaste,0,0,2,2
49769,lidar,0,0,2,2
4513,distribuir,0,0,2,2
37972,kim,0,0,2,2
37971,weitermachen,0,0,2,2
22286,originais,0,0,2,2
1422,settimana,1,2,0,2
22265,vestidos,0,0,2,2
1512,complessa,1,2,0,2
22779,herkesin,0,0,2,2
4534,öppna,0,0,2,2
38009,posibilidades,0,0,2,2
22231,encyclopédies,0,0,2,2
49656,νάρκισσος,0,0,2,2
4528,etmenin,0,0,2,2
4527,നിർദ്ദേശങ്ങൾ,0,0,2,2
22788,-page,0,0,2,2
51441,quotations,0,0,2,2
22247,almak,0,0,2,2
22785,önemli,0,0,2,2
22249,τίτλο.,0,0,2,2
1421,generalista,1,2,0,2
4521,ಅಲ್ಲಿಗೆ,0,0,2,2
37989,aprenda,0,0,2,2
22780,broadest,0,0,2,2
22287,taxa,0,0,2,2
37970,campagne,0,0,2,2
22762,negócios,0,0,2,2
37968,النهاية.,0,0,2,2
22324,tard.,0,0,2,2
51407,portions,0,0,2,2
37943,kannst.,0,0,2,2
37942,watching.,0,0,2,2
22329,cia,0,0,2,2
22744,vandalizm,0,0,2,2
31631,amables,0,0,2,2
22334,faces,0,0,2,2
22335,известность,0,0,2,2
31632,பெறவில்லை,0,0,2,2
22339,ശരിയായ,0,0,2,2
49682,перешла,0,0,2,2
31634,posted,0,0,2,2
37684,avond,0,0,2,2
1489,«non,1,2,0,2
4351,orientée,0,0,2,2
22747,описывают,0,0,2,2
22317,وهي,0,0,2,2
51402,подождите,0,0,2,2
31622,bile,0,0,2,2
22294,ajudam,0,0,2,2
22759,ಹೆಲ್ಲರ್,0,0,2,2
22758,أولئك,0,0,2,2
22757,edition.,0,0,2,2
49665,இயங்கி,0,0,2,2
22301,technical,0,0,2,2
4504,typer,0,0,2,2
4510,ontwikkeling,0,0,2,2
4508,arreglar,0,0,2,2
37957,traduction,0,0,2,2
1427,possano,1,2,0,2
37955,consultation,0,0,2,2
49668,डोक्युमेंटेशन,0,0,2,2
22225,الطريقة,0,0,2,2
38014,പ്രവർത്തിക്കുന്നു.,0,0,2,2
23089,شكك,0,0,2,2
38075,astuce,0,0,2,2
38071,saß,0,0,2,2
31759,savoirs,0,0,2,2
37627,have.,0,0,2,2
22143,hakkındaki,0,0,2,2
31758,konanykhin,0,0,2,2
38067,ಹೊರತು,0,0,2,2
51445,hiérarchie,0,0,2,2
22148,nativos,0,0,2,2
22149,जिन,0,0,2,2
4337,καρδιά.,0,0,2,2
4567,سأقدم,0,0,2,2
38062,ogg,0,0,2,2
22155,collaboratif,0,0,2,2
1523,fluente.,2,1,1,2
22828,escribir,0,0,2,2
38073,machine-learning,0,0,2,2
38076,publiceerde,0,0,2,2
49654,вся,0,0,2,2
22134,suma,0,0,2,2
31596,λεπτά.,0,0,2,2
22112,رفاق,0,0,2,2
1412,fenomeno,1,2,0,2
38090,ലേഖനത്തിൽ,0,0,2,2
22115,hosted,0,0,2,2
51387,ελπίζω,0,0,2,2
31597,desse,0,0,2,2
49632,учёные,0,0,2,2
1528,solitamente,1,2,0,2
38083,revertir,0,0,2,2
51446,länka,0,0,2,2
22128,available.,0,0,2,2
22129,letárgico,0,0,2,2
22130,बोलना,0,0,2,2
22840,alcanzar,0,0,2,2
38057,orbit.,0,0,2,2
51444,miljon,0,0,2,2
22826,appears,0,0,2,2
4561,d'écrire,0,0,2,2
38032,gustó,0,0,2,2
31614,καλέσετε,0,0,2,2
37647,unable,0,0,2,2
38028,resultat,0,0,2,2
37648,ενοχλητική,0,0,2,2
38025,التحقق,0,0,2,2
49653,συνομιλία.,0,0,2,2
22803,выходные,0,0,2,2
22211,تحدث,0,0,2,2
22801,djur,0,0,2,2
38020,værd,0,0,2,2
22216,menciones.,0,0,2,2
22217,montré,0,0,2,2
37651,l'existence,0,0,2,2
38017,travel,0,0,2,2
49775,fikrim,0,0,2,2
37645,மொழிகளிலும்,0,0,2,2
1419,senti,1,2,0,2
22176,rely,0,0,2,2
37633,narzissenhand,0,0,2,2
4560,الثلاثة,0,0,2,2
4559,maurice,0,0,2,2
31756,trabaje,0,0,2,2
22172,dissesse,0,0,2,2
4556,الشائعة,0,0,2,2
4554,.que,0,0,2,2
4550,irme.,0,0,2,2
22178,prøv,0,0,2,2
37636,said.,0,0,2,2
51443,outperformed,0,0,2,2
38046,math,0,0,2,2
49643,அவர்களின்,0,0,2,2
37639,ഇല്ലാത്തതിനാൽ,0,0,2,2
49685,ωραία,0,0,2,2
49766,النسخة,0,0,2,2
22735,സമവാക്യം,0,0,2,2
4406,कराया,0,0,2,2
22521,pédagogique,0,0,2,2
22522,suivants ,0,0,2,2
49761,doorgeven,0,0,2,2
22526,l'utiliser,0,0,2,2
31704,mão,0,0,2,2
37813,lesquelles,0,0,2,2
37811,påståenden,0,0,2,2
49738,μυαλό,0,0,2,2
22535,happening,0,0,2,2
22536,oceanic,0,0,2,2
22537,നിന്നു,0,0,2,2
4398,avis,0,0,2,2
37743,dependent,0,0,2,2
37804,ولطيف,0,0,2,2
1464,misura,1,2,0,2
4405,sufficiently,0,0,2,2
22515,episodes,0,0,2,2
1432,modifica,1,2,0,2
49736,കരയുകയും,0,0,2,2
22656,mens,0,0,2,2
1467,considerate,1,2,0,2
22496,επαναλάβει,0,0,2,2
22497,الجزء,0,0,2,2
22498,понравилось,0,0,2,2
22500,വിവരങ്ങളും,0,0,2,2
4412,totaal,0,0,2,2
1450,siciliano,2,1,1,2
22506,leva,0,0,2,2
37825,sag,0,0,2,2
22508,σάββατο,0,0,2,2
31706,ஒன்றைப்,0,0,2,2
22510,istiyorum.,0,0,2,2
22650,wikilivros,0,0,2,2
22649,.freaked,0,0,2,2
22548,kreeg,0,0,2,2
22550,déterminant,0,0,2,2
22551,சொல்வதற்கான,0,0,2,2
37746,wacht,0,0,2,2
37780,sage,0,0,2,2
37779,الأم,0,0,2,2
4368,negocio,0,0,2,2
4382,تعتمد,0,0,2,2
4381,series,0,0,2,2
4380,trees,0,0,2,2
37761,تذهب,0,0,2,2
22593,σίγουροι,0,0,2,2
22595,fångade,0,0,2,2
49753,पसंदीदा,0,0,2,2
22597,ஆய்வின்,0,0,2,2
49755,dårligt,0,0,2,2
4373,வெள்ளிக்கிழமை,0,0,2,2
1458,vestito,1,2,0,2
49757,يوفر,0,0,2,2
37757,semanas,0,0,2,2
51424,næppe,0,0,2,2
22576,कोशिश,0,0,2,2
49744,cry,0,0,2,2
4393,ನಾರ್ಸಿಸ್,0,0,2,2
22556,vilar,0,0,2,2
37747,назван,0,0,2,2
37748,ಹೆಚ್ಚಾಗಿ,0,0,2,2
22626,теме,0,0,2,2
22563,erkek,0,0,2,2
22565,risque,0,0,2,2
22619,soucis.,0,0,2,2
22624,தேவை,0,0,2,2
4388,gelen,0,0,2,2
3,buona.,1,2,0,2
49747,базовые,0,0,2,2
31698,permis,0,0,2,2
22574,സ്വതന്ത്രവിജ്ഞാനകോശത്തിന്റെ,0,0,2,2
22659,conectado,0,0,2,2
37838,создание,0,0,2,2
22479,الأسبوع.,0,0,2,2
5,venir,2,1,1,2
22388,verlicht,0,0,2,2
22390,الحر,0,0,2,2
1484,l'impact,1,2,0,2
49702,horas.,0,0,2,2
37903,जॉन,0,0,2,2
22710,ಪುಸ್ತಕವನ್ನು,0,0,2,2
4457,nah,0,0,2,2
22399,செய்வோம்.,0,0,2,2
22400,κάθε,0,0,2,2
37898,προτέρων,0,0,2,2
22403,priorities,0,0,2,2
22706,bäst,0,0,2,2
37702,essay,0,0,2,2
37892,بريتانيكا،,0,0,2,2
1439,come.,2,1,1,2
37907,सदस्य,0,0,2,2
22385,ஆங்கிலம்,0,0,2,2
22382,جذور,0,0,2,2
22360,ആയിരുന്നു.,0,0,2,2
49691,jogo,0,0,2,2
37925,ναρκίσσα.,0,0,2,2
37924,artificial.,0,0,2,2
4473,lá,0,0,2,2
1488,portata,1,2,0,2
22731,dog,0,0,2,2
49696,स्वभाव,0,0,2,2
51435,answers,0,0,2,2
22366,المسجلين,0,0,2,2
22367,منظمة,0,0,2,2
22370,आइकन,0,0,2,2
4355,أمر,0,0,2,2
4466,கிடைத்தது,0,0,2,2
22376,formatting,0,0,2,2
37890,novia,0,0,2,2
37708,restrictions,0,0,2,2
4422,j'étais,0,0,2,2
4449,lateinische,0,0,2,2
31664,chateada,0,0,2,2
49722,enormt,0,0,2,2
49723,четыре,0,0,2,2
4429,financiamento,0,0,2,2
22675,avsedd,0,0,2,2
37855,المواضيع,0,0,2,2
4428,व्यू,0,0,2,2
37853,missing,0,0,2,2
37720,trouver,0,0,2,2
1470,uscì,1,2,0,2
22672,reciben,0,0,2,2
1468,utilizzato,1,2,0,2
22469,хорошая,0,0,2,2
4425,ночью,0,0,2,2
49725,αρνητικό,0,0,2,2
22679,threshold,0,0,2,2
1445,osservazioni,1,2,0,2
22447,βικιβιβλία,0,0,2,2
22433,متجاوزة,0,0,2,2
51414,تقريبًا,0,0,2,2
4444,artikels,0,0,2,2
52233,καθυστέρησης,0,0,2,2
31720,मिलना,0,0,2,2
37877,party,0,0,2,2
49715,ಎಷ್ಟು,0,0,2,2
22691,स्पीकर,0,0,2,2
22683,λειτουργία,0,0,2,2
22435,realiza,0,0,2,2
31661,contributions.,0,0,2,2
37710,l'énergie,0,0,2,2
37872,έξω,0,0,2,2
1473,utente,1,2,0,2
22684,وتعني,0,0,2,2
4584,konuşmak,0,0,2,2
4336,சரி.,0,0,2,2
22105,главный,0,0,2,2
21782,помочь.,0,0,2,2
21784,d'environ,0,0,2,2
49544,ihop,0,0,2,2
4711,использую,0,0,2,2
31541,rockar,0,0,2,2
1387,mettendo,1,2,0,2
38308,മുൻ‌കൂട്ടി,0,0,2,2
21792,disciplines,0,0,2,2
49784,ganska,0,0,2,2
37514,sunucuları,0,0,2,2
4323,περισσότερες,0,0,2,2
49550,namens,0,0,2,2
21800,ಚಂದಾದಾರ,0,0,2,2
1388,riguarda,1,2,0,2
1390,dimensioni,1,2,0,2
38300,ಕನಸಿನ,0,0,2,2
49543,waard.,0,0,2,2
37510,logra,0,0,2,2
4680,ashburn,0,0,2,2
23009,milieux,0,0,2,2
23029,telecomunicaciones,0,0,2,2
21748,ಹೋಗಲು,0,0,2,2
23026,modifying,0,0,2,2
38333,ട്യൂമറിന്റെ,0,0,2,2
31805,кусок,0,0,2,2
38331,твои,0,0,2,2
37501,विनम्र,0,0,2,2
38326,يجري,0,0,2,2
23021,न्यासी,0,0,2,2
23018,alexa.,0,0,2,2
23017,प्रकाशित,0,0,2,2
21773,hiervan,0,0,2,2
23011,located,0,0,2,2
4719,ഉപയോഗിക്കാം.,0,0,2,2
4718,και.,0,0,2,2
21804,maximize,0,0,2,2
49551,கனவுகளின்,0,0,2,2
21807,power,0,0,2,2
51363,இதற்குக்,0,0,2,2
21837,cidadão,0,0,2,2
38273,heuristic,0,0,2,2
4692,மதிப்புக்குரியது,0,0,2,2
21842,திட்டங்களை,0,0,2,2
4691,ಕೇಳಿದ್ದೇನೆ,0,0,2,2
4690,الأخبار,0,0,2,2
1396,preferita,1,2,0,2
38263,animados,0,0,2,2
38262,poäng.,0,0,2,2
38261,naturelles.,0,0,2,2
49559,நபரிடம்,0,0,2,2
38258,बैठे,0,0,2,2
4684,mac,0,0,2,2
21862,representações,0,0,2,2
49562,eigen,0,0,2,2
52224,كيفية,0,0,2,2
21835,δάνειο,0,0,2,2
4697,सम्बन्ध,0,0,2,2
49553,adição,0,0,2,2
21811,месяцы,0,0,2,2
21813,уэйлсу,0,0,2,2
38294,உடனடியாக,0,0,2,2
49552,تلتقط,0,0,2,2
51364,.இது,0,0,2,2
22995,welk,0,0,2,2
22993,огромных,0,0,2,2
37526,r,0,0,2,2
21820,herzen,0,0,2,2
38288,बनने,0,0,2,2
38287,relevant,0,0,2,2
1577,tu.,2,1,1,2
51455,seasonal,0,0,2,2
38278,attempts,0,0,2,2
21743,rationality,0,0,2,2
37496,പരിചയം,0,0,2,2
31812,numa,0,0,2,2
4769,’de,0,0,2,2
37473,ചെയ്ത്,0,0,2,2
21657,سأرسل,0,0,2,2
21658,dromen,0,0,2,2
23071,proibir,0,0,2,2
52221,«когда,0,0,2,2
21664,apply,0,0,2,2
23068,கட்டுரைகளுடன்,0,0,2,2
38387,demuestra,0,0,2,2
21667,betydning,0,0,2,2
23066,ಚಿಂತೆ,0,0,2,2
4777,dozen,0,0,2,2
38384,वेबसाइटों,0,0,2,2
49503,kararlar,0,0,2,2
22,greco,1,2,0,2
37478,programmés,0,0,2,2
23074,føler,0,0,2,2
23075,undisclosed,0,0,2,2
1598,progress,2,1,1,2
1378,critici,2,1,1,2
49486,dando,0,0,2,2
21625,logiciel ,0,0,2,2
1377,classiche,1,2,0,2
49487,продолжить,0,0,2,2
49490,sociólogo,0,0,2,2
4792,iedereen,0,0,2,2
21638,fondé,0,0,2,2
24,dopo.,1,2,0,2
23078,kullanabilirsiniz.,0,0,2,2
49497,aller.,0,0,2,2
31501,repita,0,0,2,2
4783,forêt,0,0,2,2
38399,åt,0,0,2,2
23076,appliquer,0,0,2,2
4773,oficial.,0,0,2,2
21681,something.,0,0,2,2
31813,எதுவும்,0,0,2,2
37483,أخرى،,0,0,2,2
4312,activities.,0,0,2,2
21717,wik-ih-pee-dee-ə,0,0,2,2
49519,großartige,0,0,2,2
38352,σφαίρα,0,0,2,2
23039,cautions,0,0,2,2
31519,geri,0,0,2,2
31520,pornographic,0,0,2,2
4745,उच्चतम,0,0,2,2
38348,thin,0,0,2,2
21728,soutenir,0,0,2,2
23037,uitspraak,0,0,2,2
23036,مراقبة,0,0,2,2
21733,decirlo.,0,0,2,2
4315,lançada,0,0,2,2
21736,первые,0,0,2,2
23042,विकिताबें,0,0,2,2
4310,فيما,0,0,2,2
4754,sprekend,0,0,2,2
37486,systematische,0,0,2,2
21685,diamanten,0,0,2,2
38374,ولكنك,0,0,2,2
31824,original.,0,0,2,2
21690,differentiated,0,0,2,2
31822,sofá.,0,0,2,2
38369,относительно,0,0,2,2
49795,centuries,0,0,2,2
37491,sauvagerie,0,0,2,2
21699,«por,0,0,2,2
21701,topla,0,0,2,2
38363,internettet,0,0,2,2
49793,esfera,0,0,2,2
21705,daarvoor,0,0,2,2
21711,carácter,0,0,2,2
37537,kızım,0,0,2,2
38249,formuleringen,0,0,2,2
31763,membro,0,0,2,2
38161,alcançar,0,0,2,2
22019,hızlı,0,0,2,2
22020,números,0,0,2,2
22021,текстов,0,0,2,2
22022,لحظة.,0,0,2,2
22897,examen.,0,0,2,2
22027,ഭാഗം,0,0,2,2
22894,சிறுவன்,0,0,2,2
4618,origins,0,0,2,2
49601,request,0,0,2,2
37590,doet.,0,0,2,2
37591,universities,0,0,2,2
38148,கேட்டபோது,0,0,2,2
22888,चीनी,0,0,2,2
22037,റഫറൻസുകൾ,0,0,2,2
22038,الرياضيات,0,0,2,2
51382,исключительно,0,0,2,2
22901,dillerdeki,0,0,2,2
21871,closest,0,0,2,2
38166,plainte,0,0,2,2
4639,d'hommes,0,0,2,2
49587,krydsede,0,0,2,2
37576,neemt,0,0,2,2
38175,fio,0,0,2,2
21989,high,0,0,2,2
37578,godkännande,0,0,2,2
37580,εντάξει.,0,0,2,2
4637,warte,0,0,2,2
4329,welchem,0,0,2,2
31779,savoureux,0,0,2,2
1542,stesse,1,2,0,2
22903,बिलकुल,0,0,2,2
31569,அனைத்தையும்,0,0,2,2
22003,extensão,0,0,2,2
4633,christian,0,0,2,2
22887,tidig,0,0,2,2
22885,valt,0,0,2,2
38143,pessoa.,0,0,2,2
22044,qu'avez-vous,0,0,2,2
38117,chegou,0,0,2,2
22079,acht,0,0,2,2
22080,крупные,0,0,2,2
37605,διαφωνώ.,0,0,2,2
49615,звучит,0,0,2,2
12,conoscere,1,2,0,2
49618,உள்ளன.,0,0,2,2
49620,processing.,0,0,2,2
22088,virginia.,0,0,2,2
49623,понять,0,0,2,2
4589,maturation,0,0,2,2
22097,ändra,0,0,2,2
49625,σημείο,0,0,2,2
38100,wäre.,0,0,2,2
1410,venerdì,1,2,0,2
22865,degrees.,0,0,2,2
22866,gerek,0,0,2,2
22073,المسؤولون,0,0,2,2
22878,अरबी,0,0,2,2
22045,söyleyebilirsin,0,0,2,2
49604,kväll,0,0,2,2
22047,прав,0,0,2,2
37594,திருகினேன்.,0,0,2,2
4333,expérimentale,0,0,2,2
38138,επόμενο,0,0,2,2
38133,producera,0,0,2,2
22867,аппроксимации,0,0,2,2
38129,plates.,0,0,2,2
31584,connaissez,0,0,2,2
4334,месте.,0,0,2,2
22871,ciclo,0,0,2,2
31586,computed,0,0,2,2
49778,communications,0,0,2,2
21981,pensée.,0,0,2,2
38181,lee,0,0,2,2
31567,skønhed.,0,0,2,2
49574,rencontrer,0,0,2,2
49567,semelhantes,0,0,2,2
37547,papier,0,0,2,2
21902,முழு,0,0,2,2
21903,estabelecido,0,0,2,2
1562,frase.,2,1,1,2
31785,μέρος,0,0,2,2
37552,αμβλύ,0,0,2,2
4666,المؤسس,0,0,2,2
21913,fête,0,0,2,2
21915,പെട്ടെന്നുതന്നെ,0,0,2,2
38224,viés,0,0,2,2
16,dispiacerebbe,1,2,0,2
31560,askerler,0,0,2,2
51371,oito,0,0,2,2
1401,l'ipotesi,1,2,0,2
22958,ordnummer.,0,0,2,2
51369,grow,0,0,2,2
51368,spel.,0,0,2,2
31555,formulée,0,0,2,2
4679,kommit,0,0,2,2
21874,upptagen,0,0,2,2
38245,gens,0,0,2,2
38244,السياسية,0,0,2,2
1399,riguardanti,1,2,0,2
4676,يتطلب,0,0,2,2
4674,описания,0,0,2,2
21894,exame,0,0,2,2
21885,classiques,0,0,2,2
51366,تهدف,0,0,2,2
21888, million.,0,0,2,2
21889,générées,0,0,2,2
1567,collegato,1,2,0,2
22961,estará,0,0,2,2
4661,république,0,0,2,2
51372,إس,0,0,2,2
22916,விளக்குகிறது.,0,0,2,2
49575,g,0,0,2,2
4328,paths,0,0,2,2
49583,paradoks,0,0,2,2
21961,വിഷയങ്ങൾ,0,0,2,2
31566,porte,0,0,2,2
37566,आक्रामक,0,0,2,2
37569,تتم,0,0,2,2
37571,ceremony,0,0,2,2
22920,κορυφή,0,0,2,2
21970,dreams,0,0,2,2
37572,seeing,0,0,2,2
4641,esposa,0,0,2,2
38185,rire,0,0,2,2
37573,ernst,0,0,2,2
51378,вашим,0,0,2,2
21976,υπάρχουν,0,0,2,2
38196,celle-ci,0,0,2,2
37563,говорю,0,0,2,2
1552,utili,1,2,0,2
37561,energi,0,0,2,2
21932,antwoord,0,0,2,2
1556,domanda.,1,2,0,2
21935,ensaio,0,0,2,2
21937,discours,0,0,2,2
38208,raíces,0,0,2,2
31781,मारी,0,0,2,2
4650,தெரியப்படுத்துங்கள்.,0,0,2,2
38200,மற்றதைச்,0,0,2,2
38205,نحن,0,0,2,2
22933,represents,0,0,2,2
4647,encyclopédiques,0,0,2,2
21950,financer,0,0,2,2
38202,recibido,0,0,2,2
1402,strumenti,1,2,0,2
39139,சேனலுக்கு,0,0,2,2
31268,என,0,0,2,2
48594,परिवर्तनों,0,0,2,2
19162,planes.,0,0,2,2
36638,slet,0,0,2,2
19165,مشاهدة,0,0,2,2
19166,ಯೋಗ್ಯವಾಗಿಲ್ಲ,0,0,2,2
4147,cuore,1,2,0,2
19169,gehts,0,0,2,2
24315,تخلق,0,0,2,2
19171,നാർസിസ്,0,0,2,2
40029,صحيح,0,0,2,2
40027,கொடுக்க,0,0,2,2
19176,kleiner,0,0,2,2
19178,shane,0,0,2,2
19181,ലേഖനത്തെ,0,0,2,2
19183,colonized,0,0,2,2
2003,più.,1,2,0,2
40020,gegangen,0,0,2,2
40033,conséquence,0,0,2,2
24317,unregistered,0,0,2,2
36623,håber,0,0,2,2
24319,ತಮಾಷೆ,0,0,2,2
48792,ചെയ്യാം.,0,0,2,2
5863,لقول,0,0,2,2
24337,задач,0,0,2,2
36628,पॉइंट,0,0,2,2
40052,الصوت,0,0,2,2
30926,audience,0,0,2,2
30929,ratings,0,0,2,2
24332,शुरुआत,0,0,2,2
24330,बह,0,0,2,2
19144,εκπληκτική.,0,0,2,2
30931,ترَ,0,0,2,2
40041,loves,0,0,2,2
51568,hacia,0,0,2,2
19156,deltagarna,0,0,2,2
30934,forkerte,0,0,2,2
32188,lære,0,0,2,2
2002,modo.,1,2,0,2
51131,carved,0,0,2,2
19192,nemen.,0,0,2,2
24294,actifs,0,0,2,2
39999,தலைமையான,0,0,2,2
30949,citerede,0,0,2,2
36655,gemaakt.,0,0,2,2
1208,l'insegnante,1,2,0,2
19229,poder,0,0,2,2
39993,globally,0,0,2,2
5824,போன்றது.,0,0,2,2
32181,système.,0,0,2,2
24286,regels,0,0,2,2
24285,தயாராக,0,0,2,2
19237,जनता,0,0,2,2
39988,tomorrow,0,0,2,2
24284,ലേഖനത്തിന്,0,0,2,2
24283,sueños,0,0,2,2
40001,கட்டுரைகளைக்,0,0,2,2
48817,exige,0,0,2,2
40004,tummen,0,0,2,2
5837,kommet,0,0,2,2
40016,نيتشر,0,0,2,2
19194,ಮಗಳ,0,0,2,2
30942,போன்றவற்றைக்,0,0,2,2
51133,secondary,0,0,2,2
30943,anunciada,0,0,2,2
19201,kender,0,0,2,2
49904,स्वप्न,0,0,2,2
32185,λόγω,0,0,2,2
36645,kullanım,0,0,2,2
24304,términos,0,0,2,2
19208,പങ്കാളിത്തത്തിലൂടെ,0,0,2,2
1997,costruita,1,2,0,2
30946,предложение.,0,0,2,2
19212,vídeos,0,0,2,2
19123,improving,0,0,2,2
24344,zorg,0,0,2,2
24155,responsabilidad,0,0,2,2
36588,पत्रिका,0,0,2,2
19013,работайте,0,0,2,2
19017,l’encyclopédie,0,0,2,2
19018,sted.,0,0,2,2
40138,citar,0,0,2,2
30903,méthodes,0,0,2,2
24395,νόστιμα,0,0,2,2
24389,മുകളിൽ,0,0,2,2
40129,idén,0,0,2,2
40128,ಆಶ್ಚರ್ಯಕರವಾಗಿ,0,0,2,2
5902,documentaire,0,0,2,2
36596,mention,0,0,2,2
19037,जड़,0,0,2,2
122,mettere,1,2,0,2
36597,चलता,0,0,2,2
48768,βιβλιοθήκη,0,0,2,2
19012,representan,0,0,2,2
24402,contrário,0,0,2,2
1197,linus,2,1,1,2
19008,എന്നിങ്ങനെ,0,0,2,2
40154,мальчик,0,0,2,2
18990,सब्सक्राइब,0,0,2,2
5917,chacune,0,0,2,2
18993,ettiği,0,0,2,2
40152,darauf,0,0,2,2
48761,κάτι.,0,0,2,2
18996,വിക്കിപീഡിയയാണ്,0,0,2,2
5915,obscene,0,0,2,2
40150,vidt,0,0,2,2
36584,தன்னை,0,0,2,2
36585,naturligt.,0,0,2,2
5913,должно,0,0,2,2
32213,ஆரம்பத்தில்,0,0,2,2
40145,antes.,0,0,2,2
19007,animales.,0,0,2,2
32210,спрашиваю,0,0,2,2
48770,ಬಯಸುತ್ತೀರಾ,0,0,2,2
40119,അൽപ്പം,0,0,2,2
5896,forskningspublikationer,0,0,2,2
32203,λήμμα,0,0,2,2
2019,preoccupata,1,2,0,2
32201,değmez.,0,0,2,2
19090,الحرية,0,0,2,2
24360,reforço,0,0,2,2
40086,branch,0,0,2,2
40082,xviie siècle,0,0,2,2
24353,consequência,0,0,2,2
19102,configuração,0,0,2,2
5874,политика,0,0,2,2
30923,grap,0,0,2,2
40074,λογισμικού,0,0,2,2
24350,expansión,0,0,2,2
5870,burden,0,0,2,2
19116,physique,0,0,2,2
36607,nadie,0,0,2,2
40098,kallade,0,0,2,2
2021,chiedere.,1,2,0,2
48774,facteurs,0,0,2,2
36602,senere.,0,0,2,2
19053,dúvida,0,0,2,2
40111,migrating,0,0,2,2
19056,asignaciones,0,0,2,2
32208,παίρνεις,0,0,2,2
5892,надеюсь,0,0,2,2
2022,bel,2,1,1,2
19072,свободен,0,0,2,2
19064,देखें,0,0,2,2
19066,turquie,0,0,2,2
24372,pequena,0,0,2,2
24371,καλοί,0,0,2,2
5888,доступна,0,0,2,2
30911,سأعطيك,0,0,2,2
19242,députés,0,0,2,2
39984,groeide,0,0,2,2
19244,ಬ್ಯಾಂಕ್,0,0,2,2
39880,saiba,0,0,2,2
36715,geschenk,0,0,2,2
19406,rekommenderar,0,0,2,2
48870,ലഭിക്കുന്നു,0,0,2,2
24199,internes,0,0,2,2
19412,oficialmente,0,0,2,2
30993,अखबार,0,0,2,2
30994,sormanın,0,0,2,2
32157,महान,0,0,2,2
19421,bitten,0,0,2,2
51151,publicidade,0,0,2,2
30998,lezzetli,0,0,2,2
5740,beta,0,0,2,2
49893,işler,0,0,2,2
52178,dicen,0,0,2,2
36727,الفيلم,0,0,2,2
5753,siècles,0,0,2,2
36713,manipular,0,0,2,2
24281,remonter,0,0,2,2
24205,الموضوعات,0,0,2,2
1218,dimenticare,1,2,0,2
32164,decirles,0,0,2,2
24224,рендеринга,0,0,2,2
19373,konuda,0,0,2,2
48859,söt,0,0,2,2
24221,algún,0,0,2,2
5767,instructions,0,0,2,2
24219,हास्य,0,0,2,2
36702,والآن,0,0,2,2
36704,أنشأ,0,0,2,2
5763,anonyma,0,0,2,2
106,cunningham,2,1,1,2
30989,formar,0,0,2,2
30990,каждый,0,0,2,2
39882,ganzen,0,0,2,2
1954,παιδεία,2,1,1,2
19434,lolicon,0,0,2,2
19435,holdout,0,0,2,2
24184,മനസ്സിൽ,0,0,2,2
5730,perteneciente,0,0,2,2
31006,cuyas,0,0,2,2
19465,parmaklar,0,0,2,2
32150,ഇതെല്ലാം,0,0,2,2
36742,«я,0,0,2,2
36745,உழைப்பது,0,0,2,2
51157,रखना।,0,0,2,2
39824,вообще,0,0,2,2
19483,condutas,0,0,2,2
19484,habilidades,0,0,2,2
36747,instruktioner,0,0,2,2
5720,compose,0,0,2,2
31012,llorar,0,0,2,2
39818,unidas,0,0,2,2
32145,hat.,0,0,2,2
39841,avis.,0,0,2,2
24173,hit,0,0,2,2
4164,prenditi,1,2,0,2
19449,fortsätter,0,0,2,2
24181,ഉണ്ടോ,0,0,2,2
31002,கடன்,0,0,2,2
39851,لتكون,0,0,2,2
39850,wisdom,0,0,2,2
19447,stötte,0,0,2,2
19448,ಪದಗಳಲ್ಲಿ,0,0,2,2
32153,മാറ്റം,0,0,2,2
103,fronte,1,2,0,2
32152,ούτως,0,0,2,2
36732,विश्वकोशों,0,0,2,2
36733,الحرة,0,0,2,2
19454,krav,0,0,2,2
39847,सुनहरे,0,0,2,2
36734,edits.,0,0,2,2
19368,சொன்னால்,0,0,2,2
39904,pocos,0,0,2,2
39910,இருப்பினும்,0,0,2,2
48838,larousse,0,0,2,2
19273,terrível,0,0,2,2
19274,sowohl,0,0,2,2
39965,parvient,0,0,2,2
24268,ним,0,0,2,2
48835,donations,0,0,2,2
19285,longue,0,0,2,2
4149,articolo,1,2,0,2
36671,inclusão,0,0,2,2
39956,swartz,0,0,2,2
19291,ninguém,0,0,2,2
30963,λένε.,0,0,2,2
51562,заранее,0,0,2,2
49901,أجمل,0,0,2,2
19298,profound,0,0,2,2
30964,aussehen,0,0,2,2
1212,lamentarti,1,2,0,2
30959,recebeu,0,0,2,2
5810,« décisions »,0,0,2,2
5817,climatic,0,0,2,2
19246,terceira,0,0,2,2
19247,health-related,0,0,2,2
39982,appliqué,0,0,2,2
19251,digamos,0,0,2,2
36661,ниже,0,0,2,2
1991,conto,1,2,0,2
36662,ergens,0,0,2,2
30958,flux,0,0,2,2
24277,bewegen,0,0,2,2
5815,दस्तावेज़,0,0,2,2
5814,binnen,0,0,2,2
1987,continuo,1,2,0,2
19265,രണ്ടുപേരും,0,0,2,2
48829,wörtern,0,0,2,2
39949,culturel,0,0,2,2
24256,thinking,0,0,2,2
24231,durumu,0,0,2,2
32173,ಸಂತೋಷದ,0,0,2,2
1975,l'angelo,1,2,0,2
19334,दोहराने,0,0,2,2
24241,виду,0,0,2,2
19340,skärmar.,0,0,2,2
19342,concluded,0,0,2,2
48851,toi.,0,0,2,2
39918,اعتني,0,0,2,2
1217,ritiene,1,2,0,2
48853,finales,0,0,2,2
19353,முனை,0,0,2,2
1974,multimediali,1,2,0,2
39912,достаточно,0,0,2,2
30976,സേവനങ്ങൾ,0,0,2,2
19357,ruimte,0,0,2,2
19358,escala,0,0,2,2
5782,l’utilisation,0,0,2,2
52176,motivos,0,0,2,2
19329,ഉണ്ടെങ്കിൽ,0,0,2,2
36681,running,0,0,2,2
1978,ragazzi.,1,2,0,2
36680,वर्तनी,0,0,2,2
5795,ಬಳಸಿ,0,0,2,2
19312,numara,0,0,2,2
5791,ಹೇಗೆ,0,0,2,2
32170,स्पष्ट,0,0,2,2
48845,roots,0,0,2,2
32169,hänvisar,0,0,2,2
39934,απαντήσετε,0,0,2,2
5787,assouline,0,0,2,2
39933,vandalism-prone,0,0,2,2
24246,صلاحيات,0,0,2,2
39931,restaurante,0,0,2,2
5786,الملاك,0,0,2,2
5920,gideceksin,0,0,2,2
40157,experiente,0,0,2,2
24411,lila,0,0,2,2
1152,pubblicare,1,2,0,2
24599,sediments,0,0,2,2
6082,моментом,0,0,2,2
18617,etablerade,0,0,2,2
32272,düşünebilirsiniz.,0,0,2,2
36450,suche,0,0,2,2
48648,sentados,0,0,2,2
6078,apparaît,0,0,2,2
18626,click,0,0,2,2
40401,incorporam,0,0,2,2
18628,τέσσερα,0,0,2,2
48650,blocage,0,0,2,2
6075,esto.,0,0,2,2
18634,извините.,0,0,2,2
18635,சொன்னேன்,0,0,2,2
18636,toi,0,0,2,2
18613,bekæmpe,0,0,2,2
48644,للشك,0,0,2,2
18707,focusing,0,0,2,2
48643,iii,0,0,2,2
30797,ii,0,0,2,2
140,padre,2,1,1,2
2089,lanciata,1,2,0,2
51596,баз,0,0,2,2
40424,தெரியவில்லை.,0,0,2,2
24613,portugués,0,0,2,2
18589,पेश,0,0,2,2
18591,mvs,0,0,2,2
4118,note,2,1,1,2
18598,اللجنة,0,0,2,2
30799,allvar,0,0,2,2
40415,agradecendo,0,0,2,2
2086,soluzioni,1,2,0,2
48642,sexism,0,0,2,2
2085,preciso,2,1,1,2
48653,tasks.,0,0,2,2
18638,carga,0,0,2,2
40396,रहती,0,0,2,2
2077,problematica,1,2,0,2
18671,сомнение,0,0,2,2
40377,capazes,0,0,2,2
40375,skål,0,0,2,2
18678,udelukkende,0,0,2,2
18681,தாய்,0,0,2,2
18685,l'exemple,0,0,2,2
52152,physician,0,0,2,2
40368,mí.,0,0,2,2
36470,أثناء,0,0,2,2
18697,preocupaciones,0,0,2,2
40360,السياسات,0,0,2,2
4123,avvenimenti,1,2,0,2
6047,செய்திருந்தால்,0,0,2,2
40358,prenez,0,0,2,2
40355,lycka,0,0,2,2
18669,रो,0,0,2,2
30811,ಇನ್ನೊಂದನ್ನು,0,0,2,2
18665,الذكور,0,0,2,2
48656,iria,0,0,2,2
1155,mette,1,2,0,2
48654,glaube,0,0,2,2
40393,política.,0,0,2,2
18645,gördüğünü,0,0,2,2
51592,kampen,0,0,2,2
18648,nações,0,0,2,2
30808,أنحاء,0,0,2,2
2076,terribile,1,2,0,2
18653,verstaan.,0,0,2,2
18654,என்பதால்,0,0,2,2
18656,conclusión,0,0,2,2
18657,ζούσε,0,0,2,2
32269,исследователей,0,0,2,2
48659,månaden.,0,0,2,2
2091,responsabile,1,2,0,2
18580,золота,0,0,2,2
18579,сделано,0,0,2,2
48611,bonnes,0,0,2,2
40482,petit,0,0,2,2
6141,ಹೇಗಿದ್ದೀರಿ,0,0,2,2
145,festa,2,1,1,2
40478,wetland,0,0,2,2
18501,plads.,0,0,2,2
18504,verward,0,0,2,2
40474,'αυτό.,0,0,2,2
2100,sistemici,1,2,0,2
24645,weekenden,0,0,2,2
4113,accessibile,1,2,0,2
48606,الأفضل,0,0,2,2
40470,stoor,0,0,2,2
18514,चलाने,0,0,2,2
30777,सुखद,0,0,2,2
48610,assets,0,0,2,2
18492,குறிப்பிடலாம்.,0,0,2,2
40483,planlar,0,0,2,2
36414,пальцы,0,0,2,2
24665,squared,0,0,2,2
51085,تفهم,0,0,2,2
40507,ifade.,0,0,2,2
40505,രേഖകൾ,0,0,2,2
36404,michel,0,0,2,2
36405,móvil,0,0,2,2
40502,harmful,0,0,2,2
36406,rise,0,0,2,2
48598,अगस्त,0,0,2,2
24661,criada,0,0,2,2
18475,सुभाषितों,0,0,2,2
18476,matemática,0,0,2,2
40493,मेजबानी,0,0,2,2
24657,lien,0,0,2,2
6145,switch,0,0,2,2
18517,έφτασε,0,0,2,2
24643,philosophes,0,0,2,2
40430,l’accès,0,0,2,2
48614,volledig,0,0,2,2
18547,αστειεύεσαι,0,0,2,2
48622,отметил,0,0,2,2
40447,كمشروع,0,0,2,2
24629,enfermedades,0,0,2,2
24628,занят.,0,0,2,2
30789,нее,0,0,2,2
40444,bent.,0,0,2,2
18556,recebendo,0,0,2,2
40443,fines,0,0,2,2
24627,словом,0,0,2,2
6100,παρακαλούμε,0,0,2,2
18569,ανησυχούσε,0,0,2,2
6098,طبعة,0,0,2,2
30796,språkversionerna,0,0,2,2
18577,vanderbilt,0,0,2,2
40450,फ्री,0,0,2,2
18545,kaldım,0,0,2,2
48621,genial.,0,0,2,2
40456,share-alike,0,0,2,2
6125,har.,0,0,2,2
6124,kardeş,0,0,2,2
18526,troublesome,0,0,2,2
6122,zu.,0,0,2,2
32286,jongen,0,0,2,2
24636,политик,0,0,2,2
6119,ಮೂರು,0,0,2,2
30784,mutation,0,0,2,2
24635,lärt,0,0,2,2
32285,stored,0,0,2,2
18539,فما,0,0,2,2
24633,rode,0,0,2,2
24632,-ൽ,0,0,2,2
51088,japonês,0,0,2,2
24562,thanks,0,0,2,2
49921,varies,0,0,2,2
24412,ഭയാനകമായ,0,0,2,2
5968,лицензией,0,0,2,2
5966,executive,0,0,2,2
36543,samtale,0,0,2,2
36544,വിശദീകരിക്കുന്നു.,0,0,2,2
40229,suggestions.,0,0,2,2
51114,internas,0,0,2,2
48728,viktiga,0,0,2,2
40226,പ്രസിദ്ധമായ,0,0,2,2
18892,അടിസ്ഥാനമാക്കി,0,0,2,2
1175,tradizionale,1,2,0,2
18895,mot-valise,0,0,2,2
18898,ആവർത്തിക്കാമോ,0,0,2,2
40222,desarrolló,0,0,2,2
48732,fácilmente,0,0,2,2
30873,समतुल्य,0,0,2,2
51116,التحدث,0,0,2,2
18880,يوليو,0,0,2,2
18877,stegbauer,0,0,2,2
24559,восстановить,0,0,2,2
36539,agency,0,0,2,2
40268,sammanhang.,0,0,2,2
30859,ഇല്ലാതെ,0,0,2,2
18845,आवश्यक,0,0,2,2
2053,proceedings,2,1,1,2
51584,سيجنثالر،,0,0,2,2
40250,tone,0,0,2,2
40249,probably,0,0,2,2
48721,ir.,0,0,2,2
40245,television,0,0,2,2
30866,säg,0,0,2,2
24479,அம்மாவாக,0,0,2,2
24478,kesinlikle,0,0,2,2
2045,pratica.,1,2,0,2
5969,ihn,0,0,2,2
24477,pequeños,0,0,2,2
1176,diffuse.,2,1,1,2
36552,meta,0,0,2,2
30875,travlt,0,0,2,2
18917,zat,0,0,2,2
18957,suivi,0,0,2,2
2033,gergo,1,2,0,2
32222,«punto,0,0,2,2
30889,परस्पर,0,0,2,2
18969,estés,0,0,2,2
36575,planos,0,0,2,2
18971,universitetet,0,0,2,2
5927,collect,0,0,2,2
5926,descartes.,0,0,2,2
40168,selvfølgelig,0,0,2,2
52165,beseffen,0,0,2,2
2032,-pedia,1,2,0,2
36577,relied,0,0,2,2
5923,النزاعات,0,0,2,2
5922,préstamo,0,0,2,2
30887,sensitivity,0,0,2,2
24430,വിജ്ഞാനകോശത്തിന്റെ,0,0,2,2
5940,accommodate,0,0,2,2
24448,дополнительный,0,0,2,2
2036,niente.,1,2,0,2
18919,оригинальных,0,0,2,2
32231,jornalistas,0,0,2,2
5953,зависимости,0,0,2,2
48739,médical,0,0,2,2
40204,echt.,0,0,2,2
32227,πήγαν,0,0,2,2
18949,என்னவென்று,0,0,2,2
36560,plates,0,0,2,2
36562,स्वर,0,0,2,2
24443,الأمثلة,0,0,2,2
32226,beskrev,0,0,2,2
24436,propensos,0,0,2,2
40187,slutet,0,0,2,2
2055,abbia,1,2,0,2
18833,sit,0,0,2,2
32242,starten,0,0,2,2
32257,மாற்றப்பட்டது.,0,0,2,2
18742,журнал,0,0,2,2
40328,ifadesi,0,0,2,2
18745,erzählt,0,0,2,2
40326,sept,0,0,2,2
24542,primært,0,0,2,2
18750,missão,0,0,2,2
18751,gutaussehend,0,0,2,2
2067,recoba,1,2,0,2
36496,издания,0,0,2,2
6030,menace,0,0,2,2
1159,osservare,1,2,0,2
51103,подумать.,0,0,2,2
36499,artiklarna.,0,0,2,2
18759,trevlig,0,0,2,2
18761,eukaryotic,0,0,2,2
40329,existent,0,0,2,2
40330,culturele,0,0,2,2
48681,expected,0,0,2,2
6035,പുസ്തകം,0,0,2,2
32261,l’a,0,0,2,2
6040,acha,0,0,2,2
36480,emner.,0,0,2,2
36482,notability,0,0,2,2
40344,ಪಾಠಗಳನ್ನು,0,0,2,2
4128,mille.,1,2,0,2
18727,coloquial,0,0,2,2
40334,associate,0,0,2,2
40338,yasal,0,0,2,2
6034,primarily,0,0,2,2
18730,веб,0,0,2,2
18733,μαρμελάδα,0,0,2,2
40335,trodde,0,0,2,2
18735,glass,0,0,2,2
2063,andasse,1,2,0,2
30832,publikationer.,0,0,2,2
40272,அனுப்ப,0,0,2,2
40314,animar,0,0,2,2
36516,பொருள்.,0,0,2,2
51588,alexandre,0,0,2,2
40292,infantil,0,0,2,2
36518,коммерческой,0,0,2,2
30843,hast.,0,0,2,2
30844,courantes,0,0,2,2
6004,ತಾಯಿಯನ್ನು,0,0,2,2
18811,inquiète,0,0,2,2
18814,சரியான,0,0,2,2
5998,ನಿಧಾನವಾಗಿದೆ,0,0,2,2
15005,noms,0,0,2,2
40279,visitantes,0,0,2,2
24503,rank,0,0,2,2
30853,schelen,0,0,2,2
24501,rüyaydı,0,0,2,2
36512,पेज,0,0,2,2
30840,നൽകാൻ,0,0,2,2
24518,ഞങ്ങളുടെ,0,0,2,2
18777,förhand,0,0,2,2
24531,switched,0,0,2,2
18771,neurales,0,0,2,2
18772,kartor,0,0,2,2
18773,falls,0,0,2,2
6020,الليلة,0,0,2,2
18776,γνωρίζετε,0,0,2,2
24528,twelve,0,0,2,2
18794,extensas,0,0,2,2
30835,agradable,0,0,2,2
18782,piensa,0,0,2,2
48695,ταξίδι,0,0,2,2
18787,edited,0,0,2,2
24523,maakte,0,0,2,2
40303,مساعدتك,0,0,2,2
1945,incontro,1,2,0,2
39814,weet.,0,0,2,2
5226,jongens,0,0,2,2
23819,λικνίζεις,0,0,2,2
31178,основана,0,0,2,2
20191,abajo,0,0,2,2
1834,autonomamente,1,2,0,2
20197,indépendante,0,0,2,2
39354,distintos,0,0,2,2
31183,reorganized,0,0,2,2
51221,solicitações,0,0,2,2
49862,erişim,0,0,2,2
36983,occident,0,0,2,2
23804,relatou,0,0,2,2
23803,niemand,0,0,2,2
20218,рассылки,0,0,2,2
23801,கொடூரமானவை,0,0,2,2
23799,حال.,0,0,2,2
23798,souligner,0,0,2,2
23817,instituto,0,0,2,2
5394,التالي,0,0,2,2
31172,werkt,0,0,2,2
20184,advent,0,0,2,2
23833,facebook.,0,0,2,2
5406,ಪುನರಾವರ್ತಿಸಬಹುದೇ,0,0,2,2
20162,microorganisms,0,0,2,2
49099,تسير,0,0,2,2
23829,intrusion,0,0,2,2
39377,label,0,0,2,2
31174,что-нибудь,0,0,2,2
39375,vi.,0,0,2,2
49101,java,0,0,2,2
39373,ثمانية,0,0,2,2
20176,escuchando,0,0,2,2
20179,gebruik.,0,0,2,2
39370, млн,0,0,2,2
23821,تنزعج,0,0,2,2
5397,diseñador,0,0,2,2
20225,ಭಯ,0,0,2,2
31189,πούμε,0,0,2,2
20229,ميليسا,0,0,2,2
20231,ήμασταν,0,0,2,2
23775,എവിടെ,0,0,2,2
31204,ابنتها,0,0,2,2
39306,convey,0,0,2,2
39305,darle,0,0,2,2
32022,naturelles,0,0,2,2
49139,guld.,0,0,2,2
5351,prisons,0,0,2,2
20283,mermelada,0,0,2,2
39301,informática.,0,0,2,2
1821,studi,1,2,0,2
5349,незамедлительно,0,0,2,2
5348,iyi.,0,0,2,2
5347,परी,0,0,2,2
20291,காணப்படும்,0,0,2,2
5346,تسمع,0,0,2,2
39310,biographies,0,0,2,2
20269,making.,0,0,2,2
20268,tex,0,0,2,2
49127,preserves,0,0,2,2
20232,portmanteau,0,0,2,2
23794,извиниться,0,0,2,2
20238,والزاوية,0,0,2,2
31193,organization.,0,0,2,2
31196,faktorer,0,0,2,2
51226,ανησυχείς,0,0,2,2
39325,desculpe.,0,0,2,2
39316,മാർഗമാണ്,0,0,2,2
20252,प्रदर्शित,0,0,2,2
1823,marvin,1,2,0,2
31198,ستحصل,0,0,2,2
20256,अस्वीकार,0,0,2,2
31200,ಮನಸ್ಸಿನಲ್ಲಿ,0,0,2,2
32023,ജനകീയ,0,0,2,2
23834,фразы,0,0,2,2
31171,பயன்படுகிறது,0,0,2,2
19497,henry,0,0,2,2
31150,своего,0,0,2,2
32051,മൂന്ന്,0,0,2,2
23874,журнале,0,0,2,2
39435,функции,0,0,2,2
20073,felaktig,0,0,2,2
20075,τύπο,0,0,2,2
5437,ஆர்வம்,0,0,2,2
20080,حلمًا,0,0,2,2
39430,اسمها,0,0,2,2
5436,superior,0,0,2,2
49077,iedere,0,0,2,2
51207,advertisements,0,0,2,2
31158,frau,0,0,2,2
39427,baseras,0,0,2,2
20090,دواعي,0,0,2,2
39426,satire,0,0,2,2
23875,puedan,0,0,2,2
4209,പതുക്കെ,0,0,2,2
51213,organisatie,0,0,2,2
5447,جذر,0,0,2,2
39466,trendline,0,0,2,2
51203,зарегистрированы,0,0,2,2
5460,واسعة,0,0,2,2
23889,standards,0,0,2,2
36928,വഴികൾ,0,0,2,2
39459,விரும்பவில்லை.,0,0,2,2
20040,hjem.,0,0,2,2
1858,eravamo,1,2,0,2
31145,jämföra,0,0,2,2
39453,l'utilisateur,0,0,2,2
5453,الأستاذ,0,0,2,2
39452,read,0,0,2,2
39450,capables,0,0,2,2
32052,smaragden,0,0,2,2
20056,operated,0,0,2,2
23865,ಬಂದರು,0,0,2,2
5430,creativity,0,0,2,2
23863,herinde,0,0,2,2
23862,പദാവലി,0,0,2,2
20131,alleges,0,0,2,2
1846,parlamento,2,1,1,2
20134,λόγους.,0,0,2,2
31165,oprindeligt,0,0,2,2
20137,trace,0,0,2,2
20138,платье,0,0,2,2
23841,விற்றீர்கள்,0,0,2,2
39395,percepção,0,0,2,2
49089,asia.,0,0,2,2
20145,பிரமாதமான,0,0,2,2
32042,exactly,0,0,2,2
20147,stallman.,0,0,2,2
49093,كتب,0,0,2,2
84,editori,1,2,0,2
39388,l'idée,0,0,2,2
20130,मुश्किल,0,0,2,2
23845,assist,0,0,2,2
39404,எல்லாம்,0,0,2,2
1271,assume,2,1,1,2
20097,würdest,0,0,2,2
49081,sugeriu,0,0,2,2
20103,ഇങ്ങനെ,0,0,2,2
20104,wurzel,0,0,2,2
1849,garantire,1,2,0,2
39418,свободно,0,0,2,2
39414,exempel.,0,0,2,2
23847,ans,0,0,2,2
39413,temps.,0,0,2,2
5428,sabah,0,0,2,2
20115,ಬಹುತೇಕ,0,0,2,2
49083,imparcialidade,0,0,2,2
5424,prepared,0,0,2,2
39407,sie.,0,0,2,2
20294,güvenilir,0,0,2,2
20298,carnegie-mellon,0,0,2,2
20300,ಐಕಾನ್,0,0,2,2
5275,muntra,0,0,2,2
23696,تناوله,0,0,2,2
20452,अर्थात,0,0,2,2
31996,про,0,0,2,2
20454,mitad,0,0,2,2
49852,மகிழ்ச்சியாக,0,0,2,2
5270,röra,0,0,2,2
5269,publicada,0,0,2,2
20458,महल,0,0,2,2
37053,coberto,0,0,2,2
20464,voorbeeld,0,0,2,2
20465,καιρό,0,0,2,2
31250,appareil,0,0,2,2
37056,சரி,0,0,2,2
23682,lämpligt,0,0,2,2
51252,yankovic,0,0,2,2
31997,ಹೆಚ್ಚಿನ,0,0,2,2
20444,erhalten,0,0,2,2
37007,உண்மையிலேயே,0,0,2,2
31244,affaires,0,0,2,2
5286,സുന്ദരനുമാണ്,0,0,2,2
1795,traguardo,1,2,0,2
5284,تدرك,0,0,2,2
39218,tijdje,0,0,2,2
49178,correcciones,0,0,2,2
23707,ilegal,0,0,2,2
23706,acuñado,0,0,2,2
49179,preguntas,0,0,2,2
23704,locuteurs,0,0,2,2
51509,எவ்வளவு,0,0,2,2
20435,knol,0,0,2,2
49180,അടിസ്ഥാന,0,0,2,2
32000,ಉತ್ತಮವಾಗಿ,0,0,2,2
20441,absoluto.,0,0,2,2
31999,голоден,0,0,2,2
39188,aktualitet.,0,0,2,2
5260,sujette,0,0,2,2
31992,origens,0,0,2,2
75,cura,1,2,0,2
39156,intensifier,0,0,2,2
31263,mágico,0,0,2,2
1299,scrivono,1,2,0,2
39154,crossbar,0,0,2,2
20533,exakt,0,0,2,2
1764,davvero.,1,2,0,2
31265,oft,0,0,2,2
20536,ato,0,0,2,2
49206,fehler,0,0,2,2
20539,amendement,0,0,2,2
20540,وإرشادات,0,0,2,2
23650,independence,0,0,2,2
49208,സംഭവിക്കുന്നതെന്ന്,0,0,2,2
37082,मंडल,0,0,2,2
39146,opdagelser,0,0,2,2
39159,print,0,0,2,2
1771,amiche,1,2,0,2
23661,жизнь,0,0,2,2
20497,abonneerknop,0,0,2,2
20483,biliyorum,0,0,2,2
1777,dirmi,1,2,0,2
20488,riparian,0,0,2,2
1776,temporaneo,1,2,0,2
5250,citados,0,0,2,2
5249,переход,0,0,2,2
49197,источником,0,0,2,2
39164,fifty,0,0,2,2
5246,tages,0,0,2,2
5245,skruede,0,0,2,2
23668,l’environnement,0,0,2,2
20509,digite,0,0,2,2
20513,pornography,0,0,2,2
49201,देशों,0,0,2,2
23710,durant,0,0,2,2
23711,dulce,0,0,2,2
5287,टाटर,0,0,2,2
20356,منهم،,0,0,2,2
1816,ciascuno,1,2,0,2
23758,globalement,0,0,2,2
23757,utilise,0,0,2,2
39278,lancer,0,0,2,2
51231,consider,0,0,2,2
23753,incorporated,0,0,2,2
32015,mooie,0,0,2,2
39272,مرتبطة,0,0,2,2
20341,formal.,0,0,2,2
39271,செய்யப்,0,0,2,2
32014,racist,0,0,2,2
31219,atribución,0,0,2,2
37017,и т. п.,0,0,2,2
5319,horrível,0,0,2,2
23746,diario,0,0,2,2
39282,sommaren,0,0,2,2
20324,autriche,0,0,2,2
20323,won,0,0,2,2
1817,nodi,1,2,0,2
39291,experimento,0,0,2,2
20304,ചെയ്യുന്നതും,0,0,2,2
39290,रिचर्ड,0,0,2,2
20307,verwijderd,0,0,2,2
20308,stødte,0,0,2,2
5337,intervjun,0,0,2,2
49144,السرية,0,0,2,2
49151,сан-франциско,0,0,2,2
20312,итак,0,0,2,2
23764,precisos,0,0,2,2
20317,redigere,0,0,2,2
31214,bericht,0,0,2,2
37009,dichas,0,0,2,2
5328,chaotic,0,0,2,2
37018,aanbieden.,0,0,2,2
1809,libertà,1,2,0,2
37041,തരാമോ,0,0,2,2
23741,edemem,0,0,2,2
1803,temporale,1,2,0,2
5298,reconocimiento,0,0,2,2
20394,modify,0,0,2,2
39237,tenham,0,0,2,2
5295,americana.,0,0,2,2
1802,comuni,1,2,0,2
5293,இணைப்புக்கள்,0,0,2,2
32004,beskriva,0,0,2,2
1800,interno,2,1,1,2
20405,lire,0,0,2,2
23722,долларов,0,0,2,2
23721,புகார்,0,0,2,2
23719,beslutning,0,0,2,2
5290,brincando,0,0,2,2
37040,bon.,0,0,2,2
51512,ब्रांड,0,0,2,2
23730,الفور.,0,0,2,2
31233,ampliación,0,0,2,2
20372,ترى,0,0,2,2
20362,بيانات,0,0,2,2
23740,wikiwiki,0,0,2,2
5309,diagram,0,0,2,2
20365,'போமிஸ்',0,0,2,2
20370,fonction,0,0,2,2
49166,protocol,0,0,2,2
20373,иметь,0,0,2,2
5301,ans.,0,0,2,2
37024,சந்திக்க,0,0,2,2
31231,simplesmente,0,0,2,2
20378,j'espère,0,0,2,2
5303,mágicos,0,0,2,2
20381,olduğunuzu,0,0,2,2
37027,explicit,0,0,2,2
23892,continuación,0,0,2,2
39469,déconcertés,0,0,2,2
5471,பிரகாசமான,0,0,2,2
5641,عنك,0,0,2,2
32115,space.,0,0,2,2
51546,identification,0,0,2,2
1918,modificare,1,2,0,2
19689,проектом,0,0,2,2
32113,cross,0,0,2,2
39684,median,0,0,2,2
1917,salto,2,1,1,2
39681,μέλι,0,0,2,2
39680,தோற்றம்,0,0,2,2
19698,personajes,0,0,2,2
36826,ones,0,0,2,2
19703,fichas,0,0,2,2
31063,മറ്റെന്തെങ്കിലും,0,0,2,2
39674,josé,0,0,2,2
48957,latinsk,0,0,2,2
36821,februar,0,0,2,2
24054,सो,0,0,2,2
5588,conjunta,0,0,2,2
5643,संकलन,0,0,2,2
31047,pairs.,0,0,2,2
4180,dizionario,1,2,0,2
5651,limitadas,0,0,2,2
32121,possibles.,0,0,2,2
31050,acerca,0,0,2,2
39707,funcionava,0,0,2,2
19660,d'expérience,0,0,2,2
19661,όλο,0,0,2,2
19663,மாற்றங்களை,0,0,2,2
19665,automatizado,0,0,2,2
24062,വാരാന്ത്യത്തിൽ,0,0,2,2
32119,underlätta,0,0,2,2
39702,बल्कि,0,0,2,2
39700,хлеба,0,0,2,2
24059,லத்தீன்,0,0,2,2
19709,نصف,0,0,2,2
36830,trick,0,0,2,2
36831,acciones,0,0,2,2
5625,समानांतर,0,0,2,2
24021,coordinated,0,0,2,2
19747,existantes,0,0,2,2
5607,исходя,0,0,2,2
36852,generates,0,0,2,2
48972,fjollet,0,0,2,2
5605,sais.,0,0,2,2
31072,fluido.,0,0,2,2
19761,d’algorithmes,0,0,2,2
5598,val,0,0,2,2
36856,princip,0,0,2,2
31076,relationship,0,0,2,2
19768,aim,0,0,2,2
5594,sådan.,0,0,2,2
31077,عشرة,0,0,2,2
32100,gibisin,0,0,2,2
1908,presentare,1,2,0,2
19739,linguistiques.,0,0,2,2
4183,pari,1,2,0,2
36836,transfer,0,0,2,2
19715,precisión,0,0,2,2
19716,directions,0,0,2,2
19717,birbirlerinin,0,0,2,2
39668,भरोसा,0,0,2,2
36833,വിവരം,0,0,2,2
48961,कंप्यूटर,0,0,2,2
48964,حلمها,0,0,2,2
36843,operations,0,0,2,2
48965,тот,0,0,2,2
19731,verstaan,0,0,2,2
36841,constar,0,0,2,2
5614,cultures,0,0,2,2
39656,تكراره,0,0,2,2
19735,चूंकि,0,0,2,2
19648,copier,0,0,2,2
31046,तुमने,0,0,2,2
39718,irrelevant,0,0,2,2
32133,الجمعة,0,0,2,2
19544,/ˌwɪkɪˈpiːdiə/,0,0,2,2
1232,inserito,1,2,0,2
24126,situations.,0,0,2,2
19549,विस्तृत,0,0,2,2
101,avuto,1,2,0,2
31026,drives,0,0,2,2
4172,piace,1,2,0,2
5687,görüşürüz.,0,0,2,2
24117,nederländska,0,0,2,2
31028,gyldne,0,0,2,2
24111,grecs,0,0,2,2
19571,består,0,0,2,2
24107,fait.,0,0,2,2
19576,hjemme,0,0,2,2
39762,participar,0,0,2,2
5700,recomponha,0,0,2,2
19539,onthoud,0,0,2,2
1935,mondiale,2,1,1,2
39804,stone,0,0,2,2
5712,ser.,0,0,2,2
1943,certamente,2,1,1,2
39807,βικινέα,0,0,2,2
5709,relicense,0,0,2,2
19511,ಧ್ವನಿಸಲು,0,0,2,2
48905,hayatında,0,0,2,2
1941,principali,1,2,0,2
51163,स्थित,0,0,2,2
39802,precies,0,0,2,2
24144,ಸ್ವರ್ಗ,0,0,2,2
5703,الوقت.,0,0,2,2
24139,strong,0,0,2,2
19529,skoja,0,0,2,2
19532,names,0,0,2,2
19579,sistémicos,0,0,2,2
24104,så.,0,0,2,2
31043,fois.,0,0,2,2
19582,waarmee,0,0,2,2
39736,dinner,0,0,2,2
39735,relativt,0,0,2,2
19624,invitation,0,0,2,2
98,distribuire,1,2,0,2
19626,дальнейшем,0,0,2,2
32125,சந்தா,0,0,2,2
24082,balance,0,0,2,2
4175,modificate,1,2,0,2
5664,esplanada,0,0,2,2
1922,almeno,1,2,0,2
19636,редактируют,0,0,2,2
19637,organizan,0,0,2,2
19638,தனிப்பட்ட,0,0,2,2
48931,ramène,0,0,2,2
36806,domaines,0,0,2,2
39737,ξέρεις.,0,0,2,2
1240,l'errore,1,2,0,2
32127,veelvoorkomende,0,0,2,2
48925,फाउनडेशन,0,0,2,2
19585,बताते,0,0,2,2
39754,drømme,0,0,2,2
1235,vincolate,1,2,0,2
19593,книгу,0,0,2,2
48923,bloqueio,0,0,2,2
51551,criticado,0,0,2,2
19601,relaciones,0,0,2,2
39740,accès,0,0,2,2
5672,ينتهك,0,0,2,2
19604,öppet,0,0,2,2
19609,förvirrad,0,0,2,2
39744,rigor,0,0,2,2
24090,feeling,0,0,2,2
5669,minuten,0,0,2,2
19774,paris,0,0,2,2
36861,continuar.,0,0,2,2
20021,convencional,0,0,2,2
36902,stumpfe,0,0,2,2
19934,olduğuna,0,0,2,2
32074,صفحاتها,0,0,2,2
39522,resolve,0,0,2,2
19937,jornalismo,0,0,2,2
52185,محمية,0,0,2,2
23931,рамках,0,0,2,2
5513,последний,0,0,2,2
32071,couverture,0,0,2,2
5508,conter,0,0,2,2
19950,coolt,0,0,2,2
19952,mir.,0,0,2,2
1260,subì,1,2,0,2
5502,ene,0,0,2,2
19956,gjorts,0,0,2,2
36912,ടെറി,0,0,2,2
23934,rich,0,0,2,2
39527,poucas,0,0,2,2
24003,alltså,0,0,2,2
5520,soruyorum,0,0,2,2
19899,miguel,0,0,2,2
39541,fini,0,0,2,2
19901,questioned,0,0,2,2
19902,reis,0,0,2,2
49018,அங்கு,0,0,2,2
36897,pronunciación,0,0,2,2
19916,dansk,0,0,2,2
39531,disponen,0,0,2,2
19920,говорит,0,0,2,2
5524,научные,0,0,2,2
1259,direzione,1,2,0,2
4196,tono,2,1,1,2
1888,francese,1,2,0,2
49025,oldu,0,0,2,2
1887,dai.,1,2,0,2
23922,påverkas,0,0,2,2
19960,لك.,0,0,2,2
39510,bevor,0,0,2,2
52187,avhandlingen,0,0,2,2
1870,philip,2,1,1,2
19991,साबित,0,0,2,2
23905,henne,0,0,2,2
51200,manufactured,0,0,2,2
32064,знаете.,0,0,2,2
23902,teknolojileri,0,0,2,2
32063,लिंक,0,0,2,2
49050,ιδρυτή,0,0,2,2
49052,تستحق,0,0,2,2
20008,ചതുപ്പുനിലം,0,0,2,2
4204,locomotion,0,0,2,2
39478,english-speaking,0,0,2,2
49869,கட்டுரைகளைத்,0,0,2,2
51201,τζίμι,0,0,2,2
39471,ആദ്യം,0,0,2,2
19988,സ്വർഗ്ഗം,0,0,2,2
23907,esqueça,0,0,2,2
23908,licentie,0,0,2,2
5494,revisions,0,0,2,2
51196,telegrama,0,0,2,2
4200,klinken.,0,0,2,2
49042,onderdeel,0,0,2,2
19969,después.,0,0,2,2
23917,المهام,0,0,2,2
36915,gibisin.,0,0,2,2
31126,faites-le,0,0,2,2
39493,تعال,0,0,2,2
51532,कस्टम-निर्मित,0,0,2,2
23914,soon,0,0,2,2
19976,poèmes,0,0,2,2
1873,passato,1,2,0,2
51199,സ്വാഗതം.,0,0,2,2
23910,needs,0,0,2,2
23948,trying,0,0,2,2
39543,plek,0,0,2,2
39544,flowing,0,0,2,2
36876,reports.,0,0,2,2
39601,pública,0,0,2,2
19812,أخذ,0,0,2,2
19813,மந்தமாக,0,0,2,2
19814,നിന്നെ,0,0,2,2
31090,desigual,0,0,2,2
32091,assignments,0,0,2,2
39595,घटना,0,0,2,2
23984,nätverk,0,0,2,2
36873,constitutes,0,0,2,2
48996,descola,0,0,2,2
39591,complémentarité,0,0,2,2
31092,അഭിപ്രായം,0,0,2,2
51537,spiel,0,0,2,2
19829,ജൂൺ,0,0,2,2
52183,случаях,0,0,2,2
1901,esattamente,1,2,0,2
31086,يقول,0,0,2,2
23990,permanecer,0,0,2,2
19792,आंशिक,0,0,2,2
5586,aufgaben,0,0,2,2
39623,النظر,0,0,2,2
5584,وتمييز,0,0,2,2
39619,سوى,0,0,2,2
23999,kapsamlı,0,0,2,2
1903,scuola,1,2,0,2
19794,users.,0,0,2,2
19804,ಬಯಸುತ್ತೇನೆ.,0,0,2,2
5578,ಸವಾರಿ,0,0,2,2
31085,l’histoire,0,0,2,2
48987,coole,0,0,2,2
23994,تمييز,0,0,2,2
39608,forstod,0,0,2,2
19802,pertinent,0,0,2,2
19831,ಕೇಳುತ್ತಿಲ್ಲ.,0,0,2,2
48999,creek,0,0,2,2
19895,noise,0,0,2,2
23976,molestarte,0,0,2,2
49011,veía,0,0,2,2
23958,observant,0,0,2,2
1893,autorevolezza.,1,2,0,2
5541,άντρες,0,0,2,2
19877,mathématicien,0,0,2,2
39560,eleições,0,0,2,2
49013,കിടക്കുന്ന,0,0,2,2
39558,लेकर,0,0,2,2
5539,الستة,0,0,2,2
39556,rédigés,0,0,2,2
36888,libre»,0,0,2,2
5536,والعمل,0,0,2,2
39552,μπορούσε,0,0,2,2
36891,oferecido,0,0,2,2
32082,padrões,0,0,2,2
5545,redactados,0,0,2,2
5546,alter,0,0,2,2
23962,ഉത്തരവും,0,0,2,2
19846,zengin,0,0,2,2
19839,resulted,0,0,2,2
19840,undervisningen,0,0,2,2
19842,மாத்திரமே,0,0,2,2
36878,responsabilidade,0,0,2,2
23973,anúncios,0,0,2,2
23972,apoio,0,0,2,2
23970,سحرية,0,0,2,2
31102,subjects,0,0,2,2
19850,wapedia,0,0,2,2
36881,विशेषज्ञों,0,0,2,2
39572,свободы,0,0,2,2
5549,facility,0,0,2,2
1895,protette,1,2,0,2
19865,പറയാൻ‌,0,0,2,2
15007,पुस्तकों,0,0,2,2
42035,ссылался,0,0,2,2
34728,ആവശ്യപ്പെടുന്നു.,0,0,2,2
45495,honger,0,0,2,2
45494,begge,0,0,2,2
27376,свободной,0,0,2,2
44088,esperar,0,0,2,2
13074,будут,0,0,2,2
27378,pauvre,0,0,2,2
10925,ಹೆಸರು,0,0,2,2
50567,μέσα,0,0,2,2
27381,soldater,0,0,2,2
44095,எங்கிருந்தோம்,0,0,2,2
13065,l'internet,0,0,2,2
45493,energy.,0,0,2,2
9208,mainly,0,0,2,2
44096,ekmeği,0,0,2,2
8331,മാറി.,0,0,2,2
10928,betekenis,0,0,2,2
13062,எப்படிப்,0,0,2,2
13061,kibar,0,0,2,2
45491,الشكوى,0,0,2,2
504,terziaria.,1,2,0,2
13059,marche,0,0,2,2
44099,εκκαθάρισης,0,0,2,2
13057,развития,0,0,2,2
8333,kinds,0,0,2,2
10931,болото,0,0,2,2
44102,soldier,0,0,2,2
44087,க்கு,0,0,2,2
44086,م,0,0,2,2
10932,أغسطس,0,0,2,2
10922,okej.,0,0,2,2
44071,rentrer,0,0,2,2
45501,αυτούς,0,0,2,2
44072,मिलती,0,0,2,2
10911,effectively,0,0,2,2
3353,raccogliere,1,2,0,2
34591,wortschatz,0,0,2,2
9213,daquela,0,0,2,2
27364,podía,0,0,2,2
13095,مقدمًا,0,0,2,2
13094,atender,0,0,2,2
10914,области.,0,0,2,2
33054,publics,0,0,2,2
33055,worries.,0,0,2,2
9212,filmes,0,0,2,2
13089,magnífico,0,0,2,2
10916,заслуживаю,0,0,2,2
8324,ആവശ്യമാണ്.,0,0,2,2
33056,daher,0,0,2,2
13084,değiştirilmesi,0,0,2,2
10919,rejette,0,0,2,2
29667,പ്രശ്നം,0,0,2,2
46581,despedir,0,0,2,2
34585,വേഗത,0,0,2,2
51855,acusação,0,0,2,2
8328,قاموا,0,0,2,2
44103,okay.,0,0,2,2
13048,gold.,0,0,2,2
667,prima.,1,2,0,2
44122,semblaient,0,0,2,2
3027,preoccupa,1,2,0,2
46586,gpl,0,0,2,2
3351,white,2,1,1,2
47163,jeito,0,0,2,2
28415,buena.,0,0,2,2
507,ultime,2,1,1,2
50159,декабря,0,0,2,2
27403,möller,0,0,2,2
28413,personne.,0,0,2,2
29241,framstående,0,0,2,2
9196,último,0,0,2,2
29242,बढ़ती,0,0,2,2
13009,ಶಬ್ದಕೋಶವನ್ನು,0,0,2,2
47160,hou,0,0,2,2
34561,destinam-se,0,0,2,2
3620,c.,2,1,1,2
33067,ശരി,0,0,2,2
29652,жениться,0,0,2,2
13001,gerektiğini,0,0,2,2
10968,pues,0,0,2,2
33068,касается,0,0,2,2
12998,libres.,0,0,2,2
9191,acomodar,0,0,2,2
12996,vieram,0,0,2,2
27412,felaktigt,0,0,2,2
51857,supporting,0,0,2,2
13019,opérations,0,0,2,2
303,carta,2,1,1,2
13020,principais,0,0,2,2
13043,russie,0,0,2,2
8342,dá,0,0,2,2
10934,некоммерческая,0,0,2,2
3352,universale,1,2,0,2
10937,λέξης,0,0,2,2
44110,مروعًا,0,0,2,2
10939,सकते।,0,0,2,2
9206,стоимость,0,0,2,2
47169,orada,0,0,2,2
50241,écrit,0,0,2,2
46583,referenced,0,0,2,2
44113,samman,0,0,2,2
10943,ಅಸಮಾಧಾನ,0,0,2,2
9203,littéralement,0,0,2,2
13035,decided,0,0,2,2
13034,veteranos,0,0,2,2
27393,المبالغة,0,0,2,2
28423,أعلى,0,0,2,2
45483,disciplinas,0,0,2,2
8347,sehe,0,0,2,2
33894,обучения.,0,0,2,2
50564,zittrain,0,0,2,2
13025,gillade,0,0,2,2
29240,woman,0,0,2,2
13022,evenwichtig,0,0,2,2
10907,inference,0,0,2,2
3356,vendita,1,2,0,2
34592,ஆங்கிலத்தில்,0,0,2,2
9234,الاستقرائي,0,0,2,2
33040,sos,0,0,2,2
13213,s'appuyant,0,0,2,2
13211,espaço,0,0,2,2
13210,мире.,0,0,2,2
9233,ready,0,0,2,2
27308,​​eller,0,0,2,2
29226,precipitation,0,0,2,2
27310,माणिक,0,0,2,2
27311,enbart,0,0,2,2
45530,inscrição,0,0,2,2
3363,nascosti,1,2,0,2
28449,ले,0,0,2,2
27317,birleşik,0,0,2,2
44006,أسفل,0,0,2,2
47202,теории,0,0,2,2
9228,genomfördes,0,0,2,2
13192,подумать,0,0,2,2
10873,klockan,0,0,2,2
2993,atroci,1,2,0,2
33043,கோணம்,0,0,2,2
676,originali,1,2,0,2
2996,matrimonio.,2,1,1,2
44012,perfect,0,0,2,2
3761,funzioni,1,2,0,2
13183,الموضوع,0,0,2,2
27302,encyclopedic,0,0,2,2
496,crossover,2,1,1,2
27357,சொற்களைக்,0,0,2,2
297,marmellata,1,2,0,2
43962,winter,0,0,2,2
50369,प्रकट,0,0,2,2
47216,hiervoor,0,0,2,2
29221,ту,0,0,2,2
3766,interpreta,1,2,0,2
27287,വരാൻ,0,0,2,2
2984,disponibile,1,2,0,2
43968,taking,0,0,2,2
8258,متطوعين,0,0,2,2
34641,incite,0,0,2,2
13244,सम्पादक,0,0,2,2
3764,persone.,1,2,0,2
372,fornire,1,2,0,2
8262,ಇಬ್ಬರು,0,0,2,2
43978,руководств,0,0,2,2
9237,सदी,0,0,2,2
10851,рецензирования,0,0,2,2
13232,inserção,0,0,2,2
43980,tampa,0,0,2,2
43981,varma,0,0,2,2
10852,समझ,0,0,2,2
45540,décimo,0,0,2,2
27297,l’opposition,0,0,2,2
45539,പ്രിയേ,0,0,2,2
27299,mandos,0,0,2,2
8279,κακό,0,0,2,2
44014,sério.,0,0,2,2
29228,şaşkına,0,0,2,2
27324,gitmeliyim,0,0,2,2
33885,doctrine,0,0,2,2
27344,economista,0,0,2,2
29677,lower,0,0,2,2
45509,war.,0,0,2,2
29676,സ്നേഹിക്കുന്നു,0,0,2,2
13136,உணவைப்,0,0,2,2
10897,uk.,0,0,2,2
13134,anordnas,0,0,2,2
50574,ஆரம்ப,0,0,2,2
28435,تلقت,0,0,2,2
44049,hoppas,0,0,2,2
34600,incorporating,0,0,2,2
13127,bildirin.,0,0,2,2
27349,எடுத்துக்காட்டுகள்,0,0,2,2
8306,வண்டி,0,0,2,2
13123,mujeres.,0,0,2,2
29675,presents,0,0,2,2
9220,கிடைக்குமா,0,0,2,2
45506,koordinering,0,0,2,2
44056,presented,0,0,2,2
44057,भीतर,0,0,2,2
50372,skruvade,0,0,2,2
34595,ajouter,0,0,2,2
13108,торговой,0,0,2,2
13107,training.,0,0,2,2
33363,arte,0,0,2,2
44043,ಬಯಸುತ್ತೇನೆ,0,0,2,2
13145,pronúncia,0,0,2,2
34609,находятся,0,0,2,2
45522,ಖಚಿತವಾಗಿ,0,0,2,2
50370,ответов,0,0,2,2
44018,escuche,0,0,2,2
29689,describes,0,0,2,2
51852,sov,0,0,2,2
45520,يتضمن,0,0,2,2
8281,türkçe,0,0,2,2
45519,ответить,0,0,2,2
13171,objective,0,0,2,2
13167,définie,0,0,2,2
33045,محايدة,0,0,2,2
10882,தயவுசெய்து,0,0,2,2
8297,സംഭാവന,0,0,2,2
10883,planos.,0,0,2,2
27335,nahm,0,0,2,2
44030,considerable,0,0,2,2
29684,d'argent,0,0,2,2
27337,очередь,0,0,2,2
44032,financiada,0,0,2,2
44033,mundial.,0,0,2,2
3361,genetici,1,2,0,2
28442,l'année.,0,0,2,2
3360,fanno,1,2,0,2
44040,मिलेगा,0,0,2,2
27414,néerlandais,0,0,2,2
3347,servizi,1,2,0,2
12717,prises,0,0,2,2
44251,πρόγραμμα,0,0,2,2
8434,ämnet,0,0,2,2
3062,businessweek,2,1,1,2
44255,സഹായിക്കാൻ,0,0,2,2
45398,salades,0,0,2,2
50539,puedo.,0,0,2,2
50232,сетевой,0,0,2,2
8435,consistía,0,0,2,2
27509,commented,0,0,2,2
50388,audaz,0,0,2,2
44258,ചോദിക്കാൻ,0,0,2,2
27510,computador,0,0,2,2
8439,μαρία,0,0,2,2
33938,criticadas,0,0,2,2
47095,podrían,0,0,2,2
11085,pays-bas,0,0,2,2
3066,significative,1,2,0,2
12791,ലാറി,0,0,2,2
8443,വിദഗ്ദ്ധന്മാർ,0,0,2,2
12788,conservation,0,0,2,2
27515,അതായത്‌,0,0,2,2
8448,gelden,0,0,2,2
12784,giver,0,0,2,2
11090,competition,0,0,2,2
12782,exactamente,0,0,2,2
3729,sarò,1,2,0,2
44252,específicos,0,0,2,2
12812,компанией,0,0,2,2
29278,sé.,0,0,2,2
44250,récompense,0,0,2,2
34504,مستوى,0,0,2,2
34503,தரம்,0,0,2,2
12840,μοίρες,0,0,2,2
34501,hinanden,0,0,2,2
12838,bin.,0,0,2,2
34500,yardımcı,0,0,2,2
44238,مشغول,0,0,2,2
33928,വലിപ്പം,0,0,2,2
28366,термин,0,0,2,2
44240,opgaver,0,0,2,2
12831,tecnológicos,0,0,2,2
46624,എങ്കിലും,0,0,2,2
11061,narcissisme,0,0,2,2
12826,ordning,0,0,2,2
12825,проекту,0,0,2,2
12824,वैसा,0,0,2,2
34494,leyendo,0,0,2,2
28363,красота,0,0,2,2
46625,arias,0,0,2,2
11066,задачах,0,0,2,2
27502,ಸಂಧಿಸಲು,0,0,2,2
44245,geven.,0,0,2,2
51942,سعيد,0,0,2,2
47100,dom,0,0,2,2
312,processi,1,2,0,2
45384,менее,0,0,2,2
27519,medmindre,0,0,2,2
44139,iniciativa,0,0,2,2
11113,इंटरैक्टिव,0,0,2,2
11114,policyn,0,0,2,2
11115,يخبرك,0,0,2,2
3631,ecc.,1,2,0,2
12741,svms,0,0,2,2
33324,الإصدارات,0,0,2,2
316,forniscono,1,2,0,2
12739,references,0,0,2,2
44293,formuleringar,0,0,2,2
45371,électorale,0,0,2,2
3074,starò,1,2,0,2
44298,lending,0,0,2,2
9121,cruzados.,0,0,2,2
45369,ಅಸಮಾಧಾನಗೊಳ್ಳಬೇಡಿ,0,0,2,2
12729,sola,0,0,2,2
27541,ಯಾವುದು,0,0,2,2
12727,ikväll,0,0,2,2
11123,dealing,0,0,2,2
317,discovery.,2,1,1,2
27543,tartışmalar,0,0,2,2
8472,beslissing,0,0,2,2
12723,المعرضة,0,0,2,2
3075,impazzito,1,2,0,2
27544,две,0,0,2,2
27545,ideal,0,0,2,2
3313,portali,1,2,0,2
12744,ഏതാണ്,0,0,2,2
12746,cuidadosamente,0,0,2,2
12776,विध्वंसक,0,0,2,2
12748,princesa,0,0,2,2
8454,muita,0,0,2,2
34482,sought,0,0,2,2
45382,tráfico,0,0,2,2
27522,icon,0,0,2,2
12769,beteende,0,0,2,2
44275,sætte,0,0,2,2
12767,النصيحة,0,0,2,2
8457,ومع,0,0,2,2
12765,caballero,0,0,2,2
27524,semaine,0,0,2,2
639,frances,2,1,1,2
11100,ಹೊಂದಿದ್ದೇನೆ,0,0,2,2
27527,يتحقق,0,0,2,2
33944,അറിയാൻ,0,0,2,2
28341,kl.,0,0,2,2
3316,aggiuntive,1,2,0,2
50534,പരസ്പരം,0,0,2,2
11104,resistance,0,0,2,2
44285,reverte,0,0,2,2
33945,leende,0,0,2,2
11108,sebep,0,0,2,2
11109,rockt,0,0,2,2
11110,syntes,0,0,2,2
636,giornalistiche,1,2,0,2
28338,correo,0,0,2,2
28372,للطلاب,0,0,2,2
34506,ಫ್ಲಮ್ಮೋಕ್ಸ್,0,0,2,2
27487,varnish,0,0,2,2
47146,أصبح,0,0,2,2
29642,rent,0,0,2,2
27440,evolves,0,0,2,2
11000,diseñado,0,0,2,2
27442,respirar,0,0,2,2
12946,அங்கீகரிக்கப்பட்ட,0,0,2,2
47142,baseado,0,0,2,2
44173,olmanın,0,0,2,2
3340,progetti.,1,2,0,2
29639,morgen.,0,0,2,2
44175,ταινίες,0,0,2,2
47137,побуждает,0,0,2,2
50163,स्वयंसेवकों,0,0,2,2
27446,symbolic,0,0,2,2
33343,الويب,0,0,2,2
45441,uv,0,0,2,2
12933,அவருடன்,0,0,2,2
8385,dejlig,0,0,2,2
44179,tema.,0,0,2,2
28393,middag,0,0,2,2
28392,alınır.,0,0,2,2
28391,geweigerd,0,0,2,2
44181,liée,0,0,2,2
28388,denominativo,0,0,2,2
11014,говорили,0,0,2,2
12924,predominantemente,0,0,2,2
10999,strategy,0,0,2,2
3343,profondo,1,2,0,2
44229,غالباً,0,0,2,2
44164,webbsidor,0,0,2,2
45459,источниках,0,0,2,2
12986,gitmeniz,0,0,2,2
12985,التحكيم,0,0,2,2
29650,confondues,0,0,2,2
27419,ಲ್ಯಾಟಿನ್,0,0,2,2
33350,l'argent,0,0,2,2
33070,κι,0,0,2,2
10983,preguntar.,0,0,2,2
27426,vertelde,0,0,2,2
44148,publicerades,0,0,2,2
50558,om.,0,0,2,2
44149,independentes,0,0,2,2
44150,kæreste,0,0,2,2
10985,geliyor,0,0,2,2
44155,ಹುಡುಗರಿಗೆ,0,0,2,2
33909,ഇത്തരത്തിൽ,0,0,2,2
8367,энциклопедического,0,0,2,2
28400,autant,0,0,2,2
10990,low,0,0,2,2
27435,существуют,0,0,2,2
50374,अग्रिम,0,0,2,2
10994,preocupes.,0,0,2,2
28398,തർക്കങ്ങൾ,0,0,2,2
27436,l’écologie,0,0,2,2
27437,cc-by-sa-licentie,0,0,2,2
44185,κάνουν,0,0,2,2
12920,الأطعمة,0,0,2,2
27455,şikayet,0,0,2,2
34525,observar,0,0,2,2
12875,отправлю,0,0,2,2
12874,negativt,0,0,2,2
3334,usate,1,2,0,2
12871,имени,0,0,2,2
50547,nereden,0,0,2,2
50170,لأول,0,0,2,2
28380,ideia.,0,0,2,2
51869,الشخصية,0,0,2,2
12862,أحد,0,0,2,2
12861,historian,0,0,2,2
11037,retains,0,0,2,2
11038,februari,0,0,2,2
11040,unmatched,0,0,2,2
11041,πήρατε,0,0,2,2
9152,geração,0,0,2,2
44222,sterk,0,0,2,2
8421,सप्ताह,0,0,2,2
50546,becoming,0,0,2,2
46621,begonnen,0,0,2,2
11046,besked,0,0,2,2
9150,example.,0,0,2,2
9149,ಸುಂದರವಾಗಿ,0,0,2,2
27486,gett,0,0,2,2
45413,работа,0,0,2,2
12848,rötter,0,0,2,2
3045,selezione,1,2,0,2
12879,öva,0,0,2,2
12880,الياقوت,0,0,2,2
11023,पिकार्ड,0,0,2,2
28386,recharge,0,0,2,2
44190,attempted,0,0,2,2
12915,الأمريكيون,0,0,2,2
12911,biçiminde,0,0,2,2
12910,puisque,0,0,2,2
11020,project.,0,0,2,2
8392,கலைக்களஞ்சியத்தின்,0,0,2,2
47131,correspondiente,0,0,2,2
47129,விக்கிப்பீடியாவிலுள்ள,0,0,2,2
12904,கீழ்,0,0,2,2
45429,όχι.,0,0,2,2
47127,venha,0,0,2,2
44211,stören,0,0,2,2
9167,αύριο.,0,0,2,2
12899,heart.,0,0,2,2
47125,dække,0,0,2,2
652,'.,1,2,0,2
29631,rédigé,0,0,2,2
29627,weise,0,0,2,2
33082,herregud.,0,0,2,2
12887,patients,0,0,2,2
29258,well-mannered,0,0,2,2
8407,ക്ഷമ,0,0,2,2
29259,ಮಾತನಾಡಲು,0,0,2,2
13256,جائع,0,0,2,2
9243,buraya,0,0,2,2
29704,gehe,0,0,2,2
52010,книге,0,0,2,2
51822,practical,0,0,2,2
13596,intellectual,0,0,2,2
45680,uppnås,0,0,2,2
29770,occupé,0,0,2,2
10626,fest,0,0,2,2
10627,அடிப்படை,0,0,2,2
3781,corse,2,1,1,2
27101,téléchargé,0,0,2,2
43735,слова.,0,0,2,2
10630,हो।,0,0,2,2
28552,ஆரம்பித்தாள்,0,0,2,2
33814,பணம்,0,0,2,2
33815,ಜಾಮ್,0,0,2,2
45675,samples,0,0,2,2
13583,حذف,0,0,2,2
43739,βικιλεξικό,0,0,2,2
8121,collectively,0,0,2,2
10637,открытый,0,0,2,2
43744,πεινασμένος,0,0,2,2
9345,карете,0,0,2,2
8123,discuss,0,0,2,2
724,realtà,1,2,0,2
3398,motori,1,2,0,2
52060,encontrado,0,0,2,2
52011,practices,0,0,2,2
51821,intéresse,0,0,2,2
29771,fire,0,0,2,2
29763,आलोचक,0,0,2,2
13600,языка,0,0,2,2
8109,gostou,0,0,2,2
13627,verificabilidad,0,0,2,2
13626,ilustraciones,0,0,2,2
52008,récord,0,0,2,2
3404,condizione,1,2,0,2
28564,western,0,0,2,2
50623,വിളിക്കുന്നത്.,0,0,2,2
735,studenti,1,2,0,2
13620,वेबसाईटों,0,0,2,2
34777,последнее,0,0,2,2
13617,brittisk,0,0,2,2
45691,increases,0,0,2,2
27085,suisse,0,0,2,2
9351,общих,0,0,2,2
27087,mythes,0,0,2,2
45689,dinlemiyordum.,0,0,2,2
51820,പോകുന്നു.,0,0,2,2
34774,الجديد,0,0,2,2
3403,disposizione,1,2,0,2
13608,”allmän,0,0,2,2
33809,மேற்கொள்ளப்பட்ட,0,0,2,2
50351,ദത്തവിവര,0,0,2,2
13604,möta,0,0,2,2
43726,உறுதிப்படுத்திக்,0,0,2,2
13602,विशिष्ट,0,0,2,2
10644,auteur,0,0,2,2
29174,उपयोगिता,0,0,2,2
43958,ins,0,0,2,2
47294,ചുമതലയും,0,0,2,2
47293,கொண்டுள்ளது.,0,0,2,2
13533,प्राथमिक,0,0,2,2
47292,experto,0,0,2,2
27132,vigiadas,0,0,2,2
34744,تدل,0,0,2,2
13528,banda,0,0,2,2
33394,termo,0,0,2,2
13526,இருக்கிறீர்களா,0,0,2,2
46503,παράδειγμα.,0,0,2,2
29758,réel,0,0,2,2
34739,ಮಿಲಿಯನ್,0,0,2,2
27140,clásico,0,0,2,2
32994,etmek.,0,0,2,2
43782,एन्साइक्लोपीडिया,0,0,2,2
8145,letter,0,0,2,2
8146,estavam,0,0,2,2
3395,enciclopedicamente,2,1,1,2
8148,ήρθατε,0,0,2,2
28537,думаешь,0,0,2,2
34738,l'évolution,0,0,2,2
34737,lärande,0,0,2,2
27143,circulation,0,0,2,2
32996,sakıncası,0,0,2,2
43789,ಉದಾಹರಣೆ,0,0,2,2
45655,तुंरत,0,0,2,2
34745,வந்தீர்கள்,0,0,2,2
34747,provedores,0,0,2,2
10648,abiotic,0,0,2,2
13539,θέλεις,0,0,2,2
13567,ആകാം,0,0,2,2
723,arrabbiato.,1,2,0,2
9341,angst,0,0,2,2
43753,biliyorsun,0,0,2,2
13562,verdens,0,0,2,2
9340,queria,0,0,2,2
43755,qu'en,0,0,2,2
47298,autoridade,0,0,2,2
34751,entscheidung,0,0,2,2
9339,contact.,0,0,2,2
10653,എന്തുകൊണ്ടാണ്,0,0,2,2
27122,नार्सीसस,0,0,2,2
10654,verilere,0,0,2,2
2933,revisione.,1,2,0,2
43762,статистических,0,0,2,2
13550,seguinte,0,0,2,2
51829,disposition,0,0,2,2
13548,إصدارات,0,0,2,2
45665,procédures,0,0,2,2
43764,சொல்கிறீர்கள்,0,0,2,2
43767,कृप्या,0,0,2,2
8137,éditoriale,0,0,2,2
13541,जल्द,0,0,2,2
28541,doorgaan,0,0,2,2
10659,выделенных,0,0,2,2
34781,लिनक्स,0,0,2,2
2919,sky,1,2,0,2
10601,هاه,0,0,2,2
43636,المساهمات,0,0,2,2
43638,φέρω,0,0,2,2
285,giù,1,2,0,2
32966,geléia,0,0,2,2
8070,suggests,0,0,2,2
27033,nogen.,0,0,2,2
47336,afortunado,0,0,2,2
27034,dibujo,0,0,2,2
34805,تعليقًا,0,0,2,2
27036,одной,0,0,2,2
33787,പുതുതായി,0,0,2,2
32968,சிறப்புக்,0,0,2,2
10559,stade,0,0,2,2
13706,интернета,0,0,2,2
8076,γίνει,0,0,2,2
43656,olur.,0,0,2,2
8077,ತಾನು,0,0,2,2
13699,dream.,0,0,2,2
10561,något.,0,0,2,2
34800,مفرداتك,0,0,2,2
10563,blockerades,0,0,2,2
13696,sent,0,0,2,2
33789,suele,0,0,2,2
13694,famosos,0,0,2,2
27045,únicos,0,0,2,2
10565,ahead.,0,0,2,2
10555,правлю,0,0,2,2
10553,japonais.,0,0,2,2
27075,reputation,0,0,2,2
27027,dépendra,0,0,2,2
43614,слово.,0,0,2,2
8051,baixos,0,0,2,2
3418,alberi,1,2,0,2
46470,назвать,0,0,2,2
10531,μάτια,0,0,2,2
50255,distribuição,0,0,2,2
33778,drömmar,0,0,2,2
10537,gerelateerd,0,0,2,2
34819,publicitários,0,0,2,2
13748,ranging,0,0,2,2
10538,legal.,0,0,2,2
45735,reizen,0,0,2,2
43622,klingt,0,0,2,2
28599,yeniden,0,0,2,2
47346,medalhas,0,0,2,2
28597,iniciados,0,0,2,2
28596,préciser,0,0,2,2
470,licenze,1,2,0,2
43628,लें।,0,0,2,2
33782,cambrian,0,0,2,2
32962,ചോദിച്ചാൽ,0,0,2,2
10550,reviews.,0,0,2,2
10551,cobriam,0,0,2,2
43633,wie.,0,0,2,2
13728,deles.,0,0,2,2
27046,estadística,0,0,2,2
51817,dabei,0,0,2,2
45718,niye,0,0,2,2
45716,ഉള്ളടക്കവും,0,0,2,2
28578,ഓർമ്മിക്കുക.,0,0,2,2
29160,forces,0,0,2,2
8097,goldbrot,0,0,2,2
46486,poised,0,0,2,2
27062,leads,0,0,2,2
34789,beğendiyseniz,0,0,2,2
10590,आशा,0,0,2,2
34788,própria,0,0,2,2
8102,tratan,0,0,2,2
50134,gobierno,0,0,2,2
27066,ganó,0,0,2,2
27068,prens,0,0,2,2
27069,πάρετε,0,0,2,2
27070,listas,0,0,2,2
10594,kendt,0,0,2,2
34785,университета,0,0,2,2
47316,demain.,0,0,2,2
2916,beh,1,2,0,2
10596,ಮಾಡುವುದು,0,0,2,2
45699,واستمر,0,0,2,2
43700,prononciation,0,0,2,2
32984,wp,0,0,2,2
736,consultabili,1,2,0,2
28569,θέλατε,0,0,2,2
45696,lendemain,0,0,2,2
43685,hayatınızda,0,0,2,2
13660,фразу,0,0,2,2
10581,glückspilz,0,0,2,2
13675,ಮೂಲ,0,0,2,2
8081,bekommen.,0,0,2,2
33791,born,0,0,2,2
47328,världens,0,0,2,2
288,neurale,1,2,0,2
43670,necesaria,0,0,2,2
13682,parliament,0,0,2,2
43671,второй,0,0,2,2
34798,двигаться,0,0,2,2
33794,bonitos,0,0,2,2
43675,quant,0,0,2,2
47324,парень,0,0,2,2
8089,temperate,0,0,2,2
45709,astúrias,0,0,2,2
34796,अभी,0,0,2,2
3411,sviluppare,1,2,0,2
29784,хорош,0,0,2,2
8091,horas,0,0,2,2
10578,αγαπητή,0,0,2,2
34793,أيضاً,0,0,2,2
13667,plágio,0,0,2,2
13666,άκουγα,0,0,2,2
33795,تكن,0,0,2,2
29782,verrast,0,0,2,2
8096,இருந்தது.,0,0,2,2
29753,predicts,0,0,2,2
10672,समस्या,0,0,2,2
13503,journals,0,0,2,2
46536,utilizan,0,0,2,2
33376,чем-то,0,0,2,2
3376,tipi,1,2,0,2
9278,büyülü,0,0,2,2
13338,naziksiniz,0,0,2,2
486,motore,1,2,0,2
13336,göndermek,0,0,2,2
34673,olduğumuzu,0,0,2,2
13334,अगले,0,0,2,2
43904,produktionssätt,0,0,2,2
13332,områden,0,0,2,2
13328,dinge,0,0,2,2
13327,skäl,0,0,2,2
13326,etti,0,0,2,2
45587,ಆಗಿ,0,0,2,2
29207,സാഹചര്യം.,0,0,2,2
13322,underrepresented,0,0,2,2
10782,geldiğini,0,0,2,2
3770,conversazione.,1,2,0,2
43912,tålmodigt,0,0,2,2
33856,போமிஸ்,0,0,2,2
8234,holocene,0,0,2,2
13316,vara.,0,0,2,2
13315,содержимое,0,0,2,2
8235,приятного,0,0,2,2
8239,crawler,0,0,2,2
45593,falsely,0,0,2,2
10770,sık,0,0,2,2
34686,.º,0,0,2,2
3606,attivo,1,2,0,2
43876,மூழ்கி,0,0,2,2
33381,വേണ്ട,0,0,2,2
13369,homens,0,0,2,2
27225,stoppede,0,0,2,2
33020,assistindo.,0,0,2,2
43881,κατά,0,0,2,2
10747,cooperação,0,0,2,2
3605,austria,2,1,1,2
50362,opfyldelse,0,0,2,2
27226,buscando,0,0,2,2
29197,செய்ததற்கு,0,0,2,2
10752,corps,0,0,2,2
27228,allez-y.,0,0,2,2
33848,examiner,0,0,2,2
13356,പ്രകൃതിയുടെ,0,0,2,2
9287,പരസ്പരബഹുമാനവും,0,0,2,2
13355,заняться,0,0,2,2
10761,forhånd,0,0,2,2
27232,حلمي,0,0,2,2
10762,ಪಠ್ಯವನ್ನು,0,0,2,2
50591,oye,0,0,2,2
27233,sesgado,0,0,2,2
3771,applicati,1,2,0,2
8228,φύγω,0,0,2,2
45596,toegekend,0,0,2,2
43917,reverts,0,0,2,2
8240,macmillan,0,0,2,2
487,importava,2,1,1,2
28484,publiée,0,0,2,2
10810,значок,0,0,2,2
493,interrompendo,2,1,1,2
43941,alterar,0,0,2,2
9256,dette.,0,0,2,2
10816,académico,0,0,2,2
9254,displace,0,0,2,2
13280,laws.,0,0,2,2
43943,книга,0,0,2,2
13278,explica.,0,0,2,2
8248,spørgsmål.,0,0,2,2
45563,கொடுத்தார்.,0,0,2,2
9252,λεξιλόγιό,0,0,2,2
10820,αποτέλεσμα,0,0,2,2
45560,اليابانية,0,0,2,2
10824,tidsskriftets,0,0,2,2
375,l'idea,1,2,0,2
10829,questioning,0,0,2,2
10830,ഫോൺ,0,0,2,2
13268,en/of,0,0,2,2
43952,manden,0,0,2,2
28464,lavet.,0,0,2,2
679,prodotto,1,2,0,2
8252,hungrig,0,0,2,2
46558,agradeço,0,0,2,2
47218,ಅದೃಷ್ಟವಂತರು,0,0,2,2
8246,convirtió,0,0,2,2
10808,pandemic,0,0,2,2
52058,اجتماع,0,0,2,2
43924,острого,0,0,2,2
43919,vardı.,0,0,2,2
34665,aspectos,0,0,2,2
10790,الحياة,0,0,2,2
33372,تهتم,0,0,2,2
43921,обсуждаются,0,0,2,2
29212,her.,0,0,2,2
27256,finally,0,0,2,2
13304,japonais,0,0,2,2
34664,inteligência,0,0,2,2
28483,projects.,0,0,2,2
45577,परिणामस्वरूप,0,0,2,2
10796,diğerini,0,0,2,2
47224,छवियों,0,0,2,2
34663,desculpas,0,0,2,2
10797,pediapress,0,0,2,2
9261,предложение,0,0,2,2
491,determinata,1,2,0,2
29213,wikipedianer.,0,0,2,2
43930,വണ്ടിയിൽ,0,0,2,2
50365,सॉरी,0,0,2,2
27265,diet,0,0,2,2
43935,termed,0,0,2,2
43936,κοινές,0,0,2,2
3768,immediatamente,1,2,0,2
47240,gratuit,0,0,2,2
45610,ndesanjo,0,0,2,2
9330,وبعض,0,0,2,2
34720,werken.,0,0,2,2
45644,ونظر,0,0,2,2
2944,proposta.,2,1,1,2
13467,induction,0,0,2,2
33005,borde,0,0,2,2
27168,established,0,0,2,2
33390,matériel,0,0,2,2
13461,evde,0,0,2,2
28526,ಹೊಂದಿಲ್ಲ,0,0,2,2
27171,достигла,0,0,2,2
27172,hoewel,0,0,2,2
43820,التعلم.,0,0,2,2
13453,illustre,0,0,2,2
27175,ഞങ്ങൾ‌,0,0,2,2
27176,köpa,0,0,2,2
8178,político,0,0,2,2
29737,فهذه,0,0,2,2
2949,frank,2,1,1,2
13442,afscheid,0,0,2,2
47262,rêves,0,0,2,2
43831,மின்னஞ்சல்,0,0,2,2
708,furono,1,2,0,2
46512,لشركة,0,0,2,2
3602,tavolo,1,2,0,2
10702,l'hébergement,0,0,2,2
10703,dada,0,0,2,2
50138,huske,0,0,2,2
2942,conseguenza,1,2,0,2
28503,फ़ाइल,0,0,2,2
8168,പിന്നീട്,0,0,2,2
9329,raiz,0,0,2,2
715,visitati,1,2,0,2
10677,डिजाइन,0,0,2,2
13495,professionals,0,0,2,2
10678,மேற்கொள்ளப்படும்,0,0,2,2
3393,vasta,1,2,0,2
13492,kentinde,0,0,2,2
34729,violation,0,0,2,2
43800,வேலையைத்,0,0,2,2
8157,zenodot,0,0,2,2
13488,s'appuie,0,0,2,2
3391,dolce,1,2,0,2
47281,المدرسة,0,0,2,2
45649,desta,0,0,2,2
380,riflettere,1,2,0,2
713,indipendentemente,1,2,0,2
46509,kopen,0,0,2,2
13481,wikiversity,0,0,2,2
33001,run,0,0,2,2
8164,entreprises,0,0,2,2
3390,dall'ia,1,2,0,2
13477,glöm,0,0,2,2
28529,cuatro,0,0,2,2
29744,எப்போது,0,0,2,2
10692,gümüş,0,0,2,2
10704,soi,0,0,2,2
9319,начал,0,0,2,2
706,questo.,1,2,0,2
33008,mobiltelefoner,0,0,2,2
27206,wikidata.,0,0,2,2
50359,humaine.,0,0,2,2
9302,المتعلقة,0,0,2,2
46523,deverá,0,0,2,2
8206,gebeuren,0,0,2,2
2961,dirlo.,1,2,0,2
29722,sentada,0,0,2,2
47242,தொகுக்க,0,0,2,2
43867,svara,0,0,2,2
28508,बाप,0,0,2,2
29192,saknas,0,0,2,2
28506,τραπεζικό,0,0,2,2
27213,miembros,0,0,2,2
9297,gek,0,0,2,2
10738,μικρότερη,0,0,2,2
10739,proposée,0,0,2,2
29193,ತೀಕ್ಷ್ಣ,0,0,2,2
13384,निर्णय,0,0,2,2
8211,ortográficas,0,0,2,2
28504,hoop,0,0,2,2
29194,apps,0,0,2,2
27216,dünyanın,0,0,2,2
9294,crédit,0,0,2,2
29720,accumulated,0,0,2,2
13377,filtering,0,0,2,2
3382,proviene,2,1,1,2
33382,ವಹಿಸಲು,0,0,2,2
29190,considerou,0,0,2,2
8197,viser,0,0,2,2
13429,manières,0,0,2,2
45635,الإعلانات,0,0,2,2
47257,argumentam,0,0,2,2
45633,halen,0,0,2,2
51955,sådan,0,0,2,2
10712,utförd,0,0,2,2
13421,gennem,0,0,2,2
45631,reclamar,0,0,2,2
13418,band,0,0,2,2
50248,hermanos,0,0,2,2
28515,முதல்,0,0,2,2
43848,मुद्दों,0,0,2,2
45621,herself,0,0,2,2
45625,coleção,0,0,2,2
29727,معي,0,0,2,2
698,liberamente,1,2,0,2
43852,specifika,0,0,2,2
13408,créateur,0,0,2,2
13407,cicéron,0,0,2,2
47249,alegação,0,0,2,2
10722,perplexes,0,0,2,2
33841,спрашивает,0,0,2,2
43858,publishers,0,0,2,2
34695,உருவாக்க,0,0,2,2
8473,പ്രശ്നങ്ങളിൽ,0,0,2,2
12716,poussé,0,0,2,2
13762,tænke,0,0,2,2
44728,κλικ,0,0,2,2
44730,nybörjare,0,0,2,2
29350,philosophique,0,0,2,2
29463,تصنيف,0,0,2,2
46733,पूर्वाग्रह,0,0,2,2
33202,ρίζα,0,0,2,2
34270,dû,0,0,2,2
33203,paradoxe,0,0,2,2
11517,مساهمات,0,0,2,2
8979,dollars.,0,0,2,2
44737,وموسوعة,0,0,2,2
554,caratteri,1,2,0,2
46734,abraham,0,0,2,2
11521,നിങ്ങൾക്കറിയാമെന്ന്,0,0,2,2
44739,médiatiques,0,0,2,2
12064,livros,0,0,2,2
12063,and.,0,0,2,2
50460,φωτεινά,0,0,2,2
44740,ningún,0,0,2,2
34269,சரியாக,0,0,2,2
50459,beispielsätze,0,0,2,2
44743,छात्रों,0,0,2,2
46890,ocorre,0,0,2,2
46735,ൽ,0,0,2,2
12056,någon.,0,0,2,2
11524,дома,0,0,2,2
50196,غاضبًا,0,0,2,2
11514,ಚಿಕಿತ್ಸೆ,0,0,2,2
45100,externes,0,0,2,2
11513,aimé,0,0,2,2
330,sebbene,1,2,0,2
34078,skillnader,0,0,2,2
3179,interessi,1,2,0,2
12101,gifta,0,0,2,2
3263,dell'apprendimento.,1,2,0,2
34081,discovered,0,0,2,2
27854,انتظر,0,0,2,2
27855,obscenas,0,0,2,2
45106,supongo,0,0,2,2
8746,मिलाकर,0,0,2,2
11509,النطق,0,0,2,2
3180,accattivante,1,2,0,2
11511,കുറച്ചുകാലമായി,0,0,2,2
12093,tochter.,0,0,2,2
27858,representatives,0,0,2,2
27859,fondateurs,0,0,2,2
50463,free.,0,0,2,2
46900,incroyable.,0,0,2,2
3685,hopfield,2,1,1,2
8749,constatou,0,0,2,2
44724,projelerinin,0,0,2,2
12084,ಮಧ್ಯದಲ್ಲಿದ್ದರೆ,0,0,2,2
3182,conclusioni,1,2,0,2
34274,pr.,0,0,2,2
29465,gehen.,0,0,2,2
555,registrati,1,2,0,2
45099,स्वादिष्ट,0,0,2,2
11565,தவிர,0,0,2,2
591,georg,1,2,0,2
12010,ia,0,0,2,2
8789,douglas,0,0,2,2
29439,thanking,0,0,2,2
44780,фильм,0,0,2,2
27898,गोल्डन,0,0,2,2
347,l'ottimizzazione,1,2,0,2
11552,matrix.,0,0,2,2
46864,turns,0,0,2,2
34247,بمدى,0,0,2,2
27902,പ്രൈമറി,0,0,2,2
28126,passait,0,0,2,2
50453,தரத்தைக்,0,0,2,2
11995,norte,0,0,2,2
34244,другую,0,0,2,2
44787,ubuntu,0,0,2,2
11560,compostura,0,0,2,2
29436,togs,0,0,2,2
44788,tijdschriften.,0,0,2,2
8797,efficient,0,0,2,2
11561,παρασκευή,0,0,2,2
34241,lång,0,0,2,2
45076,الآخرين,0,0,2,2
11984,grymma,0,0,2,2
27910,redigeringarna,0,0,2,2
46861,അമ്മയെ,0,0,2,2
46868,sociale.,0,0,2,2
50421,يدفع,0,0,2,2
34088,anúncio,0,0,2,2
12014,aquatic,0,0,2,2
8976,ध्यान,0,0,2,2
46886,classical,0,0,2,2
12045,ultraviolet,0,0,2,2
34089,multilingual,0,0,2,2
34262,удачи.,0,0,2,2
46885,ಶೀಘ್ರದಲ್ಲೇ,0,0,2,2
12042,أستمع,0,0,2,2
33207,وأن,0,0,2,2
50211,تأسيسها,0,0,2,2
46738,confiture,0,0,2,2
27881,friend,0,0,2,2
3259,spero,1,2,0,2
27884,værd.,0,0,2,2
34255,d'amélioration,0,0,2,2
3257,prendere,1,2,0,2
44766,chère,0,0,2,2
46878,प्रदर्शन,0,0,2,2
12027,நேச்சர்,0,0,2,2
11545,स्टीफन,0,0,2,2
44769,numerosos,0,0,2,2
11546,suit,0,0,2,2
27891,n'ont,0,0,2,2
12018,τραπέζι,0,0,2,2
8964,dynamo,0,0,2,2
333,obiettivo,1,2,0,2
44711,رؤيته,0,0,2,2
3662,proposto,1,2,0,2
44709,contratados,0,0,2,2
3171,atroce.,2,1,1,2
12195,suppe,0,0,2,2
12194,fıkra,0,0,2,2
28176,blij,0,0,2,2
44648,regularmente,0,0,2,2
46927,evolution,0,0,2,2
45150,freitag,0,0,2,2
27811,الجامعات,0,0,2,2
51895,day.,0,0,2,2
29339,sted,0,0,2,2
3271,permettono,1,2,0,2
29486,incidentes,0,0,2,2
46923,منفرجة,0,0,2,2
551,inserendo,1,2,0,2
11453,उनमें,0,0,2,2
34302,നിങ്ങളോടൊപ്പമുണ്ടാകും,0,0,2,2
3269,mancante.,1,2,0,2
44658,videre,0,0,2,2
12179,patterns.,0,0,2,2
11456,complain,0,0,2,2
12177,आरोप,0,0,2,2
8709,കേട്ടിട്ടുണ്ട്,0,0,2,2
45143,ಅವು,0,0,2,2
12175,théoriquement,0,0,2,2
11459,believe,0,0,2,2
12173,number.,0,0,2,2
3272,attuale,1,2,0,2
3693,l'allenamento,1,2,0,2
12110,فترة,0,0,2,2
46711,générer,0,0,2,2
50413,ಬೇಕು,0,0,2,2
45166,kelimeleri,0,0,2,2
12225,sulten,0,0,2,2
44627,ವಾಕ್ಯಗಳು,0,0,2,2
29501,internos,0,0,2,2
44631,усерднее,0,0,2,2
3277,strategie,1,2,0,2
27795,delete,0,0,2,2
45163,«нравится»,0,0,2,2
34050,andel,0,0,2,2
8683,encyclopedie.,0,0,2,2
44635,वाक्यों,0,0,2,2
33177,nobel,0,0,2,2
12210,أطول,0,0,2,2
9011,indiquant,0,0,2,2
44640,veio,0,0,2,2
28181,politician,0,0,2,2
34053,failed,0,0,2,2
34054,occasionally,0,0,2,2
11438,βάσης,0,0,2,2
9010,tengan,0,0,2,2
44641,القناة,0,0,2,2
550,migliore,1,2,0,2
29492,तारीख,0,0,2,2
12201,மெலிசா,0,0,2,2
46716,classify,0,0,2,2
44662,électronique,0,0,2,2
29483,فيمكنك,0,0,2,2
34299,numera,0,0,2,2
8723,संचालन,0,0,2,2
12145,box,0,0,2,2
11483,மாயாஜால,0,0,2,2
44688,χρυσή,0,0,2,2
8992,yıl,0,0,2,2
12141,informatiques,0,0,2,2
44689,devoted,0,0,2,2
27836,derovre,0,0,2,2
12137,dün,0,0,2,2
12136,ರಹಸ್ಯ,0,0,2,2
44691,சர்ச்சைக்குரிய,0,0,2,2
44692,irmãos,0,0,2,2
27838,telefone,0,0,2,2
12131,weglatingen,0,0,2,2
8729,துல்லியத்தன்மை,0,0,2,2
45121,balança,0,0,2,2
46725,सोचा,0,0,2,2
3267,sostengono,1,2,0,2
46909,prêmios,0,0,2,2
8734,komm,0,0,2,2
27845,أمريكي,0,0,2,2
44702,രഹസ്യമായി,0,0,2,2
45115,விரும்புகிறீர்களா,0,0,2,2
12113,விரும்பினேன்,0,0,2,2
44707,manske.,0,0,2,2
11482,bırak,0,0,2,2
11481,παρακάτω,0,0,2,2
34066,écoutez,0,0,2,2
3268,geometry,2,1,1,2
8714,entity,0,0,2,2
44667,belleza.,0,0,2,2
45138,soar,0,0,2,2
33284,удаления,0,0,2,2
3658,www,2,1,1,2
46718,mudou,0,0,2,2
8715,клеток,0,0,2,2
44669,eyes,0,0,2,2
44670,installed,0,0,2,2
33283,século,0,0,2,2
28165,हैरान,0,0,2,2
11471,استعدت,0,0,2,2
45127,sistêmico,0,0,2,2
27824,telling,0,0,2,2
34293,ಮದುವೆಯಲ್ಲಿ,0,0,2,2
8720,cowen,0,0,2,2
28164,citations.,0,0,2,2
34291,lié,0,0,2,2
28162,acusada,0,0,2,2
8721,പ്രശ്‌നകരമായ,0,0,2,2
27831,руководства,0,0,2,2
11475,ಪ್ರಶ್ನೆಯನ್ನು,0,0,2,2
348,debba,1,2,0,2
598,l'intelligenza,1,2,0,2
45075,m'aider,0,0,2,2
28120,следующую,0,0,2,2
47076,व्यक्त,0,0,2,2
11677,neurones,0,0,2,2
8918,نوع,0,0,2,2
576,assolutamente,1,2,0,2
3668,usata,1,2,0,2
11830,supprimé,0,0,2,2
8914,zouden,0,0,2,2
27991,aura,0,0,2,2
44997,tendemos,0,0,2,2
44904,ومدى,0,0,2,2
51911,πρόβλημα,0,0,2,2
34188,egoísta,0,0,2,2
11822,opinião,0,0,2,2
44993,व्यक्तिगत,0,0,2,2
11690,svare,0,0,2,2
11820,turisten,0,0,2,2
11817,εγκυκλοπαίδειας,0,0,2,2
44989,अग्रसर,0,0,2,2
8910,kvalitet,0,0,2,2
46780,அபத்தமானது,0,0,2,2
11698,arabic,0,0,2,2
29386,formatação,0,0,2,2
46782,spreken,0,0,2,2
11702,varying,0,0,2,2
46813,مصداقية,0,0,2,2
11704,uppdrag,0,0,2,2
46812,отправить,0,0,2,2
11835,मुझसे,0,0,2,2
8854,yollarını,0,0,2,2
11805,grappige,0,0,2,2
46820,नौकरी,0,0,2,2
44884,ನುಡಿಗಟ್ಟುಗಳು,0,0,2,2
11855,denotar,0,0,2,2
34201,यहां,0,0,2,2
27977,ന്,0,0,2,2
11657,परिभाषित,0,0,2,2
11852,sju,0,0,2,2
11851,εγγραφής,0,0,2,2
29378,связанных,0,0,2,2
3245,soli,1,2,0,2
28076,встреча,0,0,2,2
44888,sorprendente,0,0,2,2
34126,stakkels,0,0,2,2
11666,விரும்பினால்.,0,0,2,2
34199,comentário,0,0,2,2
11667,annual,0,0,2,2
11846,misiniz,0,0,2,2
11669,vendredi,0,0,2,2
11845,wikier,0,0,2,2
45007,озадачены,0,0,2,2
46823,belirtilmeli],0,0,2,2
3219,wikipediani,1,2,0,2
3243,sarei,1,2,0,2
46821,tendencias,0,0,2,2
45004,விக்கி,0,0,2,2
8920,piezas,0,0,2,2
44981,damas,0,0,2,2
28003,αρκετά.,0,0,2,2
44797,feel,0,0,2,2
34146,فلوريدا،,0,0,2,2
8872,расстраивайтесь,0,0,2,2
52031,ಆಗಿದೆ.,0,0,2,2
11771,استمر.,0,0,2,2
8891,التراجع,0,0,2,2
571,artificiali.,1,2,0,2
8875,diskussionsforum,0,0,2,2
44944,نظر,0,0,2,2
51909,сильно,0,0,2,2
8877,ಒಬ್ಟೂಸ್,0,0,2,2
44966,bezeichnen,0,0,2,2
3238,filtraggio,1,2,0,2
44950,equipe,0,0,2,2
3237,progetto.,1,2,0,2
44953,கூறலாம்,0,0,2,2
11735,fruto,0,0,2,2
3233,rappresentati,1,2,0,2
8890,berbat,0,0,2,2
11753,succes,0,0,2,2
46797,satt,0,0,2,2
28034,sabes.,0,0,2,2
34154,glömmer,0,0,2,2
46799,lessons,0,0,2,2
46800,رأي,0,0,2,2
28039,aplicaciones,0,0,2,2
11745,fingre,0,0,2,2
8894,ungefär,0,0,2,2
570,riprodurre,1,2,0,2
28054,توقف,0,0,2,2
11776,ಮರೆಯದಿರಿ.,0,0,2,2
11709,മലയാളമടക്കം,0,0,2,2
3223,insiemi,1,2,0,2
11710,ಸಿಲ್ಲಿ,0,0,2,2
44921,diseño,0,0,2,2
28006,offer,0,0,2,2
29403,levels,0,0,2,2
28007,എഴുതുവാനും,0,0,2,2
46809,जादुई,0,0,2,2
44978,أحبك,0,0,2,2
34176,varsa,0,0,2,2
28053,удивительно,0,0,2,2
44926,धीरे-धीरे,0,0,2,2
8902,ಪ್ರೀತಿಸುತ್ತೇನೆ,0,0,2,2
46785,templates,0,0,2,2
34174,चला,0,0,2,2
28052,предложения.,0,0,2,2
8871,noterat,0,0,2,2
44975,точности,0,0,2,2
3227,finché,1,2,0,2
11717,हुह,0,0,2,2
28017,wikipédia ,0,0,2,2
44936,प्रशासकों,0,0,2,2
11778,zavallı,0,0,2,2
46790,eksempler,0,0,2,2
29392,vested,0,0,2,2
28079,nommé,0,0,2,2
11857,പണം,0,0,2,2
11858,делаешь,0,0,2,2
33227,πολλοί,0,0,2,2
45053,d'obtenir,0,0,2,2
11596,morgon,0,0,2,2
27933,banning,0,0,2,2
11601,доступа,0,0,2,2
11937,निर्धारित,0,0,2,2
45048,publicação,0,0,2,2
11936,கவலைப்படுகிறீர்களா,0,0,2,2
3209,condivisione,1,2,0,2
46848,trevligt,0,0,2,2
28100,d,0,0,2,2
46847,बड़ा,0,0,2,2
8946,acyclic,0,0,2,2
44835,openness,0,0,2,2
8819,aktif,0,0,2,2
27943,watercourse,0,0,2,2
44840,sluta,0,0,2,2
34215,أمثلة,0,0,2,2
3679,porterò,1,2,0,2
11917,schule,0,0,2,2
11916,commonalities,0,0,2,2
11915,motsvarande,0,0,2,2
27945,involve,0,0,2,2
27946,πάρτε,0,0,2,2
46841,ಸ್ಥಳವನ್ನು,0,0,2,2
27950,पूरा,0,0,2,2
28107,revanche,0,0,2,2
44819,சமீபத்திய,0,0,2,2
27975,cuidar,0,0,2,2
11951,maken.,0,0,2,2
28118,മാതൃക,0,0,2,2
29433,londres,0,0,2,2
44799,stimuli,0,0,2,2
34236,conclusão,0,0,2,2
44801,forum,0,0,2,2
3203,sporco,1,2,0,2
11572,revisão.,0,0,2,2
11573,блокировки,0,0,2,2
28115,امرأة,0,0,2,2
28114,centros,0,0,2,2
33266,लेखक,0,0,2,2
11580,منتصف,0,0,2,2
11581,تغطيني,0,0,2,2
44810,procedentes,0,0,2,2
44811,bad,0,0,2,2
11960,él.,0,0,2,2
45062,δουλειά.,0,0,2,2
44812,batmak,0,0,2,2
11584,duiden,0,0,2,2
34104,hazırlandım,0,0,2,2
45060,премию,0,0,2,2
44814,ಅಲ್ಲ.,0,0,2,2
8811,kaffe,0,0,2,2
11955,மைல்,0,0,2,2
34230,ilk,0,0,2,2
45040,oben,0,0,2,2
46837,ഇതിലൂടെ,0,0,2,2
8830,оставить,0,0,2,2
46758,holde,0,0,2,2
11878,desalienta,0,0,2,2
11877,anyway,0,0,2,2
8935,participated,0,0,2,2
45024,errado,0,0,2,2
27968,belle,0,0,2,2
46830,útil,0,0,2,2
8840,விரும்பும்,0,0,2,2
28082,ordenou,0,0,2,2
3667,controllate,1,2,0,2
11645,sorge,0,0,2,2
27969,джозефом,0,0,2,2
3246,recenti,1,2,0,2
44875,bankkredit,0,0,2,2
46764,wortes,0,0,2,2
46828,ಪರಿಸ್ಥಿತಿಯಲ್ಲಿ,0,0,2,2
11648,textes,0,0,2,2
34205,iwf,0,0,2,2
45020,bigipedia,0,0,2,2
11865,défaut,0,0,2,2
46766,ഖേദിക്കുന്നു.,0,0,2,2
3674,smetti,1,2,0,2
11863,et/ou,0,0,2,2
45018,تعتقد,0,0,2,2
45017,deleted,0,0,2,2
27974,factualmente,0,0,2,2
34121,vrijdag,0,0,2,2
27967,ബാങ്ക്,0,0,2,2
34120,vejo,0,0,2,2
11892,способы,0,0,2,2
28092,l’influence,0,0,2,2
45035,incrível.,0,0,2,2
11901,широкий,0,0,2,2
11620,ತಪ್ಪಾಗಿ,0,0,2,2
11900,σχέδια.,0,0,2,2
44855,wortel,0,0,2,2
11622,gebracht,0,0,2,2
11623,humilde,0,0,2,2
8831,anayasa,0,0,2,2
27959,confus,0,0,2,2
8942,λάθος.,0,0,2,2
11625,necessarily,0,0,2,2
33260,sunmaktadır.,0,0,2,2
27960,последние,0,0,2,2
44862,régulièrement,0,0,2,2
29371,മൂന്നു,0,0,2,2
11627,слушал,0,0,2,2
29372,élèves,0,0,2,2
11629,talte,0,0,2,2
51915,वहां,0,0,2,2
8939,تفعل.,0,0,2,2
34118,gang.,0,0,2,2
50209,கடவுளே.,0,0,2,2
34119,آخرون,0,0,2,2
8675,मौजूद,0,0,2,2
33289,pergunta.,0,0,2,2
27789,assouline et,0,0,2,2
8535,autonomes,0,0,2,2
12564,reprise,0,0,2,2
34425,essencialmente,0,0,2,2
34424,expand,0,0,2,2
27629,περάσετε,0,0,2,2
8537,публикаций,0,0,2,2
44416,tabii,0,0,2,2
11217,criticism,0,0,2,2
12554,ويكيبيديا؛,0,0,2,2
11218,पढ़,0,0,2,2
12550,entrenamiento,0,0,2,2
9087,repos ».,0,0,2,2
33129,विज्ञापन,0,0,2,2
47034,användarna,0,0,2,2
45299,حل,0,0,2,2
3714,spam,2,1,1,2
44420,بنسبة,0,0,2,2
8547,குழப்பம்,0,0,2,2
29295,höja,0,0,2,2
47032,fed,0,0,2,2
50510,ameaça,0,0,2,2
50399,parlementaire,0,0,2,2
27640,estadísticas,0,0,2,2
9085,göndereceğim,0,0,2,2
33989,impresa.,0,0,2,2
44428,تحب,0,0,2,2
34426,ويقولون,0,0,2,2
47041,يسمى,0,0,2,2
34416,culturais,0,0,2,2
45303,procuram,0,0,2,2
46658,comprises,0,0,2,2
11202,önemi,0,0,2,2
50518,digam,0,0,2,2
629,altamente,1,2,0,2
27612,goodbye,0,0,2,2
27613,containing,0,0,2,2
28295,allá,0,0,2,2
9091,pare,0,0,2,2
27615,запас.,0,0,2,2
8528,overrasket,0,0,2,2
47043,что.,0,0,2,2
45307,tien,0,0,2,2
27620,kiggede,0,0,2,2
44399,بعمل,0,0,2,2
44400,الوصول,0,0,2,2
9090,согласен.,0,0,2,2
12577,ställde,0,0,2,2
27621,idéologie,0,0,2,2
11210,theory.,0,0,2,2
44403,kontroversielle,0,0,2,2
44404,تعرض,0,0,2,2
33984,soldaten,0,0,2,2
8533,uppnått,0,0,2,2
9089,ഉയർന്ന,0,0,2,2
44408,​​om,0,0,2,2
11227,intuición,0,0,2,2
3637,artificiale.,1,2,0,2
27788,எரிகிறது,0,0,2,2
44454,ഫ്ലംമോക്സ്,0,0,2,2
33312,hacker,0,0,2,2
28269,globo,0,0,2,2
8571,نبدأ,0,0,2,2
44458,mismos,0,0,2,2
3710,contesto,1,2,0,2
3116,disturbo,1,2,0,2
12490,மதிப்பு,0,0,2,2
29302,koordinationsarbete,0,0,2,2
12487,сначала,0,0,2,2
45277,работала,0,0,2,2
33139,الويب،,0,0,2,2
52020,செய்தி,0,0,2,2
33141,использовалась,0,0,2,2
28265,mentalt,0,0,2,2
12478,verhoog,0,0,2,2
47013,supplémentaire,0,0,2,2
45272,مجال,0,0,2,2
44469,drowning,0,0,2,2
8579,deserve,0,0,2,2
29306,சனவரி,0,0,2,2
50500,världen,0,0,2,2
45270,ακούσετε,0,0,2,2
50499,inspirée,0,0,2,2
44473,τούτου,0,0,2,2
28263,who's,0,0,2,2
12497,singapore,0,0,2,2
44453,असाइनमेंट,0,0,2,2
34414,ofrecer,0,0,2,2
11248,effectué,0,0,2,2
28283,decline.,0,0,2,2
29296,воспитанный,0,0,2,2
12529,ಕೆಲಸದ,0,0,2,2
11233,hører,0,0,2,2
47031,voraus,0,0,2,2
11234,kişinin,0,0,2,2
50509,ചോദിക്കാനുള്ള,0,0,2,2
12524,aparência,0,0,2,2
34412,ഒരേ,0,0,2,2
29561,ഉപയോഗിക്കാൻ‌,0,0,2,2
11236,kullanabileceğin,0,0,2,2
12517,सुविधा,0,0,2,2
3108,affidabilità,1,2,0,2
8558,देखी,0,0,2,2
46664,अदालत,0,0,2,2
44443,vivants,0,0,2,2
3639,riconosciuta,1,2,0,2
29555,registran,0,0,2,2
33135,contextes,0,0,2,2
45285,വ്യക്തമായ,0,0,2,2
45284,الربع,0,0,2,2
3302,discutere,1,2,0,2
44448,ചോദിച്ചപ്പോൾ,0,0,2,2
27653,l'école,0,0,2,2
11247,editions.,0,0,2,2
12594,concernant,0,0,2,2
27610,ದೇವರೇ.,0,0,2,2
27609,دعنا,0,0,2,2
44328,الأسبوع,0,0,2,2
8489,profesor,0,0,2,2
12674,ತಂಪಾದ,0,0,2,2
33968,endroit.,0,0,2,2
27568,seconde.,0,0,2,2
27569,volunteers,0,0,2,2
28312,बनाई,0,0,2,2
3084,opinioni,1,2,0,2
34454,звучать,0,0,2,2
29285,participantes,0,0,2,2
12667,sentindo,0,0,2,2
12666,originais.,0,0,2,2
3311,mantengono,1,2,0,2
8491,отметку,0,0,2,2
8492,ആധികാരികത,0,0,2,2
12662,extensión,0,0,2,2
50526,[kaynak,0,0,2,2
27573,sayfa,0,0,2,2
11158,فضلك,0,0,2,2
44342,viendo.,0,0,2,2
3086,registrati.,1,2,0,2
9112,attendez,0,0,2,2
45339,சரியாகப்,0,0,2,2
33971,trots,0,0,2,2
9111,arriver,0,0,2,2
44344,श्रेणी,0,0,2,2
33965,συνηθισμένο,0,0,2,2
12683,भूल,0,0,2,2
46657,وتم,0,0,2,2
45351,языковые,0,0,2,2
525,marketing,2,1,1,2
28330,besökta,0,0,2,2
27548,cualquiera,0,0,2,2
34469,история,0,0,2,2
12712,принятия,0,0,2,2
12709,allerlei,0,0,2,2
46642,كتاب,0,0,2,2
45357,ideologiskt,0,0,2,2
12705,φυσικά,0,0,2,2
12704,அழகாகவும்,0,0,2,2
44316,cubrirme,0,0,2,2
12699,σχολείο,0,0,2,2
8483,comenzar,0,0,2,2
44319,bildning,0,0,2,2
27555,हुआ।,0,0,2,2
33323,förutsäga,0,0,2,2
11139,privatisé,0,0,2,2
12692,இருந்தீர்கள்,0,0,2,2
50176,försökte,0,0,2,2
11143,hang,0,0,2,2
47066,douce,0,0,2,2
47065,പോകുന്നു,0,0,2,2
34463,മിനിറ്റിനുള്ളിൽ,0,0,2,2
528,sapevo,1,2,0,2
44327,записи,0,0,2,2
29577,verdrinken,0,0,2,2
9110,more.,0,0,2,2
28306,environmental,0,0,2,2
45332,مثال,0,0,2,2
45323,சாரும்.,0,0,2,2
29290,gênante,0,0,2,2
44364,നടത്താൻ,0,0,2,2
11187,chérie,0,0,2,2
27593,stiftelsen,0,0,2,2
33977,gemacht.,0,0,2,2
44366,pronunciation,0,0,2,2
44368,حادة,0,0,2,2
12620,पत्रकारिता,0,0,2,2
47049,وجدت,0,0,2,2
27596,veja,0,0,2,2
8518,neveneffect,0,0,2,2
27597,viewpoints,0,0,2,2
27598,déranger,0,0,2,2
51881,одного,0,0,2,2
44374,सफल,0,0,2,2
11191,levantadas,0,0,2,2
44377,ancient,0,0,2,2
11192,opener,0,0,2,2
27602,aanstaande,0,0,2,2
45318,possibles,0,0,2,2
9097,مشاهدات,0,0,2,2
34437,தகவல்கள்,0,0,2,2
47044,следовательно,0,0,2,2
11197,साइट,0,0,2,2
47050,corrigir,0,0,2,2
8513,واليابانية,0,0,2,2
47053,викимедиа.,0,0,2,2
3721,ricorda,1,2,0,2
9109,bedanken.,0,0,2,2
27578,أما,0,0,2,2
9107,explosion,0,0,2,2
3722,cuore.,1,2,0,2
11174,propuesta,0,0,2,2
44351,حسنًا,0,0,2,2
12646,prediction,0,0,2,2
634,procedura,1,2,0,2
34448,இல்லையென்றால்,0,0,2,2
33975,beslut,0,0,2,2
11177,بحث,0,0,2,2
11178,dizaines,0,0,2,2
9103,yazılımı,0,0,2,2
11179,بأنها,0,0,2,2
12641,ಮರುದಿನ,0,0,2,2
27584,सदस्यता,0,0,2,2
28303,lyssnade,0,0,2,2
45325,குறிக்கோளை,0,0,2,2
27587,vrijwilligers,0,0,2,2
27588,lives,0,0,2,2
50521,danken.,0,0,2,2
12633,requested,0,0,2,2
34445,सेंटर,0,0,2,2
8508,bevatte,0,0,2,2
45268,വീഡിയോയിൽ,0,0,2,2
34002,gestion,0,0,2,2
34003,सरंचना,0,0,2,2
34347,hjertet.,0,0,2,2
12323,доступные,0,0,2,2
44563,requisitos,0,0,2,2
45203,comédia,0,0,2,2
28211,мужчина,0,0,2,2
12318,ಅರ್ಹನೆಂದು,0,0,2,2
3145,distinte,1,2,0,2
27753,surpassing,0,0,2,2
11371,estábamos,0,0,2,2
34033,rod,0,0,2,2
27754,indexação,0,0,2,2
12310,hayalim,0,0,2,2
27755,ελέγξετε,0,0,2,2
29322,geduldig,0,0,2,2
45199,tabeller,0,0,2,2
12305,هائلة,0,0,2,2
12303,açısı,0,0,2,2
27760,apprenez,0,0,2,2
11377,incoming,0,0,2,2
33164,katalanska,0,0,2,2
34038,создан,0,0,2,2
12298,geral.,0,0,2,2
9033,ट्रुथ,0,0,2,2
12296,gratuito,0,0,2,2
27764,qu'est,0,0,2,2
51894,eletrônico,0,0,2,2
11367,besvärlig,0,0,2,2
27746,necesariamente,0,0,2,2
28223,αρχείο,0,0,2,2
34348,المواقع,0,0,2,2
606,visione,1,2,0,2
34028,potatoes,0,0,2,2
28219,studera,0,0,2,2
46977,kvalitén,0,0,2,2
28218,другом,0,0,2,2
11349,रहूँगा,0,0,2,2
44554,ആരംഭിച്ച,0,0,2,2
45215,archives,0,0,2,2
45213,अरे,0,0,2,2
11354,censure,0,0,2,2
11355,λιγότερο,0,0,2,2
12340,ಮಾರ್ಗಗಳನ್ನು,0,0,2,2
11358,plantae,0,0,2,2
12338,تمرير,0,0,2,2
12337,hjalmarsson,0,0,2,2
46692,verschrikkelijk,0,0,2,2
50408,waard,0,0,2,2
46975,سميت,0,0,2,2
12335,pelas,0,0,2,2
45207,literally,0,0,2,2
28212,overgenomen,0,0,2,2
3142,sicurezza.,1,2,0,2
12331,plus.,0,0,2,2
45204,reçus,0,0,2,2
27744,المتطوعين,0,0,2,2
50479,معينة.,0,0,2,2
12291,voedsel,0,0,2,2
12290,البريدية,0,0,2,2
33296,användbara,0,0,2,2
12261,exemple ,0,0,2,2
44600,проблем,0,0,2,2
46956,ilgili,0,0,2,2
46699,possam,0,0,2,2
9025,reconnu,0,0,2,2
44604,ನೋಡಿದ,0,0,2,2
45174,gardner,0,0,2,2
11411,tråkiga,0,0,2,2
34322,movies,0,0,2,2
46952,featured,0,0,2,2
12247,negatief,0,0,2,2
46704,l'antiquité,0,0,2,2
3164,buono,1,2,0,2
27782,வைக்க,0,0,2,2
33291,ರಾಜಕುಮಾರ,0,0,2,2
11417,простое,0,0,2,2
12240,hantera,0,0,2,2
29504,omedelbart,0,0,2,2
12237,caused,0,0,2,2
27786,tropenmuseum,0,0,2,2
44619,herzen.,0,0,2,2
9018,neşelen,0,0,2,2
12232,qu'une,0,0,2,2
8674,« ce,0,0,2,2
28186,atteindre,0,0,2,2
28192,ikiniz,0,0,2,2
3162,determinato,1,2,0,2
12264,tâches,0,0,2,2
11398,protégées,0,0,2,2
45190,abuse,0,0,2,2
44582,soyez,0,0,2,2
28200,åsikt,0,0,2,2
28199,فارما,0,0,2,2
11389,länk,0,0,2,2
45187,செல்வது,0,0,2,2
12284,विकि-शब्दकोष,0,0,2,2
45185,نفسها,0,0,2,2
45184,ചെയ്യുന്ന,0,0,2,2
12282,അതുകൊണ്ട്,0,0,2,2
12278,das.,0,0,2,2
46963,आपत्तिजनक,0,0,2,2
46698,myspace.,0,0,2,2
12276,foiré,0,0,2,2
3160,canzoni,1,2,0,2
11399,erro,0,0,2,2
27773,डूब,0,0,2,2
44593,citations,0,0,2,2
11401,इसी,0,0,2,2
45179,каждая,0,0,2,2
50219,പദങ്ങൾ,0,0,2,2
12269,dalga,0,0,2,2
44594,बदला,0,0,2,2
44596,sesgos,0,0,2,2
34353,últimas,0,0,2,2
11342,quotes,0,0,2,2
29546,zamanla,0,0,2,2
9062,εύκολη,0,0,2,2
11291,comparável,0,0,2,2
34381,банковский,0,0,2,2
618,tremendamente,2,1,1,2
12432,écologie,0,0,2,2
11293,കാഴ്ചപ്പാടുകൾ,0,0,2,2
44501,पंजाबी,0,0,2,2
44502,خاطئة,0,0,2,2
44503,skriv,0,0,2,2
617,chiamare,1,2,0,2
3641,supporto,1,2,0,2
12425,klicken,0,0,2,2
28247,annexes,0,0,2,2
34010,recueil,0,0,2,2
3706,votazione,1,2,0,2
8599,bokmål,0,0,2,2
8601,ridder.,0,0,2,2
3126,ted,2,1,1,2
46682,ಯೋಗ್ಯವಾಗಿಲ್ಲ.,0,0,2,2
27704,spel,0,0,2,2
9056,impersonation,0,0,2,2
27706,دقيقة,0,0,2,2
44516,verden,0,0,2,2
613,descrivono,1,2,0,2
12407,человек,0,0,2,2
45246,savaşı,0,0,2,2
34382,[update],0,0,2,2
28251,sampled,0,0,2,2
11340,большое,0,0,2,2
11288,मेलिंग,0,0,2,2
11270,minuter.,0,0,2,2
27673,fortjener,0,0,2,2
27675,ஒருவருக்கொருவர்,0,0,2,2
12462,k,0,0,2,2
28257,children.,0,0,2,2
3707,francia,2,1,1,2
44480,decisiones.,0,0,2,2
11275,birinden,0,0,2,2
45261,recebe,0,0,2,2
11277,fremsætter,0,0,2,2
34388,بحثًا,0,0,2,2
46675,map,0,0,2,2
27679,dominated,0,0,2,2
34387,lecteur,0,0,2,2
47007,hacen,0,0,2,2
28254,classificada,0,0,2,2
33304,مذهل,0,0,2,2
11285,കുറിച്ച്,0,0,2,2
46677,портал,0,0,2,2
12448,jij.,0,0,2,2
33145,réseau,0,0,2,2
27684,british,0,0,2,2
12444,मील,0,0,2,2
29311,naturaleza,0,0,2,2
34384,нажав,0,0,2,2
27710,dentre,0,0,2,2
27711,altaylı,0,0,2,2
44521,ತಿಳಿದಿತ್ತು,0,0,2,2
11307,σταματήστε,0,0,2,2
12374,tomada,0,0,2,2
3290,settimanale,1,2,0,2
12373,l’espèce,0,0,2,2
12371,мой.,0,0,2,2
34020,talep,0,0,2,2
27727,existem,0,0,2,2
27728,трафика,0,0,2,2
357,istruzioni,1,2,0,2
11329,ബന്ധപ്പെട്ട,0,0,2,2
46984,όνειρο.,0,0,2,2
29317,populære,0,0,2,2
29318,இளவரசன்,0,0,2,2
12364,talt,0,0,2,2
8624,दुर्लभ,0,0,2,2
34024,utgången,0,0,2,2
9045,विशाल,0,0,2,2
12359,ಕ್ಲಿಕ್,0,0,2,2
45224,английской,0,0,2,2
8626,കാഴ്ചപ്പാടുകളും,0,0,2,2
11337,عطلة,0,0,2,2
11338,sal,0,0,2,2
608,inferiore,1,2,0,2
12356,manejo,0,0,2,2
46982,estadunidense,0,0,2,2
50185,explicó,0,0,2,2
46685,locked,0,0,2,2
3291,oggetti,1,2,0,2
11321,arbitration,0,0,2,2
3130,ragionamenti,1,2,0,2
46996,species.,0,0,2,2
11308,letters,0,0,2,2
46994,أكون,0,0,2,2
45243,संस्था,0,0,2,2
8606,πάτε,0,0,2,2
8607,ஜாம்,0,0,2,2
27716,alls,0,0,2,2
34015,navegar,0,0,2,2
3129,inserire,1,2,0,2
3294,foto,1,2,0,2
46992,conhecido,0,0,2,2
34366,समावेश,0,0,2,2
12375,talking,0,0,2,2
44530,tentando,0,0,2,2
29314,remedies,0,0,2,2
44531,outsiders,0,0,2,2
45240,l'éthique,0,0,2,2
34016,içeriği,0,0,2,2
33301,natureza,0,0,2,2
27721,comparou,0,0,2,2
51892,usarem,0,0,2,2
3135,supervisionato.,1,2,0,2
3292,comunemente,1,2,0,2
28236,factually,0,0,2,2
34823,kurumu,0,0,2,2
11744,förtjänar,0,0,2,2
26619,हाथ,0,0,2,2
34922,l'homme.,0,0,2,2
45903,común,0,0,2,2
46170,образуют,0,0,2,2
26826,l'honneur,0,0,2,2
14137,ಮಾಡುವುದನ್ನು,0,0,2,2
257,orribile,1,2,0,2
10110,acontecimentos,0,0,2,2
10280,издан,0,0,2,2
812,álvaro,1,2,0,2
7891,ziemlich,0,0,2,2
26508,español.,0,0,2,2
14133,εμένα,0,0,2,2
7690,பிடித்திருந்தால்,0,0,2,2
9659,d'études,0,0,2,2
29104,каждый.,0,0,2,2
28723,ലാഭേച്ഛയില്ലാതെ,0,0,2,2
26680,रखें।,0,0,2,2
42926,betreft,0,0,2,2
14139,voulait,0,0,2,2
10275,reise,0,0,2,2
43365,vertelt,0,0,2,2
42936,mögen,0,0,2,2
14149,tamaño,0,0,2,2
47534,arreglo,0,0,2,2
50311,അയാൾക്ക്,0,0,2,2
26513, years.,0,0,2,2
29899,départ,0,0,2,2
2835,ancora,1,2,0,2
9858,öppen,0,0,2,2
7629,جادل,0,0,2,2
14142,grader.,0,0,2,2
14411,att.,0,0,2,2
14778,φορές.,0,0,2,2
30034,बढ़ा,0,0,2,2
29898,kelimelerin,0,0,2,2
26511,விரும்புகிறீர்கள்,0,0,2,2
10274,परिणामों,0,0,2,2
47643,الصور,0,0,2,2
50299,recouvre,0,0,2,2
32855,kullanıcı,0,0,2,2
47458,πύλη,0,0,2,2
28922,picked,0,0,2,2
9611,enig.,0,0,2,2
35164,ve.,0,0,2,2
7895,gotta,0,0,2,2
33699,статус,0,0,2,2
45888,vois,0,0,2,2
29995,slår,0,0,2,2
45887,الذهاب,0,0,2,2
29949,titan's,0,0,2,2
3867,california,2,1,1,2
50736,bataklık,0,0,2,2
9545,problemer.,0,0,2,2
30038,inspirado,0,0,2,2
10298,لغة.,0,0,2,2
34943,julie,0,0,2,2
2784,ciascun,1,2,0,2
26842,visitors.,0,0,2,2
10292,πλαίσιο,0,0,2,2
29107,génère,0,0,2,2
29014,തീയതി,0,0,2,2
50260,أستحق,0,0,2,2
14415,defesa,0,0,2,2
28721,ಹೊಂದಿದ್ದೀರಿ,0,0,2,2
9852,identities,0,0,2,2
46362,sons,0,0,2,2
47457,électroniques,0,0,2,2
43184,दर्जा,0,0,2,2
42923,samenwerking,0,0,2,2
7622,réfléchir,0,0,2,2
26678,xviie,0,0,2,2
9851,matters,0,0,2,2
14126,expor,0,0,2,2
14418,análises,0,0,2,2
45892,surrounding,0,0,2,2
10289,baixas,0,0,2,2
28719,locations.,0,0,2,2
43377,stellen,0,0,2,2
45905,vroeg,0,0,2,2
14152,resume,0,0,2,2
26514,έκανα,0,0,2,2
28734,variation,0,0,2,2
43031,மரியான்,0,0,2,2
29903,courses,0,0,2,2
28735,ícone,0,0,2,2
52083,செய்தியை,0,0,2,2
35153,m'en,0,0,2,2
2755,voce.,1,2,0,2
50733,mercado,0,0,2,2
9955,νομίζετε,0,0,2,2
26805,significations,0,0,2,2
42949,മുങ്ങുക,0,0,2,2
14179,empréstimo,0,0,2,2
50717,சிக்கியிருக்கிறேன்,0,0,2,2
35154,ಸಮಯ,0,0,2,2
46166,достижения,0,0,2,2
26518,αντικειμενική,0,0,2,2
7632,ride,0,0,2,2
47469,probeer,0,0,2,2
43335,contrôlant,0,0,2,2
7879,annulations,0,0,2,2
26801,वर्ग,0,0,2,2
34970,interesante,0,0,2,2
388,tratta,1,2,0,2
9483,പ്രശ്നമുണ്ടോ,0,0,2,2
9867,neue,0,0,2,2
34968,காலத்தில்,0,0,2,2
14753,നിഷ്പ്രയാസം,0,0,2,2
29016,числа,0,0,2,2
10116,deel,0,0,2,2
32797,omkring,0,0,2,2
26802,graph,0,0,2,2
14397,académica,0,0,2,2
29097,bureaucrats,0,0,2,2
29944,dank.,0,0,2,2
50731,செய்வேன்,0,0,2,2
14399,próximo,0,0,2,2
43334,दूसरी,0,0,2,2
26686,രാവിലെ,0,0,2,2
772,preprocessing,2,1,1,2
43357,தற்போது,0,0,2,2
7885,favorite,0,0,2,2
14160,now.,0,0,2,2
26817,रिकॉर्ड,0,0,2,2
29069,rapidez,0,0,2,2
46106,grootste,0,0,2,2
26683,tantas,0,0,2,2
46105,gefallen,0,0,2,2
50671,विभिन्न,0,0,2,2
28731,கணக்குகள்,0,0,2,2
14161,versioner,0,0,2,2
43035,göstermek,0,0,2,2
14771,aşağıdaki,0,0,2,2
14154,degrees,0,0,2,2
26682,टु,0,0,2,2
28730,английских,0,0,2,2
28729,playstation,0,0,2,2
35116,desenvolvido,0,0,2,2
14406,buch,0,0,2,2
26816,потом,0,0,2,2
47533,തങ്ങൾ,0,0,2,2
14168,ಕೇಳಿದರೆ,0,0,2,2
771,altrettante,1,2,0,2
33693,respectively.,0,0,2,2
43345,தேதி,0,0,2,2
34961,ഇന്ത്യൻഭാഷകളിലും,0,0,2,2
42943,تصدر,0,0,2,2
26813,ಅಪ್ರಸ್ತುತವಾಗುತ್ತದೆ.,0,0,2,2
26684,الآلة,0,0,2,2
9476,saltet,0,0,2,2
14163,παιχνίδι,0,0,2,2
3582,l'intero,1,2,0,2
43350,ಸ್ವಾಗತ.,0,0,2,2
14405,குறைவாக,0,0,2,2
769,membri,1,2,0,2
10267,interface,0,0,2,2
46107,mobiele,0,0,2,2
14769,بيديا,0,0,2,2
445,fantastico.,1,2,0,2
10104,dat.,0,0,2,2
35167,φίλο,0,0,2,2
817,ricevere,1,2,0,2
32905,stört,0,0,2,2
29881,lecciones,0,0,2,2
9828,pequeño,0,0,2,2
35110,sonunda,0,0,2,2
45866,convection,0,0,2,2
7920,groter,0,0,2,2
2725,percettroni,1,2,0,2
50662,hangisinin,0,0,2,2
9965,arbejde.,0,0,2,2
47439,обычных,0,0,2,2
34927,birden,0,0,2,2
33600,gebied,0,0,2,2
35181,économique.,0,0,2,2
32828,candidato,0,0,2,2
28930,ingilizce,0,0,2,2
26475,vores,0,0,2,2
800,raccolta,1,2,0,2
14070,praised,0,0,2,2
14840,usaron,0,0,2,2
43411,hepsini,0,0,2,2
42896,συμφωνώ,0,0,2,2
9668,forslag.,0,0,2,2
29886,सुनें।,0,0,2,2
9834,acadêmicas,0,0,2,2
10323,أعجبك,0,0,2,2
9833,английском,0,0,2,2
43046,апреле,0,0,2,2
47542,قالوا,0,0,2,2
14443,ನಮ್ಮ,0,0,2,2
10093,κομμάτια,0,0,2,2
14441,publiceringen,0,0,2,2
29008,trubbig,0,0,2,2
43413,doré,0,0,2,2
43165,émancipation,0,0,2,2
14832,изначально,0,0,2,2
9830,l'explique,0,0,2,2
431,licenza.,1,2,0,2
7603,εκτός,0,0,2,2
7769,массачусетского,0,0,2,2
33604,выделились,0,0,2,2
45861,prüfung,0,0,2,2
10089,സന്തോഷം.,0,0,2,2
14047,perfekt,0,0,2,2
2853,trattati,1,2,0,2
3447,database.,2,1,1,2
10088,ആകർഷണീയമായ,0,0,2,2
32910,διαγραφεί.,0,0,2,2
26470,понимаю,0,0,2,2
43158,prenumerationsknappen,0,0,2,2
28932,desarrollado,0,0,2,2
52071,ejecuta,0,0,2,2
29989,ആറ്,0,0,2,2
26469,πείραζε,0,0,2,2
47656,conexión,0,0,2,2
30045,രഥത്തിൽ,0,0,2,2
30046,platform,0,0,2,2
14846,annually,0,0,2,2
14048,देखभाल,0,0,2,2
33709,creditado,0,0,2,2
35061,purpose,0,0,2,2
47654,rijkdom,0,0,2,2
14059,балл,0,0,2,2
7671,endereços,0,0,2,2
46186,trends,0,0,2,2
10330,tried,0,0,2,2
9823,senare.,0,0,2,2
43420,clicando,0,0,2,2
3842,singolo,1,2,0,2
9821,tomorrow.,0,0,2,2
26869,protéger,0,0,2,2
14451,erhalten.,0,0,2,2
14050,பயன்படுத்தப்படுகிறது,0,0,2,2
29006,المرور,0,0,2,2
43425,хорошими,0,0,2,2
14452,snigel,0,0,2,2
28699,kökeni,0,0,2,2
34931,bittet,0,0,2,2
47541,kidding,0,0,2,2
10103,podemos,0,0,2,2
9841,executando,0,0,2,2
7615,മെച്ചപ്പെട്ട,0,0,2,2
50102,ಚಾನಲ್‌ಗೆ,0,0,2,2
35172,उपस्थित,0,0,2,2
7901,έτσι.,0,0,2,2
26850,murat,0,0,2,2
14614,источник,0,0,2,2
14809,« apprentissage,0,0,2,2
46177,заболоченного,0,0,2,2
10310,இருப்பது,0,0,2,2
14811,സ്വയംചലിത,0,0,2,2
7614,heavy,0,0,2,2
47451,biografías,0,0,2,2
7613,ಉಚ್ಚಾರಣೆಯನ್ನು,0,0,2,2
7774,எது,0,0,2,2
45877,«не,0,0,2,2
43400,bénéficie,0,0,2,2
50665,സിസോപ്പുകളേയും,0,0,2,2
26849,woord.,0,0,2,2
14815,uenig.,0,0,2,2
802,verificare,1,2,0,2
43387,ಇದೆ,0,0,2,2
9463,comprise,0,0,2,2
33503,website.,0,0,2,2
34940,उत्पन्न,0,0,2,2
14109,frankrike,0,0,2,2
29893,die.,0,0,2,2
46021,ആയി,0,0,2,2
7617,நனவாகும்,0,0,2,2
9546,ενεργειακό,0,0,2,2
3476,aree,1,2,0,2
42912,பயன்படுத்தலாம்,0,0,2,2
45880,संरक्षण,0,0,2,2
10307,abierto,0,0,2,2
33564,degré,0,0,2,2
28712,discrete,0,0,2,2
3453,predizioni,1,2,0,2
43173,പറയാം,0,0,2,2
447,intenzione,1,2,0,2
26858,ರ,0,0,2,2
14083,gusta,0,0,2,2
7773,celui-ci,0,0,2,2
10098,numerators,0,0,2,2
14823,ampliamente,0,0,2,2
14086,optimal,0,0,2,2
51983,المحادثة,0,0,2,2
42901,ouvi,0,0,2,2
42899,cebuanospråkiga,0,0,2,2
14082,procedimientos,0,0,2,2
33704,лучшая,0,0,2,2
46025,அழகான,0,0,2,2
35054,ചോദ്യം,0,0,2,2
26482,श्रेय,0,0,2,2
34932,raízes,0,0,2,2
2845,teorici,1,2,0,2
46361,नयी,0,0,2,2
10094,данный,0,0,2,2
34934,بسهولة,0,0,2,2
14088,ಮದುವೆಯಾಗಲು,0,0,2,2
9460,estávamos,0,0,2,2
28879,specialiserade,0,0,2,2
26488,çapraz,0,0,2,2
9459,കത്തിക്കാം,0,0,2,2
14817,finding,0,0,2,2
14091,നിരവധി,0,0,2,2
10099,maandenlang,0,0,2,2
26487,संगठनों,0,0,2,2
14090,klinkt,0,0,2,2
9666,извини,0,0,2,2
26485,кому-то,0,0,2,2
14819,ofertas.,0,0,2,2
2844,chiede,1,2,0,2
9457,وداعًا,0,0,2,2
35052,ansiklopedi,0,0,2,2
33440,دلالات,0,0,2,2
45871,முரண்பாடான,0,0,2,2
47649,медленно,0,0,2,2
32859,эффект,0,0,2,2
28737,crisis.,0,0,2,2
26796,ഉദാഹരണമായി,0,0,2,2
33487,pessoas.,0,0,2,2
14296,لاروس,0,0,2,2
14653,eller.,0,0,2,2
35007,article »,0,0,2,2
52074,speaking,0,0,2,2
783,uomini,1,2,0,2
7839,convective,0,0,2,2
9516,تخبرني,0,0,2,2
50723,quatrième,0,0,2,2
42989,servicios,0,0,2,2
9515,subdomain,0,0,2,2
32802,apresenta,0,0,2,2
43265,ενοχλεί,0,0,2,2
3861,punti,1,2,0,2
35140,ನಿಮಿಷಗಳಲ್ಲಿ,0,0,2,2
45963,ποιος,0,0,2,2
14362,तौर,0,0,2,2
14700,ettiğimi,0,0,2,2
9938,conduite,0,0,2,2
29026,artificiales,0,0,2,2
45969,raisonné,0,0,2,2
47616,береги,0,0,2,2
10175,visages,0,0,2,2
3468,singoli,1,2,0,2
43253,publient,0,0,2,2
437,teorie,1,2,0,2
50722,removidas,0,0,2,2
50695,prazer,0,0,2,2
28774,färre,0,0,2,2
50696,réellement,0,0,2,2
14693,பயன்படுத்தப்படுகின்றன.,0,0,2,2
259,computer.,1,2,0,2
10183,paradox,0,0,2,2
50690,مستخدمو,0,0,2,2
28897,acto,0,0,2,2
9635,субботу,0,0,2,2
33669,градусов,0,0,2,2
51981,ним.,0,0,2,2
14652,zo'n,0,0,2,2
42995,recorded,0,0,2,2
9903,इन्हें,0,0,2,2
51979,tonight,0,0,2,2
28797,leitura,0,0,2,2
2810,vedendo,1,2,0,2
30023,property,0,0,2,2
51794,عزيزتي,0,0,2,2
10202,खुशी,0,0,2,2
14712,komplicerad,0,0,2,2
9902,மேற்கொள்ளும்,0,0,2,2
14277,الأكادميين,0,0,2,2
14714,schreef,0,0,2,2
26757,permitan,0,0,2,2
26758,tillämpas,0,0,2,2
50314,comportamientos,0,0,2,2
26760,considering,0,0,2,2
2748,operato,1,2,0,2
43281,fruktansvärt,0,0,2,2
9940,klicka,0,0,2,2
42980,zilver,0,0,2,2
3472,backgammon,1,2,0,2
2796,aggiunto,1,2,0,2
35001,இருவரும்,0,0,2,2
30021,राय,0,0,2,2
28768,bryde,0,0,2,2
9907,disponibles.,0,0,2,2
26750,особенностью,0,0,2,2
28767,ஃப்ளூமொக்ஸ்,0,0,2,2
35143,πρίγκιπας,0,0,2,2
14651,поражена,0,0,2,2
46138,muss,0,0,2,2
10194,века,0,0,2,2
29083,intonationen.,0,0,2,2
46382,vis-à-vis,0,0,2,2
30022,verbazingwekkende,0,0,2,2
43018,രൂപത്തിൽ,0,0,2,2
7848,centre,0,0,2,2
46137,добавления,0,0,2,2
9520,césar,0,0,2,2
32865,कोरियाई,0,0,2,2
47517,مجرد,0,0,2,2
7672,borrowed,0,0,2,2
26724,gouvernement,0,0,2,2
26713,ερωτήσεις,0,0,2,2
14666,χρήση,0,0,2,2
35027,perte,0,0,2,2
14347,रह,0,0,2,2
436,stupido,1,2,0,2
43219,περιμένατε,0,0,2,2
9923,syn,0,0,2,2
46120,recientes,0,0,2,2
10145,സ്വാഗതം,0,0,2,2
14325,வணிக,0,0,2,2
10155,graus,0,0,2,2
9922,videnskabsfolk,0,0,2,2
10156,ಶನಿವಾರ,0,0,2,2
26558,visuais,0,0,2,2
43006,mark,0,0,2,2
47509,spot,0,0,2,2
14330,ಮನೆಯಲ್ಲಿ,0,0,2,2
33655,reconnues,0,0,2,2
10150,adequada.,0,0,2,2
7670,ശ്രദ്ധിച്ചില്ല.,0,0,2,2
3513,fece,1,2,0,2
14339,kullanıcıların,0,0,2,2
9928,svag,0,0,2,2
9927,reviews,0,0,2,2
14659,ερώτηση.,0,0,2,2
35021,candidat,0,0,2,2
14336,साइटों,0,0,2,2
9531,ഒരുമിച്ച്,0,0,2,2
26721,cieux,0,0,2,2
32811,ressource,0,0,2,2
26722,l'unesco,0,0,2,2
14333,ടീച്ചർ,0,0,2,2
47510,vise,0,0,2,2
43230,ali,0,0,2,2
46121,âge,0,0,2,2
9624,begränsas,0,0,2,2
35134,sonhos,0,0,2,2
26734,preguntar,0,0,2,2
14314,incidente,0,0,2,2
3559,potevo,1,2,0,2
14355,കൂടിക്കാഴ്‌ചയുണ്ട്,0,0,2,2
28894,വ്യക്തിയോട്,0,0,2,2
14684,peux-tu,0,0,2,2
45976,τόσα,0,0,2,2
33665,signals,0,0,2,2
10170,länder.,0,0,2,2
46130,metabolism,0,0,2,2
45977,قلقة,0,0,2,2
42998,'de,0,0,2,2
9915,असंख्य,0,0,2,2
43244,geeft,0,0,2,2
35031,ملايين,0,0,2,2
26550,faim,0,0,2,2
29929,hazırlanmaktadır.,0,0,2,2
2805,tutti.,1,2,0,2
7661,ಬಡ,0,0,2,2
14654,स्वागत,0,0,2,2
7822,разделов.,0,0,2,2
14352,сервера,0,0,2,2
14351,tidskrifter,0,0,2,2
50691,huylu,0,0,2,2
14674,artikel.,0,0,2,2
30011,travail.,0,0,2,2
14678,langzamer,0,0,2,2
10161,again.,0,0,2,2
3471,piattaforma,1,2,0,2
43240,മറ്റും,0,0,2,2
29933,فأنا,0,0,2,2
28893,വിഷമിക്കേണ്ടതില്ല.,0,0,2,2
45980,inscrevem,0,0,2,2
35125,publicamente,0,0,2,2
7815,എപ്പോഴും,0,0,2,2
9523,puesto,0,0,2,2
389,epic,2,1,1,2
14681,faculdade,0,0,2,2
3834,rimangono,1,2,0,2
33584,jours,0,0,2,2
32860,geschreven.,0,0,2,2
7795,формально,0,0,2,2
14219,buenos,0,0,2,2
26573,kullansam,0,0,2,2
46157,acíclico,0,0,2,2
46365,ಆಹಾರವನ್ನು,0,0,2,2
9653,ಹುರಿದುಂಬಿಸಲು,0,0,2,2
28744,preocupações,0,0,2,2
29092,saiu,0,0,2,2
47525,ಅದ್ಭುತವಾಗಿದೆ,0,0,2,2
14222,journalist,0,0,2,2
28743,உள்ளன,0,0,2,2
32885,gustaría,0,0,2,2
33575,क्रिया,0,0,2,2
42960,விரைவான,0,0,2,2
14391,محظوظ,0,0,2,2
14743,variantes,0,0,2,2
28741,زوار,0,0,2,2
7865,alegações,0,0,2,2
33644,correctly,0,0,2,2
14211,ನೋಡುತ್ತೇನೆ.,0,0,2,2
10123,другу,0,0,2,2
42964,gorman,0,0,2,2
9617,pointu,0,0,2,2
46154,respecto,0,0,2,2
3522,dovuto,1,2,0,2
7678,reflects,0,0,2,2
14642,ertrinken,0,0,2,2
809,premium,1,2,0,2
50728,forvaltere,0,0,2,2
43313,marquée,0,0,2,2
29939,تلفظ,0,0,2,2
46009,ವಾಕ್ಯಗಳನ್ನು,0,0,2,2
47477,partage,0,0,2,2
28746,emails,0,0,2,2
10120,poner,0,0,2,2
10232,réunion,0,0,2,2
7863,pude,0,0,2,2
14213,offers,0,0,2,2
45925,colaborativo,0,0,2,2
7857,curtos,0,0,2,2
10250,incomodá-lo,0,0,2,2
7874,इतनी,0,0,2,2
14637,ഒരിക്കലും,0,0,2,2
33484,s’intéressent,0,0,2,2
2826,matrimonio,2,1,1,2
34974,φράσης,0,0,2,2
10249,целях,0,0,2,2
9950,biodiversité,0,0,2,2
43324,randevum,0,0,2,2
14748,reçoit,0,0,2,2
34973,получает,0,0,2,2
29095,സ്യൂവ്,0,0,2,2
52082,إرسال,0,0,2,2
46163,custom-made,0,0,2,2
2740,dispositivo,2,1,1,2
14751,πράξη,0,0,2,2
47528,zustimmen.,0,0,2,2
50678,يتلقى,0,0,2,2
10247,सैनिकों,0,0,2,2
14209,{{{}}},0,0,2,2
7873,मोटापे,0,0,2,2
26574,kriterier,0,0,2,2
10242,words.,0,0,2,2
32888,stom,0,0,2,2
26527,ಭೇಟಿಯಾಗಲು,0,0,2,2
14206,interconnected,0,0,2,2
10117,वीं,0,0,2,2
32816,computadores,0,0,2,2
42958,establecer,0,0,2,2
51789,കളിയാക്കണം,0,0,2,2
33690,considerados,0,0,2,2
45922,precis,0,0,2,2
14638,стоит.,0,0,2,2
30027,heter,0,0,2,2
3864,donna,2,1,1,2
29018,busy,0,0,2,2
10246,നിഷ്പക്ഷത,0,0,2,2
47479,மகிழ்ச்சியான,0,0,2,2
43309,ಹೋಗುವುದು,0,0,2,2
46308,данных.,0,0,2,2
807,volte.,1,2,0,2
26768,llevó,0,0,2,2
418,primati,1,2,0,2
43205,littérature,0,0,2,2
28904,ouviu,0,0,2,2
9944,retour,0,0,2,2
33681,seine,0,0,2,2
43291,hungry,0,0,2,2
29938,പ്രതീക്ഷിക്കുന്നു,0,0,2,2
26537,перцептрон,0,0,2,2
28755,αναπτύσσεται,0,0,2,2
9887,propuso,0,0,2,2
33497,antecipadamente,0,0,2,2
33498,salinity,0,0,2,2
33579,användargränssnitt,0,0,2,2
33683,gentille,0,0,2,2
43296,öğle,0,0,2,2
28800,llevando,0,0,2,2
43022,निरीक्षण,0,0,2,2
14726,bromeando,0,0,2,2
50685,dazu,0,0,2,2
46370,juni,0,0,2,2
9899,personnalités,0,0,2,2
29024,arme,0,0,2,2
14717,lancement,0,0,2,2
47519,சொற்களஞ்சியத்தை,0,0,2,2
26763,ഓൺലൈൻ,0,0,2,2
14263,administrada,0,0,2,2
26765,comidas,0,0,2,2
34992,smaragder,0,0,2,2
3835,applicazione,1,2,0,2
3579,branca,1,2,0,2
51782,понимаешь,0,0,2,2
33680,mand,0,0,2,2
7850,имели,0,0,2,2
14257,reprennent,0,0,2,2
47520,സമവാക്യത്തിന്റെ,0,0,2,2
34989,pensei,0,0,2,2
43298,suggesting,0,0,2,2
14736,faits,0,0,2,2
10227,ചങ്ങാതിമാരുമായി,0,0,2,2
43305,συνεχίσετε,0,0,2,2
29913,propriedade,0,0,2,2
2820,crudele,1,2,0,2
14382,сервер,0,0,2,2
29912,ήξερα,0,0,2,2
33647,„википедию“,0,0,2,2
10226,pakistan,0,0,2,2
10228,langsom,0,0,2,2
9882,τρόπους,0,0,2,2
46152,الروسية,0,0,2,2
46300,musun,0,0,2,2
14732,ναρκίσσου,0,0,2,2
26782,كذلك,0,0,2,2
14735,entró,0,0,2,2
35039,хорошая.,0,0,2,2
46392,yapamayacağınız,0,0,2,2
42967,role,0,0,2,2
7800,hawaiiska,0,0,2,2
30026,door.,0,0,2,2
45939,बंद,0,0,2,2
46390,magical,0,0,2,2
26697,manipulation,0,0,2,2
14245,diretamente,0,0,2,2
42969,credenciais,0,0,2,2
28752,لمدة,0,0,2,2
28803,preparado,0,0,2,2
2817,l'abilità,1,2,0,2
28751,uanset,0,0,2,2
26779,नियंत्रण,0,0,2,2
47482,¿quieres,0,0,2,2
33578,textuel,0,0,2,2
26532,opiniões,0,0,2,2
14730,ذكرت,0,0,2,2
10223,användare.,0,0,2,2
28748,étudient,0,0,2,2
45934,passent,0,0,2,2
46028,scrubs,0,0,2,2
46360,animals.,0,0,2,2
823,mese,1,2,0,2
14500,verwirrt.,0,0,2,2
3421,programmi,1,2,0,2
10438,década,0,0,2,2
10439,ancienne,0,0,2,2
47386,вялым,0,0,2,2
10440,anônimo,0,0,2,2
32934,crée,0,0,2,2
14936,свидетельствуют,0,0,2,2
42821,ರಹಸ್ಯವಾದ,0,0,2,2
29836,ಸುಂದರ,0,0,2,2
35211,noemen,0,0,2,2
34862,обеспечения,0,0,2,2
43537,analogs,0,0,2,2
29835,перестань,0,0,2,2
13873,internetleverantörer,0,0,2,2
10037,latijnse,0,0,2,2
43533,тесно,0,0,2,2
43532,syftet,0,0,2,2
10512,الجمل,0,0,2,2
35210,lektionen,0,0,2,2
46221,إخبار,0,0,2,2
28854,portail,0,0,2,2
9389,manipulación,0,0,2,2
2710,rumelhart,2,1,1,2
52086,огромный,0,0,2,2
280,immagino,1,2,0,2
33611,könntest,0,0,2,2
47387,laddade,0,0,2,2
33612,способом,0,0,2,2
7996,outros.,0,0,2,2
10437,histoire.,0,0,2,2
42822,npov.,0,0,2,2
278,antico,1,2,0,2
13883,généraliste,0,0,2,2
10442,gelişmesi,0,0,2,2
29832,düğmesine,0,0,2,2
35078,rights,0,0,2,2
28962,prevalent,0,0,2,2
35095,mauvais,0,0,2,2
34860,അവസ്ഥയിൽ,0,0,2,2
9418,beri,0,0,2,2
9417,permission,0,0,2,2
9760,न्यूट्रल,0,0,2,2
29965,intereses,0,0,2,2
43078,போதுமான,0,0,2,2
46248,food.,0,0,2,2
3799,l'affidabilità,1,2,0,2
43545,diagnosis.,0,0,2,2
43079,ens,0,0,2,2
32779,அறிமுகப்படுத்தப்பட்டது.,0,0,2,2
8010,wikiality,0,0,2,2
42813,لدرجة,0,0,2,2
29966,overall.,0,0,2,2
13865,பெயர்,0,0,2,2
8007,amaçlı,0,0,2,2
9762,artiklerne,0,0,2,2
29054,मांग,0,0,2,2
28647,l,0,0,2,2
33746,ಇಲ್ಲಿಗೆ,0,0,2,2
3423,portland,1,2,0,2
28645,reinvestment,0,0,2,2
9573,καλώς,0,0,2,2
26637,regel,0,0,2,2
33426,censura,0,0,2,2
13867,σελίδων,0,0,2,2
43540,finns.,0,0,2,2
3499,fondata,1,2,0,2
9686,webbplats,0,0,2,2
43124,bottom,0,0,2,2
14564,constants,0,0,2,2
28848,limité,0,0,2,2
7994,യഥാർത്ഥത്തിൽ,0,0,2,2
7571,esmeraldas,0,0,2,2
7564,hébergeant,0,0,2,2
26946,прикрыть,0,0,2,2
7710,non.,0,0,2,2
43513,inventé,0,0,2,2
26429,en.m.wikipedia.org,0,0,2,2
34828,какое,0,0,2,2
42834,लैटिन,0,0,2,2
33738,l'univers,0,0,2,2
13906,producido,0,0,2,2
47671,വർഗ്ഗ,0,0,2,2
28836,ആദ്യത്തെ,0,0,2,2
34869,ചെയ്യും,0,0,2,2
10422,opensolaris,0,0,2,2
14920,συμβαίνουν,0,0,2,2
46086,economy,0,0,2,2
35232,publiées,0,0,2,2
28657,источникам,0,0,2,2
27000,hakkına,0,0,2,2
43511,organisation,0,0,2,2
50285,दानपुण्य,0,0,2,2
35233,conduire,0,0,2,2
34877,totalidad,0,0,2,2
10049,bize,0,0,2,2
13921,daarnaast,0,0,2,2
26989,الموجودة,0,0,2,2
45805,സിൽവർ,0,0,2,2
47398,grados,0,0,2,2
9779,comedy,0,0,2,2
43510,нет.,0,0,2,2
2713,fa,1,2,0,2
2871,raramente,2,1,1,2
28834,toegang,0,0,2,2
33620,toplantı,0,0,2,2
14915,således,0,0,2,2
10420,beleuchtet,0,0,2,2
3434,adattivo,1,2,0,2
14989,francophones,0,0,2,2
14497,stackars,0,0,2,2
47394,comercial.,0,0,2,2
7573,diagnostic,0,0,2,2
46051,விரல்களைக்,0,0,2,2
13893,comscore.,0,0,2,2
28934,ben.,0,0,2,2
14566,endişelendiğini,0,0,2,2
43594,administrativo,0,0,2,2
26951,verbal,0,0,2,2
13891,فضلك؟,0,0,2,2
7743,sección,0,0,2,2
3494,minuto,2,1,1,2
9727,ಟೆರೆನ್ಸ್,0,0,2,2
9728,परिष्कृत,0,0,2,2
13890,contributor,0,0,2,2
26640,இருக்கலாம்,0,0,2,2
26952,extérieure,0,0,2,2
45798,deposited,0,0,2,2
13895,eruditos,0,0,2,2
425,d'accordo,1,2,0,2
50095,everyone,0,0,2,2
35205,norueguês,0,0,2,2
43595,obligé,0,0,2,2
7574,bounds,0,0,2,2
43074,seeks,0,0,2,2
13899,mécanisme,0,0,2,2
26948,report.,0,0,2,2
46443,கணித,0,0,2,2
50099,silly,0,0,2,2
33427,kötü,0,0,2,2
46215,evlenmek,0,0,2,2
10018,रखना,0,0,2,2
28656,groundwater,0,0,2,2
33739,बढ़ाने,0,0,2,2
14988,ரொட்டியை,0,0,2,2
50335,mil.,0,0,2,2
50281,procurando,0,0,2,2
10050,सोर्बियाई,0,0,2,2
26614,tidigt,0,0,2,2
14972,сказали,0,0,2,2
43573,daarna,0,0,2,2
28992,νοιάζει,0,0,2,2
3591,successivi,1,2,0,2
3593,descriveva,1,2,0,2
46240,mujeres,0,0,2,2
10486,beraber,0,0,2,2
42796,möchten.,0,0,2,2
43111,ಬೆಳಿಗ್ಗೆ,0,0,2,2
46453,hen,0,0,2,2
46241,extent,0,0,2,2
29971,ach,0,0,2,2
8027,सारे,0,0,2,2
45761,ഒര്മയുല്ലപ്പം,0,0,2,2
3793,infrazioni,1,2,0,2
26983,दिखती,0,0,2,2
47684,venido,0,0,2,2
467,stampa,1,2,0,2
50642,daad,0,0,2,2
14968,εσείς.,0,0,2,2
10480,pensé,0,0,2,2
28857,bancaire,0,0,2,2
10481,reglerna,0,0,2,2
13827,başlamak,0,0,2,2
14557,sverige.,0,0,2,2
42799,jornal,0,0,2,2
35092,flinke,0,0,2,2
7731,sød,0,0,2,2
29141,यू,0,0,2,2
3428,servire,1,2,0,2
50096,специально,0,0,2,2
28973,erasmus,0,0,2,2
43083,ऋण,0,0,2,2
13817,تتبع,0,0,2,2
46063,ruso,0,0,2,2
46450,shifted,0,0,2,2
26397,الأشهر,0,0,2,2
34836,ask.,0,0,2,2
29140,celebrated,0,0,2,2
250,ufficiali,1,2,0,2
14983,വിട,0,0,2,2
2893,proposta,1,2,0,2
9733,διαγραφή,0,0,2,2
28847,الأمور؟,0,0,2,2
8029,rikedomar,0,0,2,2
9703,мной,0,0,2,2
45755,engang,0,0,2,2
43581,пятница,0,0,2,2
29819,അമ്മയോട്,0,0,2,2
43106,consultées,0,0,2,2
10501,συνομιλία,0,0,2,2
9398,gradually,0,0,2,2
35229,parfaite,0,0,2,2
33766,немного.,0,0,2,2
46074,научными,0,0,2,2
46267,slaat,0,0,2,2
34838,nuestro,0,0,2,2
9587,bacterial,0,0,2,2
26628,gelernt,0,0,2,2
7551,adicional,0,0,2,2
28975,μέλισσα,0,0,2,2
32842,entendiste,0,0,2,2
51965,énorme,0,0,2,2
13812,scolaires,0,0,2,2
792,condotta,1,2,0,2
9735,months,0,0,2,2
13814,structures,0,0,2,2
14980,posee,0,0,2,2
9702,rusa,0,0,2,2
50640,мета-вики,0,0,2,2
50270,academics,0,0,2,2
46334,tiende,0,0,2,2
13796,conhece,0,0,2,2
10469,haya,0,0,2,2
46230,niño,0,0,2,2
29967,αρχή,0,0,2,2
10464,hemma,0,0,2,2
13850,admite,0,0,2,2
45777,especialistas,0,0,2,2
746,simili,1,2,0,2
46079,biased,0,0,2,2
3551,accedere,1,2,0,2
9999,administrator,0,0,2,2
7735,результате,0,0,2,2
51967,environnement,0,0,2,2
51812,estatuto,0,0,2,2
46273,wikiznanie,0,0,2,2
13801,γλυκιά,0,0,2,2
50710,pequenos,0,0,2,2
26408,जलाया,0,0,2,2
47680,aprenderá,0,0,2,2
14507,miedo,0,0,2,2
50645,presentatie,0,0,2,2
409,limiti,1,2,0,2
35220,σχέδια,0,0,2,2
46081,सेकंड,0,0,2,2
29133,sat,0,0,2,2
45783,ute,0,0,2,2
45782,world.,0,0,2,2
33624,désigne,0,0,2,2
45778,ಡಿಗ್ರಿಗಳಿಗಿಂತ,0,0,2,2
52088,weiter,0,0,2,2
14984,felipe,0,0,2,2
10461,दोहरा,0,0,2,2
3792,miglio,1,2,0,2
46060,σχετικά,0,0,2,2
13853,लाइफ,0,0,2,2
46341,проблем.,0,0,2,2
9693,shape,0,0,2,2
43563,इण्टरनेट,0,0,2,2
2700,voi,1,2,0,2
26611,കുറിച്ചുള്ള,0,0,2,2
8016,dias,0,0,2,2
3542,protein,2,1,1,2
42801,ansåg,0,0,2,2
43115,querido,0,0,2,2
51813,etmeye,0,0,2,2
9581,fique,0,0,2,2
43585, modifications,0,0,2,2
50282,بجدية,0,0,2,2
7555,notable,0,0,2,2
34845,अविश्वसनीय,0,0,2,2
14549,pseudonyme,0,0,2,2
43114,tudo.,0,0,2,2
34835,größer,0,0,2,2
10477,klugen,0,0,2,2
33614,fiil,0,0,2,2
34850,версий,0,0,2,2
46078,spokesman,0,0,2,2
29827,gifte,0,0,2,2
51994,ontmoeten,0,0,2,2
45750,пройти,0,0,2,2
43118,tijdschrift,0,0,2,2
46448,απόψε,0,0,2,2
28972,لذلك،,0,0,2,2
47683,शोधकर्ताओं,0,0,2,2
33516,kalla,0,0,2,2
26970,yaacov,0,0,2,2
47562,perdón,0,0,2,2
43555,quantités,0,0,2,2
32838,antemano,0,0,2,2
7558,авторском,0,0,2,2
7556,названием,0,0,2,2
14963,colour,0,0,2,2
9782,технологического,0,0,2,2
412,sorpresa,1,2,0,2
33433,controversos,0,0,2,2
13772,फिल्म,0,0,2,2
7703,cox,0,0,2,2
47581,redacteuren,0,0,2,2
14004,djupt,0,0,2,2
10078,officiellement,0,0,2,2
14539,descrevem,0,0,2,2
28825,grandiosa,0,0,2,2
9555,எங்களுக்கு,0,0,2,2
43096,فضيًا,0,0,2,2
9556,einfache,0,0,2,2
33550,bloqueado,0,0,2,2
14003,processing,0,0,2,2
28686,videonun,0,0,2,2
32916,merezco,0,0,2,2
26452,presidente,0,0,2,2
26891,اللطيف,0,0,2,2
42865,русская,0,0,2,2
34906,ക്രോധ,0,0,2,2
8043,healthcare,0,0,2,2
3809,sviluppati,1,2,0,2
10362,собственные,0,0,2,2
10080,acontecem,0,0,2,2
45844,серверы,0,0,2,2
26887,azeri,0,0,2,2
828,sottoposta,1,2,0,2
13769,hittar,0,0,2,2
14590,welgemanierd,0,0,2,2
7947,philosophies,0,0,2,2
744,avevano,1,2,0,2
26888,climatiques,0,0,2,2
50273,ആവർത്തിക്കാൻ,0,0,2,2
34910,ಹಿಡಿಯಲಿಲ್ಲ.,0,0,2,2
3439,crea,2,1,1,2
10367,primer,0,0,2,2
43062,manque,0,0,2,2
26457,escrituras,0,0,2,2
46338,examination,0,0,2,2
34902,« pour,0,0,2,2
32850,varandra,0,0,2,2
26598,armazenadas,0,0,2,2
26450,ಫೋನ್,0,0,2,2
14882,лишнюю,0,0,2,2
29062,'y',0,0,2,2
7580,glemmer,0,0,2,2
9558,explicações,0,0,2,2
10069,measures,0,0,2,2
34901,όνομά,0,0,2,2
9801,tro,0,0,2,2
26903,idioma,0,0,2,2
14468,banka,0,0,2,2
14582,bryr,0,0,2,2
26899,εμφανίζεται,0,0,2,2
43462,licensierad,0,0,2,2
13997,thème,0,0,2,2
13993,വാക്കുകളിൽ,0,0,2,2
10073,vidéos,0,0,2,2
34904,ноября,0,0,2,2
9557,महसूस,0,0,2,2
26897,दलदली,0,0,2,2
45840,kritiken,0,0,2,2
47419,deviations,0,0,2,2
10369,വിക്കിപീഡിയക്കായി,0,0,2,2
14466,विश्वविद्यालयों,0,0,2,2
13991,οποιαδήποτε,0,0,2,2
50655,tomes,0,0,2,2
46198,ಇಷ್ಟಪಟ್ಟರೆ,0,0,2,2
7541,വെയിൽ‌സും,0,0,2,2
28684,købe,0,0,2,2
13773,английским,0,0,2,2
26456,nationalencyklopedin,0,0,2,2
45845,bestrijden,0,0,2,2
10375,بوميس,0,0,2,2
14542,hidden,0,0,2,2
10344,analizar,0,0,2,2
28694,materialet,0,0,2,2
26875,networks.,0,0,2,2
26465,editor-in-chief,0,0,2,2
29066,​​je,0,0,2,2
14858,അടുത്ത്,0,0,2,2
14457,rodando,0,0,2,2
7934,nemen,0,0,2,2
47584,सेक्शन,0,0,2,2
14029,autres.,0,0,2,2
9449,добро,0,0,2,2
29003,lutter,0,0,2,2
10348,participants,0,0,2,2
46422,amanhã.,0,0,2,2
9450,மாட்டேன்,0,0,2,2
14036,tornando-a,0,0,2,2
43610,phones,0,0,2,2
3549,formalmente,2,1,1,2
9674,بالكامل,0,0,2,2
10085,étiquette,0,0,2,2
33555,repeatedly,0,0,2,2
43054,yanıyor,0,0,2,2
50288,ومنفرجة,0,0,2,2
50326,मियां,0,0,2,2
32911,المراكز,0,0,2,2
9812,hende,0,0,2,2
14456,capaces,0,0,2,2
8046,വിക്കിപീഡിയരുടെ,0,0,2,2
14856,udseende,0,0,2,2
47355,funded,0,0,2,2
10340,മറ്റൊന്ന്,0,0,2,2
10524,passage,0,0,2,2
26463,conversación.,0,0,2,2
10350,المستنقع,0,0,2,2
34912,dictionnaire,0,0,2,2
33434,volledige,0,0,2,2
43444,förutom,0,0,2,2
14019,എനിക്കറിയാം.,0,0,2,2
42871,fonctionnement.,0,0,2,2
46426,amostra,0,0,2,2
14017,جيد.,0,0,2,2
7763,വരുത്തുന്നതിൽ,0,0,2,2
32852,தொகுப்புக்களை,0,0,2,2
35237,için.,0,0,2,2
3811,smartphone,2,1,1,2
50658,störst,0,0,2,2
14593,देखें।,0,0,2,2
29987,внимание,0,0,2,2
14870,arise,0,0,2,2
42870,purement,0,0,2,2
34914,yerde,0,0,2,2
33553,ರೀತಿಯಲ್ಲಿ,0,0,2,2
7596,contrôler,0,0,2,2
33520,au-dessus,0,0,2,2
10352,тупому,0,0,2,2
10353,ഉണ്ടെന്ന്,0,0,2,2
9583,vocabulário,0,0,2,2
3441,sapere.,1,2,0,2
43057,καθόλου,0,0,2,2
826,doveva,1,2,0,2
7592,descrição,0,0,2,2
3546,vieni,1,2,0,2
2768,sala,2,1,1,2
9716,wikiprogramvaran,0,0,2,2
29865,assez.,0,0,2,2
33435,ശല്യപ്പെടുത്തുന്നതിൽ,0,0,2,2
14459,അദ്ദേഹം,0,0,2,2
35188,customer,0,0,2,2
795,sviluppato,1,2,0,2
50339,d'objet,0,0,2,2
50653,இடமில்லை,0,0,2,2
7967,kurallarına,0,0,2,2
51771,terminar.,0,0,2,2
13783,accessible,0,0,2,2
28949,الخبراء,0,0,2,2
9432,naturaliste,0,0,2,2
26921,ekstremt,0,0,2,2
47405,дайте,0,0,2,2
10014,nej.,0,0,2,2
3538,geometria,2,1,1,2
13950,fei-fei,0,0,2,2
26920,mile,0,0,2,2
26440,devrait,0,0,2,2
50706,teil,0,0,2,2
10397,இருப்பதால்,0,0,2,2
28669,magisk,0,0,2,2
33545,doctors',0,0,2,2
7964,divers,0,0,2,2
51814,pnina,0,0,2,2
34900,αξίζω,0,0,2,2
13954,reposant,0,0,2,2
33546,консенсуса,0,0,2,2
29125,विस्तार,0,0,2,2
43486,encountered,0,0,2,2
50302,لما,0,0,2,2
29855,formel,0,0,2,2
45810,कोष,0,0,2,2
9602,തുടർച്ചയായി,0,0,2,2
9795,группы,0,0,2,2
46252,drüben,0,0,2,2
46043,wild,0,0,2,2
46042,произношение,0,0,2,2
33619,algoritmes,0,0,2,2
30055,rødder,0,0,2,2
14532,store.,0,0,2,2
9790,കഴിഞ്ഞ്,0,0,2,2
7746,bog,0,0,2,2
13937,we're,0,0,2,2
50342,ഇംഗ്ലീഷിൽ,0,0,2,2
10053,dominios,0,0,2,2
30052,fandt,0,0,2,2
10009,movimiento,0,0,2,2
790,elogiata,1,2,0,2
46067,.ಇದು,0,0,2,2
7751,कॉमंस,0,0,2,2
26927,ಹೇಳುತ್ತೇನೆ,0,0,2,2
14903,serviços,0,0,2,2
28664,στόλλμαν,0,0,2,2
47665,olmaya,0,0,2,2
52002,सुधारने,0,0,2,2
26929,μυστικό,0,0,2,2
26925,observou,0,0,2,2
3550,paradigma,2,1,1,2
14900,கூறுகிறீர்கள்.,0,0,2,2
52007,numarası,0,0,2,2
13942,मुफ़्त,0,0,2,2
42844,entretient,0,0,2,2
46045,сэнгером,0,0,2,2
35073,montrent,0,0,2,2
46438,accessibles,0,0,2,2
7752,मेटा,0,0,2,2
50258,انا,0,0,2,2
10518,integral,0,0,2,2
10401,attribution,0,0,2,2
32848,början,0,0,2,2
9680,поблагодарить,0,0,2,2
9427,intonation.,0,0,2,2
13931,журналы,0,0,2,2
14469,இயங்கும்,0,0,2,2
33549,സുന്ദരൻ,0,0,2,2
26651,impactfactor,0,0,2,2
7581,rädsla,0,0,2,2
9706,suerte,0,0,2,2
33632,vinner,0,0,2,2
34894,vá.,0,0,2,2
43476,assessment,0,0,2,2
13971,ಮನುಷ್ಯ,0,0,2,2
33725,d'opposition,0,0,2,2
45829,تمزح,0,0,2,2
10065,ഇവരുടെ,0,0,2,2
43473,välkomna,0,0,2,2
35101,ಸೌಂದರ್ಯವು,0,0,2,2
45830,«вики»,0,0,2,2
43502,voorbeeldzinnen,0,0,2,2
10384,probabilité,0,0,2,2
14910,referat,0,0,2,2
13776,creencia,0,0,2,2
33432,समूहों,0,0,2,2
45807,övervaka,0,0,2,2
26433,betekent.,0,0,2,2
10378,सवारी,0,0,2,2
33617,ഇപ്പോഴും,0,0,2,2
10415,ಒಂದೇ,0,0,2,2
33724,मिन,0,0,2,2
35193,identité,0,0,2,2
46330,interacting,0,0,2,2
28828,privacidade,0,0,2,2
46210,denn,0,0,2,2
28827,opnieuw,0,0,2,2
26446,بحلول,0,0,2,2
51772,atención,0,0,2,2
9603,annoncerede,0,0,2,2
10052,ಕಷ್ಟಪಟ್ಟು,0,0,2,2
13959,работы.,0,0,2,2
7725,ಪ್ರದೇಶದ,0,0,2,2
50267,ആരുടെയെങ്കിലും,0,0,2,2
47551,hundred,0,0,2,2
29812,allebei,0,0,2,2
28672,बोमिस,0,0,2,2
9679,videos,0,0,2,2
46282,arabanın,0,0,2,2
47411,troede,0,0,2,2
42852,micro,0,0,2,2
9797,durch,0,0,2,2
34890,définitions,0,0,2,2
13930,باستخدام,0,0,2,2
13935,एंड्रयू,0,0,2,2
9426,sizi,0,0,2,2
14535,छोड़,0,0,2,2
10385,operating,0,0,2,2
46433,millet,0,0,2,2
35195,احتلت,0,0,2,2
10063,χρησιμοποιούν,0,0,2,2
7959,ervan,0,0,2,2
33542,förslag.,0,0,2,2
799,andare.,1,2,0,2
46434,robe,0,0,2,2
3437,centrale,2,1,1,2
34880,ವಿವರಿಸುತ್ತದೆ.,0,0,2,2
52070,øg,0,0,2,2
32005,வருகிறது,0,0,1,1
37643,d’extrapoler.,0,0,1,1
34037,वैनितियाई,0,0,1,1
34039,symbol,0,0,1,1
37031,классе,0,0,1,1
37028,كبد,0,0,1,1
36991,рыночную,0,0,1,1
33476,حالك,0,0,1,1
37674,kruist.,0,0,1,1
32028,ನನಸಾಗುತ್ತದೆ,0,0,1,1
36994,занимались,0,0,1,1
34006,traversing,0,0,1,1
32029,vo •,0,0,1,1
51518,छोड़ने,0,0,1,1
37646,formam,0,0,1,1
33306,soucies,0,0,1,1
52024,frivilliga,0,0,1,1
52025,فتتلقى,0,0,1,1
51930,മനസിലാക്കരുത്,0,0,1,1
37025,paranız,0,0,1,1
33489,результатах,0,0,1,1
37673,മാറുന്നു.,0,0,1,1
37030,anteriores,0,0,1,1
32027,العلماء،,0,0,1,1
33488,chapters,0,0,1,1
34035,afspreken.,0,0,1,1
37644,ಪ್ರಕಾಶಮಾನವಾದ,0,0,1,1
34007,يحالف,0,0,1,1
32030,ಪೆಟ್ಟಿಗೆಯಲ್ಲಿ,0,0,1,1
36989,മകളെക്കുറിച്ചും,0,0,1,1
36995,ссылаясь,0,0,1,1
36992,atingir,0,0,1,1
52191,bestempeld,0,0,1,1
32025,äldsta,0,0,1,1
37664,wikitrust,0,0,1,1
33481,ट्रस्ट,0,0,1,1
37012,somebody.,0,0,1,1
37013,noktadayım,0,0,1,1
33598,സന്നദ്ധ,0,0,1,1
33479,pre-assigned,0,0,1,1
52231,betrekkelijk,0,0,1,1
34014,योजनायें,0,0,1,1
37006,добрые,0,0,1,1
37655,സൈനികർക്കായി,0,0,1,1
34026,mess,0,0,1,1
37014,गैलिसियाई,0,0,1,1
33607,égalitaire,0,0,1,1
37015,τρομερά,0,0,1,1
37654,sonraki,0,0,1,1
32020,locura.,0,0,1,1
33608,automática.,0,0,1,1
51513,എന്നതു,0,0,1,1
37005,comedor,0,0,1,1
31749,aangetroffen,0,0,1,1
32021,latinske,0,0,1,1
52022,d'explosion,0,0,1,1
52001,सुनाया,0,0,1,1
51926,ಕ್ಯಾಲಿಫೋರ್ನಿಯಾದಲ್ಲಿ,0,0,1,1
37665,derste,0,0,1,1
37666,icke-vinstinriktade,0,0,1,1
33606,വെബ്സൈറ്റ്,0,0,1,1
32016,aired,0,0,1,1
36996,stormfuldt,0,0,1,1
37657,കഴിച്ചതിനുശേഷം.,0,0,1,1
51987,ஐந்து,0,0,1,1
37660,издавался,0,0,1,1
51514,നിങ്ങൾക്കാവശ്യമുണ്ടെങ്കിൽ,0,0,1,1
51515,kurallarında,0,0,1,1
37661,இவ்விணையப்,0,0,1,1
33602,الذكور.,0,0,1,1
31747,oturmak,0,0,1,1
37008,spécifique,0,0,1,1
34019,acrescentou,0,0,1,1
37659,redigerare,0,0,1,1
34021,sidans,0,0,1,1
33601,кандидата,0,0,1,1
37010,community-produced,0,0,1,1
33599,संदेशवाहक,0,0,1,1
34023,новых,0,0,1,1
37662,encontramos,0,0,1,1
34018,человеку,0,0,1,1
51986,writers.,0,0,1,1
37663,राय।,0,0,1,1
32018,l'enfant,0,0,1,1
37658,καταπληκτικού,0,0,1,1
37011,zitten.,0,0,1,1
34025,backpropagation.,0,0,1,1
31746,groep,0,0,1,1
32019,moral.,0,0,1,1
34027,skylldes,0,0,1,1
37667,डालने,0,0,1,1
32013,suponga,0,0,1,1
37004,العودة,0,0,1,1
31744,скачать,0,0,1,1
51516,alternativt,0,0,1,1
34008,cómo',0,0,1,1
51985,definierade,0,0,1,1
37649,francés.,0,0,1,1
51928,eden,0,0,1,1
32008,ira.,0,0,1,1
37001,reklamer,0,0,1,1
37021,mecanismo,0,0,1,1
33591,खपत,0,0,1,1
32007,enlever,0,0,1,1
37000,opmerken,0,0,1,1
51517,பேச்சுவழக்கு,0,0,1,1
37023,burocratas,0,0,1,1
37670,cortésmente.,0,0,1,1
51988,उदघाटन,0,0,1,1
32024,форма,0,0,1,1
36999,बतलाता,0,0,1,1
36998,உருவாக்கும்.,0,0,1,1
36997,karşılaştığı,0,0,1,1
33485,होफ्लिंग,0,0,1,1
34032,kämpade,0,0,1,1
33486,alentar,0,0,1,1
32006,supieran,0,0,1,1
33615,parity,0,0,1,1
52193,taliban,0,0,1,1
37650,canada's,0,0,1,1
37020,moldave[quoi ],0,0,1,1
31745,свадебном,0,0,1,1
51925,darüber,0,0,1,1
37668,entorpecen,0,0,1,1
37653,confusas,0,0,1,1
33482,ध्वजांकित,0,0,1,1
33478,bedömas,0,0,1,1
32012,movie,0,0,1,1
34029,സ്വതന്ത്രവിജ്ഞാനകോശമായി,0,0,1,1
33483,entières,0,0,1,1
37652,écrits,0,0,1,1
34030,l’âge,0,0,1,1
33300,spreken.,0,0,1,1
33595,للمساعدة.,0,0,1,1
34011,فرنسا,0,0,1,1
33303,जिनका,0,0,1,1
33594,ஆண்டுகள்,0,0,1,1
34031,somewhere.,0,0,1,1
52192,counterparts,0,0,1,1
34013,alabilir.,0,0,1,1
32010,للأبحاث,0,0,1,1
37019,passa,0,0,1,1
52023,cronometra,0,0,1,1
51440,caractérisait,0,0,1,1
33592,l’intégrité,0,0,1,1
34012,എഴുതാവുന്ന,0,0,1,1
34040,demografie,0,0,1,1
51467,языком,0,0,1,1
37675,i̇çeriklerin,0,0,1,1
34115,vraiment.,0,0,1,1
51534,voir.,0,0,1,1
51916,anzutreten.,0,0,1,1
36895,റിച്ചാർഡ്,0,0,1,1
37731,ألست,0,0,1,1
31710,нейтральная,0,0,1,1
36896,göstermektedir.,0,0,1,1
52184,encantada,0,0,1,1
34114,മൃഗമാണെന്നും,0,0,1,1
51917,ഉൽപത്തി,0,0,1,1
33548,stupéfait,0,0,1,1
37730,apporté,0,0,1,1
51430,والاستنتاجي.,0,0,1,1
31711,« pédia »,0,0,1,1
31712,percept,0,0,1,1
32079,positionnement,0,0,1,1
32078,स्थल,0,0,1,1
31713,vaters,0,0,1,1
36898,مقصود,0,0,1,1
31714,tribos,0,0,1,1
36899,needing,0,0,1,1
32077,emulados,0,0,1,1
36900,succinctes,0,0,1,1
37728,yazılan,0,0,1,1
34113,determinación,0,0,1,1
34112,तुम्हे,0,0,1,1
36894,സമർപ്പിക്കപ്പെടുന്ന,0,0,1,1
34116,depicting,0,0,1,1
51431,والاستفادة,0,0,1,1
31709,الخلاف,0,0,1,1
33259,hardnekkiger,0,0,1,1
32085,പക്ഷപാതിത്വം,0,0,1,1
33539,συγνώμη.,0,0,1,1
33540,freude,0,0,1,1
36884,vez.,0,0,1,1
36885,πάει.,0,0,1,1
34122,spammers,0,0,1,1
37736,കണ്ടെത്തുക,0,0,1,1
37735,resulte,0,0,1,1
37734,الواضح,0,0,1,1
33510,denuncias,0,0,1,1
51429,στιλβωμένος,0,0,1,1
32084,irse,0,0,1,1
51914,ಒಂದನ್ನು,0,0,1,1
32083,arbetsdelning.,0,0,1,1
33543,clasificados,0,0,1,1
33544,ಕೋಪಗೊಂಡಿದ್ದಾರೆ,0,0,1,1
36889,wijzigingen,0,0,1,1
36890,günden,0,0,1,1
36892,«„википедия“,0,0,1,1
31707,одному,0,0,1,1
31708,снится,0,0,1,1
36893,gåva,0,0,1,1
32081,.അതിനാൽ,0,0,1,1
34117,நடத்தப்படும்,0,0,1,1
33509,रैंक,0,0,1,1
32076,aangeslagen.,0,0,1,1
32086,define,0,0,1,1
33551,മാതൃവെബ്‌സൈറ്റിനെക്കാൾ,0,0,1,1
34103,debatidos,0,0,1,1
51989,dorf,0,0,1,1
51533,sayfada,0,0,1,1
37721,geheim.,0,0,1,1
51919,behandelde.,0,0,1,1
34102,page-views,0,0,1,1
33508,aussprechen.,0,0,1,1
33507,டெர்ரியைப்,0,0,1,1
33267,ബേക്കർ,0,0,1,1
33554,embaucher,0,0,1,1
51920,وخوادم,0,0,1,1
36913,sometimes.,0,0,1,1
36914,médiathèque,0,0,1,1
33268,fio.,0,0,1,1
33269,« passeur »,0,0,1,1
37718,macht,0,0,1,1
33557,предмету,0,0,1,1
37717,disiez,0,0,1,1
33270,aklınızda,0,0,1,1
51531,encargó,0,0,1,1
36917,razones,0,0,1,1
33558,കരുതി,0,0,1,1
51921,dije,0,0,1,1
34098,probablemente,0,0,1,1
34097,supportée,0,0,1,1
51990,äußersten,0,0,1,1
52186,കൃത്യമായൊരു,0,0,1,1
34110,gekauft,0,0,1,1
37722,sugiriendo,0,0,1,1
51991,transforme,0,0,1,1
37726,entendrez,0,0,1,1
37725,перебил.,0,0,1,1
33262,contestadas,0,0,1,1
34109,താല്പര്യമില്ല.,0,0,1,1
34108,jättebra,0,0,1,1
51918,grædende,0,0,1,1
36903,envers,0,0,1,1
32075,രണ്ടാമത്തെ,0,0,1,1
33263,classés,0,0,1,1
33264,accepté,0,0,1,1
33265,morgon.,0,0,1,1
32073,خوان,0,0,1,1
37724,autoconfirmados,0,0,1,1
36904,φιλικό,0,0,1,1
36905,βοήθησέ,0,0,1,1
34107,доме,0,0,1,1
34106,sociedad,0,0,1,1
32072,hierher,0,0,1,1
37723,cuidas.,0,0,1,1
34105,açsın,0,0,1,1
36906,alex,0,0,1,1
36907,ದಣಿದಿದ್ದರೆ,0,0,1,1
31715,behulp,0,0,1,1
32069,франции,0,0,1,1
36883,apprendra,0,0,1,1
36882,subió,0,0,1,1
36988,حساء,0,0,1,1
33525,stilmallar,0,0,1,1
32102,проживет,0,0,1,1
36854,blinkade,0,0,1,1
34145,esenciales,0,0,1,1
32101,poursuivre,0,0,1,1
34144,olmayı,0,0,1,1
36857,वित्तपोषण,0,0,1,1
36858,prévois,0,0,1,1
51428,personnels,0,0,1,1
33248,censeurs,0,0,1,1
52030,foto's.,0,0,1,1
51540,symboliques,0,0,1,1
52029,म्यान्मारी,0,0,1,1
37755,наш,0,0,1,1
32099,granskar,0,0,1,1
51995,intervalos,0,0,1,1
32098,catch-'den,0,0,1,1
37753,utomstående.,0,0,1,1
33527,behandlas.,0,0,1,1
37752,സ്വതന്ത്രമായ,0,0,1,1
31699,centuple,0,0,1,1
32097,क्वैचुआ,0,0,1,1
36862,привилегий,0,0,1,1
34141,espéranto,0,0,1,1
34140,μνηστήρες,0,0,1,1
33515,traducido,0,0,1,1
33526,ചെയ്യാനോ,0,0,1,1
36853,noted,0,0,1,1
36864,devletleri,0,0,1,1
34147,വിഭാഗത്തിൽ,0,0,1,1
36839,കുറവല്ല.,0,0,1,1
36840,gallego,0,0,1,1
37762,तागलोग,0,0,1,1
31695,வழியாகப்,0,0,1,1
33246,amenaza,0,0,1,1
33521,lock,0,0,1,1
51910,enterarse,0,0,1,1
36844,совершила,0,0,1,1
33522,ejes,0,0,1,1
33518,cycles,0,0,1,1
33517,மூலமே,0,0,1,1
36845,dresse,0,0,1,1
36846,sofort,0,0,1,1
32107,mettent,0,0,1,1
32106,e-postadress.,0,0,1,1
52234,применить,0,0,1,1
51426,கற்றுக்கொள்ளப்,0,0,1,1
36849,wikiversidad,0,0,1,1
36850,والمتغيرات.,0,0,1,1
37760,tomo,0,0,1,1
37759,privacidad,0,0,1,1
52182,പിറ്റേന്ന്,0,0,1,1
32104,चक्कर,0,0,1,1
36851,girlfriend,0,0,1,1
51427,ventajas,0,0,1,1
32096,fundada.,0,0,1,1
37750,wijzigen,0,0,1,1
37737,одежды,0,0,1,1
33254,significando,0,0,1,1
36874,d'experts.,0,0,1,1
36875,doter,0,0,1,1
37742,genders.,0,0,1,1
33255,بمحتوى,0,0,1,1
32089,movido,0,0,1,1
31703,paradojas,0,0,1,1
33532,aparecían,0,0,1,1
34127,vandaliserat,0,0,1,1
33533,женщина,0,0,1,1
36877,startede,0,0,1,1
34125,നിലവിലുണ്ട്.,0,0,1,1
34124,nauw,0,0,1,1
37741,censored',0,0,1,1
36879,bräuchen,0,0,1,1
37740,slight,0,0,1,1
33534,ചെയ്തതുമായ,0,0,1,1
33535,videnskabsetik,0,0,1,1
37739,الأطعمة.,0,0,1,1
33536,السيرة,0,0,1,1
33258,spaß,0,0,1,1
32087,gegevens,0,0,1,1
33511,percevait,0,0,1,1
51992,التحرير،,0,0,1,1
37738,இப்போதே.,0,0,1,1
33538,particular.,0,0,1,1
33513,അത്താഴത്തിന്,0,0,1,1
34128,الإسبانية،,0,0,1,1
34138,അനാവശ്യ,0,0,1,1
33531,.ನಾವೆಲ್ಲರೂ,0,0,1,1
37749,تشكل,0,0,1,1
31700,правило,0,0,1,1
36866,tissues.,0,0,1,1
34137,comprueba,0,0,1,1
34136,статистики.,0,0,1,1
36867,are.,0,0,1,1
36868,sleep,0,0,1,1
34135,ошибке»,0,0,1,1
33252,بالكسل,0,0,1,1
51539,efficiently,0,0,1,1
37745,ವಾಕ್ಯ,0,0,1,1
34133,alternates,0,0,1,1
52028,zufällig,0,0,1,1
32094,проблема.,0,0,1,1
32093,öğrendim,0,0,1,1
36871,مقطعين,0,0,1,1
32092,വണ്ടി,0,0,1,1
34131,ഇന്റർനെറ്റുമായി,0,0,1,1
37744,licença.,0,0,1,1
34130,फ़्लैमिश,0,0,1,1
33529,угрожают,0,0,1,1
31701,غالباً،,0,0,1,1
51912,مصرفي,0,0,1,1
51538,begrijp,0,0,1,1
31702,ಸೈನ್ಯದ,0,0,1,1
37716,വീഡിയോയിൽ‌,0,0,1,1
51530,confundido,0,0,1,1
34096,« liberal »,0,0,1,1
32044,интернет-сайт,0,0,1,1
36958,റിപ്പബ്ലിക്ക്,0,0,1,1
34057,alphazero,0,0,1,1
36959,imprécis,0,0,1,1
36960,أمريكا,0,0,1,1
34056,டாலர்களை,0,0,1,1
31735,laïque,0,0,1,1
37688,ಮೂಲಗಳನ್ನು,0,0,1,1
32043,amável,0,0,1,1
34055,åldrar,0,0,1,1
37687,മാർച്ച്,0,0,1,1
36962,tas,0,0,1,1
51998,quejan,0,0,1,1
31736,богатств,0,0,1,1
33581,eveneens,0,0,1,1
33582,oldum.,0,0,1,1
33583,ಗೆಳೆಯನಿಗೆ,0,0,1,1
51520,methane.,0,0,1,1
33495,ستستخدمها,0,0,1,1
32040,энциклопедий,0,0,1,1
36964,социальной,0,0,1,1
34052,λατινικές,0,0,1,1
33287,finance,0,0,1,1
32039,வங்கி,0,0,1,1
33288,esperar.,0,0,1,1
36967,quinta,0,0,1,1
34058,حق,0,0,1,1
34060,farms,0,0,1,1
51519,rätta,0,0,1,1
32045,ಪರಸ್ಪರ,0,0,1,1
33500,erfgoed,0,0,1,1
36947,ilgilerini,0,0,1,1
51524,fomenta,0,0,1,1
37694,frihed,0,0,1,1
36948,opinions.,0,0,1,1
33282,अधीन,0,0,1,1
36949,уравновешенный,0,0,1,1
36950,неприятной,0,0,1,1
51523,നിർവ്വാഹകർ,0,0,1,1
37693,т. н.,0,0,1,1
37692,paradoxo,0,0,1,1
37691,uncyclopedia,0,0,1,1
33576,disculpas.,0,0,1,1
34062,intelectual ,0,0,1,1
31731,l'accent,0,0,1,1
33499,الويكيبيديات،,0,0,1,1
31733,entregue,0,0,1,1
36952,dérangerait-il,0,0,1,1
51522,riding,0,0,1,1
34061,العربية,0,0,1,1
36955,retrace,0,0,1,1
51521,possibility,0,0,1,1
33285,udføre,0,0,1,1
36957,locale,0,0,1,1
33577,fungerer,0,0,1,1
36968,quienes,0,0,1,1
36969,нарциссизм,0,0,1,1
33272,nació,0,0,1,1
36979,informationskälla,0,0,1,1
51438,है।कुछ,0,0,1,1
34045,desencorajam,0,0,1,1
32035,विज्ञापनपर,0,0,1,1
36982,μπόρεσα,0,0,1,1
31742,sekunde.,0,0,1,1
31743,l'opérateur,0,0,1,1
33587, ×,0,0,1,1
34044,humans.,0,0,1,1
36984,പങ്കു,0,0,1,1
34043,primarias,0,0,1,1
32034,المقاطعة,0,0,1,1
32033,ಎಂದರ್ಥ,0,0,1,1
52026,чем-нибудь.,0,0,1,1
34042,demenin,0,0,1,1
36985,पूछे,0,0,1,1
33491,रूसी,0,0,1,1
33588,ഏകഗ്രഹമാണ്,0,0,1,1
32032,topla.,0,0,1,1
36986,«the,0,0,1,1
34041,heeft.,0,0,1,1
32031,vollständig,0,0,1,1
37676,c..,0,0,1,1
33490,अनुवादित,0,0,1,1
33589,अंग्रजी,0,0,1,1
36987,يكافئ,0,0,1,1
36980,тону,0,0,1,1
51999,wikiprogramvara,0,0,1,1
31737,للتعبير,0,0,1,1
36978,viewing,0,0,1,1
36970,لاحقًا،,0,0,1,1
31738,ಸುಂದರವಾಗಿದ್ದರು.,0,0,1,1
31739,pássaro,0,0,1,1
32038,nede,0,0,1,1
33493,bulunmuştur.,0,0,1,1
36972,cero.,0,0,1,1
36973,തമാശകളും,0,0,1,1
34049,angebot.,0,0,1,1
33290,recep,0,0,1,1
34048,അതിർത്തി,0,0,1,1
34047,konuklar,0,0,1,1
32037,jackson,0,0,1,1
31740,recebem,0,0,1,1
33585,mismo​​,0,0,1,1
33292,rannte,0,0,1,1
36974,soppa,0,0,1,1
37680,الجرس,0,0,1,1
37679,egentligen,0,0,1,1
36975,tokens,0,0,1,1
36976,consultations,0,0,1,1
33294,suffisant,0,0,1,1
32036,hebrea,0,0,1,1
37678,entonación.,0,0,1,1
33492,подобная,0,0,1,1
31741,تشير,0,0,1,1
51525,उलझन,0,0,1,1
37695,abendessen,0,0,1,1
36946,antiguo,0,0,1,1
32060,diseñada,0,0,1,1
31719,താളുകൾ‍,0,0,1,1
33278,जाग,0,0,1,1
36922,вкусной,0,0,1,1
33505,μπερδεμένοι,0,0,1,1
36923,individu,0,0,1,1
34087,കാണില്ലെന്ന്,0,0,1,1
32059,بماذا,0,0,1,1
36926,-க்கும்,0,0,1,1
34085,«спасибо,0,0,1,1
37709,anfangen.,0,0,1,1
32057,assistir,0,0,1,1
31721,экспертами,0,0,1,1
33504,awareness,0,0,1,1
36927,voordeel,0,0,1,1
31722,краткое,0,0,1,1
37707,arrastrar,0,0,1,1
37706,ലഭിച്ചത്,0,0,1,1
37705,conflitantes,0,0,1,1
31723,voortbouwen,0,0,1,1
37704,അതുമായി,0,0,1,1
32056,ಕಲಿಯುತ್ತಿದ್ದರೆ,0,0,1,1
32055,«проверяемость,0,0,1,1
37703,auc.,0,0,1,1
33502,biaisé,0,0,1,1
33565,பிரச்சினையை,0,0,1,1
33563,സൗന്ദര്യത്തെയും,0,0,1,1
34090,reed,0,0,1,1
34064,έρχεστε,0,0,1,1
33277,critère,0,0,1,1
37714,आजादी,0,0,1,1
36919,educativo,0,0,1,1
33559,கேட்கிறீர்களா,0,0,1,1
31716,sıklıkla,0,0,1,1
34095,comentário.,0,0,1,1
37712,eric,0,0,1,1
33560,camada,0,0,1,1
37711,கேட்கும்போது.,0,0,1,1
34094,പെരുമാറ്റവും,0,0,1,1
51529,മാണിക്യ,0,0,1,1
32068,لتزايد,0,0,1,1
32067,hiérarchisation,0,0,1,1
31717,பயன்படுத்த.,0,0,1,1
32065,للحديث,0,0,1,1
33506,ومثقف,0,0,1,1
33273,നാളത്തേക്ക്,0,0,1,1
33274,работающих,0,0,1,1
33275,الأمر،,0,0,1,1
32062,değerlendirilir,0,0,1,1
32061,تعليمية,0,0,1,1
31718,interessanter,0,0,1,1
36920,yazılmalıdır.,0,0,1,1
33562,non-gouvernementales,0,0,1,1
33276,технологии,0,0,1,1
51528,refereed,0,0,1,1
33566,சாப்பிடலாமா,0,0,1,1
36929,avísame,0,0,1,1
33567,beyazdır.,0,0,1,1
34083,ಕಳುಹಿಸುತ್ತೇನೆ.,0,0,1,1
34073,αυτής,0,0,1,1
34072,تطبيق,0,0,1,1
33280,ವಿಭಾಗದಲ್ಲಿ,0,0,1,1
33570,atmospheres,0,0,1,1
32048,бьет,0,0,1,1
36942,impulso,0,0,1,1
33571,l'extérieur,0,0,1,1
37698,likewise,0,0,1,1
33572,statens,0,0,1,1
31727,inexplorable,0,0,1,1
36943,கோரிக்கைகளை,0,0,1,1
33573,विकिवर्सिटी,0,0,1,1
33574,калифорнии.,0,0,1,1
34069,synke,0,0,1,1
34068,ಘಟನೆಗಳು,0,0,1,1
34067,அவளைப்,0,0,1,1
37697,растущего,0,0,1,1
36945,arkadaşlarınıza,0,0,1,1
52189,pixels,0,0,1,1
31728,incompleta,0,0,1,1
51434,inscription.,0,0,1,1
31729,hacker.,0,0,1,1
31730,sammanfattas,0,0,1,1
34065,conquistado,0,0,1,1
51436,चौथी,0,0,1,1
32050,जी,0,0,1,1
34074,obtenida,0,0,1,1
31726,enables,0,0,1,1
34079,കണ്ടെത്താം,0,0,1,1
32054,veracidad.,0,0,1,1
37701,entschuldige,0,0,1,1
36930,metamorphosed.,0,0,1,1
33568,disclose,0,0,1,1
37700,आयरिश,0,0,1,1
36931,ഒറിയ,0,0,1,1
33279,finlandês,0,0,1,1
33501,λεξικού,0,0,1,1
32053,n’oppose,0,0,1,1
36932,ಕಲಿಕೆಯನ್ನು,0,0,1,1
36933,frågeställningarna,0,0,1,1
36934,anlayabilirsiniz.,0,0,1,1
36940,three-fold,0,0,1,1
36935,متزايد,0,0,1,1
31725,dybt,0,0,1,1
36936,பார்க்கிறீர்கள்,0,0,1,1
51433,superstitions,0,0,1,1
36937,ಸಾಲವನ್ನು,0,0,1,1
31750,estates,0,0,1,1
33569,itibaren,0,0,1,1
34076,linnaeus',0,0,1,1
51527,ph.d.,0,0,1,1
34075,biased.,0,0,1,1
36939,அனுபவத்தைப்,0,0,1,1
34077,कर्मचारियों,0,0,1,1
33949,конкурсе,0,0,1,1
37032,spåddes,0,0,1,1
51975,ஊக்கத்துடன்,0,0,1,1
31811,وبين موسوعة,0,0,1,1
31908,മൂർച്ചയുള്ളവയെ,0,0,1,1
37497,proved,0,0,1,1
33714,заботиться,0,0,1,1
33373,biblique,0,0,1,1
51954,verabschieden,0,0,1,1
37495,पात्रों,0,0,1,1
33715,தரவரிசையில்,0,0,1,1
37494,mulheres.,0,0,1,1
31814,मिलनी,0,0,1,1
37285,ستعجبك,0,0,1,1
37286,organismo.,0,0,1,1
33374,publiées.,0,0,1,1
33436,intelectual,0,0,1,1
37493,नियम,0,0,1,1
37287,بياني,0,0,1,1
33717,википедистов,0,0,1,1
37288,juiz,0,0,1,1
33855,malgaxe,0,0,1,1
33375,categorias,0,0,1,1
31816,talenversies,0,0,1,1
37290,റെയിൽ‌വേ,0,0,1,1
37291,quiere,0,0,1,1
31905,κάντε,0,0,1,1
37492,«verificabilidad»​,0,0,1,1
33718,editores»,0,0,1,1
51481,admiração,0,0,1,1
37293,удалена,0,0,1,1
31903,slutade,0,0,1,1
37498,nerviosos,0,0,1,1
51483,ülkenin,0,0,1,1
37294,bekannt.,0,0,1,1
31909,accepteres,0,0,1,1
37503,lander,0,0,1,1
31801,oyununuzu,0,0,1,1
31803,navegava,0,0,1,1
31804,уроки,0,0,1,1
37502,souhaiter,0,0,1,1
33710,السبب،,0,0,1,1
31911,പകുതി,0,0,1,1
33370,ஓர்,0,0,1,1
37279,ಶನಿವಾರದಂದು,0,0,1,1
51953,വിക്കി.,0,0,1,1
37281,acervo,0,0,1,1
31806,விடுமுறை,0,0,1,1
33861,लड़का,0,0,1,1
31807,kommentarfältet,0,0,1,1
33711,الحلوة,0,0,1,1
52212,المتعددة,0,0,1,1
33371,قانون,0,0,1,1
37282,அருமையான,0,0,1,1
33437,molestarte.,0,0,1,1
37283,benämnda,0,0,1,1
52213,favorece,0,0,1,1
33712,صديقان,0,0,1,1
33860,uiterlijk,0,0,1,1
52222,collaborateurs,0,0,1,1
33859,يخبرني,0,0,1,1
33858,വിക്കിപീഡിയർക്കായുള്ള,0,0,1,1
37499,dyka,0,0,1,1
31810,faixa,0,0,1,1
37284,kanada,0,0,1,1
33719,bakalım.,0,0,1,1
33377,metadata,0,0,1,1
37278,википедией,0,0,1,1
33722,مليوني,0,0,1,1
37310,സമാനമായ,0,0,1,1
37485,arkadaşlar,0,0,1,1
33723,посещений,0,0,1,1
31893,of.,0,0,1,1
31892,വാക്യം.,0,0,1,1
37313,ismine,0,0,1,1
37484,rapidly,0,0,1,1
33845,quaisquer,0,0,1,1
31891,rubinmarmelade,0,0,1,1
52006,jenny,0,0,1,1
51477,uneven.,0,0,1,1
31825,статью»,0,0,1,1
37481,kopyalamasını,0,0,1,1
37316,δεύτερο,0,0,1,1
31889,нахожусь,0,0,1,1
31826,ಮುಸುಕಿನ,0,0,1,1
33383,உதவுவீர்கள்,0,0,1,1
37480,labores,0,0,1,1
33384,apropriado,0,0,1,1
37317,ertrinke,0,0,1,1
33385,curation,0,0,1,1
33726,политике,0,0,1,1
33386,المتمثل,0,0,1,1
51476,arquitetura,0,0,1,1
37319,tratava,0,0,1,1
52214,ആദ്യ,0,0,1,1
33727,ആഴ്ചകളോ,0,0,1,1
33839,примеров.,0,0,1,1
37320,tridimensional,0,0,1,1
31821,காரணமாக,0,0,1,1
37309,periodically.,0,0,1,1
33853,köyde,0,0,1,1
33721,excellent,0,0,1,1
37295,overnemen.,0,0,1,1
33379,нильса,0,0,1,1
33852,सके।,0,0,1,1
37296,intervenant,0,0,1,1
37297,рассказ,0,0,1,1
31817,ಕೋಪಗೊಂಡಿದ್ದೀರಿ,0,0,1,1
51480,sözlerim,0,0,1,1
37490,förfrågningar.,0,0,1,1
37299,primaires,0,0,1,1
33851,boğulabilir,0,0,1,1
33850,ställning,0,0,1,1
33849,സമ്മതിക്കുകയും,0,0,1,1
31900,φροντίστε,0,0,1,1
31818,கட்டுப்பாடில்லாத,0,0,1,1
37489,योंगल,0,0,1,1
33847,மூலத்தைப்,0,0,1,1
33720,உற்சாகமாக,0,0,1,1
31819,roches,0,0,1,1
31897,courts,0,0,1,1
37301,प्रॉजेक्ट्स,0,0,1,1
37302,graus.,0,0,1,1
37303,harvested,0,0,1,1
37304,magnétique.,0,0,1,1
31820,அதிர்ஷ்டத்தின்,0,0,1,1
51478,suprême.,0,0,1,1
37487,contribuant,0,0,1,1
36838,തോന്നുന്നുവെങ്കിൽ,0,0,1,1
31895,مجهولون,0,0,1,1
37308,hemos,0,0,1,1
51952,ülkeye,0,0,1,1
33865,cilalı,0,0,1,1
37527,सुविधाओं,0,0,1,1
37243,plataforma,0,0,1,1
51456,प्रकरण,0,0,1,1
37244,mistet,0,0,1,1
31934,tournent,0,0,1,1
51949,ontzagwekkende,0,0,1,1
33443,ആകർഷകവും,0,0,1,1
37245,vitória,0,0,1,1
37518,cooperación,0,0,1,1
37246,italianos,0,0,1,1
33701,använder.,0,0,1,1
37517,afogando,0,0,1,1
31933,  lecteurs,0,0,1,1
33442,rubíes,0,0,1,1
51485,genotypes,0,0,1,1
51977,lägstanivå.,0,0,1,1
31932,hunting,0,0,1,1
33881,väljs,0,0,1,1
33702,brugt,0,0,1,1
33880,решения.,0,0,1,1
37515,setting,0,0,1,1
31930,depicts,0,0,1,1
52223,zes,0,0,1,1
33879,крайних,0,0,1,1
52209,geleden,0,0,1,1
37248,сбитых,0,0,1,1
31928,വിശാലവും,0,0,1,1
51950,interpretive,0,0,1,1
31795,займемся,0,0,1,1
33365,bulunan,0,0,1,1
33441,çeken,0,0,1,1
33698,enhance,0,0,1,1
31935,d’être,0,0,1,1
37251,असंगतियों,0,0,1,1
37242,bibliotekariens,0,0,1,1
33359,filtres,0,0,1,1
37229,readable,0,0,1,1
37230,keer.,0,0,1,1
37231,publicitaire.,0,0,1,1
33360,independently-run,0,0,1,1
33361,أخت,0,0,1,1
33444,சிவப்பு,0,0,1,1
33696,مطعم,0,0,1,1
37525,فستان,0,0,1,1
37233,أصدق,0,0,1,1
37524,شهريًا,0,0,1,1
37234,yapmanın,0,0,1,1
37235,താൽപ്പര്യമില്ലെങ്കിൽ,0,0,1,1
37236,وإيلي,0,0,1,1
37522,historietas,0,0,1,1
52005,id,0,0,1,1
37521,complementar,0,0,1,1
37238,inanimate,0,0,1,1
37239,честно,0,0,1,1
33884,ترجمة,0,0,1,1
33883,janis,0,0,1,1
51488,الفعل,0,0,1,1
31938,ಬೆಳಗಬಹುದು,0,0,1,1
51487,مخطئ.,0,0,1,1
37520,காணலாம்,0,0,1,1
33882,സംഭവിക്കാം.,0,0,1,1
33364,bidrage,0,0,1,1
33697,daughter's,0,0,1,1
51948,négliger,0,0,1,1
31926,advertisements.,0,0,1,1
31796,deli,0,0,1,1
33866,arrays,0,0,1,1
33872,concentrerait,0,0,1,1
33871,النيويورك,0,0,1,1
33439,explícitamente.,0,0,1,1
33870,pragmatic,0,0,1,1
51951,κερδοσκοπικό,0,0,1,1
37267,कुत्ते,0,0,1,1
33707,ترتبط,0,0,1,1
37268,корпораций,0,0,1,1
51976,robots ,0,0,1,1
37509,बढ़ेगा,0,0,1,1
33368,നോക്കുമ്പോൾ,0,0,1,1
37508,അപ്പപ്പോഴത്തെ,0,0,1,1
31799,سلاش,0,0,1,1
33869,görüşmek,0,0,1,1
37506,വഴിയല്ലാതെ,0,0,1,1
31800,करना.,0,0,1,1
31914,سبب,0,0,1,1
31913,«какая,0,0,1,1
33369,نسخ,0,0,1,1
37270,beispielsweise.,0,0,1,1
37271,للتغيير،,0,0,1,1
33438,kostsamt,0,0,1,1
37505,ஈரநிலத்தின்,0,0,1,1
37272,vê.,0,0,1,1
37504,γραμμένη,0,0,1,1
33868,uppsala,0,0,1,1
37273,«список,0,0,1,1
37274,ನಿಲ್ಲಿಸಿದ್ದೇವೆ,0,0,1,1
33867,ein-,0,0,1,1
31912,दिलाना,0,0,1,1
37266,omstridte,0,0,1,1
37265,« youtube ».,0,0,1,1
52014,да.,0,0,1,1
37264,meteen,0,0,1,1
37513,funktion,0,0,1,1
33877,разговорная,0,0,1,1
31923,storslået,0,0,1,1
37254,forberedt,0,0,1,1
52210,озадачены.,0,0,1,1
52211,aborígenes,0,0,1,1
37255,பங்களிப்பாளர்களுக்கு,0,0,1,1
37256,visitante,0,0,1,1
33876,amateur-wetenschappers,0,0,1,1
37258,critic,0,0,1,1
33874,പട്ടിണി,0,0,1,1
31922,datacenter,0,0,1,1
31921,حر،,0,0,1,1
37259,വിവരങ്ങളിലൂടെ,0,0,1,1
31797,sechs,0,0,1,1
37511,felicitar,0,0,1,1
31798,homepage.,0,0,1,1
31918,inundação,0,0,1,1
33705,executiva,0,0,1,1
31917,تعاونية,0,0,1,1
31916,técnicos,0,0,1,1
31915,researcher,0,0,1,1
37260,लागत,0,0,1,1
37261,omissions,0,0,1,1
33366,война,0,0,1,1
33706,klasik,0,0,1,1
37262,വായിക്കുന്നു,0,0,1,1
33873,bulunmamaktadır.,0,0,1,1
33367,ಬಳಲುತ್ತಿದ್ದೇನೆ,0,0,1,1
31888,initiales,0,0,1,1
37321,verhungern.,0,0,1,1
37323,relación,0,0,1,1
37441,ಎಲ್ಲಿಗೆ,0,0,1,1
33800,सतत,0,0,1,1
37440,luchadores,0,0,1,1
33799,d'amnesty,0,0,1,1
52218,geldim,0,0,1,1
37438,céus,0,0,1,1
31866,heather,0,0,1,1
37382,ends,0,0,1,1
51470,otimização,0,0,1,1
33798,ഉറപ്പുണ്ട്,0,0,1,1
37384,piscaram,0,0,1,1
33797,stripfiguren,0,0,1,1
33402,değiştirdi,0,0,1,1
33796,വിവരിക്കാൻ,0,0,1,1
33762,сосуществовали,0,0,1,1
33423,modell,0,0,1,1
37385,« print,0,0,1,1
37434,endeavor,0,0,1,1
31865,എക്സ്ക്യൂസ്,0,0,1,1
33422,المنتجين,0,0,1,1
37386,ارجو,0,0,1,1
37387,verblüffend,0,0,1,1
33421,unabated,0,0,1,1
33764,руководителя,0,0,1,1
31864,القرض,0,0,1,1
37388,ಆಶ್ಚರ್ಯಪಟ್ಟರು.,0,0,1,1
37389,المتوسط,0,0,1,1
33404,şaşkınlık,0,0,1,1
37433,samarbejde,0,0,1,1
37391,அழகிய,0,0,1,1
51966,económicos,0,0,1,1
33401,uk •,0,0,1,1
31863,doce.,0,0,1,1
37442,തയ്യാറാണ്,0,0,1,1
51472,والخبز,0,0,1,1
37369,κινείσαι,0,0,1,1
33753,cd'de,0,0,1,1
37370,ben',0,0,1,1
37446,replied,0,0,1,1
31872,للنوم,0,0,1,1
37372,skeletor,0,0,1,1
33805,मां,0,0,1,1
33754,linguistic,0,0,1,1
31871,ziet.,0,0,1,1
31870,opiniões.,0,0,1,1
31842,ड्राफ्ट,0,0,1,1
52009,editável,0,0,1,1
31843,agira,0,0,1,1
31869,обнаружено,0,0,1,1
33804,aktivitet,0,0,1,1
51471,diskutera,0,0,1,1
33400,онлайн-справочников.,0,0,1,1
51960,york.,0,0,1,1
33756,exclusividade,0,0,1,1
33757,insanlar,0,0,1,1
33758,любимое,0,0,1,1
33759,legt,0,0,1,1
37376,course.,0,0,1,1
51464,അപ്രാപ്യമല്ല,0,0,1,1
51961,terá,0,0,1,1
37444,ನಕಲಿ,0,0,1,1
37377,கலைக்களஞ்சிய,0,0,1,1
37443,المنازعات.,0,0,1,1
52217,αμερική,0,0,1,1
33793,اجمع,0,0,1,1
37324,edersiniz.,0,0,1,1
31858,identifié,0,0,1,1
51964,webs,0,0,1,1
37402,علمية كتبت,0,0,1,1
37403,aparecem.,0,0,1,1
37404,geheimnis.,0,0,1,1
37405,blogs,0,0,1,1
33781,environments.,0,0,1,1
37407,encouraging,0,0,1,1
37419,ज्यामिति,0,0,1,1
37418,alışveriş,0,0,1,1
31849,энциклопедии.,0,0,1,1
52216,c'étaient,0,0,1,1
37408,innehållsstyrande,0,0,1,1
33780,локьером,0,0,1,1
51466,इनकी,0,0,1,1
33410,-നാണ്,0,0,1,1
33774,வந்தாள்,0,0,1,1
33414,συναντήσει,0,0,1,1
37411,pertencente,0,0,1,1
31851,israël,0,0,1,1
33411,stipule,0,0,1,1
33412,golpea.,0,0,1,1
31854,bioinformatics.,0,0,1,1
37417,കൂട്ടങ്ങളായി,0,0,1,1
33777,trente,0,0,1,1
37412,incompatíveis.,0,0,1,1
31853,ഉറപ്പാക്കപ്പെടുന്നത്‌.,0,0,1,1
33776,подкасты,0,0,1,1
33413,demitidos,0,0,1,1
33775,أتحدث,0,0,1,1
33773,الحال؟,0,0,1,1
31859,hervatten.,0,0,1,1
37393,ഗ്രന്ഥങ്ങളെയും,0,0,1,1
33415,etki,0,0,1,1
37431,reklamsız,0,0,1,1
33792,ദശലക്ഷം.,0,0,1,1
33406,قواعده,0,0,1,1
33407,сотен,0,0,1,1
33790,uncultivated,0,0,1,1
33420,translator,0,0,1,1
33768,employee.,0,0,1,1
37394,breve.,0,0,1,1
33419,расширений,0,0,1,1
37396,remark,0,0,1,1
31848,brandit,0,0,1,1
33769,супе,0,0,1,1
51963,vindicates,0,0,1,1
37426,നൽകി.,0,0,1,1
37398,السجناء.,0,0,1,1
33418,λείπει,0,0,1,1
37399,gini,0,0,1,1
33771,teams,0,0,1,1
37422,fazerem,0,0,1,1
33417,dima,0,0,1,1
33786,lecun,0,0,1,1
33785,தொகுக்கப்படக்,0,0,1,1
37400,maskiner,0,0,1,1
37401,общем,0,0,1,1
33772,« réseau,0,0,1,1
33416,साथ-साथ,0,0,1,1
51465,edilmiş.,0,0,1,1
31860,फ़्रियुलियाई,0,0,1,1
33784,religión,0,0,1,1
37448,ಬಳಸಬಾರದು,0,0,1,1
33807,prenant,0,0,1,1
37451,hacerlo.,0,0,1,1
31829,felaktiga,0,0,1,1
52012,സന്നദ്ധസമൂഹം,0,0,1,1
51956,problematisera,0,0,1,1
33735,confiance,0,0,1,1
31830,seem,0,0,1,1
37471,موقعًا,0,0,1,1
37339,middenin,0,0,1,1
37469,nyheder,0,0,1,1
33829,descoberta,0,0,1,1
51972,تدرب,0,0,1,1
37340,ووضوحًا,0,0,1,1
31831,تشاهد,0,0,1,1
37341,പുനർജീവിച്ചു,0,0,1,1
37468,compléter,0,0,1,1
31832,encuentra,0,0,1,1
33828,எடுக்கப்பட்டது.,0,0,1,1
33737,вкратце,0,0,1,1
37342,fourniture,0,0,1,1
31834,representatividad,0,0,1,1
51957,alınarak,0,0,1,1
37467,محرريها,0,0,1,1
31835,बेनाम,0,0,1,1
31836,ionized,0,0,1,1
33392,skall,0,0,1,1
37344,d'œuvres,0,0,1,1
51474,повторил,0,0,1,1
51958,எனப்,0,0,1,1
33393,proporcionaron,0,0,1,1
33428,l'accélération,0,0,1,1
37466,മുകളിലുള്ള,0,0,1,1
37338,കൈമുതലായുണ്ടാവും,0,0,1,1
33734,eliminando,0,0,1,1
33808,malaiala,0,0,1,1
33830,organisationen,0,0,1,1
33431,gutaussehend.,0,0,1,1
37477,ಸಂಪರ್ಕದಲ್ಲಿರಿ.,0,0,1,1
37325,platz,0,0,1,1
37326,antonino,0,0,1,1
51973,aplicá-las,0,0,1,1
33387,ஒருமுறை,0,0,1,1
33837,नमक,0,0,1,1
31886,noticia,0,0,1,1
37476,हटाने,0,0,1,1
31885,imitation.,0,0,1,1
33834,erstaunliches.,0,0,1,1
37475,infinitamente,0,0,1,1
33729,மனரீதியாகக்,0,0,1,1
37330,denominators.,0,0,1,1
37331,üzgün.,0,0,1,1
37332,eurocentric,0,0,1,1
37474,fiable,0,0,1,1
33833,dispone,0,0,1,1
31884,favorisée,0,0,1,1
33731,geest,0,0,1,1
37333,शिक्षण,0,0,1,1
37334,sokpopaccounts,0,0,1,1
33732,типа,0,0,1,1
33832,التجارب,0,0,1,1
37335,soulevé,0,0,1,1
51475,salladığın,0,0,1,1
37336,تنمو,0,0,1,1
33733,economics ·environmental,0,0,1,1
31828,нейронных,0,0,1,1
37347,майкл,0,0,1,1
37348,historiens ».,0,0,1,1
37464,sources.,0,0,1,1
37463,குதித்தால்,0,0,1,1
51970,утопление,0,0,1,1
51463,doing.,0,0,1,1
51959,மொழிப்பதிப்பும்,0,0,1,1
37360,மொழியில்,0,0,1,1
51969,സേർച്ച്,0,0,1,1
37361,познавательной,0,0,1,1
37362,приписывают,0,0,1,1
33816,إداريي,0,0,1,1
31877,മന്ദഗതിയിലാക്കുന്നു,0,0,1,1
51473,നോക്കിയപ്പോൾ,0,0,1,1
33749,വിലയിരുത്തി,0,0,1,1
37366,உருவாக்கியவரோ,0,0,1,1
31875,internetsajter.,0,0,1,1
33813,kredisini,0,0,1,1
31839,സമീപകാല,0,0,1,1
33397,earliest,0,0,1,1
37367,ειδήμονες,0,0,1,1
37456,ангела,0,0,1,1
33750,siden.,0,0,1,1
37454,paródia,0,0,1,1
33812,smuk.,0,0,1,1
33398,يشمل,0,0,1,1
33425,اعتبارا,0,0,1,1
33751,வழங்கி,0,0,1,1
33811,estornudó,0,0,1,1
33752,capacidade,0,0,1,1
33810,पोषण,0,0,1,1
31874,cresce,0,0,1,1
37452,experienced,0,0,1,1
33818,scaling,0,0,1,1
31878,பிரிவில்,0,0,1,1
37458,ingresan,0,0,1,1
37461,choisis.,0,0,1,1
37349,сложных,0,0,1,1
33740,folder,0,0,1,1
31837,них.,0,0,1,1
33825,återställdes,0,0,1,1
33395,verspreiding,0,0,1,1
33741,mobiles,0,0,1,1
33742,u.s.,0,0,1,1
37350,udtalen,0,0,1,1
37351,opgevangen,0,0,1,1
33824,alianza,0,0,1,1
33743,ಒಬ್ಬ,0,0,1,1
52219,ടി,0,0,1,1
33744,richer,0,0,1,1
37353,zwaaiden,0,0,1,1
33820,марки,0,0,1,1
33823,ομαλής,0,0,1,1
51971,generalizar,0,0,1,1
31880,träna,0,0,1,1
33396,lकिसी,0,0,1,1
37460,തംബ്‌സ്,0,0,1,1
31838,classic,0,0,1,1
37354,مفيدة.,0,0,1,1
31879,oplossing,0,0,1,1
37356,helfen.,0,0,1,1
33822,complexiteit,0,0,1,1
37459,leihen,0,0,1,1
33745,जरूरतों,0,0,1,1
33821,சியர்ஸ்,0,0,1,1
33695,soruyorsa,0,0,1,1
33888,ofensiva,0,0,1,1
31751,கேள்விப்பட்டிருக்கிறேன்,0,0,1,1
31979,snygga,0,0,1,1
37094,rato,0,0,1,1
37095,yıkayacağım.,0,0,1,1
31978,holtzbrinck,0,0,1,1
33641,custos,0,0,1,1
33962,apavorante,0,0,1,1
37600,projelerinde,0,0,1,1
37599,உதவிக்கு,0,0,1,1
37598,программы,0,0,1,1
33961,erstaunlich.,0,0,1,1
33960,публикуется,0,0,1,1
33959,недостоверность,0,0,1,1
33642,тест,0,0,1,1
33643,टायलर,0,0,1,1
37096,mélisse,0,0,1,1
31977,« exemple,0,0,1,1
37097,சொல்லிலிருந்து,0,0,1,1
31976,oldun,0,0,1,1
37596,cartes,0,0,1,1
33958,yiyeceğe,0,0,1,1
33957,सिसलीयाई,0,0,1,1
33956,பதவி,0,0,1,1
33955,مفتوحاً,0,0,1,1
31770,planétaires.,0,0,1,1
37098,heures.,0,0,1,1
37099,accueille,0,0,1,1
37595,ಮುಗಿಸಲಿ.,0,0,1,1
33954,desearle,0,0,1,1
33952,العرض.,0,0,1,1
33464,நிரல்,0,0,1,1
33322,flotte,0,0,1,1
33964,καλή.,0,0,1,1
33645,அண்ணளவாக,0,0,1,1
52019,opponent.,0,0,1,1
37607,முடிக்கிறேன்.,0,0,1,1
33465,intervals,0,0,1,1
33318,diyorlarsa,0,0,1,1
31981,'redes,0,0,1,1
31767,narcisa'yı,0,0,1,1
37606,climate.,0,0,1,1
33974,högsta,0,0,1,1
37081,लाल,0,0,1,1
33319,ಸರಿಯೇ,0,0,1,1
33320,शुक्रवार,0,0,1,1
31980,нарушениями,0,0,1,1
31768,ഉറക്കത്തിൽ,0,0,1,1
33973,कक्ष,0,0,1,1
33972,federal.,0,0,1,1
37084,gösterilmez.,0,0,1,1
33970,trägen,0,0,1,1
33969,υπερβάλλετε.,0,0,1,1
37087,தேவதையாக,0,0,1,1
51448,gemakkelijk,0,0,1,1
33321,add,0,0,1,1
37604,vinculado,0,0,1,1
33639,consciousness,0,0,1,1
37088,luidsprekerpictogram,0,0,1,1
37603,ചിലത്,0,0,1,1
37089,نزاع,0,0,1,1
37090,കടത്തി,0,0,1,1
33967,batalha,0,0,1,1
37092,unevenness,0,0,1,1
37601,காட்டப்படும்.,0,0,1,1
33951,അമർത്തി,0,0,1,1
33950,australie,0,0,1,1
37608,प्रशंसात्मक,0,0,1,1
33943,travelling,0,0,1,1
37117,entera,0,0,1,1
37118,könntest.,0,0,1,1
37119,التقدير,0,0,1,1
33656,seid,0,0,1,1
33326,страну,0,0,1,1
37120,കൂടിയ,0,0,1,1
33941,faller,0,0,1,1
37121,personnalité,0,0,1,1
37587,أم,0,0,1,1
31971,parallèle,0,0,1,1
31775,cümlede,0,0,1,1
33940,narcis-moeder,0,0,1,1
37586,सईनपोस्ट,0,0,1,1
31776,അതുകൊണ്ടൊക്കെ,0,0,1,1
37122,вскоре,0,0,1,1
33658,partnered,0,0,1,1
37123,gedik.,0,0,1,1
37124,sexton,0,0,1,1
37125,посадить,0,0,1,1
33659,സാർവത്രികമായി,0,0,1,1
31777,योग्यता,0,0,1,1
31778,l'explique.,0,0,1,1
51499,dite,0,0,1,1
37585,отображать,0,0,1,1
33327,alternative »,0,0,1,1
33939,माइक्रो,0,0,1,1
37127,corollaire,0,0,1,1
51938,പഠിക്കുന്ന,0,0,1,1
51939,concentration,0,0,1,1
37116,ക്ലിക്കുചെയ്ത്,0,0,1,1
33654,yazıyı,0,0,1,1
33646,ದೊಡ್ಡದಾದ,0,0,1,1
37115,aşar.,0,0,1,1
31771,polyvalente,0,0,1,1
51502,المضيفون،,0,0,1,1
37593,squid,0,0,1,1
37103,βικιεπιστήμιο,0,0,1,1
37416,comply,0,0,1,1
51982,continuaba,0,0,1,1
37104,выучите,0,0,1,1
33948,realizados,0,0,1,1
33650,sendos,0,0,1,1
33462,boğuluyorum.,0,0,1,1
37592,تعطلت,0,0,1,1
37105,yazının,0,0,1,1
37106,educativas,0,0,1,1
37107,skrive,0,0,1,1
33651,vecka,0,0,1,1
33947,விக்கித்திட்டம்,0,0,1,1
31772,ulaştığını,0,0,1,1
33652,fotorrealista,0,0,1,1
33653,geleerd,0,0,1,1
37109,diğerinin,0,0,1,1
37110,oliver,0,0,1,1
33325,ಕೇಳಿದಾಗ.,0,0,1,1
33946,instructs,0,0,1,1
33461,பிழைத்திருத்தத்திற்குப்,0,0,1,1
31773,قال,0,0,1,1
31774,providing,0,0,1,1
37114,लिखें,0,0,1,1
37588,varierande,0,0,1,1
31972,സംഭാഷണമാണ്,0,0,1,1
51503,sofrem,0,0,1,1
51447,pendentes,0,0,1,1
31939,pionnier,0,0,1,1
51933,noting,0,0,1,1
31757,വലിക്കുക,0,0,1,1
37047,forest.,0,0,1,1
33623,जड़ी,0,0,1,1
33994,confirmé,0,0,1,1
37048,projets[a].,0,0,1,1
33993,s'étendra,0,0,1,1
33992,xvi,0,0,1,1
31998,« don-cosaque »,0,0,1,1
33313,याहू,0,0,1,1
52228,oke,0,0,1,1
37049,emphasizing,0,0,1,1
33474,suitable,0,0,1,1
33991,tokio,0,0,1,1
33473,objetivo.,0,0,1,1
37050,zelfstandig,0,0,1,1
37051,άμαξας,0,0,1,1
33626,företagens,0,0,1,1
33314,contribuye,0,0,1,1
33990,emulated,0,0,1,1
33472,güiquipedia,0,0,1,1
33627,autorisations,0,0,1,1
37630,investigan,0,0,1,1
33470,கண்டது,0,0,1,1
31995,posteriori,0,0,1,1
51934,ഇമെയിൽ,0,0,1,1
51506,ಖಚಿತವಾಗಿದೆಯೇ,0,0,1,1
37629,energieksempel,0,0,1,1
33469,प्रक्टिसस,0,0,1,1
37054,apart.,0,0,1,1
33622,घोषित,0,0,1,1
37045,വെട്ടി,0,0,1,1
33988,gerekmez.,0,0,1,1
51510,rangeringsystem.,0,0,1,1
37642,массовой,0,0,1,1
33307,maand,0,0,1,1
37033,intonatie.,0,0,1,1
34005,ξανά.,0,0,1,1
34004,territorio,0,0,1,1
51511,dupla,0,0,1,1
37641,lincoln...,0,0,1,1
34001,doğrultusunda,0,0,1,1
52230,uuu,0,0,1,1
37035,poll,0,0,1,1
37638,ബുദ്ധിമുട്ടായിരുന്നു,0,0,1,1
31754,sormak.,0,0,1,1
37036,uğrayan,0,0,1,1
37037,arz •,0,0,1,1
32003,yakın,0,0,1,1
32002,алгоритм,0,0,1,1
51931,rédacteurs.,0,0,1,1
33309,situé,0,0,1,1
33310,supresores,0,0,1,1
33998,terra,0,0,1,1
32001,manga.,0,0,1,1
31755,amigos.,0,0,1,1
37043,ലേഖനങ്ങൾ.,0,0,1,1
33997,gne.,0,0,1,1
33311,விஷயத்தைச்,0,0,1,1
33995,ಕೇಳುವುದು.,0,0,1,1
37634,ಅತ್ಯಾಧುನಿಕ.,0,0,1,1
37044,«астероид,0,0,1,1
33621,hurtige,0,0,1,1
37055,ವರ್ಷ,0,0,1,1
37628,وتغيرت,0,0,1,1
31765,بوجود,0,0,1,1
33980,വരിക.,0,0,1,1
31986,الأراضي,0,0,1,1
33466,حفلة,0,0,1,1
37067,portales,0,0,1,1
31985,хранилища,0,0,1,1
33979,الغيرالمسجليين،,0,0,1,1
37068,trykke,0,0,1,1
37069,المصنوع,0,0,1,1
37070,rectitud,0,0,1,1
51936,apropriada.,0,0,1,1
37071,dénotant,0,0,1,1
33633,रूसिन,0,0,1,1
31762,voyage.,0,0,1,1
37072,печатного,0,0,1,1
52004,coût,0,0,1,1
31984,aspire,0,0,1,1
37615,നല്ലവനായിരുന്നു,0,0,1,1
33317,romantic,0,0,1,1
33635,engelsksproget,0,0,1,1
31983,वित्तीय,0,0,1,1
37614,sindet,0,0,1,1
33636,seixas.,0,0,1,1
37612,ತಾಳ್ಮೆಯಿಂದ,0,0,1,1
37073,preferia,0,0,1,1
37074,dick,0,0,1,1
37611,mettant,0,0,1,1
31764,ನಿರ್ಧಾರ,0,0,1,1
37077,functioning,0,0,1,1
37609,потрясающе».,0,0,1,1
33976,частичная,0,0,1,1
31987,многоязычная,0,0,1,1
37618,классические,0,0,1,1
33628,انفتاحًا,0,0,1,1
37621,красивый,0,0,1,1
31994,സലാഡുകളും,0,0,1,1
37058,legibilidade,0,0,1,1
37059,jour-là.,0,0,1,1
33468,മെയിൽ,0,0,1,1
51984,demandais,0,0,1,1
52194,تقوم,0,0,1,1
33987,positives.,0,0,1,1
33315,estupro,0,0,1,1
33629,institutionnalisation,0,0,1,1
31991,ಪ್ರೀತಿಸುತ್ತೀರಿ,0,0,1,1
37626,bulacağınız,0,0,1,1
31989,итальянских,0,0,1,1
52003,perro,0,0,1,1
33985,casper,0,0,1,1
33630,свойственна,0,0,1,1
31760,noemt.,0,0,1,1
37625,الناس,0,0,1,1
33631,stärka,0,0,1,1
51505,إيكونوميك,0,0,1,1
31761,распределённом,0,0,1,1
37061,வைக்கிறது.,0,0,1,1
37062,diversidad,0,0,1,1
51504,принц.,0,0,1,1
37063,cariño,0,0,1,1
33983,genome,0,0,1,1
33982,செல்வங்களுக்கு,0,0,1,1
33981,traditions,0,0,1,1
37622,défauts,0,0,1,1
37065,५०१सी३,0,0,1,1
37129,φρικάρω,0,0,1,1
51940,aussehen.,0,0,1,1
33937,testte,0,0,1,1
37184,kopiere,0,0,1,1
33903,wikipediaförfattare,0,0,1,1
31786,ஆச்சரியம்,0,0,1,1
37185,yapmadan,0,0,1,1
33902,आलसी,0,0,1,1
52203,d'alimenter,0,0,1,1
31949,والتعليمات,0,0,1,1
33687,مناقشتهم،,0,0,1,1
37189,വിദ്യാർത്ഥികൾക്കായുള്ള,0,0,1,1
31948,likelihood,0,0,1,1
33354,contextualização,0,0,1,1
37546,regroupées,0,0,1,1
33688,slower,0,0,1,1
37545,interativas,0,0,1,1
37191,உட்கார்ந்திருந்த,0,0,1,1
51493,tröga,0,0,1,1
33450,மெருகூட்டப்பட்டவராகவும்,0,0,1,1
37544,വിദ്യാ‍ഭ്യാസത്തിന്റെ,0,0,1,1
33899,straks,0,0,1,1
33689,حوادث,0,0,1,1
33898,ഗുണാങ്കങ്ങൾക്ക്,0,0,1,1
37194,വരാം,0,0,1,1
51946,bedacht,0,0,1,1
33896,നടത്തുവാൻ,0,0,1,1
33895,ജില്ലയെച്ചൊല്ലി,0,0,1,1
31787,താൽപ്പര്യമുണ്ടെന്ന്,0,0,1,1
37196,भले,0,0,1,1
31946,sainte.,0,0,1,1
37197,devenus,0,0,1,1
33691,хранения,0,0,1,1
33352,dotter.,0,0,1,1
37548,acompanhamento,0,0,1,1
51947,വിക്കിപീഡിയകൾ,0,0,1,1
37549,ρωτήθηκε,0,0,1,1
37168,ವಿಶೇಷವಾಗಿ,0,0,1,1
37169,υψηλότερης,0,0,1,1
33912,வாரங்கள்,0,0,1,1
37554,വിവരങ്ങളെ,0,0,1,1
33911,ನಂತರ.,0,0,1,1
37171,θέση.,0,0,1,1
37172,എടുക്കാൻ,0,0,1,1
51495,caixa,0,0,1,1
37173,co.,0,0,1,1
33451,возможности,0,0,1,1
33910,சொல்கிறார்கள்.,0,0,1,1
33346,പ്രയത്നത്തിന്,0,0,1,1
37176,எடுத்தால்,0,0,1,1
37177,κατάλαβα.,0,0,1,1
31951,ഉറവിടം,0,0,1,1
52017,τρομακτικά.,0,0,1,1
37178,ويكيبيديا؟,0,0,1,1
51494,distinctly,0,0,1,1
33347,handy,0,0,1,1
52016,suponha,0,0,1,1
33349,barbe,0,0,1,1
31950,sitesini,0,0,1,1
33686,p.t.,0,0,1,1
33906,ഹിക്കുന്നതുപോലെ,0,0,1,1
37551,സുഹൃത്തുക്കളായിരുന്നു,0,0,1,1
33905,werden.,0,0,1,1
37183,visuelle,0,0,1,1
33351,φανταστικά,0,0,1,1
37550,webbpubliceringssystem.,0,0,1,1
37198,топологий,0,0,1,1
31945,exigidos,0,0,1,1
52226,تعديلها,0,0,1,1
37212,குறிக்கப்,0,0,1,1
31791,первых,0,0,1,1
33446,небеса,0,0,1,1
31942,damerne,0,0,1,1
37214,¿pueden,0,0,1,1
51978,പരാതിപ്പെടുകയും,0,0,1,1
31792,l’automatisation,0,0,1,1
33890,تشابك,0,0,1,1
31941,venaient,0,0,1,1
33356,игру»,0,0,1,1
33889,harmonie,0,0,1,1
37216,പറഞ്ഞതായി,0,0,1,1
31793,representadas,0,0,1,1
37217,conducta,0,0,1,1
37530,tanımlamalardan,0,0,1,1
37218,मददगार,0,0,1,1
37529,എല്ലാംതന്നെ,0,0,1,1
31794,bilen,0,0,1,1
37220,redacción,0,0,1,1
31940,houvesse,0,0,1,1
37528,увижу.,0,0,1,1
33445,mi‑,0,0,1,1
33357,நல்லவர்களாக,0,0,1,1
37222,anzugeben.,0,0,1,1
37223,பொருட்படுத்தவில்லை,0,0,1,1
51453,intégralité,0,0,1,1
37225,πρόκειται,0,0,1,1
52206,hawaiano​,0,0,1,1
37226,glücks.,0,0,1,1
37227,musste,0,0,1,1
37213,kıkırdıyordu,0,0,1,1
37532, milliards,0,0,1,1
37543,बताती,0,0,1,1
37211,ಭಾರೀ,0,0,1,1
31788,சாங்கரையேச்,0,0,1,1
51491,تذكرها.,0,0,1,1
37199,источниками.,0,0,1,1
31789,مدهش,0,0,1,1
37200,wird.,0,0,1,1
37542,उम्मीद,0,0,1,1
33892,ಮೂವರು,0,0,1,1
52015,implausible,0,0,1,1
33692,പ്രശസ്തി,0,0,1,1
37202,യാത്ര,0,0,1,1
52205,ethnologie,0,0,1,1
33891,المحددة,0,0,1,1
51490,εγκωμιάζουν,0,0,1,1
37205,intet,0,0,1,1
37540,levebröd,0,0,1,1
37539,muhtemelen,0,0,1,1
37206,summary,0,0,1,1
33449,इंटरफ़ेस,0,0,1,1
33448,ganz,0,0,1,1
37207,പോകാനുള്ള,0,0,1,1
33447,vakgebied,0,0,1,1
37536,revision[réf.,0,0,1,1
37208,redistribution,0,0,1,1
37535,kultiviert,0,0,1,1
37209,noyer,0,0,1,1
31790,ಮೂಕ,0,0,1,1
37210,bağlamında,0,0,1,1
37534,tourne,0,0,1,1
37533,besorgt,0,0,1,1
37555,positif,0,0,1,1
33682,spitzer,0,0,1,1
37167,redirecionamento,0,0,1,1
33930,attracting,0,0,1,1
52197,kronolojik,0,0,1,1
37140,kaufen.,0,0,1,1
33332,obtenido,0,0,1,1
37577,न्यायाधीशों,0,0,1,1
31964,estritas,0,0,1,1
51450,d'aujourd'hui.,0,0,1,1
33927,solitude.,0,0,1,1
51451,компьютерные,0,0,1,1
37141,astra,0,0,1,1
31963,जाऊं,0,0,1,1
33926,drømte,0,0,1,1
51943,stinkt,0,0,1,1
33925,prestarme,0,0,1,1
31962,wikifiera,0,0,1,1
52198,casheservrar,0,0,1,1
37142,adieux,0,0,1,1
37143,çılgın,0,0,1,1
33666,حقا,0,0,1,1
33667,robijnen,0,0,1,1
37574,كارلوس,0,0,1,1
33457,ಅಷ್ಟಾಗಿ,0,0,1,1
33923,marginaux,0,0,1,1
33668,semantiska,0,0,1,1
33456,образования,0,0,1,1
37145,çıkardın.,0,0,1,1
33333,narsisa'nın,0,0,1,1
33334,ограничений,0,0,1,1
37146,homossexual,0,0,1,1
33335,pending,0,0,1,1
37139,könnten,0,0,1,1
51449,يومًا,0,0,1,1
31952,традиционную,0,0,1,1
37138,кэше,0,0,1,1
33328,problématiques,0,0,1,1
52195,kodlu,0,0,1,1
33660,позволить,0,0,1,1
31969,तकनीकी,0,0,1,1
33661,'good',0,0,1,1
37132,посмотрели,0,0,1,1
33662,koştu,0,0,1,1
37133,ಕಾರ್ಯನಿರ್ವಹಿಸುತ್ತಿದ್ದರೆ,0,0,1,1
37134,bouleverser,0,0,1,1
52196,totémisme,0,0,1,1
37135,oiseau,0,0,1,1
37136,مناسب.,0,0,1,1
37584,conservées,0,0,1,1
31967,мюнхене,0,0,1,1
31966,ಮನೆಯ,0,0,1,1
33460,ആയിട്ടും,0,0,1,1
33934,forkert,0,0,1,1
37583,amou,0,0,1,1
33663,kaïkavien,0,0,1,1
31965,ओपनसोलारिस,0,0,1,1
33933,അർത്ഥങ്ങൾ,0,0,1,1
33932,philosophical,0,0,1,1
37582,الصينية,0,0,1,1
33329,confined,0,0,1,1
33330,assaulting,0,0,1,1
33331,ibland.,0,0,1,1
37581,vandalizing,0,0,1,1
33459,rousseau,0,0,1,1
33664,γελάει,0,0,1,1
37570,источники.,0,0,1,1
51452,ಎಲ್ಲೀ,0,0,1,1
33336,« liste,0,0,1,1
37567,clases,0,0,1,1
52225,arbetat,0,0,1,1
33341,അവനോടൊപ്പം,0,0,1,1
33916,varier,0,0,1,1
37560,placerade,0,0,1,1
33342,panne,0,0,1,1
37559,gmatı,0,0,1,1
37160,zulke,0,0,1,1
33452,σοβαρή,0,0,1,1
31783,walmart,0,0,1,1
33915,lagrar,0,0,1,1
33914,möjlig,0,0,1,1
33679,цитируется,0,0,1,1
52199,constitutionnelle,0,0,1,1
31956,ort,0,0,1,1
31784,التفاصيل.,0,0,1,1
37162,المفضلة,0,0,1,1
37163,serez,0,0,1,1
37558,dilemenin,0,0,1,1
33913,جئت,0,0,1,1
52200,மகிழ்ச்சியற்றதையும்,0,0,1,1
52201,عاشت,0,0,1,1
31955,filer,0,0,1,1
37557,നിർത്താൻ,0,0,1,1
37556,bureaukrater,0,0,1,1
33344,चलो।,0,0,1,1
37165,volverse,0,0,1,1
51945,ενότητα,0,0,1,1
52202,தன்னார்வலர்களால்,0,0,1,1
33345,بتشجيع,0,0,1,1
33678,tårer,0,0,1,1
33917,adressée,0,0,1,1
37159,« moments,0,0,1,1
31959,उबुन्टु,0,0,1,1
33337,redactor.,0,0,1,1
33921,ನಾರ್ಸಿಸಿಯ,0,0,1,1
33339,एव्रीथिंग,0,0,1,1
37148,അനുബദ്ധ,0,0,1,1
33671,темпе.,0,0,1,1
37149,engelen,0,0,1,1
33340,retirado,0,0,1,1
33455,நம்,0,0,1,1
33920,बास्क,0,0,1,1
37564,l'agence,0,0,1,1
37151,λέγω.,0,0,1,1
33672,தகுதியானவன்,0,0,1,1
51944,வளர்ப்பதற்கு,0,0,1,1
37152,كيو,0,0,1,1
37158,يخبار.,0,0,1,1
37153,proibições,0,0,1,1
31958,realizing,0,0,1,1
37154,സാങ്കേതികവിദ്യയിൽ,0,0,1,1
33454,armee,0,0,1,1
33675,ಹೇಳುತ್ತಾರೆ,0,0,1,1
37155,αγωνίστηκε,0,0,1,1
31780,philosophical/content,0,0,1,1
33918,andas,0,0,1,1
33676,ετοιμάστηκα,0,0,1,1
37156,занят,0,0,1,1
37157,يمرر,0,0,1,1
33453,هيلر,0,0,1,1
33677,செய்வதைத்,0,0,1,1
37307,exclusão,0,0,1,1
35241,filmlerde,0,0,1,1
36837,aptalca,0,0,1,1
52122,ஆதாரம்,0,0,1,1
35787,diskussionssidorna.,0,0,1,1
35786,acımasızca,0,0,1,1
35785,क्रिमसन,0,0,1,1
35784,δεδομένου,0,0,1,1
34881,götürürüm,0,0,1,1
51808,scientifiques.,0,0,1,1
35782,τείνει,0,0,1,1
32926,försiktighet.,0,0,1,1
32538,tidskriftsartiklar,0,0,1,1
32539,لسوء,0,0,1,1
32925,beş,0,0,1,1
51699,voorbij,0,0,1,1
32540,versionerna,0,0,1,1
32924,foreslået,0,0,1,1
32542,اختلافات,0,0,1,1
34885,ρωτήσει,0,0,1,1
34886,вправе,0,0,1,1
34887,ritt,0,0,1,1
32923,aylardır,0,0,1,1
34879,consistem,0,0,1,1
34878,تتحرك,0,0,1,1
32927,choses ,0,0,1,1
34870,vivre,0,0,1,1
32531,المراجعة,0,0,1,1
35796,proposé,0,0,1,1
32932,കാലങ്ങളായി,0,0,1,1
32532,ബാൽക്കണിയിൽ,0,0,1,1
32930,ministre,0,0,1,1
34867,viaf,0,0,1,1
32534,الإداريون،,0,0,1,1
34868,ಕೇಳುತ್ತಿದ್ದರೆ,0,0,1,1
35792,superprotection,0,0,1,1
34876,ಖಚಿತವಾಗಿದೆಯೆ,0,0,1,1
34871,городах,0,0,1,1
34872,günümüz,0,0,1,1
35789,lexicografische,0,0,1,1
34873,nauruano,0,0,1,1
32535,उसमें,0,0,1,1
32929,λατρεύω,0,0,1,1
34874,emeralds,0,0,1,1
32928,സമ്പദ്‌വ്യവസ്ഥ,0,0,1,1
32922,excesivo,0,0,1,1
35778,விரும்புவதாகக்,0,0,1,1
35798,താൽ‌പ്പര്യപ്പെടുന്നെങ്കിൽ‌,0,0,1,1
32544,ziehen,0,0,1,1
35766,أمستردام،,0,0,1,1
35765,videoya,0,0,1,1
34898,endereços.,0,0,1,1
34899,dalaï-lama.[réf.,0,0,1,1
52119,रोका,0,0,1,1
32552,खुलापन,0,0,1,1
32918,fortælle.,0,0,1,1
52118,stören.,0,0,1,1
35763,casualidad,0,0,1,1
32553,organizados,0,0,1,1
51806,deverão,0,0,1,1
35762,wp-artikel,0,0,1,1
35761,nécessitant,0,0,1,1
34903,« sibérien »,0,0,1,1
32917,antigua,0,0,1,1
32554,nicholson,0,0,1,1
34905,heavily,0,0,1,1
32556,venez,0,0,1,1
51702,origines,0,0,1,1
32919,മതിയായ,0,0,1,1
51807,уместно,0,0,1,1
34896,كوم,0,0,1,1
34891,signals.,0,0,1,1
32921,luister,0,0,1,1
35777,правильнее,0,0,1,1
34888,صحتك,0,0,1,1
35775,رقيقة,0,0,1,1
35774,ബന്ധിപ്പിക്കുന്നു.,0,0,1,1
35773,поиска,0,0,1,1
34889,ಅವಳೊಂದಿಗೆ,0,0,1,1
35772,registrarse,0,0,1,1
35771,ennuyeux.,0,0,1,1
32549,புன்னகைத்தனர்.,0,0,1,1
32547,скобок,0,0,1,1
34892,gebiet,0,0,1,1
34893,arbetslivserfarenhet.,0,0,1,1
32920,chelsea,0,0,1,1
32548,തയ്യാറാക്കികൊണ്ടിരിക്കുന്നു.,0,0,1,1
35769,உச்சரிக்கிறீர்கள்,0,0,1,1
34895,düğme,0,0,1,1
35768,பங்களிப்பாளர்களையும்,0,0,1,1
35797,വരികയാണ്.,0,0,1,1
35799,ಶಕ್ತಿಯ,0,0,1,1
32558,ಆರ್ಥಿಕತೆಯು,0,0,1,1
34855,ωραίο,0,0,1,1
32942,لاحقًا,0,0,1,1
34843,принял,0,0,1,1
34844,kultur,0,0,1,1
32941,supports,0,0,1,1
34848,مثلك,0,0,1,1
32940,എന്നതുകൊണ്ട്,0,0,1,1
34849,തിരക്കിലായിരുന്നതിനാൽ,0,0,1,1
32520,söyleyen,0,0,1,1
35831,‘இறங்கு,0,0,1,1
34851,poupée,0,0,1,1
51694,подходам.,0,0,1,1
35828,ущерб,0,0,1,1
34852,terörist,0,0,1,1
32521,reageren,0,0,1,1
35827,मान,0,0,1,1
35826,तकनीक,0,0,1,1
32939,genomineerd,0,0,1,1
32522,universitaria,0,0,1,1
34854,русскоязычной,0,0,1,1
34842,humaine ».,0,0,1,1
35834,çıkaracak,0,0,1,1
34841,появилось,0,0,1,1
35842,vroeg.,0,0,1,1
35848,прошедших,0,0,1,1
32516,криминального,0,0,1,1
51692,bezoeker,0,0,1,1
35846,ഹാംഗ്,0,0,1,1
35845,officiels,0,0,1,1
34839,பதிப்புக்களில்,0,0,1,1
32517,மூல,0,0,1,1
35843,girdilerin,0,0,1,1
35841,включают,0,0,1,1
35835,الروبوت,0,0,1,1
51693,ಬಯಸುವ,0,0,1,1
35840,παγωτό,0,0,1,1
35839,νόημα,0,0,1,1
32945,artikelform,0,0,1,1
35837,bedraagt.,0,0,1,1
35836,милой,0,0,1,1
32944,खत्म,0,0,1,1
32943,acabou,0,0,1,1
51696,تثبت,0,0,1,1
34856,nude,0,0,1,1
35801,अधिनियम,0,0,1,1
35824,abouti.,0,0,1,1
51697,الدراسات,0,0,1,1
32526,ومؤسس,0,0,1,1
32935,украинскими,0,0,1,1
35810,parler.,0,0,1,1
35809,கேட்கிறீர்கள்.,0,0,1,1
35808,dès,0,0,1,1
32527,cuidar.,0,0,1,1
35807,ഒന്നുമില്ല,0,0,1,1
32528,presentador,0,0,1,1
34863,variadíssimos,0,0,1,1
35806,दिशानिर्देशों,0,0,1,1
34864,اليومية.,0,0,1,1
32529,dotters,0,0,1,1
35805,ограничиваются,0,0,1,1
35804,dağıtılmasına,0,0,1,1
35803,repetirlo.,0,0,1,1
32530,développée.,0,0,1,1
32933,novatos,0,0,1,1
35802,പാർട്ടിയിൽ,0,0,1,1
35812,upwards,0,0,1,1
35813,hösten,0,0,1,1
35814,inattendues,0,0,1,1
35820,मैरियन,0,0,1,1
32523,ingetrokken,0,0,1,1
35823,inúmeras,0,0,1,1
32524,ക്ഷീണിതനാണോ,0,0,1,1
32938,végétal,0,0,1,1
32937,skepsis,0,0,1,1
35821,britannique,0,0,1,1
34858,básicas.,0,0,1,1
51811,одет,0,0,1,1
32525,acceptere,0,0,1,1
51809,οικονομία,0,0,1,1
35819,wikicode[q].,0,0,1,1
32936,micro-currents,0,0,1,1
35818,stoten,0,0,1,1
52123,regardant.,0,0,1,1
51810,ആശയത്തിനെ,0,0,1,1
34861,συνεχίσεις,0,0,1,1
35816,நர்சிசாவும்,0,0,1,1
35815,identifiquen.,0,0,1,1
32915,ترى.,0,0,1,1
32559,erfaring,0,0,1,1
32514,സമ്മതിച്ചാൽ,0,0,1,1
34958,tillsvidare,0,0,1,1
32580,kasteel,0,0,1,1
32581,l'occasion,0,0,1,1
51712,ഒരുപാട്,0,0,1,1
35689,تقولها,0,0,1,1
35688,épique,0,0,1,1
34950,meinung,0,0,1,1
34951,dénonce,0,0,1,1
32894,notify,0,0,1,1
34952,поддержанию,0,0,1,1
35687,relative,0,0,1,1
35685,ഗുജറാത്തി,0,0,1,1
32893,actualisée,0,0,1,1
34954,தகவல்களைக்,0,0,1,1
35683,شاهد,0,0,1,1
51713,förslaget,0,0,1,1
32892,ενθαρρύνονται,0,0,1,1
34955,جعل,0,0,1,1
34956,υπέρμαχο,0,0,1,1
32582,அடைய,0,0,1,1
32579,causadas,0,0,1,1
34949,knepig,0,0,1,1
34948,estime,0,0,1,1
32895,габриэлем.,0,0,1,1
32577,testament,0,0,1,1
35698,nullius,0,0,1,1
52114,وكأنه,0,0,1,1
34938,spitz,0,0,1,1
34939,inelegant,0,0,1,1
35697,förutsatt,0,0,1,1
35696,oneself,0,0,1,1
34941,voit,0,0,1,1
34942,الفرعي,0,0,1,1
35693,μάθει,0,0,1,1
34944,kommentarsfält,0,0,1,1
35695,dos.,0,0,1,1
34945,попали,0,0,1,1
52113,citable,0,0,1,1
35694,يترجموا,0,0,1,1
34946,κατανοητή,0,0,1,1
34947,المواد,0,0,1,1
32578,primaria»​,0,0,1,1
51802,مقتبساً,0,0,1,1
35680,مقابلات,0,0,1,1
32576,nouns,0,0,1,1
35679,ιστοχώρο,0,0,1,1
35665,സ്വപ്നങ്ങളിൽ,0,0,1,1
35664,opérationnellement,0,0,1,1
35663,dressed,0,0,1,1
32586,ονείρων,0,0,1,1
34966,acontecimientos.,0,0,1,1
35661,sorters,0,0,1,1
34967,पत्र,0,0,1,1
34969,версиями,0,0,1,1
32587,pop.,0,0,1,1
51716,ഭാഷാപരമായ,0,0,1,1
34971,பெறுவாள்,0,0,1,1
35658,வைத்து,0,0,1,1
51798,ತಂಪಾಗಿದೆ,0,0,1,1
35657,proprietär,0,0,1,1
35656,занимались.,0,0,1,1
35655,ആരംഭിക്കാനുള്ള,0,0,1,1
51718,estilísticas,0,0,1,1
35653,mühen.,0,0,1,1
35651,[تحديث]،,0,0,1,1
51715,пожаловать.,0,0,1,1
35666,مشروب,0,0,1,1
34964,skiljer,0,0,1,1
51799,സാധിക്കും.,0,0,1,1
32583,يُنصح,0,0,1,1
51801,levar.,0,0,1,1
52112,ابتهج,0,0,1,1
51800,энциклопедической.,0,0,1,1
35675,doktorerat,0,0,1,1
35674,doté,0,0,1,1
35673,qui.,0,0,1,1
35672,центре,0,0,1,1
35671,.which,0,0,1,1
35667,ответ.,0,0,1,1
35670,spéciale,0,0,1,1
34960,καθένα.,0,0,1,1
32891,religious,0,0,1,1
35669,antissocial.,0,0,1,1
32890,hole,0,0,1,1
32889,forvirre,0,0,1,1
35668,ethics ·environmental,0,0,1,1
34963,schlief,0,0,1,1
34937,literature,0,0,1,1
32896,supérieur,0,0,1,1
32560,anglia,0,0,1,1
35731,bogen,0,0,1,1
51805,inclus[réf.,0,0,1,1
52116,gebeurde,0,0,1,1
34920,hiérarchie.,0,0,1,1
32912,ഭാഷയിലുള്ള,0,0,1,1
35741,deductieve,0,0,1,1
35740,கீழாகவும்,0,0,1,1
35739,shut,0,0,1,1
51804,plausible,0,0,1,1
35737,raiva.,0,0,1,1
51705,attributes,0,0,1,1
35735,vedalaşmadan,0,0,1,1
35734,وتساءلوا,0,0,1,1
35733,contrat,0,0,1,1
52115,ಶಾಲೆಯಲ್ಲಿ,0,0,1,1
34921,nat,0,0,1,1
35732,seguridad,0,0,1,1
32564,sofistike.,0,0,1,1
34923,registrar,0,0,1,1
32566,wichtig,0,0,1,1
35743,споров,0,0,1,1
32562,hızlıca,0,0,1,1
35744,أرسل,0,0,1,1
34913,travels,0,0,1,1
34909,verwijderen.,0,0,1,1
35755,uppskattar,0,0,1,1
34911,смог.,0,0,1,1
32561,rol.,0,0,1,1
35754,культу»,0,0,1,1
51703,вопросам,0,0,1,1
35752,chatbot,0,0,1,1
35751,собираетесь.,0,0,1,1
52117,التعديلات.,0,0,1,1
35745,fill,0,0,1,1
34915,enfados,0,0,1,1
35750,ഏക,0,0,1,1
35749,tabağımda,0,0,1,1
32914,kritiker.,0,0,1,1
34917,ഉച്ചകഴിഞ്ഞ്,0,0,1,1
35747,नरसिंह,0,0,1,1
34918,tutabilmek,0,0,1,1
32913,d'accélérer,0,0,1,1
32909,ആശ്ചര്യപ്പെടുത്തുന്ന,0,0,1,1
35730,east,0,0,1,1
35700,डिस्क्स,0,0,1,1
35729,يخطئ,0,0,1,1
35718,எஸ்.எம்.எஸ்,0,0,1,1
32571,hjälpa.,0,0,1,1
34933,digitais,0,0,1,1
51707,कन्नड़,0,0,1,1
35715,selbst,0,0,1,1
51708,gale,0,0,1,1
35712,caters,0,0,1,1
35711,grades,0,0,1,1
35710,ಕಂಡಿದೆ,0,0,1,1
51709,موثوق.,0,0,1,1
32900,انتقد,0,0,1,1
34935,journalister,0,0,1,1
32572,καθένας,0,0,1,1
32899,infantiles.,0,0,1,1
35704,semanario,0,0,1,1
32898,ведущие,0,0,1,1
32897,entraîne,0,0,1,1
32574,मैक्स,0,0,1,1
32575,judío.,0,0,1,1
35719,उठा,0,0,1,1
34930,colaboración.,0,0,1,1
32902,thema.,0,0,1,1
32906,intersektionalitet.,0,0,1,1
51706,இழக்கப்பட்ட,0,0,1,1
35728,ووجهات,0,0,1,1
35727,القياسي,0,0,1,1
32568,ονειρευόσασταν.,0,0,1,1
52072,atribuição,0,0,1,1
32908,എന്നിവയിൽ,0,0,1,1
34924,ക്ലസ്റ്ററിംഗിലൂടെ,0,0,1,1
32907,आखिरी,0,0,1,1
35724,anger,0,0,1,1
35720,பக்கச்,0,0,1,1
34926,erzählte,0,0,1,1
35723,ellas.,0,0,1,1
32569,second-class,0,0,1,1
34928,σοβαρά,0,0,1,1
35721,ரகசியம்,0,0,1,1
32570,метод,0,0,1,1
32904,நர்சிஸ்,0,0,1,1
32903,intellectuelles,0,0,1,1
34837,ændre,0,0,1,1
35851,നിങ്ങള്ക്ക്,0,0,1,1
35649,cut,0,0,1,1
34746,amid,0,0,1,1
35978,l'accusent,0,0,1,1
32997,moedertaalsprekers,0,0,1,1
51831,relies,0,0,1,1
34735,corrigées,0,0,1,1
35976,πάνε,0,0,1,1
35975,læring,0,0,1,1
34736,கிடைக்கும்படியான,0,0,1,1
35974,adhere,0,0,1,1
35972,daterad,0,0,1,1
32455,{onionspotatoes},0,0,1,1
35971,तभी,0,0,1,1
32995,وتحرير,0,0,1,1
32456,échéance,0,0,1,1
34741,أريكتك.,0,0,1,1
34742,മറക്കരുത്.,0,0,1,1
34743,معك.,0,0,1,1
35967,सोचते,0,0,1,1
51830,வேளையில்,0,0,1,1
35966,فجأة,0,0,1,1
34733,موضعاً,0,0,1,1
32999,innebar,0,0,1,1
35980,rubies,0,0,1,1
33000,époque.,0,0,1,1
35989,வரவேற்பு.,0,0,1,1
32451,techniciens,0,0,1,1
34721,conjunctions,0,0,1,1
34722,leer,0,0,1,1
35986,إل.,0,0,1,1
35985,sonsuza,0,0,1,1
34723,المجهولين،,0,0,1,1
51670,cunhado,0,0,1,1
34725,μαντέψουν,0,0,1,1
35981,catalan.,0,0,1,1
51672,μίλησε,0,0,1,1
34727,providence,0,0,1,1
35984,werkwoord,0,0,1,1
35983,weil.,0,0,1,1
37764,formulerer,0,0,1,1
51673,proportionnellement,0,0,1,1
34730,civiques,0,0,1,1
34731,tim,0,0,1,1
35965,programación,0,0,1,1
35962,stalled,0,0,1,1
35991,सवार्त्ज़,0,0,1,1
34748,düşünmeme,0,0,1,1
34758,l'astéroïde,0,0,1,1
35951,سنوات.,0,0,1,1
34760,documentação,0,0,1,1
32463,مندهشة,0,0,1,1
51826,अल्बानियाई,0,0,1,1
35948,നിയമങ്ങൾ,0,0,1,1
34762,erreichte.,0,0,1,1
32988,وثلاثة,0,0,1,1
35947,uhøfligt,0,0,1,1
35945,aanstootgevend,0,0,1,1
35944,editörler,0,0,1,1
32465,कमयूनिटीस,0,0,1,1
32466,vardera,0,0,1,1
35943,realidade.,0,0,1,1
34764,ಟಿಪ್,0,0,1,1
32987,patent,0,0,1,1
34766,coordenados,0,0,1,1
52061,namely,0,0,1,1
35940,मीडियन,0,0,1,1
35952,invisibles »,0,0,1,1
35953,d'adapter,0,0,1,1
32990,attenuates,0,0,1,1
35957,chercheuse.,0,0,1,1
32457,είπα,0,0,1,1
35961,एस,0,0,1,1
32458,l'obs,0,0,1,1
34749,encyclopedia،,0,0,1,1
32992,ಮುಂದುವರಿಸಲು,0,0,1,1
35960,la •,0,0,1,1
35958,nelson,0,0,1,1
51828,minst,0,0,1,1
34754,olmayın,0,0,1,1
35954,ευφυή,0,0,1,1
32460,malintencionadas,0,0,1,1
34755,தனித்து,0,0,1,1
32461,brauche,0,0,1,1
32991,coexisted,0,0,1,1
32462,موثوق,0,0,1,1
34756,depicted,0,0,1,1
35955,stewardship,0,0,1,1
34757,diciéndome,0,0,1,1
34719,termo.,0,0,1,1
35992,lucratif,0,0,1,1
35939,comunidade...,0,0,1,1
34699,illiterate,0,0,1,1
36022,glimlachen,0,0,1,1
32441,потребность,0,0,1,1
36021,ejecutarían,0,0,1,1
34692,drømmemor,0,0,1,1
36020,baktığında,0,0,1,1
34693,modernes,0,0,1,1
34694,slösa,0,0,1,1
36018,πες,0,0,1,1
51838,создавать,0,0,1,1
36017,ನೀಡಿದ,0,0,1,1
33017,видах,0,0,1,1
33016,finnish,0,0,1,1
36016,bilmiyorsun,0,0,1,1
36015,dites-vous,0,0,1,1
32443,ಉತ್ಪ್ರೇಕ್ಷಿಸಲು,0,0,1,1
52130,esclusa,0,0,1,1
34696,requereu,0,0,1,1
36013,scene,0,0,1,1
34697,workload,0,0,1,1
36023,tranen,0,0,1,1
36024,tillförlitlig,0,0,1,1
51664,uitzicht,0,0,1,1
36034,piedade,0,0,1,1
36038,atentos,0,0,1,1
33019,molesto.,0,0,1,1
51841,instancias,0,0,1,1
36037,قصري,0,0,1,1
34687,strenge,0,0,1,1
36036,खो,0,0,1,1
34688,قناتي,0,0,1,1
34690,citado,0,0,1,1
32440,подойди.,0,0,1,1
36026,λέγατε,0,0,1,1
51660,şeyden,0,0,1,1
34691,electrónica,0,0,1,1
51662,coloniale,0,0,1,1
36031,rubi,0,0,1,1
36030,ಬಗ್ಗೆಯೂ,0,0,1,1
36029,ಪ್ರಯತ್ನಿಸುತ್ತಿದೆ,0,0,1,1
36027,शाब्दिक,0,0,1,1
51663,lituano,0,0,1,1
34698,الأنواع,0,0,1,1
51837,ستريت,0,0,1,1
33006,gelmeyen,0,0,1,1
52129,prisonniers,0,0,1,1
34707,gerir,0,0,1,1
36001,وأريد,0,0,1,1
51667,conduisent,0,0,1,1
35999,instaure,0,0,1,1
34709,tief,0,0,1,1
51834,производных,0,0,1,1
34710,før.,0,0,1,1
35998,पीड़ित,0,0,1,1
35997,liknande,0,0,1,1
35996,categorieën,0,0,1,1
34712,തണ്ണീർത്തടമാണ്,0,0,1,1
34713,épurée,0,0,1,1
32449,ಚೆನ್ನಾಗಿರುತ್ತೇನೆ.,0,0,1,1
34714,questão,0,0,1,1
33007,تقدمها,0,0,1,1
32450,tide,0,0,1,1
34717,रुकें।,0,0,1,1
34718,جامعيون,0,0,1,1
35994,uintelligen.t,0,0,1,1
33009,syrie.,0,0,1,1
51666,hepsi,0,0,1,1
32448,بعدي.,0,0,1,1
36006,çalışın,0,0,1,1
36010,neuronaux.,0,0,1,1
36009,награду,0,0,1,1
32444,bağlantı,0,0,1,1
36008,l'arrivée,0,0,1,1
52128,fi,0,0,1,1
36007,consultent,0,0,1,1
33014,осуществляют,0,0,1,1
33013,grados.,0,0,1,1
34704,വസ്തുതകളും,0,0,1,1
52127,चलाये.,0,0,1,1
36005,perfeita,0,0,1,1
33012,percatara,0,0,1,1
32447,türkiye’den,0,0,1,1
36003,hoşsunuz,0,0,1,1
33011,व्यवसाय,0,0,1,1
52059,самоубийство,0,0,1,1
34706,ഗൗരവമായി,0,0,1,1
33010,सकूं,0,0,1,1
34767,онлайн-проекта,0,0,1,1
34768,samtal.,0,0,1,1
32513,traduzidos,0,0,1,1
32955,práctica,0,0,1,1
34814,erudita,0,0,1,1
35886,intends,0,0,1,1
34815,d'attribuer,0,0,1,1
34816,सिस्टम,0,0,1,1
34817,adición,0,0,1,1
34818,ಆಗಿದೆ,0,0,1,1
32960,படையினருக்கான,0,0,1,1
35883,incredible,0,0,1,1
35882,ഇടുന്നു.,0,0,1,1
32959,pierre.,0,0,1,1
35880,ഗേറ്റ്സിന്റെ,0,0,1,1
35879,mcpherson's,0,0,1,1
32500,storlek,0,0,1,1
35878,والسؤال.,0,0,1,1
35877,«„википедия“ ,0,0,1,1
32958,consisting,0,0,1,1
34820,திட்டத்தை,0,0,1,1
32957,divulgadas,0,0,1,1
35875,العشوائي.,0,0,1,1
51815,efterfølgende,0,0,1,1
34813,डिलीट,0,0,1,1
35887,besproken,0,0,1,1
32964,качаешь,0,0,1,1
32497,poser,0,0,1,1
34806,huvudsakliga,0,0,1,1
32967,المتعمدة,0,0,1,1
35893,mistake.,0,0,1,1
34807,befördert,0,0,1,1
34808,веб-порталом.,0,0,1,1
35891,calculated,0,0,1,1
35890,рад,0,0,1,1
34809,बिना-लाभार्जन,0,0,1,1
32499,എഴുതുന്നു,0,0,1,1
35889,встречаюсь,0,0,1,1
51687,численных,0,0,1,1
34810,необходимых,0,0,1,1
32963,nécessité,0,0,1,1
35888,kalbe,0,0,1,1
34812,sujetos,0,0,1,1
51688,மன்னிப்பு,0,0,1,1
52064,ലിങ്ക്,0,0,1,1
32956,сторону.,0,0,1,1
34821,engraçado,0,0,1,1
34803,التصنيف,0,0,1,1
35874,широкую,0,0,1,1
34831,البحث،,0,0,1,1
35862,vandalisme.,0,0,1,1
35861,desempeño,0,0,1,1
32507,συνεχίσει,0,0,1,1
32948,मंद-व्यंजित,0,0,1,1
35860,προφέρετε.,0,0,1,1
34832,കൊണ്ടുപോകും,0,0,1,1
34834,சொல்.,0,0,1,1
32508,சொல்லான,0,0,1,1
35858,innehållet.,0,0,1,1
32509,التعريف.,0,0,1,1
32511,சிக்கல்களையும்,0,0,1,1
32512,girilerek,0,0,1,1
35857,ಮಲಗಿದ್ದಾಗ,0,0,1,1
35856,ചെയ്യുന്നത്.,0,0,1,1
35855,especulou,0,0,1,1
32946,homonymes,0,0,1,1
35854,ampliada,0,0,1,1
35853,сингапура,0,0,1,1
34830,comprends,0,0,1,1
32506,inedible,0,0,1,1
35866,forhånd.,0,0,1,1
34824,databasdumpar,0,0,1,1
52125,confirming,0,0,1,1
34822,strukturerat,0,0,1,1
35873,latine.,0,0,1,1
32954,alınmış,0,0,1,1
32503,alimentador,0,0,1,1
35871,കൊണ്ട്,0,0,1,1
32953,становиться,0,0,1,1
35870,kalın.,0,0,1,1
35869,anglófona,0,0,1,1
34829,confirmó,0,0,1,1
32504,shells,0,0,1,1
34825,söylenmeyecek,0,0,1,1
32952,фразам,0,0,1,1
34826,infelizmente,0,0,1,1
34827,பட்டியல்,0,0,1,1
32951,confirma,0,0,1,1
35868,прокат.,0,0,1,1
32505,ಸಲಹೆಯನ್ನು,0,0,1,1
34804,trokken,0,0,1,1
34802,уме,0,0,1,1
51824,betraktades,0,0,1,1
35922,или.,0,0,1,1
34778,ചരിത്രവും,0,0,1,1
32478,إنشاؤها,0,0,1,1
51682,voluntaria,0,0,1,1
32985,haces,0,0,1,1
35928,निंदन,0,0,1,1
32479,уходить,0,0,1,1
51683,கூடியனவாய்,0,0,1,1
35927,वर्चुअल,0,0,1,1
34780,നിർമ്മാണ-പഠന,0,0,1,1
35926,ഫാൻസി,0,0,1,1
34782,монографиями.,0,0,1,1
35925,artificiels,0,0,1,1
32481,selección,0,0,1,1
34783,connexions,0,0,1,1
34784,vir.,0,0,1,1
32482,påbörjade,0,0,1,1
32983,γωνίααυτή,0,0,1,1
35923,fiables».,0,0,1,1
32483,tapiz,0,0,1,1
32477,isimde,0,0,1,1
32476,ederler.,0,0,1,1
51819,regulamentações.,0,0,1,1
34772,ayudar,0,0,1,1
32468,введите,0,0,1,1
34769,mellie'ydi,0,0,1,1
32470,métiers,0,0,1,1
32472,comprenez,0,0,1,1
35937,obtuso.,0,0,1,1
35936,απουσιάζουν,0,0,1,1
34770,würden.,0,0,1,1
34771,जयादा,0,0,1,1
52062,ಹೇಳಿದರು,0,0,1,1
34776,corrigen,0,0,1,1
35935,मणिपुरी,0,0,1,1
32473,bezighouden,0,0,1,1
32474,الأكبر,0,0,1,1
35934,две.,0,0,1,1
34775,bytes,0,0,1,1
32475,albert,0,0,1,1
51681,pornografiska,0,0,1,1
35933,തുടങ്ങിയിട്ടില്ല,0,0,1,1
34786,inclure,0,0,1,1
35921,racional.,0,0,1,1
34801,debris,0,0,1,1
35920,soup,0,0,1,1
51684,είπαν,0,0,1,1
51685,الأم.,0,0,1,1
32976,reservado,0,0,1,1
34797,parents,0,0,1,1
35907,συνεχίσω,0,0,1,1
32493,नेगोशिएशन,0,0,1,1
32974,ഉപവിഭാഗമാണ്,0,0,1,1
32973,å,0,0,1,1
34799,φέρεσαι,0,0,1,1
32494,கண்ணீருக்கு,0,0,1,1
32495,upp.,0,0,1,1
35905,विर्गील,0,0,1,1
35904,magst,0,0,1,1
32972,أريده,0,0,1,1
35902,forekommer,0,0,1,1
32971,பிரமாதமாக,0,0,1,1
35900,l'ont,0,0,1,1
35899,правосудия,0,0,1,1
51816,medtaget,0,0,1,1
34794,minde,0,0,1,1
32491,красоту.,0,0,1,1
35910,escriba,0,0,1,1
35916,الخبرة,0,0,1,1
32980,wordsworth's,0,0,1,1
52063,ochtend,0,0,1,1
34790,argon,0,0,1,1
32978,exploitation,0,0,1,1
35917,الادعاءات,0,0,1,1
32485,തമാശ,0,0,1,1
32486,dilemas.,0,0,1,1
51818,இணையத்,0,0,1,1
35915,κάποιον.,0,0,1,1
35911,связи.,0,0,1,1
34791,торговом,0,0,1,1
35914,സഹിക്കൂ.,0,0,1,1
52126,femme,0,0,1,1
35913,независимо,0,0,1,1
34792,texter,0,0,1,1
32489,പദ്ധതിക്ക്,0,0,1,1
32490,प्रविष्टियाॅं,0,0,1,1
32977,отпустила,0,0,1,1
35650,vlees,0,0,1,1
34975,mercury,0,0,1,1
32109,rumpelte,0,0,1,1
32703,artikelhistoriken.,0,0,1,1
51780,நடைமுறைப்படுத்தி,0,0,1,1
35150,എല്ലായ്‌പ്പോഴും,0,0,1,1
35368,lyfter,0,0,1,1
32697,मुद्दे,0,0,1,1
35367,sıktığım,0,0,1,1
51750,തീരുമാനിക്കേണ്ടതുണ്ട്.,0,0,1,1
32698,chiffrement,0,0,1,1
35365,मुद्दा,0,0,1,1
35364,يقوله,0,0,1,1
32699,записей,0,0,1,1
35363,hermosa.,0,0,1,1
35362,trouwjurk,0,0,1,1
35361,ಆಬ್ಟ್ಯೂಸ್,0,0,1,1
35151,garantizar,0,0,1,1
52095,site[z].,0,0,1,1
35360,salida.,0,0,1,1
32701,изданием,0,0,1,1
35359,implicaba,0,0,1,1
32799,attrapé,0,0,1,1
51749,مفتوح,0,0,1,1
35148,இன்,0,0,1,1
35370,d'extrême,0,0,1,1
35382,данное,0,0,1,1
35387,കാണുന്നില്ലെന്ന്‌,0,0,1,1
35144,tøver.,0,0,1,1
35145,ಕೊಳಕು,0,0,1,1
35386,الجنود,0,0,1,1
35385,reborn,0,0,1,1
35384,idéalement,0,0,1,1
35383,website's,0,0,1,1
51781,söyledi.,0,0,1,1
32800,ip-adress.,0,0,1,1
35371,march [update],0,0,1,1
35380,ಕಡೆಗೆ,0,0,1,1
35379,согласен,0,0,1,1
35378,putting,0,0,1,1
35147,вызван,0,0,1,1
35377,hurtigt,0,0,1,1
35376,научной,0,0,1,1
35373,cunt,0,0,1,1
32695,hoor,0,0,1,1
32702,win,0,0,1,1
32704,zorunluğu,0,0,1,1
35388,«википедия»,0,0,1,1
35358,ethnocentrique,0,0,1,1
35347,விடயங்கள்,0,0,1,1
32716,நேசிக்கிறேன்,0,0,1,1
35345,juxtaposition,0,0,1,1
32717,antik,0,0,1,1
51752,минутку.,0,0,1,1
35165,entrada.,0,0,1,1
51777,authoritative,0,0,1,1
35344,कंजर्वापीडिया,0,0,1,1
32718,المتبقي,0,0,1,1
32719,явный,0,0,1,1
35168,multidimensional,0,0,1,1
35343,democrática.,0,0,1,1
35342,.qui,0,0,1,1
32794,التعاوني،,0,0,1,1
35170,battle,0,0,1,1
35171,ಪ್ರಿಯತಮೆಯು,0,0,1,1
32720,réussite,0,0,1,1
35173,n'obtenez,0,0,1,1
32721,сердца.,0,0,1,1
35161,பெரிதுபடுத்த,0,0,1,1
32713,തുടരുന്നതിന്,0,0,1,1
32712,loved,0,0,1,1
32795,contribuído,0,0,1,1
32798,दावे,0,0,1,1
35357,λήθαργοι,0,0,1,1
35356,मजेदार,0,0,1,1
35354,καταπληκτικά,0,0,1,1
32705,déchristianisation,0,0,1,1
32706,темам,0,0,1,1
32796,actives,0,0,1,1
35353,मुहम्मद,0,0,1,1
35155,alimentés,0,0,1,1
35348,даллас,0,0,1,1
35156,ದಾಸಿಯರು,0,0,1,1
35350,schätzen.,0,0,1,1
35349,commune,0,0,1,1
51778,fundamentally,0,0,1,1
32711,وضع,0,0,1,1
35158,நபரின்,0,0,1,1
35159,prestigiosas,0,0,1,1
35160,l'intonation.,0,0,1,1
32801,ആഗ്രഹിക്കുന്നിടത്തോളം,0,0,1,1
35389,perdon,0,0,1,1
32724,fatores,0,0,1,1
32812,stay,0,0,1,1
32821,d'amsterdam,0,0,1,1
51783,treatment,0,0,1,1
32819,улыбалась,0,0,1,1
35121,फ़ाइलों,0,0,1,1
35429,ಕೋಪಗೊಂಡಿದ್ದೇನೆ,0,0,1,1
35428,décrit,0,0,1,1
32680,ceasing,0,0,1,1
35426,войну,0,0,1,1
35425,understrege,0,0,1,1
35424,написанных,0,0,1,1
32815,damaged,0,0,1,1
32814,hechas.,0,0,1,1
35123,охвату,0,0,1,1
32681,അല്ലെങ്കിൽ‌.,0,0,1,1
32813,കണക്കുകൂട്ടൽ,0,0,1,1
35124,restricciones.,0,0,1,1
35420,ಟಕ್ಕೆ,0,0,1,1
35419,красотой,0,0,1,1
35418,onderzoeken,0,0,1,1
32822,konferanslarda,0,0,1,1
35430,emploient ,0,0,1,1
35432,позицией,0,0,1,1
32825,النصف,0,0,1,1
35109,உலகின்,0,0,1,1
32827,καθρέφτη,0,0,1,1
52081,பங்களிப்பாளர்கள்,0,0,1,1
32673,നോക്കാറുണ്ട്.,0,0,1,1
35438,dizem.,0,0,1,1
51784,realized,0,0,1,1
32826,മാതൃകയുടെ,0,0,1,1
35111,arbeitet.,0,0,1,1
35437,தொகுப்பாளர்களால்,0,0,1,1
35118,فالكلمة,0,0,1,1
35113,onderbreken.,0,0,1,1
35435,ಕೋಣೆಗೆ,0,0,1,1
35434,انظرويكيبيدياترجمة,0,0,1,1
35114,batido,0,0,1,1
35115,gboard,0,0,1,1
35433,  euros,0,0,1,1
32824,roden,0,0,1,1
35117,olursa,0,0,1,1
32683,klassificerat,0,0,1,1
35416,ஒன்றுக்கு,0,0,1,1
32694,ഫ്ലംമോക്സായി,0,0,1,1
51744,കഴിക്കുന്നതിനേക്കാൾ,0,0,1,1
35403,spiser,0,0,1,1
32807,उतने,0,0,1,1
32806,imorgon.,0,0,1,1
35402,один-единственный,0,0,1,1
35137,relectures,0,0,1,1
35401,acordados,0,0,1,1
32805,ओपन,0,0,1,1
32690,çalışır.,0,0,1,1
35138,واجهته,0,0,1,1
35139,ഒട്ടും,0,0,1,1
32691,δάκρυά,0,0,1,1
35141,ശ്രദ്ധിക്കാൻ,0,0,1,1
32692,géométrie,0,0,1,1
51748,made.,0,0,1,1
35142,forth,0,0,1,1
35395,stoppe,0,0,1,1
35393,मॉल,0,0,1,1
35392,återge,0,0,1,1
35391,mainstream,0,0,1,1
32689,خورازميات,0,0,1,1
32809,sementes,0,0,1,1
35136,سعيدًا,0,0,1,1
35411,اهتمامك,0,0,1,1
35413,നാർസിസയും,0,0,1,1
32684,കൊടുത്തുകൊണ്ടുള്ള,0,0,1,1
35126,بالإصدارات,0,0,1,1
35127,مساهمون,0,0,1,1
35128,sacred,0,0,1,1
32685,ಕಳೆದ,0,0,1,1
35130,detailed,0,0,1,1
51745,وخسرت,0,0,1,1
35410,английская ,0,0,1,1
52097,മറ്റുള്ളവരോട്,0,0,1,1
35409,söyleyebileceğinizden,0,0,1,1
35408,സ്രോതസ്സിന്റെ,0,0,1,1
32686,embodied,0,0,1,1
32810,plato,0,0,1,1
35131,بقائمة,0,0,1,1
35132,காபியை,0,0,1,1
35133,εκπλαγείτε,0,0,1,1
35404,количества,0,0,1,1
32793,viennent,0,0,1,1
32725,владелец,0,0,1,1
35440,praktijk,0,0,1,1
35264,participatória,0,0,1,1
35273,count,0,0,1,1
35215,passed.,0,0,1,1
35216,ക്രൂരവും,0,0,1,1
35217,περιλαμβάνει,0,0,1,1
35272,consécutifs,0,0,1,1
32778,സഞ്ചി,0,0,1,1
35271,समुदाय...,0,0,1,1
51768,çorbada,0,0,1,1
35270,ഉള്ളവരായതിനാൽ,0,0,1,1
32777,الأخرى،,0,0,1,1
51760,मेज,0,0,1,1
35269,அன்றிரவு,0,0,1,1
35221,auténtico,0,0,1,1
52087,காலம்வரை,0,0,1,1
32757,ευχαριστήσετε,0,0,1,1
35222,grundtankarna,0,0,1,1
35223,предложения,0,0,1,1
35224,presenterat,0,0,1,1
35266,pkdd,0,0,1,1
35274,питтсбурга,0,0,1,1
35214,ξέρετε.,0,0,1,1
32780,പ്രിയപ്പെട്ടവനാണ്,0,0,1,1
35208,yapacağım.,0,0,1,1
35204,медленном,0,0,1,1
35287,സൗന്ദര്യവും,0,0,1,1
51759,denkst,0,0,1,1
35206,മെലിസ,0,0,1,1
51769,tankerne,0,0,1,1
35283,ثاني,0,0,1,1
32782,υπηρέτησε,0,0,1,1
35282,рэнди,0,0,1,1
35281,κλπ.,0,0,1,1
32756,सौभाग्य।,0,0,1,1
52085,utvärderade,0,0,1,1
35279,plattformar,0,0,1,1
35209,ahogamiento,0,0,1,1
32753,находитесь,0,0,1,1
35278,ಶಬ್ದವಾಗಿದೆ.,0,0,1,1
32755,supercontinent.,0,0,1,1
35212,programma's.,0,0,1,1
35213,democráticamente,0,0,1,1
32759,visualizar,0,0,1,1
35225,المتداولة,0,0,1,1
35289,acessar,0,0,1,1
35263,للكتب,0,0,1,1
32764,craintes,0,0,1,1
35249,máquina,0,0,1,1
32765,verspreiden,0,0,1,1
32773,tropperne,0,0,1,1
35248,critical,0,0,1,1
35247,siyasi,0,0,1,1
52089,டிப்,0,0,1,1
51765,efetivada,0,0,1,1
35234,गूढ़,0,0,1,1
35235,observateurs,0,0,1,1
51767,умный,0,0,1,1
35236,аналогична,0,0,1,1
52090,கொண்டது.,0,0,1,1
32772,defect,0,0,1,1
51766,knams,0,0,1,1
35238,utilisée.,0,0,1,1
32769,हैंडसम,0,0,1,1
32770,fragezeichen.,0,0,1,1
32771,зачем,0,0,1,1
35231,alcanzó,0,0,1,1
35251,अपरंपरागत,0,0,1,1
32763,parallèles,0,0,1,1
35228,planın,0,0,1,1
35226,предвзятость,0,0,1,1
35262,ಬನ್ನಿ,0,0,1,1
51761,gesproken,0,0,1,1
35260,согласия,0,0,1,1
35259,входного,0,0,1,1
35258,வழங்கியது.,0,0,1,1
32776,தேடலில்,0,0,1,1
35256,descubrimiento,0,0,1,1
51762,चूँकि,0,0,1,1
32762,microwave,0,0,1,1
35255,woche,0,0,1,1
35254,κοινά,0,0,1,1
32760,வளர்ந்து,0,0,1,1
35253,கோடல்கள்,0,0,1,1
32761,possesseur,0,0,1,1
51764,பயன்படுத்திக்,0,0,1,1
35252,specialområden,0,0,1,1
35230,പ്രാപ്തിയാക്കുകയും,0,0,1,1
32752,ಖಚಿತವಿಲ್ಲ.,0,0,1,1
35203,acordei,0,0,1,1
32791,ciudad.,0,0,1,1
35316,dezenas,0,0,1,1
52093,طردت,0,0,1,1
35183,பேண,0,0,1,1
35184,ಚಿಂತಿಸಬೇಡ,0,0,1,1
35327,administratörsval,0,0,1,1
32736,değildi.,0,0,1,1
35326,അറിയാം.,0,0,1,1
35325,pms •,0,0,1,1
51758,ciência,0,0,1,1
35185,വിലയിരുത്തുന്നു.,0,0,1,1
35324,أقرت,0,0,1,1
35323,എന്നിവർ,0,0,1,1
32737,ارى.,0,0,1,1
32738,dehaene,0,0,1,1
32788,philips',0,0,1,1
35186,δυνατής,0,0,1,1
32787,தாக்கத்தை,0,0,1,1
35187,daran.,0,0,1,1
35319,وبسبب,0,0,1,1
35318,الملح،,0,0,1,1
32789,instantáneo.,0,0,1,1
35328,assumed,0,0,1,1
35182,avoir[w].,0,0,1,1
35337,premières,0,0,1,1
35177,mantenimiento.,0,0,1,1
35178,variant,0,0,1,1
32726,indenfor,0,0,1,1
35339,objections,0,0,1,1
32728,intervient,0,0,1,1
32729,என்பதே,0,0,1,1
32730,تعاونياً.,0,0,1,1
35338,groupes,0,0,1,1
35336,بمراجعة,0,0,1,1
32732,« wikipedia,0,0,1,1
51756,اليابانية،,0,0,1,1
51757,bütün,0,0,1,1
35179,gerenommeerd,0,0,1,1
32790,സൈനികർക്ക്,0,0,1,1
51776,நொடியில்,0,0,1,1
35331,tómate,0,0,1,1
32731,ഇടമില്ല,0,0,1,1
51775,बांग्ला,0,0,1,1
51773,दोष,0,0,1,1
35315,மயங்கிவிட்டேன்,0,0,1,1
35290,открытие,0,0,1,1
35189,indépendant,0,0,1,1
35197,φίλη,0,0,1,1
32746,ವಿಷಯಗಳನ್ನು,0,0,1,1
32747,« nature,0,0,1,1
35198,supervisor,0,0,1,1
35300,sejt.,0,0,1,1
32785,جميلًا,0,0,1,1
35299,нобелевский,0,0,1,1
35199,ettiler,0,0,1,1
35200,overskuelighed.,0,0,1,1
32750,разговаривали,0,0,1,1
52084,ആയിരിക്കുമെന്ന്,0,0,1,1
32784,объёмов,0,0,1,1
32783,продовольствие,0,0,1,1
35296,അവനോട്‌,0,0,1,1
35294,eet,0,0,1,1
35293,ethane,0,0,1,1
35292,يشعر,0,0,1,1
32751,lekkers,0,0,1,1
35291,തൽക്ഷണം,0,0,1,1
35301,ουρανούς,0,0,1,1
32745,pictures,0,0,1,1
35302,başladı.,0,0,1,1
35309,touch,0,0,1,1
35314,wikificere,0,0,1,1
35190,mover,0,0,1,1
32742,राष्ट्रपति,0,0,1,1
35313,நுபீடியாவிலிருந்து,0,0,1,1
35191,большую,0,0,1,1
32786,cebuano.,0,0,1,1
35192,davada,0,0,1,1
35310,waterways,0,0,1,1
52092,പദമില്ലാത്തതിനാൽ,0,0,1,1
35303,முறையான,0,0,1,1
32743,environnementale,0,0,1,1
32744,högtalaren.,0,0,1,1
35307,féminines.,0,0,1,1
35306,रोजेनजवीग,0,0,1,1
35194,ಹೇಳಿದ್ದು,0,0,1,1
35196,സൂചിപ്പിക്കുന്നു,0,0,1,1
35305,ಕೊಡುಗೆಗಳನ್ನು,0,0,1,1
35304,बिल्ट-इन,0,0,1,1
35439,derinlemesine,0,0,1,1
35108,challenged,0,0,1,1
32590,खातों,0,0,1,1
35029,топология,0,0,1,1
35584,önemlidir.,0,0,1,1
35018,بمقدار,0,0,1,1
52076,another.,0,0,1,1
32613,النظرات,0,0,1,1
35583,eliminado.,0,0,1,1
35581,പ്രവചിക്കുന്ന,0,0,1,1
35580,miraron,0,0,1,1
35578,φροντίζετε,0,0,1,1
35577,macha.,0,0,1,1
35576,génial.,0,0,1,1
35022,ಪುನರಾರಂಭಿಸಿ,0,0,1,1
35023,المجموعة,0,0,1,1
35025,بعمق,0,0,1,1
35575,أسألك,0,0,1,1
35026,opeten.,0,0,1,1
35574,அல்லவா,0,0,1,1
35573,droger,0,0,1,1
35571,प्रतिनिधि,0,0,1,1
35028,wovon,0,0,1,1
35017,internetvrienden,0,0,1,1
35016,confidencialmente,0,0,1,1
35015,किताब,0,0,1,1
35590,عيون,0,0,1,1
32869,തിരയിലിലൂടെ,0,0,1,1
52075,وقتًا,0,0,1,1
35594,पडेगा.,0,0,1,1
35593,oneerlijke,0,0,1,1
35592,дочь.,0,0,1,1
32867,şişman,0,0,1,1
32608,யூகிக்கிறீர்கள்,0,0,1,1
35591,வர்த்தகம்,0,0,1,1
32609,dividido,0,0,1,1
51725,verrückt.,0,0,1,1
35012,администраторам,0,0,1,1
32610,innehöll,0,0,1,1
35589,webbserver,0,0,1,1
35013,некоего,0,0,1,1
35587,πρακτική,0,0,1,1
35014,ನೀಡಿ,0,0,1,1
35586,bronnen,0,0,1,1
32611,assumant,0,0,1,1
32616,conditional,0,0,1,1
35569,انتقاد,0,0,1,1
32870,பெற்றுள்ளேன்,0,0,1,1
35568,preservar,0,0,1,1
32626,вперемешку,0,0,1,1
35554,जेन्नी,0,0,1,1
35553,l'autre.,0,0,1,1
35041,внешних,0,0,1,1
35552,நூலகம்,0,0,1,1
51790,phu,0,0,1,1
51729,refleja,0,0,1,1
51730,போகலாம்,0,0,1,1
32861,обнаружен,0,0,1,1
35551,कहेगा,0,0,1,1
35549,சுவாசிக்க,0,0,1,1
32629,zazaki,0,0,1,1
32858,automobile,0,0,1,1
32857,barnskyddslagstiftning.,0,0,1,1
35546,посещаемости.,0,0,1,1
32630,smaka,0,0,1,1
35544,dénonçant,0,0,1,1
32633,друга,0,0,1,1
35542,υποστηρίζει,0,0,1,1
35556,market.,0,0,1,1
32625,consistera,0,0,1,1
35557,langsame,0,0,1,1
35033,rétribution,0,0,1,1
32617,ubrugeligt,0,0,1,1
32619,others',0,0,1,1
32864,dependendo,0,0,1,1
35032,சந்தேகம்,0,0,1,1
32620,σχολίων.,0,0,1,1
32863,κάθισε,0,0,1,1
35565,примере,0,0,1,1
51791,ബാങ്ക്‌,0,0,1,1
35034,scheibe,0,0,1,1
35038,afasta-se,0,0,1,1
35035,gradiente,0,0,1,1
35563,услуга,0,0,1,1
35562,instalaciones,0,0,1,1
32622,tendência,0,0,1,1
35037,práticas,0,0,1,1
32623,sqlite,0,0,1,1
32624,gosto.,0,0,1,1
35558,σπόρους,0,0,1,1
35598,ontmoeting,0,0,1,1
35599,അതിശയകരമാണ്.,0,0,1,1
35540,derefter,0,0,1,1
35622,« fin,0,0,1,1
35639,கட்டுரையை,0,0,1,1
35638,pérennité,0,0,1,1
35637,publishes,0,0,1,1
34982,нуждаются,0,0,1,1
34984,kullanabileceğinizi,0,0,1,1
34985,avancement,0,0,1,1
34986,ilícita,0,0,1,1
32598,démarche,0,0,1,1
35634,opt-out,0,0,1,1
35633,kökler,0,0,1,1
34987,löst,0,0,1,1
35631,kede,0,0,1,1
34988,ರಜೆ,0,0,1,1
34990,coopératif »,0,0,1,1
32880,wikipedista,0,0,1,1
32879,കണ്ടെത്തൽ,0,0,1,1
34991,ошибаются.,0,0,1,1
35628,الإعلام,0,0,1,1
51723,boğuşuyorum,0,0,1,1
35640,المستخدم،,0,0,1,1
33519,основателей,0,0,1,1
32881,souciait,0,0,1,1
32886,donaties,0,0,1,1
34976,услышите,0,0,1,1
51719,brevetage,0,0,1,1
35647,disseminação,0,0,1,1
34977,പേജില്,0,0,1,1
32591,ചുവടെ,0,0,1,1
32887,uppslagsverksartikel.,0,0,1,1
52111,war •,0,0,1,1
32592,മറികടന്നുവെന്നും,0,0,1,1
32883,guldgyldent,0,0,1,1
35642,​​geräusch,0,0,1,1
34978,prestes,0,0,1,1
32593,resultantes,0,0,1,1
52110,vakgebieden.,0,0,1,1
34979,ഇവർക്കാണ്.,0,0,1,1
32596,يتعاونون,0,0,1,1
32882,recevoir,0,0,1,1
35644,repeating,0,0,1,1
35643,aniden,0,0,1,1
35626,καναπέ,0,0,1,1
35621,хороши,0,0,1,1
32871,survived,0,0,1,1
52108,придерживаются,0,0,1,1
35002,updating,0,0,1,1
35609,empregam,0,0,1,1
35608,осуществляет,0,0,1,1
51724,άκρη,0,0,1,1
35003,naaktslak,0,0,1,1
35004,verpest.,0,0,1,1
32605,heurísticas,0,0,1,1
35005,compitieron,0,0,1,1
35605,snegleeksempel.,0,0,1,1
35008,покупать,0,0,1,1
35603,score.,0,0,1,1
52106,comunidades.,0,0,1,1
35602,प्रयत्न,0,0,1,1
32607,എന്നുപറയുക.,0,0,1,1
35601,أصابعي,0,0,1,1
35600,κανονικό,0,0,1,1
35009,وتوزيع,0,0,1,1
35010,schaffen.,0,0,1,1
32872,mètres,0,0,1,1
35610,kleid,0,0,1,1
35000,കാര്യത്തിനിടയിലാണെങ്കിൽ,0,0,1,1
52073,año.,0,0,1,1
34997,வீட்டுப்பாடம்,0,0,1,1
34993,الإصدارات،,0,0,1,1
34994,عربته,0,0,1,1
32600,تجنب,0,0,1,1
34995,tanımlamaktadır.,0,0,1,1
32878,σύζυγος,0,0,1,1
34996,कैलिफोर्निया,0,0,1,1
32601,ഒരൊറ്റ,0,0,1,1
32602,şikayetçi,0,0,1,1
32603,أشغال,0,0,1,1
35611,க்குச்,0,0,1,1
51795,താരതമ്യേന,0,0,1,1
34998,wasser,0,0,1,1
52107,കുഴപ്പമില്ല,0,0,1,1
35615,क्राइमियाई,0,0,1,1
35613,മാതൃകാ,0,0,1,1
32877,tatlım,0,0,1,1
35612,entdeckung.,0,0,1,1
32876,ಅಳಲು,0,0,1,1
35541,producers',0,0,1,1
35539,juridiska,0,0,1,1
35107,perfecte,0,0,1,1
51739,அங்கேயே,0,0,1,1
32841,aportar,0,0,1,1
35476,πραγματική,0,0,1,1
35475,mimics,0,0,1,1
35474,βαρύ,0,0,1,1
35473,licensor,0,0,1,1
35472,ಹಣ,0,0,1,1
51786,تمضي,0,0,1,1
35471,authoritative.,0,0,1,1
32658,også.,0,0,1,1
32840,pestaña,0,0,1,1
52079,أو.,0,0,1,1
32661,हफ्तों,0,0,1,1
35468,ಮೆದುಳನ್ನು,0,0,1,1
51737,सोसाइटी,0,0,1,1
35467,المظهر,0,0,1,1
35466,കാര്യനിർവ്വാഹകർ,0,0,1,1
52080,konversationen.,0,0,1,1
32662,canciones,0,0,1,1
35090,تخريبًا.,0,0,1,1
35088,kopyalamaya,0,0,1,1
35087,консультируются,0,0,1,1
35478,nysade,0,0,1,1
35482,olabilirdim.,0,0,1,1
32653,нарцисой.,0,0,1,1
35486,амстердаме,0,0,1,1
35485,aarzelend.,0,0,1,1
32845,மகிழ்ச்சி.,0,0,1,1
35484,coração,0,0,1,1
51736,മറികടന്നു.,0,0,1,1
35081,kleding,0,0,1,1
35483,പ്രവർത്തിക്കുന്നത്.,0,0,1,1
35082,لاحقًا.,0,0,1,1
35479,फंसेंगे,0,0,1,1
35083,ಪಡೆಯಲಿಲ್ಲ,0,0,1,1
35481,ശ്രദ്ധപുലർത്തുക.,0,0,1,1
52078,uitdrukkelijk,0,0,1,1
35480,അടിസ്ഥാനമാക്കിയാണ്,0,0,1,1
35084,dictionary-style.,0,0,1,1
32843,era.,0,0,1,1
32654,unnatural,0,0,1,1
51788,study.,0,0,1,1
32663,minister,0,0,1,1
32664,meatspace.,0,0,1,1
35487,satisfactory,0,0,1,1
35091,طرقها,0,0,1,1
32834,ലക്ഷക്കണക്കിന്,0,0,1,1
32671,انطلقت,0,0,1,1
35450,électriques.,0,0,1,1
35449,gemeten,0,0,1,1
35099,moeilijker,0,0,1,1
51743,корреляцию,0,0,1,1
35447,bakışları,0,0,1,1
35102,beresheet,0,0,1,1
32832,utilization,0,0,1,1
35446,изменила,0,0,1,1
32831,ಪ್ರಶ್ನಾರ್ಥಕ,0,0,1,1
35103,burro,0,0,1,1
35444,pagina's,0,0,1,1
32830,ca •,0,0,1,1
35104,utsikt,0,0,1,1
35105,learning‏,0,0,1,1
35442,congratulations,0,0,1,1
32829,industrializados.,0,0,1,1
32672,läraren,0,0,1,1
35452,ലോസ്സ്,0,0,1,1
35098,bekostnad,0,0,1,1
35453,wiederholt,0,0,1,1
51785,ನಾಮಪದವಾಗಿ,0,0,1,1
32837,wissen.,0,0,1,1
32836,-pédia,0,0,1,1
32665,tasting,0,0,1,1
35464,tvekande.,0,0,1,1
51741,осознание,0,0,1,1
35462,utbildning,0,0,1,1
52098,¿perdóneme,0,0,1,1
35093,δουλέψεις,0,0,1,1
35459,huiquipedia,0,0,1,1
35454,المزهرة,0,0,1,1
32667,карролтон,0,0,1,1
51742,ಬಿರುಗಾಳಿಯ,0,0,1,1
35458,maddesinin,0,0,1,1
32669,geological,0,0,1,1
35096,gedachten,0,0,1,1
32835,поддерживались,0,0,1,1
35097,börja.,0,0,1,1
35456,எனப்படும்,0,0,1,1
35079,element,0,0,1,1
35488,विधि,0,0,1,1
32856,duitse,0,0,1,1
35514,agi.,0,0,1,1
35059,ಹೇಳುತ್ತಿದ್ದೀರಿ,0,0,1,1
35060,συνειδητοποιείς,0,0,1,1
32639,रत्नों,0,0,1,1
35526,ഭാഗവും,0,0,1,1
35525,kender.,0,0,1,1
35524,enten,0,0,1,1
51731,nergisli,0,0,1,1
35522,وسيمًا,0,0,1,1
35062,provocó,0,0,1,1
52077,verilen,0,0,1,1
35521,ವ್ಯವಹಾರವು,0,0,1,1
35520,front-page,0,0,1,1
32640,kahraman,0,0,1,1
35519,olmuştur.,0,0,1,1
52104,drukken,0,0,1,1
35518,pre.,0,0,1,1
35517,பொதேரி’,0,0,1,1
52101,മനസ്സിലായില്ലെങ്കിൽ‌,0,0,1,1
35515,सुस्निंग.नु,0,0,1,1
35058,débats,0,0,1,1
35057,തുടങ്ങുന്നത്.,0,0,1,1
35056,αδελφά,0,0,1,1
35534,değiştirmesini,0,0,1,1
35045,dépassées,0,0,1,1
35538,lykønske,0,0,1,1
35046,выходных».,0,0,1,1
35047,complejidad,0,0,1,1
32854,ci-dessous.,0,0,1,1
35049,манеры,0,0,1,1
35535,honderden,0,0,1,1
35050,δίλημμα.,0,0,1,1
35051,كائنات,0,0,1,1
35055,inicio,0,0,1,1
32637,получена,0,0,1,1
35532,dialetos,0,0,1,1
35531,तुर्कमैनी,0,0,1,1
35053,hohe,0,0,1,1
35530,പങ്കിടാൻ,0,0,1,1
35529,kızdırdım.,0,0,1,1
32638,o.lign.,0,0,1,1
35527,instituciones,0,0,1,1
32853,empirique.,0,0,1,1
35513,detection.,0,0,1,1
32652,d'elles.,0,0,1,1
35063,indiquer,0,0,1,1
32646,ആണിക്കല്ലായി,0,0,1,1
35501,phusika,0,0,1,1
32647,എല്ലാക്കാലവും,0,0,1,1
35500,soruyorsun.,0,0,1,1
35499,dönüyor,0,0,1,1
35074,имеющая,0,0,1,1
32847,смеяться,0,0,1,1
35497,hermana,0,0,1,1
32649,købte,0,0,1,1
32650,ألتو,0,0,1,1
35496,eliminador,0,0,1,1
52099,оплачиваемых,0,0,1,1
35076,edin,0,0,1,1
35494,aanstelling,0,0,1,1
35493,türetilmiştir.,0,0,1,1
51735,ಇದಕ್ಕಾಗಿ,0,0,1,1
35492,കളികൾ,0,0,1,1
32846,மாற்றினாள்,0,0,1,1
35490,عليهم,0,0,1,1
35072,പറയാതെ,0,0,1,1
35071,مبني,0,0,1,1
32849,dis-moi,0,0,1,1
32643,buluyorum,0,0,1,1
35512,nogensinde,0,0,1,1
52100,turco,0,0,1,1
35511,обучению,0,0,1,1
35064,sobreviveu,0,0,1,1
32851,beruhige,0,0,1,1
32642,قراءة,0,0,1,1
35065,ركضت,0,0,1,1
35508,disposent,0,0,1,1
35507,வரும்,0,0,1,1
35070,jardim,0,0,1,1
32644,görüyorum.,0,0,1,1
51732,بمصدر،,0,0,1,1
35504,مستقل,0,0,1,1
35067,тупоумный,0,0,1,1
35503,ifadeler,0,0,1,1
35068,التنغيم.,0,0,1,1
35069,koning,0,0,1,1
35502,noter,0,0,1,1
51659,honnêtement,0,0,1,1
32437,жарко,0,0,1,1
32436,accesserna.,0,0,1,1
52161,wiederholung,0,0,1,1
36574,mais.,0,0,1,1
36573,ييل,0,0,1,1
36572,ಹಿಸಿದಂತೆ,0,0,1,1
33167,астрономами,0,0,1,1
34327,браках,0,0,1,1
36571,τάξη,0,0,1,1
36569,ασημένιο,0,0,1,1
52162,shipments,0,0,1,1
32223,kamm,0,0,1,1
36568,docka,0,0,1,1
51578,अलेक्सा,0,0,1,1
33166,ಪುನರಾವರ್ತಿಸಬೇಕು,0,0,1,1
33165,http//en.wikipedia.org,0,0,1,1
36567,അനുവാദം,0,0,1,1
34328,നല്ലതാണെങ്കിൽ,0,0,1,1
36566,ಸುಂದರವಾಗಿದ್ದನು,0,0,1,1
36565,успех,0,0,1,1
36564,உணர்கிறேன்.,0,0,1,1
34329,bakıcısı,0,0,1,1
32221,adoptó,0,0,1,1
33168,bescheiden,0,0,1,1
33169,மாணவர்களுக்கான,0,0,1,1
34323,hydrosphere.,0,0,1,1
34319,ശ്രദ്ധിക്കുന്നു.,0,0,1,1
32214,സ്റ്റം‌പൻ‌ഡസിനുപകരം,0,0,1,1
34320,centralizam,0,0,1,1
52040,sønderknust,0,0,1,1
32215,வருகிறார்கள்,0,0,1,1
33173,staat.,0,0,1,1
34321,innovateurs,0,0,1,1
33172,apoiados,0,0,1,1
32216,lanzó,0,0,1,1
36576,prijs.,0,0,1,1
34324,søster,0,0,1,1
34325,”machine,0,0,1,1
33171,publiceras,0,0,1,1
32217,wikipediaträff,0,0,1,1
36578,நகரும்,0,0,1,1
34326,gesprochen,0,0,1,1
32218,المسجلون,0,0,1,1
33170,ημέρα,0,0,1,1
36563,نتائج,0,0,1,1
32224,नो-ब्रेनर,0,0,1,1
33175,زفافي,0,0,1,1
34330,bedömningen,0,0,1,1
34338,loop,0,0,1,1
32233,விக்கிப்பீடியாவாக,0,0,1,1
36549,δυσκολία,0,0,1,1
34339,confina,0,0,1,1
34340,encendido,0,0,1,1
36548,huwelijk,0,0,1,1
34341,representation.,0,0,1,1
52041,performed,0,0,1,1
36546,техническое,0,0,1,1
33163,försök,0,0,1,1
32234,задание,0,0,1,1
52157,uppträdde,0,0,1,1
34342,contemporaine,0,0,1,1
34343,الكامل,0,0,1,1
36542,الفارسية,0,0,1,1
34344,filtra,0,0,1,1
34345,κάνατε,0,0,1,1
52042,directa,0,0,1,1
36540,त्वरित,0,0,1,1
52158,paz,0,0,1,1
36550,åbent,0,0,1,1
51893,والعينات,0,0,1,1
36558,உயர்வு,0,0,1,1
34331,χαρούμε,0,0,1,1
36561,കൊള്ളാം.,0,0,1,1
34332,редакторами.,0,0,1,1
32228,traiter.,0,0,1,1
34333,icono,0,0,1,1
51579,rir,0,0,1,1
36559,l’homme.,0,0,1,1
32229,الحياة.,0,0,1,1
36557,πατώντας,0,0,1,1
52160,الصوت.,0,0,1,1
34334,मानने,0,0,1,1
34335,ಬಸ್,0,0,1,1
36556,दबाव,0,0,1,1
36555,сходных,0,0,1,1
51580,പങ്കെടുക്കുമ്പോൾ,0,0,1,1
36553,collabore,0,0,1,1
51581,अज़रबैजानी,0,0,1,1
51582,lava,0,0,1,1
36586,وأنواع,0,0,1,1
36587,جيدا,0,0,1,1
34346,зверски,0,0,1,1
34303,tardaba,0,0,1,1
51573,отнести,0,0,1,1
32198,имевшихся,0,0,1,1
36619,fluide,0,0,1,1
36618,aning.,0,0,1,1
33190,lösta,0,0,1,1
32199,tappat,0,0,1,1
52170,parodi,0,0,1,1
36617,repositório,0,0,1,1
36616,ലഭ്യമായിരിക്കണം.,0,0,1,1
33189,affiliates,0,0,1,1
36615,salate,0,0,1,1
36614,contrasting,0,0,1,1
36613,പിന്തുണയോടെയാണ്,0,0,1,1
52169,condicionales,0,0,1,1
36612,deformational,0,0,1,1
33188,olamazsın.,0,0,1,1
36611,المكونات,0,0,1,1
36610,conferências,0,0,1,1
32202,welt,0,0,1,1
36622,mesela,0,0,1,1
34297,ಇಲ್ಲದಿದ್ದರೆ,0,0,1,1
32197,ponctuellement,0,0,1,1
34290,arayana,0,0,1,1
36633,ತೀವ್ರ,0,0,1,1
51571,numérique »,0,0,1,1
32195,vermeiden.,0,0,1,1
36632,الجاني,0,0,1,1
33192,interchange,0,0,1,1
36631,combinée,0,0,1,1
32196,அழாதபடி,0,0,1,1
52171,ведомств.,0,0,1,1
36630,protists,0,0,1,1
36625,indonesië,0,0,1,1
36629,कमजोर,0,0,1,1
51572,delega,0,0,1,1
33191,actualiser}}.,0,0,1,1
36627,bénévoles,0,0,1,1
34294,subatomic,0,0,1,1
36626,للمعرفة,0,0,1,1
34295,உற்சாகமான,0,0,1,1
34296,yemelisin.,0,0,1,1
51574,ഗണത്തിൽപ്പെടുന്നു.,0,0,1,1
36608,reçue,0,0,1,1
34318,ακούτε,0,0,1,1
52168,സംവൃതോകാരത്തിന്റെ,0,0,1,1
51576,paleis,0,0,1,1
33179,currency,0,0,1,1
34308,irmã,0,0,1,1
34309,dørs,0,0,1,1
51577,följde,0,0,1,1
34310,ದಾಳಿಕೋರರು,0,0,1,1
34311,absolut,0,0,1,1
34312,आयमार,0,0,1,1
32211,aussicht,0,0,1,1
36595,remember.,0,0,1,1
36594,விட்டால்,0,0,1,1
36593,hetgeen,0,0,1,1
34314,consenso.,0,0,1,1
36592,ordnade,0,0,1,1
34315,സുഹൃത്ത്,0,0,1,1
36591,ámbito,0,0,1,1
34317,സാദ്ധ്യതയുണ്ടാവാറുണ്ട്।,0,0,1,1
36590,uncertainty,0,0,1,1
36589,ميدياويكي،,0,0,1,1
32209,aprendi,0,0,1,1
33180,annesiyle,0,0,1,1
52166,separation,0,0,1,1
33185,യാത്രയെക്കുറിച്ചോ,0,0,1,1
32205,энциклопедию,0,0,1,1
33187,week-end.,0,0,1,1
36606,couler,0,0,1,1
36605,б.,0,0,1,1
52167,подвез,0,0,1,1
34304,paresseux,0,0,1,1
34305,ಉಗುರು,0,0,1,1
36604,patch,0,0,1,1
32207,توزيع,0,0,1,1
36599,yapabilirler.,0,0,1,1
34306,telifi,0,0,1,1
33184,existentes,0,0,1,1
33183,தொனி,0,0,1,1
51575,exemple.,0,0,1,1
36603,naked,0,0,1,1
33181,lösenord,0,0,1,1
36601,годы,0,0,1,1
36600,establishes,0,0,1,1
36538,संध्या।,0,0,1,1
33161,pressionou,0,0,1,1
34287,ജീവശാസ്ത്രം ·രസതന്ത്രം ·environmental,0,0,1,1
34391,الخطأ,0,0,1,1
33143,кислоту ,0,0,1,1
52153,உப்பு,0,0,1,1
33142,വിലമതിക്കുന്നില്ല.,0,0,1,1
36468,المادية.,0,0,1,1
51886,quarry.,0,0,1,1
36467,rösttonen,0,0,1,1
36466,energievoorbeeld,0,0,1,1
32267,cosmic,0,0,1,1
52151,отклонила,0,0,1,1
34389,आपराधिक,0,0,1,1
36465,χρήσιμο,0,0,1,1
36464,materia,0,0,1,1
36463,corrijan.,0,0,1,1
52150,വാങ്ങാൻ,0,0,1,1
36461,διατήρηση,0,0,1,1
34390,للقاء,0,0,1,1
36460,etmeden,0,0,1,1
32268,implica.,0,0,1,1
36459,erhvervserfaring.,0,0,1,1
33144,dileyebilirsiniz,0,0,1,1
36471,администраторы,0,0,1,1
36472,sache,0,0,1,1
51590,español​,0,0,1,1
36487,പാവം,0,0,1,1
36485,dégustation,0,0,1,1
36484,दर्पण,0,0,1,1
36483,१५,0,0,1,1
32260,tagits,0,0,1,1
34378,കിടക്ക,0,0,1,1
34379,слушайте,0,0,1,1
34380,séquences,0,0,1,1
33148,ash,0,0,1,1
36473, مليون,0,0,1,1
36477,देर,0,0,1,1
33147,flicka.,0,0,1,1
32262,மொத்தக்,0,0,1,1
34383,செய்திகள்,0,0,1,1
34385,സ്വീകരിക്കാം.,0,0,1,1
33146,alayım,0,0,1,1
32264,/ˌwɪki-/,0,0,1,1
32265,означает.,0,0,1,1
36458,dokument,0,0,1,1
34392,judiciais.,0,0,1,1
51888,necessity,0,0,1,1
34393,ಹೊಂದಿರುವ,0,0,1,1
36448,добровольцев.,0,0,1,1
34405,mycket.,0,0,1,1
32274,indícios,0,0,1,1
34406,изобретений,0,0,1,1
34407,செய்நிரல்கள்’,0,0,1,1
36444,gelijk,0,0,1,1
33137,vänster-,0,0,1,1
33136,totalement,0,0,1,1
36443,patruljerer,0,0,1,1
36442,وإزالة,0,0,1,1
34408,تدريجية,0,0,1,1
32275,vurgulamakta,0,0,1,1
36441,الوثائقي,0,0,1,1
33134,പണമുണ്ടെന്ന്,0,0,1,1
33133,sammanfatta,0,0,1,1
36439,قهوتك,0,0,1,1
36438,следующих,0,0,1,1
36437,കീഴിൽ,0,0,1,1
34410,propuestos,0,0,1,1
51594,القمر،,0,0,1,1
32273,deliberate,0,0,1,1
34404,बीबीसी,0,0,1,1
36453,undeveloped,0,0,1,1
36457,profond,0,0,1,1
51591,melisa,0,0,1,1
36455,ಲೈಬ್ರರಿ,0,0,1,1
34394,يواجه,0,0,1,1
32270,compartilhada,0,0,1,1
34396,കഴിയുന്നില്ലെങ്കിൽ,0,0,1,1
34397,prachtige.,0,0,1,1
34398,acento,0,0,1,1
34400,ആകസ്‌മിക,0,0,1,1
36449,savez-vous.,0,0,1,1
34401,discussed,0,0,1,1
34402,सेल,0,0,1,1
33140,செல்கிறேன்.,0,0,1,1
51593,telefoniert,0,0,1,1
32271,ഒച്ചയുടെ,0,0,1,1
36451,“border,0,0,1,1
34403,admit,0,0,1,1
33138,sud.,0,0,1,1
36488,தொடங்குவதற்கு,0,0,1,1
33149,handful,0,0,1,1
36537,betona,0,0,1,1
33154,aquel,0,0,1,1
34355,напечатаны,0,0,1,1
51587,சிமிட்டினர்.,0,0,1,1
52043,drengen,0,0,1,1
33157,आंतरिक,0,0,1,1
32243,otro.,0,0,1,1
32244,téléverser,0,0,1,1
36522,solve.,0,0,1,1
32245,звонка,0,0,1,1
52155,forsøger,0,0,1,1
32246,اتضح,0,0,1,1
36521,расширяется.,0,0,1,1
52044,θέλατε.,0,0,1,1
32247,வந்தார்கள்,0,0,1,1
34358,wikimedia​,0,0,1,1
32248,கேள்வி.,0,0,1,1
32249,characterized,0,0,1,1
34359,процесса,0,0,1,1
36519,ತೋರುತ್ತೇವೆ.,0,0,1,1
35240,incrustar,0,0,1,1
32241,dakikalar,0,0,1,1
34354,финансировании,0,0,1,1
52156,bercez-vous,0,0,1,1
51583,efterfrågar,0,0,1,1
36536,وجبة,0,0,1,1
32236,നിങ്ങൾക്കറിയാമെങ്കിൽ,0,0,1,1
33160,indhold,0,0,1,1
32237,सिफोलिली,0,0,1,1
32238,सफलतापूर्वक,0,0,1,1
36533,basins,0,0,1,1
34349,وتخصصهم,0,0,1,1
32239,मस्तिष्क,0,0,1,1
36529,eserin,0,0,1,1
51586,behind,0,0,1,1
51585,фигурами,0,0,1,1
33159,princess,0,0,1,1
34350,directives,0,0,1,1
36528,ഹിച്ചാലും,0,0,1,1
36527,kindle,0,0,1,1
36526,ஏற்படுத்தப்பட்டுள்ள,0,0,1,1
36525,mars.,0,0,1,1
34351,calmez-vous,0,0,1,1
33155,zurückwies,0,0,1,1
36515,रेवोलुशन,0,0,1,1
34375,slid,0,0,1,1
36514,fond ,0,0,1,1
32258,கேள்விகளால்,0,0,1,1
36500,mueve,0,0,1,1
34368,überwältigt,0,0,1,1
36498,هكذا.,0,0,1,1
33151,திட்டமாகவும்,0,0,1,1
34369,parody,0,0,1,1
34370,अध्याय,0,0,1,1
32259,pisa,0,0,1,1
36494,edelstenen,0,0,1,1
34371,ಆಲಿಸಿ.,0,0,1,1
36493,यूरोपीय,0,0,1,1
51890,ಸರಿಯಾಗಿರುತ್ತೇನೆ.,0,0,1,1
36492,düşündü,0,0,1,1
36491,direct.,0,0,1,1
51889,offrira,0,0,1,1
34373,ಮೂಲಭೂತ,0,0,1,1
34374,திருத்தங்களைக்,0,0,1,1
36490,superieur,0,0,1,1
36489,together.,0,0,1,1
32256,giderse,0,0,1,1
52045,സാഹചര്യത്തിലായിരിക്കുക,0,0,1,1
36502,meegaan.,0,0,1,1
34362,അതിശയകരമാംവിധം,0,0,1,1
36513,flour,0,0,1,1
34360,topical,0,0,1,1
36511,போட்டி,0,0,1,1
36510,соберись.,0,0,1,1
32251,simulan,0,0,1,1
36509,оставался,0,0,1,1
51589,zinkt,0,0,1,1
34361,خاملة,0,0,1,1
36507,välmenande,0,0,1,1
36503,слушал.,0,0,1,1
34363,ಬರುತ್ತಾರೆ,0,0,1,1
32252,sondés,0,0,1,1
36506,независимости».,0,0,1,1
32255,tl •,0,0,1,1
33153,الساعة,0,0,1,1
51891,सामोगितियाई,0,0,1,1
36504,നിയമിക്കുന്നത്,0,0,1,1
34365,emner,0,0,1,1
36634,ενήργησα,0,0,1,1
51569,traduite,0,0,1,1
33022,бесплатно,0,0,1,1
33236,necessidade,0,0,1,1
36775,ತೆಗೆದುಕೊಂಡಿದ್ದೇನೆ,0,0,1,1
36774,evolvement,0,0,1,1
34200,வருகின்றது.,0,0,1,1
32136,ആരാണ്.,0,0,1,1
36773,pedidos.,0,0,1,1
36772,заинтересованы,0,0,1,1
36771,l'équivalent,0,0,1,1
36769,foretrukne,0,0,1,1
36767,tillförda,0,0,1,1
34202,undergoing,0,0,1,1
36766,ontwikkeling.,0,0,1,1
34203,solapa,0,0,1,1
36765,equivocarse.,0,0,1,1
32141,لدولة,0,0,1,1
36764,pools.,0,0,1,1
36763,пройдёт,0,0,1,1
34204,prominent,0,0,1,1
36762,ஆய்வொன்று,0,0,1,1
36761,العكس,0,0,1,1
36776,страницей,0,0,1,1
36777,معرفي,0,0,1,1
36778,wकैटलन,0,0,1,1
52035,χρησιμοποιεί,0,0,1,1
33239,फ़ाइलें,0,0,1,1
34194,låna,0,0,1,1
36787,ಮೇಜಿನ,0,0,1,1
51552,ortaya,0,0,1,1
32131,stock,0,0,1,1
36784,comprovação,0,0,1,1
34197,demandant,0,0,1,1
32132,hoşçakal,0,0,1,1
36783,тупыми,0,0,1,1
36779,aire,0,0,1,1
33238,walls.,0,0,1,1
34198,rundad,0,0,1,1
36782,meat.,0,0,1,1
32134,licences[f].,0,0,1,1
36781,spain,0,0,1,1
32135,весело»,0,0,1,1
36780,vermek,0,0,1,1
33237,αναπνεύσω,0,0,1,1
36760,diskussionen,0,0,1,1
36759,talihlerin,0,0,1,1
36788,não-especialistas,0,0,1,1
51553,ವೀಡಿಯೊಗೆ,0,0,1,1
33231,trycka,0,0,1,1
36749,интонацию.,0,0,1,1
33230,people ...,0,0,1,1
51556,पार्टी,0,0,1,1
32148,minor,0,0,1,1
34209,escucha,0,0,1,1
34210,باردة,0,0,1,1
36746,réparées,0,0,1,1
51903,edges.,0,0,1,1
34211,contenait,0,0,1,1
36744,pleasant,0,0,1,1
51557,defendia,0,0,1,1
34212,cair,0,0,1,1
32149,colaboraciones,0,0,1,1
36741,മൂന്നും,0,0,1,1
34213,और।,0,0,1,1
32151,polished,0,0,1,1
36740,wiskundehuiswerk,0,0,1,1
36739,лайк,0,0,1,1
34208,erfahren,0,0,1,1
34207,mauvaise,0,0,1,1
51904,tekstpassages.,0,0,1,1
32143,mevcuttur,0,0,1,1
51554,владеет,0,0,1,1
33235,gulches,0,0,1,1
36757,النخبوية,0,0,1,1
36756,olanların,0,0,1,1
36755,εμένα.,0,0,1,1
36754,costumbres,0,0,1,1
33234,البسيط,0,0,1,1
32142,chegaram,0,0,1,1
33233,luxemburguês,0,0,1,1
51905,ευτυχισμένος,0,0,1,1
33232,apresentou,0,0,1,1
36753,историк,0,0,1,1
51555,إعجابًا,0,0,1,1
32144,αμέσως.,0,0,1,1
36752,admiratifs,0,0,1,1
36751,долгое,0,0,1,1
36750,собственность,0,0,1,1
51906,एलेक्सा,0,0,1,1
32129,έφυγε,0,0,1,1
34192,μύτη,0,0,1,1
52036,acerta,0,0,1,1
34172,yapmamanı,0,0,1,1
32114,नवीनतम,0,0,1,1
51545,значения.,0,0,1,1
52181,relatórios,0,0,1,1
34165,കണ്ടെത്തുന്ന,0,0,1,1
32116,وجهت,0,0,1,1
51547,दबाकर,0,0,1,1
52180,hadean,0,0,1,1
36822,editoriais.,0,0,1,1
34166,zijd,0,0,1,1
34167,செய்தீர்கள்,0,0,1,1
36819,യോജിക്കാനാവുന്ന,0,0,1,1
36818,efectos,0,0,1,1
32117,التأثير,0,0,1,1
36817,nuit,0,0,1,1
34168,länkning,0,0,1,1
36816,cortos,0,0,1,1
32118,новая,0,0,1,1
34169,habían,0,0,1,1
34170,الملحوظة،,0,0,1,1
34164,lucir,0,0,1,1
34163,turing's,0,0,1,1
36825,المستخدمة,0,0,1,1
34156,hazineni,0,0,1,1
34151,बनायी,0,0,1,1
51541,drömmen,0,0,1,1
36834,காத்திருக்கச்,0,0,1,1
34152,plata,0,0,1,1
34153,médicos,0,0,1,1
34155,marxiste,0,0,1,1
32110,التعليمات,0,0,1,1
36832,leeft,0,0,1,1
34157,ಒಳ್ಳೆಯವರಂತೆ,0,0,1,1
34161,بدونك,0,0,1,1
34158,profondément,0,0,1,1
34159,montant,0,0,1,1
36829,kandidatexamen,0,0,1,1
51542,contido,0,0,1,1
33245,transactions.,0,0,1,1
51544,تركت,0,0,1,1
32111,ποτέ,0,0,1,1
34160,الخاطبين,0,0,1,1
34171,تملك,0,0,1,1
32120,معينة،,0,0,1,1
51549,parlak,0,0,1,1
34173,concordo,0,0,1,1
52032,remnants,0,0,1,1
36798,फीचर्ड,0,0,1,1
34185,okulda,0,0,1,1
34186,nesse,0,0,1,1
34187,interests.,0,0,1,1
33240,graphique,0,0,1,1
36797,ulaşamadı.,0,0,1,1
36796,fırtınalı,0,0,1,1
36795,ιανουαρίου,0,0,1,1
52033,amacı,0,0,1,1
36794,.ஆங்கிலத்தில்,0,0,1,1
52034,çıkarmanız,0,0,1,1
52179,ecke,0,0,1,1
36792,överens,0,0,1,1
36790,l’accessibilité,0,0,1,1
34189,ruwe,0,0,1,1
51548,gebe,0,0,1,1
34190,المنفرج,0,0,1,1
34191,ಬಂದಿದ್ದರು,0,0,1,1
34184,فحسب،,0,0,1,1
34183,décrivait,0,0,1,1
34182,konuşmayı,0,0,1,1
32123,satisfacer,0,0,1,1
36813,verbessern.,0,0,1,1
34175,altas,0,0,1,1
36812,αγαπημένη,0,0,1,1
36811,noruego,0,0,1,1
36810,natt,0,0,1,1
33243,докладах,0,0,1,1
36807,apprendre,0,0,1,1
51907,طاقة.,0,0,1,1
34177,schleppenden,0,0,1,1
34181,viviría,0,0,1,1
36804,tome,0,0,1,1
36803,cierta,0,0,1,1
34178,ugly,0,0,1,1
36802,'te,0,0,1,1
36801,distribuídas.,0,0,1,1
32124,உட்பட,0,0,1,1
36800,güzelce,0,0,1,1
34180,ऑफ,0,0,1,1
36738,эпично,0,0,1,1
36737,πούλησες,0,0,1,1
32193,amatör,0,0,1,1
34273,roc's,0,0,1,1
34263,செய்யவில்லை,0,0,1,1
34264,l'admettez,0,0,1,1
34265,aanbiedingen,0,0,1,1
34266,çıkmasını,0,0,1,1
33204,server.,0,0,1,1
36665,истинность,0,0,1,1
34268,flora.,0,0,1,1
36663,targeted,0,0,1,1
51565,രഹസ്യമുണ്ടായിരുന്നു.,0,0,1,1
52038,eklenmesi,0,0,1,1
32177,मल्टिपल,0,0,1,1
52174,beland.,0,0,1,1
36660,levensvatbare,0,0,1,1
52173,editan,0,0,1,1
32180,grameri,0,0,1,1
33201,analyserade,0,0,1,1
34271,şirketi,0,0,1,1
33200,комментарий,0,0,1,1
51566,utseendet,0,0,1,1
36667,élèves.,0,0,1,1
33206,“vikipedi,0,0,1,1
36668,interessado,0,0,1,1
36675,aménageurs,0,0,1,1
36679,incentivos,0,0,1,1
32174,fondamental,0,0,1,1
36678,الكتاب,0,0,1,1
32175,saisie,0,0,1,1
34254,август,0,0,1,1
33209,τεράστια,0,0,1,1
36677,[d]are,0,0,1,1
33208,yo',0,0,1,1
34258,grönvall,0,0,1,1
52175,الأحرف,0,0,1,1
36674,сложную,0,0,1,1
34259,trettonde,0,0,1,1
36673,möchtest.,0,0,1,1
36672,compartilhados,0,0,1,1
34260,précédents,0,0,1,1
36670,bekleyin.,0,0,1,1
36669,móvel.,0,0,1,1
51563,schleppend.,0,0,1,1
34272,ecologists,0,0,1,1
36658,réelles,0,0,1,1
34252,நண்பரிடம்,0,0,1,1
32182,hydrology,0,0,1,1
32189,galardonada,0,0,1,1
34281,gedroeg,0,0,1,1
36642,ഉണ്ട്,0,0,1,1
34282,levantou,0,0,1,1
36641,അവയ്ക്ക്,0,0,1,1
34283,جوزيف,0,0,1,1
32190,संगीत,0,0,1,1
33195,yoksa,0,0,1,1
33194,ഇതിഹാസം,0,0,1,1
34284,മുന്നോട്ടുപോകുക.,0,0,1,1
36639,filiations,0,0,1,1
52039,kuşunki,0,0,1,1
51896,πνίγω,0,0,1,1
34285,planten,0,0,1,1
33193,interplanetary,0,0,1,1
36637,setze,0,0,1,1
34286,zugeritten.,0,0,1,1
36636,consulting,0,0,1,1
36635,الحقيقة،,0,0,1,1
34280,ವ್ಯಕ್ತಿಯ,0,0,1,1
34279,saken.,0,0,1,1
36643,jornada.,0,0,1,1
36648,adquiridos,0,0,1,1
32183,распределяются,0,0,1,1
32184,опубликованными,0,0,1,1
36653,d'explicabilité,0,0,1,1
36652,háganme,0,0,1,1
36651,βιασμού,0,0,1,1
36650,jemand.,0,0,1,1
36649,ಬಯಸುತ್ತೀರಿ.,0,0,1,1
34276,നിർമ്മിച്ചിരിക്കുന്നത്,0,0,1,1
34277,ചേർക്കുന്നതും,0,0,1,1
33197,சந்திக்கப்,0,0,1,1
32186,önska,0,0,1,1
32187,ग्रिफ़िथ,0,0,1,1
34278,projetados,0,0,1,1
33199,предоставлен,0,0,1,1
33198,won't,0,0,1,1
51897,نصها,0,0,1,1
51567,filtrerades,0,0,1,1
36644,स्थानीय,0,0,1,1
33211,imprima,0,0,1,1
52037,нажали,0,0,1,1
51902,l'exercice.,0,0,1,1
36708,separately,0,0,1,1
36722,propriété,0,0,1,1
36721,efecto,0,0,1,1
34224,react,0,0,1,1
34225,design ·environmental,0,0,1,1
34226,مسكين,0,0,1,1
36720,sulak,0,0,1,1
36719,முயற்சிக்கும்போது,0,0,1,1
36718,गारंटी,0,0,1,1
32158,solely,0,0,1,1
51559,مشتقة,0,0,1,1
34227,ആയതുകൊണ്ട്,0,0,1,1
34228,identifiées,0,0,1,1
36714,beperkte,0,0,1,1
34229,positiv,0,0,1,1
33226,gönüllülerin,0,0,1,1
51560,പദങ്ങളോ,0,0,1,1
33225,просмотра.,0,0,1,1
36711,otte,0,0,1,1
36710,mantenido,0,0,1,1
36723,canadiennes,0,0,1,1
34223,verwijderen,0,0,1,1
32156,meelmeisjes,0,0,1,1
51558,inconsistencia,0,0,1,1
36736,daardoor,0,0,1,1
34214,siffran,0,0,1,1
34216,bought,0,0,1,1
34217,επιμεληθεί,0,0,1,1
36731,minecraft.,0,0,1,1
36730,dissidents.,0,0,1,1
33228,« communauté »,0,0,1,1
32154,описывал,0,0,1,1
36729,étymologique,0,0,1,1
36724,حرفيًا,0,0,1,1
32155,uppsatser.,0,0,1,1
34219,коммерческое,0,0,1,1
36728,ônibus,0,0,1,1
51900,θέματος,0,0,1,1
36726,عنك؟,0,0,1,1
34220,александрийской,0,0,1,1
34221,coletar,0,0,1,1
34222,toegankelijke,0,0,1,1
36709,تكشف,0,0,1,1
34231,tekniske.,0,0,1,1
32172,இயங்குகிறது.,0,0,1,1
33224,antalet,0,0,1,1
36692,coke.,0,0,1,1
34243,spisebordet,0,0,1,1
36691,редактор,0,0,1,1
36690,exhibir,0,0,1,1
34245,مفيدًا,0,0,1,1
36689,τρομακτική.,0,0,1,1
33220,αιτήματα.,0,0,1,1
36687,verängstigt,0,0,1,1
36686,المجالات,0,0,1,1
34246,ബന്ധത്തെക്കുറിച്ച്,0,0,1,1
33219,വാക്യങ്ങളെയും,0,0,1,1
36685,réciproque,0,0,1,1
34248,സംഭാഷണത്തിനിടയിലാണെങ്കിൽ,0,0,1,1
33216,slave,0,0,1,1
36683,lyckas,0,0,1,1
36682,расстроены,0,0,1,1
34250,kötüsü,0,0,1,1
34251,خطط.,0,0,1,1
33214,s'affranchir,0,0,1,1
36694,чаще,0,0,1,1
34242,gfdl.,0,0,1,1
51898,जाऊँगा,0,0,1,1
51899,للإنترنت,0,0,1,1
36706,soruda,0,0,1,1
32160,നിയന്ത്രിക്കപ്പെട്ടിരിക്കുന്നു.,0,0,1,1
36705,irlandês,0,0,1,1
33223,ಶೆಲ್ನ,0,0,1,1
32161,souriant,0,0,1,1
36703,acepte,0,0,1,1
34233,discrimination.,0,0,1,1
34234,بإمكان,0,0,1,1
32163,وحذف,0,0,1,1
36695,aniversário,0,0,1,1
33221,empregava,0,0,1,1
34238,upright.,0,0,1,1
34239,incrementa,0,0,1,1
36699,തുമ്മുമ്പോൾ,0,0,1,1
32165,förhandsgranskning,0,0,1,1
32166,economie,0,0,1,1
36697,நிகழும்,0,0,1,1
36696,forlader,0,0,1,1
36436,kleidern,0,0,1,1
33131,படுக்கை,0,0,1,1
36435,أعطت,0,0,1,1
34594,использовании,0,0,1,1
36177,wikislavia,0,0,1,1
36176,misterioso,0,0,1,1
36174,தொங்க,0,0,1,1
33053,सुन्दा,0,0,1,1
51854,заданиями,0,0,1,1
36173,कायम,0,0,1,1
34589,дорожки.,0,0,1,1
34590,بترتيب,0,0,1,1
36172,overalt,0,0,1,1
51643,вашингтоне,0,0,1,1
36171,dier,0,0,1,1
32384,شكر,0,0,1,1
36170,évoquer,0,0,1,1
36169,brudekjole,0,0,1,1
32385,реализуют,0,0,1,1
52134,developers,0,0,1,1
51644,كطباعة,0,0,1,1
36167,suscite,0,0,1,1
36166,modificam,0,0,1,1
34588,calcular,0,0,1,1
32382,பயணத்தைத்,0,0,1,1
51641,continuarmos,0,0,1,1
34583,penis,0,0,1,1
32378,islandés,0,0,1,1
36195,прошли,0,0,1,1
36194,labs,0,0,1,1
36193,conflits,0,0,1,1
36192,കൊണ്ടിരുന്ന,0,0,1,1
36191,ಸಾಬೀತುಪಡಿಸದ,0,0,1,1
36189,længe,0,0,1,1
33057,سكور.,0,0,1,1
36188,കശ്മീർ,0,0,1,1
36179,dries,0,0,1,1
34584,auffahrt,0,0,1,1
36187,existiam,0,0,1,1
36185,αναβαθμίστε,0,0,1,1
36184,onions,0,0,1,1
51640,« discussion »,0,0,1,1
36182,clavo.,0,0,1,1
32381,участвуют,0,0,1,1
34586,l'audience,0,0,1,1
34593,रीति-रिवाजों,0,0,1,1
36164,ನೋಡುತ್ತಿದ್ದೇನೆ,0,0,1,1
33058,activités[réf.,0,0,1,1
33052,communication.,0,0,1,1
32390,gestão,0,0,1,1
32391,заведомо,0,0,1,1
33048,auteursrechtelijke,0,0,1,1
33047,ಖರೀದಿಸಲು,0,0,1,1
33046,узнаваемы,0,0,1,1
36148,inclining,0,0,1,1
34604,physicien,0,0,1,1
34605,erop,0,0,1,1
36147,geht's,0,0,1,1
36146,tomando,0,0,1,1
32395,горничные,0,0,1,1
34608,termijn,0,0,1,1
52133,unintelligen,0,0,1,1
34610,ritter,0,0,1,1
51853,europeisk,0,0,1,1
36143,уроните,0,0,1,1
32397,pipaby,0,0,1,1
36142,brandt,0,0,1,1
34612,aumenta,0,0,1,1
33049,l'autoaprentissage,0,0,1,1
32389,tonlamayı,0,0,1,1
36153,கூடுவன.,0,0,1,1
36159,award.,0,0,1,1
33051,vacant,0,0,1,1
34596,ಹೇಳಬಹುದೇ,0,0,1,1
34597,rappelé,0,0,1,1
36163,orageuse,0,0,1,1
36162,lyse,0,0,1,1
36161,அறைக்குள்,0,0,1,1
34598,låtar,0,0,1,1
34599,ರುಚಿ,0,0,1,1
36158,herhalen.,0,0,1,1
32388,postings,0,0,1,1
34601,നന്ദിയുണ്ട്,0,0,1,1
34602,gelijk.,0,0,1,1
36156,frivillig,0,0,1,1
34603,φυσικό.,0,0,1,1
32387,δουλεύει,0,0,1,1
36155,föreställer,0,0,1,1
33050,turkiets,0,0,1,1
36154,الادعاء,0,0,1,1
51639,grundare.,0,0,1,1
32377,മില്ല്യൺ,0,0,1,1
34614,truppen,0,0,1,1
36217,असाधारण,0,0,1,1
34551,kullanılmaz.,0,0,1,1
34552,declínio,0,0,1,1
36229,концепцию,0,0,1,1
32360,urls.,0,0,1,1
36227,كمتمم,0,0,1,1
36226,صديقي.,0,0,1,1
34554,skydda,0,0,1,1
34555,திட்டவடிவம்,0,0,1,1
36225,tårar.,0,0,1,1
34556,animalia.,0,0,1,1
51634,graham,0,0,1,1
34557,disposait,0,0,1,1
34558,träumen,0,0,1,1
34559,ಎಳೆಯಿರಿ,0,0,1,1
34560,agricoles,0,0,1,1
36221,pronoun,0,0,1,1
32362,bekendmaken,0,0,1,1
36220,escritores,0,0,1,1
36219,प्रभाविकता,0,0,1,1
34550,regimes,0,0,1,1
36230,سلطات,0,0,1,1
34549,ಅವುಗಳಲ್ಲಿ,0,0,1,1
34543,अनुमान,0,0,1,1
32356,большому,0,0,1,1
36236,онлайн-голосований,0,0,1,1
36235,campanha,0,0,1,1
33073,ആവർത്തിക്കണം,0,0,1,1
34539,bölümünde,0,0,1,1
33071,finalmente,0,0,1,1
34541,agências,0,0,1,1
34542,ernstige,0,0,1,1
36233,ಮಾಡುತ್ತೇನೆಂದರೆ,0,0,1,1
52054,déconcertée,0,0,1,1
34544,böyle,0,0,1,1
32358,வாசகர்களையும்,0,0,1,1
32359,energidrik,0,0,1,1
51632,locomotion‏.,0,0,1,1
34545,supervisionar,0,0,1,1
34546,оперирующий,0,0,1,1
36231,hemlighet,0,0,1,1
34547,slö,0,0,1,1
36218,девушка,0,0,1,1
33066,brydde,0,0,1,1
34580,återställs,0,0,1,1
34562,llegaron,0,0,1,1
36207,«+,0,0,1,1
33062,δηλώσει,0,0,1,1
32369,stub,0,0,1,1
34573,regulation,0,0,1,1
36205,lees,0,0,1,1
36204,ஆறாவது,0,0,1,1
32370,sucediendo,0,0,1,1
36203,redactado,0,0,1,1
36201,captaste,0,0,1,1
32371,controverse ,0,0,1,1
32372,повторения.,0,0,1,1
32373,knappe,0,0,1,1
36200,عالمية،,0,0,1,1
34575,التحذيرات.,0,0,1,1
33061,உணவுகள்,0,0,1,1
33060,कहे,0,0,1,1
34577,introduzido,0,0,1,1
34579,чикаго,0,0,1,1
52136,إصدار,0,0,1,1
36208,красивая,0,0,1,1
36209,какие-то,0,0,1,1
34572,methodological,0,0,1,1
32365,цели.,0,0,1,1
34563,жила,0,0,1,1
32363,فيها،,0,0,1,1
36216,статьями,0,0,1,1
32364,கண்டறிந்ததோடு,0,0,1,1
51635,portrayals,0,0,1,1
36215,alumnos,0,0,1,1
34565,tegnsætning,0,0,1,1
52137,உரிமம்,0,0,1,1
34566,энергетический,0,0,1,1
36210,لديهما,0,0,1,1
51856,africa-related,0,0,1,1
34569,blockering,0,0,1,1
32366,മാർഗ്ഗമാണ്,0,0,1,1
34570,parsemé,0,0,1,1
33064,perú,0,0,1,1
51637,conquest,0,0,1,1
36212,«символом,0,0,1,1
36211,गतिविधियाँ,0,0,1,1
34613,سلسلة,0,0,1,1
36139,basıma,0,0,1,1
34411,صغيرًا,0,0,1,1
34667,изучали,0,0,1,1
36082,sorgulanabilir,0,0,1,1
51846,ونتيجة,0,0,1,1
51653,reflet,0,0,1,1
34661,codified,0,0,1,1
34662,donatorer.,0,0,1,1
36080,sætter,0,0,1,1
36079,मेटा-विकी,0,0,1,1
32424,renderização.,0,0,1,1
36078,चलना,0,0,1,1
36076,cassés,0,0,1,1
36075,journalistiques,0,0,1,1
32425,kommen,0,0,1,1
36072,l'envergure,0,0,1,1
33028,mérite,0,0,1,1
36071,söylediği,0,0,1,1
36070,descenso,0,0,1,1
36069,सुसाइड,0,0,1,1
36068,advances,0,0,1,1
36067,wikiprojects,0,0,1,1
32423,നെഗറ്റീവ്,0,0,1,1
36083,varken,0,0,1,1
52131,ഡൽഹിയിൽ,0,0,1,1
33031,चिंतित,0,0,1,1
51848,refere-se,0,0,1,1
34653,histories,0,0,1,1
51847,ನಾರ್ಸಿಸಿಸಮ್,0,0,1,1
36090,zusätzlichen,0,0,1,1
36089,birisinin,0,0,1,1
36088,sur ,0,0,1,1
36087,commencent,0,0,1,1
34654,एफ़,0,0,1,1
36086,الإنجليزي,0,0,1,1
34659,hydrosphere,0,0,1,1
36085,செய்யவே,0,0,1,1
32420,ஆச்சரியப்படுகிறீர்கள்.,0,0,1,1
32421,هنا؟,0,0,1,1
34656,subjectives,0,0,1,1
34657,авторов,0,0,1,1
33029,reward.,0,0,1,1
34658,لطبيعة,0,0,1,1
32422,விளைவைப்,0,0,1,1
36065,sprankelende,0,0,1,1
32426,« usage,0,0,1,1
36093,पी.एच.डी.,0,0,1,1
51843,disagreeing.,0,0,1,1
51655,मानसिक,0,0,1,1
34680,ಬ್ರೆಡ್ನೊಂದಿಗೆ,0,0,1,1
34681,находится,0,0,1,1
36051,norwegian,0,0,1,1
51657,conditionne,0,0,1,1
36049,ಸ್ನೇಹಿತರಿಗೆ,0,0,1,1
36048,koffie,0,0,1,1
36047,ക്ഷമയോടെ,0,0,1,1
36046,வா.,0,0,1,1
33023,பிரிட்டானிக்காவின்,0,0,1,1
34682,etc,0,0,1,1
36044,ಗುದ್ದಾಟ,0,0,1,1
36043,جرب,0,0,1,1
36042,börja,0,0,1,1
34683,है।कनाडा,0,0,1,1
34684,d'escargot.,0,0,1,1
36041,медицины,0,0,1,1
36040,permanecessem,0,0,1,1
34685,ತೊಂದರೆಗೊಳಗಾಗಲು,0,0,1,1
34679,പറ്റുന്നതിൽ,0,0,1,1
34678,സംബന്ധിക്കുന്ന,0,0,1,1
34677,இக்கட்டுரைகளில்,0,0,1,1
34672,اعترض,0,0,1,1
36061,proactifs.,0,0,1,1
34669,suceden,0,0,1,1
36060,ಪ್ರವೇಶಿಸಿದರು,0,0,1,1
36059,upptagen.,0,0,1,1
34670,തണുത്തത്,0,0,1,1
34671,παρά,0,0,1,1
32428,democratic,0,0,1,1
33027,ücretsiz,0,0,1,1
32429,ಎಲ್ಲಿದೆ,0,0,1,1
36054,قاموس.,0,0,1,1
33025,जटिल,0,0,1,1
32431,learning”,0,0,1,1
51842,nombre.,0,0,1,1
34675,ज़रा,0,0,1,1
33024,saknar,0,0,1,1
36056,mahvettim,0,0,1,1
32432,منتديات,0,0,1,1
34676,предмета,0,0,1,1
52132,corridor,0,0,1,1
34652,bahsetme.,0,0,1,1
51647,ancestry,0,0,1,1
34636,zugehört,0,0,1,1
36129,källhänvisningar.,0,0,1,1
34627,έλλη,0,0,1,1
36128,belonging,0,0,1,1
34629,mencione,0,0,1,1
34630,erronées,0,0,1,1
33039,énormes,0,0,1,1
36125,παντρεμένοι,0,0,1,1
34631,personificação,0,0,1,1
34632,terk,0,0,1,1
36123,pouvoir.,0,0,1,1
36122,കണ്ടിട്ട്.,0,0,1,1
34633,колберт,0,0,1,1
36120,litteratur,0,0,1,1
36119,funktionieren,0,0,1,1
32404,knop.,0,0,1,1
34634,التي.,0,0,1,1
34635,ಅನಿಸುತ್ತದೆ.,0,0,1,1
36118,φρικιαστικά,0,0,1,1
36116,minorités,0,0,1,1
34626,أيضًا.,0,0,1,1
33041,العبارة.,0,0,1,1
34625,mundo​​,0,0,1,1
33042,patocka,0,0,1,1
34615,മിശ്രശബ്ദമാണ്.,0,0,1,1
36138,reviewer,0,0,1,1
32399,describen,0,0,1,1
36137,usemod,0,0,1,1
34616,durdurduk,0,0,1,1
36136,överraskat,0,0,1,1
34618,users ...,0,0,1,1
34619,മുതലുള്ള,0,0,1,1
34620,है.,0,0,1,1
36130,except,0,0,1,1
36134,spekulerede,0,0,1,1
36133,tachonado,0,0,1,1
51851,серверов.,0,0,1,1
34621,yrkeskategorier,0,0,1,1
34622,plaisir.,0,0,1,1
34623,potentiële,0,0,1,1
34624,d’intuition,0,0,1,1
36131,mimesis,0,0,1,1
36115,énfasis,0,0,1,1
32405,личных,0,0,1,1
36094,décident,0,0,1,1
34637,ausgewogenen,0,0,1,1
36104,ഇംഗ്ലീഷ്‌,0,0,1,1
32411,पता।,0,0,1,1
32412,correspondiente.,0,0,1,1
34646,विघटनकारी,0,0,1,1
51849,கட்டுரைத்,0,0,1,1
33033,förstasidan.,0,0,1,1
32413,bn •,0,0,1,1
34648,контексте,0,0,1,1
32415,gehouden.,0,0,1,1
32416,masivo,0,0,1,1
36100,père,0,0,1,1
34649,genéticos,0,0,1,1
36098,bâtir,0,0,1,1
33032,angesehen,0,0,1,1
34650,biliyorum.,0,0,1,1
34651,दोहराना,0,0,1,1
32418,हैतियाई,0,0,1,1
36096,behagelig,0,0,1,1
36095,aanrijden,0,0,1,1
34644,esforço,0,0,1,1
51850,suffisent,0,0,1,1
34643,annoncent,0,0,1,1
32408,سيمونس,0,0,1,1
34638,слышать,0,0,1,1
52057,boodschapper,0,0,1,1
33036,uppmanar,0,0,1,1
34640,φοβόμουν,0,0,1,1
33035,அவரிடம்,0,0,1,1
36114,sunumlar,0,0,1,1
32407,girdiyse,0,0,1,1
33034,учебник,0,0,1,1
36112,pludselig,0,0,1,1
34642,استخدامًا،,0,0,1,1
36111,मरम्मत,0,0,1,1
36110,london,0,0,1,1
36109,ambicioso,0,0,1,1
51652,ανακρίβεια,0,0,1,1
32409,ഉചിതമല്ല,0,0,1,1
32410,السائح,0,0,1,1
36108,text-only,0,0,1,1
36107,abdecken,0,0,1,1
51630,والمجتمع,0,0,1,1
32355,разрабатывались,0,0,1,1
36238,போலி,0,0,1,1
34462,ameliorating,0,0,1,1
32300,orbital,0,0,1,1
34453,ಕಾಣಲು,0,0,1,1
36369,radiostation,0,0,1,1
32302,tommelfingrene,0,0,1,1
36368,estadounidense,0,0,1,1
34455,viajou,0,0,1,1
36367,competir,0,0,1,1
34456,അറിഞ്ഞിരിക്കണം.,0,0,1,1
36366,ತರಬಹುದೇ,0,0,1,1
51607,aldıkları,0,0,1,1
32303,växla,0,0,1,1
36364,exploration,0,0,1,1
34457,undertiden,0,0,1,1
32304,dividir,0,0,1,1
34458,javascript.,0,0,1,1
34459,статус.,0,0,1,1
34460,unes,0,0,1,1
36363,ή.,0,0,1,1
32305,«уловка-»,0,0,1,1
33117,polêmica,0,0,1,1
36371,عدداً,0,0,1,1
36372,energidryck,0,0,1,1
36380,ολόκληρη,0,0,1,1
36387,wikipediaappar,0,0,1,1
36385,assustador.,0,0,1,1
36384,minam,0,0,1,1
33119,comprobar,0,0,1,1
51605,planejando,0,0,1,1
36383,связана,0,0,1,1
34450,adequação,0,0,1,1
32298,ஆக்கப்பட்டு,0,0,1,1
36379,خمس,0,0,1,1
32299,βιβλιογραφία,0,0,1,1
36378,सभा,0,0,1,1
36377,опубликовал,0,0,1,1
34451,खींच,0,0,1,1
51606,மொழிகள்',0,0,1,1
34452,giacomo,0,0,1,1
36374,aprendizado.,0,0,1,1
36373,partido.,0,0,1,1
33118,cumprem,0,0,1,1
34461,death,0,0,1,1
34464,ίδρυση,0,0,1,1
34447,உற்சாகப்படுத்துங்கள்,0,0,1,1
36358,författats,0,0,1,1
36342,ребенку.,0,0,1,1
51612,ആധികാരിക,0,0,1,1
36341,удаляют,0,0,1,1
36339,tenga,0,0,1,1
36338,संभालते,0,0,1,1
33108,εγκέφαλό,0,0,1,1
36337,धमकी,0,0,1,1
32309,ಬಂದಿತು,0,0,1,1
34472,важнейших,0,0,1,1
34473,μαθαίνετε.,0,0,1,1
52145,قفزت,0,0,1,1
32312,oficina,0,0,1,1
34474,forskningsgrene,0,0,1,1
32313,والإندونيسية,0,0,1,1
52049,उज्ज्वल,0,0,1,1
32314,metrix.,0,0,1,1
36333,сладкого,0,0,1,1
52144,всеми,0,0,1,1
32316,انقر,0,0,1,1
34471,respectivement,0,0,1,1
36344,heterogen,0,0,1,1
36346,savoir-faire,0,0,1,1
34467,игру.,0,0,1,1
34465,общедоступная,0,0,1,1
36357,மென்மையானது,0,0,1,1
51879,l'automatisation,0,0,1,1
36356,созданы,0,0,1,1
32306,lachen.,0,0,1,1
34466,kontrollerar,0,0,1,1
33113,رمز,0,0,1,1
33112,ತರಗತಿಯಲ್ಲಿ,0,0,1,1
32307,विक्षनरी,0,0,1,1
36347,licences,0,0,1,1
36353,வர்த்தக,0,0,1,1
34468,آمل,0,0,1,1
36352,ændrede,0,0,1,1
36351,வென்றது,0,0,1,1
36350,thème.,0,0,1,1
36349,kaçınılır.,0,0,1,1
33110,violent,0,0,1,1
36348,поразительная,0,0,1,1
36388,ناقدة.,0,0,1,1
36389,விடைபெற்று,0,0,1,1
51629,العشرة,0,0,1,1
34431,mesclam-se,0,0,1,1
32283,टेलीग्राम,0,0,1,1
34422,congratulating,0,0,1,1
33128,कोल्बेर्ट,0,0,1,1
34423,imprecisiones,0,0,1,1
33127,குற்ற,0,0,1,1
32284,ósseo,0,0,1,1
36426,உணவுகளையும்,0,0,1,1
36425,prejudices.,0,0,1,1
36424,экзамену.,0,0,1,1
51599,connectionism,0,0,1,1
32287,التفكير,0,0,1,1
34427,concernées,0,0,1,1
34428,dominique,0,0,1,1
52148,شيركي،,0,0,1,1
34429,yaklaşan,0,0,1,1
32288,குழுசேர,0,0,1,1
36421,kolaydır,0,0,1,1
33125,സാധ്യമാക്കുന്ന,0,0,1,1
34430,catastrophe,0,0,1,1
32282,ಅಭಿಪ್ರಾಯವಿಲ್ಲ.,0,0,1,1
34421,water.,0,0,1,1
34419,संघर्ष,0,0,1,1
34415,оригинальные,0,0,1,1
34413,descripción,0,0,1,1
33130,ലേഖനങ്ങളെഴുതാനും,0,0,1,1
51885,d'exemple,0,0,1,1
36434,плачешь,0,0,1,1
36433,supervisory,0,0,1,1
51597,αφού,0,0,1,1
51598,événement,0,0,1,1
32276,lucratif.,0,0,1,1
36430,correctement,0,0,1,1
34418,penalidades,0,0,1,1
36429,وأخذت,0,0,1,1
52149,onéreusement.,0,0,1,1
36428,geheimnisvolles,0,0,1,1
32277,ವಿವರಿಸುವ,0,0,1,1
32278,inkluderar,0,0,1,1
51884,professional,0,0,1,1
32279,παίρνετε.,0,0,1,1
34417,கேட்கவும்.,0,0,1,1
32289,இருப்பதாகவும்,0,0,1,1
36420,എന്തുചെയ്യണമെന്ന്,0,0,1,1
36390,françois,0,0,1,1
36419,resten,0,0,1,1
34440,benutze,0,0,1,1
34441,breit,0,0,1,1
33122,gebruikt.,0,0,1,1
51602,/ˌwɪkiˈpiːdiə/,0,0,1,1
32293,حساب,0,0,1,1
36402,obra.,0,0,1,1
36400,trillion,0,0,1,1
36399,ويشكو,0,0,1,1
32294,ചോദിക്കണമെങ്കിൽ.,0,0,1,1
52146,„википедии“,0,0,1,1
36397,векторы.,0,0,1,1
34444,പ്രശ്നമില്ല.,0,0,1,1
36396,sarayımda,0,0,1,1
36395,estrategia.,0,0,1,1
36394,educativos,0,0,1,1
32295,information ,0,0,1,1
34446,respectueux,0,0,1,1
33121,गंभीर,0,0,1,1
36392,anneme,0,0,1,1
51882,تزايد,0,0,1,1
36407,تحتفظ,0,0,1,1
36408,ridande,0,0,1,1
34434,гарвардской,0,0,1,1
34433,beğenmeyi,0,0,1,1
32290,sonriendo,0,0,1,1
51600,tocante,0,0,1,1
36417,prost,0,0,1,1
51883,hierarchy,0,0,1,1
36416,столетия.,0,0,1,1
36415,stap,0,0,1,1
36413,polish,0,0,1,1
36412,female.,0,0,1,1
32292,париже,0,0,1,1
36411,şimdi.,0,0,1,1
52147,« diderot,0,0,1,1
34436,செருமானிய,0,0,1,1
36410,adicción».,0,0,1,1
51601,geklickt,0,0,1,1
33124,изменилась,0,0,1,1
36409,निकाल,0,0,1,1
34438,богатство,0,0,1,1
34475,hitting,0,0,1,1
52050,возникающие,0,0,1,1
36332,выходной,0,0,1,1
33079,rediffuser.,0,0,1,1
51868,ಸಿನೆಮಾಗಳಿಗಾಗಿ,0,0,1,1
33084,журналистов,0,0,1,1
52051,сделала,0,0,1,1
34513,broadly,0,0,1,1
36267,wiskundeboek,0,0,1,1
34514,سؤالك,0,0,1,1
36266,பானத்துடன்,0,0,1,1
34515,ഗ്നു,0,0,1,1
34516,ಉಡುಗೆ,0,0,1,1
51867,phase.,0,0,1,1
34517,stand.,0,0,1,1
32347,coding,0,0,1,1
33081,gevangenen,0,0,1,1
34518,دقة,0,0,1,1
51866,narcissemamma,0,0,1,1
36263,reivindicações,0,0,1,1
34521,deletion,0,0,1,1
34522,ಕೆಟ್ಟದಾಗಿದೆ,0,0,1,1
36262,çıldırdığımı,0,0,1,1
33085,tercüme,0,0,1,1
51870,ಹಿಂದಿನ,0,0,1,1
32344,وضميرًا,0,0,1,1
33087,armén,0,0,1,1
36278,കാമുകിയോ,0,0,1,1
51874,сне.,0,0,1,1
36277,diyebilirim,0,0,1,1
32339,accordingly,0,0,1,1
34507,conservar,0,0,1,1
51873,«истории»,0,0,1,1
32340,विज्ञान,0,0,1,1
33089,contrebande,0,0,1,1
51872,​​உங்கள்,0,0,1,1
36272,semence ,0,0,1,1
32341,opensourcesoftware,0,0,1,1
32342,administrative,0,0,1,1
36276,låne,0,0,1,1
32343,science ·ഹൈഡ്രോളജി,0,0,1,1
33086,italienne,0,0,1,1
36275,regardèrent,0,0,1,1
36274,قليلا,0,0,1,1
36273,направляются,0,0,1,1
32348,eleita,0,0,1,1
36261,zh-yue •,0,0,1,1
32318,emerged.,0,0,1,1
32349,amplio,0,0,1,1
36251,concurrent,0,0,1,1
51858,motståndare,0,0,1,1
36249,webaroo,0,0,1,1
36248,adjusts,0,0,1,1
51627,collaboratives.,0,0,1,1
36247,ενδιαφέρουσα,0,0,1,1
36246,сфера,0,0,1,1
34535,dessous,0,0,1,1
36244,независимыми,0,0,1,1
36243,beslutsgång,0,0,1,1
36242,விடைபெற,0,0,1,1
34536,ஒருவராக,0,0,1,1
32353,उपहार,0,0,1,1
36241,ऊर्जा,0,0,1,1
52053,твоих,0,0,1,1
36240,non-college,0,0,1,1
34537,கணக்கொன்று,0,0,1,1
32354,dinosaurs,0,0,1,1
51628,zalimce,0,0,1,1
33076,yourself.,0,0,1,1
34533,oversvømmelse,0,0,1,1
32352,παντρευτώ,0,0,1,1
33077,ملياري,0,0,1,1
33078,derive,0,0,1,1
34523,ആഗ്രഹിച്ചില്ല.,0,0,1,1
51863,сайтом,0,0,1,1
34524,oprettes,0,0,1,1
51862,valuation,0,0,1,1
34527,und.,0,0,1,1
36258,nothing.,0,0,1,1
51624,altos,0,0,1,1
51861,samlas,0,0,1,1
51859,ay,0,0,1,1
36256,мариан.,0,0,1,1
36255,l'état,0,0,1,1
32350,μαρία.,0,0,1,1
51860,killed,0,0,1,1
36253,скажете,0,0,1,1
51625,വെയറിന്റെ,0,0,1,1
34531,بخير.,0,0,1,1
32351,неделю,0,0,1,1
32338,weird,0,0,1,1
51621,söylüyordun,0,0,1,1
32337,juego.,0,0,1,1
36281,رأته,0,0,1,1
36317,தொகுக்கும்,0,0,1,1
52143,ചെയ്യാൻ.,0,0,1,1
36316,stunned,0,0,1,1
36314,vivía,0,0,1,1
34483,convención,0,0,1,1
33098,articulação.,0,0,1,1
36311,www.wikipedia.com،,0,0,1,1
33097,प्रभावी,0,0,1,1
36310,[sus],0,0,1,1
32322,ആവശ്യമില്ലെങ്കിൽ.,0,0,1,1
36309,ligesom.,0,0,1,1
34485,quedaría,0,0,1,1
36307,preferring,0,0,1,1
36306,tjugonde,0,0,1,1
51616,acontece,0,0,1,1
32323,l’émergence,0,0,1,1
32324,കണ്ടെത്തുകയാണ്,0,0,1,1
34486,ಹಾಗಾಗಿ,0,0,1,1
34487,accordent,0,0,1,1
36318,¿estaría,0,0,1,1
34481,mistaken.,0,0,1,1
33100,tanta,0,0,1,1
36326,своем,0,0,1,1
34477,onthe,0,0,1,1
34478,appellation,0,0,1,1
33104,l'équilibre,0,0,1,1
36330,بالإسبانية,0,0,1,1
51613,maktspel,0,0,1,1
36329,état,0,0,1,1
36328,wikitext,0,0,1,1
33103,إرباك,0,0,1,1
51877,wide.,0,0,1,1
36319,виделись,0,0,1,1
34480,tecavüz,0,0,1,1
33102,repetición.,0,0,1,1
32319,اصبروا,0,0,1,1
36325,arbetsflöden,0,0,1,1
33101,thermal,0,0,1,1
36323,tvivl,0,0,1,1
36322,ಸುಸ್ತಾಗಿಲ್ಲ,0,0,1,1
36321,serieus,0,0,1,1
32325,அறிமுகப்படுத்தியது.,0,0,1,1
33095,likhet,0,0,1,1
33094,கருத்துக்கள்.,0,0,1,1
34497,ಬಳಸುತ್ತೇವೆ,0,0,1,1
32331,ശരിയാക്കുന്നു.,0,0,1,1
51876,автор,0,0,1,1
36288,прерываю,0,0,1,1
36286,нарцис,0,0,1,1
34495,पाँच,0,0,1,1
36285,ലാഭേച്ഛകൂടാതെ,0,0,1,1
34496,numéricos,0,0,1,1
32332,viajando,0,0,1,1
51620,high-dimensional,0,0,1,1
36289,ίσχυαν,0,0,1,1
32333,ಸಭೆ,0,0,1,1
52141,diepbedroefd,0,0,1,1
33091,advice,0,0,1,1
51875,kalkylark,0,0,1,1
34499,ചെയ്യുന്നതിനെക്കുറിച്ച്,0,0,1,1
32336,அமைந்துள்ளது.,0,0,1,1
33090,ومرحبا.,0,0,1,1
36282,verwechseln,0,0,1,1
33092,ഉൾപ്പെടെ,0,0,1,1
36290,αγγλόφωνη,0,0,1,1
32326,альтернатива,0,0,1,1
36297,باحث,0,0,1,1
32327,exakt.,0,0,1,1
36303,преобразования,0,0,1,1
51617,தொகுத்துள்ளார்.,0,0,1,1
36301,التنقيب,0,0,1,1
36300,علمت,0,0,1,1
34489,basada,0,0,1,1
34490,buiten,0,0,1,1
36298,ಮೇಲಿನ,0,0,1,1
32328,planteamiento,0,0,1,1
36292,удачного,0,0,1,1
32329,nederig,0,0,1,1
51618,ब्लॉक,0,0,1,1
36296,directe,0,0,1,1
34491,possibilités.,0,0,1,1
36295,catégoriser,0,0,1,1
36294,لموقع,0,0,1,1
36293,sprogversion,0,0,1,1
33093,bordssätt,0,0,1,1
32250,pendentes',0,0,1,1
51039,தொகுப்பாளர்களின்,0,0,1,1
37765,பிட்,0,0,1,1
45817,üstteki,0,0,1,1
45808,d'interprétation,0,0,1,1
45811,ചെയ്യപ്പെട്ടു.,0,0,1,1
45812,നിരന്തരമായ,0,0,1,1
45813,bevæge,0,0,1,1
45814,δίπλα,0,0,1,1
45816,الحلو.,0,0,1,1
45819,ഉണ്ടായിരുന്നുവെന്ന്,0,0,1,1
45804,ಪೋರ್ಟಲ್,0,0,1,1
50331,umgangssprachlich,0,0,1,1
45820,अनुकूल,0,0,1,1
45821,ಲೈಕ್,0,0,1,1
45822,فاجئك,0,0,1,1
45823,vancouversystemet,0,0,1,1
45825,темы.,0,0,1,1
45806,статей».,0,0,1,1
45803,ചൂടാണ്,0,0,1,1
45785,artikelversion,0,0,1,1
45793,terminará,0,0,1,1
45788,anlamakta,0,0,1,1
50334,nynorsk,0,0,1,1
45789,anónimo,0,0,1,1
45790,ಸಿದ್ಧರಿದ್ದೀರಿ,0,0,1,1
45791,يتحدث,0,0,1,1
50333,wikitext.,0,0,1,1
45794,κόπο.,0,0,1,1
45802,தரப்பும்,0,0,1,1
45795,ссылается,0,0,1,1
45796,приглашения,0,0,1,1
45797,chimiques,0,0,1,1
45799,j'utilise.,0,0,1,1
45800,dagligen,0,0,1,1
45801,absolument,0,0,1,1
45826,cliquear,0,0,1,1
45827,നിങ്ങൾക്കറിയാം,0,0,1,1
45828,propiedad.,0,0,1,1
45865,لمعلومات,0,0,1,1
50327,വൃത്തിയാക്കൽ,0,0,1,1
45859,ऑप्टिकल,0,0,1,1
45860,robotisées.,0,0,1,1
45862,ശ്രദ്ധയിൽ,0,0,1,1
45863,стимулом англ.,0,0,1,1
45864,handlinger,0,0,1,1
50324,padronizado,0,0,1,1
45831,tratados.,0,0,1,1
50323,धनवानों,0,0,1,1
50321,ഇടയില്ലാത്ത,0,0,1,1
45868,créative,0,0,1,1
45869,année.,0,0,1,1
45870,estudo.,0,0,1,1
45873,ഇതിനർത്ഥം,0,0,1,1
45857,claim.,0,0,1,1
50328,siglos.,0,0,1,1
45855,ശ്രദ്ധപുലർത്തുന്നു.,0,0,1,1
45854,esprits.,0,0,1,1
45851,पर्सन,0,0,1,1
45850,реальных,0,0,1,1
45849,adamların,0,0,1,1
45848,δείξει,0,0,1,1
45846,rival,0,0,1,1
50330,الدنا،,0,0,1,1
45841,அதிநவீனமாக,0,0,1,1
45839,அம்மாவுக்குத்,0,0,1,1
45838,kökü,0,0,1,1
45836,الأقل,0,0,1,1
45835,l'estimation,0,0,1,1
45834,acadêmico.,0,0,1,1
45832,kinesiska,0,0,1,1
45787,गन,0,0,1,1
45784,പ്രവർത്തനം,0,0,1,1
45876,yazarlarının,0,0,1,1
45730,даю,0,0,1,1
45724,intresseområden.,0,0,1,1
45725,detektere,0,0,1,1
45726,síntomas,0,0,1,1
45728,saknat,0,0,1,1
50344,gerekmez,0,0,1,1
45729,അഞ്ച്,0,0,1,1
45731,framfört,0,0,1,1
45722,بزيارة,0,0,1,1
45732,k-,0,0,1,1
45733,एस्टोनीयाई,0,0,1,1
45734,göründüğünde,0,0,1,1
45736,غالبية,0,0,1,1
45737,يدور,0,0,1,1
45739,soon.,0,0,1,1
45723,راي,0,0,1,1
45721,«в,0,0,1,1
45780,dvds,0,0,1,1
45708,radikalt,0,0,1,1
45702,बदलने,0,0,1,1
45703,अन्तर्गत,0,0,1,1
50348,enkätundersökningen,0,0,1,1
45704,consultables,0,0,1,1
45706,yapmadığınız,0,0,1,1
45707,നാം,0,0,1,1
45710,contrer,0,0,1,1
50345,التبرعات,0,0,1,1
45712,ouvrages,0,0,1,1
45713,αδιάφορο.t,0,0,1,1
45714,nederlands-,0,0,1,1
45715,zij,0,0,1,1
45717,твоей,0,0,1,1
45719,gerou,0,0,1,1
50343,högervinkling,0,0,1,1
45740,यू॰एस॰,0,0,1,1
45741,data-generating,0,0,1,1
45770,substantivo,0,0,1,1
45764,techniek,0,0,1,1
45765,видов,0,0,1,1
45766,отполированный,0,0,1,1
45767,تضمن,0,0,1,1
45768,zögernd.,0,0,1,1
45769,egentliga,0,0,1,1
45771,മണമുള്ള,0,0,1,1
45742,அதற்கான,0,0,1,1
45772,энциклопедической,0,0,1,1
45773,ಮೂಗು,0,0,1,1
45774,ಸಾಧ್ಯವಾಗಲಿಲ್ಲ,0,0,1,1
45775,geluid,0,0,1,1
45776,பார்க்கும்போது,0,0,1,1
45779,wind,0,0,1,1
45763,forfærdelig.,0,0,1,1
45762,ஒபாமாவுக்கு,0,0,1,1
45759,couru,0,0,1,1
45758,சிறப்புக்கட்டுரைகளிடையே,0,0,1,1
45757,caja,0,0,1,1
45756,avanços,0,0,1,1
50337,sexta,0,0,1,1
45753,تباعدوا,0,0,1,1
45752,meldde,0,0,1,1
45751,والتنسيق,0,0,1,1
45749,περισσότερα,0,0,1,1
45748,yazılmaktadır.,0,0,1,1
45747,namiddag,0,0,1,1
45746,ஒழுங்குபடுத்தப்பட்டிருக்கும்.,0,0,1,1
45745,ಆಲಸ್ಯ,0,0,1,1
45744,fera,0,0,1,1
45743,« marques »,0,0,1,1
45874,votar,0,0,1,1
45879,ведь,0,0,1,1
45700,الماضي,0,0,1,1
46012,απόγευμα.,0,0,1,1
46004,تعيينك,0,0,1,1
46005,அருமையானவை,0,0,1,1
46006,gennembrud.,0,0,1,1
46007,الكريمة,0,0,1,1
46010,révision.,0,0,1,1
46011,fotnoter,0,0,1,1
50312,привилегированных,0,0,1,1
46002,draft,0,0,1,1
46013,تحولت,0,0,1,1
46014,wakker.,0,0,1,1
46017,आलू,0,0,1,1
46018,'wikipedia',0,0,1,1
46019,πει,0,0,1,1
50309,സ്വതന്ത്രനാണ്,0,0,1,1
46003,ನುಡಿಗಟ್ಟು.,0,0,1,1
46001,الملكية,0,0,1,1
45983,പ്രവർത്തകരെ,0,0,1,1
45992,நிரூபிக்காவிட்டால்,0,0,1,1
45986,நண்பர்களாக,0,0,1,1
45987,ಮಾರ್ಗದಲ್ಲಿ,0,0,1,1
45988,помните,0,0,1,1
45989,статуса»,0,0,1,1
45990,resorted,0,0,1,1
45991,يشتبه,0,0,1,1
45993,basicamente,0,0,1,1
46000,تقلق.,0,0,1,1
45994,project-wide,0,0,1,1
45995,tusind,0,0,1,1
45996,usuarios.,0,0,1,1
45997,കട്ടിലിൽ,0,0,1,1
45998,spørge.,0,0,1,1
45999,множественного,0,0,1,1
46024,soll.,0,0,1,1
46026,rivulet,0,0,1,1
46027,ಅವರಲ್ಲಿ,0,0,1,1
50305,downloading,0,0,1,1
46052,തുടരുകയാണെങ്കിൽ,0,0,1,1
46053,ಗೆಳೆಯ,0,0,1,1
46055,carbon-and-water-based,0,0,1,1
46056,protestar,0,0,1,1
46058,கண்காணிப்பு,0,0,1,1
46059,l'obtiendrez.,0,0,1,1
46062,دمج,0,0,1,1
50308,جماعيا،,0,0,1,1
50304,ಪರಿಸ್ಥಿತಿಯಲ್ಲಿರಬೇಕು,0,0,1,1
46064,mislukkingen,0,0,1,1
46065,digitala,0,0,1,1
46066,nutzen.,0,0,1,1
46068,العلوم،,0,0,1,1
46069,скрестив,0,0,1,1
50306,ричарда,0,0,1,1
46049,ഉള്ളത്.,0,0,1,1
46048,واجمع,0,0,1,1
46047,ενημερώστε,0,0,1,1
46046,مجانية.,0,0,1,1
46044,गिलाकी,0,0,1,1
46041,thermohaline,0,0,1,1
46040,diplômes.,0,0,1,1
46039,ചങ്ങാതിമാർ‌ക്ക്,0,0,1,1
46037,bouleversé.,0,0,1,1
46036,non-linearity,0,0,1,1
46035,repræsenteret,0,0,1,1
46034,sorarsa,0,0,1,1
46033,plateformes,0,0,1,1
50307,søgningen,0,0,1,1
46030,εργασία,0,0,1,1
46029,fundado,0,0,1,1
45984,возражаете,0,0,1,1
45981,البذور,0,0,1,1
45881,dataskyddsförordningen,0,0,1,1
50318,tuin,0,0,1,1
45910,تطبقه,0,0,1,1
45911,accorder,0,0,1,1
45913,especial.,0,0,1,1
45914,وجودنا,0,0,1,1
45918,gl •,0,0,1,1
45920,groseramente,0,0,1,1
45923,ഒരുപോലെ,0,0,1,1
45907,boyunca,0,0,1,1
50317,acessível,0,0,1,1
45926,fünf,0,0,1,1
45927,extensively.,0,0,1,1
45928,bijgewerkt,0,0,1,1
45930,heredó,0,0,1,1
45931,замечательно,0,0,1,1
45908,mdp,0,0,1,1
45906,maya,0,0,1,1
45979,danken,0,0,1,1
45893,சிகிச்சை,0,0,1,1
45882,tempérées,0,0,1,1
45884,déterminé.,0,0,1,1
45885,координации,0,0,1,1
45889,censuur,0,0,1,1
45890,açısından,0,0,1,1
45891,hastigt,0,0,1,1
45895,arborescente,0,0,1,1
45904,വാട്ട്സ്ആപ്പ്,0,0,1,1
45896,поставил,0,0,1,1
45898,beschrieb,0,0,1,1
45899,கட்டுரையொன்றில்,0,0,1,1
45900,последних,0,0,1,1
45901,बढ़ें,0,0,1,1
45902,devletleri'nde,0,0,1,1
45932,imediatamente,0,0,1,1
45933,моего,0,0,1,1
45935,gemas,0,0,1,1
50313,മന്ദഗതിയിലാണ്,0,0,1,1
45959,λυπάμαι.,0,0,1,1
45960,risques,0,0,1,1
45961,passing,0,0,1,1
45962,надо,0,0,1,1
45965,utges,0,0,1,1
45966,answers.,0,0,1,1
45968,سيئًا,0,0,1,1
45937,solicitan,0,0,1,1
45970,användarbefogenheter,0,0,1,1
45971,तीक्ष्ण,0,0,1,1
45972,apesar,0,0,1,1
45973,aide,0,0,1,1
45974,வழக்கத்தை,0,0,1,1
45975,κέντρο,0,0,1,1
45958,cujos,0,0,1,1
45957,المدينة.,0,0,1,1
45956,orsaken,0,0,1,1
45955,alto،,0,0,1,1
45954,கொடுக்கும்,0,0,1,1
45953,participam,0,0,1,1
45951,കുറവുള്ള,0,0,1,1
45949,संघ,0,0,1,1
45946,barrage,0,0,1,1
45944,färdade,0,0,1,1
45943,kunsttalen,0,0,1,1
45942,cherchez,0,0,1,1
45941,l'autoproduction,0,0,1,1
45940,begrip,0,0,1,1
50315,supervise,0,0,1,1
45938,n,0,0,1,1
50316,கேள்விகளில்,0,0,1,1
45701,ai/cs,0,0,1,1
45698,ട്ട്,0,0,1,1
46072,गूगल्स,0,0,1,1
45426,отключены,0,0,1,1
50379,தம்முள்,0,0,1,1
45419,haut.,0,0,1,1
45420,favorablemente,0,0,1,1
45421,abend.,0,0,1,1
45423,starte,0,0,1,1
45425,kolaylaştırmak,0,0,1,1
45428,obteve,0,0,1,1
45415,d’adaptation,0,0,1,1
45430,влияние,0,0,1,1
45431,издательством,0,0,1,1
45433,وهناك,0,0,1,1
45435,наблюдения»,0,0,1,1
45436,petrolífero,0,0,1,1
45437,நாளில்,0,0,1,1
45418,ഒഴിവാക്കുന്നു.,0,0,1,1
45414,sélection.,0,0,1,1
45400,d'alan,0,0,1,1
50381,продолжился,0,0,1,1
45401,gülümseyerek,0,0,1,1
50384,зеркале,0,0,1,1
45402,لتحرير,0,0,1,1
45403,«fuentes,0,0,1,1
50383,क्षति,0,0,1,1
45404,rends,0,0,1,1
45405,vendus,0,0,1,1
45412,حاليًا,0,0,1,1
45406,помоги,0,0,1,1
45407,skapande,0,0,1,1
45408,φαγητά.,0,0,1,1
45409,resultaten,0,0,1,1
45410,panorama,0,0,1,1
45411,جديد.,0,0,1,1
45438,öbekleri,0,0,1,1
45439,اشتروه,0,0,1,1
45440,സാദ്ധ്യതയുണ്ട്.,0,0,1,1
45477,ediyorsun,0,0,1,1
45469,നന്നാക്കുന്നതിലൂടെ.,0,0,1,1
45470,umursamıyordu,0,0,1,1
45471,surveiller,0,0,1,1
45472,outlaw,0,0,1,1
45475,concepteurs,0,0,1,1
45476,അവലംബമായി,0,0,1,1
45478,anímate,0,0,1,1
45442,μεγάλη,0,0,1,1
45479,laboratories.,0,0,1,1
45481,சொற்றொடராக,0,0,1,1
45482,ευρύ,0,0,1,1
45484,запутаться,0,0,1,1
45485,पीडिया,0,0,1,1
45486,ഇവരും,0,0,1,1
45467,ഘടകങ്ങളാണ്,0,0,1,1
45466,even.,0,0,1,1
45465,contestarte,0,0,1,1
45464,crowdsourcing ...,0,0,1,1
45461,ambiente,0,0,1,1
45460,வங்கிக்,0,0,1,1
45458,думать,0,0,1,1
45457,befinden.,0,0,1,1
45455,comentar,0,0,1,1
45454,ஹலோ,0,0,1,1
45452,lorsqu'une,0,0,1,1
45451,ಪ್ರಯಾಣಿಸುತ್ತಿದ್ದಾಗ,0,0,1,1
45449,concourent,0,0,1,1
45448,غيرت,0,0,1,1
50376,организацией,0,0,1,1
45446,şeye,0,0,1,1
45444,прыгну,0,0,1,1
50385,πέσεις,0,0,1,1
45399,'fake,0,0,1,1
45489,especiais,0,0,1,1
45343,begynde.,0,0,1,1
45333,വിക്കിപീഡിയരായി,0,0,1,1
45334,annesinin,0,0,1,1
50396,abonneren,0,0,1,1
45337,lebensmitteln,0,0,1,1
45338,situatie.,0,0,1,1
50395,förutsättningarna,0,0,1,1
45344,beskrivit,0,0,1,1
45327,gungar,0,0,1,1
45345,विकिकोट,0,0,1,1
45346,ankam.,0,0,1,1
45347,youtube'da,0,0,1,1
45348,lägger,0,0,1,1
45349,തരുന്നതതാണ്.,0,0,1,1
45352,प्रतिक्रिया,0,0,1,1
45328,recourent,0,0,1,1
45326,ചെയ്യുകയും,0,0,1,1
45397,överraskar,0,0,1,1
45311,samenwerking.,0,0,1,1
45302,storbritanniens,0,0,1,1
45304,दूंगा,0,0,1,1
45305,இருந்தபோதிலும்,0,0,1,1
45308,നേടിയെടുക്കാവുന്നതേയുള്ളൂ.,0,0,1,1
45309,optimize,0,0,1,1
45310,рунете ,0,0,1,1
45312,quedó,0,0,1,1
45324,controversas.,0,0,1,1
45313,traveled,0,0,1,1
45316,സങ്കേതത്തിൽ,0,0,1,1
45317,ties,0,0,1,1
45319,vir,0,0,1,1
45321,dépendant,0,0,1,1
45322,tallerken,0,0,1,1
45353,daarvan.,0,0,1,1
50394,bugle,0,0,1,1
45354,адресу,0,0,1,1
45385,ചിന്തിക്കട്ടെ.,0,0,1,1
50391,başarısız,0,0,1,1
45377,rattachée,0,0,1,1
45378,kullanıma,0,0,1,1
45380,внести,0,0,1,1
50390,transform.,0,0,1,1
45383,painting,0,0,1,1
45387,lembram-se,0,0,1,1
45355,الرغبة.,0,0,1,1
45388,hatte.,0,0,1,1
45389,magisch,0,0,1,1
45390,intimidad,0,0,1,1
45391,ಮೇಲಿನಿಂದ,0,0,1,1
50389,അവിശ്വസനീയമാംവിധം,0,0,1,1
50387,улыбаясь,0,0,1,1
50392,programın,0,0,1,1
45376,süslenmişti,0,0,1,1
45375,εξέπληξε,0,0,1,1
50393,frihet,0,0,1,1
45372,خاصية,0,0,1,1
45370,fría.,0,0,1,1
45368,beundrande,0,0,1,1
45367,للمقالة،,0,0,1,1
45366,прослушайте,0,0,1,1
45365,चैचन,0,0,1,1
45364,priorité,0,0,1,1
45363,टैग,0,0,1,1
45362,сми.,0,0,1,1
45361,علي,0,0,1,1
45360,μη-εγκυκλοπαιδικούς,0,0,1,1
45359,inversement,0,0,1,1
45358,hvordan.,0,0,1,1
45487,அணிந்திருந்தார்,0,0,1,1
45490,eet.,0,0,1,1
45697,priority.,0,0,1,1
45640,चले,0,0,1,1
45634,ومفيدة,0,0,1,1
45636,escravos,0,0,1,1
50357,разделе.,0,0,1,1
45637,αλάτι,0,0,1,1
45638,догадаются,0,0,1,1
45639,atendidos,0,0,1,1
45641,ರೂಪಿಸುತ್ತಿದ್ದೇನೆ.,0,0,1,1
45630,n'achèterais,0,0,1,1
50356,notoriété,0,0,1,1
45643,estáveis,0,0,1,1
45645,equivocado.,0,0,1,1
45646,χρόνια,0,0,1,1
45647,karışırsa,0,0,1,1
50355,vorschlag.,0,0,1,1
45632,sixième,0,0,1,1
45629,होस्टिंग,0,0,1,1
45604,സമ്പൂർണ്ണമാക്കുന്നതിനും,0,0,1,1
45615,διαδίκτυο,0,0,1,1
45606,'rápido',0,0,1,1
45607,hazreti,0,0,1,1
45611,പോകണമെന്ന്,0,0,1,1
45613,passionnés,0,0,1,1
45614,determining,0,0,1,1
50361,ωραία.,0,0,1,1
50360,أخبرت,0,0,1,1
45628,codificada,0,0,1,1
45617,உருவாக்கினார்.,0,0,1,1
45618,ಶ್ರಮವಹಿಸಬೇಕೆಂದು,0,0,1,1
45619,करना।,0,0,1,1
45620,calcified,0,0,1,1
45622,aconteceu,0,0,1,1
45626,algorithmically,0,0,1,1
45651,प्रोजेक्टों,0,0,1,1
45652,godzijdank,0,0,1,1
45654,تدوين,0,0,1,1
45687,instantaneamente.,0,0,1,1
45681,presenteert,0,0,1,1
45682,பிடித்த,0,0,1,1
45683,entero.,0,0,1,1
45684,contundente,0,0,1,1
50350,أشهر,0,0,1,1
45686,automáticos»,0,0,1,1
45688,d'internautes,0,0,1,1
45657,தரப்பில்,0,0,1,1
45690,ранних,0,0,1,1
45692,uttalar.,0,0,1,1
45693,ينوي,0,0,1,1
45694,paradoxes,0,0,1,1
45695,målgruppe,0,0,1,1
50349,databasserver,0,0,1,1
45679,अवरुद्ध,0,0,1,1
45678,إضافيًا.,0,0,1,1
45677,والنص,0,0,1,1
45676,सुव्यवस्थित,0,0,1,1
45674,adéquation,0,0,1,1
45673,gizlice,0,0,1,1
50352,tercih,0,0,1,1
45671,behandlade,0,0,1,1
45669,инструмент,0,0,1,1
45668,βασικοί,0,0,1,1
50353,ಯಾವುದೇ,0,0,1,1
45664,elske,0,0,1,1
45663,costume.,0,0,1,1
50354,ഒന്നുമല്ല.,0,0,1,1
45662,பறவையைப்,0,0,1,1
45661,afbalancerede,0,0,1,1
45659,utiliza,0,0,1,1
45605,மூளைச்சலவை,0,0,1,1
45602,telespectadores,0,0,1,1
45496,defendida,0,0,1,1
45536,എങ്ങനെയെങ്കിലും,0,0,1,1
45526,أستراليون,0,0,1,1
45527,σχόλιο.,0,0,1,1
45528,ವಾಕ್ಯದಲ್ಲಿ,0,0,1,1
45529,മരിയനെ,0,0,1,1
45533,विकीवर्सिटी,0,0,1,1
45534,skede,0,0,1,1
45537,நம்பமுடியாத,0,0,1,1
45524,kritisk,0,0,1,1
45538,.[bron],0,0,1,1
45543,अधिकतर,0,0,1,1
45544,identificados,0,0,1,1
45545,konusunda,0,0,1,1
45546,nagedacht.,0,0,1,1
45547,« meilleures,0,0,1,1
45525,tændt,0,0,1,1
45523,எடுத்து,0,0,1,1
45601,достичь,0,0,1,1
45510,acusan,0,0,1,1
45498,blinkede,0,0,1,1
45503,ydmyg,0,0,1,1
45505,nyheterna,0,0,1,1
50371,eventueel,0,0,1,1
45507,desempenho,0,0,1,1
45508,ракушка,0,0,1,1
45511,schlimmes,0,0,1,1
45518,bataklıkta,0,0,1,1
45512,दबाया,0,0,1,1
45513,மணி.,0,0,1,1
45514,co,0,0,1,1
45515,afrika,0,0,1,1
45516,பயன்படுத்தக்கூடாது.,0,0,1,1
45517,construct,0,0,1,1
45550,fixes,0,0,1,1
45553,«páginas,0,0,1,1
45555,månader,0,0,1,1
45588,imposé,0,0,1,1
45578,modsatte,0,0,1,1
45581,ψάχνουμε,0,0,1,1
45582,natureza.,0,0,1,1
50363,следствием,0,0,1,1
45584,tendency,0,0,1,1
45585,aurez,0,0,1,1
45589,andet.,0,0,1,1
45556,catalisador,0,0,1,1
45590,സ്വർണ്ണത്തിൽ,0,0,1,1
45591,blijkt,0,0,1,1
45594,дорогое,0,0,1,1
45595,wikiespecies,0,0,1,1
45598,uppmärksammades,0,0,1,1
45599,überfluten,0,0,1,1
45576,juegos,0,0,1,1
50364,ಆಗಲು,0,0,1,1
45575,blockera,0,0,1,1
45574,superfluo,0,0,1,1
45572,winkelcentrum,0,0,1,1
45571,weliswaar,0,0,1,1
45570,beğeneceğinizi,0,0,1,1
45569,saniye,0,0,1,1
45568,грязь,0,0,1,1
45567,efforts.,0,0,1,1
45566,« guerres,0,0,1,1
50366,kategoriserades,0,0,1,1
45564,bijdragen.,0,0,1,1
45561,avvisade,0,0,1,1
45559,quiere.,0,0,1,1
45558,squares.,0,0,1,1
45557,ofta.,0,0,1,1
46071,അഥവാ,0,0,1,1
50303,prérogatives,0,0,1,1
50398,распространению,0,0,1,1
46576,തീരുമാനങ്ങളിലെത്താൻ,0,0,1,1
46569,специалистам,0,0,1,1
46570,áfrica,0,0,1,1
46571,yemeye,0,0,1,1
46572,anima,0,0,1,1
46573,entertainment.,0,0,1,1
46575,നിങ്ങൾക്കറിയില്ല,0,0,1,1
46578,opmuntre.,0,0,1,1
46566,foule,0,0,1,1
46579,terem,0,0,1,1
46580,vecteur,0,0,1,1
50242,exclusively,0,0,1,1
46584,للتدرب,0,0,1,1
46587,bias–variance,0,0,1,1
46588,escrevem,0,0,1,1
46568,kerel,0,0,1,1
50243,ചേർക്കണം,0,0,1,1
46544,significatif,0,0,1,1
46555,വിശേഷം,0,0,1,1
46546,appeler,0,0,1,1
50246,крокером.,0,0,1,1
50245,wonders,0,0,1,1
46551,l'explication,0,0,1,1
46552,autorrevisores,0,0,1,1
46553,miembro».,0,0,1,1
46556,காண்பீர்கள்.,0,0,1,1
46564,ஒரே,0,0,1,1
46557,existence.,0,0,1,1
46559,«энциклопедия».,0,0,1,1
46560,oportunista,0,0,1,1
50244,fået,0,0,1,1
46561,longtemps.,0,0,1,1
46562,multilingües,0,0,1,1
46589,التراكم,0,0,1,1
46591,εκπλήσσει,0,0,1,1
46592,schönen,0,0,1,1
46623,oförskämt,0,0,1,1
46615,ಬಂತು.,0,0,1,1
50233,അവസ്ഥകളെ,0,0,1,1
46616,leg,0,0,1,1
46617,ನೋಡುತ್ತಿರುವಿರಿ.,0,0,1,1
46618,capturing,0,0,1,1
46620,dictate,0,0,1,1
46626,വച്ചിരുന്നു.,0,0,1,1
46594,ஆரம்பிக்கலாம்.,0,0,1,1
46627,intéressé,0,0,1,1
46629,linked,0,0,1,1
46630,கண்ணியமான,0,0,1,1
50231,отрицательной,0,0,1,1
46634,upprepning.,0,0,1,1
46635,d'impact,0,0,1,1
46614,smukkeste,0,0,1,1
46613,utestängas,0,0,1,1
46612,estonien,0,0,1,1
50234,annuelle,0,0,1,1
46610,восприимчивость,0,0,1,1
50235,страницам,0,0,1,1
46608,referenssystem,0,0,1,1
46607,drin,0,0,1,1
46606,م.,0,0,1,1
46604,விக்கிமீடியா,0,0,1,1
46603,ficticio,0,0,1,1
50238,austriaca,0,0,1,1
46601,arrangement,0,0,1,1
46600,влиятельных,0,0,1,1
46599,panel,0,0,1,1
46596,tafel,0,0,1,1
46595,estaría,0,0,1,1
46545,irgendeine,0,0,1,1
46543,dolaylı,0,0,1,1
46639,distinct,0,0,1,1
46488,விதிகளை,0,0,1,1
50253,comenta,0,0,1,1
50252,секрет,0,0,1,1
46482,गेब्रियल,0,0,1,1
50251,moatti,0,0,1,1
46485,coupled,0,0,1,1
46487,ζαμάνια.,0,0,1,1
46489,வரைவிலக்கணம்,0,0,1,1
46479,sun's,0,0,1,1
46490,lourde,0,0,1,1
46492,vista.,0,0,1,1
46493,مقالًا,0,0,1,1
46494,buydu.,0,0,1,1
50250,السؤال.,0,0,1,1
46495,implementeringen,0,0,1,1
46480,entendre,0,0,1,1
46478,التصدي,0,0,1,1
46542,വിക്കിസമൂഹത്തിന്റെ,0,0,1,1
46465,sensory,0,0,1,1
46457,cloning,0,0,1,1
46458,wachtwoord,0,0,1,1
46459,d'héberger,0,0,1,1
46461,definitive,0,0,1,1
46462,pedestrian,0,0,1,1
46463,крайне,0,0,1,1
46466,avsedda,0,0,1,1
46476,vs.,0,0,1,1
46467,такова,0,0,1,1
46469,persönlich,0,0,1,1
46472,கடுமையான,0,0,1,1
46473,सबसेट,0,0,1,1
46474,حلت,0,0,1,1
46475,computer's,0,0,1,1
46496,rendered,0,0,1,1
46497,paradigmático,0,0,1,1
46499,huang.,0,0,1,1
46532,opportunistic,0,0,1,1
46525,relacione,0,0,1,1
46526,udgaver,0,0,1,1
46527,tevens,0,0,1,1
46528,λίγο.,0,0,1,1
46529,patrones,0,0,1,1
46531,എടുത്തു.,0,0,1,1
46533,καλύτερη,0,0,1,1
46500,technè,0,0,1,1
46535,getirebilir,0,0,1,1
46537,விஷயங்களை,0,0,1,1
46538,controversy,0,0,1,1
46539,ilegível.,0,0,1,1
46540,notoriedade,0,0,1,1
46541,википедией.,0,0,1,1
46524,d'indiquer,0,0,1,1
46522,partialité,0,0,1,1
46520,കൃത്യമായി,0,0,1,1
50247,علق,0,0,1,1
46519,genoptager,0,0,1,1
46518,माओरी,0,0,1,1
46517,families,0,0,1,1
46515,välkommen.,0,0,1,1
46514,pedirle,0,0,1,1
46513,ಭಾವಿಸಬಹುದು,0,0,1,1
46511,ബീഹാറി,0,0,1,1
46510,explaining,0,0,1,1
46508,நான்',0,0,1,1
46505,வகுப்பில்,0,0,1,1
46504,servisleri,0,0,1,1
46502,pdf.,0,0,1,1
46501,the.,0,0,1,1
46636,weg.,0,0,1,1
46640,ägna,0,0,1,1
46455,generalizados,0,0,1,1
46769,geliştirin.,0,0,1,1
46759,பைத்தியம்,0,0,1,1
46760,ವಿನಮ್ರ,0,0,1,1
46761,voetnoten,0,0,1,1
46762,просмотра[комм.,0,0,1,1
46765,skolarbete.,0,0,1,1
46768,administrateur,0,0,1,1
46770,gisteren,0,0,1,1
46757,विरले,0,0,1,1
46772,contrasted,0,0,1,1
46773,अंतर्गत,0,0,1,1
46774,randevusu.,0,0,1,1
46775,رائعا،,0,0,1,1
46776,ಅವುಗಳನ್ನು,0,0,1,1
46777,qualifie,0,0,1,1
50210,സൃഷ്ടിക്കപ്പെട്ടിരിക്കുന്ന,0,0,1,1
46756,സേവന,0,0,1,1
46736,поддающимися,0,0,1,1
46746,übertreiben.,0,0,1,1
46739,കവിഞ്ഞു.,0,0,1,1
46740,मेमोरियम,0,0,1,1
46741,sucinta,0,0,1,1
46743,confiaron,0,0,1,1
46744,utförs,0,0,1,1
46745,شديد,0,0,1,1
46747,guarda-redes,0,0,1,1
46755,ചതുപ്പുനിലത്തിന്,0,0,1,1
46748,அவற்றில்,0,0,1,1
46749,basado,0,0,1,1
46750,кандидата.,0,0,1,1
46751,«получение,0,0,1,1
46753,ഉദാഹരണ,0,0,1,1
46754,ಅಭಿಪ್ರಾಯಗಳು.,0,0,1,1
46779,city,0,0,1,1
46781,നിഷ്പക്ഷതഉറപ്പാക്കുന്നു.,0,0,1,1
46783,مكرسة,0,0,1,1
46826,biliyorsunuz,0,0,1,1
46816,veamos,0,0,1,1
46817,हमलों,0,0,1,1
46818,عادة,0,0,1,1
46819,parties,0,0,1,1
46822,благодарю,0,0,1,1
46824,المجتمع,0,0,1,1
50204,முந்தையவை.,0,0,1,1
46784,بلغته,0,0,1,1
50203,ಪಠ್ಯ,0,0,1,1
46832,φάσμα,0,0,1,1
50202,காத்திருப்பு,0,0,1,1
50201,üzgünsün,0,0,1,1
46835,bedeutung,0,0,1,1
46836,behandles.,0,0,1,1
46815,постановка,0,0,1,1
46814,इमारतों,0,0,1,1
46810,عمومًا,0,0,1,1
46808,vurgulamanın,0,0,1,1
46807,دعا,0,0,1,1
46805,bekijkt,0,0,1,1
46803,lett,0,0,1,1
46802,hartstikke,0,0,1,1
50207,handlade,0,0,1,1
46796,πάρουν,0,0,1,1
46794,हाउ,0,0,1,1
46793,பத்து,0,0,1,1
50208,kalmasını,0,0,1,1
46791,eyaleti'ndeki,0,0,1,1
46788,அப்பட்டமான,0,0,1,1
46787,proíbe,0,0,1,1
46786,читателя,0,0,1,1
46737,செய்கிறேன்,0,0,1,1
46732,അത്യാധുനികമാണ്.,0,0,1,1
46641,visitou,0,0,1,1
46671,décernés,0,0,1,1
46665,studentens,0,0,1,1
46666,யார்.,0,0,1,1
46667,voûte,0,0,1,1
46668,запретить,0,0,1,1
46669,ved.,0,0,1,1
46670,var.,0,0,1,1
46672,comment',0,0,1,1
46662,rentré,0,0,1,1
46673,deeper,0,0,1,1
46674,सत्ता,0,0,1,1
46676,ஆகியவையும்,0,0,1,1
46678,voyages,0,0,1,1
50226,subtropical,0,0,1,1
50225,ويصفون,0,0,1,1
46663,grundskoleexamen.,0,0,1,1
46661,utilisation,0,0,1,1
46731,حين,0,0,1,1
46650,búlgaro,0,0,1,1
46643,l'eau,0,0,1,1
46644,corretos,0,0,1,1
46646,ആവശ്യമാണ്],0,0,1,1
46647,onjuist,0,0,1,1
46648,வழிகளை,0,0,1,1
46649,ആശയമാണെന്ന്,0,0,1,1
50229,amador.,0,0,1,1
50227,nuclei,0,0,1,1
46652,tausend,0,0,1,1
50228,മോശമാണ്,0,0,1,1
46655,tenido,0,0,1,1
46656,εξετάσεις.,0,0,1,1
46659,kaybettim,0,0,1,1
46660,soutenue,0,0,1,1
46683,görande,0,0,1,1
46684,erstaunlichste,0,0,1,1
46686,தீர்வில்,0,0,1,1
46717,grootser,0,0,1,1
46710,крупнейшей,0,0,1,1
50216,φάει,0,0,1,1
50215,ouais,0,0,1,1
46712,الإحصائية,0,0,1,1
50214,labelliser,0,0,1,1
46715,açıldı.,0,0,1,1
50213,aumenten,0,0,1,1
46688,ഒന്നിൽ,0,0,1,1
46719,ağır,0,0,1,1
46720,படுக்கையில்,0,0,1,1
46721,bilgilerden,0,0,1,1
46724,തോന്നുന്ന,0,0,1,1
46726,voraus.,0,0,1,1
46727,¿quién,0,0,1,1
46709,coexistia,0,0,1,1
46707,വിവരിക്കുന്നതിനാലാണ്,0,0,1,1
46706,wending,0,0,1,1
50217,l'intelligence »,0,0,1,1
46702,ഫൗണ്ടേഷൻ,0,0,1,1
46701,hypothesized,0,0,1,1
46700,franse,0,0,1,1
50218,interdisciplinar,0,0,1,1
46696,مستقرًا,0,0,1,1
50220,मज़ाक,0,0,1,1
46695,¿de,0,0,1,1
50222,பிடிக்கவில்லையா,0,0,1,1
50223,læse,0,0,1,1
46694,interessado.,0,0,1,1
46693,wikiwoordenboek,0,0,1,1
46690,borttaget.,0,0,1,1
46689,ಬಂದಿದೆಯೆಂದರೆ,0,0,1,1
46456,enhancements,0,0,1,1
46454,ortasındasın,0,0,1,1
46073,demand,0,0,1,1
46208,dyr,0,0,1,1
46201,qu’une,0,0,1,1
46202,figuras,0,0,1,1
50286,lourd,0,0,1,1
46204,plotseling,0,0,1,1
46206,assumer,0,0,1,1
46207,пометка,0,0,1,1
46209,importantes.,0,0,1,1
46199,ayúdame,0,0,1,1
46212,различают,0,0,1,1
46213,لتحديد,0,0,1,1
46214,científicas.,0,0,1,1
46216,deem,0,0,1,1
46217,ದಾಟಿದೆ.,0,0,1,1
46218,entonação.,0,0,1,1
46200,ماء؟,0,0,1,1
46197,وسعد,0,0,1,1
46180,kullanırlar,0,0,1,1
50289,hazırlanırken,0,0,1,1
46182,تكنولوجي,0,0,1,1
46183,زائر,0,0,1,1
46184,perguntou-lhe,0,0,1,1
46185,താഴേക്കും,0,0,1,1
46187,ഖേദിക്കുന്നു,0,0,1,1
46188,сидишь,0,0,1,1
46190,അവബോധത്തോടെ,0,0,1,1
46196,slumpmässigt,0,0,1,1
46191,ಹಳೆಯ,0,0,1,1
46192,zenginlik,0,0,1,1
46193,أقرأ,0,0,1,1
46194,പ്രശ്നങ്ങളെ,0,0,1,1
46195,сериала,0,0,1,1
50287,eliot,0,0,1,1
46220,colabora,0,0,1,1
46222,βάλετε,0,0,1,1
46223,ആളുകൾക്ക്,0,0,1,1
50280,νύχτα,0,0,1,1
46250,சொன்னேன்.,0,0,1,1
46253,അതിനായി,0,0,1,1
46254,അഡ്മിന്മാർ,0,0,1,1
46255,blanking,0,0,1,1
46256,såvitt,0,0,1,1
46257,colocó,0,0,1,1
46260,chapter,0,0,1,1
46224,रुके,0,0,1,1
46261,intragável,0,0,1,1
46262,مذهلة,0,0,1,1
46263,വായനക്കാർക്കോ,0,0,1,1
46264,وشك,0,0,1,1
46268,initiée[c],0,0,1,1
46269,дня],0,0,1,1
46249,ಕೇಳುತ್ತಿದ್ದಾರೆ.,0,0,1,1
46247,பொருளாதாரம்,0,0,1,1
46246,palm,0,0,1,1
46245,sonuca,0,0,1,1
46243,sinais,0,0,1,1
46242,covering,0,0,1,1
46237,neredeydik,0,0,1,1
46234,bråkdel,0,0,1,1
46233,factorization,0,0,1,1
46232,statisticians,0,0,1,1
46231,versionen.,0,0,1,1
46229,зависит,0,0,1,1
50283,califórnia.,0,0,1,1
46228,generar,0,0,1,1
46227,கைதிகள்,0,0,1,1
46226,någonstans.,0,0,1,1
46225,gemiddelde,0,0,1,1
46181,കൊടുക്കുന്നു.,0,0,1,1
46179,مهما,0,0,1,1
46272,allèrent,0,0,1,1
46103,moulinwiki,0,0,1,1
46097,التراكمية,0,0,1,1
46098,следы,0,0,1,1
46099,media-services,0,0,1,1
46100,интересное,0,0,1,1
46101,результата,0,0,1,1
46102,ಹೇಳು,0,0,1,1
46104,ഇവർക്ക്,0,0,1,1
46095,hospedada,0,0,1,1
46108,cento,0,0,1,1
50298,människor.,0,0,1,1
46109,editoras,0,0,1,1
46110,gens.,0,0,1,1
46111,açıklama,0,0,1,1
46112,distribution.,0,0,1,1
46096,تمتد,0,0,1,1
50300,binnenkort,0,0,1,1
46176,சார்பற்றது,0,0,1,1
46084,அறிவியல்,0,0,1,1
46075,necesitamos,0,0,1,1
46076,wachten,0,0,1,1
46077,croisés,0,0,1,1
46080,പോലെയുള്ള,0,0,1,1
46082,отношениях,0,0,1,1
46083,kunstmatige,0,0,1,1
46087,coin,0,0,1,1
46094,premiada,0,0,1,1
46088,يسمح,0,0,1,1
46089,generalize,0,0,1,1
46090,البحث,0,0,1,1
50301,تخريب,0,0,1,1
46092,категориям,0,0,1,1
46093,sustainability,0,0,1,1
46114,-м,0,0,1,1
46115,λένε,0,0,1,1
46122,വിജ്ഞാനതൃഷ്ണയുമുള്ള,0,0,1,1
46168,helaas,0,0,1,1
46158,пополните,0,0,1,1
50294,дамами,0,0,1,1
50293,маме,0,0,1,1
46164,смотрите.,0,0,1,1
46165,നിരസിച്ചു,0,0,1,1
46167,address.,0,0,1,1
46169,ரிச்சர்ட்,0,0,1,1
46123,точка,0,0,1,1
50292,കോളർ‌,0,0,1,1
50291,vanligen,0,0,1,1
46172,неприятную,0,0,1,1
46173,estabeleceu,0,0,1,1
46174,respetar,0,0,1,1
46175,ಹೊಂದಿದ್ದಾನೆ.,0,0,1,1
46156,تعني.,0,0,1,1
50295,planlægger,0,0,1,1
46151,γάμο,0,0,1,1
46150,beatles,0,0,1,1
46148,μυρωδιά,0,0,1,1
46147,emplaced,0,0,1,1
46144,baseados,0,0,1,1
46143,tøjvask.,0,0,1,1
46142,assustados,0,0,1,1
46140,sürdürmeye,0,0,1,1
46134,उदमुर्त,0,0,1,1
46133,நர்சிஸாவைப்,0,0,1,1
46132,असहमति,0,0,1,1
46131,loudest,0,0,1,1
46129,ചരിത്രത്തെപ്പറ്റിയും,0,0,1,1
46127,eleştirilerine,0,0,1,1
46125,yakalama-,0,0,1,1
46271,consideradas,0,0,1,1
46275,sizable,0,0,1,1
46449,लाइक,0,0,1,1
46395,inappropriées,0,0,1,1
46388,variétés,0,0,1,1
46389,திட்டமாகச்,0,0,1,1
46391,бедный,0,0,1,1
50262,life-forms,0,0,1,1
46393,instantly,0,0,1,1
46394,भेजते,0,0,1,1
46396,പങ്ക്,0,0,1,1
46384,матч,0,0,1,1
46397,தலையில்,0,0,1,1
46398,விரும்ப,0,0,1,1
46399,hänt,0,0,1,1
46400,കൊടുക്കാൻ,0,0,1,1
46401,تواجه,0,0,1,1
46402,உள்ளடக்கப்பட்ட,0,0,1,1
46387,تسأل,0,0,1,1
46383,trabajó,0,0,1,1
50265,söta,0,0,1,1
46374,ವಾಸ್ತವವಾಗಿ,0,0,1,1
50264,ñiquipedia,0,0,1,1
46367,parabéns,0,0,1,1
46368,قفل,0,0,1,1
46369,مقالاً,0,0,1,1
46371,زائر.,0,0,1,1
46373,edward,0,0,1,1
46375,ಕಳುಹಿಸಲು,0,0,1,1
46381,frem.,0,0,1,1
46376,പ്രസിദ്ധീകരണാനുമതി,0,0,1,1
46377,eleitoral,0,0,1,1
46378,rettigheder,0,0,1,1
46379,आता,0,0,1,1
50263,refletem,0,0,1,1
46380,ಹೆಂಗಸರ,0,0,1,1
46403,التطبيق,0,0,1,1
46405,fångar,0,0,1,1
50261,реляционную,0,0,1,1
46440,vrijers,0,0,1,1
46432,acenaram,0,0,1,1
46435,μαθηματικά,0,0,1,1
46436,مبدأ,0,0,1,1
50259,вопроса.,0,0,1,1
46437,kırıldı,0,0,1,1
46439,progresiva,0,0,1,1
46441,несчастный.,0,0,1,1
46408,fundaram,0,0,1,1
46442,പ്രവചിക്കുകയാകാം,0,0,1,1
46444,செல்கிறோம்,0,0,1,1
50257,итальянский,0,0,1,1
46445,बिकोल,0,0,1,1
50256,iyiler,0,0,1,1
46446,et •,0,0,1,1
46431,l'obsession,0,0,1,1
46429,l'actionnaire,0,0,1,1
46428,ജീവിതവും,0,0,1,1
46427,thorough,0,0,1,1
46425,പാഴ്‌മെയിലുകളെയും,0,0,1,1
46423,galten.,0,0,1,1
46420,kir,0,0,1,1
46419,ilgisizlik,0,0,1,1
46418,d’administration,0,0,1,1
46417,ചോദിക്കുക.,0,0,1,1
46416,ಅವನಾಗಬಹುದು,0,0,1,1
46415,baisser,0,0,1,1
46414,verifieras,0,0,1,1
46413,yapabilirsin.,0,0,1,1
46412,நம்ப,0,0,1,1
46410,geomorphology,0,0,1,1
46409,أثبتت,0,0,1,1
46363,redunda,0,0,1,1
46359,сну,0,0,1,1
46276,l'enseignement.,0,0,1,1
46304,mini,0,0,1,1
46295,ಹೋಗಬಹುದು,0,0,1,1
46296,dildeki,0,0,1,1
46297,вопросы.,0,0,1,1
46299,işlere,0,0,1,1
46301,supercontinent,0,0,1,1
46302,விவரிக்கும்,0,0,1,1
46306,основателя,0,0,1,1
46293,antologin,0,0,1,1
46307,يشبهونني,0,0,1,1
46309,نكتة,0,0,1,1
46310,русск.»,0,0,1,1
46311,فروع,0,0,1,1
50275,ಓಬ್ಟೂಸ್,0,0,1,1
46314,αστεροειδής,0,0,1,1
46294,amsterdam.,0,0,1,1
46292,fbi,0,0,1,1
46358,vriendelijke,0,0,1,1
46285,അഭിപ്രായങ്ങൾ.,0,0,1,1
46277,தோற்றமளிக்கிறீர்கள்,0,0,1,1
46279,ஏற்படுத்துவதைத்,0,0,1,1
46280,lucene.,0,0,1,1
46281,tıklanan,0,0,1,1
46283,doubling-time,0,0,1,1
46284,demek,0,0,1,1
46286,opcional.,0,0,1,1
46291,സംവിധാനം,0,0,1,1
46287,наличием,0,0,1,1
46288,السادس,0,0,1,1
46289,ശ്രമങ്ങൾ‍,0,0,1,1
50279,لوفلاند,0,0,1,1
50278,ressembles,0,0,1,1
46290,gevangenissen,0,0,1,1
46315,applicables,0,0,1,1
46316,d'analyse,0,0,1,1
46317,ತಿಳಿದಿದ್ದರೆ,0,0,1,1
50269,icke-administratörer,0,0,1,1
46342,копиями,0,0,1,1
46343,mahoma,0,0,1,1
46344,pensantes,0,0,1,1
46345,contentious,0,0,1,1
46346,ഞങ്ങൾക്ക്,0,0,1,1
46347,يوميًا,0,0,1,1
50268,yolunu,0,0,1,1
46318,എഴുത്തുകാരുടേയും,0,0,1,1
46351,naturels.,0,0,1,1
46352,supposons,0,0,1,1
50266,mått,0,0,1,1
46355,vê-lo,0,0,1,1
46356,காப்புரிமைத்,0,0,1,1
46357,aprecio.,0,0,1,1
46340,angstaanjagenders,0,0,1,1
46337,இவற்றின்,0,0,1,1
46336,inconsistências,0,0,1,1
46335,வங்கிக்கு,0,0,1,1
46333,inductively,0,0,1,1
50272,ഉള്ളത്,0,0,1,1
46331,organizationthough,0,0,1,1
46329,δέξου,0,0,1,1
50274,pieds,0,0,1,1
46328,വ്യാമോഹിതനാണ്,0,0,1,1
46327,arbcom,0,0,1,1
46325,harina,0,0,1,1
46324,l’action,0,0,1,1
46322,элли,0,0,1,1
46321,areasautomatic,0,0,1,1
46320,وراء,0,0,1,1
46319,scorpions.,0,0,1,1
45301,فكرة.,0,0,1,1
45297,മേഖലയെ,0,0,1,1
43796,enganado.,0,0,1,1
44287,gelmesidir.,0,0,1,1
44278,show's,0,0,1,1
44279,gevaar,0,0,1,1
44281,econômicas,0,0,1,1
44282,protegida,0,0,1,1
44283,blijft,0,0,1,1
44286,ووصلت,0,0,1,1
44288,influir,0,0,1,1
50536,expend,0,0,1,1
44289,والمناقشات,0,0,1,1
50533,yakalayıp,0,0,1,1
44291,tijdschriften,0,0,1,1
44292,choice,0,0,1,1
44294,ينبغي,0,0,1,1
44296,cartésienne,0,0,1,1
44277,arrivent,0,0,1,1
44274,ergs,0,0,1,1
44253,ഉപജ്ഞാതാവ്.,0,0,1,1
44263,ಕಂಡಿದ್ದೀರಿ,0,0,1,1
50540,референдум,0,0,1,1
44257,commons[o].,0,0,1,1
50538,வலியுறுத்துவதைப்,0,0,1,1
44259,அருகில்,0,0,1,1
44260,tvätt,0,0,1,1
44262,испугался,0,0,1,1
44264,påbegyndt,0,0,1,1
50537,ബന്ധപ്പെടുത്തിയ,0,0,1,1
44265,wikiality​,0,0,1,1
44266,колеблясь.,0,0,1,1
44267,ವ್ಯಾಕರಣ,0,0,1,1
44269,désinformation,0,0,1,1
44270,provenían.,0,0,1,1
44272,विकिपीडियाने,0,0,1,1
44299,الأفلام,0,0,1,1
44300,വിറ്റു.,0,0,1,1
44302,títulos.,0,0,1,1
50528,संयोजन,0,0,1,1
44325,κύριας,0,0,1,1
44326,والتنظيمات,0,0,1,1
50530,сшил,0,0,1,1
44329,regularization,0,0,1,1
50529,деревушке,0,0,1,1
44330,அதிகமில்லை.,0,0,1,1
44333,പ്രത്യേകതയാണ്.,0,0,1,1
44303,afi [ˌwɪkiˈpiːdi.ə],0,0,1,1
44334,സ്വാതന്ത്ര്യമില്ല.,0,0,1,1
44335,τηρούν,0,0,1,1
44336,продолжите,0,0,1,1
44337,συμπλήρωμα,0,0,1,1
44338,للباحثين,0,0,1,1
44340,immédiates,0,0,1,1
44324,informationen,0,0,1,1
50531,attendues,0,0,1,1
44322,battre,0,0,1,1
44321,openai,0,0,1,1
44320,abrange,0,0,1,1
44318,prediction.,0,0,1,1
44314,øverst,0,0,1,1
44313,попросите,0,0,1,1
44312,ലോകമെമ്പാടും,0,0,1,1
44311,infallsvinklar.,0,0,1,1
44310,'நடுநிலைமை',0,0,1,1
44309,गैर-लाभ,0,0,1,1
44308,настройка,0,0,1,1
44307,تنسيق,0,0,1,1
50532,отклонениям.,0,0,1,1
44306,уровню,0,0,1,1
44304,gebrauchen,0,0,1,1
44254,«рандеву,0,0,1,1
44249,​sin,0,0,1,1
50525,للمشروع,0,0,1,1
44195,binary,0,0,1,1
44186,concordando,0,0,1,1
44187,trupperna,0,0,1,1
44188,علاجاته,0,0,1,1
44189,iğrençtir,0,0,1,1
50552,användarens,0,0,1,1
44192,notada,0,0,1,1
44196,independientes,0,0,1,1
44183,சொல்கிறேன்.,0,0,1,1
50550,ഇതി,0,0,1,1
44197,edição.,0,0,1,1
44199,geomagnetic,0,0,1,1
44200,groepsverstand,0,0,1,1
44201,வடிவம்,0,0,1,1
44202,sarılmak,0,0,1,1
44184,തോന്നിയെന്നിരിക്കട്ടെ,0,0,1,1
44182,каких-то,0,0,1,1
44248,نسخها,0,0,1,1
44172,நுபீடியாவிற்கான,0,0,1,1
50556,construites,0,0,1,1
44163,skapats,0,0,1,1
44165,ജോസഫ്,0,0,1,1
44167,தாக்குதல்,0,0,1,1
44169,ലഭിക്കണമെങ്കിൽ,0,0,1,1
44171,κουδούνι,0,0,1,1
50555,başlayacak,0,0,1,1
44180,της.,0,0,1,1
50554,mentionné,0,0,1,1
44174,åsikter.,0,0,1,1
44176,ಹೇಳುತ್ತಾರೆ.,0,0,1,1
44177,വരുത്താൻ,0,0,1,1
44178,dergelijks,0,0,1,1
50553,befindet,0,0,1,1
44203,διαγλωσσικές,0,0,1,1
44205,центра,0,0,1,1
44207,fictício,0,0,1,1
50543,சுதந்திரம்,0,0,1,1
44232,hipotético,0,0,1,1
50545,സൂചിപ്പിക്കാൻ,0,0,1,1
44234,साथी,0,0,1,1
44235,मांक्स,0,0,1,1
50544,kontakter,0,0,1,1
44236,spaces.,0,0,1,1
44239,ημερομηνία,0,0,1,1
44208,bilmelisin.,0,0,1,1
44241,controversé.,0,0,1,1
44242,حلقة,0,0,1,1
44243,emploie,0,0,1,1
50542,لتشمل,0,0,1,1
50541,واحصل,0,0,1,1
44244,логистическому,0,0,1,1
44231,wikipedia-skribenterna,0,0,1,1
44230,cannot.,0,0,1,1
44228,نمط,0,0,1,1
44227,georgiano,0,0,1,1
44226,എങ്ങനെ',0,0,1,1
44223,ഇമെയിലിൽ,0,0,1,1
44221,बवारियाई,0,0,1,1
44220,brute,0,0,1,1
44219,fuese,0,0,1,1
44218,eyes.,0,0,1,1
44217,ഔട്ട്പുട്ടിലേക്കുള്ള,0,0,1,1
44216,toefl'i,0,0,1,1
44214,реализованная,0,0,1,1
44213,toevallig,0,0,1,1
44212,പ്രവൃത്തികളും,0,0,1,1
44210,സ്വേവ്,0,0,1,1
44209,árbol,0,0,1,1
44341,ಕೋಪಗೊಂಡಿದೆ.,0,0,1,1
44345,mechanism.ref,0,0,1,1
44160,algemene,0,0,1,1
44477,എടുക്കുന്നതുപോലെ,0,0,1,1
44468,харуко,0,0,1,1
50501,julgamento,0,0,1,1
44470,officiellt,0,0,1,1
44474,instrucciones,0,0,1,1
44475,يُسمح,0,0,1,1
44476,liberado,0,0,1,1
44478,ரொட்டியுடன்,0,0,1,1
44466,ಇನ್ನು,0,0,1,1
44479,spams,0,0,1,1
44481,défunte,0,0,1,1
44482,ಯೋಜನೆ,0,0,1,1
44483,individus.,0,0,1,1
44484,வைத்திருப்பது,0,0,1,1
44485,çapında,0,0,1,1
44467,वॉलून,0,0,1,1
44465,argumentou,0,0,1,1
50507,computadora,0,0,1,1
44452,martin,0,0,1,1
44441,चूक,0,0,1,1
44442,уставшим,0,0,1,1
44446,klædt,0,0,1,1
44447,ಚೀರ್ಸ್,0,0,1,1
44449,planets.,0,0,1,1
44451,sonst,0,0,1,1
44455,ಕೇಳುತ್ತಿರಲಿಲ್ಲ,0,0,1,1
44464,യുദ്ധത്തിൽ,0,0,1,1
44456,отображена,0,0,1,1
44459,plet,0,0,1,1
44460,ജീവൻ,0,0,1,1
44461,പൊതു-അവലംബ,0,0,1,1
44462,fitted,0,0,1,1
44463,сэнгером.,0,0,1,1
50497,ಅಹಂಕಾರಿ,0,0,1,1
44486,الآراء,0,0,1,1
44488,начале,0,0,1,1
44518,lebte.,0,0,1,1
44510,секунду,0,0,1,1
44511,الحلزون.,0,0,1,1
44513,weinig,0,0,1,1
44514,सम्नाक्ष,0,0,1,1
44515,sostuvo,0,0,1,1
44517,माज़न्दारिनी,0,0,1,1
44519,ಪಾರ್ಟಿಯಲ್ಲಿರುವಾಗ,0,0,1,1
44489,harbor,0,0,1,1
50494,killing,0,0,1,1
44520,كاثرين,0,0,1,1
44522,traditionally-compiled,0,0,1,1
50493,പുസ്തകത്തിൽ,0,0,1,1
44524,doneerde,0,0,1,1
44525,visioenen,0,0,1,1
44509,vand,0,0,1,1
44508,இருந்திருக்கிறேன்,0,0,1,1
44507,bomis.,0,0,1,1
44506,السماء,0,0,1,1
44505,желающим,0,0,1,1
44504,kelimedir.,0,0,1,1
44500,apresentarei,0,0,1,1
44499,പങ്കുവയ്ക്കുന്നു...,0,0,1,1
44498,lenteur,0,0,1,1
44497,« décrire,0,0,1,1
50495,ಸೂಚನೆಗಳನ್ನು,0,0,1,1
44496,frecuente.,0,0,1,1
44495,finalité.,0,0,1,1
44493,​​det,0,0,1,1
44492,insana,0,0,1,1
44491,plaats.,0,0,1,1
44490,großen,0,0,1,1
50506,ஸ்பீக்கர்,0,0,1,1
44437,objeto.,0,0,1,1
44347,frustration,0,0,1,1
44379,ಪುನರಾವರ್ತಿಸಬೇಕೆಂದು,0,0,1,1
44370,geotechnical,0,0,1,1
44371,bankaya,0,0,1,1
44372,naber,0,0,1,1
44373,دائما,0,0,1,1
44376,mandar,0,0,1,1
44378,حصل,0,0,1,1
44380,stopte,0,0,1,1
44367,практики,0,0,1,1
44381,parecerem,0,0,1,1
44382,осознанном,0,0,1,1
44383,usualmente,0,0,1,1
44384,trög.,0,0,1,1
44386,ദയനീയമാണെന്ന്,0,0,1,1
50519,κυριολεκτικά,0,0,1,1
44369,δάγκωμα,0,0,1,1
44365,وذهبا,0,0,1,1
44434,réutiliser,0,0,1,1
50523,حرب,0,0,1,1
44348,prévaloir,0,0,1,1
44349,stoppen,0,0,1,1
44352,identifiable,0,0,1,1
44353,பார்ப்பது,0,0,1,1
44354,latinska,0,0,1,1
44355,million.,0,0,1,1
44357,நல்லவை,0,0,1,1
44363,दाईं,0,0,1,1
44358,പോകുന്നതാണ്,0,0,1,1
50522,proporcionarle,0,0,1,1
44359,എന്നും,0,0,1,1
44360,ρόλους.,0,0,1,1
44362,cogitans »,0,0,1,1
50520,модификации,0,0,1,1
44387,hatalı,0,0,1,1
44388,العزيز,0,0,1,1
44389,அழைப்பில்,0,0,1,1
44423,anti-vandal,0,0,1,1
50513,maand.,0,0,1,1
44418,ಆಕ್ರಮಣಕಾರಿ,0,0,1,1
50512,wikiproyectos,0,0,1,1
50511,പന്തിരുകുലം,0,0,1,1
44421,صوت,0,0,1,1
44422,reducir,0,0,1,1
44424,فلست,0,0,1,1
44390,hilfreich,0,0,1,1
44426,hire,0,0,1,1
44427,ambiguïté,0,0,1,1
44429,dolan,0,0,1,1
44430,önünde,0,0,1,1
44431,sphère,0,0,1,1
44432,traversa,0,0,1,1
44417,fora-da-lei,0,0,1,1
50515,şehit,0,0,1,1
44411,confundes,0,0,1,1
44410,बने,0,0,1,1
44409,ಪಡೆದರೆ,0,0,1,1
44407,അസാമാന്യമായ,0,0,1,1
44406,conflitos,0,0,1,1
44405,वैज्ञानिक,0,0,1,1
50516,طبيعة,0,0,1,1
44401,മാളിൽ,0,0,1,1
44398,toutes.,0,0,1,1
44397,dosyalarının,0,0,1,1
44396,लेती,0,0,1,1
44395,мешают,0,0,1,1
44394,rejoignit,0,0,1,1
44392,ನೀರು,0,0,1,1
44391,located.,0,0,1,1
44161,കാണരുത്,0,0,1,1
44158,vietnamese,0,0,1,1
44528,kolaylıkla,0,0,1,1
43909,voluntaria.,0,0,1,1
43901,تجعلني,0,0,1,1
43902,göras,0,0,1,1
43903,iran,0,0,1,1
43906,specifieke,0,0,1,1
50588,raisonnable,0,0,1,1
43908,circulação,0,0,1,1
43910,விளங்கிய,0,0,1,1
43899,elever,0,0,1,1
43911,tilbyde.,0,0,1,1
43913,desculpando.,0,0,1,1
43914,മറയ്ക്കാൻ,0,0,1,1
43915,creep,0,0,1,1
43916,ഭക്ഷണത്തെക്കുറിച്ച്,0,0,1,1
43918,dengeli,0,0,1,1
43900,наблюдаемой,0,0,1,1
43898,μπορούν,0,0,1,1
50594,ஆரம்பிக்கப்படும்.,0,0,1,1
43885,galilée,0,0,1,1
50593,true.,0,0,1,1
43877,يسافرون,0,0,1,1
43878,tratar,0,0,1,1
43882,evaluate,0,0,1,1
43883,frequência,0,0,1,1
43884,arriverez,0,0,1,1
43886,उल्लंघन,0,0,1,1
43897,confianza,0,0,1,1
43887,gereken,0,0,1,1
43889,d'approfondir,0,0,1,1
43891,eqdfw,0,0,1,1
43894,enige,0,0,1,1
43895,hvert,0,0,1,1
50590,decades,0,0,1,1
43920,geldiniz.,0,0,1,1
43922,பேசலாம்.,0,0,1,1
43923,survive,0,0,1,1
43959,ഇതിനർത്ഥം.,0,0,1,1
43951,समीक्षाओं,0,0,1,1
43953,لكشف,0,0,1,1
43954,സങ്കീർണ്ണവും.,0,0,1,1
43955,अनियन,0,0,1,1
43956,engaged,0,0,1,1
50585,synes,0,0,1,1
43960,avsevärt,0,0,1,1
43925,центром,0,0,1,1
43961,lance,0,0,1,1
43963,diras,0,0,1,1
43964,ಇಷ್ಟಪಡುವ,0,0,1,1
43966,directrices,0,0,1,1
43969,llamar,0,0,1,1
43971,springs,0,0,1,1
43950,கேள்விக்கு,0,0,1,1
43949,servo-croata,0,0,1,1
43948,ದಾಟಿದೆ,0,0,1,1
43947,усыпана,0,0,1,1
43946,gravedad,0,0,1,1
43945,ബുദ്ധിശൂന്യമാണെന്ന്,0,0,1,1
43942,despedirse,0,0,1,1
43940,سؤاله,0,0,1,1
43938,sensibles,0,0,1,1
43937,τραγούδια,0,0,1,1
43934,блокировкой,0,0,1,1
43933,yapılır.,0,0,1,1
43931,വരുന്നവർ,0,0,1,1
43929,​​als,0,0,1,1
43928,प्रचार,0,0,1,1
43927,adorable,0,0,1,1
43926,प्रोफेसर,0,0,1,1
43874,посещаемых,0,0,1,1
50595,portugais,0,0,1,1
43974,χειρότερα,0,0,1,1
50606,контакты,0,0,1,1
43817,hebraico,0,0,1,1
43818,немецкой,0,0,1,1
43819,संक्षिप्त,0,0,1,1
43821,paris-nanterre,0,0,1,1
50607,porções,0,0,1,1
43822,مربع,0,0,1,1
43824,помимо,0,0,1,1
43815,الأمور,0,0,1,1
43825,upphovsrätt,0,0,1,1
43826,கருத்தைத்,0,0,1,1
43828,दूं,0,0,1,1
43829,deselegante,0,0,1,1
43832,connus,0,0,1,1
43833,gerektirir,0,0,1,1
43816,extensões,0,0,1,1
43814,искусственного,0,0,1,1
43873,ковариацией,0,0,1,1
43805,encyclopédies.,0,0,1,1
43798,упростить,0,0,1,1
43799,أستطع,0,0,1,1
43801,வெற்றிகரமாக,0,0,1,1
43802,embotado,0,0,1,1
43803,vorbereitet.,0,0,1,1
43804,καταλαβαίνω,0,0,1,1
43806,представьте,0,0,1,1
43813,fluidos,0,0,1,1
43807,verricht.,0,0,1,1
43808,работает.,0,0,1,1
43810,ടെലിഫോൺ,0,0,1,1
50609,الصلة.,0,0,1,1
43811,έφερα,0,0,1,1
43812,указанные,0,0,1,1
43834,مساهمين,0,0,1,1
43835,بأدوار,0,0,1,1
43836,kodeord,0,0,1,1
43866,ζητά,0,0,1,1
50599,സമയമാണ്,0,0,1,1
43860,माग्नस,0,0,1,1
43861,πολύπλοκος,0,0,1,1
43863,असहमत,0,0,1,1
50598,bout,0,0,1,1
43864,contract,0,0,1,1
50597,ಕೆಳಗಿನ,0,0,1,1
50604,d'expression,0,0,1,1
43868,amateur.,0,0,1,1
50596,साक्षात्कार,0,0,1,1
43869,നിയന്ത്രിക്കുന്നത്.,0,0,1,1
43870,അമ്മയ്ക്ക്,0,0,1,1
43871,facia.,0,0,1,1
43872,طعام,0,0,1,1
43857,besökarna,0,0,1,1
50600,ഭാഷകളും,0,0,1,1
43855,ಸಂತೋಷಪಡುತ್ತೇನೆ.,0,0,1,1
50601,തെറ്റായ,0,0,1,1
43854,temsil,0,0,1,1
43853,سبتمبر,0,0,1,1
43851,സബ്‌സ്‌ക്രൈബുചെയ്യാൻ,0,0,1,1
43850,répondant,0,0,1,1
43849,بقدر,0,0,1,1
43847,manifold,0,0,1,1
43846,ನೀರಸವಾಗಿದೆ.,0,0,1,1
43845,balcón,0,0,1,1
43844,stellte,0,0,1,1
43842,πλούτος,0,0,1,1
50602,хотя.,0,0,1,1
43840,categorías.,0,0,1,1
43838,doel,0,0,1,1
43972,yansıtmaya,0,0,1,1
43975,experimente,0,0,1,1
44157,ಬೆಳೆಯುತ್ತಾಳೆ,0,0,1,1
44109,besøgende,0,0,1,1
44101,μίλι.,0,0,1,1
44104,respirer,0,0,1,1
44105,итоге,0,0,1,1
44106,ഇല്ലയോ,0,0,1,1
44107,содержимое.,0,0,1,1
44108,stanford-based,0,0,1,1
44111,വാക്യത്തിൽ‌,0,0,1,1
44094,« est,0,0,1,1
44112,ansvarig,0,0,1,1
44114,vald,0,0,1,1
44115,läget,0,0,1,1
50565,th •,0,0,1,1
44116,которого,0,0,1,1
44118,seferinde,0,0,1,1
44097,إهانة,0,0,1,1
44092,conflicting,0,0,1,1
44075,الكوكب,0,0,1,1
44082,மாணிக்கங்களில்,0,0,1,1
44077,demandes.,0,0,1,1
44078,sire,0,0,1,1
50572,kaleme,0,0,1,1
44079,couche,0,0,1,1
50571,مدير,0,0,1,1
44081,interrompre.,0,0,1,1
50570,τεράστιου,0,0,1,1
44090,وثالث,0,0,1,1
44083,discutido,0,0,1,1
44084,neuf,0,0,1,1
44085,धन,0,0,1,1
50569,bitmiş,0,0,1,1
50568,ocasionales,0,0,1,1
44089,sétimo,0,0,1,1
44119,carrying,0,0,1,1
44120,تصبح,0,0,1,1
50563,identifier,0,0,1,1
44145,плагиат,0,0,1,1
44140,globalmente.,0,0,1,1
44141,புத்தகத்தை,0,0,1,1
50559,undesired,0,0,1,1
44142,loosely,0,0,1,1
44143,philippe,0,0,1,1
44144,darin,0,0,1,1
44146,modereras,0,0,1,1
50562,trabajadora,0,0,1,1
44147,حسناً,0,0,1,1
44151,anti-elitism.,0,0,1,1
44152,philosophe,0,0,1,1
44153,للإنجليزية,0,0,1,1
50557,हवाई,0,0,1,1
44156,poderá,0,0,1,1
50560,veas,0,0,1,1
44138,metric,0,0,1,1
44137,exceeding,0,0,1,1
44136,وسماع,0,0,1,1
44135,നര്ചിഷ.,0,0,1,1
44134,التدمير,0,0,1,1
44133,عديم,0,0,1,1
50561,அழகு,0,0,1,1
44132,சோகமாகவோ,0,0,1,1
44131,handicapant,0,0,1,1
44130,«obra,0,0,1,1
44129,videnskabeligt,0,0,1,1
44128,confirmer].,0,0,1,1
44126,النشر,0,0,1,1
44125,mailing-list,0,0,1,1
44124,மாலில்,0,0,1,1
44123,emphasis,0,0,1,1
44076,précipitations,0,0,1,1
44074,pequenas,0,0,1,1
43976,معنى,0,0,1,1
50580,ദേഷ്യപ്പെട്ടതുപോലെയാണെന്ന്,0,0,1,1
43999,ಮರೆತುಬಿಡುತ್ತಾರೆ,0,0,1,1
44000,bibliotekarien,0,0,1,1
44001,modifier[d],0,0,1,1
44002,σαλιγκαριών.,0,0,1,1
50581,incompréhensions,0,0,1,1
44003,overstromen,0,0,1,1
44007,stickprov,0,0,1,1
43997,african,0,0,1,1
44008,увидимся,0,0,1,1
44010,தேடுகிறோம்,0,0,1,1
50579,പാർട്ടിപ്രവർത്തകൻ,0,0,1,1
44015,ವಾಕ್ಯವನ್ನು,0,0,1,1
44016,खबर,0,0,1,1
44017,aktive,0,0,1,1
43998,känna,0,0,1,1
43996,शिक्षा,0,0,1,1
44073,intresserad.,0,0,1,1
50583,feelings,0,0,1,1
43979,garantizan,0,0,1,1
43982,भारी,0,0,1,1
43984,итогов,0,0,1,1
43985,مذهلًا,0,0,1,1
43986,مكالمة,0,0,1,1
43987,saudações,0,0,1,1
50582,έτοιμοι,0,0,1,1
43995,इंक,0,0,1,1
43988,അവയെ,0,0,1,1
43990,poleret.,0,0,1,1
43991,révision,0,0,1,1
43992,βικειπαιδιας,0,0,1,1
43993,γαλλικός,0,0,1,1
43994,yiyemediğim,0,0,1,1
44019,süßen,0,0,1,1
50578,reunión.,0,0,1,1
50577,ಉತ್ತಮವಾದದ್ದನ್ನು,0,0,1,1
44060,tänk,0,0,1,1
44046,запустил,0,0,1,1
44050,ангел,0,0,1,1
44051,zugehört.,0,0,1,1
44054,artificiel,0,0,1,1
44055,comienzos,0,0,1,1
44059,онлайн-сотрудничества,0,0,1,1
44064,aplicáveis,0,0,1,1
44021,locales.,0,0,1,1
44065,ആചരിക്കുന്നു.,0,0,1,1
44066,ocensurerade,0,0,1,1
44067,ಸಲಹೆಗಳು.,0,0,1,1
44068,இழுத்து,0,0,1,1
44069,κύρος,0,0,1,1
44070,интеллект,0,0,1,1
44045,കുഴപ്പമുണ്ടോ,0,0,1,1
44044,madrid​,0,0,1,1
50575,sud-coréen,0,0,1,1
44041,gekichert,0,0,1,1
44039,presionando,0,0,1,1
44038,прогнала,0,0,1,1
44037,veckan,0,0,1,1
44036,adquirimos,0,0,1,1
44034,steder,0,0,1,1
44031,currents.,0,0,1,1
50576,vidsträckt,0,0,1,1
44029,ತಿನ್ನಬೇಕು.,0,0,1,1
44027,വേരുകളുണ്ട്.,0,0,1,1
44026,സംശയമില്ലാത്ത,0,0,1,1
44024,reparação,0,0,1,1
44023,l’homme,0,0,1,1
44022,passes,0,0,1,1
44527,méta-wiki.,0,0,1,1
50492,källhänvisning,0,0,1,1
45296,१०००००,0,0,1,1
45044,நிர்வாகிகள்,0,0,1,1
45037,ettiğin,0,0,1,1
45038,préparer,0,0,1,1
45039,пора.,0,0,1,1
45041,tidligere,0,0,1,1
45042,الجمال.,0,0,1,1
45043,домашнее,0,0,1,1
45045,aangepast,0,0,1,1
45034,зрелыми,0,0,1,1
45046,estudiante,0,0,1,1
45047,kaum.,0,0,1,1
45049,seemed,0,0,1,1
45050,കാര്യങ്ങൾക്കെല്ലാം,0,0,1,1
45051,further].,0,0,1,1
45052,सिम्बल,0,0,1,1
45036,centra-se,0,0,1,1
50423,estructuras,0,0,1,1
45009,grym,0,0,1,1
45021,παρουσίαση,0,0,1,1
45011,நாசீசஸ்,0,0,1,1
45012,ഇഷ്ടപ്പെടുകയും,0,0,1,1
45013,tardive,0,0,1,1
45014,κύρια,0,0,1,1
45015,κάπου.,0,0,1,1
45016,wapedia.mobi,0,0,1,1
45023,ومعظمها,0,0,1,1
45030,sociales,0,0,1,1
45025,kelimesinden,0,0,1,1
45026,محررون,0,0,1,1
45027,கொள்வாள்,0,0,1,1
45028,uzmanlık,0,0,1,1
50425,adelantarse,0,0,1,1
50424,verdadero,0,0,1,1
45055,dinî,0,0,1,1
45057,beğenerek,0,0,1,1
45058,éloignée,0,0,1,1
45093,varsin,0,0,1,1
45083,منهم,0,0,1,1
45084,समन्वय,0,0,1,1
45086,continuamente,0,0,1,1
45087,другой.,0,0,1,1
45088,arcade'in,0,0,1,1
45089,يتعلق,0,0,1,1
45095,romaine,0,0,1,1
45059,२००१,0,0,1,1
45096,ಸಮಯದಲ್ಲಿ.,0,0,1,1
45097,caparazón,0,0,1,1
45098,cerebro,0,0,1,1
45101,present.,0,0,1,1
50419,blanding,0,0,1,1
45102,लूंगा।,0,0,1,1
45082,редакции,0,0,1,1
45081,рубинов,0,0,1,1
45080,نشر,0,0,1,1
45079,valued,0,0,1,1
45078,χαιρετισμοί,0,0,1,1
45077,fidedignas,0,0,1,1
45074,разработанную,0,0,1,1
45073,universalis,0,0,1,1
50422,ಇತರರಿಗೆ,0,0,1,1
45071,paniek,0,0,1,1
45069,l'internet ,0,0,1,1
45068,ಮಾಡುವವರಿಗೆ,0,0,1,1
45067,voeren,0,0,1,1
45066,கற்கள்,0,0,1,1
45064,quieren,0,0,1,1
45063,bizimle,0,0,1,1
45061,endangered,0,0,1,1
45010,பால்கனியில்,0,0,1,1
45008,சேர்த்து,0,0,1,1
45104,وسيمه,0,0,1,1
44949,विन्यास,0,0,1,1
44940,redistributions,0,0,1,1
44942,സജീവ,0,0,1,1
44943,بعضهما,0,0,1,1
44945,wikipedia ».,0,0,1,1
44947,unu-merit.,0,0,1,1
44948,управления,0,0,1,1
44951,massive,0,0,1,1
50435,одолжить,0,0,1,1
44952,olmadı,0,0,1,1
50432,ποιες,0,0,1,1
44955,beschikbaar.,0,0,1,1
50431,cycle.,0,0,1,1
50430,разрушительных,0,0,1,1
44957,வாக்கியங்களை,0,0,1,1
50434,l'icône,0,0,1,1
44937,visionen,0,0,1,1
45005,கால்களை,0,0,1,1
50437,atribuíram,0,0,1,1
44919,предоставляется,0,0,1,1
44920,relate,0,0,1,1
44922,comunicação,0,0,1,1
44923,சலுகைகள்.,0,0,1,1
44924,கொண்டார்.,0,0,1,1
44925,vivrait,0,0,1,1
44927,ska.,0,0,1,1
44935,regard,0,0,1,1
44928,αναφορές,0,0,1,1
44931,جعلتها,0,0,1,1
50436,والتحرير,0,0,1,1
44932,वैद्यता,0,0,1,1
44933,l'adresse,0,0,1,1
44934,non-white,0,0,1,1
44958,прецедентам.,0,0,1,1
44959,പുതുക്കാറുണ്ട്.,0,0,1,1
44960,probations,0,0,1,1
44994,embarcarse,0,0,1,1
44983,fedorenta,0,0,1,1
44984,പേരും,0,0,1,1
44985,maktspel.,0,0,1,1
44987,litt.,0,0,1,1
50426,conference,0,0,1,1
44992,publicerade,0,0,1,1
44995,فظيع.,0,0,1,1
44961,kijken,0,0,1,1
44996,görünüyorlardı,0,0,1,1
44998,puzzled,0,0,1,1
44999,compton's,0,0,1,1
45000,அதிலிருந்து,0,0,1,1
45001,cheers,0,0,1,1
45002,ನಗುತ್ತಾ,0,0,1,1
44982,startपारंपरिक,0,0,1,1
44980,σταματήσαμε,0,0,1,1
44979,सोचने,0,0,1,1
44977,fourth-largest,0,0,1,1
44976,generosamente,0,0,1,1
44974,الخطط.,0,0,1,1
44973,غدا.,0,0,1,1
44972,متواضعة,0,0,1,1
44971,പദ്ധതി,0,0,1,1
44970,elders,0,0,1,1
44968,முடுக்கிவிடுங்கள்.,0,0,1,1
50428,δικαιοδοσίας,0,0,1,1
50429,инцидент,0,0,1,1
44967,μητέρας,0,0,1,1
44964,vann,0,0,1,1
44963,vulva,0,0,1,1
44962,लग्ज़म्बर्गी,0,0,1,1
50418,ಪಟ್ಟಣದ,0,0,1,1
45105,«уборка»,0,0,1,1
44917,collaboratively,0,0,1,1
45242,seen.,0,0,1,1
45236,biosphère,0,0,1,1
45237,xixe,0,0,1,1
45238,dirigidas,0,0,1,1
50405,ಮಾಣಿಕ್ಯ,0,0,1,1
45239,точность,0,0,1,1
45241,διάρκεια,0,0,1,1
45244,शहरों,0,0,1,1
45232,visitor,0,0,1,1
45248,dergelijke,0,0,1,1
45249,undersökning.,0,0,1,1
50403,негативной,0,0,1,1
45250,voeden,0,0,1,1
45251,சொற்றொடரின்,0,0,1,1
45252,betegne,0,0,1,1
45233,seeking,0,0,1,1
45231,mentaal,0,0,1,1
45211,yoluna,0,0,1,1
45221,гибкая,0,0,1,1
45214,amont,0,0,1,1
45216,froh,0,0,1,1
45217,podrán,0,0,1,1
50407,сайтом.,0,0,1,1
45219,repérer ,0,0,1,1
45220,شاركت,0,0,1,1
50406,வினைச்சொல்லாக,0,0,1,1
45230,பிரித்தானிக்கா,0,0,1,1
45223,rencontrer.,0,0,1,1
45225,sake,0,0,1,1
45226,begins,0,0,1,1
45227,മീറ്റിംഗിനും,0,0,1,1
45228,hverdag.,0,0,1,1
45229,अभिधान,0,0,1,1
45253,mütevazı,0,0,1,1
45254,adını,0,0,1,1
45255,حاسوبياً,0,0,1,1
45287,bretão,0,0,1,1
45279,ulaşıp,0,0,1,1
45280,брайдл,0,0,1,1
45281,يكتبه,0,0,1,1
45282,women's,0,0,1,1
45283,tristeza.,0,0,1,1
45286,offensant,0,0,1,1
45288,சிரமமாக,0,0,1,1
45256,истории,0,0,1,1
45289,सतर्क,0,0,1,1
45290,ದೀರ್ಘಕಾಲ,0,0,1,1
50400,inblandning,0,0,1,1
45292,plate,0,0,1,1
45293,опыта,0,0,1,1
45295,corner,0,0,1,1
50401,никак,0,0,1,1
45276,suggéré,0,0,1,1
45275,определении,0,0,1,1
45274,संग्रह.,0,0,1,1
45273,астрономической,0,0,1,1
45271,empty,0,0,1,1
45269,bulsam,0,0,1,1
45267,செய்வதற்கான,0,0,1,1
45266,любую,0,0,1,1
45265,policy[which],0,0,1,1
45264,bedövad,0,0,1,1
50402,brengt,0,0,1,1
45262,também.,0,0,1,1
45260,ex-presidente,0,0,1,1
45259,sufrido,0,0,1,1
45258,passende,0,0,1,1
45257,model's,0,0,1,1
45212,ahora.,0,0,1,1
45210,olduktan,0,0,1,1
45107,afi.,0,0,1,1
45142,snabbheten,0,0,1,1
45132,تفضيل,0,0,1,1
45134,فهذا,0,0,1,1
45136,« bon,0,0,1,1
45137,president,0,0,1,1
45139,عمليات,0,0,1,1
45141,விவரிக்கிறார்கள்,0,0,1,1
45144,turísticas.,0,0,1,1
45130,tanrıya,0,0,1,1
45145,uk,0,0,1,1
45146,nachdenken.,0,0,1,1
45148,inciclopedia.,0,0,1,1
45151,glæde,0,0,1,1
45152,gravity.,0,0,1,1
45154,d'édition »,0,0,1,1
45131,περιστατικά,0,0,1,1
45129,existia,0,0,1,1
45206,buchstäblich,0,0,1,1
45117,ontwikkelen,0,0,1,1
45109,innecesarios,0,0,1,1
45110,ചേർക്കുന്നു.,0,0,1,1
45111,discourage,0,0,1,1
45113,πέντε,0,0,1,1
50417,indican,0,0,1,1
45116,तीसरे,0,0,1,1
45118,ನೋಡುತ್ತಾ,0,0,1,1
45126,الأول.,0,0,1,1
45119,pas ».,0,0,1,1
50416,bewonderende,0,0,1,1
45122,stapt,0,0,1,1
45123,kullanıyoruz,0,0,1,1
45124,frans-,0,0,1,1
45125,podrá,0,0,1,1
50415,traído,0,0,1,1
45157,parlement,0,0,1,1
45158,starving,0,0,1,1
45196,кластеров,0,0,1,1
45188,പ്രശ്നമല്ല.,0,0,1,1
45189,красивом,0,0,1,1
45191,பல்கலைக்கழகத்தில்,0,0,1,1
45192,offres.,0,0,1,1
45194,അതിശക്തമായ,0,0,1,1
50410,confundí,0,0,1,1
45197,புத்தகமான,0,0,1,1
45159,pleurs,0,0,1,1
45198,rammer,0,0,1,1
45200,εγγραφείτε,0,0,1,1
45201,terres,0,0,1,1
50409,. million.,0,0,1,1
45202,வார்த்தைகளில்,0,0,1,1
45205,ουσιαστικό,0,0,1,1
45186,онлайн-обращение,0,0,1,1
45183,функция,0,0,1,1
45181,emne,0,0,1,1
50411,varsayalım,0,0,1,1
45180,mediação,0,0,1,1
45178,indkørslen.,0,0,1,1
45177,molesto,0,0,1,1
45176,bible.,0,0,1,1
45175,அட்டூழியம்,0,0,1,1
45170,५०,0,0,1,1
45169,uzmanların,0,0,1,1
45168,விவரிக்கிறார்கள்.,0,0,1,1
45167,lujo,0,0,1,1
45165,asuntos,0,0,1,1
45162,agriculture.,0,0,1,1
50414,lower-level,0,0,1,1
45160,internetbaserade,0,0,1,1
44918,humaine »,0,0,1,1
44915,yemeklerden,0,0,1,1
44529,situer,0,0,1,1
44659,провели,0,0,1,1
44650,aanleidinggevende,0,0,1,1
44651,प्रति,0,0,1,1
44652,terrain.,0,0,1,1
44653,ശരിയാണെന്ന്,0,0,1,1
44656,ltd,0,0,1,1
44657,φράση.,0,0,1,1
44660,اسمح,0,0,1,1
44644,anfragen.,0,0,1,1
44661,veré,0,0,1,1
44665,savunulmaktadır,0,0,1,1
44668,century,0,0,1,1
44671,delegados,0,0,1,1
44672,desconcertantemente,0,0,1,1
50469,التهجئة،,0,0,1,1
44645,лицензии,0,0,1,1
44643,administrativas.,0,0,1,1
44623,γειά,0,0,1,1
44633,vinklingarna,0,0,1,1
44625,قدمًا,0,0,1,1
44626,അക്ഷരാർത്ഥത്തിൽ,0,0,1,1
44629,البطاطس,0,0,1,1
44630,सीखा,0,0,1,1
44632,анонсировала,0,0,1,1
50472,முக்கிய,0,0,1,1
44634,grootte,0,0,1,1
44642,religies,0,0,1,1
44636,divulgou,0,0,1,1
44637,بالإنترنت.,0,0,1,1
50471,затопленный,0,0,1,1
44638,audience.,0,0,1,1
50470,mountainous,0,0,1,1
44639,انتحالًا,0,0,1,1
44674,வெளியிடப்படும்.,0,0,1,1
44675,inträffade,0,0,1,1
44676,المساعد,0,0,1,1
44706,verlaat.,0,0,1,1
44700,кампании,0,0,1,1
50465,وعدم,0,0,1,1
44701,сэром,0,0,1,1
50464,productive,0,0,1,1
44704,तेज,0,0,1,1
44705,activation.,0,0,1,1
44710,greenwich,0,0,1,1
44677,wikipedia»​​​​,0,0,1,1
44713,പരിഗണനയും,0,0,1,1
44715,затраты,0,0,1,1
44716,især,0,0,1,1
44717,как',0,0,1,1
44719,ஆராய,0,0,1,1
44720,anlamadıysa,0,0,1,1
44699,политику.,0,0,1,1
44698,hemsidan,0,0,1,1
50466,alleged,0,0,1,1
44696,engagement,0,0,1,1
44695,بسلامة,0,0,1,1
44694,σχέση,0,0,1,1
44693,θαλασσωσα.,0,0,1,1
44690,ಬಣ್ಣದ್ದಾಗಿತ್ತು,0,0,1,1
44687,ಮನೆಕೆಲಸವನ್ನು,0,0,1,1
50467,ഇരിക്കുന്ന,0,0,1,1
44684,المضللة.,0,0,1,1
50468,нормальный,0,0,1,1
44682,بعلامة,0,0,1,1
44681,deslocar,0,0,1,1
44680,noiva,0,0,1,1
44679,faithful,0,0,1,1
44678,المستقبلية,0,0,1,1
44624,необходимости,0,0,1,1
44622,schat,0,0,1,1
44722,contenha,0,0,1,1
44558,fremstilles,0,0,1,1
44551,l'exactitude,0,0,1,1
50487,الفاكهة,0,0,1,1
44552,تعلمون.,0,0,1,1
44553,paciente,0,0,1,1
44555,arkivera,0,0,1,1
44557,ಶ್ರೀಮಂತರು,0,0,1,1
44559,الوصف,0,0,1,1
44549,eat.,0,0,1,1
44560,ತೀಕ್ಷ್ಣವಾಗಿ,0,0,1,1
44561,χάσει,0,0,1,1
50486,vader,0,0,1,1
44564,والنقاشات,0,0,1,1
44565,غدًا.,0,0,1,1
44566,ಕಣ್ಣುಗಳು.,0,0,1,1
44550,«βικιπαίδεια»,0,0,1,1
44548,efficiency,0,0,1,1
44620,innegociable,0,0,1,1
44537,وأنواعًا,0,0,1,1
50491,विष्णुप्रिया,0,0,1,1
44532,आशंका,0,0,1,1
50490,fördjupade.,0,0,1,1
44534,categorized.,0,0,1,1
44535,மனைவியாக,0,0,1,1
44536,leert,0,0,1,1
50489,internet-baserede,0,0,1,1
44547,digital».,0,0,1,1
44538,τελειώσω.,0,0,1,1
44539,читатель,0,0,1,1
44540,придется,0,0,1,1
44541,ദിവസേന,0,0,1,1
44543,weakly,0,0,1,1
44546,combining,0,0,1,1
50485,квартале,0,0,1,1
44568,продал,0,0,1,1
50484,оболочки,0,0,1,1
44606,de •,0,0,1,1
44590,japanska.,0,0,1,1
44591,jump,0,0,1,1
44599,لي.,0,0,1,1
44602,الجديد.,0,0,1,1
44603,någonsin,0,0,1,1
44605,accessas,0,0,1,1
44607,ज़र्मन,0,0,1,1
44569,وتقنيات,0,0,1,1
44610,ಸಂತೋಷವಾಗಿರಲು,0,0,1,1
44612,теорий,0,0,1,1
44614,ತಂದಿದ್ದೇನೆ,0,0,1,1
44615,superó,0,0,1,1
44616,вечера.,0,0,1,1
44617,yapılmıştır,0,0,1,1
50477,income-generating,0,0,1,1
44585,കർത്തവ്യമാണ്,0,0,1,1
44584,yolculuğunuza,0,0,1,1
50478,подъездной,0,0,1,1
44583,l’écriture,0,0,1,1
44581,medio.,0,0,1,1
44580,ಭೇಟಿ,0,0,1,1
44579,يشبه,0,0,1,1
50480,सहन,0,0,1,1
44578,шутка,0,0,1,1
44577,ناجحًا,0,0,1,1
50481,abandonada,0,0,1,1
44574,açıktır.,0,0,1,1
44573,viajó,0,0,1,1
50482,l'engouement,0,0,1,1
44571,query.,0,0,1,1
50483,أتناوله,0,0,1,1
44721,policydrivet,0,0,1,1
44725,iron-filled,0,0,1,1
44914,وfrench،,0,0,1,1
44857,frygt,0,0,1,1
44850,വിദഗ്ദ്ധനുമായ,0,0,1,1
44851,realidad.,0,0,1,1
44852,signalent,0,0,1,1
44853,«обсуждение»,0,0,1,1
44854,fnr.,0,0,1,1
44856,αμηχανία,0,0,1,1
50439,actuar,0,0,1,1
44848,espera,0,0,1,1
44858,politikalarından,0,0,1,1
44860,conocen,0,0,1,1
44863,symbols,0,0,1,1
44864,முன்,0,0,1,1
44865,egoistische,0,0,1,1
44866,ves,0,0,1,1
44849,وعبارة,0,0,1,1
44847,परे,0,0,1,1
44825,waffling,0,0,1,1
44836,asesino,0,0,1,1
44827,ja •,0,0,1,1
44828,जाएगा,0,0,1,1
44829,βασικές,0,0,1,1
44831,മികച്ചതായിരിക്കും,0,0,1,1
50443,sporen.,0,0,1,1
44834,completos,0,0,1,1
44837,அழகை,0,0,1,1
44846,искусства,0,0,1,1
44838,வாட்ஸ்அப்,0,0,1,1
50442,ಪಾಸ್‌ವರ್ಡ್,0,0,1,1
44839,estadístico,0,0,1,1
44843,മായ്ച്ചുകളയാറുമുണ്ട്.,0,0,1,1
44844,abstengan,0,0,1,1
44845,применения,0,0,1,1
44867,semi-protected,0,0,1,1
44869,എഡിറ്റുകളെല്ലാം,0,0,1,1
44870,αμφιβολίας,0,0,1,1
44905,fransa'da,0,0,1,1
44899,некоммерческого,0,0,1,1
44900,hilfe,0,0,1,1
44901,manuals,0,0,1,1
44902,gözlerimi.,0,0,1,1
44903,précis.,0,0,1,1
50438,تقنية,0,0,1,1
44906,mid-s,0,0,1,1
44871,വിക്കിപീഡിയൻ,0,0,1,1
44907,இதற்கு,0,0,1,1
44908,грустная,0,0,1,1
44910,قطعة,0,0,1,1
44911,¿tiene,0,0,1,1
44912,predilecta,0,0,1,1
44913,başlangıçtan,0,0,1,1
44898,vannevar,0,0,1,1
44897,ಆದ,0,0,1,1
44896,ஆகியோரால்,0,0,1,1
44895,рекламы,0,0,1,1
44894,incapacidade,0,0,1,1
44891,मलयालम,0,0,1,1
44889,invalidated,0,0,1,1
44887,بامتلاك,0,0,1,1
44886,vandálicos.,0,0,1,1
44885,atribuídos,0,0,1,1
44883,ಮಾಡಲ್ಪಟ್ಟಿದೆ,0,0,1,1
44882,correspondante,0,0,1,1
44881,nutteloos,0,0,1,1
44880,الظروف.,0,0,1,1
44879,neuesten,0,0,1,1
44878,ഗൂഗിളിലേക്ക്,0,0,1,1
44874,बताएं,0,0,1,1
44826,software​,0,0,1,1
50445,demeç,0,0,1,1
44726,மாறிவிட்டாள்.,0,0,1,1
50458,அங்கீகரிக்கப்படல்,0,0,1,1
44758,βοήθεια,0,0,1,1
44759,വിയോജിക്കുന്നു,0,0,1,1
44760,свободного,0,0,1,1
44761,ಮದುವೆಯಾದ,0,0,1,1
44762,précision,0,0,1,1
44763,fingrene,0,0,1,1
44767,സാമൂഹ്യവിരുദ്ധർ,0,0,1,1
44756,politik.,0,0,1,1
44768,konuşulan,0,0,1,1
44770,cuídate.,0,0,1,1
50457,المكان,0,0,1,1
44771,«история»,0,0,1,1
44772,eksamen,0,0,1,1
44773,denominan,0,0,1,1
44757,neutral».,0,0,1,1
44754,vikipedileri,0,0,1,1
44823,hy •,0,0,1,1
44745,мухаммеда,0,0,1,1
44727,désencyclopédie.,0,0,1,1
44731,എന്നിവ,0,0,1,1
44732,выглядел,0,0,1,1
50461,confundidos,0,0,1,1
44735,vonden,0,0,1,1
44741,suchen,0,0,1,1
44746,katılmak,0,0,1,1
44753,interagem,0,0,1,1
44747,pay,0,0,1,1
44748,അതുകൊണ്ട്‌,0,0,1,1
44749,aesthetic,0,0,1,1
44750,riktiga,0,0,1,1
44751,ಕಾಫಿಯನ್ನು,0,0,1,1
44752,അവർ‍,0,0,1,1
44774,não-parcialidade.,0,0,1,1
44776,conhecê-lo.,0,0,1,1
44777,эмпирически,0,0,1,1
44809,mars',0,0,1,1
44802,പശ്ചാത്തലത്തിൽ,0,0,1,1
44803,ಹೋಗುತ್ತೀರಿ,0,0,1,1
44804,கொடுத்த,0,0,1,1
44806,parfait,0,0,1,1
44807,ஆரம்பித்து,0,0,1,1
44808,هارفارد،,0,0,1,1
44813,conformada,0,0,1,1
44779,контентом[комм.,0,0,1,1
50446,depend,0,0,1,1
44817,diyebilirim.,0,0,1,1
44818,मिली,0,0,1,1
44820,familiares,0,0,1,1
44821,suajili,0,0,1,1
44822,ವಿಧಾನವೆಂದರೆ,0,0,1,1
50448,k-svd,0,0,1,1
44798,الآراء.,0,0,1,1
44796,viaje,0,0,1,1
44795,психолога,0,0,1,1
44794,istediği,0,0,1,1
44793,κρεβάτι,0,0,1,1
44792,kind.,0,0,1,1
50450,svenska.,0,0,1,1
44789,ஃப்ளூமாக்ஸைப்,0,0,1,1
44786,पोलिश,0,0,1,1
50451,ಒಪ್ಪಿಕೊಳ್ಳುತ್ತೇನೆ.,0,0,1,1
50452,വാക്യങ്ങളും,0,0,1,1
50455,நாசீசஸின்,0,0,1,1
44783,തത്ത്വം.,0,0,1,1
44782,ಕಾರ್ಯನಿರತರಾಗಿರಬಹುದು.,0,0,1,1
44781,διάφορα,0,0,1,1
50456,mängd,0,0,1,1
46839,tolkningar,0,0,1,1
46840,забавный,0,0,1,1
46843,goal.,0,0,1,1
48805,assistants,0,0,1,1
49907,புளகாங்கிதம்,0,0,1,1
49906,ಅರ್ಥಗಳ,0,0,1,1
49905,вверху,0,0,1,1
48800,يتجاوز,0,0,1,1
48802,niettemin,0,0,1,1
48803,faça,0,0,1,1
48806,olun.,0,0,1,1
48797,मॉडल,0,0,1,1
48807,полезных,0,0,1,1
48808,வெளியேறுகிறேன்,0,0,1,1
48810,قرية,0,0,1,1
48811,bureaucratic,0,0,1,1
48812,uitgespookt,0,0,1,1
48814,ögonblicket,0,0,1,1
48798,demokrater,0,0,1,1
48796,ബഹുപദമായിരിക്കണോ,0,0,1,1
48777,récurrentes,0,0,1,1
49909,snowpacks,0,0,1,1
48779,sécurisées,0,0,1,1
48780,reduce,0,0,1,1
48781,status.,0,0,1,1
48782,முயற்சித்தது,0,0,1,1
48783,दलित,0,0,1,1
48784,αυξηθεί,0,0,1,1
48785,പ്രിന്റ്,0,0,1,1
49908,ನೀವೇ,0,0,1,1
48786,smartphone.,0,0,1,1
48787,suscetível,0,0,1,1
48790,informe,0,0,1,1
48791,circling,0,0,1,1
48794,காக்கப்படுகின்றன.,0,0,1,1
48795,razão,0,0,1,1
48815,εμπορικό,0,0,1,1
48816,фламмокс,0,0,1,1
48818,suffisamment,0,0,1,1
48848,πατάτες,0,0,1,1
48840,alsjeblieft,0,0,1,1
48841,associée,0,0,1,1
49898,candidat.,0,0,1,1
48842,redaktion,0,0,1,1
48843,கூட்டு,0,0,1,1
48846,mains,0,0,1,1
48849,mundial,0,0,1,1
48819,καθοριστεί,0,0,1,1
48852,eerdere,0,0,1,1
48854,वाशिंगटन,0,0,1,1
49897,thoughts,0,0,1,1
48855,heiß,0,0,1,1
48856,ανόητος,0,0,1,1
48857,संतुलित,0,0,1,1
48839,изображений.,0,0,1,1
49899,castelhana,0,0,1,1
49900,wherefrom,0,0,1,1
49902,يجعل,0,0,1,1
48834,anglais.,0,0,1,1
48833,எப்படியாவது,0,0,1,1
48832,fiaskoer,0,0,1,1
48831,goza,0,0,1,1
48830,പത്തുവാചകം,0,0,1,1
48827,ரெண்டெஸ்வஸ்.,0,0,1,1
48826,предложил,0,0,1,1
48825,веб-сервер,0,0,1,1
48824,ofrecen,0,0,1,1
48823,slug,0,0,1,1
48822,désignant,0,0,1,1
48821,spirituel,0,0,1,1
48820,അന്ന്,0,0,1,1
48778,d'éditeurs,0,0,1,1
48776,खुफिया,0,0,1,1
48860,informatique,0,0,1,1
48724,التعبير.,0,0,1,1
48717,पर्ल,0,0,1,1
48719,maratones,0,0,1,1
49913,ಧ್ವನಿಸುವ,0,0,1,1
48720,الممارسة,0,0,1,1
48722,contenues,0,0,1,1
48723,النزاعات،,0,0,1,1
48725,task-specific,0,0,1,1
49914,ökade,0,0,1,1
48726,सलेक्ट,0,0,1,1
48727,india,0,0,1,1
48731,non-free,0,0,1,1
48733,dites-nous,0,0,1,1
48734,arkadaş,0,0,1,1
48735,associëren,0,0,1,1
48716,redistribuição,0,0,1,1
48715,weeks,0,0,1,1
48775,encontra-se,0,0,1,1
49915,partenariat,0,0,1,1
48700,révolutions,0,0,1,1
48701,şarkılarda,0,0,1,1
48702,തകർന്നു,0,0,1,1
48703,remunerado.,0,0,1,1
48704,confondu,0,0,1,1
49916,സ്വാധീനമുള്ള,0,0,1,1
48706,meningsfulla,0,0,1,1
48714,признать,0,0,1,1
48707,المشرقة,0,0,1,1
48708,d'énergie,0,0,1,1
48709,വാൻഡലിസത്തിന്,0,0,1,1
48711,അനാശാസ്യമായ,0,0,1,1
48712,re-distribute,0,0,1,1
48713,ചെയ്തു.,0,0,1,1
48736,ehud,0,0,1,1
48737,تلميحًا,0,0,1,1
48738,ಮೂಲವೆಂದರೆ,0,0,1,1
49911,маркой,0,0,1,1
48759,wikiversité.,0,0,1,1
48760,irgendwo,0,0,1,1
48762,неделю ,0,0,1,1
48763,विशेषताएं,0,0,1,1
48764,ആന,0,0,1,1
48765,ಗಣಿತದ,0,0,1,1
48766,exam,0,0,1,1
49912,nécessite,0,0,1,1
48767,specialized,0,0,1,1
49910,εξηγεί.,0,0,1,1
48769,механизма,0,0,1,1
48771,recouverte,0,0,1,1
48772,ζητώ,0,0,1,1
48773,televisión,0,0,1,1
48758,பிரச்சனை.,0,0,1,1
48757,சிறப்புக்கட்டுரைத்,0,0,1,1
48756,gekruist,0,0,1,1
48755,regions.,0,0,1,1
48754,സിദ്ധാന്ത,0,0,1,1
48753,possua,0,0,1,1
48752,объявлено,0,0,1,1
48751,expansions,0,0,1,1
48749,neerleggen,0,0,1,1
48748,kalırsınız.,0,0,1,1
48747,seçkin,0,0,1,1
48745,jupiter,0,0,1,1
48744,humanities,0,0,1,1
48743,सामी,0,0,1,1
48742,«мне,0,0,1,1
48741,ಭಾವಿಸಿದ್ದಳು.,0,0,1,1
48740,complementary,0,0,1,1
48858,προσφορά.,0,0,1,1
48861,paseo.,0,0,1,1
48698,γνωρίζω,0,0,1,1
48981,massachusetts,0,0,1,1
48975,convenient,0,0,1,1
48976,hughes,0,0,1,1
49881,undskylder.,0,0,1,1
48977,acadêmica.,0,0,1,1
48979,geluksvogel,0,0,1,1
48980,inexactitudes,0,0,1,1
48982,человечества.,0,0,1,1
48973,لطريقة,0,0,1,1
49880,tornarmos,0,0,1,1
48984,satisfação,0,0,1,1
48985,inútiles,0,0,1,1
48986,ಪದಗಳಿಗಿಂತ,0,0,1,1
48989,തയ്യാറാക്കിയിട്ടുണ്ട്,0,0,1,1
48990,вечер.,0,0,1,1
48974,والتحيزات,0,0,1,1
48971,förändra,0,0,1,1
48943,suggérait,0,0,1,1
48955,ಗಾಡಿಯೊಂದಿಗೆ,0,0,1,1
48948,samtale.,0,0,1,1
48950,படித்துக்கொண்டிருக்கிறேன்,0,0,1,1
48951,wikimodellen.,0,0,1,1
48952,deeply,0,0,1,1
48953,impidiendo,0,0,1,1
48954,exercer,0,0,1,1
48956,asombrada,0,0,1,1
48970,др..,0,0,1,1
48959,low-dimensional.,0,0,1,1
48960,لجنة,0,0,1,1
48962,inapropiadas,0,0,1,1
48963,marquées,0,0,1,1
48968,தளங்களுக்கான,0,0,1,1
48969,speak,0,0,1,1
48991,ಕೇಳಿದ್ದೇವೆ,0,0,1,1
48992,малым,0,0,1,1
48993,user-generated,0,0,1,1
49028,liebes,0,0,1,1
49021,smilende,0,0,1,1
49022,ورائعًا.,0,0,1,1
49023,ಹತ್ತಿರ,0,0,1,1
49024,öyleyse,0,0,1,1
49026,കാഴ്ച,0,0,1,1
49027,அறிந்திருக்க,0,0,1,1
49029,besat,0,0,1,1
48995,νυφικό,0,0,1,1
49030,neoproterozoic,0,0,1,1
49031,раздела.,0,0,1,1
49032,kina,0,0,1,1
49033,jeg',0,0,1,1
49036,абсолютно,0,0,1,1
49037,продавались,0,0,1,1
49020,engagé,0,0,1,1
49019,kurucularından,0,0,1,1
49016,dışarıdayken,0,0,1,1
49015,sapiens.,0,0,1,1
49014,получала,0,0,1,1
49876,editörleri,0,0,1,1
49009,വിക്കിസമൂഹമെന്നും,0,0,1,1
49008,actifs.,0,0,1,1
49877,syriska,0,0,1,1
49006,ಹೇಳಿದ್ದೇನೆಂದರೆ,0,0,1,1
49005,ஏழை,0,0,1,1
49878,техники,0,0,1,1
49003,dust,0,0,1,1
49001,venezuela,0,0,1,1
49000,formulation.,0,0,1,1
48998,മേഖലകളിൽ,0,0,1,1
48997,tron's,0,0,1,1
48944,மனிதனும்,0,0,1,1
48942,salientou,0,0,1,1
48862,വിഷമകരമായ,0,0,1,1
48891,klarer,0,0,1,1
48884,nyt,0,0,1,1
48885,sujeitas,0,0,1,1
48886,document,0,0,1,1
48888,studentuppsatser,0,0,1,1
48889,खिलाते,0,0,1,1
48890,ella.,0,0,1,1
48892,وأنتم,0,0,1,1
48882,சந்திப்பிற்கும்,0,0,1,1
48895,prometteuses.,0,0,1,1
48896,категории,0,0,1,1
48897,sjunka,0,0,1,1
48899,förutsättning,0,0,1,1
49890,denote,0,0,1,1
48901,guider,0,0,1,1
48883,designation,0,0,1,1
48881,اللغة،,0,0,1,1
48941,ചോദിക്കാൻ‌,0,0,1,1
48871,talloze,0,0,1,1
48863,двумя,0,0,1,1
48864,absorbing,0,0,1,1
48865,avslöjande,0,0,1,1
48866,human/nature,0,0,1,1
48868,جعلني,0,0,1,1
49896,kapatılmasını,0,0,1,1
48872,posts,0,0,1,1
49892,inception,0,0,1,1
48873,സൂര്യനിൽ,0,0,1,1
48874,сведений,0,0,1,1
49895,подкреплены,0,0,1,1
48875,welkom,0,0,1,1
48876,rempli,0,0,1,1
49894,anglosakson,0,0,1,1
48902,recommendations,0,0,1,1
48903,novel,0,0,1,1
49889,kosteloos,0,0,1,1
48934,secrètement,0,0,1,1
48928,funnits,0,0,1,1
48929,simplifié.,0,0,1,1
48930,लटकाओ।,0,0,1,1
49887,слышите,0,0,1,1
48932,затмившей,0,0,1,1
48933,stattdessen,0,0,1,1
49886,செயலதிகாரியான,0,0,1,1
49888,вернуться,0,0,1,1
48935,palais,0,0,1,1
48937,aceito,0,0,1,1
49884,anklagats,0,0,1,1
48938,ಯಶಸ್ವಿಯಾದರೆ,0,0,1,1
48939,प्राणी,0,0,1,1
48940,подкреплением,0,0,1,1
48927,soir.,0,0,1,1
48926,правил,0,0,1,1
48924,ചിന്തിച്ചേക്കാം,0,0,1,1
48922,rejecting,0,0,1,1
48921,ஆரம்பித்தாள்.,0,0,1,1
48920,ಶಿಕ್ಷಕನು,0,0,1,1
48919,skal.,0,0,1,1
48918,on-line,0,0,1,1
48917,comporte,0,0,1,1
48916,ändamålet,0,0,1,1
48914,воздействия,0,0,1,1
48913,материала.,0,0,1,1
48912,ஐகானைக்,0,0,1,1
48911,освещении,0,0,1,1
48910,thuiskwam.,0,0,1,1
48909,dol,0,0,1,1
48907,voudrais,0,0,1,1
48699,rätt.,0,0,1,1
48697,physicians,0,0,1,1
49040,نقلاً,0,0,1,1
48437,grandir,0,0,1,1
48430,gratuitement,0,0,1,1
48431,построения,0,0,1,1
48432,schnecke,0,0,1,1
48434,permitindo,0,0,1,1
48435,vérifiabilité,0,0,1,1
48436,graves,0,0,1,1
48438,الرقم,0,0,1,1
48428,hacían,0,0,1,1
48440,« featured,0,0,1,1
48441,comic,0,0,1,1
49959,interprétation.,0,0,1,1
49958,propiamente,0,0,1,1
49957,segos,0,0,1,1
48443,snarare,0,0,1,1
48429,வளர்ந்தது.,0,0,1,1
48427,metne,0,0,1,1
48407,gidiyorsa,0,0,1,1
48418,الهاتف,0,0,1,1
48410,pairs,0,0,1,1
48411,gitmek,0,0,1,1
48414,ترميز,0,0,1,1
48415,stiftelsens,0,0,1,1
48416,vraie,0,0,1,1
48417,textbooks,0,0,1,1
49961,usual.,0,0,1,1
48426,बताएं।,0,0,1,1
48420,roll.,0,0,1,1
48421,rijksdienst,0,0,1,1
48422,نقودًا,0,0,1,1
48423,ontem,0,0,1,1
48424,entendía,0,0,1,1
48425,അന്ധാളിച്ച്,0,0,1,1
48444,nette,0,0,1,1
48445,documentary,0,0,1,1
48446,franskt,0,0,1,1
48484,പ്രതിനിധാനം,0,0,1,1
48474,submeter-se,0,0,1,1
48476,adequada,0,0,1,1
48477,തരത്തിലാണുള്ളത്.,0,0,1,1
49952,renforcée,0,0,1,1
49951,പരീക്ഷിക്കുക,0,0,1,1
48483,sucré.,0,0,1,1
48489,wereldoorlog.,0,0,1,1
48449,umgegangen,0,0,1,1
49947,describió,0,0,1,1
48493,ஒப்புக்கொள்ள,0,0,1,1
48495,ഇക്കാലത്ത്,0,0,1,1
48496,dialogueur,0,0,1,1
48497,टेलीफोन,0,0,1,1
48498,ca,0,0,1,1
48473,கூர்மையைக்,0,0,1,1
48472,resource.,0,0,1,1
48471,الطالب,0,0,1,1
48470,högt,0,0,1,1
48469,former's,0,0,1,1
48468,interglacial,0,0,1,1
48467, millions d'articles,0,0,1,1
48465,اعتمادًا,0,0,1,1
48463,kaynaklarını,0,0,1,1
48461,يحدق,0,0,1,1
48460,بحجب,0,0,1,1
48456,दोहराए।,0,0,1,1
48454,ಬಳಸಬಹುದು,0,0,1,1
48453,d’identification »,0,0,1,1
48452,التاريخية,0,0,1,1
48451,года»,0,0,1,1
49955,حزن,0,0,1,1
48408,ഓയെപ്പോലെയാണ്,0,0,1,1
48406,τρίμηνο,0,0,1,1
48503,vandalizada,0,0,1,1
48345,regards,0,0,1,1
48336,செய்யும்படி,0,0,1,1
48337,определенному,0,0,1,1
48338,والصحفي,0,0,1,1
48340,source.,0,0,1,1
48343,opslagruimte,0,0,1,1
48344,забывают,0,0,1,1
48346,интернете,0,0,1,1
48334,προετοιμαζόμουν,0,0,1,1
48347,теста,0,0,1,1
49974,haar.,0,0,1,1
48349,joueurs,0,0,1,1
48352,ಬೆರಗುಗೊಳಿಸುವ,0,0,1,1
48353,pos,0,0,1,1
48359,souberem,0,0,1,1
48335,décoder,0,0,1,1
48331,ಅರ್ಥಮಾಡಿಕೊಳ್ಳದಿದ್ದರೆ,0,0,1,1
48405,poderes,0,0,1,1
48320,hellen,0,0,1,1
48312,saxão,0,0,1,1
48314,gerechtigd,0,0,1,1
48315,kültürde,0,0,1,1
48316,बोरिस,0,0,1,1
48318,αντιγράψετε,0,0,1,1
49978,φράσης.,0,0,1,1
48321,exceeds,0,0,1,1
48330,सेबुआनो,0,0,1,1
48322,விக்கிப்பீடியாவிற்கும்,0,0,1,1
48323,pretty,0,0,1,1
48325,enyongle,0,0,1,1
48326,enciclopédicamente,0,0,1,1
48327,smakprov.,0,0,1,1
48329,goodbye.,0,0,1,1
49973,disposer,0,0,1,1
48361,wereld,0,0,1,1
48362,كنا,0,0,1,1
48393,t'aime,0,0,1,1
49966,ستالمان.,0,0,1,1
48387,redactores.,0,0,1,1
48388,γεμάτη,0,0,1,1
48389,بيركمان,0,0,1,1
48390,victorian.,0,0,1,1
48392,κούκλα,0,0,1,1
48395,archieven,0,0,1,1
49972,inteira.,0,0,1,1
48396,സമ്പത്ത്,0,0,1,1
48397,десятке,0,0,1,1
48398,وقت.,0,0,1,1
48400,consultaient,0,0,1,1
49965,regroupe,0,0,1,1
49964,тон,0,0,1,1
48383,gesicht,0,0,1,1
48381,blockeringar,0,0,1,1
48380,inexpertos,0,0,1,1
49968,व्हाट्सएप,0,0,1,1
49969,expertgranskning,0,0,1,1
48377,участником,0,0,1,1
48376,ತಿನ್ನು.,0,0,1,1
48375,jurk,0,0,1,1
48373,pierre,0,0,1,1
48372,saw,0,0,1,1
48371,stavningen,0,0,1,1
48370,стороны ,0,0,1,1
48369,φτάσω,0,0,1,1
49970,осуществлён,0,0,1,1
48366,voted,0,0,1,1
48365,ബുദ്ധിശൂന്യമോ,0,0,1,1
48364,فأخبرني,0,0,1,1
48501,alternativ,0,0,1,1
48504,freely,0,0,1,1
49917,هاتفك,0,0,1,1
48634,decreases,0,0,1,1
48626,σκέφτεται,0,0,1,1
48628,എന്നിട്ട്,0,0,1,1
48629,βρείτε,0,0,1,1
48630,remoção,0,0,1,1
48632,ودفعت,0,0,1,1
48633,robes,0,0,1,1
48635,manuales,0,0,1,1
48624,ಪದ್ಧತಿಗಳಿಂದ,0,0,1,1
48636,diseases,0,0,1,1
48640,оставайтесь,0,0,1,1
48641,எதிர்,0,0,1,1
49925,journalistes.,0,0,1,1
48646,enoje,0,0,1,1
48647,submergée,0,0,1,1
48625,residence',0,0,1,1
48623,« philosophie,0,0,1,1
48597,discordo.,0,0,1,1
49928,anti-elitismo.,0,0,1,1
48601,непроверенной,0,0,1,1
48602,ascending,0,0,1,1
48603,издательство,0,0,1,1
48604,دوت,0,0,1,1
48608,ದೌರ್ಜನ್ಯ.,0,0,1,1
48609,تطلق,0,0,1,1
48613,πνιγμό,0,0,1,1
49926,« dépourvus,0,0,1,1
48615,ämnesorienterade,0,0,1,1
48616,सर्बो-क्रोएशियाई,0,0,1,1
48618,постоянные,0,0,1,1
48619,ignore-all-rules,0,0,1,1
48620,sejt,0,0,1,1
49927,وبهذا,0,0,1,1
48649,करूँगी,0,0,1,1
48651,ഭാഷകളിലും,0,0,1,1
48652,inner,0,0,1,1
48687,வேண்டத்தகாத,0,0,1,1
49920,samengewerkt,0,0,1,1
48682,loyal,0,0,1,1
48683,മലയാളീകരണമാണ്,0,0,1,1
48684,säger.,0,0,1,1
48685,grind,0,0,1,1
48686,asigna,0,0,1,1
49919,ആശങ്കകളൊന്നുമില്ല.,0,0,1,1
48655,दोषी,0,0,1,1
48688,праве,0,0,1,1
48689,reshaping,0,0,1,1
48691,kontorskonto,0,0,1,1
48692,injuste,0,0,1,1
48693,தாருங்கள்.,0,0,1,1
48694,elogiando,0,0,1,1
48679,ചതുപ്പുനിലമാക്കി.,0,0,1,1
48678,civiles,0,0,1,1
48674,கொண்டிருப்பதுடன்,0,0,1,1
49922,spelling,0,0,1,1
48671,hør,0,0,1,1
48670,programadores,0,0,1,1
48669,सका।usa,0,0,1,1
48668,टर्म्स,0,0,1,1
48667,ನಮಸ್ಕಾರ,0,0,1,1
48665,forskningsresultat,0,0,1,1
48664,കുട്ടി,0,0,1,1
48663,إلي,0,0,1,1
48662,telaffuzu,0,0,1,1
48661,ತಕ್ಷಣ,0,0,1,1
48660,ಪರೀಕ್ಷೆ,0,0,1,1
48658,ακόλουθοι,0,0,1,1
48657,പുരുഷന്മാർ,0,0,1,1
48599,outre,0,0,1,1
48596,года  »,0,0,1,1
48505,فحص,0,0,1,1
48535,apologizing.,0,0,1,1
49943,வேலையைப்,0,0,1,1
48531,σκεφτείτε,0,0,1,1
49942,sætning.,0,0,1,1
48533,വിജ്ഞാനകോശമാണ്,0,0,1,1
48534,விக்கிப்பீடியாவை,0,0,1,1
49941,എത്തി.,0,0,1,1
49939,மனிதனுக்கு,0,0,1,1
48527,vu.,0,0,1,1
48538,वोरो,0,0,1,1
48539,основного,0,0,1,1
48540,entreolharam,0,0,1,1
49938,ആശ്വസിപ്പിക്കാൻ,0,0,1,1
48542,добавление,0,0,1,1
48544,stupid,0,0,1,1
48528,«ты»,0,0,1,1
48526,lembrá-lo,0,0,1,1
48595,électriques,0,0,1,1
48513,قلعة,0,0,1,1
48506,we.,0,0,1,1
48507,സൃഷ്ടിച്ചു.,0,0,1,1
48508,diskuteras.,0,0,1,1
48510,помогает,0,0,1,1
48511,t'épouser,0,0,1,1
48512,lenguaje,0,0,1,1
48514,tegenkwam,0,0,1,1
48524,intégré,0,0,1,1
48515,packen,0,0,1,1
48518,custo.,0,0,1,1
48519,agora.,0,0,1,1
48521,ഉറപ്പായിട്ടും.,0,0,1,1
48522,controversée,0,0,1,1
48523,بإرسال,0,0,1,1
48545,debates,0,0,1,1
48548,odum,0,0,1,1
48549,التطبيقات,0,0,1,1
48582,elogiou,0,0,1,1
48574,ανοικτό,0,0,1,1
48575,кого,0,0,1,1
48577,distincts.,0,0,1,1
48579,citam,0,0,1,1
48580,world's,0,0,1,1
48581,kullanılır.,0,0,1,1
49931,lyssnade.,0,0,1,1
48550,лицензия,0,0,1,1
48584,schreiben,0,0,1,1
48585,входные,0,0,1,1
48588,débit,0,0,1,1
48589,editassem,0,0,1,1
48590,posent,0,0,1,1
48593,ಹೊರಡುವ,0,0,1,1
48573,natürlich.,0,0,1,1
48572,отношении,0,0,1,1
48569,baja,0,0,1,1
49932,presocratic,0,0,1,1
49933,beleidigung,0,0,1,1
48563,министерств,0,0,1,1
48561,skarpe,0,0,1,1
49934,ഓളം,0,0,1,1
48560,λεωφορείο,0,0,1,1
48558,بملكية,0,0,1,1
49936,ia.,0,0,1,1
48556,hochzeitskleid,0,0,1,1
48555,yüzlerce,0,0,1,1
48554,éditeurs,0,0,1,1
48553,исправить,0,0,1,1
48552,l’esquisse,0,0,1,1
48551,символ,0,0,1,1
49039,heat.,0,0,1,1
49872,решившегося,0,0,1,1
46844,immatériel ,0,0,1,1
49504,lecteur.,0,0,1,1
49496,பெண்,0,0,1,1
49498,ഉറപ്പാണോ,0,0,1,1
49499,ஆடைகளின்,0,0,1,1
49500,«непредубеждения»,0,0,1,1
49501,вверх,0,0,1,1
49502,imorgon,0,0,1,1
49505,sous-branches ,0,0,1,1
49493,stabilise,0,0,1,1
49797,acima,0,0,1,1
49507,ಸರಿಪಡಿಸಲು,0,0,1,1
49508,branden,0,0,1,1
49509,acessível.,0,0,1,1
49796,بالأرقام,0,0,1,1
49510,sinks,0,0,1,1
49495,ouvrages.,0,0,1,1
49492,टुकड़ा,0,0,1,1
49469,agrupan,0,0,1,1
49479,كيف',0,0,1,1
49471,calm,0,0,1,1
49472,θέα,0,0,1,1
49473,ಇಂಗ್ಲಿಷ್‌ನಲ್ಲಿ,0,0,1,1
49801,simgesi,0,0,1,1
49474,άλλον,0,0,1,1
49477,تعيينه,0,0,1,1
49481,corregir,0,0,1,1
49491,التعليقات,0,0,1,1
49482,reflect,0,0,1,1
49483,يفعل.,0,0,1,1
49485,அறியப்பட்ட,0,0,1,1
49799,ayrıntıya,0,0,1,1
49488,തോന്നാൻ,0,0,1,1
49489,தொலைதூரத்தில்,0,0,1,1
49511,வாக்கியத்தைப்,0,0,1,1
49794,n'utilisez-vous,0,0,1,1
49514,resolved,0,0,1,1
49545,нозека,0,0,1,1
49538,drunknar,0,0,1,1
49787,кино,0,0,1,1
49540,próximas,0,0,1,1
49541,ahogando,0,0,1,1
49542,ಪಡೆದುಕೊಂಡೆ,0,0,1,1
49785,चुनौती,0,0,1,1
49546,sanningsenlig,0,0,1,1
49515,பன்மொழி,0,0,1,1
49547,zaden,0,0,1,1
49548,erfahrung,0,0,1,1
49554,видела.,0,0,1,1
49555,إليهم,0,0,1,1
49556,warren,0,0,1,1
49783,banimento,0,0,1,1
49537,सांस्कृतिक,0,0,1,1
49536,parodia,0,0,1,1
49535,manifestation,0,0,1,1
49533,моём,0,0,1,1
49788,uber,0,0,1,1
49532,suspender,0,0,1,1
49789,ഭയമായിരുന്നു,0,0,1,1
49529,liminar,0,0,1,1
49527,१.३५,0,0,1,1
49526,परिप्रेक्ष्य,0,0,1,1
49524,ಒಬಾಮಾ,0,0,1,1
49523,please.,0,0,1,1
49522,بمرور,0,0,1,1
49790,характер,0,0,1,1
49521,വിജ്ഞാനശകലങ്ങൾ,0,0,1,1
49791,повсеместная,0,0,1,1
49518,മേശ,0,0,1,1
49470,to.,0,0,1,1
49468,അന്നുകണ്ട,0,0,1,1
49558,deltagande,0,0,1,1
49418,ссылки,0,0,1,1
49408,.സുഹൃത്ത്,0,0,1,1
49409,atordoado,0,0,1,1
49410,defienden,0,0,1,1
49414,e symposium,0,0,1,1
49415,discernible,0,0,1,1
49416,fåtal,0,0,1,1
49419,uitdrukking,0,0,1,1
49406,ровно,0,0,1,1
49420,ಕಾಣಿಸುತ್ತಾಳೆ,0,0,1,1
49422,интеллектуальной,0,0,1,1
49424,frozen.,0,0,1,1
49425,j'adorerais,0,0,1,1
49426,engellendi.,0,0,1,1
49427,värden,0,0,1,1
49407,ಅಲ್ಲಿರುವ,0,0,1,1
49815,தொலைபேசியை,0,0,1,1
49802,bazılarının,0,0,1,1
49396,اقترح,0,0,1,1
49388,panciera,0,0,1,1
49389,slide,0,0,1,1
49391,education.,0,0,1,1
49392,tornou,0,0,1,1
49393,språkgrupp,0,0,1,1
49394,population,0,0,1,1
49397,étonnant.,0,0,1,1
49405,статьях.,0,0,1,1
49398,hediye,0,0,1,1
49399,സഹായത്തിനായി,0,0,1,1
49401,பயனர்களை,0,0,1,1
49402,elbiseyle,0,0,1,1
49816,apestosa,0,0,1,1
49404,மூலமாக,0,0,1,1
49428,आरम्भ,0,0,1,1
49814,المجاور,0,0,1,1
49430,lighthearted,0,0,1,1
49460,avancerad,0,0,1,1
49806,ഇവരേയും,0,0,1,1
49454,unido.,0,0,1,1
49456,intimidating,0,0,1,1
49457,hawaiiaans,0,0,1,1
49805,பிடிக்கவில்லை.,0,0,1,1
49459,limitaría,0,0,1,1
49804,sahen,0,0,1,1
49813,πίστευε,0,0,1,1
49462,നടത്തി.,0,0,1,1
49463,قادم,0,0,1,1
49464,diseñar,0,0,1,1
49466,l'a,0,0,1,1
49467,kullanacağım,0,0,1,1
49803,overmatige,0,0,1,1
49807,uncertain,0,0,1,1
49450,المشكلة,0,0,1,1
49449,многочисленных,0,0,1,1
49448,ответами,0,0,1,1
49447,entretenimiento,0,0,1,1
49809,sciences ·പരിതഃസ്ഥിതിക,0,0,1,1
49445,одноименной,0,0,1,1
49444,utilizadores,0,0,1,1
49443,dira,0,0,1,1
49442,ശരിയായി,0,0,1,1
49441,ಪ್ರತಿಬಿಂಬದಲ್ಲಿ,0,0,1,1
49439,atlamamın,0,0,1,1
49438,imminente,0,0,1,1
49437,censureringar,0,0,1,1
49436,söyledim,0,0,1,1
49434,mãos,0,0,1,1
49812,பாங்கு,0,0,1,1
49782,recognizable,0,0,1,1
49560,அறிவிக்கப்பட்டது.,0,0,1,1
49385,« l'ordinateur,0,0,1,1
49704,принести,0,0,1,1
49695,dorpje,0,0,1,1
49765,وسري,0,0,1,1
49699,tomarse,0,0,1,1
49700,بمجموعة,0,0,1,1
49764,santiago,0,0,1,1
49703,télévisées,0,0,1,1
49705,организатор,0,0,1,1
49693,baseren,0,0,1,1
49706,ppt,0,0,1,1
49707,переписывают,0,0,1,1
49708,imprime,0,0,1,1
49710,disentangles,0,0,1,1
49711,arises,0,0,1,1
49712,velsmagende,0,0,1,1
49694,réduit,0,0,1,1
49692,ашберн,0,0,1,1
49664,environnementales,0,0,1,1
49675,drömmen.,0,0,1,1
49667,любого,0,0,1,1
49669,repetir.,0,0,1,1
49670,redigerade,0,0,1,1
49672,παρακολουθώντας,0,0,1,1
49673,alls.,0,0,1,1
49674,physics,0,0,1,1
49677,والثاني,0,0,1,1
49689,كاسم,0,0,1,1
49678,première.,0,0,1,1
49679,നെഗറ്റീവും,0,0,1,1
49683,सराहना,0,0,1,1
49684,பார்க்காதபோது,0,0,1,1
49686,exacte,0,0,1,1
49688,beteckna,0,0,1,1
49763,verwenden.,0,0,1,1
49713,للأكل,0,0,1,1
49714,tente,0,0,1,1
49743,despidieron,0,0,1,1
49737,डिस्कशन,0,0,1,1
49759,ജനാധിപത്യ,0,0,1,1
49740,unlike,0,0,1,1
49741,مجالهم,0,0,1,1
49742,fou.,0,0,1,1
49758,relatif,0,0,1,1
49745,evidentes,0,0,1,1
49716,aangezien,0,0,1,1
49746,feest,0,0,1,1
49748,confitures,0,0,1,1
49751,siglo,0,0,1,1
49752,forvirrede,0,0,1,1
49754,لكل,0,0,1,1
49756,تجربتهم,0,0,1,1
49760,ചെയ്തത്,0,0,1,1
49735,velocidade,0,0,1,1
49734,inteiro,0,0,1,1
49733,समस्याएं,0,0,1,1
49732,'da,0,0,1,1
49731,модель,0,0,1,1
49730,данному,0,0,1,1
49729,peaked,0,0,1,1
49728,ai...it’s,0,0,1,1
49727,കൂടതൽ,0,0,1,1
49726,titan,0,0,1,1
49762,utländska,0,0,1,1
49721,sociologer,0,0,1,1
49720,larga,0,0,1,1
49719,angår,0,0,1,1
49718,färdigheter,0,0,1,1
49717,rejetés,0,0,1,1
49768,புரியவில்லை,0,0,1,1
49770,பேசினால்,0,0,1,1
49561,متوسط,0,0,1,1
49599,azar,0,0,1,1
49591,мысленно,0,0,1,1
49780,enheter,0,0,1,1
49779,pesquisas.,0,0,1,1
49595,करूं,0,0,1,1
49596,şaşırdım,0,0,1,1
49597,हफ्ते,0,0,1,1
49600,नॉर्मन,0,0,1,1
49589,quotidienne.,0,0,1,1
49602,सीखना,0,0,1,1
49603,تعيشها.,0,0,1,1
49606,marchó,0,0,1,1
49607,தங்கமாக,0,0,1,1
49608,receitas,0,0,1,1
49609,épouse,0,0,1,1
49590,vistas.,0,0,1,1
49588,lusteloos,0,0,1,1
49663,totalités.,0,0,1,1
49571,ದೊಡ್ಡವಳು,0,0,1,1
49563,языках,0,0,1,1
49564,masasına,0,0,1,1
49565,الإعلامية,0,0,1,1
49566,അപ്പം,0,0,1,1
49568,encontradas,0,0,1,1
49569,vivant.,0,0,1,1
49572,spare,0,0,1,1
49586,tropicale,0,0,1,1
49576,الضخمة.,0,0,1,1
49577,الطاولة,0,0,1,1
49578,venant,0,0,1,1
49580,मैसिडोनियाई,0,0,1,1
49581,पहुंचते,0,0,1,1
49585,однополых,0,0,1,1
49611,décontenancée,0,0,1,1
49612,وتحريك,0,0,1,1
49614,consistência,0,0,1,1
49648,है-,0,0,1,1
49641,அழுக்கு,0,0,1,1
49642,formé,0,0,1,1
49644,mínimo,0,0,1,1
49776,milyon,0,0,1,1
49646,το.,0,0,1,1
49647,типизировать,0,0,1,1
49771,ಪೂರ್ತಿ,0,0,1,1
49616,географических,0,0,1,1
49651,géographie,0,0,1,1
49655,masturbation,0,0,1,1
49657,expressar,0,0,1,1
49658,denominators,0,0,1,1
49659,लक्षित,0,0,1,1
49662,torne,0,0,1,1
49640,disposal,0,0,1,1
49639,beklemesini,0,0,1,1
49777,anlayamadım.,0,0,1,1
49637,ανοικτής,0,0,1,1
49636,valorizado,0,0,1,1
49635,regardless,0,0,1,1
49634,மூளை,0,0,1,1
49631,நன்றாகச்,0,0,1,1
49630,والجدير,0,0,1,1
49629,einstellen,0,0,1,1
49627,sobrecargas,0,0,1,1
49626,för.,0,0,1,1
49624,cognition,0,0,1,1
49622,fertig,0,0,1,1
49621,ಅಸಾಧಾರಣವಾದ,0,0,1,1
49619,fraud,0,0,1,1
49617,задач.,0,0,1,1
49386,croyait,0,0,1,1
49384,foundation”,0,0,1,1
49043,буквально,0,0,1,1
49158,പരീക്ഷ,0,0,1,1
49152,फोरम,0,0,1,1
49153,multilinear,0,0,1,1
49154,முதன்மைச்,0,0,1,1
49155,largar,0,0,1,1
49156,блокирование,0,0,1,1
49157,തനിക്ക്,0,0,1,1
49159,الموسوعة.,0,0,1,1
49855,μιλούσατε,0,0,1,1
49160,கண்டுபிடிப்பு,0,0,1,1
49161,regelmatig,0,0,1,1
49162,توش,0,0,1,1
49164,coup,0,0,1,1
49854,gewogen,0,0,1,1
49165,выйдете,0,0,1,1
49150,வார்த்தையைத்,0,0,1,1
49146,المكان.,0,0,1,1
49125,कक्षा,0,0,1,1
49136,incomuns,0,0,1,1
49129,vertellen.,0,0,1,1
49130,nupedia's,0,0,1,1
49131,vandálicas,0,0,1,1
49132,bottar,0,0,1,1
49861,remonte,0,0,1,1
49860,reproduction.,0,0,1,1
49137,تفسيراتهم,0,0,1,1
49145,стандартном,0,0,1,1
49138,ഉപയോഗിക്കാൻ.,0,0,1,1
49140,വീട്ടിലെത്തിയതായും,0,0,1,1
49856,ಪ್ರೇರೇಪಿಸುತ್ತದೆ,0,0,1,1
49141,फ्रीडम,0,0,1,1
49142,extensions,0,0,1,1
49143,fatally,0,0,1,1
49167,inc. ,0,0,1,1
49168,இலகுவில்,0,0,1,1
49169,sí.,0,0,1,1
49196,വലിയൊരാത്മവിശ്വാസം,0,0,1,1
49190,особо,0,0,1,1
49850,bobo.,0,0,1,1
49849,ഫോണിൽ,0,0,1,1
49193,تستغرق,0,0,1,1
49194,frappant,0,0,1,1
49195,clearance,0,0,1,1
49198,പറഞ്ഞുകഴിഞ്ഞാലുടൻ,0,0,1,1
49170,للموارد,0,0,1,1
49200,കൂട്ടായ,0,0,1,1
49847,ಮುರಿದುಬಿದ್ದಿದೆ,0,0,1,1
49202,വിവരങ്ങൾtest,0,0,1,1
49203,vaso,0,0,1,1
49846,boyle,0,0,1,1
49204,bordmanerer,0,0,1,1
49189,മറ്റൊന്നും,0,0,1,1
49188,trädgård,0,0,1,1
49187,υπέροχο.,0,0,1,1
49186,cenas,0,0,1,1
49185,لأمها,0,0,1,1
49184,allmänbildning..,0,0,1,1
49183,εστιατόριο,0,0,1,1
49182,വിക്കിപീഡിയർക്ക്,0,0,1,1
49181,celles-ci.,0,0,1,1
49177,killera,0,0,1,1
49853,നിയോഗിക്കുന്ന,0,0,1,1
49176,ಯೋಚಿಸಿ.,0,0,1,1
49175,sorulduğunda,0,0,1,1
49174,നൽകിയ,0,0,1,1
49173,parcialmente,0,0,1,1
49172,அமெரிக்காவில்,0,0,1,1
49171,أتضور,0,0,1,1
49128,moeite,0,0,1,1
49124,anrufer,0,0,1,1
49207,conventional,0,0,1,1
49071,procuran,0,0,1,1
49064,عملها.,0,0,1,1
49066,رؤيتك,0,0,1,1
49067,ஹெல்லரால்,0,0,1,1
49068,limitam-se,0,0,1,1
49069,jämförbar,0,0,1,1
49070,والسلج,0,0,1,1
49072,atmosphere.,0,0,1,1
49062,переведённые,0,0,1,1
49073,gelassen,0,0,1,1
49866,zaman.,0,0,1,1
49074,d'introduire,0,0,1,1
49075,giydiğim,0,0,1,1
49076,ஒருபோதும்,0,0,1,1
49078,insistent,0,0,1,1
49063,reprinted,0,0,1,1
49060,നോക്കട്ടെ.,0,0,1,1
49123,artikelsidan,0,0,1,1
49049,संदर्भित,0,0,1,1
49044,கவலைப்படாதே,0,0,1,1
49871,pete,0,0,1,1
49045,pétrole,0,0,1,1
49047,salt-water,0,0,1,1
49048,அர்த்தம்,0,0,1,1
49870,വിഷമിക്കേണ്ട.,0,0,1,1
49051,«nuestra,0,0,1,1
49868,olvides,0,0,1,1
49053,diverged,0,0,1,1
49055,vary,0,0,1,1
49056,gelin,0,0,1,1
49057,d'avance.,0,0,1,1
49058,ചേർക്കാനോ,0,0,1,1
49059,ex-nihilo,0,0,1,1
49079,url.,0,0,1,1
49080,signera,0,0,1,1
49082,شئ.,0,0,1,1
49115,തമിഴ്,0,0,1,1
49863,tribunais,0,0,1,1
49108,वैश्विक,0,0,1,1
49109,பெரும்பாலான,0,0,1,1
49111,شرح,0,0,1,1
49112,അമിതമായി,0,0,1,1
49114,restent,0,0,1,1
49116,الزوار,0,0,1,1
49084,மகிழ்ச்சியடைகிறேன்,0,0,1,1
49117,ropa.,0,0,1,1
49118,demasiada,0,0,1,1
49119,freezing,0,0,1,1
49120,நன்றாகப்,0,0,1,1
49121,പതിവിലും,0,0,1,1
49122,gösterilmiştir.,0,0,1,1
49106,вандализм.,0,0,1,1
49105,handle,0,0,1,1
49864,anpassa,0,0,1,1
49103,kämpfte,0,0,1,1
49102,കൃഷിയെപറ്റിയുള്ള,0,0,1,1
49100,tiny,0,0,1,1
49098,منك.,0,0,1,1
49097,cinquième,0,0,1,1
49096,nöje.,0,0,1,1
49095,нью-йорке,0,0,1,1
49094,खिलाफ,0,0,1,1
49092,നീ,0,0,1,1
49091,schaffen,0,0,1,1
49090,çocuklar,0,0,1,1
49087,fördelade,0,0,1,1
49086,croises,0,0,1,1
49865,कॉफी,0,0,1,1
49205,prepare-se,0,0,1,1
49209,experiences,0,0,1,1
49382,guidance,0,0,1,1
49332,آخرين,0,0,1,1
49327,है।हालाँकि,0,0,1,1
49328,பட்டியலூடாக,0,0,1,1
49329,baas,0,0,1,1
49330,άφησέ,0,0,1,1
49826,.ordet,0,0,1,1
49331,planerar,0,0,1,1
49334,raul,0,0,1,1
49325,रिपब्लिक,0,0,1,1
49825,edilmez,0,0,1,1
49335,changing,0,0,1,1
49336,захвачена,0,0,1,1
49337,graag.,0,0,1,1
49338,créées,0,0,1,1
49339,usá-lo,0,0,1,1
49326,irait,0,0,1,1
49324,säkerställda,0,0,1,1
49832,hotter,0,0,1,1
49314,görüşler.,0,0,1,1
49306,almaya,0,0,1,1
49309,fejlede.,0,0,1,1
49831,slot,0,0,1,1
49311,சுவேவ்,0,0,1,1
49312,originalomslaget,0,0,1,1
49313,artikelredigering,0,0,1,1
49315,वास्तविक,0,0,1,1
49323,enkätsvaren,0,0,1,1
49316,консультируются»,0,0,1,1
49318,novelties,0,0,1,1
49319,போதிய,0,0,1,1
49829,performances,0,0,1,1
49320,κόπο,0,0,1,1
49828,للإجابة,0,0,1,1
49340,événements,0,0,1,1
49824,бейзингстоке.,0,0,1,1
49341,talip,0,0,1,1
49371,അവയുടെ,0,0,1,1
49362,काट,0,0,1,1
49364,profits.,0,0,1,1
49822,बदले,0,0,1,1
49366,constante.,0,0,1,1
49367,oluşturacak.,0,0,1,1
49369,بإمكانك,0,0,1,1
49374,cyberspace,0,0,1,1
49342,humanidad,0,0,1,1
49820,adabı,0,0,1,1
49819,saturn's,0,0,1,1
49378,आलोचना,0,0,1,1
49379,donné.,0,0,1,1
49380,одиноко»,0,0,1,1
49381,вечеринке,0,0,1,1
49361,trajet,0,0,1,1
49360,meeste,0,0,1,1
49359,orsaker,0,0,1,1
49358,классическим,0,0,1,1
49357,syntaxiques,0,0,1,1
49355,generiek,0,0,1,1
49354,இறங்கினீர்கள்,0,0,1,1
49353,வழக்குரைஞர்கள்,0,0,1,1
49352,sinophones,0,0,1,1
49351,टाइप,0,0,1,1
49350,सैन,0,0,1,1
49349,نعود,0,0,1,1
49348,وأيضًا.,0,0,1,1
49347,рыцаря.,0,0,1,1
49345,pratique ,0,0,1,1
49344,şehirdeki,0,0,1,1
49343,wikipédiameta,0,0,1,1
49305,narzissa.,0,0,1,1
49304,scotland,0,0,1,1
49210,gerektiğidir.,0,0,1,1
49245,वैस्पियाई,0,0,1,1
49235,cavalgou,0,0,1,1
49237,பையன்,0,0,1,1
49238,relacionadas,0,0,1,1
49239,معاكسة,0,0,1,1
49242,franskspråkiga,0,0,1,1
49244,contraseña,0,0,1,1
49246,ചെയ്യുന്നതെന്തും,0,0,1,1
49232,marrons,0,0,1,1
49247,вниз,0,0,1,1
49248,ಇದುವರೆಗೆ,0,0,1,1
49249,stort.,0,0,1,1
49250,alcançado,0,0,1,1
49251,múltiple,0,0,1,1
49252,durak,0,0,1,1
49234,pierda,0,0,1,1
49231,pratiquez-la,0,0,1,1
49833,ದೂರು,0,0,1,1
49222,fjortonde,0,0,1,1
49211,şimdiye,0,0,1,1
49215,ഉപേക്ഷിച്ചാൽ,0,0,1,1
49216,जबरदस्त,0,0,1,1
49217,sanger​,0,0,1,1
49843,مزيف,0,0,1,1
49219,brugere.,0,0,1,1
49223,wildness,0,0,1,1
49230,अचानक,0,0,1,1
49224,vendo,0,0,1,1
49225,überhäuft,0,0,1,1
49226,arrête,0,0,1,1
49227,lumières.,0,0,1,1
49228,eslovaco,0,0,1,1
49229,polido,0,0,1,1
49254,إجماع,0,0,1,1
49256,அமர்ந்திருக்கிறார்கள்.,0,0,1,1
49258,അന്തരം,0,0,1,1
49294,doradas,0,0,1,1
49283,techniques.,0,0,1,1
49836,تقتصر,0,0,1,1
49286,आइए,0,0,1,1
49288,recurso,0,0,1,1
49292,используемый,0,0,1,1
49293,редакторы,0,0,1,1
49295,exacto,0,0,1,1
49259,de ,0,0,1,1
49296,fry,0,0,1,1
49297,समाविष्टि,0,0,1,1
49834,tyckte,0,0,1,1
49299,etkin,0,0,1,1
49301,أيًا,0,0,1,1
49302,abierto.,0,0,1,1
49280,école,0,0,1,1
49279,culte,0,0,1,1
49278,«pequeño,0,0,1,1
49837,uiquipedia,0,0,1,1
49272,banks.,0,0,1,1
49270,şaka,0,0,1,1
49269,israeli,0,0,1,1
49268,räknas,0,0,1,1
49838,अग्रणी,0,0,1,1
49267,d'« appels »,0,0,1,1
49266,waters,0,0,1,1
49265,sahne,0,0,1,1
49264,செய்துள்ளேன்,0,0,1,1
49263,சாப்பிடக்கூடிய,0,0,1,1
49262,wikiviajes.,0,0,1,1
49261,ألواح,0,0,1,1
49839,vivia,0,0,1,1
48311,يُنسب,0,0,1,1
49979,मिंग्रिलियाई,0,0,1,1
48310,समाज,0,0,1,1
47348,английские,0,0,1,1
47339,uncommon,0,0,1,1
47340,confundem.,0,0,1,1
47341,وحشيًا,0,0,1,1
47342,ಅವರೆಲ್ಲರನ್ನೂ,0,0,1,1
47343,ಮಾಡಲಿಲ್ಲ,0,0,1,1
47345,προσπαθούσε,0,0,1,1
47349,ಒಬ್ಬರ,0,0,1,1
47337,knopf.,0,0,1,1
50131,കണക്കാക്കുന്നത്.,0,0,1,1
47350,förre,0,0,1,1
47351,σκληρή,0,0,1,1
50130,débattues,0,0,1,1
47353,susning[al],0,0,1,1
47356,log,0,0,1,1
50132,grandes.,0,0,1,1
47335,over-reported,0,0,1,1
50135,effectuer,0,0,1,1
47325,ഐക്കൺ,0,0,1,1
47319,şahsen,0,0,1,1
50133,गढ़ा,0,0,1,1
47320,aliens”,0,0,1,1
47321,subdesarrollados,0,0,1,1
47322,medelåldern,0,0,1,1
47323,impresiones,0,0,1,1
47326,mcpherson...,0,0,1,1
47334,lykke,0,0,1,1
47327,تحديداً,0,0,1,1
47329,uitwezen,0,0,1,1
47330,പൊതുവായ,0,0,1,1
47331,beschreef,0,0,1,1
47332,ιανουάριο,0,0,1,1
47333,штате,0,0,1,1
47358,ನಿಷ್ಠುರ,0,0,1,1
50129,взгляды,0,0,1,1
47360,corchetes,0,0,1,1
47388,min •,0,0,1,1
47381,ചാനൽ,0,0,1,1
50125,stoppa,0,0,1,1
47382,piemontês,0,0,1,1
47383,alacağım,0,0,1,1
50124,sprake,0,0,1,1
47385,långsam,0,0,1,1
47389,പോലെയാണിവർ.,0,0,1,1
47362,ώστε,0,0,1,1
50123,droomde.,0,0,1,1
47390,பரிந்துரைகள்.,0,0,1,1
47391,افترض,0,0,1,1
47392,consorcio,0,0,1,1
47393,wikipedia-watch.org,0,0,1,1
47396,ран,0,0,1,1
47380,الكبرى,0,0,1,1
47379,கற்பழிப்பு,0,0,1,1
47378,executes,0,0,1,1
47377,gostasse,0,0,1,1
47376,belediging,0,0,1,1
47375,ομπάμα,0,0,1,1
47374,zones.,0,0,1,1
50128,hoort.,0,0,1,1
47373,feuchtgebiet,0,0,1,1
47371,sacralisation,0,0,1,1
47370,like-knop,0,0,1,1
47369,presently,0,0,1,1
47368,ഉപയോക്താവിനെ,0,0,1,1
47367,вещь,0,0,1,1
47366,stapte,0,0,1,1
47365,modificações,0,0,1,1
47364,dueños,0,0,1,1
47318,التحريرية,0,0,1,1
47315,cirkler,0,0,1,1
47400,ഭാഗ്യമെന്ന്,0,0,1,1
47255,tætskrevne,0,0,1,1
47248,fötterna,0,0,1,1
47250,doubt,0,0,1,1
47252,parodies,0,0,1,1
47253,تحديدًا,0,0,1,1
50142,intenta,0,0,1,1
50141,difamación,0,0,1,1
47256,सोफे,0,0,1,1
47246,meritsystem,0,0,1,1
50140,இறுதிகளிலும்,0,0,1,1
47260,скотт,0,0,1,1
47261,izliyordu.,0,0,1,1
47263,ഇപ്രകാരം,0,0,1,1
47265,overbrugt,0,0,1,1
47268,machistas,0,0,1,1
47247,عينة,0,0,1,1
47245,well-ordered,0,0,1,1
47314,गया।जुलाई,0,0,1,1
47231,ربطها,0,0,1,1
47223,ml •,0,0,1,1
47226,переводные,0,0,1,1
47227,keeping,0,0,1,1
47228,ny,0,0,1,1
47229,cites,0,0,1,1
47230,بتأثيره،,0,0,1,1
50143,ആവർത്തിക്കണമെന്ന്,0,0,1,1
47244,leerproblemen,0,0,1,1
47236,பார்வை,0,0,1,1
47237,gleichnamigen,0,0,1,1
47238,medium,0,0,1,1
47239,construire,0,0,1,1
47241,tilbageværende,0,0,1,1
47243,vandt,0,0,1,1
47269,ഇന്റർനെറ്റിൽ,0,0,1,1
47270,مذهلاً.,0,0,1,1
47273,régionales,0,0,1,1
47305,ссылку,0,0,1,1
47299,адамсом,0,0,1,1
47300,донизу,0,0,1,1
47301,dondurmaya,0,0,1,1
47302,arbeit.,0,0,1,1
47303,αγαπητοί,0,0,1,1
47304,tr •,0,0,1,1
47306,தொடர்பான,0,0,1,1
47274,приобретала,0,0,1,1
47307,ucraniano,0,0,1,1
47308,осознать,0,0,1,1
47309,influyendo,0,0,1,1
47310,كويكب،,0,0,1,1
47311,накоплению,0,0,1,1
47313,उत्पादों,0,0,1,1
47296,sorabilirsiniz.,0,0,1,1
47295,commentaires,0,0,1,1
47291,layers.,0,0,1,1
47290,നാമപദമായി,0,0,1,1
47289,செய்துள்ளீர்கள்.,0,0,1,1
47288,velden,0,0,1,1
47287,quién,0,0,1,1
47286,സെപ്റ്റംബർ,0,0,1,1
47285,végétales,0,0,1,1
47284,ಸುಸ್ತಾಗುವುದಿಲ್ಲ,0,0,1,1
47283,डिग,0,0,1,1
47282,dietitian,0,0,1,1
47280,நிலை,0,0,1,1
47279,thésaurus,0,0,1,1
47277,projeye,0,0,1,1
47276,இத்திட்டத்தின்,0,0,1,1
47275,അഞ്ചുമിനിറ്റിനുള്ളിൽ,0,0,1,1
47399,എല്ലാവർക്കും,0,0,1,1
47401,verzoeken,0,0,1,1
47221,d'écriture…,0,0,1,1
47531,ήδη.,0,0,1,1
47524,विरोधाभास,0,0,1,1
47526,procedente,0,0,1,1
47527,യൂണികോഡ്,0,0,1,1
47529,soleil ,0,0,1,1
47530,ವಿಷಯದಲ್ಲಿ,0,0,1,1
50104,ತಲೆಗೆ,0,0,1,1
47532,labs-research,0,0,1,1
47518,görünüyor,0,0,1,1
50103,‎[wikipidia]‏؛,0,0,1,1
47536,court.,0,0,1,1
47537,обоих.,0,0,1,1
47538,reseñados,0,0,1,1
47540,adorável,0,0,1,1
47543,डिलीवरी,0,0,1,1
47521,gætte,0,0,1,1
47515,vänder,0,0,1,1
47489,அழ,0,0,1,1
47500,comienzo,0,0,1,1
47491,normaal,0,0,1,1
47493,المستخدمون,0,0,1,1
47494,நபர்களாக,0,0,1,1
47497,ставились,0,0,1,1
47498,listade,0,0,1,1
47499,भूतपूर्व,0,0,1,1
47502,ترفض,0,0,1,1
47514,bekannt,0,0,1,1
50107,promoted,0,0,1,1
47504,ഉറുമ്പുകൂട്ടത്തെ,0,0,1,1
47507,paren,0,0,1,1
47508,сотрудничество,0,0,1,1
47512,مقارنة,0,0,1,1
47513,frontière,0,0,1,1
47544,maestro,0,0,1,1
50100,поддерживающей,0,0,1,1
47546,takes,0,0,1,1
47575,നിർമ്മിച്ചതാണ്.,0,0,1,1
47568,ऑसिशियाई,0,0,1,1
47569,resurser,0,0,1,1
47571,അമ്മയല്ലേ,0,0,1,1
47572,cayó,0,0,1,1
47573,staring,0,0,1,1
47574,വിവരണം,0,0,1,1
47576,ബരാക്,0,0,1,1
47547,origem,0,0,1,1
47577,remuneradas,0,0,1,1
47578,ενοχλεί.,0,0,1,1
47579,παρακολουθείτε,0,0,1,1
47580,своё,0,0,1,1
50094,μοναδικό,0,0,1,1
47583,deneyin,0,0,1,1
47567,प्रेक्षण,0,0,1,1
47565,ευγενική,0,0,1,1
47564,изложением,0,0,1,1
47563,തുടരുക.,0,0,1,1
47561,ziyaretçilerinin,0,0,1,1
47560,πλυντήριο,0,0,1,1
47559,heritage,0,0,1,1
50098,расстраиваться,0,0,1,1
47557,ಅದರೊಂದಿಗೆ,0,0,1,1
47556,‎[wikibidija]‏,0,0,1,1
47555,അറിയില്ലായിരുന്നു,0,0,1,1
47554,صعبًا.,0,0,1,1
47553,brillants,0,0,1,1
47552,வளர்ச்சிக்கு,0,0,1,1
47550,χρησιμοποιώ.,0,0,1,1
47549,التعريف,0,0,1,1
47548,всемирная,0,0,1,1
47490,நுபீடியாவை,0,0,1,1
47488,تفعل؟,0,0,1,1
50122,twijfel,0,0,1,1
47433,ಸಹೋದರಿ,0,0,1,1
47427,améliorez,0,0,1,1
47428,കാണപ്പെടും,0,0,1,1
47429,турист,0,0,1,1
47430,d'annoncer,0,0,1,1
47431,desbloqueada,0,0,1,1
50120,للحظة.,0,0,1,1
47434,अधिकारिक,0,0,1,1
47425,टाइम,0,0,1,1
47435,gmt.,0,0,1,1
47436,soruyu,0,0,1,1
47437,découvertes ».,0,0,1,1
47438,reichtum,0,0,1,1
50119,descobertas,0,0,1,1
47440,olvide,0,0,1,1
47426,لطلب,0,0,1,1
47424,பிரிந்து,0,0,1,1
47487,கட்டுரைகளை,0,0,1,1
47412,kritikere,0,0,1,1
47402,atmosphériques,0,0,1,1
47403,=||was||,0,0,1,1
47404,frankrijk,0,0,1,1
47406,ಹೊಂದಿದ್ದರೆ,0,0,1,1
47407,градусов.,0,0,1,1
47408,അനുമതി,0,0,1,1
47414,naturel.,0,0,1,1
50121,wikilibros,0,0,1,1
47415,вандализму,0,0,1,1
47416,الأحياء.,0,0,1,1
47417,النظر.,0,0,1,1
47418,violés,0,0,1,1
47420,historiadores...,0,0,1,1
47421,بدوا,0,0,1,1
50118,μιλώντας,0,0,1,1
47442,inconsistencias​,0,0,1,1
50117,வரையறை,0,0,1,1
47475,ikisinin,0,0,1,1
47468,hébergeur,0,0,1,1
47470,cümleye,0,0,1,1
47471,nature‏,0,0,1,1
47472,materializó,0,0,1,1
50111,செல்வேன்,0,0,1,1
50110,samtalet,0,0,1,1
47476,multas,0,0,1,1
47444,सेवानिवृत्त,0,0,1,1
47478,meertalige,0,0,1,1
47480,vicente,0,0,1,1
47481,συνάντηση.,0,0,1,1
47483,പാടുപെട്ട,0,0,1,1
50109,πληροφορίες.,0,0,1,1
50108,higher-level,0,0,1,1
47467,ஐபி,0,0,1,1
50112,आते,0,0,1,1
47466,rituals,0,0,1,1
47463,ಆಶ್ಚರ್ಯಚಕಿತರಾದರು,0,0,1,1
47461,ينسى,0,0,1,1
47460,palacio,0,0,1,1
50113,മനസിലാക്കുകയും,0,0,1,1
47459,marcadas,0,0,1,1
47456,ofensivos,0,0,1,1
47454,kaputt,0,0,1,1
50114,eleştirmiştir.,0,0,1,1
47452,സഹായിക്കുന്നതിൽ,0,0,1,1
47450,रीडायरेक्शन.,0,0,1,1
47449,synnerhet,0,0,1,1
50115,verilmez,0,0,1,1
50116,croire,0,0,1,1
47445,şeklinde,0,0,1,1
47222,recognizing,0,0,1,1
47219,nonliving,0,0,1,1
48309,النص,0,0,1,1
46969,tillförlitlighet.,0,0,1,1
50189,ativos.,0,0,1,1
46964,പിടിച്ചില്ലെന്ന്,0,0,1,1
46965,medlemmarna,0,0,1,1
46966,കണ്ട,0,0,1,1
46967,असमर्थ,0,0,1,1
46968,forfærdelse,0,0,1,1
46970,dvs.,0,0,1,1
46958,demography,0,0,1,1
50187,объекта,0,0,1,1
46972,صباح,0,0,1,1
50186,recognizes,0,0,1,1
46974,daarvan,0,0,1,1
46976,ಹ್ಯಾಂಗ್,0,0,1,1
46980,വിക്കിപീഡിയകളിൽ,0,0,1,1
46959,instant,0,0,1,1
46957,системным,0,0,1,1
46935,disminuir,0,0,1,1
46944,كلاسيكية,0,0,1,1
46938,множества,0,0,1,1
50190,φτωχή,0,0,1,1
46940,creator,0,0,1,1
46941,warten,0,0,1,1
46942,publicités.,0,0,1,1
46943,ತಿನ್ನುವ,0,0,1,1
46945,എന്താണെന്ന,0,0,1,1
46955,способа,0,0,1,1
46948,esloveno,0,0,1,1
46949,ಸಾಗುವುದು,0,0,1,1
46950,поверить,0,0,1,1
46951,“பி.எச்.பி.”,0,0,1,1
46953,ನಂಬಲು,0,0,1,1
46954,ضخمة,0,0,1,1
46981,கிளாசிக்கல்,0,0,1,1
50184,insulte,0,0,1,1
46983,vocabulary.,0,0,1,1
50181,задумывалась,0,0,1,1
50183,മീ,0,0,1,1
47015,gratuite,0,0,1,1
47016,särskilda,0,0,1,1
47018,tekrarlamanız,0,0,1,1
47019,s'étend,0,0,1,1
47020,behandelt.,0,0,1,1
47022,implementará,0,0,1,1
46985,περιέγραφε,0,0,1,1
47024,للغد؟,0,0,1,1
47025,range.,0,0,1,1
47026,schleppend,0,0,1,1
47027,ஒன்றுசேர்ந்து,0,0,1,1
47028,чувство,0,0,1,1
47029,inconsistencias,0,0,1,1
47014,विश्वास,0,0,1,1
47012,d'arbitrage,0,0,1,1
47011,തുടർന്നുള്ള,0,0,1,1
47010,diante.,0,0,1,1
47006,τόπο,0,0,1,1
47005,बच्चा,0,0,1,1
47004,وإصلاحه,0,0,1,1
47003,informatie.,0,0,1,1
47001,förvirra,0,0,1,1
47000,घोंघे,0,0,1,1
46999,fließende,0,0,1,1
46997,مستقلة,0,0,1,1
46995,புயல்,0,0,1,1
46993,холодно,0,0,1,1
46988,mm.,0,0,1,1
46987,പോകുക.,0,0,1,1
46986,يصفون,0,0,1,1
46936,الجنسين،,0,0,1,1
46934,സ്റ്റാൾമാൻ,0,0,1,1
47035,kretsar,0,0,1,1
46876,прощание,0,0,1,1
46870,chamber.,0,0,1,1
46871,weinst,0,0,1,1
50198,форме.,0,0,1,1
46873,concentre,0,0,1,1
46874,सीखें,0,0,1,1
46875,ζητήσω,0,0,1,1
46877,வாக்கெடுப்பும்,0,0,1,1
46867,esclareceu,0,0,1,1
46880,inclusionism.,0,0,1,1
46881,veria.,0,0,1,1
46882,തുല്യമായ,0,0,1,1
46883,وكذلك,0,0,1,1
46884,sociobiologie,0,0,1,1
50197,അതിശയകരമായി,0,0,1,1
46869,placeholder,0,0,1,1
46866,ബാങ്കിന്റെ,0,0,1,1
46933,πιστέψω,0,0,1,1
46855,rastrear,0,0,1,1
46846,gebrek,0,0,1,1
46850,strip,0,0,1,1
46851,periodísticos,0,0,1,1
46852,കരച്ചിലും,0,0,1,1
46853,introduced.,0,0,1,1
46854,fangst-,0,0,1,1
46856,المشكلات,0,0,1,1
46865,söylediğinizi,0,0,1,1
46857,kæmpe,0,0,1,1
46858,أشهر.,0,0,1,1
46859,wiki-based,0,0,1,1
46862,dilbert,0,0,1,1
50200,шутите,0,0,1,1
50199,verificáveis.,0,0,1,1
46887,ಹುಡುಕುತ್ತಿದ್ದೇವೆ,0,0,1,1
46888,formulated,0,0,1,1
46889,مبنية,0,0,1,1
46920,betonen,0,0,1,1
50193,conduct,0,0,1,1
46914,politici,0,0,1,1
46915,asombroso.,0,0,1,1
46916,davranış,0,0,1,1
50192,wik-ee-pee-dee-ə,0,0,1,1
46919,bem-vindo.,0,0,1,1
46921,boon,0,0,1,1
46891,وربما,0,0,1,1
50191,artig,0,0,1,1
46924,இருக்கிறோம்.,0,0,1,1
46925,néanmoins,0,0,1,1
46928,milyonlarca,0,0,1,1
46929,olacaktır.,0,0,1,1
46930,بإصدارات,0,0,1,1
46912,amusante,0,0,1,1
46911,nep-beller,0,0,1,1
46910,അവളെ,0,0,1,1
50194,pasaran,0,0,1,1
46907,கற்றலைத்,0,0,1,1
46906,upphov,0,0,1,1
46905,okuyorum,0,0,1,1
50195,insultantes,0,0,1,1
46903,polarisering,0,0,1,1
46902,വിരോധാഭാസം,0,0,1,1
46901,ശൈലിയും,0,0,1,1
46898,ஒருவகை,0,0,1,1
46896,εγκυκλοπαίδεια»,0,0,1,1
46895,ஆவர்.,0,0,1,1
46894,natur,0,0,1,1
46893,idéologique,0,0,1,1
46892,apparut,0,0,1,1
50180,minangkabau,0,0,1,1
47036,tries,0,0,1,1
47217,ವಿರೋಧಾತ್ಮಕ,0,0,1,1
47171,«подписаться»,0,0,1,1
47161,ikisinde,0,0,1,1
47165,shooting,0,0,1,1
47166,ಮಾಡುತ್ತಿದ್ದೀಯಾ,0,0,1,1
47167,programmers,0,0,1,1
47168,ಒಪ್ಪಿಕೊಂಡರೆ,0,0,1,1
47170,നായ,0,0,1,1
50157,كم,0,0,1,1
47158,endowment,0,0,1,1
47172,pleasure.,0,0,1,1
47174,वेल्श,0,0,1,1
47175,grubu,0,0,1,1
47176,backgrounds,0,0,1,1
47177,வழிமுறைகள்,0,0,1,1
50156,британской,0,0,1,1
47159,luego.,0,0,1,1
47157,कैदियों,0,0,1,1
47132,level.,0,0,1,1
50161,estaria,0,0,1,1
47134,وسأراكم,0,0,1,1
50162,yiyemiyorsan,0,0,1,1
47140,ഇതൊക്കെ,0,0,1,1
47141,« à,0,0,1,1
47143,понравится,0,0,1,1
47144,قل.,0,0,1,1
47147,renaissance,0,0,1,1
47156,can.,0,0,1,1
47148,retirer,0,0,1,1
47149,had.,0,0,1,1
47152,demandantes,0,0,1,1
47153,narcissen,0,0,1,1
47154,invested.,0,0,1,1
47155,جمالها,0,0,1,1
50155,sides.,0,0,1,1
47179,tanıyorsunuz,0,0,1,1
50154,jerarquía,0,0,1,1
47208,нравится.,0,0,1,1
47201,повторите.,0,0,1,1
47203,oätligt,0,0,1,1
47204,agreeing,0,0,1,1
47205,estrechamente,0,0,1,1
47206,ആൾക്കാരെ,0,0,1,1
50146,καν,0,0,1,1
47209,إخطاره,0,0,1,1
47183,'dir.,0,0,1,1
47210,выражается,0,0,1,1
47211,иной,0,0,1,1
47212,ചെയ്യുന്നതിനെ,0,0,1,1
47213,прав.,0,0,1,1
47214,പുലർത്തുക.,0,0,1,1
50145,குறியீட்டு,0,0,1,1
50148,ट्रांसक्लुजन,0,0,1,1
50150,select,0,0,1,1
50151,लाडिनो,0,0,1,1
47198,важную,0,0,1,1
47197,traditionella,0,0,1,1
47196,evrimi,0,0,1,1
47195,يرتدي,0,0,1,1
47194,associé,0,0,1,1
47193,لويكيبيديا...,0,0,1,1
47192,fonctionne,0,0,1,1
47190,källförteckningen,0,0,1,1
47189,ಪ್ರಶಂಸಿಸುತ್ತೇನೆ.,0,0,1,1
47188,अन्तरजाल,0,0,1,1
47187,residências,0,0,1,1
47186,unreadable,0,0,1,1
47185,кукла,0,0,1,1
47184,inéluctablement,0,0,1,1
47133,batırdım,0,0,1,1
47130,schönsten,0,0,1,1
47037,l’entrainement,0,0,1,1
47079,ನಿಲ್ಲಿಸಬಹುದೇ,0,0,1,1
47069,ഉറപ്പാക്കുക.,0,0,1,1
47072,dialecten,0,0,1,1
47073,مباشرة,0,0,1,1
47074,കരുതി.,0,0,1,1
47075,частому,0,0,1,1
50175,يقتصر,0,0,1,1
47080,identifie,0,0,1,1
47063,schrijfsters.,0,0,1,1
47081,lentes,0,0,1,1
47082,சொல்லிக்,0,0,1,1
47083,επιτύχει,0,0,1,1
47084,descobrem,0,0,1,1
47085,nachdem,0,0,1,1
50174,ആരംഭിച്ചത്‌.,0,0,1,1
47068,interfaces,0,0,1,1
47062,acción,0,0,1,1
50167,جنو/لينكس.,0,0,1,1
47048,ألف,0,0,1,1
47039,dbpedia,0,0,1,1
47040,ನಾಯಿ,0,0,1,1
47042,entretanto,0,0,1,1
47045,بالتعب,0,0,1,1
50178,själv.,0,0,1,1
47047,assar,0,0,1,1
47054,الأيديولوجية,0,0,1,1
47061,होनी,0,0,1,1
47055,narcisini,0,0,1,1
47056,конкретным,0,0,1,1
47057,unter,0,0,1,1
47058,ശബ്‌ദം,0,0,1,1
50177,للمشاركة,0,0,1,1
47060,utilisateurs.,0,0,1,1
50173,लेन,0,0,1,1
47086,propia[nota,0,0,1,1
47087,يفعل,0,0,1,1
50169,câncer,0,0,1,1
47108,reunião,0,0,1,1
47110,ഉണ്ടായില്ല.,0,0,1,1
50171,atteinte,0,0,1,1
47113,فوجئت,0,0,1,1
47114,предварительной,0,0,1,1
47115,திறமூல,0,0,1,1
50168,тех,0,0,1,1
47088,الكيميائية،,0,0,1,1
47119,للغاية.,0,0,1,1
47120,சொல்வதாகவும்,0,0,1,1
47121,bewijst,0,0,1,1
47122,करूँगा,0,0,1,1
47123,émergeant,0,0,1,1
47124,സ്വപ്നമായിരുന്നു,0,0,1,1
47107,guild,0,0,1,1
47106,ಆಶ್ಚರ್ಯ,0,0,1,1
47105,multi-cellular,0,0,1,1
47104,agricultural,0,0,1,1
47103,أعطى,0,0,1,1
47102,culturelles,0,0,1,1
50172,абстрактного,0,0,1,1
47101,tang,0,0,1,1
47099,verbose,0,0,1,1
47098,aldığı,0,0,1,1
47097,المتناقضة,0,0,1,1
47096,സംബന്ധിച്ചിടത്തോളം,0,0,1,1
47094,menschen,0,0,1,1
47093,шекмана,0,0,1,1
47092,ಪದಗಳಿವೆ,0,0,1,1
47090,sorprendida,0,0,1,1
47089,mjölstädarna,0,0,1,1
47585,derslerimi,0,0,1,1
47586,contribuições.,0,0,1,1
47587,piecemeal,0,0,1,1
48072,griffith,0,0,1,1
48063,estimate,0,0,1,1
48065,шекман,0,0,1,1
48067,hollanda'nın,0,0,1,1
48068,pflanzen,0,0,1,1
48069,tryckta,0,0,1,1
48071,yoktur,0,0,1,1
48073,ഉച്ചഭക്ഷണത്തിന്,0,0,1,1
48061,açıdır,0,0,1,1
48076,നിങ്ങളോടൊപ്പം,0,0,1,1
48077,non-sexual,0,0,1,1
48079,октябрь,0,0,1,1
48080,magnetic,0,0,1,1
48081,motion.,0,0,1,1
48084,boğulma,0,0,1,1
48062,unterhaltung,0,0,1,1
50020,очевидной.,0,0,1,1
48036,stumpfer,0,0,1,1
48049,guys.,0,0,1,1
48039,ωθεί,0,0,1,1
50021,dormait,0,0,1,1
48045,अभिवादन,0,0,1,1
48046,காணமுடியும்.,0,0,1,1
48047,religieux,0,0,1,1
48048,bienvenue.,0,0,1,1
48052,kommentieren,0,0,1,1
48059,உருவாக்கியிருப்பர்.,0,0,1,1
48053,adéquat,0,0,1,1
48054,commencer,0,0,1,1
48055,wollen.,0,0,1,1
48056,assurer,0,0,1,1
48057,numérique.,0,0,1,1
48058,allemagne,0,0,1,1
48089,எங்காவது,0,0,1,1
48091,stimme,0,0,1,1
48092,gouvernée,0,0,1,1
50016,ಅಡ್ಡಿಪಡಿಸುವುದು.,0,0,1,1
48117,märkspråken,0,0,1,1
48118,ثانية,0,0,1,1
48119,сомнений,0,0,1,1
48120,வழமையான,0,0,1,1
48123,hr •,0,0,1,1
48124,es-tu,0,0,1,1
48127,présentés,0,0,1,1
48094,പരിഭ്രാന്തരായി.,0,0,1,1
48128,verkeerde,0,0,1,1
48129,stresses,0,0,1,1
48130,بأدب.,0,0,1,1
48131,российскую,0,0,1,1
48133,qualité[h].,0,0,1,1
48134,αυτούς.,0,0,1,1
48115,proprietário,0,0,1,1
48114,diverge,0,0,1,1
48113,கூறும்போது,0,0,1,1
48108,kann.,0,0,1,1
48107,ಸುದ್ದಿಯಲ್ಲಿ,0,0,1,1
48106,அவற்றை,0,0,1,1
48105,ವಾರ,0,0,1,1
48104,l'impossibilité,0,0,1,1
48103,технология,0,0,1,1
48102,स्वामित्व,0,0,1,1
48101,baserat,0,0,1,1
48100,suppressions,0,0,1,1
48099,.the,0,0,1,1
48098,wik-ee-,0,0,1,1
48097,lief,0,0,1,1
48096,rangeret,0,0,1,1
48095,preciosas,0,0,1,1
50022,außergewöhnlich,0,0,1,1
48035,λογισμικό,0,0,1,1
50015,tentar,0,0,1,1
47978,censure »,0,0,1,1
47968,wish,0,0,1,1
50029,samspel,0,0,1,1
47972,droite,0,0,1,1
47973,വിക്കിപീഡിയയ്ക്ക്,0,0,1,1
47975,yakalanma,0,0,1,1
50028,desperté,0,0,1,1
50027,accesses.,0,0,1,1
50030,ännu,0,0,1,1
47979,процесс,0,0,1,1
47980,jämförelse,0,0,1,1
47981,ഹോം,0,0,1,1
47982,συστηματική,0,0,1,1
47984,«лучшую,0,0,1,1
47985,tirasse,0,0,1,1
47967,لتعانق,0,0,1,1
47966,brugernavne.,0,0,1,1
48033,görs.,0,0,1,1
47956,ലഭിച്ചുവെന്ന്,0,0,1,1
47944,الرائحة,0,0,1,1
50035,tarihindeki,0,0,1,1
47949,tolerance,0,0,1,1
47950,картофеля,0,0,1,1
47953,autorisés,0,0,1,1
50034,എഞ്ചിനിയർ,0,0,1,1
47957,ಸಭೆಯ,0,0,1,1
47965,результатов,0,0,1,1
50032,qualité »[ab],0,0,1,1
47959,buurt,0,0,1,1
47960,относился,0,0,1,1
47961,أمام,0,0,1,1
47963,invocadas,0,0,1,1
47964,рекламу,0,0,1,1
47986,sardenberg,0,0,1,1
47987,ವೀಡಿಯೊ,0,0,1,1
47988,brödbröd,0,0,1,1
48021,പരീക്ഷകൾ,0,0,1,1
48015,அரண்மனையில்,0,0,1,1
48016,затоплен,0,0,1,1
48017,yapamayacak,0,0,1,1
48018,laissant,0,0,1,1
48019,устарел,0,0,1,1
48020,işaretiyle,0,0,1,1
48022,« wikipédia,0,0,1,1
47990,பயன்பாட்டுக்கு,0,0,1,1
48023,game.,0,0,1,1
48026,érasme,0,0,1,1
50023,ಇನ್ನಷ್ಟು,0,0,1,1
48029,രേഖീയസമവാക്യമായിരിക്കണോ,0,0,1,1
48031,cunhou,0,0,1,1
48032,adaptable,0,0,1,1
48014,медиафайлы,0,0,1,1
48013,llegada,0,0,1,1
48010,آداب,0,0,1,1
48009,استطلاع,0,0,1,1
48006,ocasionais,0,0,1,1
48005,karmaşa,0,0,1,1
48003,பயன்படுத்துவீர்கள்.,0,0,1,1
48002,barnet.,0,0,1,1
48001,woke,0,0,1,1
48000,merely,0,0,1,1
47999,dérangerait,0,0,1,1
47997,سارت,0,0,1,1
47996,الاقتصاد,0,0,1,1
47995,организации,0,0,1,1
47994,deep.,0,0,1,1
47993,offers.,0,0,1,1
47991,inclut,0,0,1,1
48135,imprecisas,0,0,1,1
48137,لمواقع,0,0,1,1
47588,başlıklı,0,0,1,1
48262,haline,0,0,1,1
48255,உருவாக்குகிறது.,0,0,1,1
48256,letão,0,0,1,1
48259,zout,0,0,1,1
48261,للإشارة,0,0,1,1
49994,நாசீஸை,0,0,1,1
49993,ಭಾವಿಸಿದೆ.,0,0,1,1
48263,ಅತ್ಯಾಧುನಿಕ,0,0,1,1
48252,globe,0,0,1,1
48265,വിവരിക്കുമ്പോൾ,0,0,1,1
48266,disons,0,0,1,1
48267,учётом,0,0,1,1
49992,задача,0,0,1,1
48268,troca,0,0,1,1
48269,öppnades,0,0,1,1
48254,доставляют,0,0,1,1
49995,decisive,0,0,1,1
48232,privada,0,0,1,1
48242,hemmelighedsfuldt,0,0,1,1
48235,eserler,0,0,1,1
48236,ಹೇಳಿದರು.,0,0,1,1
48237,περιθώριο,0,0,1,1
48238,fewer,0,0,1,1
48239,முடிவு.,0,0,1,1
49998,garantia,0,0,1,1
48244,എന്നതിൻറെ,0,0,1,1
49996,necesito,0,0,1,1
48245,ഗ്രഹങ്ങളിൽ,0,0,1,1
48246,antecedência.,0,0,1,1
48247,точек,0,0,1,1
48248,hungrig.,0,0,1,1
48250,helpful,0,0,1,1
49997,inşa,0,0,1,1
48271,لكني,0,0,1,1
48272,idari,0,0,1,1
49991,المطاف.,0,0,1,1
49981,trans,0,0,1,1
48297,vocabulaire.,0,0,1,1
48298,deforestation,0,0,1,1
48299,étymologie,0,0,1,1
48300,തിരക്കിലാണ്,0,0,1,1
49982,potentiellement,0,0,1,1
48302,செய்வதாகவும்,0,0,1,1
48303,opérateur,0,0,1,1
49990,engendré,0,0,1,1
48304,εκείνο,0,0,1,1
48305,hayallerindeki,0,0,1,1
48306,ಬಳಸಲು.,0,0,1,1
48307,टाडिक,0,0,1,1
49980,تنافسية,0,0,1,1
48308,qu'apparent,0,0,1,1
48296,κοιμόταν,0,0,1,1
48295,trafik.,0,0,1,1
48293,​​dem.,0,0,1,1
48292,vast,0,0,1,1
48291,употребить,0,0,1,1
48290,landen.,0,0,1,1
48289,diacrítico,0,0,1,1
48287,сервере,0,0,1,1
48286,sunuş,0,0,1,1
48285,നിങ്ങളെപ്പോലെ,0,0,1,1
48284,söylemesi,0,0,1,1
48282,wikipedianerna,0,0,1,1
48281,കർത്തവ്യം,0,0,1,1
49984,exagerar.,0,0,1,1
49985,подбодритесь,0,0,1,1
48276,വിക്കിപീഡിയയിലുണ്ടാകാറുണ്ട്.,0,0,1,1
49989,समविष्टि,0,0,1,1
48233,travail »,0,0,1,1
48231,базу,0,0,1,1
48138,ജീവനും,0,0,1,1
48166,προτάσεις.,0,0,1,1
50010,വസ്തുതകളിലൂന്നിയുള്ള,0,0,1,1
48161,årlig,0,0,1,1
48162,أعلن,0,0,1,1
48163,gemeenschap.,0,0,1,1
48164,يقارب,0,0,1,1
48165,€.,0,0,1,1
48168,ತೊರೆಯುತ್ತಿದ್ದೇನೆ,0,0,1,1
48158,snabbt.,0,0,1,1
48169,السجون,0,0,1,1
48171,müthiş,0,0,1,1
48172,touch.,0,0,1,1
50007,kommunikation,0,0,1,1
48174,லிப்ரேவை,0,0,1,1
48176,കഠിനമായ,0,0,1,1
50011,çevrilmiş,0,0,1,1
48155,straight,0,0,1,1
48228,mechanisms,0,0,1,1
50012,التسويف,0,0,1,1
48139,« un,0,0,1,1
48140,மனிதர்,0,0,1,1
48142,sûrement,0,0,1,1
48143,milletin,0,0,1,1
48144,salienta,0,0,1,1
48145,издаётся,0,0,1,1
48147,perigosos.,0,0,1,1
48154,опубликовали,0,0,1,1
48148,യന്ത്രത്തെ,0,0,1,1
48149,minimiza,0,0,1,1
48150,σήμα,0,0,1,1
48151,استخدامه,0,0,1,1
48152,ब्रिटन,0,0,1,1
48153,proyecto​,0,0,1,1
48177,vandallamalarına,0,0,1,1
48182,sänkte,0,0,1,1
50004,pests,0,0,1,1
48216,voorzien.,0,0,1,1
48204,വന്ന,0,0,1,1
48205,экспертной,0,0,1,1
48206,arabasına,0,0,1,1
48209,accredited,0,0,1,1
50000,avaliação,0,0,1,1
48212,mathe-hausaufgaben,0,0,1,1
48219,ενοχλητικής,0,0,1,1
48185,الاصطناعي,0,0,1,1
48220,അത്തരത്തിൽ,0,0,1,1
48221,manifeste,0,0,1,1
48222,καφέ,0,0,1,1
48223,صحيح.,0,0,1,1
48225,വാക്കിന്,0,0,1,1
48227,ineffektivt,0,0,1,1
48203,δύο.,0,0,1,1
48202,أخطط,0,0,1,1
48201,seguido,0,0,1,1
50001,d'apprendre.,0,0,1,1
48199,counts.,0,0,1,1
48197,अंतरों,0,0,1,1
48195,artículos»,0,0,1,1
48194,kinderen,0,0,1,1
48192,لكم,0,0,1,1
48191,frokost,0,0,1,1
48190,польская,0,0,1,1
48189,nylige,0,0,1,1
48188,μιλήσει,0,0,1,1
48187,समितियां,0,0,1,1
50002,редакторами,0,0,1,1
50003,altında,0,0,1,1
48186,diversiteit,0,0,1,1
47943,¿me,0,0,1,1
47941,முழுமையானது,0,0,1,1
50036,frequente,0,0,1,1
47707,इंडीपेनडेंस.,0,0,1,1
47699,أوراق,0,0,1,1
47701,viu,0,0,1,1
50073,эпизод,0,0,1,1
47703,aggregate,0,0,1,1
47704,милыми,0,0,1,1
50072,extraheren,0,0,1,1
47709,upptäckas.,0,0,1,1
47697,பூட்டப்பட்டு,0,0,1,1
50071,svært,0,0,1,1
47711,conferencista,0,0,1,1
47714,டிசம்பர்,0,0,1,1
47715,introducen,0,0,1,1
47717,postgresql,0,0,1,1
47718,μακριά,0,0,1,1
47698,diferenciación,0,0,1,1
47696,كوب,0,0,1,1
50075,emitidos,0,0,1,1
47687,reflejo,0,0,1,1
47678,läsbarhet,0,0,1,1
47679,stoppade,0,0,1,1
47681,amostragem,0,0,1,1
47682,participe,0,0,1,1
47685,क्लिफ्फोर्ड,0,0,1,1
47686,गाँव,0,0,1,1
50074,أدخلت,0,0,1,1
47695,ateliers,0,0,1,1
47688,beneficial,0,0,1,1
47690,गुणधर्मों,0,0,1,1
47691,കാണുന്നു,0,0,1,1
47692,персоналом,0,0,1,1
47693,показали,0,0,1,1
47694,பெயரும்,0,0,1,1
50070,подтверждения,0,0,1,1
47720,ಹೊರಟರು,0,0,1,1
47721,ayuda,0,0,1,1
50062,குறுக்கிடுகிறது.,0,0,1,1
47750,ಕಾಮೆಂಟ್,0,0,1,1
47751,policy-,0,0,1,1
50063,സ്കോർ,0,0,1,1
47752,qualified,0,0,1,1
47753,അർഹതയുണ്ടെന്ന്,0,0,1,1
47754,levende.,0,0,1,1
47756,deliberately,0,0,1,1
47727,toegankelijk,0,0,1,1
50061,continuent,0,0,1,1
47758,non-fiction,0,0,1,1
47759,пределах,0,0,1,1
47760,stöd,0,0,1,1
50060,essentielles,0,0,1,1
47761,naturelle,0,0,1,1
47749,शैलीगत,0,0,1,1
47748,നിയമവിരുദ്ധരെ,0,0,1,1
47747,ಪಡೆಯುತ್ತಾರೆ,0,0,1,1
47746,« encyclopédie »,0,0,1,1
47745,prévaut,0,0,1,1
50064,jenna,0,0,1,1
50065,ежегодном,0,0,1,1
47742,lesson,0,0,1,1
47741,веб-сервера,0,0,1,1
50066,иракскую,0,0,1,1
47738,άλλως,0,0,1,1
47736,рейтинге,0,0,1,1
47733,ಖಚಿತಪಡಿಸಿಕೊಳ್ಳಿ,0,0,1,1
47731,ഏറെയുണ്ടാകുന്നതുകൊണ്ടുള്ള,0,0,1,1
47730,concernés,0,0,1,1
47729,vidare.,0,0,1,1
47728,eklerler,0,0,1,1
47677,παιδιά.,0,0,1,1
47675,ஓடினாள்,0,0,1,1
47939,ವಿಶ್ವವಿದ್ಯಾನಿಲಯಕ್ಕೆ,0,0,1,1
47615,μοιάζεις,0,0,1,1
47608,alto-falante,0,0,1,1
47609,odası,0,0,1,1
47611,مواضيع,0,0,1,1
47612,новую,0,0,1,1
50091,tid.,0,0,1,1
47614,syfte.,0,0,1,1
47617,yakalamadığını,0,0,1,1
47605,en •,0,0,1,1
47618,ആദ്യശ്രമം,0,0,1,1
50090,அண்மைய,0,0,1,1
50089,«criterios,0,0,1,1
47622,introduzida,0,0,1,1
47623,связаны,0,0,1,1
50088,തത്ത്വം,0,0,1,1
47607,ചെയ്യണമെന്ന്,0,0,1,1
47604,meteorite,0,0,1,1
50077,சொல்கிறேன்,0,0,1,1
47595,இன்பம்.,0,0,1,1
47589,сообщается,0,0,1,1
47590,بالنساء,0,0,1,1
50093,belpictogram,0,0,1,1
47591,الإضافة،,0,0,1,1
47592,enkyklios,0,0,1,1
47593,ക്യാൻസർ,0,0,1,1
47596,എന്നറിയുവാൻ,0,0,1,1
47603,البناء,0,0,1,1
47597,plaques,0,0,1,1
47598,лично,0,0,1,1
50092,बनाना,0,0,1,1
47600,agrawal,0,0,1,1
47601,d'identifier,0,0,1,1
47602,पड़ाव,0,0,1,1
47625,நடித்த,0,0,1,1
47626,transmitir,0,0,1,1
47627,августе,0,0,1,1
50080,onglets,0,0,1,1
47657,equivocado,0,0,1,1
47658,негибко,0,0,1,1
50082,parlamentar,0,0,1,1
47659,ആരംഭിക്കാൻ,0,0,1,1
47661,ಪ್ರವಾಹ,0,0,1,1
47662,consideration,0,0,1,1
47666,വിഷയത്തെപ്പറ്റി,0,0,1,1
47629,സൗകര്യം,0,0,1,1
47667,répétition.,0,0,1,1
47668,κάπως,0,0,1,1
47669,ತೆಗೆದುಕೊಳ್ಳುತ್ತೇನೆ.,0,0,1,1
47670,delante,0,0,1,1
50079,серьёзно,0,0,1,1
50078,darwin.,0,0,1,1
47655,canadá,0,0,1,1
47653,улыбнуться,0,0,1,1
50083,minut,0,0,1,1
47650,ومعظم,0,0,1,1
47648,ingenting,0,0,1,1
47647,tendent,0,0,1,1
47646,изумрудов,0,0,1,1
47644,अफ़्रीकान्स,0,0,1,1
47642,أندريا,0,0,1,1
47641,фильмов.,0,0,1,1
50085,particles.,0,0,1,1
47639,keken,0,0,1,1
47637,kingdoms.,0,0,1,1
47636,தொடங்கினாள்,0,0,1,1
47635,vueltas,0,0,1,1
47634,affamé,0,0,1,1
47631,grattis,0,0,1,1
47762,يظن,0,0,1,1
47763,weggestuurd,0,0,1,1
47764,conversely,0,0,1,1
47881,മര്യാദയുള്ള,0,0,1,1
47863,multicamadas,0,0,1,1
47864,izliyorsunuz.,0,0,1,1
47868,आइसक्रीम,0,0,1,1
47870,reversores,0,0,1,1
47877,العد،,0,0,1,1
47880,nose,0,0,1,1
47882,கண்கள்.,0,0,1,1
47861,φοβισμένος,0,0,1,1
47883,savoirs.,0,0,1,1
47884,ακούστε,0,0,1,1
47885,honored,0,0,1,1
47886,നിർജീവമാണ്.,0,0,1,1
47887,ಹಾದುಹೋಗಬಹುದು.,0,0,1,1
47889,allégorique.,0,0,1,1
47862,написанный,0,0,1,1
47859,nachmittags,0,0,1,1
47765,criminal,0,0,1,1
47849,gjord,0,0,1,1
47841,weed,0,0,1,1
47842,മനസ്സിലായി.,0,0,1,1
47843,décompté,0,0,1,1
47845,digestive,0,0,1,1
50041,واسع,0,0,1,1
47848,icke-hierarkisk,0,0,1,1
47850,interrumpiendo,0,0,1,1
50038,चुवाश,0,0,1,1
50040,الانهيار,0,0,1,1
50039,offensantes,0,0,1,1
47853,للتسجيل,0,0,1,1
47854,അടുത്തത്‌.,0,0,1,1
47855,divergem,0,0,1,1
47856,pugilat,0,0,1,1
47891,apparence.,0,0,1,1
47892,matando,0,0,1,1
47893,géologiques,0,0,1,1
47930,molecular,0,0,1,1
47920,darunter,0,0,1,1
47921,ಕಳುಹಿಸಿದ್ದೀರಿ,0,0,1,1
47922,dependência,0,0,1,1
47925,கலாச்சார,0,0,1,1
47926,pseudovetenskap.,0,0,1,1
47929,വരുത്തുന്നു.,0,0,1,1
47931,σχολιάστε,0,0,1,1
47894,ಸೆಲ್,0,0,1,1
47932,presumiblemente,0,0,1,1
47933,உள்ளடக்க,0,0,1,1
47934,cooled,0,0,1,1
50037,parisien,0,0,1,1
47937,incidenter,0,0,1,1
47938,«администратора»,0,0,1,1
47919,определённым,0,0,1,1
47917,முறைமை,0,0,1,1
47916,meewerken,0,0,1,1
47915,இரண்டாம்,0,0,1,1
47913,ಇಂಗ್ಲಿಷ್ನಲ್ಲಿ,0,0,1,1
47912,adams.,0,0,1,1
47911,குழப்பத்தில்,0,0,1,1
47909,ತಿಳಿದಿರಬೇಕು.,0,0,1,1
47908,sådant,0,0,1,1
47907,политикам,0,0,1,1
47906,സന്ദേശങ്ങളിൽ,0,0,1,1
47905,централизованного,0,0,1,1
47899,impresionante,0,0,1,1
47898,bereikbaar,0,0,1,1
47897,أسوأ,0,0,1,1
47896,north-east,0,0,1,1
47895,circuits,0,0,1,1
47840,χρησιμοποιήσεις,0,0,1,1
47837,സ്ഥാനമാണ്,0,0,1,1
47836,forfait.,0,0,1,1
47790,giriş,0,0,1,1
50054,clásica,0,0,1,1
47785,இதில்,0,0,1,1
47786,подрывает,0,0,1,1
47787,harías.,0,0,1,1
47788,استيقظت,0,0,1,1
47789,شجع,0,0,1,1
47791,ಇದೆ.,0,0,1,1
47799,irregular​,0,0,1,1
47792,خطأ,0,0,1,1
47793,signo,0,0,1,1
47794,tasty,0,0,1,1
47795,योगदानकर्ता.........ज्ञान,0,0,1,1
47796,realizadas,0,0,1,1
50052,സഞ്ചരിച്ചു,0,0,1,1
47782,løb,0,0,1,1
50055,ചിന്തിക്കാൻ,0,0,1,1
50056,desistindo.,0,0,1,1
47780,tax”,0,0,1,1
47779,unrelated,0,0,1,1
47778,vur.,0,0,1,1
47777,ഉപയോഗിക്കും.,0,0,1,1
47776,கிடப்பேன்,0,0,1,1
50057,സാധ്യമാ‍വുകയുള്ളൂ.,0,0,1,1
47775,desencorajada.,0,0,1,1
47774,ಡಾಲರ್,0,0,1,1
47773,téléversement,0,0,1,1
47772,tool.,0,0,1,1
50059,يفي,0,0,1,1
47769,occurred.,0,0,1,1
47767,авторское,0,0,1,1
47766,abordan,0,0,1,1
47798,وأحيانًا,0,0,1,1
47800,σύνταξη,0,0,1,1
50042,effectués,0,0,1,1
50045,bataklığın,0,0,1,1
47821,muddled,0,0,1,1
47822,ಮುಳುಗಿಸುತ್ತದೆ,0,0,1,1
47823,laugh,0,0,1,1
47824,you'd,0,0,1,1
50046,conseguirá,0,0,1,1
47825,enkäten,0,0,1,1
47827,പഴയ,0,0,1,1
50051,അനുമതി.,0,0,1,1
50044,structurantes,0,0,1,1
47828,amerikalılar,0,0,1,1
47830,पाश्चात्य,0,0,1,1
47831,писатель,0,0,1,1
50043,चुनूंगा,0,0,1,1
47833,wikiconcept.,0,0,1,1
47819,l'interrompre,0,0,1,1
47818,подождать.,0,0,1,1
47817,lacus,0,0,1,1
47816,flaws,0,0,1,1
50047,бора,0,0,1,1
47815,intégralement,0,0,1,1
47814,വാക്യങ്ങൾ,0,0,1,1
50048,والفيتنامية,0,0,1,1
47811,நிறுத்தம்,0,0,1,1
50049,fyre.,0,0,1,1
50050,lenen,0,0,1,1
47809,grundas,0,0,1,1
47808,recientes.,0,0,1,1
47807,dele.,0,0,1,1
47806,व्यवहार,0,0,1,1
47805,funkelnden,0,0,1,1
47803,éternué,0,0,1,1
43797,classique.,0,0,1,1
43795,searches,0,0,1,1
37766,എന്നതുപോലെയല്ല,0,0,1,1
51166,automatique »,0,0,1,1
39773,patiently,0,0,1,1
39774,ದೇವದೂತನಾಗಿದ್ದೇನೆ,0,0,1,1
39775,உருவாக்குதல்.,0,0,1,1
39776,нас,0,0,1,1
51167,уловки-,0,0,1,1
39777,sökning,0,0,1,1
39778,perceptrones,0,0,1,1
39771,മകളേ,0,0,1,1
39779,رابطًا,0,0,1,1
39781,apontam,0,0,1,1
51165,équivaut,0,0,1,1
39783,вероятностью,0,0,1,1
39784,sänkts.,0,0,1,1
39785,ledde,0,0,1,1
39772,προσέχεις.,0,0,1,1
39770,inskränkningar,0,0,1,1
51171,أتفق,0,0,1,1
39761,handwritten,0,0,1,1
39755,notamment.,0,0,1,1
39756,comme.,0,0,1,1
39757,talen.,0,0,1,1
39758,نتيجة,0,0,1,1
39759,تشجيع,0,0,1,1
51169,исключением,0,0,1,1
51168,приехал,0,0,1,1
39769,замка,0,0,1,1
39763,معاداة,0,0,1,1
39764,verse,0,0,1,1
39765,raison ».,0,0,1,1
39766,erasmusprijs,0,0,1,1
39767,λειτουργήσει.,0,0,1,1
39768,болота,0,0,1,1
39787,эпохи,0,0,1,1
39788,глубоко,0,0,1,1
39789,kväll.,0,0,1,1
39822,shopping.,0,0,1,1
39811,сломался,0,0,1,1
51159,കാമുകനോ,0,0,1,1
39815,நம்புகிறேன்.,0,0,1,1
39817,near,0,0,1,1
39819,randomly,0,0,1,1
39821,transcendantalisme,0,0,1,1
39823,بمواصلة,0,0,1,1
39790,изменяющими,0,0,1,1
39825,analyseren.,0,0,1,1
39828,pommes,0,0,1,1
39829,amerikalıların,0,0,1,1
39831,abandoned,0,0,1,1
39832,ഇവ,0,0,1,1
39833,κάποιος.,0,0,1,1
39810,políglota,0,0,1,1
39809,زائر،,0,0,1,1
39808,прямое,0,0,1,1
51160,ന്നിപ്പറയുന്നത്,0,0,1,1
39805,स्कोलरपीडिया,0,0,1,1
39801,بقي,0,0,1,1
39800,pedagogos,0,0,1,1
39799,gelinliğimi,0,0,1,1
51161,ομιλητές,0,0,1,1
39798,родном,0,0,1,1
39797,obscenidade,0,0,1,1
39796,ಪ್ರಾರಂಭಿಸೋಣ.,0,0,1,1
39795,മൂർച്ചയുള്ള,0,0,1,1
39794,övrigt.,0,0,1,1
51162,மகத்தான,0,0,1,1
39792,असफलता,0,0,1,1
39791,sw •,0,0,1,1
51170,ανακάλυψη.,0,0,1,1
39750,главным,0,0,1,1
39836,endorse,0,0,1,1
39693,documentário,0,0,1,1
39685,ಹೊಳಪುಳ್ಳವನಾಗಿದ್ದಾನೆ,0,0,1,1
39688,çalışma,0,0,1,1
39689,inaktiv,0,0,1,1
39690,خادم,0,0,1,1
39691,hacer.,0,0,1,1
39692,yediğim,0,0,1,1
39694,beantworten,0,0,1,1
51177,передаёт,0,0,1,1
51176,cultivated.,0,0,1,1
39696,இழுக்கவும்.,0,0,1,1
39697,cohen,0,0,1,1
39698,verrez,0,0,1,1
39699,استشهدت,0,0,1,1
39701,alacak,0,0,1,1
39682,ಆರಂಭದ,0,0,1,1
39678,mathematics,0,0,1,1
39749,freier,0,0,1,1
39665,filtrering,0,0,1,1
39658,spredt,0,0,1,1
39659,tyvärr,0,0,1,1
39660,credenciales,0,0,1,1
39661,tadım,0,0,1,1
39662,wherein,0,0,1,1
39664,mücevherler,0,0,1,1
39666,والصربية,0,0,1,1
39677,بالغ,0,0,1,1
51178,frön,0,0,1,1
39670,supermarket,0,0,1,1
39671,varié,0,0,1,1
39672,നാണ്‌,0,0,1,1
39675,d'ajuster,0,0,1,1
39676,الخلافات,0,0,1,1
51175,establece,0,0,1,1
39704,​​denne,0,0,1,1
39705,désuets,0,0,1,1
51174,repetitiva.,0,0,1,1
39731,obeying,0,0,1,1
39732,bringe,0,0,1,1
39734,qualifier,0,0,1,1
39738,توم,0,0,1,1
39739,substantial,0,0,1,1
39741,bijdragers,0,0,1,1
39742,compétitif,0,0,1,1
39706,contraditórias,0,0,1,1
51173,graphies,0,0,1,1
39745,ശാസ്ത്രം,0,0,1,1
39746,अचरज,0,0,1,1
39747,கடவுச்சொல்லை,0,0,1,1
39748,usability,0,0,1,1
51172,flummoxte,0,0,1,1
39730,ಚತುರನಾಗಿರುತ್ತೇನೆ,0,0,1,1
39729,agreed,0,0,1,1
39728,konular,0,0,1,1
39727,åh.,0,0,1,1
39726,όνειρά,0,0,1,1
39725,prejuicios,0,0,1,1
39724,separado,0,0,1,1
39722,conotação,0,0,1,1
39721,வெற்றியடையவில்லை.,0,0,1,1
39720,इकलौती,0,0,1,1
39719,लंबे,0,0,1,1
39717,интересно.,0,0,1,1
39716,nossos,0,0,1,1
39713,βάζω,0,0,1,1
39711,വീഡിയോയിലേക്ക്,0,0,1,1
39710,биография,0,0,1,1
39708,ശൈശവാവസ്ഥയിലാണ്.,0,0,1,1
39835,censur,0,0,1,1
39837,aumentarem,0,0,1,1
39655,enkla,0,0,1,1
39960,friedman,0,0,1,1
51139,proposal.,0,0,1,1
39954,ഉദ്ധരിച്ചാണ്,0,0,1,1
39955,aufgehört,0,0,1,1
39957,деятельность,0,0,1,1
39958,pressas,0,0,1,1
39959,d'abonnement,0,0,1,1
39961,copyrights,0,0,1,1
51140,moldar,0,0,1,1
39962,hayvandır.,0,0,1,1
39964,велась,0,0,1,1
39966,aimais,0,0,1,1
39967,carencia,0,0,1,1
39969,डेनियल,0,0,1,1
39970,commander,0,0,1,1
39952,λειτουργίας,0,0,1,1
39950,traduire,0,0,1,1
39924,وإنشاء,0,0,1,1
39935,refinado,0,0,1,1
39927,gaseous,0,0,1,1
39928,تأكل.,0,0,1,1
39929,வேலையைச்,0,0,1,1
39930,கட்டுரைகளிலும்,0,0,1,1
39932,பதிப்பாக,0,0,1,1
51141,хорошего,0,0,1,1
39936,कार्यकारी,0,0,1,1
39947,ഒന്നാം,0,0,1,1
39937,conceptions,0,0,1,1
39940,செய்தாலன்றி,0,0,1,1
39941,paysage.,0,0,1,1
39944,liabilities,0,0,1,1
39945,negatieve,0,0,1,1
39946,άτομο.,0,0,1,1
39971,жестокое,0,0,1,1
39972,وتلحن,0,0,1,1
39973,almadınız,0,0,1,1
40007,suspects,0,0,1,1
40002,vindo,0,0,1,1
40003,española,0,0,1,1
51136,animistes,0,0,1,1
40005,أهلا,0,0,1,1
51135,jeu ,0,0,1,1
51134,nogmaals,0,0,1,1
40008,judea,0,0,1,1
39974,aptitudes,0,0,1,1
40009,الجميل,0,0,1,1
40010,поздравления,0,0,1,1
40011,modos.,0,0,1,1
40012,balcon,0,0,1,1
40013,सोमाली,0,0,1,1
40015,നടുവിലാണ്,0,0,1,1
51137,ordenados,0,0,1,1
39998,ಒಳಗೊಂಡಂತೆ,0,0,1,1
39997,अनगिनत,0,0,1,1
39996,today’s,0,0,1,1
39995,grammar,0,0,1,1
39994,ഉറപ്പാക്കുക,0,0,1,1
39992,recaudación,0,0,1,1
39991,ತಾಯಿಯಾಗಲು,0,0,1,1
39990,балансирующие,0,0,1,1
39989,énergétique,0,0,1,1
39987,gränsen,0,0,1,1
39986,ilustrativa,0,0,1,1
39985,பரந்த,0,0,1,1
39983,köpek,0,0,1,1
39979,çelişkili,0,0,1,1
39976,editó,0,0,1,1
39975,തന്നാൽ,0,0,1,1
39926,vådområde,0,0,1,1
39923,щелкнувший,0,0,1,1
39838,reparieren.,0,0,1,1
39872,gebeurtenissen,0,0,1,1
39865,sont ,0,0,1,1
39866,मुहावरा,0,0,1,1
39867,pologne,0,0,1,1
39868,сообщений,0,0,1,1
51150,technology.,0,0,1,1
39871,discrètes.,0,0,1,1
39873,yeterlilik,0,0,1,1
39861,anthropologie,0,0,1,1
39874,عدة,0,0,1,1
51149,rettelse,0,0,1,1
39875,ಬುದ್ಧಿಹೀನ,0,0,1,1
39876,kunskap,0,0,1,1
39877,yazarı,0,0,1,1
39878,подбодритесь.,0,0,1,1
39863,encyklopedin,0,0,1,1
39860,latines,0,0,1,1
39922,redden,0,0,1,1
39848,ποιότητα,0,0,1,1
39839,മൂക്കും,0,0,1,1
51156,കാലിഫോർണിയയിൽ,0,0,1,1
39842,merit,0,0,1,1
39844,cirka,0,0,1,1
39845,कंटेंट,0,0,1,1
39846,rejettent,0,0,1,1
51155,stirrade,0,0,1,1
39858,sécurité,0,0,1,1
51153,sumaban,0,0,1,1
39853,contacto.,0,0,1,1
39854,leta,0,0,1,1
39855,da •,0,0,1,1
39856,чисто,0,0,1,1
39857,multilayer,0,0,1,1
39879,നഗരത്തിലെ,0,0,1,1
51148,вкусных,0,0,1,1
39881,സാഹചര്യമാണ്,0,0,1,1
39909,بأس.,0,0,1,1
39902,hemmeligt,0,0,1,1
39903,തിരക്കിലാണ്.,0,0,1,1
39905,σαββατοκύριακο.,0,0,1,1
39906,självklart.,0,0,1,1
39907,ಮತ್ತು.,0,0,1,1
39908,praten.,0,0,1,1
39911,βάλτε,0,0,1,1
39883,நினைக்கிறீர்கள்,0,0,1,1
39915,वही,0,0,1,1
39916,خوارزميات,0,0,1,1
39917,فكلمة,0,0,1,1
39919,voie,0,0,1,1
39920,किस्मत,0,0,1,1
39921,embark,0,0,1,1
39901,переплётом.,0,0,1,1
39900,escolar,0,0,1,1
39899,ಸಂಗತಿಗಳು,0,0,1,1
51144,ചെയ്യാത്തത്,0,0,1,1
39898,fylld,0,0,1,1
39897,ಕಣ್ಣುಗಳು,0,0,1,1
39896,القائمون,0,0,1,1
39894,hoeveelheden,0,0,1,1
39893,apresentar,0,0,1,1
51145,сайта ,0,0,1,1
51146,первое.,0,0,1,1
39889,seeds,0,0,1,1
39888,m.fl.,0,0,1,1
39886,распечатал,0,0,1,1
39885,déposé,0,0,1,1
51147,evaluating,0,0,1,1
39884,autoridades,0,0,1,1
39657,मुद्रित,0,0,1,1
39654,грантом,0,0,1,1
40021,billeder,0,0,1,1
39393,информацию».,0,0,1,1
39384,sorrir,0,0,1,1
51216,l’épistémologie,0,0,1,1
39386,bağımsızdır.,0,0,1,1
51212,matière « chaque,0,0,1,1
39391,ಪ್ರಸ್ತಾಪವನ್ನು,0,0,1,1
39392,एनसायक्लोपीडिया,0,0,1,1
39396,thriller,0,0,1,1
39382,aral,0,0,1,1
39397,விரல்கள்,0,0,1,1
39398,நிராகரித்தாள்,0,0,1,1
39400,club.,0,0,1,1
39403,l'empreinte,0,0,1,1
39405,хорошей,0,0,1,1
39406,doğa,0,0,1,1
39383,പൂന്തോട്ടത്തിൽ,0,0,1,1
51217,பேசும்,0,0,1,1
39360,വിക്കിപീഡിയകളിലും,0,0,1,1
39371,ഇസ്രായേൽ-പാലസ്തീൻ,0,0,1,1
39363,அறியப்பட்டிருந்தாலும்,0,0,1,1
39364,«квадрига»,0,0,1,1
39365,δημοτικότητα,0,0,1,1
39366,concreta,0,0,1,1
39367,ಕಳೆದುಕೊಂಡಿದ್ದೇನೆ,0,0,1,1
39369,worldcat,0,0,1,1
39372,ومصداقيتها.,0,0,1,1
51218,periodista,0,0,1,1
39374,простая,0,0,1,1
39376,tafelmanieren,0,0,1,1
51219,klingt.,0,0,1,1
39378,താനും.,0,0,1,1
39379,ಭ್ರಮನಿರಸನಗೊಂಡಿದ್ದೇನೆ,0,0,1,1
39380,الويب.,0,0,1,1
39408,timen.,0,0,1,1
39409,uyuşuk,0,0,1,1
39410,checked,0,0,1,1
39440,سطح,0,0,1,1
39432,வாழ்த்துவதற்கான,0,0,1,1
39433,generalized,0,0,1,1
39436,बुनियादी,0,0,1,1
39437,dağıtılması,0,0,1,1
39438,விளக்க,0,0,1,1
39439,избирательной,0,0,1,1
39441,starta,0,0,1,1
39411,хранятся,0,0,1,1
39442,neşelendirmek,0,0,1,1
39443,featuring,0,0,1,1
39444,danmark,0,0,1,1
39445,الفضل,0,0,1,1
39447,vererek,0,0,1,1
39448,رسالتي,0,0,1,1
51206,பெறுவீர்கள்.,0,0,1,1
39429,adaptado,0,0,1,1
39428,bryter,0,0,1,1
39425,contrôles,0,0,1,1
39424,править ,0,0,1,1
39423,incorporates,0,0,1,1
51208,नॉन-फिक्शन,0,0,1,1
51209,مقال.,0,0,1,1
39422,nyheden.,0,0,1,1
39421,genellikle,0,0,1,1
39420,sufixo,0,0,1,1
39419,echten,0,0,1,1
51210,இன்றுவரை,0,0,1,1
39417,provider,0,0,1,1
39416,población,0,0,1,1
39415,generalizable,0,0,1,1
51211,vervangen,0,0,1,1
39361,விதிமுறைகள்,0,0,1,1
39359,abogaba,0,0,1,1
39451,posicionado,0,0,1,1
39295,consecuentemente,0,0,1,1
39287,beundrende,0,0,1,1
39288,ведётся,0,0,1,1
39289,failures,0,0,1,1
39292,सुझाव।,0,0,1,1
39293,divertidas,0,0,1,1
51229,எடுத்துக்காட்டாக,0,0,1,1
39297,encorajada,0,0,1,1
39285,sänka,0,0,1,1
39298,estábamos.,0,0,1,1
39302,interdisciplinära,0,0,1,1
39304,preservando,0,0,1,1
39307,തെലുഗ്,0,0,1,1
39308,المتدلية,0,0,1,1
39309,நோக்கமாகும்.,0,0,1,1
39286,forgets,0,0,1,1
39283,поездки.,0,0,1,1
39357,incité,0,0,1,1
51232,auktoriteter,0,0,1,1
51235,izlediyseniz.,0,0,1,1
51233,ώρα,0,0,1,1
39265,öğrenelim,0,0,1,1
39266,langweilig.,0,0,1,1
39267,zamandan,0,0,1,1
39270,лицом,0,0,1,1
39273,самого,0,0,1,1
39281,ötesinde,0,0,1,1
39274,améliorez-le,0,0,1,1
39275,موجودة,0,0,1,1
39276,incorrectas,0,0,1,1
39277,hänvisningar,0,0,1,1
39279,вероятностей,0,0,1,1
39280,proliferation,0,0,1,1
39312,envió,0,0,1,1
39313,நிர்வாகக்,0,0,1,1
39314,رفضتهم,0,0,1,1
39344,générales,0,0,1,1
39338,والصينية،,0,0,1,1
39340,ഘട്ടം,0,0,1,1
39341,acted.,0,0,1,1
51223,helped,0,0,1,1
39342,ನೀಡಲಾಗುತ್ತದೆ.,0,0,1,1
39343,அகங்காரமான,0,0,1,1
39346,gente.,0,0,1,1
39315,παραδοσιακές,0,0,1,1
39347,agreement,0,0,1,1
39348,उपस्थिति,0,0,1,1
39350,pará-lo,0,0,1,1
39351,формируемого,0,0,1,1
39355,stuff,0,0,1,1
39356,júri,0,0,1,1
39336,മാന്യമായി,0,0,1,1
39335,للمساهمة,0,0,1,1
39334,ഉപയോഗിച്ചാൽ,0,0,1,1
39333,financiero,0,0,1,1
39332,consequently,0,0,1,1
51225,dördü,0,0,1,1
39329,ಅವನನ್ನು,0,0,1,1
39328,jobb.,0,0,1,1
39327,databas,0,0,1,1
51227,दिखाई,0,0,1,1
39326,डरा,0,0,1,1
39324,டெர்சி,0,0,1,1
39322,relational,0,0,1,1
39321,insistant,0,0,1,1
39320,ചുവടെയുള്ള,0,0,1,1
39319,जॉर्जियाई,0,0,1,1
39317,anerkendt,0,0,1,1
39449,لتشجيع,0,0,1,1
39454,भावना,0,0,1,1
39653,tip.,0,0,1,1
39592,säkerhetstjänst,0,0,1,1
39585,φυλακές,0,0,1,1
51186,справочного,0,0,1,1
39587,സൃഷ്ടിക്കണമെന്ന്,0,0,1,1
39588,profit.,0,0,1,1
39589,சாதிக்காத,0,0,1,1
39590,reverta,0,0,1,1
39593,بشأنه.,0,0,1,1
39583,മന്ദഗതിയിലാകുന്നു,0,0,1,1
39594,oil,0,0,1,1
39596,wikileaks.,0,0,1,1
39599,бурной,0,0,1,1
39600,प्रविष्ट,0,0,1,1
51185,objectivement,0,0,1,1
39603,catch-'de,0,0,1,1
39584,yesterday,0,0,1,1
39582,leicht,0,0,1,1
39559,udvalgt,0,0,1,1
39568,constat,0,0,1,1
39562,pourriez-vous,0,0,1,1
39563,permiso,0,0,1,1
51187,vocabulary,0,0,1,1
39564,redigerar,0,0,1,1
39566,données ,0,0,1,1
39567,العلوم في,0,0,1,1
39569,oluşturma,0,0,1,1
39581,தூண்டுதலால்,0,0,1,1
39573,ஷெல்லின்,0,0,1,1
39574,πλάι,0,0,1,1
39575,മോശമായ,0,0,1,1
39577,मापदंडों,0,0,1,1
39579,ενδιαφέρει.,0,0,1,1
39580,undersøgelse,0,0,1,1
39604,vrolijken,0,0,1,1
39605,μέχρι,0,0,1,1
39607,collaboratifs,0,0,1,1
39645,കാര്യങ്ങളെല്ലാം,0,0,1,1
39635,organisés,0,0,1,1
39636,tous.,0,0,1,1
39637,தொடங்கப்பட்டது.,0,0,1,1
39640, mo.,0,0,1,1
39642,caras,0,0,1,1
39644,fyr,0,0,1,1
39646,trykket,0,0,1,1
39609,сетей,0,0,1,1
39647,defended,0,0,1,1
39648,loslegen.,0,0,1,1
51182,verwendeten,0,0,1,1
51181,ब्रेकेट,0,0,1,1
51180,asterisco,0,0,1,1
39652,afirmações,0,0,1,1
51184,विद्यार्थी,0,0,1,1
39633,υποστηρίζεται,0,0,1,1
39632,ಮಾತನಾಡುತ್ತಿದ್ದರು,0,0,1,1
39631,تتزوجني.,0,0,1,1
39628,खाने,0,0,1,1
39627,skruvat,0,0,1,1
39626,تسويته,0,0,1,1
39625,retourner,0,0,1,1
39624,stämmer,0,0,1,1
39621,pesadamente,0,0,1,1
39620,verschil,0,0,1,1
39618,متردد.,0,0,1,1
39615,valid,0,0,1,1
39614,diff,0,0,1,1
39613,कम्पनी,0,0,1,1
39612,ಕಾರ್ಯನಿರತರಾಗಿದ್ದಾರೆ,0,0,1,1
39610,educacional,0,0,1,1
39561,വിക്കിയിലേക്കും,0,0,1,1
39555,palast,0,0,1,1
39455,المركز,0,0,1,1
39498,down.,0,0,1,1
39489,högskolestudier,0,0,1,1
39490,nævner,0,0,1,1
39491,भगवान,0,0,1,1
39492,runoff,0,0,1,1
39494,விக்கிப்பீடியாவினது,0,0,1,1
39495,زالوا,0,0,1,1
39499,aposentado,0,0,1,1
39485,d'hébergement,0,0,1,1
39500,negotiation»,0,0,1,1
39502,yapabilmek,0,0,1,1
39503,बोक्माल,0,0,1,1
39505,trentaine,0,0,1,1
51198,kurslitteraturen,0,0,1,1
39507,betaalde,0,0,1,1
39487,κλήση,0,0,1,1
39484,changea,0,0,1,1
39554,إتمام,0,0,1,1
39470,ميتشيل,0,0,1,1
39457,தும்மும்போது,0,0,1,1
39460,biografieën,0,0,1,1
39462,semelhantes.,0,0,1,1
39463,البلدان,0,0,1,1
39467,presión,0,0,1,1
39468,diego,0,0,1,1
39472,stemden,0,0,1,1
39483,aktad,0,0,1,1
39473,قائلا,0,0,1,1
51202,testing,0,0,1,1
39479,ബഹിരാകാശം,0,0,1,1
39480,habilidade,0,0,1,1
39481,occitane,0,0,1,1
39482,dermed,0,0,1,1
51197,местные,0,0,1,1
39508,requests.,0,0,1,1
39509,जितने,0,0,1,1
39539,ämnen.,0,0,1,1
51189,mixture,0,0,1,1
51188,மன்னிப்பை,0,0,1,1
39535,بالمشاريع,0,0,1,1
39536,interviennent,0,0,1,1
39537,ലേഖനങ്ങൾക്ക്‌,0,0,1,1
39538,krets,0,0,1,1
39540,étions,0,0,1,1
39511,anweisungen,0,0,1,1
39542,ночь,0,0,1,1
39546,sprang,0,0,1,1
39547,aportaciones,0,0,1,1
39549,umarmen,0,0,1,1
39550,helg,0,0,1,1
39551,ನಿಷ್ಪ್ರಯೋಜಕವಾಗಿದ್ದರಿಂದ,0,0,1,1
39532,ومحركات,0,0,1,1
39530,isim,0,0,1,1
39529,hersenen,0,0,1,1
39526,==കുറിപ്പുകളും,0,0,1,1
39525,plena,0,0,1,1
51190,भोजपुरी,0,0,1,1
51191,помешал,0,0,1,1
39520,കഴിക്കണം,0,0,1,1
39519,гораздо,0,0,1,1
39518,l'attribution,0,0,1,1
39517,medlingsärenden,0,0,1,1
51192,aidez-moi,0,0,1,1
51193,crossbow,0,0,1,1
39515,носящего,0,0,1,1
39514,idade.,0,0,1,1
39512,сбудется.,0,0,1,1
51194,εβδομάδες,0,0,1,1
40017,sofistike,0,0,1,1
40023,confusa,0,0,1,1
39263,industrielle,0,0,1,1
40539,checking,0,0,1,1
40531,выглядит,0,0,1,1
40532,s'éloigner.,0,0,1,1
40535,பாதுகாப்பு,0,0,1,1
40536,طفل,0,0,1,1
40537,gebruikersbijdragen,0,0,1,1
40538,opkijken.,0,0,1,1
40540,comentarios,0,0,1,1
40529,schweres,0,0,1,1
40541,graffiti,0,0,1,1
40544,ανθρώπους.,0,0,1,1
40545,электронном,0,0,1,1
40546,اعتمادها.,0,0,1,1
40547,decorum,0,0,1,1
40548,modersmål,0,0,1,1
51082,لسلوك,0,0,1,1
40528,adında,0,0,1,1
40503,ami.,0,0,1,1
40514,പോകുമെന്ന്,0,0,1,1
40506,sony,0,0,1,1
40509,أفاد,0,0,1,1
40510,innovations,0,0,1,1
40511,tant.,0,0,1,1
40512,slette,0,0,1,1
40513,steam.,0,0,1,1
40515,والزميل,0,0,1,1
40525,convenciones,0,0,1,1
40516,formler,0,0,1,1
40517,demand.,0,0,1,1
40520,« repose,0,0,1,1
51084,d'objectivité,0,0,1,1
40522,ಪಠ್ಯಕ್ಕೆ,0,0,1,1
51083,bort.,0,0,1,1
40549,مليارات,0,0,1,1
40550,الى,0,0,1,1
40551,privacidade.,0,0,1,1
40590,trouvait,0,0,1,1
40580,ಸಭ್ಯವಾಗಿರಲು,0,0,1,1
40581,уэйлса,0,0,1,1
40583,eb,0,0,1,1
40584,വിജ്ഞാനപ്രദമായ,0,0,1,1
40587,koppla,0,0,1,1
40588,langue ».,0,0,1,1
40593,top-ten,0,0,1,1
40552,ψήσω,0,0,1,1
40595,comprobase,0,0,1,1
51075,εντελώς.,0,0,1,1
40597,ಅಸಮಾಧಾನಗೊಳ್ಳದಂತೆ,0,0,1,1
40598,resulta,0,0,1,1
40599,имеющее,0,0,1,1
40600,nord,0,0,1,1
40578,cross-validation,0,0,1,1
51077,politely.,0,0,1,1
40575,maskinöversatts,0,0,1,1
51078,​​lange,0,0,1,1
40574,remaniée,0,0,1,1
40573,doncellas,0,0,1,1
40572,unimportant,0,0,1,1
40567,faydasızdı,0,0,1,1
40565,aimeriez,0,0,1,1
40564,inserir,0,0,1,1
40562,científicos.,0,0,1,1
40560,bereikte,0,0,1,1
40558,distincts,0,0,1,1
51079,δάσκαλος,0,0,1,1
51080,söylemeyi,0,0,1,1
40556,self-replication,0,0,1,1
51081,deputy,0,0,1,1
40504,spiegelbeeld,0,0,1,1
40501,വിശദീകരിക്കുക,0,0,1,1
40604,വെക്കാനുള്ള,0,0,1,1
40436,нечисловыми,0,0,1,1
40426,ಭಾಗವನ್ನು,0,0,1,1
40428,ظل,0,0,1,1
40431,dictadores,0,0,1,1
40432,இற்றைப்படுத்தப்படும்.,0,0,1,1
40433,hauteur,0,0,1,1
40435,tí,0,0,1,1
40437,المطبقة,0,0,1,1
40423,собираетесь,0,0,1,1
51091,എന്തൊരു,0,0,1,1
40439,preferência,0,0,1,1
40440,garoto,0,0,1,1
40441,sûr.,0,0,1,1
40442,السياسة,0,0,1,1
40445,added.,0,0,1,1
40425,verlasse.,0,0,1,1
40422,κινητό,0,0,1,1
40500,ومراجعة,0,0,1,1
40412,authority,0,0,1,1
51096,υποτονική,0,0,1,1
40406,معانيها,0,0,1,1
40407,ಕಲಿತಿದ್ದೇವೆ,0,0,1,1
51095,gnupedia,0,0,1,1
40409,articlehave,0,0,1,1
40410,يضيف,0,0,1,1
40413,entré,0,0,1,1
40420,vite,0,0,1,1
40414,disminuido,0,0,1,1
40416,सीमाओं,0,0,1,1
51093,अभियान,0,0,1,1
40418,följt,0,0,1,1
51092,weitere,0,0,1,1
40419,ಚಲನಚಿತ್ರಗಳಿಗೆ,0,0,1,1
40446,d'îles[réf.,0,0,1,1
51090,wikipédia[g].,0,0,1,1
51089,समन्वित,0,0,1,1
40491,physico-chimiques,0,0,1,1
40484,gången.,0,0,1,1
40485,ക്രിയാപദം,0,0,1,1
40487,quelles,0,0,1,1
40488,​​από,0,0,1,1
40489,ryssland,0,0,1,1
40490,റോമൻ,0,0,1,1
40492,acabará,0,0,1,1
40451,عينات,0,0,1,1
40494,расположена,0,0,1,1
40495,الماكرو،,0,0,1,1
40496,പറയുമ്പോൾ,0,0,1,1
40497,فوقي.,0,0,1,1
40498,fresco»,0,0,1,1
40499,ഉപയോഗിക്കാത്തതെന്താണ്,0,0,1,1
40480,άποψης,0,0,1,1
40479,ഗ്നൂ,0,0,1,1
40476,семена,0,0,1,1
40475,स्लाइस,0,0,1,1
40473,philippines.,0,0,1,1
40469,sürü,0,0,1,1
51086,ربحية.,0,0,1,1
51087,ಅರ್ಥವಾಗಿದೆ,0,0,1,1
40463,normales,0,0,1,1
40462,διαχείρισης,0,0,1,1
40461,étais,0,0,1,1
40459,camino,0,0,1,1
40458,sujeito,0,0,1,1
40457,തിരിയുന്നു,0,0,1,1
40454,எண்ணை,0,0,1,1
40453,ഡിസംബർ,0,0,1,1
40452,frågades,0,0,1,1
40603,ಒನ್,0,0,1,1
51074,ανησυχείς.,0,0,1,1
40404,மீதான,0,0,1,1
40719,kalmeer,0,0,1,1
40711,telefones,0,0,1,1
51046,biggest,0,0,1,1
40712,smsar,0,0,1,1
40714,кодом,0,0,1,1
40715,erger,0,0,1,1
40717,passages,0,0,1,1
40720,planering,0,0,1,1
51049,ಖಚಿತವಾಗಿದೆ,0,0,1,1
40722,informativos.,0,0,1,1
40723,изменяют,0,0,1,1
40725,والأوكرانية،,0,0,1,1
40726,occurrences,0,0,1,1
40728,kultiverad,0,0,1,1
40729,stormigt,0,0,1,1
51048,genommen,0,0,1,1
40706,пересадки.,0,0,1,1
40686,ಪೋರ್ಟಲ್ಗೆ,0,0,1,1
51053,لطيفًا,0,0,1,1
40689,ναρκίσια,0,0,1,1
40693,للموسوعة.,0,0,1,1
40694,intelectuais,0,0,1,1
40695,हटा,0,0,1,1
40696,επινοήθηκε,0,0,1,1
40698,lb •,0,0,1,1
40699,تشديد,0,0,1,1
40705,الغربية,0,0,1,1
51052,просит,0,0,1,1
51051,bijeenkomst,0,0,1,1
51050,publicaron,0,0,1,1
40702,पाठकों,0,0,1,1
40703,lui-même,0,0,1,1
40704,вики-проектов,0,0,1,1
40730,bite,0,0,1,1
40731,предпочтение,0,0,1,1
40733,wars,0,0,1,1
40769,ചിന്തിക്കുകയായിരുന്നു.,0,0,1,1
40759,கொண்டாட,0,0,1,1
40761,computes,0,0,1,1
40762,acumulado,0,0,1,1
40763,المربيات.,0,0,1,1
40766,konuşmayla,0,0,1,1
40768,внутреннего,0,0,1,1
40770,bærende,0,0,1,1
40734,tillträde,0,0,1,1
40773,pretendentes,0,0,1,1
40776,reconheceu,0,0,1,1
40778,പതിപ്പാണ്,0,0,1,1
40779,गरीब,0,0,1,1
40780,குறிப்பிட,0,0,1,1
51040,нарцисс.,0,0,1,1
40757,refuses,0,0,1,1
40756,прикладных,0,0,1,1
40755,divisé,0,0,1,1
40754,सेवी,0,0,1,1
40752,ideas.,0,0,1,1
51042,κοινού,0,0,1,1
40750,ellen,0,0,1,1
40749,envelops,0,0,1,1
40748,palavras-raiz,0,0,1,1
40746,preguntas.,0,0,1,1
40745,പരീക്ഷയിൽ,0,0,1,1
40744,വാശി,0,0,1,1
51044,fuhr.,0,0,1,1
40743,syntactic,0,0,1,1
40741,ബി,0,0,1,1
40738,أفسدت,0,0,1,1
40735,ever-more,0,0,1,1
40688,leger,0,0,1,1
40685,கீழேயுள்ள,0,0,1,1
40605,cidadãos,0,0,1,1
40634,régions,0,0,1,1
40628,benaderen.,0,0,1,1
40629,kalırsa,0,0,1,1
40630,definen,0,0,1,1
51067,hesitating.,0,0,1,1
40632,വച്ച്,0,0,1,1
40633,instante,0,0,1,1
40635,debía,0,0,1,1
40627,मच,0,0,1,1
40636,लाद,0,0,1,1
40637,рендеринг,0,0,1,1
51066,end.,0,0,1,1
51065,reconhecida,0,0,1,1
40640,hieronder,0,0,1,1
40641,kaartsysteem,0,0,1,1
51068,içeceği,0,0,1,1
40625,கலைக்களஞ்சியமாகும்.,0,0,1,1
40684,tchakavien,0,0,1,1
40613,الاصابع.,0,0,1,1
40607,haut-parleur.,0,0,1,1
40608,partitions,0,0,1,1
40609,எதிர்மறையாக,0,0,1,1
40610,réflexion,0,0,1,1
40611,பயன்பாட்டிற்காகவும்,0,0,1,1
40612,fallecimiento,0,0,1,1
40614,afirmó,0,0,1,1
40624,disfavor,0,0,1,1
40616,publicarse,0,0,1,1
40619,evolucionan,0,0,1,1
40621,पकड़ना,0,0,1,1
40622,считала,0,0,1,1
51071,inspirera,0,0,1,1
40623,opfyldelse.,0,0,1,1
40643,caráter,0,0,1,1
40644,lektier,0,0,1,1
51063,πολύτιμους,0,0,1,1
40675,editar.,0,0,1,1
40669,excessivo,0,0,1,1
40670,τονισμό.,0,0,1,1
40671,मार्च,0,0,1,1
51057,موعدًا,0,0,1,1
40673,synvinkel,0,0,1,1
40674,creditadas,0,0,1,1
40677,التذكاري؛,0,0,1,1
51062,स्थानान्तरण,0,0,1,1
51055,basculer,0,0,1,1
40680,விக்கிபீடியாவின்,0,0,1,1
40681,rart.,0,0,1,1
40682,طاولة,0,0,1,1
40683,يصبحن,0,0,1,1
51054,trae,0,0,1,1
40667,ಬಿಸಿಯಾಗಿರುತ್ತದೆ,0,0,1,1
40666,normer,0,0,1,1
51059,начала.,0,0,1,1
40665,skapar.,0,0,1,1
40664,швеции,0,0,1,1
40663,сверху,0,0,1,1
40662,изменяется,0,0,1,1
40661,jeux,0,0,1,1
40660,ich.,0,0,1,1
40659,échanger,0,0,1,1
40658,विक्शनरी,0,0,1,1
51060,ಸ್ಲಗ್,0,0,1,1
40656,πουλί,0,0,1,1
40655,suciedad,0,0,1,1
40652,بالضحك,0,0,1,1
51061,capteurs.,0,0,1,1
40649,செல்வம்,0,0,1,1
40405,ресурсов,0,0,1,1
40403,étonné,0,0,1,1
40025,découlent,0,0,1,1
40153,பதிப்பிடக்கூடிய,0,0,1,1
40143,soulevée,0,0,1,1
40144,редакционном,0,0,1,1
40146,анонимы,0,0,1,1
40148,поощряет,0,0,1,1
40149,संपादकीय,0,0,1,1
40151,fracos,0,0,1,1
40155,ആഴത്തിൽ,0,0,1,1
40142,inlägg,0,0,1,1
51118,التعديل,0,0,1,1
40158,sollten,0,0,1,1
40159,semantics,0,0,1,1
40160,lettres,0,0,1,1
40161,oneens.,0,0,1,1
40162,claro.,0,0,1,1
51120,points.,0,0,1,1
40141,модным,0,0,1,1
40121,ನುಡಿಗಟ್ಟುಗಳು.,0,0,1,1
40131,baktı,0,0,1,1
40123,рост,0,0,1,1
40124,обеспечивает,0,0,1,1
40125,hæve,0,0,1,1
40126,«громадный»,0,0,1,1
40127,കുലുങ്ങുന്നു,0,0,1,1
40130,textual,0,0,1,1
40132,நிறுவனர்கள்,0,0,1,1
40140,оценкам,0,0,1,1
40133,möten.,0,0,1,1
51121,заставил,0,0,1,1
40134,étonnée,0,0,1,1
40135,triffst,0,0,1,1
40137,കൃത്രിമം,0,0,1,1
40139,améliorer,0,0,1,1
40163,souhaitez,0,0,1,1
40164,கருத்துகள்,0,0,1,1
40166,لوح,0,0,1,1
40196,веб-сайтов,0,0,1,1
40190,വന്നു.,0,0,1,1
40191,पूर्ण,0,0,1,1
40192,edemezsiniz,0,0,1,1
40193,görüşme,0,0,1,1
40194,composed.,0,0,1,1
40195,criterio,0,0,1,1
40197,«wikipedian,0,0,1,1
40169,pageviews,0,0,1,1
40198,захватывающее,0,0,1,1
40199,سوبود,0,0,1,1
40200,bokstavligen,0,0,1,1
40201,batatas,0,0,1,1
40202,الامور؟.,0,0,1,1
40203,അരികിലിരുന്നു.,0,0,1,1
40189,jouant.,0,0,1,1
40188,ಸ್ವಾತಂತ್ರ್ಯವಿಲ್ಲ.,0,0,1,1
40186,estabelecida,0,0,1,1
40185,limace,0,0,1,1
40184,förändrade,0,0,1,1
40183,vie.,0,0,1,1
40182,akademisyenler,0,0,1,1
40180,dialectos.,0,0,1,1
40179,casamento.,0,0,1,1
40178,secciones,0,0,1,1
40176,bırakılmış,0,0,1,1
40175,alternativos.,0,0,1,1
40174,कोमी-पेर्मायक,0,0,1,1
40173,protests,0,0,1,1
40172,ευγενικά,0,0,1,1
40171,pathogenic,0,0,1,1
40170,participer ».,0,0,1,1
40122,όμορφη.,0,0,1,1
40120,ಇಷ್ಟಪಡುತ್ತೇನೆ,0,0,1,1
40206,மறக்காதீர்கள்.,0,0,1,1
40057,السلوك,0,0,1,1
40048,verwirren.,0,0,1,1
40049,gaaf,0,0,1,1
40053,contaba,0,0,1,1
40054,bok,0,0,1,1
40055,أفكر,0,0,1,1
40056,χαρείτε,0,0,1,1
40059,documentering,0,0,1,1
40046,στρατό,0,0,1,1
40060,निष्क्रिय,0,0,1,1
51128,помахали,0,0,1,1
40063,الاحتجاجات,0,0,1,1
51127,afijo,0,0,1,1
40065,pearl,0,0,1,1
40066,beliefs,0,0,1,1
40047,basit,0,0,1,1
40045,globales,0,0,1,1
40116,arkadaşla,0,0,1,1
40036,ദൂതനോടും,0,0,1,1
40026,projetada,0,0,1,1
40028,wikiworld,0,0,1,1
40030,contraria,0,0,1,1
40032,अंगूठे,0,0,1,1
40034,ortasındaysanız,0,0,1,1
40035,ചെയ്തെടുക്കുന്നു.,0,0,1,1
40037,ശ്രമിക്കുമ്പോൾ,0,0,1,1
40044,community-wide,0,0,1,1
51130,hier.,0,0,1,1
40039,нежелательными,0,0,1,1
51129,aussi.,0,0,1,1
40040,automates.,0,0,1,1
40042,basque,0,0,1,1
40043,الخمس,0,0,1,1
40067,selectie,0,0,1,1
40068,பகுதிகளிலேயே,0,0,1,1
40069,κομμάτι,0,0,1,1
40104,കുറിക്കുന്നു.,0,0,1,1
40095,universidades.,0,0,1,1
40096,çalışıyordu,0,0,1,1
40099,отбора,0,0,1,1
40100,الإدارية,0,0,1,1
40101,benötigen,0,0,1,1
40103,garry,0,0,1,1
40105,скопирована,0,0,1,1
51126,जानकारीपूर्ण,0,0,1,1
40108,टोफेल,0,0,1,1
40110,शास्त्रीय,0,0,1,1
40112,विशेषाधिकार,0,0,1,1
51122,wikipedia-webbgränssnitt,0,0,1,1
40114,பகுதியை,0,0,1,1
40115,déranger.,0,0,1,1
40094,livre.,0,0,1,1
51123,கொண்டன,0,0,1,1
40091,hablantes,0,0,1,1
51124,hazlo,0,0,1,1
40089,கட்டிப்பிடிக்க,0,0,1,1
40088,ಒಪ್ಪುವುದು,0,0,1,1
40087,grown,0,0,1,1
51125,paradigm,0,0,1,1
40085,ಖಚಿತಪಡಿಸಿಕೊಳ್ಳಿ.,0,0,1,1
40084,compenser »,0,0,1,1
40083,ಅವನೊಂದಿಗೆ,0,0,1,1
40081,affiliated,0,0,1,1
40080,noticiário,0,0,1,1
40079,बर्खास्त,0,0,1,1
40078,tomos,0,0,1,1
40073,ومستدامًا.,0,0,1,1
40071,yoludur.,0,0,1,1
40205,अमेरिकन्स,0,0,1,1
40208,डॉइशलैंड,0,0,1,1
40402,photosynthesis,0,0,1,1
40341,eb-artikel,0,0,1,1
40331,moderne.,0,0,1,1
40333,gruppen,0,0,1,1
40336,limiting,0,0,1,1
40337,പരിശീലന,0,0,1,1
40339,σωστός,0,0,1,1
40340,tentant,0,0,1,1
40342,unterbreche.,0,0,1,1
40325,«periodista,0,0,1,1
51101,l'écriture,0,0,1,1
51100,रोमानियाई,0,0,1,1
40345,الجيش,0,0,1,1
51099,эмоциях,0,0,1,1
40347,основной,0,0,1,1
51098,oude,0,0,1,1
40327,μαζί.,0,0,1,1
40324,வழிமுறையாகும்,0,0,1,1
40305,klänningen,0,0,1,1
40313,l’intervention,0,0,1,1
40307,പറ്റുമോ,0,0,1,1
40308,ഫൗണ്ടേഷന്റെ,0,0,1,1
40309,المنشأة,0,0,1,1
40310,oc •,0,0,1,1
51104,förstöra,0,0,1,1
40312,années.,0,0,1,1
40316,jahr,0,0,1,1
40323,omröstningar,0,0,1,1
40317, [ˌwɪkɨˈpiːdi.ə],0,0,1,1
40318,ധർമ്മസങ്കടമുള്ള,0,0,1,1
40319,എവിടെയായിരുന്നു,0,0,1,1
40320,islandês,0,0,1,1
40321,d'apprentissage.,0,0,1,1
51102,प्रतिबिंब,0,0,1,1
40348,riche,0,0,1,1
40349,ಮಾಡಬೇಕೆಂಬುದನ್ನು,0,0,1,1
40351,minimum,0,0,1,1
40390,riesgo,0,0,1,1
40381,adres,0,0,1,1
40382,miroirs,0,0,1,1
40384,काशुबियाई,0,0,1,1
40386,aardiger,0,0,1,1
40387,selfie,0,0,1,1
40388,மிகப்,0,0,1,1
40391,dirección,0,0,1,1
40353,redigeringar.,0,0,1,1
40392,كنا.,0,0,1,1
40394,लेटेस्ट,0,0,1,1
40395,escolhidos,0,0,1,1
40397,elinde,0,0,1,1
40398,cerveau,0,0,1,1
40399,humanidades,0,0,1,1
40380,أرتدي,0,0,1,1
40379,atributos.,0,0,1,1
40378,auprès,0,0,1,1
40376,voltam,0,0,1,1
40374,குழந்தை,0,0,1,1
51097,geboden,0,0,1,1
40372,أخبرتهم,0,0,1,1
40371,otroligt,0,0,1,1
40367,உட்கார்ந்திருப்பதைப்,0,0,1,1
40366,gitme,0,0,1,1
40365,ξεκινήσετε,0,0,1,1
40364,мороженого,0,0,1,1
40363,wint,0,0,1,1
40362,şeklim,0,0,1,1
40361,восемь,0,0,1,1
40359,gérés,0,0,1,1
40354,genomsnitt,0,0,1,1
40306,وجمالها,0,0,1,1
40304,[p]erhaps,0,0,1,1
40210,घूमते,0,0,1,1
40242,músicas,0,0,1,1
40234,oficiales.,0,0,1,1
40237,predicted,0,0,1,1
40238,projets.,0,0,1,1
40239,toma,0,0,1,1
51113,namorado,0,0,1,1
40241,categorização,0,0,1,1
40243,exempelmeningar,0,0,1,1
40232,विकिइन्फो,0,0,1,1
51112,fóruns,0,0,1,1
40246,المحتمل,0,0,1,1
40247,l'encyclopédie[n].,0,0,1,1
40248,مفارقة,0,0,1,1
40251,perigosas,0,0,1,1
40252,называется.,0,0,1,1
40233,محفوظات,0,0,1,1
40231,sleeping,0,0,1,1
40302,المعاملات,0,0,1,1
40216,divin.,0,0,1,1
40211,തൂങ്ങുക.,0,0,1,1
40212,repris,0,0,1,1
40213,уэйлсом,0,0,1,1
40214,عشوائية,0,0,1,1
40215,ഒബാമ,0,0,1,1
51117,noisy,0,0,1,1
40218,നല്ലതെന്ന്,0,0,1,1
40230,beğenme,0,0,1,1
40219,അറിയാം,0,0,1,1
51115,लगेगी।,0,0,1,1
40224,getirdim,0,0,1,1
40225,mundial​,0,0,1,1
40227,projektredigeringar,0,0,1,1
40228,compréhension,0,0,1,1
40253,candidato.,0,0,1,1
40254,hazard,0,0,1,1
40255,задал,0,0,1,1
40295,niets.,0,0,1,1
40285,ചുറ്റിപ്പറ്റിയുള്ള,0,0,1,1
40286,γνωρίζω.,0,0,1,1
51108,الناس.,0,0,1,1
40291,hazırlanmış,0,0,1,1
40293,للحظة؟,0,0,1,1
51107,guidant,0,0,1,1
40296,udtale,0,0,1,1
40257,fahre,0,0,1,1
40297,написанном,0,0,1,1
40298,പോകാം.,0,0,1,1
40299,normalement,0,0,1,1
51106,развивается,0,0,1,1
40300,партнёрства,0,0,1,1
40301,män.,0,0,1,1
40283,araştırmada,0,0,1,1
40281,എടുത്തുമാറ്റുക,0,0,1,1
40280,personalizadas,0,0,1,1
40278,haciéndolo,0,0,1,1
40277,hebben.,0,0,1,1
40274,ಲೋಟ,0,0,1,1
40273,brett,0,0,1,1
40271,ಅಭ್ಯಾಸ,0,0,1,1
40270,verheiratet,0,0,1,1
40269,പ്രകാരം,0,0,1,1
40267,fitting,0,0,1,1
40265,england.,0,0,1,1
40264,pertenece,0,0,1,1
51109,niveaux ,0,0,1,1
40260,തിരയുന്നുവെങ്കിൽ,0,0,1,1
40259,принесет,0,0,1,1
40258,выпуск,0,0,1,1
39264,cloche,0,0,1,1
39262,suivantes,0,0,1,1
43794,morceau,0,0,1,1
38281,solicitação,0,0,1,1
38271,reaches,0,0,1,1
38272,للولايات,0,0,1,1
38276,cdi,0,0,1,1
38277,накормим,0,0,1,1
38279,transformer,0,0,1,1
38280,സുഖമായിരിക്കും.,0,0,1,1
38282,машинами.,0,0,1,1
38266,новейший,0,0,1,1
38284,മാർഗമാണ്.,0,0,1,1
38285,compositor,0,0,1,1
38286,дискриминантный,0,0,1,1
38289,réunion.,0,0,1,1
38290,நேர்காணலில்,0,0,1,1
38291,പാദത്തിൽ,0,0,1,1
38268,fuerza,0,0,1,1
38265,campus,0,0,1,1
38239,المناسبة،[note,0,0,1,1
38251,inspiration,0,0,1,1
38242,tensor,0,0,1,1
38243,سيبدو,0,0,1,1
38246,الهوية,0,0,1,1
38247,मशीनों,0,0,1,1
38248,clássicas,0,0,1,1
38250,باحثون,0,0,1,1
38252,википедия ,0,0,1,1
51365,help.,0,0,1,1
38253,ಸಂಪೂರ್ಣ,0,0,1,1
38254,vindos,0,0,1,1
38255,.όλοι,0,0,1,1
38256,exceptional,0,0,1,1
38257,കാര്യനിർവ്വാഹർക്കുണ്ട്.,0,0,1,1
38259,misbruik,0,0,1,1
38295,λέξεων.,0,0,1,1
38297,αγκαλιάσει,0,0,1,1
38299,المعرفة،,0,0,1,1
38329,грандиозная,0,0,1,1
38321,bitte.,0,0,1,1
38322,actué,0,0,1,1
38323,d'aujourd'hui,0,0,1,1
38324,λίγα,0,0,1,1
51358,экономика,0,0,1,1
38327,low-hanging,0,0,1,1
38330,बोलिये।,0,0,1,1
38301,smilede,0,0,1,1
51357,يمثل,0,0,1,1
38334,merged,0,0,1,1
38335,monate,0,0,1,1
38336,gemeinsame,0,0,1,1
38338,hissediyorsanız,0,0,1,1
38339,плачущий,0,0,1,1
51359,तुर्क,0,0,1,1
38320,metodologia,0,0,1,1
38319,yaşamda,0,0,1,1
38318,aesthetics.,0,0,1,1
38317,अनुभवहीन,0,0,1,1
38316,தாயைப்,0,0,1,1
38315,المال,0,0,1,1
38314,deltagarportalerna.,0,0,1,1
51361,подарок.,0,0,1,1
38313,ಸಂಭವಿಸಿದ,0,0,1,1
38312,molestia,0,0,1,1
38311,barajaron,0,0,1,1
38310,nitrogen,0,0,1,1
38309,balanceamento,0,0,1,1
38305,ಹೊಂದಿಲ್ಲದಿದ್ದರೆ,0,0,1,1
38303,качества.,0,0,1,1
38302,волшебными,0,0,1,1
38241,ಮಾಡಿದ್ದೀರಿ.,0,0,1,1
38238,redactor,0,0,1,1
38342,desacreditarlo,0,0,1,1
51376,индуктивного,0,0,1,1
38177,efetivamente,0,0,1,1
38178,‘அண்மைய,0,0,1,1
38179,photographique,0,0,1,1
38180,consultam,0,0,1,1
38183,gagné,0,0,1,1
38184,تتجسد,0,0,1,1
38186,ciberespaço,0,0,1,1
38174,ಮಾನಸಿಕವಾಗಿ,0,0,1,1
38187,интернета[комм.,0,0,1,1
38188,എല്ലാവരും,0,0,1,1
51375,l'insertion,0,0,1,1
38189,elegantes.,0,0,1,1
38190,aclu,0,0,1,1
38191,годах,0,0,1,1
51379,ஏறினாள்,0,0,1,1
38173,respondeu,0,0,1,1
51367,руководством,0,0,1,1
38159,otrs,0,0,1,1
38153,जाए।,0,0,1,1
38154,феврале,0,0,1,1
38155,медейко,0,0,1,1
38156,especializados,0,0,1,1
38157,n'est-ce,0,0,1,1
38158,بنسخ,0,0,1,1
38162,ലഭിക്കുമ്പോൾ,0,0,1,1
51380,ചിത്രീകരണവും,0,0,1,1
38163,يكفي.,0,0,1,1
38167,album's,0,0,1,1
38168,ക്ലാസ്സിൽ,0,0,1,1
38169,excessivamente,0,0,1,1
38170,vikipediler,0,0,1,1
38171,ರಹಸ್ಯವಾಗಿ,0,0,1,1
38192,dictionary.,0,0,1,1
38193,உலாவியையும்,0,0,1,1
38194,cartas.,0,0,1,1
38229,declining,0,0,1,1
38222,skrivit,0,0,1,1
38223,അവളുമായി,0,0,1,1
38225,new •,0,0,1,1
38226,durable »,0,0,1,1
38227,implications,0,0,1,1
38228,മനുഷ്യന്,0,0,1,1
38230,temor,0,0,1,1
51374,сне,0,0,1,1
38231,genoptage,0,0,1,1
38233,löpande,0,0,1,1
51370,доминирующей,0,0,1,1
38234,டோஃபிள்,0,0,1,1
38235,कृत्य,0,0,1,1
38236,castle,0,0,1,1
38220,marriage.,0,0,1,1
38219,σταματήσω,0,0,1,1
38218,ತಿಂಗಳುಗಳವರೆಗೆ,0,0,1,1
38216,affect,0,0,1,1
38215,cliquer,0,0,1,1
38213,छोटी,0,0,1,1
38212,πιστεύετε,0,0,1,1
38211,образовательном,0,0,1,1
38210,пожаловать,0,0,1,1
51373,agree.,0,0,1,1
38207,deems,0,0,1,1
38206,précieuses,0,0,1,1
38204,درس,0,0,1,1
38203,للعينة,0,0,1,1
38201,stockholms,0,0,1,1
38198,pre-processing,0,0,1,1
38197,ಮಾಡಿದರೆ,0,0,1,1
38341,equilibrado.,0,0,1,1
38343,constate,0,0,1,1
38150,göremeyeceğimi,0,0,1,1
38474,nedenini,0,0,1,1
38465,δέκα,0,0,1,1
38468,готовности,0,0,1,1
38469,تراقبها.,0,0,1,1
38471,énumère,0,0,1,1
38472,rosto,0,0,1,1
38473,बश्किर,0,0,1,1
38475,reçeli,0,0,1,1
38461,fenomenet,0,0,1,1
38476,followed,0,0,1,1
38477,spacecraft.,0,0,1,1
38478,adiós.,0,0,1,1
38479,хорошие.,0,0,1,1
51347,oído,0,0,1,1
38484,sosyal,0,0,1,1
38462,джеймс,0,0,1,1
38460,mordisco,0,0,1,1
38438,kaldet,0,0,1,1
38450,поисковых,0,0,1,1
51351,reconocía,0,0,1,1
38441,കരയാൻ,0,0,1,1
38444,இரகசியமாக,0,0,1,1
51349,mottaglig,0,0,1,1
38446,banqueiro,0,0,1,1
38447,സൂചിപ്പിക്കുന്നതിന്,0,0,1,1
38452,ಸಂತೋಷವಾಗಿದೆ.,0,0,1,1
38459,l’élection,0,0,1,1
38453,வருத்தப்படுகிறீர்கள்,0,0,1,1
38454,d'expression ».,0,0,1,1
51348,palads,0,0,1,1
38456,ljuset,0,0,1,1
38457,questionou,0,0,1,1
38458,ഏതുസമയത്തും.,0,0,1,1
38485,dönüşüyor.,0,0,1,1
38486,ಹೇಳಿ,0,0,1,1
38489,eenvoudigste,0,0,1,1
38520,μερικοί,0,0,1,1
38513,волшебный,0,0,1,1
38514,urval,0,0,1,1
38515,எச்சரிப்பதற்காகவும்,0,0,1,1
38516,ಬರಾಕ್,0,0,1,1
38518,хватает.,0,0,1,1
38519,dificuldade,0,0,1,1
38521,ahnung.,0,0,1,1
38490,ഇന്നലെ,0,0,1,1
38522,versuche,0,0,1,1
38526,basmadıysanız,0,0,1,1
38528,catch--situatie,0,0,1,1
38530,ബോക്സിൽ,0,0,1,1
51344,construída,0,0,1,1
38532,historic,0,0,1,1
38512,спросили,0,0,1,1
38510,efectúan,0,0,1,1
38509,latinisé,0,0,1,1
38507,بمعلومات,0,0,1,1
38506,mirándola.,0,0,1,1
38505,surprised,0,0,1,1
38504,yanına,0,0,1,1
51345,burocracia,0,0,1,1
38502,resumos,0,0,1,1
38501,nytt,0,0,1,1
38500,head,0,0,1,1
38497,wwe,0,0,1,1
38496,സമൂഹമാണ്,0,0,1,1
38495,seriøs,0,0,1,1
38494,മുഴുകിയിരിക്കുന്നു,0,0,1,1
38493,contradictorias,0,0,1,1
38492,വിചാരിക്കുന്നില്ല.,0,0,1,1
38439,complutense,0,0,1,1
38436,elskede,0,0,1,1
38344,συνεργατικά,0,0,1,1
38376,ooit,0,0,1,1
38370,interwikilänkar,0,0,1,1
38371,códigos,0,0,1,1
38372,gætter,0,0,1,1
51354,التحقق،,0,0,1,1
38373,دعونا,0,0,1,1
38375,julius,0,0,1,1
38377,സ്ലഗ്,0,0,1,1
38367,அர்த்தமாகும்,0,0,1,1
38378,much.,0,0,1,1
38379,.dk,0,0,1,1
38380,حيال,0,0,1,1
51353,approximately.,0,0,1,1
38383,uppfyller,0,0,1,1
38385,அமர்த்த,0,0,1,1
38368,وثقافة,0,0,1,1
38366,woordnummer,0,0,1,1
38435,പറഞ്ഞുകൊണ്ട്,0,0,1,1
38354,ёсики,0,0,1,1
38345,falsidades,0,0,1,1
38346,äktenskapet.,0,0,1,1
38347,مرتين.,0,0,1,1
38350,detuvo,0,0,1,1
38351,फीडर,0,0,1,1
38353,d'émeraudes,0,0,1,1
38355,وقال,0,0,1,1
38365,wikipediaversioner,0,0,1,1
38356,« wiki »,0,0,1,1
38357,ஹேங்கவுட்,0,0,1,1
38360,துரதிர்ஷ்டவசமாக,0,0,1,1
38361,mükemmele,0,0,1,1
38362,consultado,0,0,1,1
38364,siembra,0,0,1,1
38386,renvoyé,0,0,1,1
38388,شكرك,0,0,1,1
38389,செய்வது,0,0,1,1
38422,சிக்கியிருப்பதை,0,0,1,1
38414,mets,0,0,1,1
38415,dileme.,0,0,1,1
38416,votou,0,0,1,1
38418,baktığım,0,0,1,1
38419,gozar,0,0,1,1
38420,myxozoa,0,0,1,1
38423,bays,0,0,1,1
38390,tombé,0,0,1,1
38424,മഹായുദ്ധസമയത്ത്,0,0,1,1
38425,zur,0,0,1,1
38426,بيريشيت،,0,0,1,1
38427,délicates,0,0,1,1
38429,प्रदान,0,0,1,1
38431,forcément,0,0,1,1
38413,غداء,0,0,1,1
38411,quantity,0,0,1,1
38410,بتلميحات,0,0,1,1
38409,künt,0,0,1,1
51352,ഡോളർ,0,0,1,1
38407,تفكر,0,0,1,1
38406,organisationer,0,0,1,1
38405,இற்றைப்படுத்தப்படுவதேயாகும்.,0,0,1,1
38404,ದೇಶಕ್ಕೆ,0,0,1,1
38403,diyebileceğine,0,0,1,1
38400,பார்த்ததிலிருந்து,0,0,1,1
38398,നടത്തുവാനും,0,0,1,1
38396,заботился,0,0,1,1
38395,efetuou,0,0,1,1
38394,ar •,0,0,1,1
38393,théorise,0,0,1,1
38392,против,0,0,1,1
38151,ഭാഷയുമായി,0,0,1,1
38149,chapitre,0,0,1,1
38534,അതിന്,0,0,1,1
37891,പോകാം,0,0,1,1
37885,ഉപയോഗം,0,0,1,1
37886,rêvais.,0,0,1,1
37887,demostró,0,0,1,1
37888,ಕಲಿಕೆ,0,0,1,1
37889,ترقية,0,0,1,1
51413,നമ്മുടെ,0,0,1,1
51412,tillfällig,0,0,1,1
37882,സ്വർണ്ണമായും,0,0,1,1
37895,уэйлс.,0,0,1,1
37896,للتخلص,0,0,1,1
37899,appelant,0,0,1,1
37900,ഓപ്റ്റിക്കൽ,0,0,1,1
37901,результатом,0,0,1,1
37902,والدتي,0,0,1,1
37884,स्वाद।,0,0,1,1
37881,वर्षों,0,0,1,1
37860,японии,0,0,1,1
37870,saline,0,0,1,1
37864,विकिअलिटी.,0,0,1,1
37865,náhuatl,0,0,1,1
37866,existido,0,0,1,1
37867,amacıyla,0,0,1,1
37868,википедиях.,0,0,1,1
37869,kilometers,0,0,1,1
37871,βλέπετε.,0,0,1,1
37880,άδεια.,0,0,1,1
37873,çalışmalarda,0,0,1,1
37874,machine »,0,0,1,1
51417,consideran,0,0,1,1
51416,taal,0,0,1,1
37876,dis-tu,0,0,1,1
37879,беспокойтесь».,0,0,1,1
37905,ಫಲಿತಾಂಶವನ್ನು,0,0,1,1
37906,hegemony,0,0,1,1
51410,patiemment,0,0,1,1
37934,ranting,0,0,1,1
37927,അമിതപ്രാധാന്യമാവാം,0,0,1,1
37928,wales',0,0,1,1
37929,επιλογές,0,0,1,1
37930,hende.,0,0,1,1
37932,yararlanmasına,0,0,1,1
37933,தேடு,0,0,1,1
37936,sætningsnummer.,0,0,1,1
37908,اجتماعية،,0,0,1,1
37938,ombads,0,0,1,1
37939,tornar-se,0,0,1,1
37940,الخوف,0,0,1,1
37941,genehmigung.,0,0,1,1
37945,‘பேச்சுப்பக்கம்’,0,0,1,1
37947,forums[note,0,0,1,1
37926,ലഭ്യമായതിനാൽ,0,0,1,1
51408,påpegede,0,0,1,1
37922,تيمز،,0,0,1,1
37921,dropped,0,0,1,1
37920,çalışabilir,0,0,1,1
37919,herhaling.,0,0,1,1
37918,lessive.,0,0,1,1
37917,कहा.,0,0,1,1
37916,подчеркнуть,0,0,1,1
37915,opkalder,0,0,1,1
37914,boş,0,0,1,1
37913,واحدًا,0,0,1,1
37912,ищете,0,0,1,1
51409,konsumerar,0,0,1,1
37911,متطوعين.,0,0,1,1
37910,എഴുതുന്നുണ്ട്.,0,0,1,1
37909,mirada,0,0,1,1
37863,متفاجئة,0,0,1,1
37858,ولطيفة,0,0,1,1
37949,escándalos,0,0,1,1
37799,സാധ്യമാക്കുന്നത്.,0,0,1,1
37793,océaniques,0,0,1,1
37794,βάση,0,0,1,1
37795,رائعًا.,0,0,1,1
37796,hulp,0,0,1,1
37797,puestos.,0,0,1,1
37798,ettusen,0,0,1,1
37800,vecteurs,0,0,1,1
37791,other.,0,0,1,1
37802,डालना।,0,0,1,1
37803,بالنقر,0,0,1,1
37805,coutumières,0,0,1,1
51421,அறிவுள்ள,0,0,1,1
37808,university.,0,0,1,1
37809,caption,0,0,1,1
37792,व्यवधान,0,0,1,1
51422,d’accident,0,0,1,1
37857,поле,0,0,1,1
37777,медицинским,0,0,1,1
37770,बताएंगे,0,0,1,1
51425,reputadas.,0,0,1,1
37773,defines,0,0,1,1
37774,असफल,0,0,1,1
37775,  €,0,0,1,1
37776,ganado,0,0,1,1
37781,provision,0,0,1,1
37789,schrijfstijl,0,0,1,1
37782,coca-cola.,0,0,1,1
37784,tâmil,0,0,1,1
51423,μ.μ.,0,0,1,1
37785,திரைப்படங்களுக்குச்,0,0,1,1
37786,bachelet,0,0,1,1
37788,observada,0,0,1,1
37810,минутку,0,0,1,1
37812,zorgen.,0,0,1,1
37814,kişiye,0,0,1,1
37844,adoro,0,0,1,1
37837,minutes ».,0,0,1,1
37839,humorista,0,0,1,1
37840,controversa.,0,0,1,1
37841,wiederholen.,0,0,1,1
37842,χρησιμοποιούμε,0,0,1,1
37843,tilladelse.,0,0,1,1
37845,الجنساني,0,0,1,1
37815,പിടിച്ചില്ലെങ്കിൽ‌,0,0,1,1
37846,centrar,0,0,1,1
51420,принца,0,0,1,1
37851,و.,0,0,1,1
37852,ordforråd,0,0,1,1
37854,ταπεινή,0,0,1,1
37856,dilden,0,0,1,1
37836,soruyorsunuz.,0,0,1,1
37835,d'afrique,0,0,1,1
37834,التقليدية,0,0,1,1
37833,desistir.,0,0,1,1
37832,inter-disciplinary,0,0,1,1
37831,africa,0,0,1,1
37829,फ़ैरोई,0,0,1,1
37828,ال,0,0,1,1
37827,iso,0,0,1,1
37826,prends-toi,0,0,1,1
37823,பக்கக்,0,0,1,1
37822,söylüyorsun.,0,0,1,1
37821,ബുദ്ധിമുട്ടാണെന്നകാര്യം,0,0,1,1
37820,ശിൽപ്പികൾ.,0,0,1,1
37819,farm,0,0,1,1
37817,forestation,0,0,1,1
37816,modèles.,0,0,1,1
37948,flourish,0,0,1,1
37950,foutjes,0,0,1,1
51383,theme,0,0,1,1
38088,spill,0,0,1,1
38079,dinle.,0,0,1,1
38080,anímate.,0,0,1,1
38081,وقف,0,0,1,1
38085,autorisation.,0,0,1,1
38086,образовался,0,0,1,1
38087,ونرجسية.,0,0,1,1
38089,рода,0,0,1,1
38077,definição,0,0,1,1
38091,klassen,0,0,1,1
38094,تكررها,0,0,1,1
38095,ஒலிக்கிறோம்.,0,0,1,1
38096,требуется,0,0,1,1
38097,gülmeye,0,0,1,1
38099,outgassing,0,0,1,1
38078,précédentes.,0,0,1,1
38072,mediawikiprogramvaran,0,0,1,1
38047,единственным,0,0,1,1
38058,j'aurais,0,0,1,1
51390,değiştirilmeye,0,0,1,1
51389,منهم.,0,0,1,1
38052,outnyttjade,0,0,1,1
38053,رفاق.,0,0,1,1
51388,wildernesswild,0,0,1,1
38056,оскорбительное,0,0,1,1
38059, الويكيبيديا,0,0,1,1
38069,எசுப்பானிய,0,0,1,1
38060,يحمل,0,0,1,1
38061,étonnante,0,0,1,1
38063,തയ്യാറായി,0,0,1,1
38064,fondations,0,0,1,1
38065,ഒന്നോ,0,0,1,1
38066,nådde,0,0,1,1
38101,adicionou,0,0,1,1
38102,وداعًا.,0,0,1,1
38103,увидеть,0,0,1,1
38140,солдатам,0,0,1,1
38131,последующим,0,0,1,1
38132,photo,0,0,1,1
38134,englobando,0,0,1,1
38135,brillantes,0,0,1,1
38136,നിഷ്പക്ഷമായ,0,0,1,1
38137,ചെറുപെട്ടികളിൽ,0,0,1,1
38141,एल,0,0,1,1
38105,shepelyansky,0,0,1,1
38142,анализ,0,0,1,1
51385,днем.,0,0,1,1
38145,வேல்ஸையே,0,0,1,1
38146,d’intentionnalités,0,0,1,1
38147,caracteriza,0,0,1,1
51384,وتوقيت,0,0,1,1
38130,любыми,0,0,1,1
38127,പതിപ്പുകളുണ്ട്‌.,0,0,1,1
38126,வீடியோவுக்கு,0,0,1,1
38125,ennuyeux,0,0,1,1
38124,فازت,0,0,1,1
38123,متعارضين,0,0,1,1
38121,courbes,0,0,1,1
38120,обращают,0,0,1,1
38119,mutación,0,0,1,1
38118,അഴുക്ക്,0,0,1,1
38114,அர்த்தம்.,0,0,1,1
51386,klaar,0,0,1,1
38111,مهتم.,0,0,1,1
38110,sonrisas,0,0,1,1
38109,ಮೂರನೆಯ,0,0,1,1
38108,الإطلاق،,0,0,1,1
38107,സ്യൂട്ടർമാർ,0,0,1,1
38048,afuera,0,0,1,1
38045,крупный,0,0,1,1
37951,जाऊंगा।,0,0,1,1
37984,meningsverschillen,0,0,1,1
37978,கடி,0,0,1,1
51397,nase,0,0,1,1
37979,retaining,0,0,1,1
37980,மந்தமாக்குகிறது,0,0,1,1
37981,dorées,0,0,1,1
37982,நேரத்திலிருந்து,0,0,1,1
51395,destiné,0,0,1,1
37976,ملابس,0,0,1,1
37986,بتعديل,0,0,1,1
51394,हाइपरलिंक,0,0,1,1
37987,kore'nin,0,0,1,1
37988,abnormal,0,0,1,1
37990,ആശംസകൾ,0,0,1,1
37992,bear,0,0,1,1
37977,anlama,0,0,1,1
37975,suerte.,0,0,1,1
38044,ensinadas,0,0,1,1
51401,écrire,0,0,1,1
37952,satirizou,0,0,1,1
37954,envoyé,0,0,1,1
37956,εύκολα,0,0,1,1
51403,поездку,0,0,1,1
37960,administrativas,0,0,1,1
37963,بها،,0,0,1,1
37964,വാരാന്ത്യത്തിലും,0,0,1,1
37974,solicitado,0,0,1,1
37965,divisão,0,0,1,1
37966,kluge,0,0,1,1
51400,கட்டைவிரலைக்,0,0,1,1
51399,ജീവനക്കാരൻ,0,0,1,1
37969,brisé,0,0,1,1
37973,усилие.,0,0,1,1
37993,ekonomin,0,0,1,1
37994,förlåt.,0,0,1,1
37995,ناجحًا.,0,0,1,1
38035,organizar,0,0,1,1
38024,போக,0,0,1,1
38026,descubierto,0,0,1,1
38029,chémoinformatique ,0,0,1,1
38030,جنو,0,0,1,1
38033,correu,0,0,1,1
38034,taste,0,0,1,1
38036,formateret,0,0,1,1
37996,τηλέφωνο,0,0,1,1
38039,equivalent,0,0,1,1
38040,τέλος,0,0,1,1
51391,impossibles,0,0,1,1
38041,måneder,0,0,1,1
38042,मीठा,0,0,1,1
38043,ಮಾಡಲಿದ್ದೀರಿ,0,0,1,1
38023,sistem,0,0,1,1
38022,limitée,0,0,1,1
38021,frais,0,0,1,1
38019,governing,0,0,1,1
38018,län,0,0,1,1
38016,​​sneetje,0,0,1,1
38013,führen,0,0,1,1
38010,அழுத்தவும்,0,0,1,1
38008,وdutch.,0,0,1,1
38007,поставьте,0,0,1,1
38005,disputas.,0,0,1,1
38004,couverture.,0,0,1,1
38002,ned,0,0,1,1
38001,wikipedia-artikelen,0,0,1,1
37999,desacuerdo.,0,0,1,1
37998,amérindiens,0,0,1,1
37997,ചെയ്യാനും,0,0,1,1
38533,находящихся,0,0,1,1
51343,कुर्द,0,0,1,1
39261,υποδηλώνει,0,0,1,1
51272,igång.,0,0,1,1
39028,आटा,0,0,1,1
39029,chegar,0,0,1,1
51274,நோக்கமற்றது,0,0,1,1
39031,صحة,0,0,1,1
51273,ನಿರ್ಧಾರವಾಗಿದೆ,0,0,1,1
39033,klinkt.,0,0,1,1
39035,pedaço,0,0,1,1
39026,ವಿವರಿಸಲು,0,0,1,1
39036,rød,0,0,1,1
39037,flummoxade,0,0,1,1
39038,بالذكر,0,0,1,1
51270,paralela,0,0,1,1
39040,vikipedist,0,0,1,1
39042,cached,0,0,1,1
51275,التنسيق,0,0,1,1
39024,கட்டுரைக்குமான,0,0,1,1
39006,« caractère,0,0,1,1
39015,εκπληκτικά,0,0,1,1
39007,ಸ್ನೇಹಿತರಾಗಿದ್ದರು,0,0,1,1
39008,'natuur',0,0,1,1
39009,bekymmer.,0,0,1,1
39011,opt,0,0,1,1
39012,τόνο,0,0,1,1
39014,inundación,0,0,1,1
39016,willkommen.,0,0,1,1
39023,περιλαμβάνουν,0,0,1,1
51277,ಆರು,0,0,1,1
39018,விரும்புவதன்,0,0,1,1
39019,describing,0,0,1,1
39020,conoces,0,0,1,1
39021,olagligt,0,0,1,1
39022,बहक,0,0,1,1
39043,disait,0,0,1,1
39044,d'ouvrages,0,0,1,1
39045,récentes ».,0,0,1,1
39077,रहें,0,0,1,1
39069,गुज़री,0,0,1,1
39070,اقتراحات.,0,0,1,1
39071,прошу,0,0,1,1
39073,issue.,0,0,1,1
39074,deixa,0,0,1,1
39076,пожаловаться,0,0,1,1
39078,seçimler,0,0,1,1
39046,extinctions.,0,0,1,1
39079,критику.,0,0,1,1
51265,interstellar,0,0,1,1
39080,ಹಿಟ್ಟು,0,0,1,1
39082,esams,0,0,1,1
39085,francês,0,0,1,1
39086,комиксе,0,0,1,1
39068,النهاية,0,0,1,1
39067,tolke.,0,0,1,1
39066,duyarım.,0,0,1,1
39065,demasia,0,0,1,1
39064,eisenberg,0,0,1,1
39063,അവബോധം,0,0,1,1
39062,ف.,0,0,1,1
39059,ಇಬ್ಬರಿಗೂ,0,0,1,1
39058,independência,0,0,1,1
39057,رسمي,0,0,1,1
39056,laundry,0,0,1,1
39055,ഭാഗമായി,0,0,1,1
39054,uzaklaştılar.,0,0,1,1
39052,stunningly,0,0,1,1
39051,değilseniz,0,0,1,1
39049,cares,0,0,1,1
39047,നുറുങ്ങ്,0,0,1,1
51278,സ്വർണ്ണവണ്ടി,0,0,1,1
39005,insertion,0,0,1,1
51264,heette.,0,0,1,1
38949,एली,0,0,1,1
38943,маленький,0,0,1,1
38945,distributes,0,0,1,1
38946,सरकारी,0,0,1,1
38947,published.,0,0,1,1
51288,εκπληρώνουν,0,0,1,1
38948,número.,0,0,1,1
38953,geçerli,0,0,1,1
38939,nyare,0,0,1,1
38955,probabilísticas,0,0,1,1
38956,relaterede,0,0,1,1
51286,benziyorsun,0,0,1,1
38957,allez-y,0,0,1,1
38959,consiguió,0,0,1,1
38960,giechelde,0,0,1,1
38942,gelsin.,0,0,1,1
38937,someten,0,0,1,1
39003,lingüísticas,0,0,1,1
38925,कोर्ट,0,0,1,1
51290,ordförråd.,0,0,1,1
38919,செய்துகொண்டிருந்தபோது,0,0,1,1
38920,замуж.,0,0,1,1
38922,objectivity,0,0,1,1
38923,splits,0,0,1,1
38924,пятым,0,0,1,1
38926,kritiek,0,0,1,1
38935,android-enheder,0,0,1,1
38927,angives,0,0,1,1
38928,التوالي،,0,0,1,1
38931,ಏನಾಗುತ್ತದೆ,0,0,1,1
51289,heyecanlanıyoruz,0,0,1,1
38932,fechamento,0,0,1,1
38934,suretiyle,0,0,1,1
38961,извиняюсь.,0,0,1,1
38962,англоязычный,0,0,1,1
38964,функциями,0,0,1,1
38992,வழியாகும்,0,0,1,1
38988,voyage,0,0,1,1
38989,zullen,0,0,1,1
51280,iddia,0,0,1,1
51279,англоцентризме,0,0,1,1
38990,reshaped,0,0,1,1
38991,ടൂറിസ്റ്റിലോ,0,0,1,1
38995,الفلبين.,0,0,1,1
38966,intéressante,0,0,1,1
38996,لعبتك.,0,0,1,1
38997,пообещал,0,0,1,1
38999,الطاقة,0,0,1,1
39000,courant,0,0,1,1
39001,gevallen,0,0,1,1
39002,مسؤولين,0,0,1,1
38987,вонючая,0,0,1,1
38986,वक्ताओं,0,0,1,1
38984,прилагающейся,0,0,1,1
38983,κλασικές,0,0,1,1
38982,തലയിൽ,0,0,1,1
38981,സൂചിപ്പിക്കുന്ന,0,0,1,1
38979,croyance.,0,0,1,1
38978,എന്നല്ല,0,0,1,1
38975,«wiki,0,0,1,1
38973,настоящем,0,0,1,1
38972,référant,0,0,1,1
51284,ಮಹಿಳೆ,0,0,1,1
38970,ελληνόφωνη,0,0,1,1
38969,அழுவதையும்,0,0,1,1
51285,olabilir.,0,0,1,1
38968,النهائية,0,0,1,1
38967,люблю,0,0,1,1
39087,översättningar,0,0,1,1
39089,raiva,0,0,1,1
38917,небесам»,0,0,1,1
39207,новостей.,0,0,1,1
39198,വാക്യങ്ങൾ‌,0,0,1,1
39200,οποτεδήποτε.,0,0,1,1
51247,vivantes,0,0,1,1
39201,मेनवल,0,0,1,1
39202,разрешён.,0,0,1,1
51246,interwiki,0,0,1,1
39208,தினசரி,0,0,1,1
39196,förblir,0,0,1,1
39209,temario,0,0,1,1
39212,rodinia,0,0,1,1
39213,плачет,0,0,1,1
39214,высокого,0,0,1,1
39215,प्रेरणा,0,0,1,1
39216,förhållande,0,0,1,1
39197,സാമാന്യവത്കരണം,0,0,1,1
51249,engines‏,0,0,1,1
39176,alemão.de,0,0,1,1
39186,لتتعلم,0,0,1,1
39178,balanced,0,0,1,1
39179,تشعر,0,0,1,1
39180,തരാം,0,0,1,1
39181,nobelpristagare.,0,0,1,1
39182,bedenker,0,0,1,1
39183,tun.,0,0,1,1
39187,häpnadsväckande.,0,0,1,1
39194,الفاخرة,0,0,1,1
39189,φέτος,0,0,1,1
39190,narcissushand,0,0,1,1
39191,неудач,0,0,1,1
39192,diyorsunuz,0,0,1,1
39193,dejaste,0,0,1,1
51250,directrice,0,0,1,1
51243,förekomsten,0,0,1,1
39217,صديقك,0,0,1,1
39220,പുറത്തുവന്ന്,0,0,1,1
39247,نول,0,0,1,1
39241,mamãe,0,0,1,1
39242,continuant,0,0,1,1
39243,managers,0,0,1,1
39244,interaccionar,0,0,1,1
39245,gördüğünüzü,0,0,1,1
51238,تمول,0,0,1,1
39248,inscrever,0,0,1,1
51242,blokkeerde,0,0,1,1
39251,auktoritetsbristen,0,0,1,1
39253,adecuada,0,0,1,1
39255,romains,0,0,1,1
51236,webben,0,0,1,1
39257,ildelugtende,0,0,1,1
39259,എഴുതുമ്പോൾ,0,0,1,1
39239,le.,0,0,1,1
39238,ഓർക്കുക.,0,0,1,1
39236,narcissmamma,0,0,1,1
39234,கேளுங்கள்.,0,0,1,1
39233,تذكره,0,0,1,1
39232,équitable.,0,0,1,1
39231,تجميعها,0,0,1,1
39230,പ്രേരിപ്പിക്കുന്നതെന്താണ്,0,0,1,1
39229,stormachtig,0,0,1,1
51239,improbable,0,0,1,1
39227,uyar.,0,0,1,1
51240,obtengas,0,0,1,1
51241,γλώσσα,0,0,1,1
39225,कदम,0,0,1,1
39224,charges,0,0,1,1
39223,entails,0,0,1,1
39222,symptoms,0,0,1,1
39177,पहुँचायी,0,0,1,1
39175,पन्ना,0,0,1,1
39090,réparé,0,0,1,1
39121,википедия.,0,0,1,1
51262,விவரிக்கப்,0,0,1,1
39115,startades,0,0,1,1
39116,aufhörte,0,0,1,1
39118,greenhouse,0,0,1,1
39119,पेटेंट,0,0,1,1
39120,защиту,0,0,1,1
39122,guldbrödet,0,0,1,1
51263,pourcentages,0,0,1,1
39123,maladies,0,0,1,1
39124,cumhuriyeti,0,0,1,1
51259,formado,0,0,1,1
39126,subcampo,0,0,1,1
39127,முக்கியமாகத்,0,0,1,1
39128,-fold,0,0,1,1
39112,franchi,0,0,1,1
39109,законов,0,0,1,1
51254,خرج,0,0,1,1
39099,langue.,0,0,1,1
39092,ആശയക്കുഴപ്പത്തിലാകുന്നത്,0,0,1,1
39093,जानी,0,0,1,1
39094,drücken,0,0,1,1
39095,ترغب,0,0,1,1
39097,критерии,0,0,1,1
39098,dvd-диск,0,0,1,1
39100,keşke,0,0,1,1
39107,фурор.,0,0,1,1
39101,censée,0,0,1,1
39102,മലയാളഭാഷയിൽ,0,0,1,1
39103,хотела,0,0,1,1
39104,للتكرار,0,0,1,1
39105,maravilhoso,0,0,1,1
39106,-bibliotheek,0,0,1,1
39129,மாதம்,0,0,1,1
39130,телефон,0,0,1,1
39131,nationalities,0,0,1,1
39163,минут,0,0,1,1
39155,निर्देशांक,0,0,1,1
39157,вырастет,0,0,1,1
39158,usemodwiki.,0,0,1,1
39160,கொண்டிருந்தது,0,0,1,1
39161,பெறுகிறார்கள்.,0,0,1,1
39162,ಎಲ್ಲ,0,0,1,1
39166,ചാലക്കുടി,0,0,1,1
39132,ई,0,0,1,1
39167,holistique,0,0,1,1
39168,canton,0,0,1,1
39169,உண்மையான,0,0,1,1
39170,suivie,0,0,1,1
39171,västerländska,0,0,1,1
39173,real.,0,0,1,1
51256,طرف.,0,0,1,1
51257,ईमानदार,0,0,1,1
51258,تكريم,0,0,1,1
39151,पिला,0,0,1,1
39150,story,0,0,1,1
39149,സുഹൃത്തിനോട്,0,0,1,1
39148,lanserat,0,0,1,1
39147,uitkomt.,0,0,1,1
39145,таков.,0,0,1,1
39143,comencemos.,0,0,1,1
39142,нанять,0,0,1,1
39141,попрощаться.,0,0,1,1
39137,γνώμη,0,0,1,1
39136,tidsskriftet.,0,0,1,1
39135,сохраняют,0,0,1,1
39134,pu.,0,0,1,1
39133,உணர்த்தியுள்ளது,0,0,1,1
38918,എന്നതിനർത്ഥം,0,0,1,1
38916,implicitamente,0,0,1,1
51341,elogios,0,0,1,1
38664,മാനസികമായി,0,0,1,1
38656,mall,0,0,1,1
38659,spännande,0,0,1,1
38660,تتخطى,0,0,1,1
38661,fahrt,0,0,1,1
38662,especificando,0,0,1,1
38663,presidential,0,0,1,1
38667,quantité,0,0,1,1
51329,house,0,0,1,1
38668,uppgifterna,0,0,1,1
38669,لمقطع,0,0,1,1
38672,sofistikeret.,0,0,1,1
38673,ήρθατε.,0,0,1,1
38674,volontaire,0,0,1,1
38675,deportes,0,0,1,1
38655,confusions,0,0,1,1
51330,أمستردام,0,0,1,1
38630,फ्यूचर,0,0,1,1
38643,pregunte,0,0,1,1
38632,древней,0,0,1,1
38635,كشف,0,0,1,1
38637,докажете,0,0,1,1
51331,أفادت,0,0,1,1
38641,சவாரிக்குப்,0,0,1,1
38642,والبولندية,0,0,1,1
38644,ml ,0,0,1,1
38653,आरोन,0,0,1,1
38645,ഇന്നുള്ള,0,0,1,1
38646,ತಿಳಿದಿದೆಯೆ,0,0,1,1
38649,തുടക്കത്തിനുശേഷം,0,0,1,1
38650,inheritable,0,0,1,1
38651,सिंहला,0,0,1,1
38652,d'enquête,0,0,1,1
38676,описанные,0,0,1,1
51326,erziehen,0,0,1,1
38679,முன்னிறுத்தப்பட்டது.,0,0,1,1
51319,ನಿಲುಗಡೆ,0,0,1,1
38700,റഫർ,0,0,1,1
38702,возможную,0,0,1,1
38704,genèse,0,0,1,1
38705,golpes,0,0,1,1
38706,groß,0,0,1,1
38708,കൃത്രിമബുദ്ധിയുടെ,0,0,1,1
38712,niche,0,0,1,1
38680,എപ്പോൾ,0,0,1,1
38713,weggaf,0,0,1,1
38714,operational,0,0,1,1
38716,έρθει,0,0,1,1
38718,कॉपी,0,0,1,1
51318,περίπτωσή,0,0,1,1
38720,लगाती,0,0,1,1
38699,preferiría,0,0,1,1
51321,الزواج,0,0,1,1
51322,தெரிந்தால்,0,0,1,1
38697,искусствоведческой,0,0,1,1
51323,ευγενικά.,0,0,1,1
38694,மீளமைக்கவோ,0,0,1,1
38693,certains.,0,0,1,1
38692,atuais,0,0,1,1
51324,அல்லது.,0,0,1,1
38690,exemplares,0,0,1,1
38689,allmänhetens,0,0,1,1
38688,नवंबर,0,0,1,1
51325,ನೋಡಿದಾಗಿನಿಂದ,0,0,1,1
38685,şerefe,0,0,1,1
38684,iyiydim,0,0,1,1
38683,extractos,0,0,1,1
38682,actualizó,0,0,1,1
38631,pudo,0,0,1,1
38627,open.,0,0,1,1
38723,como',0,0,1,1
38567,مهتمًا,0,0,1,1
38560,hongrois,0,0,1,1
38562,त्रुटियां,0,0,1,1
38563,burası,0,0,1,1
51336,ചതുപ്പിന്റെ,0,0,1,1
38565,snegl,0,0,1,1
38566,отвергла,0,0,1,1
38568,öğrencilerin,0,0,1,1
38557,contraire ,0,0,1,1
38569,இறைச்சி,0,0,1,1
38570,ortasındayken,0,0,1,1
38572,φτωχοί,0,0,1,1
38574,fate,0,0,1,1
51335,مقترحين,0,0,1,1
38576,பொருத்தவரை,0,0,1,1
38559,отсеиваются,0,0,1,1
51337,εξέταση,0,0,1,1
38625,настоянию,0,0,1,1
38543,nerdy,0,0,1,1
38537,australiskt,0,0,1,1
38538,карету,0,0,1,1
38539,offentlighed.,0,0,1,1
38540,цитировано,0,0,1,1
38541,destin,0,0,1,1
38542,волочить,0,0,1,1
38549,الستينيات,0,0,1,1
51338,بعامين،,0,0,1,1
38550,mind.,0,0,1,1
38552,uafhængig.,0,0,1,1
38553,wikia.,0,0,1,1
38554,اتهم,0,0,1,1
51340,научным,0,0,1,1
51339,tá,0,0,1,1
38578,मामलों,0,0,1,1
38579,ämne,0,0,1,1
38580,ιστό,0,0,1,1
51332,frikipedia,0,0,1,1
51333,नीतियां।,0,0,1,1
38609,elles-mêmes,0,0,1,1
38611,விட்டு,0,0,1,1
38612,soyons,0,0,1,1
38613,πάω.,0,0,1,1
38614,أعرف.,0,0,1,1
38617,ഞങ്ങളോട്,0,0,1,1
38582,allvarliga,0,0,1,1
38618,согласиться,0,0,1,1
38619,cinéma,0,0,1,1
38620,princesse,0,0,1,1
38621,vocabulario,0,0,1,1
38622,собой.,0,0,1,1
38624,kahvenizi,0,0,1,1
51334,représentent,0,0,1,1
38603,टारण्टीनो,0,0,1,1
38602,ലഭിക്കേണ്ടതാണ്.,0,0,1,1
38600,usbeque,0,0,1,1
38599,accusation,0,0,1,1
38598,विकिपुस्तक,0,0,1,1
38597,κάστρο,0,0,1,1
38596,móviles.,0,0,1,1
38595,motsvarade,0,0,1,1
38594,ಉತ್ಸುಕರಾಗಿದ್ದೇವೆ.,0,0,1,1
38593,νιώθω,0,0,1,1
38592,patatas,0,0,1,1
38589,séparée,0,0,1,1
38586,proposant,0,0,1,1
38585,¿dónde,0,0,1,1
38584,educadamente.,0,0,1,1
38583,سيتم,0,0,1,1
38722,مئات,0,0,1,1
38724,ಮೊದಲು.,0,0,1,1
38915,exception,0,0,1,1
51299,tediosas,0,0,1,1
38857,தாண்டின.,0,0,1,1
38858,اختبار,0,0,1,1
38859,بدء,0,0,1,1
38861,المتباينة,0,0,1,1
51300,«будущее,0,0,1,1
38864,sahiptir.,0,0,1,1
38867,العالمية,0,0,1,1
38855,волнуйся,0,0,1,1
51298,ലഭിച്ചോ,0,0,1,1
38870,habermas,0,0,1,1
38871,saltwater,0,0,1,1
38872,இருந்தோம்,0,0,1,1
38873,recomponha.,0,0,1,1
38874,يتلاعب,0,0,1,1
38856,«человеком,0,0,1,1
38853,je',0,0,1,1
38826,rédigées,0,0,1,1
38841,mutluyum,0,0,1,1
38828,auxquels,0,0,1,1
38831,ஆங்கிலச்,0,0,1,1
38832,bulmuştur.,0,0,1,1
38837,ссылкой,0,0,1,1
38839,suspected,0,0,1,1
38840,ಜೀವಂತವಾಗಿದ್ದ,0,0,1,1
38843,aware,0,0,1,1
38852,correta,0,0,1,1
38844,диване.,0,0,1,1
38846,പ്ലേറ്റിൽ,0,0,1,1
38847,спроса.,0,0,1,1
38848,ಏಕೈಕ,0,0,1,1
38849,atmen,0,0,1,1
38850,derseniz.,0,0,1,1
38876,risitas,0,0,1,1
38877,secondes,0,0,1,1
38878,يصدق,0,0,1,1
38906,röd,0,0,1,1
38899,acercó.,0,0,1,1
38900,ಕೆಟ್ಟದು,0,0,1,1
38902,περιβάλλουν,0,0,1,1
38903,ünlü,0,0,1,1
38904,любому,0,0,1,1
38905,deltar,0,0,1,1
38908,prédéterminées,0,0,1,1
38879,repareren.,0,0,1,1
51294,constater,0,0,1,1
51293,μαγική,0,0,1,1
38911,rápida,0,0,1,1
51291,कैचिंग,0,0,1,1
38913,الروابط,0,0,1,1
38914,πολιτική,0,0,1,1
38898,ko •,0,0,1,1
38896,hurricanes,0,0,1,1
38894,willst.,0,0,1,1
38893,frontières,0,0,1,1
38891,l'optimisation,0,0,1,1
38890,universitet,0,0,1,1
38889,korsade,0,0,1,1
38888,datanamnrymd,0,0,1,1
38887,بالخوف,0,0,1,1
38886,blijken,0,0,1,1
38884,influenciado,0,0,1,1
38882,फाउन्डिंग,0,0,1,1
38881,género.,0,0,1,1
51295,نطقك,0,0,1,1
51296,തുടങ്ങി.,0,0,1,1
38880,kontakt,0,0,1,1
51297,системную,0,0,1,1
38827,¿eh,0,0,1,1
38825,exaggerate,0,0,1,1
38725,mapa,0,0,1,1
38760,fréquentés,0,0,1,1
38749,unidos.,0,0,1,1
38751,фантастические,0,0,1,1
38754,atrapado,0,0,1,1
38755,разнородными.,0,0,1,1
38757,കാശ്മീർ,0,0,1,1
38759,operação,0,0,1,1
51312,ನೀವು,0,0,1,1
38746,ಸುಂದರವಾಗಿದ್ದೀರಿ,0,0,1,1
38763,विध्वंस-प्रवण,0,0,1,1
38764,أنا؟,0,0,1,1
38765,naturally,0,0,1,1
38766,apresentassem,0,0,1,1
38768,ಉಡುಗೊರೆಯನ್ನು,0,0,1,1
38769,colaborativa,0,0,1,1
51314,juli.,0,0,1,1
38744,leaves,0,0,1,1
38823,камнями,0,0,1,1
38733,bristen,0,0,1,1
38726,тексты,0,0,1,1
38727,ನಿಧಾನವಾಗಿರುತ್ತದೆ,0,0,1,1
38728,சொன்னால்.,0,0,1,1
38730,الإلكترونية,0,0,1,1
38731,وكيف.,0,0,1,1
38732,ಕರೆಯಲು,0,0,1,1
38735,hield.,0,0,1,1
38743,médiatisées,0,0,1,1
38736,tracking,0,0,1,1
38737,certos,0,0,1,1
38738,éclairé,0,0,1,1
38740,verdrietig,0,0,1,1
38741,agreeable,0,0,1,1
38742,சரியில்லை,0,0,1,1
38771,notified,0,0,1,1
38772,யோசிக்கிறேன்.,0,0,1,1
38773,ekonomi,0,0,1,1
38813,шутку,0,0,1,1
38801,perçues,0,0,1,1
38802,ചേർന്നൊരു,0,0,1,1
38803,виделись.,0,0,1,1
38806,louco.,0,0,1,1
38809,വിവരണ,0,0,1,1
38811,الشهير,0,0,1,1
38815,passaram,0,0,1,1
51310,नकली,0,0,1,1
38816,mécaniste,0,0,1,1
38817,l'arrêt,0,0,1,1
38818,problème »,0,0,1,1
38819,ನೋಡದಿದ್ದಾಗ,0,0,1,1
38820,ಮುಂದುವರಿಯಿರಿ,0,0,1,1
38821,വ്യക്തിയാണെന്നും,0,0,1,1
38799,autonome.,0,0,1,1
38798,tosh.,0,0,1,1
38797,φέτα,0,0,1,1
38796,d'expériences,0,0,1,1
51307,воспользуюсь,0,0,1,1
38793,هاتفي,0,0,1,1
38791,panslavon,0,0,1,1
38790,இருவருமே,0,0,1,1
38789,πάρω,0,0,1,1
38786,alfabetos,0,0,1,1
38784,dukke,0,0,1,1
38783,сенсация,0,0,1,1
38779,d'universalis,0,0,1,1
38778,skratta,0,0,1,1
38777,يُعرف,0,0,1,1
38776,substantia.,0,0,1,1
51309,മാതൃകയെ,0,0,1,1
40781,funcionando,0,0,1,1
40782,tretikov's,0,0,1,1
51038,feinste,0,0,1,1
42792,disasters,0,0,1,1
42786,informations.,0,0,1,1
42787,बोलने,0,0,1,1
42788,التقليدية،,0,0,1,1
42789,മനസിലാക്കിയാൽ,0,0,1,1
42790,للدلالة,0,0,1,1
42791,которому,0,0,1,1
42793,indfødte,0,0,1,1
42784,   articles,0,0,1,1
42794,elevar,0,0,1,1
42795,cometí,0,0,1,1
42797,القانونية،,0,0,1,1
42798,despercebida,0,0,1,1
42800,وأحكام,0,0,1,1
42802,temperatures,0,0,1,1
42785,modificado,0,0,1,1
50754,பிரச்சனையும்,0,0,1,1
42763,ex ,0,0,1,1
42773,vacker.,0,0,1,1
42765,groei,0,0,1,1
50756,ಇಲ್ಲದೆ,0,0,1,1
42767,dags,0,0,1,1
42768,seks,0,0,1,1
42770,indsætte,0,0,1,1
42772,ranges,0,0,1,1
42776,efeito,0,0,1,1
42782,disco,0,0,1,1
42777,ukrainien,0,0,1,1
42778,الغداء,0,0,1,1
50755,cidade.,0,0,1,1
42779,للاستخدام,0,0,1,1
42780,familière,0,0,1,1
42781,visualización,0,0,1,1
42803,suportada,0,0,1,1
42804,سينتهي,0,0,1,1
42806,ചോദ്യമാണ്.,0,0,1,1
42836,ഇക്കാര്യത്തിലും,0,0,1,1
42828,énergisante,0,0,1,1
50748,«espejos»,0,0,1,1
42830,удивительного,0,0,1,1
42832,заниматься,0,0,1,1
42833,ses.,0,0,1,1
42835,έτρεξε,0,0,1,1
42837,البرنامج،,0,0,1,1
42807,ağlamasın,0,0,1,1
42838,ಪ್ರಯಾಣದ,0,0,1,1
42839,προς,0,0,1,1
42842,ouvindo.,0,0,1,1
42843,imaginar,0,0,1,1
42845,viva,0,0,1,1
42846,solucionar,0,0,1,1
42827,threatening,0,0,1,1
42826,hopelijk,0,0,1,1
50749,older,0,0,1,1
50750,línea.,0,0,1,1
42820,desacordo,0,0,1,1
42818,imite,0,0,1,1
42817,npov,0,0,1,1
42816,விக்கிப்பீடியாக்களில்,0,0,1,1
42815,അസ്വസ്ഥനാണ്.,0,0,1,1
42814,objet.,0,0,1,1
42812,ihlalleri,0,0,1,1
42811,debattörer,0,0,1,1
42810,inició,0,0,1,1
50752,பார்த்தால்.,0,0,1,1
50753,mantidas.,0,0,1,1
42809,ഉറപ്പുവരുത്തുന്നതിന്,0,0,1,1
42808,ошибку,0,0,1,1
42764,ಒಬ್ಟ್ಯೂಸ್,0,0,1,1
42761,ಆಶ್ಚರ್ಯಚಕಿತರಾಗಲು,0,0,1,1
42848,kingdoms,0,0,1,1
42697,undersöks,0,0,1,1
42689,തത്ത്വത്തിലാണ്,0,0,1,1
42690,συνηθισμένη,0,0,1,1
42692,ഗുണാങ്കങ്ങളുടെ,0,0,1,1
42694,sverker,0,0,1,1
42695,глаза,0,0,1,1
42696,bestäms,0,0,1,1
42698,tillmätas,0,0,1,1
50763,basados,0,0,1,1
42699,شوارتز,0,0,1,1
42701,तुम्हारे,0,0,1,1
42702,existieron,0,0,1,1
50761,الرائع,0,0,1,1
42704,registro,0,0,1,1
42705,பெயர்கள்,0,0,1,1
42688,danés,0,0,1,1
42687,recuerde,0,0,1,1
42760,пишет,0,0,1,1
50764,sugieren,0,0,1,1
42671,betrof,0,0,1,1
42673,« naturels »,0,0,1,1
42674,बराक,0,0,1,1
42675,birth.,0,0,1,1
42676,معلموا,0,0,1,1
42677,insuffisances,0,0,1,1
42678,വിക്കിപീഡിയകളായ,0,0,1,1
42686,representaban,0,0,1,1
42679,outliers,0,0,1,1
42680,تعديله.,0,0,1,1
42681,replacement,0,0,1,1
42682,diagnósticos,0,0,1,1
42683,persondatorer,0,0,1,1
42685,للقوات,0,0,1,1
42706,synen,0,0,1,1
42707,cybersécurité,0,0,1,1
42708,உருவாக்கப்பட்டு,0,0,1,1
42751,கவனிப்பதில்லை.,0,0,1,1
42742,കേൾക്കുമ്പോൾ.,0,0,1,1
42743,  images[k],0,0,1,1
42746,whereas,0,0,1,1
42748,अमृत,0,0,1,1
42749,справочника,0,0,1,1
42750,едва,0,0,1,1
42753,chegarem,0,0,1,1
42709,homepage,0,0,1,1
42754,figures,0,0,1,1
50758,cloud,0,0,1,1
42755,sonraları,0,0,1,1
42756,contigo.,0,0,1,1
42758,geoinformação.,0,0,1,1
42759,colocando,0,0,1,1
42741,teach,0,0,1,1
42740,worldwide.,0,0,1,1
42739,semillas,0,0,1,1
42738,l’entraînant,0,0,1,1
42737,ganglia[af],0,0,1,1
42734,wikipediaartiklars,0,0,1,1
42731,güney,0,0,1,1
42730,espérons-le.,0,0,1,1
42728,جادًا,0,0,1,1
42725,nadenken.,0,0,1,1
42724,inteira,0,0,1,1
42721,différence,0,0,1,1
50760,объективно,0,0,1,1
42716,ನಿಮಿಷದಲ್ಲಿ,0,0,1,1
42715,இணையத்தள,0,0,1,1
42713,lionel,0,0,1,1
42712,തടയാറുണ്ട്.,0,0,1,1
42847,ilgilenmiyorsan,0,0,1,1
42849,антиэлитаризм,0,0,1,1
42669,pratiques ».,0,0,1,1
50726,greetings,0,0,1,1
42966,ontbrak,0,0,1,1
50727,transphobie,0,0,1,1
42971,ρωτάτε.,0,0,1,1
42972,فالزوجة,0,0,1,1
42973,hoşgörü,0,0,1,1
42974,للعربية.,0,0,1,1
50725,faisait,0,0,1,1
42962,anos.,0,0,1,1
42976,también.,0,0,1,1
50724,возражаешь,0,0,1,1
42981,organisées,0,0,1,1
42982,helado,0,0,1,1
42983,ämnet.,0,0,1,1
42985,varelser,0,0,1,1
42963,निर्देशों,0,0,1,1
42961,للكلمة.,0,0,1,1
42932,തെളിയിച്ചില്ലെങ്കിൽ,0,0,1,1
42947,hoppar,0,0,1,1
42938,उधार,0,0,1,1
42939,عنوان,0,0,1,1
42940,ದಣಿದಿದ್ದೀರಾ,0,0,1,1
42941,австрии,0,0,1,1
42942,« encyclopédie,0,0,1,1
42946,കാര്യങ്ങളിലും,0,0,1,1
50734,californie.,0,0,1,1
42959,dosyaları,0,0,1,1
42951,खूबसूरती,0,0,1,1
50732,താൾ,0,0,1,1
42953,मांगने,0,0,1,1
42956,netfront,0,0,1,1
50730,إلكترونية.,0,0,1,1
42957,d'économie,0,0,1,1
42986,parlant,0,0,1,1
42987,meşgulse,0,0,1,1
42990,physiques,0,0,1,1
43024,n'aurait,0,0,1,1
43015,dublinés,0,0,1,1
43017,neither,0,0,1,1
43019,αστεροειδών,0,0,1,1
43020,chegavam,0,0,1,1
43021,موسوعة.,0,0,1,1
43023,ഗുണനിലവാരം,0,0,1,1
43025,राजनितिक,0,0,1,1
42991,fall.,0,0,1,1
50718,कोक,0,0,1,1
43027,amène,0,0,1,1
43029,ಕೆಂಪು,0,0,1,1
43030,utilização,0,0,1,1
43033,σούπα,0,0,1,1
43034,பரபரப்பான,0,0,1,1
43014,расчленяются,0,0,1,1
43013,rituais,0,0,1,1
43012,elbiselerden,0,0,1,1
43011,существительное,0,0,1,1
43010,لإخبار,0,0,1,1
43009,governo,0,0,1,1
43008,provavelmente,0,0,1,1
43007,accrue,0,0,1,1
43005,reconsideró,0,0,1,1
43004,τείνουμε,0,0,1,1
50720,apropriadas,0,0,1,1
43002,şaşırdı,0,0,1,1
43001,« proches,0,0,1,1
43000,asturiano,0,0,1,1
42997,l'importance,0,0,1,1
42996,produktiva,0,0,1,1
42993,تغذية,0,0,1,1
42937,περιοχή,0,0,1,1
42931,bibliotheken,0,0,1,1
42850,ಕ್ರಿಯಾಪದವು,0,0,1,1
42881,breeding,0,0,1,1
42874,विवादों,0,0,1,1
42875,японском,0,0,1,1
42877,വസ്തുതകളോട്,0,0,1,1
50744,atrocious.,0,0,1,1
42879,suck,0,0,1,1
42880,maintaining,0,0,1,1
42882,d'athéisme.,0,0,1,1
42872,மனிதர்களாக,0,0,1,1
42883,förhoppningsvis,0,0,1,1
42885,near-perfect,0,0,1,1
42886,объясните,0,0,1,1
42887,ദുരുദ്ദേശ്യത്തോടുകൂടി,0,0,1,1
42888,d'appareils,0,0,1,1
42889,révèlent,0,0,1,1
42873,snelle,0,0,1,1
42869,statement,0,0,1,1
42930,immense,0,0,1,1
42858,அமைதிப்படுத்திக்,0,0,1,1
42851,viewers',0,0,1,1
42853,கடுமையாக,0,0,1,1
42854,помните.,0,0,1,1
42855,स्टोरी,0,0,1,1
42856,supin.,0,0,1,1
42857,wapedia.,0,0,1,1
42859,ಹಿಡಿದುಕೊಳ್ಳಿ.,0,0,1,1
42868,réussit,0,0,1,1
42861,விக்கிப்பீடியா.ஓர்க்,0,0,1,1
42862,permaneceu,0,0,1,1
42863,exato.,0,0,1,1
42864,källan,0,0,1,1
50746,voces,0,0,1,1
50745,какая-то,0,0,1,1
42890,finder,0,0,1,1
50741,الكتابة,0,0,1,1
42891,referenser,0,0,1,1
42920,вторичных,0,0,1,1
42913,ಹುಡುಕುತ್ತಿದ್ದರೆ,0,0,1,1
42915,mangelhaft,0,0,1,1
42916,leeftijd,0,0,1,1
50737,recherchons,0,0,1,1
42917,interpretativa,0,0,1,1
42919,l'appui,0,0,1,1
42921,endişeye,0,0,1,1
42892,διασκεδαστικό,0,0,1,1
42922,parou,0,0,1,1
42924,decide,0,0,1,1
50735,funktionen,0,0,1,1
42927,acusá-la,0,0,1,1
42928,ersättning.,0,0,1,1
42929,derude,0,0,1,1
42911,смотрела,0,0,1,1
42909,peticiones.,0,0,1,1
42908,എവിടെയെങ്കിലും,0,0,1,1
42907,αμφισβητούμενο.,0,0,1,1
42906,verre,0,0,1,1
50738,free-knowledge,0,0,1,1
42905,السعيد,0,0,1,1
50739,hvilke,0,0,1,1
42904,мэриан.,0,0,1,1
42903,صعوبة,0,0,1,1
42902,роду,0,0,1,1
42900,الفزع,0,0,1,1
42898,launches,0,0,1,1
42897,الانقسام,0,0,1,1
42895,ab,0,0,1,1
42894,नाक,0,0,1,1
42893,ചോദിക്കാം,0,0,1,1
42670,interativa,0,0,1,1
42666,സിനിമകൾക്കായി,0,0,1,1
43037,compreensíveis,0,0,1,1
42418,türkiye'den,0,0,1,1
42410,things.,0,0,1,1
50798,предпочли,0,0,1,1
42414,höfling en,0,0,1,1
42415,rapporterats,0,0,1,1
42416,asociado,0,0,1,1
42417,{burger},0,0,1,1
42419,κρέας,0,0,1,1
42404,detail,0,0,1,1
42420,practicar,0,0,1,1
42422,seslerin,0,0,1,1
42423,लंबा,0,0,1,1
42425,पासवर्ड,0,0,1,1
42426,σωστό,0,0,1,1
42427,idiomáticas,0,0,1,1
42409,ಸಂತೋಷದಿಂದ,0,0,1,1
50801,planctu,0,0,1,1
42379,சொல்லக்கூடிய,0,0,1,1
42394,conocerte.,0,0,1,1
42384,before.,0,0,1,1
42385,endişelenmeyin.,0,0,1,1
42386,l'architecture,0,0,1,1
42388,deshecho,0,0,1,1
42389,ചുറ്റും,0,0,1,1
42391,பிடித்தது,0,0,1,1
50803,முகத்தில்,0,0,1,1
42402,karışmış,0,0,1,1
42395,столовую,0,0,1,1
50802,grubun,0,0,1,1
42396,تنسى,0,0,1,1
42398,coolen,0,0,1,1
42400,മാലാഖയെപ്പോലെയാണ്,0,0,1,1
42401,смотрите,0,0,1,1
50797,வாருங்கள்,0,0,1,1
42430,എന്നിവയാണ്,0,0,1,1
42431,ആവുന്നതിനു,0,0,1,1
42458,лучших,0,0,1,1
42449,entschuldigen.,0,0,1,1
42450,soñaste.,0,0,1,1
42451,esforço.,0,0,1,1
42453,esquece.,0,0,1,1
42455,vagueness,0,0,1,1
42457,وبكلمات,0,0,1,1
42461,merendeels,0,0,1,1
42432,generelle,0,0,1,1
42463,التحليلات,0,0,1,1
42466,दुखी,0,0,1,1
42467,bilmiyorsunuz,0,0,1,1
42468,в переводе,0,0,1,1
42469,förhand.,0,0,1,1
42470,köpcentret,0,0,1,1
42448,arriba,0,0,1,1
50791,dagar,0,0,1,1
42447,umulig,0,0,1,1
42446,സംവിധാനമാണ്‌,0,0,1,1
42445,espagnol,0,0,1,1
42444,wii,0,0,1,1
42442,إطار,0,0,1,1
42441,strikser,0,0,1,1
42440,voulais,0,0,1,1
50793,ബെൽ,0,0,1,1
42438,balkondan,0,0,1,1
42437,«сообщество».,0,0,1,1
50794,الربح.,0,0,1,1
50795,variances,0,0,1,1
50796,incidents,0,0,1,1
42434,iesc-geekcorps-mali,0,0,1,1
42433,βασικούς,0,0,1,1
50805,പ്രതിഭാസങ്ങളെയും,0,0,1,1
42378,घटनाएं,0,0,1,1
42472,birgitta,0,0,1,1
42317,partidos,0,0,1,1
42306,totalmente,0,0,1,1
42311,ചിരിക്കാൻ,0,0,1,1
42312,എന്തുകൊണ്ടെന്ന്,0,0,1,1
42315,provável,0,0,1,1
42316,xviiie siècle,0,0,1,1
50816,prepubescent,0,0,1,1
42318,logoları,0,0,1,1
42303,запись,0,0,1,1
42319,davrandığının,0,0,1,1
42320,ಣಾತ್ಮಕವಾಗಿರಬಹುದು,0,0,1,1
42322,وول,0,0,1,1
42324,particuliers,0,0,1,1
50812,посещаемости,0,0,1,1
42329,योजनाओं,0,0,1,1
42304,веб-сайта,0,0,1,1
42302,heraclitus,0,0,1,1
42377,aplicables,0,0,1,1
42292,ediciones​,0,0,1,1
42283,gericht,0,0,1,1
42286,எனக்குப்,0,0,1,1
50820,സമ്പത്തും,0,0,1,1
42287,तलाश,0,0,1,1
42289,തിരയലിൽ,0,0,1,1
42291,stelde,0,0,1,1
42293,χρειάζεστε,0,0,1,1
42301,perdeu,0,0,1,1
42294,rastreado.,0,0,1,1
42295,hataları,0,0,1,1
42296,publiken.,0,0,1,1
50818,ഗെയിമിനെ,0,0,1,1
42298,ഹിന്ദി,0,0,1,1
42299,åtgärder,0,0,1,1
42331,கொள்கை,0,0,1,1
42332,μη-brainer,0,0,1,1
42333,criá-los,0,0,1,1
42362,xviiie siècle.,0,0,1,1
42355,العظمى,0,0,1,1
50809,disambiguation.,0,0,1,1
42357,ഒരർത്ഥത്തിൽ,0,0,1,1
42358,começar.,0,0,1,1
42359,gråt,0,0,1,1
42360,கண்ணாடியில்,0,0,1,1
42363,βιδώσω,0,0,1,1
42335,grippe.,0,0,1,1
42364,ಉತ್ತಮವಾಗಿದೆ.,0,0,1,1
42365,ಅದಕ್ಕಾಗಿ,0,0,1,1
42367,soucis,0,0,1,1
42370,لاحقا.,0,0,1,1
42373,रुचियों,0,0,1,1
42375,उठाने,0,0,1,1
42354,harvard's,0,0,1,1
42353,проектами,0,0,1,1
42352,കാലാന്തരത്തിൽ,0,0,1,1
42350,ಸಹಾಯಕವಾಗಿದೆಯೆ,0,0,1,1
42349,പുറകേ,0,0,1,1
50810,तरीकों,0,0,1,1
42347,leaving,0,0,1,1
42346,shellincluding,0,0,1,1
42345,estranhos,0,0,1,1
42344,honestly,0,0,1,1
42343,classifications,0,0,1,1
50811,conocía,0,0,1,1
42341,ನೋಡುವುದಿಲ್ಲ.,0,0,1,1
42340,oferecer.,0,0,1,1
42339,succession,0,0,1,1
42338,महिलाओं,0,0,1,1
42336,relationerna,0,0,1,1
42471,theories.,0,0,1,1
42474,ನೋಡಬೇಡಿ,0,0,1,1
42665,reproduction,0,0,1,1
42597,clique,0,0,1,1
42592,استراتيجية,0,0,1,1
42593,besetzt,0,0,1,1
42594,ender,0,0,1,1
42595,andmost,0,0,1,1
42596,mp,0,0,1,1
50771,necessário,0,0,1,1
42598,الفترة,0,0,1,1
42589,самый,0,0,1,1
42599,وابنتها.,0,0,1,1
42600,düşürürseniz,0,0,1,1
42601,dresses,0,0,1,1
42606,ಸಿಕ್ಕಿದ್ದು,0,0,1,1
42611,allgemeine,0,0,1,1
42615,swarm,0,0,1,1
42591,editem,0,0,1,1
42588,gene,0,0,1,1
42559,ബന്ധവും,0,0,1,1
42571,greed,0,0,1,1
42562,وجهي,0,0,1,1
50774,dessein,0,0,1,1
50773,προσπαθείτε,0,0,1,1
42566,соль,0,0,1,1
42568,blikken,0,0,1,1
42570,स्मृति,0,0,1,1
42572,السلام,0,0,1,1
42587,ತಿಳುವಳಿಕೆಯಿದ್ದರೆ,0,0,1,1
42574,chargée,0,0,1,1
42578,താമസിച്ചിരുന്നു.,0,0,1,1
42580,ρωτήσω,0,0,1,1
42581,brillants.,0,0,1,1
42582,dicen.,0,0,1,1
42585,baike.com,0,0,1,1
42617,capaz.,0,0,1,1
42618,pc,0,0,1,1
42619,والمحطة,0,0,1,1
42654,m'a,0,0,1,1
42647,soudainement,0,0,1,1
42648,написания,0,0,1,1
42649,αποδείξετε,0,0,1,1
42652,ಮುಳುಗುತ್ತಿದ್ದೇನೆ.,0,0,1,1
50765,breve,0,0,1,1
42653,wikikoden,0,0,1,1
42655,الالتقاط,0,0,1,1
42620,mutuas,0,0,1,1
42656,سروري,0,0,1,1
42659,brain.,0,0,1,1
42660,ನನಸಾದರೆ,0,0,1,1
42662,licentie.,0,0,1,1
42663,l'élaboration,0,0,1,1
42664,لاتينية,0,0,1,1
42646,ಮಾಡುವಂತೆ,0,0,1,1
42645,telaffuzumu,0,0,1,1
42644,abril-junio,0,0,1,1
42643,ஒலி.,0,0,1,1
50767,dn,0,0,1,1
42641,टी,0,0,1,1
42640,petição,0,0,1,1
50768,பதிலளிக்குமுகமாக,0,0,1,1
42634,ámsterdam.,0,0,1,1
42633,statistiek,0,0,1,1
42632,മൂന്നുപേരും,0,0,1,1
42631,continues,0,0,1,1
42630,سأحضر,0,0,1,1
42629,basması,0,0,1,1
42628,informeel,0,0,1,1
42626,frit,0,0,1,1
42625,jamás,0,0,1,1
42560,जानता,0,0,1,1
42558,உதவுங்கள்,0,0,1,1
42476,phrasen,0,0,1,1
42502,விரும்புகிறீர்கள்.,0,0,1,1
42496,விளையாட்டை,0,0,1,1
42497,religión.,0,0,1,1
42498,δουλέψτε,0,0,1,1
42499,ರವಾನಿಸಬಹುದೇ,0,0,1,1
42500,человеческой,0,0,1,1
42501,ಒಮ್ಮೆ,0,0,1,1
42503,modèle.,0,0,1,1
42494,llevadas,0,0,1,1
42504,enojado.,0,0,1,1
42505,блестящие,0,0,1,1
50788,मिस्सा,0,0,1,1
42508,polaires,0,0,1,1
50787,habitual,0,0,1,1
42509,colocan,0,0,1,1
42495,mythologies.,0,0,1,1
42492,uitkomt,0,0,1,1
42557,raconte,0,0,1,1
50790,ഭൂമിക്ക്,0,0,1,1
42477,ഉള്ളവരായിരിക്കും,0,0,1,1
42478,மொழிப்பதிப்புகளில்,0,0,1,1
42479,praising,0,0,1,1
42480,форме,0,0,1,1
42482,ваша,0,0,1,1
42483,прослеживает,0,0,1,1
42484,ചർച്ചകളും,0,0,1,1
42491,galen,0,0,1,1
42485,corée,0,0,1,1
42486, millions de fichiers.,0,0,1,1
42487,búsquedas,0,0,1,1
42488,français.,0,0,1,1
42489,bile.,0,0,1,1
42490,incorporava,0,0,1,1
42510,τρεις,0,0,1,1
42511,применена,0,0,1,1
42512,transition,0,0,1,1
42541,reaching,0,0,1,1
42534,क्रोकर,0,0,1,1
42535,estricto,0,0,1,1
42537,dinin,0,0,1,1
42538,يجادل,0,0,1,1
42539,centrados,0,0,1,1
42540,ಕುಳಿತಿದ್ದಾರೆ.,0,0,1,1
42542,செய்வதன்,0,0,1,1
42513,marco,0,0,1,1
42543,uppgift,0,0,1,1
42544,apport,0,0,1,1
42550,फ़िक्स,0,0,1,1
50775,καλύτερος,0,0,1,1
42554,planetary,0,0,1,1
42556,طبيعية.,0,0,1,1
42533,أَنَّ,0,0,1,1
42532,snow,0,0,1,1
42530,seviyede,0,0,1,1
50778,tracts,0,0,1,1
42529,åldersgruppen,0,0,1,1
42527,ongelukkig,0,0,1,1
42526,வலை,0,0,1,1
50779,заранее.,0,0,1,1
50780,يدين,0,0,1,1
42524,distinctif,0,0,1,1
50782,asociación,0,0,1,1
42521,classes,0,0,1,1
50783,моим,0,0,1,1
42518,مقالاته,0,0,1,1
42517,.°w﻿,0,0,1,1
42515,मंत्री,0,0,1,1
50786,ijsje,0,0,1,1
43036,مقدما.,0,0,1,1
43038,naturalité,0,0,1,1
40785,creëren,0,0,1,1
43548,والعالم،,0,0,1,1
43539,elastic,0,0,1,1
43541,மூளையைச்,0,0,1,1
43542,эмбрионально-подобное,0,0,1,1
43543,ಎಂಬುದನ್ನು,0,0,1,1
43546,rad,0,0,1,1
43547,ಅಲಂಕಾರಿಕ,0,0,1,1
43549,tropas,0,0,1,1
43535,age.,0,0,1,1
43550,visera,0,0,1,1
43551,मुख्यालय,0,0,1,1
43552,harassment.,0,0,1,1
43553,prachtig,0,0,1,1
43554,tænk,0,0,1,1
43556,preconceitos,0,0,1,1
43536,hagas.,0,0,1,1
43528,kramme,0,0,1,1
43507,artigt.,0,0,1,1
43518,drukne,0,0,1,1
50648,تكاليف,0,0,1,1
43512,लुम्बार्ट,0,0,1,1
43514,bero,0,0,1,1
43516,n’était,0,0,1,1
50647,நினைக்கிறாய்,0,0,1,1
43517,hund,0,0,1,1
43519,ومشاريع,0,0,1,1
43527,permitida.,0,0,1,1
43520,தொடரச்,0,0,1,1
43521,награждения,0,0,1,1
43522,άκουσε,0,0,1,1
43523,الزيارات,0,0,1,1
43524,δείπνο,0,0,1,1
43525,évaluations,0,0,1,1
43557,രഹസ്യവുമായ,0,0,1,1
43558,spectroscopy,0,0,1,1
43559,ഉത്ഭവം,0,0,1,1
43597,protista.,0,0,1,1
43587,ഓർമ്മിക്കുകയും,0,0,1,1
43589,connu.,0,0,1,1
43591,reprints,0,0,1,1
43592,पांचवीं,0,0,1,1
43593,verreweg,0,0,1,1
43596,تجمع,0,0,1,1
43598,verbluft,0,0,1,1
50644,கொடூரமானது.,0,0,1,1
43599,stuur,0,0,1,1
50639,verte.,0,0,1,1
43602,spins,0,0,1,1
43603,edit-a-thons,0,0,1,1
43605,ulykkelig.,0,0,1,1
50638,ಟಿ,0,0,1,1
43586,ആസ്വദിക്കും.,0,0,1,1
43584,المتحدة،,0,0,1,1
43583,historiquement,0,0,1,1
43582,alimentado,0,0,1,1
43579,बिस्तर,0,0,1,1
43578,വിളിക്കാം,0,0,1,1
43576,tailandês,0,0,1,1
43575,αίσθηση,0,0,1,1
43572,skipped,0,0,1,1
43568,olmasıdır.,0,0,1,1
43567,maids,0,0,1,1
43566,ർജ്ജ,0,0,1,1
50643,πήγε,0,0,1,1
43564,başlayalım.,0,0,1,1
43562,запутал,0,0,1,1
43561,എന്തിന്,0,0,1,1
43560,samarbetsprojekt,0,0,1,1
43508,répète,0,0,1,1
43506,அர்த்தங்கள்,0,0,1,1
43608,møder,0,0,1,1
43454,pornographic.,0,0,1,1
43448,سلبي,0,0,1,1
43449,fréquentes[ac].,0,0,1,1
43450,s'éclairer,0,0,1,1
43451,passe-t-il,0,0,1,1
43452,يفعله,0,0,1,1
43453,communauté ».,0,0,1,1
43455,validity,0,0,1,1
43445,borrar,0,0,1,1
43456,olgudur,0,0,1,1
43457,அழகைத்,0,0,1,1
43458,ആർക്കെങ്കിലും,0,0,1,1
43459,ξαφνιασμένος,0,0,1,1
43461,kennen,0,0,1,1
43463,പറയുന്നതും.,0,0,1,1
43447,اللحم,0,0,1,1
43443, مليار,0,0,1,1
43505,എന്നിലുടനീളം,0,0,1,1
43432,d'artifice,0,0,1,1
43423,طفيف،,0,0,1,1
43424,disregard,0,0,1,1
43428,else,0,0,1,1
43429,حيوان,0,0,1,1
43430,ರತ್ನಗಳು,0,0,1,1
43431,représenter,0,0,1,1
43433,localized,0,0,1,1
43442,ತಂಪಾಗಿರಲು,0,0,1,1
43435,உருவாக்கியுள்ளது.,0,0,1,1
43436,garten,0,0,1,1
43438,μέρους,0,0,1,1
43439,encoded,0,0,1,1
43440,होगी,0,0,1,1
43441,दूसरों,0,0,1,1
43464,மீக்கா,0,0,1,1
43465,ومفتقدًا.,0,0,1,1
50654,træder,0,0,1,1
43495,ശ്രമിക്കുന്നു.,0,0,1,1
43490,femme ,0,0,1,1
43491,ഉണ്ടായിരുന്നെങ്കിൽ,0,0,1,1
43492,vas,0,0,1,1
50649,अस्तूरियाई,0,0,1,1
43493,webos,0,0,1,1
43494,والبرتغالية,0,0,1,1
43496,आइसलैण्डी,0,0,1,1
43466,haut-parleur,0,0,1,1
43497,dirt,0,0,1,1
43499,australia.,0,0,1,1
43500,değiştirebilir,0,0,1,1
43501,தமது,0,0,1,1
43503,वेबसाइट्स,0,0,1,1
43504,mythologiques.,0,0,1,1
50650,حاد,0,0,1,1
43487,വിവാഹ,0,0,1,1
43484,indecent,0,0,1,1
43483,σκύλος,0,0,1,1
50651,chics,0,0,1,1
43482,histórico,0,0,1,1
43481,evlendikten,0,0,1,1
43479,ಅದ್ಭುತವಾಗಿ,0,0,1,1
43478,طويلة,0,0,1,1
43477,കടിയെടുത്തു,0,0,1,1
50652,ತಲುಪಿತು.,0,0,1,1
43472,possível.,0,0,1,1
43471,مسؤولة.,0,0,1,1
43470,alemães,0,0,1,1
43469,economische,0,0,1,1
43468,കോട്ട,0,0,1,1
43467,مهذبًا,0,0,1,1
43607,dilinde,0,0,1,1
43609,ειδήσεων,0,0,1,1
43421,έκπληκτος,0,0,1,1
43740,revisar,0,0,1,1
43732,établissements,0,0,1,1
43733,roter,0,0,1,1
50621,framgår,0,0,1,1
43736,ρωτήσεις.,0,0,1,1
43737,webbrowsere,0,0,1,1
43738,βοηθήσω,0,0,1,1
50618,നൈറ്റിനെയോ,0,0,1,1
43730,ಪುಸ್ತಕದಲ್ಲಿ,0,0,1,1
43742,collision.,0,0,1,1
43743,മാനദണ്ഡങ്ങൾ,0,0,1,1
43745,ഡിഗ്രിവിദ്യാർത്ഥി,0,0,1,1
43746,നിർത്തിയെന്നത്,0,0,1,1
50617,testar,0,0,1,1
43749,modtog,0,0,1,1
43731,സ്പാനിഷ്,0,0,1,1
43729,αφήσει,0,0,1,1
43710,phases.,0,0,1,1
43719,أخفقت,0,0,1,1
43713,matéria,0,0,1,1
50622,consegue,0,0,1,1
43715,«сообщество…,0,0,1,1
43716,അസ്വസ്ഥനാകുന്നത്,0,0,1,1
43717,sangue,0,0,1,1
43718,kunniga,0,0,1,1
43720,aspekter,0,0,1,1
43728,ausgefallene,0,0,1,1
43721,παιδί,0,0,1,1
43722,പുതിയതായി,0,0,1,1
43723,meegebracht,0,0,1,1
43724,रणनीति,0,0,1,1
43725,dialectique ,0,0,1,1
43727,பிடிக்க,0,0,1,1
50616,charles,0,0,1,1
43750,استفهام.,0,0,1,1
43751,nationell,0,0,1,1
43780,sampling,0,0,1,1
43775,d’évaluation,0,0,1,1
50612,syllabi,0,0,1,1
43776,αλλάξουν,0,0,1,1
43777,भूलें,0,0,1,1
43778,grants,0,0,1,1
43779,канады,0,0,1,1
43784,berufserfahrung,0,0,1,1
50615,وswedish،,0,0,1,1
43785,paralelo»,0,0,1,1
43786,يشغل,0,0,1,1
43787,contemplados,0,0,1,1
43790,കത്തിക്കുന്നു,0,0,1,1
50611,salladın,0,0,1,1
50610,presencia,0,0,1,1
43774,കീഴ്‌വഴക്കവും.,0,0,1,1
43773,nickel,0,0,1,1
43772,മലയാളികളാണ്,0,0,1,1
43770,مزحة,0,0,1,1
50613,الالتزام,0,0,1,1
43769,அதிநவீன.,0,0,1,1
43768,произведён,0,0,1,1
43766,فأنت.,0,0,1,1
43765,விலங்கு.,0,0,1,1
43763,إلا,0,0,1,1
50614,essenciais.,0,0,1,1
43760,yapılması,0,0,1,1
43759,библиотека,0,0,1,1
43758,aprecio,0,0,1,1
43757,faites.,0,0,1,1
43756,consola,0,0,1,1
43754,middel,0,0,1,1
43712,وريجل,0,0,1,1
43709,الأكاديمية,0,0,1,1
43611,queries,0,0,1,1
43646,поговорим,0,0,1,1
43635,لقاء,0,0,1,1
43637,विकिपीडिया.,0,0,1,1
43639,சிந்திக்க,0,0,1,1
43641,inget.,0,0,1,1
43643,sayısı,0,0,1,1
43644,बहुस्तरीय,0,0,1,1
50632,pedagogiskt,0,0,1,1
43632,kalitesi,0,0,1,1
43648,institutions,0,0,1,1
50631,volumétrie.,0,0,1,1
43651,ഭക്ഷണമായിരുന്നു,0,0,1,1
43652,mirent,0,0,1,1
43653,ругательства,0,0,1,1
43657,அதற்குப்,0,0,1,1
43634,anförts,0,0,1,1
50633,ಬೆರಗುಗೊಳಿಸುತ್ತದೆ.,0,0,1,1
43708,கலந்துரையாடல்களுக்குப்,0,0,1,1
43623,этим.,0,0,1,1
43612,εμφανίσεις,0,0,1,1
43615,biografen,0,0,1,1
43616,التحيز,0,0,1,1
43617,നടത്തിയ,0,0,1,1
43619,croatia,0,0,1,1
43621,registrado,0,0,1,1
50636,n'obtiendrez,0,0,1,1
43631,നോക്കിയ,0,0,1,1
50634,regularities,0,0,1,1
43625,meşguldün.,0,0,1,1
43626,شديدة,0,0,1,1
43627,ವಿಷಯವಲ್ಲ.,0,0,1,1
43629,запрещено,0,0,1,1
43630,favoring,0,0,1,1
43659,wollte,0,0,1,1
43660,различному,0,0,1,1
43661,физико-химических,0,0,1,1
43696,озаглавленный,0,0,1,1
43690,അർ‌ത്ഥമാക്കുന്നു,0,0,1,1
43691,atomic,0,0,1,1
43692,typologie,0,0,1,1
43693,الإبداعي.,0,0,1,1
50626,موثوقة,0,0,1,1
50625,felicitaties,0,0,1,1
43697,सके......,0,0,1,1
43662,प्रतिदिन,0,0,1,1
43698,studded,0,0,1,1
43701,τέλειο,0,0,1,1
43702,uppfattar,0,0,1,1
43704,பெட்டியில்,0,0,1,1
43705,servicio,0,0,1,1
50624,jams,0,0,1,1
43688,drukner,0,0,1,1
43687,doğrudan,0,0,1,1
43686,driver,0,0,1,1
43684,mængde,0,0,1,1
43683,أتلانتيك,0,0,1,1
43682,остановилась,0,0,1,1
43680,excluí-las,0,0,1,1
50628,വെയർ,0,0,1,1
43679,fazem,0,0,1,1
43678,appearances,0,0,1,1
43677,​​med,0,0,1,1
43676,circuler,0,0,1,1
43673,വർദ്ധച്ചുകൊണ്ടിരിക്കുന്ന,0,0,1,1
50629,मांसके,0,0,1,1
43665,groei.,0,0,1,1
43664,cuantas,0,0,1,1
43663,publicitaires,0,0,1,1
50660,administrateurs,0,0,1,1
43419,indicarles,0,0,1,1
43039,مذهولًا,0,0,1,1
43185,vicinity,0,0,1,1
43178,verbum,0,0,1,1
43179,методами.,0,0,1,1
43180,títeres,0,0,1,1
43181,खरीदूंगा,0,0,1,1
43182,vidéos etc.,0,0,1,1
50701,-birçok,0,0,1,1
43186,مشيرة,0,0,1,1
50702,الرهيب,0,0,1,1
43187,റെസ്റ്റോറന്റാണിത്.,0,0,1,1
43188,дисков,0,0,1,1
43189,обществом,0,0,1,1
43190,ಮುಂದುವರೆಸು.,0,0,1,1
43191,severos,0,0,1,1
43192,mijlpaal,0,0,1,1
43177,norteamericano,0,0,1,1
43172,മകളായ,0,0,1,1
43147,टेम्पलेट्स,0,0,1,1
43159,cognitive,0,0,1,1
43149,klingon.,0,0,1,1
43150,d'incohérences,0,0,1,1
43151,glückwünsche,0,0,1,1
43152,underbar,0,0,1,1
43153,prouviez,0,0,1,1
43157,счастлив,0,0,1,1
43160,പെരുമാറിയത്,0,0,1,1
43171,asemejen,0,0,1,1
43161,видите.,0,0,1,1
43162,ಹೋದರು,0,0,1,1
43163,rêve.,0,0,1,1
43164,перевод,0,0,1,1
50703,പ്രവൃത്തിയെക്കുറിച്ച്,0,0,1,1
43170,modernos,0,0,1,1
43194,ലഭ്യമല്ലെങ്കിൽ,0,0,1,1
43195,ilgilenmiyorum.,0,0,1,1
43196,സമൂഹത്തിൽ,0,0,1,1
50692,gesehen.,0,0,1,1
43216,τραπεζαρία,0,0,1,1
50693,فرد,0,0,1,1
43217,d'importance.,0,0,1,1
43218,« vous »,0,0,1,1
43220,glockensymbol,0,0,1,1
43221,pior,0,0,1,1
43222,kaldırılmasının,0,0,1,1
50699,तरह',0,0,1,1
43223,experto.,0,0,1,1
43224,«творческого,0,0,1,1
43225,intitulada,0,0,1,1
43226,δευτερόλεπτο.,0,0,1,1
43227,unsupervised.,0,0,1,1
43228,கருத்தொருமிப்பின்,0,0,1,1
50694,tillit,0,0,1,1
43215,protège,0,0,1,1
43213,العناء,0,0,1,1
43212,pensamentos,0,0,1,1
43211,ನೆಚ್ಚಿನದು,0,0,1,1
43210,ertoe,0,0,1,1
43209,சாதனையாக,0,0,1,1
43208,возьму,0,0,1,1
43206,ρίτσαρντ,0,0,1,1
43204,« rapide »,0,0,1,1
43203,partagée,0,0,1,1
50697,construit,0,0,1,1
43202,sérvio,0,0,1,1
43201,auf.,0,0,1,1
43200,ليه،,0,0,1,1
43199,تقريبًا،,0,0,1,1
43198,bulunma.,0,0,1,1
50704,sensiz,0,0,1,1
43146,الظهيرة,0,0,1,1
43231,карьеры,0,0,1,1
43077,ಬಯಸುವುದಿಲ್ಲ.,0,0,1,1
43069,καλιφόρνια.,0,0,1,1
43071,ചതുപ്പുനിലത്ത്,0,0,1,1
50714,عظيم,0,0,1,1
43073,магнусом,0,0,1,1
43075,freshwater,0,0,1,1
43076,yayımlanan,0,0,1,1
43080,rattraper,0,0,1,1
43067,blockerar,0,0,1,1
43081,ideell,0,0,1,1
50712,പാർട്ടികളെക്കുറിച്ചുള്ള,0,0,1,1
43084,வியக்க,0,0,1,1
43085,പരിഹാരത്തിലാണെന്ന്,0,0,1,1
43087,ஒன்றும்,0,0,1,1
43089,satan,0,0,1,1
43068,നിർവചിക്കണം.,0,0,1,1
43064,katı,0,0,1,1
43145,proporción,0,0,1,1
43050,திடீரென்று,0,0,1,1
43041,öğrenciler,0,0,1,1
43042,nyheter,0,0,1,1
43043,περνούσε,0,0,1,1
43045,البيتزا,0,0,1,1
43047,matière.,0,0,1,1
43048,शहर,0,0,1,1
43051,अपेक्षाकृत,0,0,1,1
43063,αγαπούσε,0,0,1,1
43052,принципе,0,0,1,1
43055,public's,0,0,1,1
43056,« durabilité »,0,0,1,1
50716,controverses,0,0,1,1
43060,trader,0,0,1,1
43061,μαρίνα,0,0,1,1
43091,tags,0,0,1,1
43092,kent.,0,0,1,1
43093,περίμενε,0,0,1,1
43132,सपने,0,0,1,1
43125,கருத்துக்கள்,0,0,1,1
43126,лицензирован,0,0,1,1
43127,bewundernden,0,0,1,1
43128,duimen.,0,0,1,1
43129,γιατί.,0,0,1,1
43131,عهد,0,0,1,1
43135,विकिन्यूज,0,0,1,1
43094,важной,0,0,1,1
43136,வைத்திருக்கிறேன்,0,0,1,1
43137,serais,0,0,1,1
50705,regrouper ,0,0,1,1
43142,വിജയിച്ചു,0,0,1,1
43143,l'examen,0,0,1,1
43144,mismo​,0,0,1,1
43123,الفساتين,0,0,1,1
43122,таково,0,0,1,1
43121,വെബ്‌,0,0,1,1
43119,അർഹനാണെന്ന്,0,0,1,1
43117,يصف,0,0,1,1
43116,anonymt.,0,0,1,1
43113,already.,0,0,1,1
43109,rapide,0,0,1,1
43108,ويقوم,0,0,1,1
50709,посещаемость,0,0,1,1
43105,quotidiennes.,0,0,1,1
43103,bumped,0,0,1,1
43102,fineste,0,0,1,1
43100,culto​​​,0,0,1,1
50711,ആശ്ചര്യപ്പെടുത്തുന്നതാണ്.,0,0,1,1
43098,ശ്രദ്ധിക്കാനാകില്ലെന്ന്,0,0,1,1
43095,påverka,0,0,1,1
43229,providers.,0,0,1,1
43232,качества,0,0,1,1
43418,reprises,0,0,1,1
43359,иду,0,0,1,1
43351,anlamadım,0,0,1,1
43353,anna,0,0,1,1
43354,மறுப்புக்களுக்கான,0,0,1,1
43355,ಹಿಡಿಯದಿದ್ದರೆ,0,0,1,1
43356,ಹಾಡುಗಳಲ್ಲಿ,0,0,1,1
43358,seas.,0,0,1,1
43362,tastiest,0,0,1,1
43348,thailand.,0,0,1,1
43363,controversés,0,0,1,1
43364,പൊതുജനങ്ങൾക്കെല്ലാം,0,0,1,1
43366,politiskt,0,0,1,1
43367,yaptım,0,0,1,1
43368,deprived,0,0,1,1
43369,έως,0,0,1,1
50672,കണ്ണുനീരിന്,0,0,1,1
43347,åtanke,0,0,1,1
43325,рассмотрим,0,0,1,1
43333,hävde,0,0,1,1
43327,ignores,0,0,1,1
43328,habitable,0,0,1,1
43329,in-depth,0,0,1,1
50676,kennenzulernen.,0,0,1,1
43331,vayamos,0,0,1,1
43332,veranderd.,0,0,1,1
50675,'featured'.,0,0,1,1
43346,injurieuse,0,0,1,1
43336,öppenheten,0,0,1,1
43337,язык,0,0,1,1
50674,l'assertion,0,0,1,1
50673,காலையில்,0,0,1,1
43342,വിചാരിക്കുന്നത്,0,0,1,1
43343,« alphago »,0,0,1,1
50668,founded.,0,0,1,1
43370,грубо,0,0,1,1
43371,wiki's,0,0,1,1
43407,nivelar,0,0,1,1
43397,പതിവ്.,0,0,1,1
50664,geschäft,0,0,1,1
43401,provoquant,0,0,1,1
43402,spil,0,0,1,1
43404,répréhensibles,0,0,1,1
43406,ആരെയോ,0,0,1,1
43408,maken,0,0,1,1
43372,статистику,0,0,1,1
43409,gönderdin,0,0,1,1
43410,ಚಿಂತೆಯಿಲ್ಲ,0,0,1,1
43412,फ़ारसी,0,0,1,1
43414,массовых,0,0,1,1
50663,αποφεύγοντας,0,0,1,1
50661,tendría,0,0,1,1
43394,மெதுவாகவும்,0,0,1,1
43392,беспокоюсь,0,0,1,1
43391,drastic,0,0,1,1
43390,بالمشاهدة.,0,0,1,1
50667,αξιόπιστης,0,0,1,1
43386,उड़िया,0,0,1,1
43385,återanvändas,0,0,1,1
43384,reader,0,0,1,1
43383,ಧನಾತ್ಮಕ,0,0,1,1
43382,مبكرين,0,0,1,1
43381,görünmek.,0,0,1,1
43380,ആലിംഗനം,0,0,1,1
43379,inhabited,0,0,1,1
43378,tebrikleri,0,0,1,1
43376,sorular,0,0,1,1
43375,النتيجة,0,0,1,1
43374,أنا',0,0,1,1
43326,sonido,0,0,1,1
50677,volumen,0,0,1,1
43233,omfattning,0,0,1,1
50689,d'étapes.,0,0,1,1
43261,التجارية,0,0,1,1
43263,المميزات,0,0,1,1
43264,requisito,0,0,1,1
43266,limitó,0,0,1,1
43267,βιβλία,0,0,1,1
43268,озаглавленное,0,0,1,1
43269,eğilimindedir,0,0,1,1
43259,للسؤال.,0,0,1,1
43271,‘வழங்கி’யில்,0,0,1,1
50688,crop,0,0,1,1
43274,erik,0,0,1,1
43275,incorporación,0,0,1,1
43276,സന്ദേശങ്ങളെ,0,0,1,1
43277,esbozos,0,0,1,1
43260,uppifrån,0,0,1,1
43258,сердцу,0,0,1,1
43323,λέξεων,0,0,1,1
43242,ಜೋಚ್,0,0,1,1
43234,جمالك.,0,0,1,1
43235,impureza,0,0,1,1
43236,lagunas,0,0,1,1
43238,ضمان,0,0,1,1
43239,владеющей,0,0,1,1
43241,handwriting,0,0,1,1
43245,candidate's,0,0,1,1
43257,американский,0,0,1,1
43247,unrecognized,0,0,1,1
43248,விக்கிப்பீடியாவிலிருந்து,0,0,1,1
43249,പ്രവർത്തിക്കണമെന്ന്,0,0,1,1
43250,'αγαπώ,0,0,1,1
43254,ഉള്ളൂവെന്നും,0,0,1,1
43255,wetlands,0,0,1,1
50687,bomis ,0,0,1,1
43279,കഴിക്കുന്നതിനെക്കുറിച്ച്,0,0,1,1
43280,सांस,0,0,1,1
43312,посчитает,0,0,1,1
50682,bio,0,0,1,1
43306,ಧ್ವನಿಯನ್ನು,0,0,1,1
43307,ಇರಲು,0,0,1,1
43308,варенье.,0,0,1,1
43310,klockikonen,0,0,1,1
43311,ದಣಿದ,0,0,1,1
43314,धोने,0,0,1,1
50686,anonimato,0,0,1,1
43315,problème,0,0,1,1
43316,omarbetats,0,0,1,1
43317,μήνες,0,0,1,1
43320,blog,0,0,1,1
43322,ವಿವರಣಾ,0,0,1,1
50680,തെറ്റിദ്ധരിക്കുന്ന,0,0,1,1
50683,зачастую,0,0,1,1
43303,belief,0,0,1,1
43302,وتطوير,0,0,1,1
43301,söylüyorsunuz,0,0,1,1
43300,irc,0,0,1,1
50684,konsensusbeslut.,0,0,1,1
43297,serão,0,0,1,1
43295,amatörer,0,0,1,1
43293,छह,0,0,1,1
43292,revertidos,0,0,1,1
43290,ocorrem,0,0,1,1
43289,étonnant,0,0,1,1
43287,несъедобным,0,0,1,1
43286,являвшаяся,0,0,1,1
43285,begin.,0,0,1,1
43284,preguiçoso,0,0,1,1
43283,നിർവ്വചിക്കുന്നു.,0,0,1,1
42282,logrado,0,0,1,1
42281,जानना,0,0,1,1
50822,grau,0,0,1,1
41294,ويحق,0,0,1,1
41288,началась,0,0,1,1
41289,träume,0,0,1,1
50962,d'univers,0,0,1,1
41290,والصينية,0,0,1,1
41292,illegal.,0,0,1,1
41293,plagiar,0,0,1,1
41295,struggled,0,0,1,1
41284,ಅವಳನ್ನು,0,0,1,1
41298,بحذف,0,0,1,1
41299,siècle,0,0,1,1
41304,türkiye'de,0,0,1,1
41305,മധുരമുള്ള,0,0,1,1
50961,chamador,0,0,1,1
41306,ब्रांडचैनल.कॉम,0,0,1,1
41287,cedido.,0,0,1,1
41283,خطا,0,0,1,1
41259,кассовые,0,0,1,1
41269,αποκτήσετε,0,0,1,1
41261,crean,0,0,1,1
41262,«откатить,0,0,1,1
41263,mödan,0,0,1,1
41264,fournie,0,0,1,1
41265,guidelines.,0,0,1,1
41267,كمشتبه,0,0,1,1
41270,behaves,0,0,1,1
50963,confrontés,0,0,1,1
41271,d'art,0,0,1,1
41274,посвящённые,0,0,1,1
41275,actors,0,0,1,1
41276,பார்த்தார்,0,0,1,1
50965,пользователями.,0,0,1,1
41278,உச்சரிப்பை,0,0,1,1
41307,нарцисой,0,0,1,1
41308,രൂപവും,0,0,1,1
41309,دائم,0,0,1,1
41340,رسول,0,0,1,1
41329,нетрадиционной,0,0,1,1
41330,داعى,0,0,1,1
41332,facultades,0,0,1,1
41336,certainty.,0,0,1,1
41337,ασημί,0,0,1,1
41338,достоверной,0,0,1,1
41341,keyfi,0,0,1,1
41311,engelsktalande,0,0,1,1
50954,sizden.,0,0,1,1
50953,மூன்றாம்,0,0,1,1
41345,لكلمتين,0,0,1,1
41346,kurohin,0,0,1,1
41348,quarter,0,0,1,1
41349,publier,0,0,1,1
41328,mathematics.,0,0,1,1
41327,polite,0,0,1,1
41326,llore,0,0,1,1
50955,içerik,0,0,1,1
41322,edersiniz,0,0,1,1
41321,அதேபோல்,0,0,1,1
41320,algorithm's,0,0,1,1
41319,нах.,0,0,1,1
41318,اتصالاً,0,0,1,1
50956,проходит,0,0,1,1
50957,गईं।,0,0,1,1
41316,dépassant,0,0,1,1
41315,lades,0,0,1,1
41314,adeus.,0,0,1,1
50959,இதையெல்லாம்,0,0,1,1
50960,പൂർവ്വസ്ഥിതിയിലെത്തുവാൻ,0,0,1,1
41312,l'avez.,0,0,1,1
41260,verdú,0,0,1,1
41258,مختلفين,0,0,1,1
41351,geliyordu,0,0,1,1
41198,impressionante.,0,0,1,1
50981,tischmanieren,0,0,1,1
41191,например.,0,0,1,1
41194,ऑस्ट्रिया,0,0,1,1
41195,ecml,0,0,1,1
41196,yemeğinde,0,0,1,1
41197,நிறுவனத்தின்,0,0,1,1
41200,φράσεων,0,0,1,1
41185,вмешивается.,0,0,1,1
41201,இருந்ததைப்,0,0,1,1
41202,zeldzaamheid,0,0,1,1
41204,p. -,0,0,1,1
41206,പ്രശ്നമല്ലെന്ന്,0,0,1,1
41207,açıkla,0,0,1,1
50979,outputs.,0,0,1,1
50982,नोल,0,0,1,1
41184,வேகத்தில்,0,0,1,1
41257,அடைந்தது.,0,0,1,1
41169,хихикала,0,0,1,1
41161,ಎಸ್‌ಎಂಎಸ್,0,0,1,1
50985,edición.,0,0,1,1
41162,poderosa,0,0,1,1
41164,quantify,0,0,1,1
41167,colectivamente,0,0,1,1
41168,gems,0,0,1,1
41170,reinventions,0,0,1,1
41183,decentralized,0,0,1,1
41172,போன்றவர்,0,0,1,1
41174,« naître »,0,0,1,1
41175,turc,0,0,1,1
41176,നിലനിൽക്കുന്നത്.,0,0,1,1
41178,översättning,0,0,1,1
41182,желаем,0,0,1,1
41211,مسح,0,0,1,1
41212,പതിച്ചിരുന്നു.,0,0,1,1
41213,εβδομάδα,0,0,1,1
41244,yakut,0,0,1,1
41236,haciendo.,0,0,1,1
41237,fågel,0,0,1,1
41239,redigeringssammanfattningar,0,0,1,1
41241,corresponding,0,0,1,1
50972,plos,0,0,1,1
41243,burn,0,0,1,1
41245,recht.,0,0,1,1
41214,நிலமாகக்,0,0,1,1
41247,introduit,0,0,1,1
50969,தாழ்மையானவர்,0,0,1,1
41252,सेलेब्रेट्स,0,0,1,1
41253,பெறுவேன்,0,0,1,1
50967,इतिहासकार,0,0,1,1
41255,costolo,0,0,1,1
41235,جلست,0,0,1,1
41234,доступных,0,0,1,1
50974,ഇന്ന്‌,0,0,1,1
41233,katılıyorum,0,0,1,1
41232,توش.،,0,0,1,1
41231,winked,0,0,1,1
41230,pregunto,0,0,1,1
41229,superior.,0,0,1,1
41228,प्रेमी,0,0,1,1
50975,filtre,0,0,1,1
50976,froid,0,0,1,1
50977,iniciado,0,0,1,1
41224,españa,0,0,1,1
41223,மேலிருந்து,0,0,1,1
41221,antingen,0,0,1,1
41218,«η,0,0,1,1
41216,തന്നെയാണ്,0,0,1,1
41350,wikislavia.,0,0,1,1
41352,speglade,0,0,1,1
41157,बोट्स,0,0,1,1
41489,வழக்கப்படியான,0,0,1,1
41479,abrió,0,0,1,1
41480,போவதே,0,0,1,1
41481,intentionally,0,0,1,1
41482,pacific,0,0,1,1
50936,l'actualisation,0,0,1,1
41484,evolutionary,0,0,1,1
41490,ಸೂಚಿಸುತ್ತದೆ,0,0,1,1
41478,modificando,0,0,1,1
41491,أخافت,0,0,1,1
50934,критиков,0,0,1,1
41495,fluvial,0,0,1,1
41497,begreep,0,0,1,1
41503,உணவிற்கு,0,0,1,1
41506,policy.,0,0,1,1
50937,قادرا.,0,0,1,1
41476,γλύφους,0,0,1,1
41454,rebuttal,0,0,1,1
41463,lit.,0,0,1,1
41456,biz',0,0,1,1
41457,تفكير,0,0,1,1
41458,പരീക്ഷിച്ചുനോക്കാൻ,0,0,1,1
41459,semaines,0,0,1,1
41461,ботами,0,0,1,1
41462,sofistikeret,0,0,1,1
41464,lente,0,0,1,1
41475,carolina,0,0,1,1
41468,gerçekleşmez,0,0,1,1
41469,ಆವರಿಸಿಕೊಳ್ಳಬಹುದೇ,0,0,1,1
41471,запутаетесь,0,0,1,1
41472,prestigio.,0,0,1,1
41473,информатизация,0,0,1,1
41474,zamandı,0,0,1,1
50932,pourvus,0,0,1,1
41510,qu'avec,0,0,1,1
41511,sobrenome,0,0,1,1
41539,kafanız,0,0,1,1
50930,pedophilia,0,0,1,1
41534,inmensa,0,0,1,1
41535,öneriler.,0,0,1,1
41536,kaçınmak.,0,0,1,1
41537,पुस्क्तकों,0,0,1,1
41538,d'anti-élitisme,0,0,1,1
41540,hazards.,0,0,1,1
41512,l'avant.,0,0,1,1
41541,حسنا,0,0,1,1
41542,annars.,0,0,1,1
41543,maneiras,0,0,1,1
41545,consacré,0,0,1,1
41546,comprobado,0,0,1,1
41547,manières.,0,0,1,1
41533,grymt.,0,0,1,1
50931,smage,0,0,1,1
41532,ಮಾರಿದ್ದೀರಿ.,0,0,1,1
41531,bandeaux,0,0,1,1
41530,exemplo.,0,0,1,1
41529,பங்களிப்பையும்,0,0,1,1
41527,vraagteken.,0,0,1,1
41526,champion,0,0,1,1
41525,l'artiste,0,0,1,1
41522,çocuk,0,0,1,1
41521,« neutralité,0,0,1,1
41520,physicists.,0,0,1,1
41519,also.,0,0,1,1
41518,categorization,0,0,1,1
41517,χρήσιμες,0,0,1,1
41515,kæmpede,0,0,1,1
41514,يحتاج,0,0,1,1
41455,sms'en,0,0,1,1
50940,comptant,0,0,1,1
50952,சிலவேளைகளில்,0,0,1,1
41388,vermasselt.,0,0,1,1
41378,عاديًا,0,0,1,1
41379,تمكنهم,0,0,1,1
41382,норманом,0,0,1,1
41384,sumarse,0,0,1,1
41385,بالمحادثة.,0,0,1,1
41387,multilíngue,0,0,1,1
50946,ജ്ഞാനമല്ല,0,0,1,1
41374,λυπημένη,0,0,1,1
41390,fond,0,0,1,1
41391,buluşmayı,0,0,1,1
41394,walter,0,0,1,1
41398,creaciones,0,0,1,1
41399,bardakçı’nın,0,0,1,1
41400,வெளியே,0,0,1,1
41376,எங்கே,0,0,1,1
41373,wikipediaartikels,0,0,1,1
41447,platonicien,0,0,1,1
41362,करेगी।,0,0,1,1
41354,cálmate,0,0,1,1
41355,opère,0,0,1,1
41356,alınmaz,0,0,1,1
41358,physis,0,0,1,1
41359,المصدر,0,0,1,1
41361,noticeable,0,0,1,1
41364,പൂർണ്ണമായ,0,0,1,1
41372,canınızı,0,0,1,1
41365,demokratiske,0,0,1,1
50949,mission.,0,0,1,1
41368,பிப்ரவரியில்,0,0,1,1
41369,bevatten,0,0,1,1
41370,ग्रिल्लिनी,0,0,1,1
41371,curve,0,0,1,1
41401,உனக்கு,0,0,1,1
41402,contrastando,0,0,1,1
41403,qu'environ,0,0,1,1
41437,upphovsrättsdirektivet.,0,0,1,1
41430,காலை,0,0,1,1
41432,klassische,0,0,1,1
41433,βρωμιά,0,0,1,1
41434,diagnostics,0,0,1,1
41435,الفشل,0,0,1,1
41436,dagligdags,0,0,1,1
41438,bouchée,0,0,1,1
41405,listelerine,0,0,1,1
41439,القراء،,0,0,1,1
50944,अगला,0,0,1,1
50943,rock.,0,0,1,1
41443,iguales,0,0,1,1
41444,ಸಾರ್ವಕಾಲಿಕ,0,0,1,1
50941,पी,0,0,1,1
41429,خبراء.,0,0,1,1
41426,уехала,0,0,1,1
41425,tamir,0,0,1,1
41424,knappen,0,0,1,1
41422,πανηγυρίζεις.,0,0,1,1
41421,raciales,0,0,1,1
41420,والغالبية,0,0,1,1
41419,وولاية,0,0,1,1
41417,idées,0,0,1,1
41416,निरन्तर,0,0,1,1
50945,सामना,0,0,1,1
41413,οτιδήποτε,0,0,1,1
41412,früher.,0,0,1,1
41411,turing.,0,0,1,1
41409,مرجعية.,0,0,1,1
41407,kontinuerligt,0,0,1,1
41406,சரிசெய்தல்.,0,0,1,1
41158,afundar,0,0,1,1
50986,விளைவிக்கக்கூடிய,0,0,1,1
42279,qu’elle,0,0,1,1
40920,ಪಡೆಯುತ್ತೀರಿ,0,0,1,1
40912,aktualitet,0,0,1,1
40914,bird's,0,0,1,1
40915,विरोधाभासी,0,0,1,1
40916,kritische,0,0,1,1
40917,entendo,0,0,1,1
40918,sûre,0,0,1,1
51021,സ്വതന്ത്രനാണോ,0,0,1,1
40910,μάθω,0,0,1,1
40922,personligen,0,0,1,1
40926,मेक्रो,0,0,1,1
40927,récapitulant,0,0,1,1
40928,recebido,0,0,1,1
40929,ಗೊಂದಲಗೊಳಿಸುವುದು.,0,0,1,1
40930,ಕಿರುನಗೆ,0,0,1,1
40911,откликов,0,0,1,1
40907,الجميلة,0,0,1,1
51026,ситуации,0,0,1,1
40894,உணவகம்.,0,0,1,1
40888,इनका,0,0,1,1
40889,wikimedia…,0,0,1,1
40890,ağlamaya,0,0,1,1
40891,hushålls,0,0,1,1
40892,കാലുകൾ,0,0,1,1
40893,മുന്നോട്ടു,0,0,1,1
40895,anlatıyorlar,0,0,1,1
40904,tercer,0,0,1,1
40897,complémentaires,0,0,1,1
40898,выпуска,0,0,1,1
51025,coexistir,0,0,1,1
40900,coordonner,0,0,1,1
40903,støttes,0,0,1,1
51024,constitutionnels,0,0,1,1
40931,deixe,0,0,1,1
40932,arrêtés,0,0,1,1
40933,interact,0,0,1,1
40965,എങ്ങനെയിരിക്കും,0,0,1,1
40959,'separate',0,0,1,1
40960,gesagt.,0,0,1,1
40961,harvardsystemet,0,0,1,1
51019,parliez,0,0,1,1
40963,changeux.,0,0,1,1
40964,fueran,0,0,1,1
40966,naturalisme.,0,0,1,1
40934,prendre.,0,0,1,1
40967,deformation,0,0,1,1
51017,தயாரிக்கப்படுகின்றன.,0,0,1,1
40970,वेंडरबिल्ट,0,0,1,1
51016,അറിയപ്പെട്ടിരുന്നെങ്കിലും,0,0,1,1
40971,நீங்களே,0,0,1,1
51015,يقال,0,0,1,1
40958,tvivel,0,0,1,1
40957,эффективным,0,0,1,1
40956,франко,0,0,1,1
40954,मैच,0,0,1,1
40953,அடிப்படையில்,0,0,1,1
40952,داعي,0,0,1,1
40951,പരാമർശിക്കരുത്.,0,0,1,1
40948,s'aimait,0,0,1,1
40946,இருவர்,0,0,1,1
40945,президентские,0,0,1,1
40944,تحته,0,0,1,1
40943,بوميس،,0,0,1,1
40942,produtivos,0,0,1,1
40939,ಪದವೆಂದರೆ,0,0,1,1
40938,gruppe,0,0,1,1
40936,insiders.,0,0,1,1
40935,permiten,0,0,1,1
40887,tragt,0,0,1,1
40885,miraban,0,0,1,1
40975,കാണാത്ത,0,0,1,1
40818,çuvalladım,0,0,1,1
40809,afogar,0,0,1,1
40812,destruction.,0,0,1,1
40814,fotográfica,0,0,1,1
40815,ஆதாயம்,0,0,1,1
40816,duur,0,0,1,1
40817,حزينة,0,0,1,1
40819,prächtigen,0,0,1,1
40807,ഭൗതികപ്രതിഭാസങ്ങളും,0,0,1,1
40821,auktoritet.,0,0,1,1
40822,κάποιες,0,0,1,1
40823,ستصل,0,0,1,1
40824,guldguldbröd,0,0,1,1
40825,منطقي.,0,0,1,1
40829,eigenaar,0,0,1,1
40808,felsefe,0,0,1,1
40806,c’est,0,0,1,1
40882,ಮೈಲಿ,0,0,1,1
40794,platenhoes,0,0,1,1
40786,freuen.,0,0,1,1
40787,отдельный,0,0,1,1
40788,« naissance ».,0,0,1,1
40789,தன்மையாலும்,0,0,1,1
40790,beschrijvingsvak,0,0,1,1
40791,troupes.,0,0,1,1
40795,والتعليق,0,0,1,1
40804,giggles,0,0,1,1
40798,gjort.,0,0,1,1
40799,freut,0,0,1,1
40800,повсюду,0,0,1,1
51036,cruzas,0,0,1,1
40802,التعليق.,0,0,1,1
40803,ചിന്തിക്കുക,0,0,1,1
40830,रेस्तरां,0,0,1,1
40831,അമേരിക്കയിൽ,0,0,1,1
40832,gentagelse.,0,0,1,1
40867,ನೋಡುವ,0,0,1,1
40861,protegido,0,0,1,1
51028,ياهو,0,0,1,1
40863,ejaculation,0,0,1,1
40864,नियमित,0,0,1,1
40865,sammeln,0,0,1,1
40866,ಹಿಡಿದಿಡಬಹುದೇ,0,0,1,1
40870,toerist,0,0,1,1
40833,hegemonia,0,0,1,1
40873,sociales…,0,0,1,1
51027,इस्परान्तो,0,0,1,1
40876,brott,0,0,1,1
40877,verrückt,0,0,1,1
40878,éthique,0,0,1,1
40880,lui-même.,0,0,1,1
40860,söyleme,0,0,1,1
40855,издания.,0,0,1,1
40854,ayudaría,0,0,1,1
40853,വിവേകം,0,0,1,1
40851,energía,0,0,1,1
51030,الإستراتيجية,0,0,1,1
51031,أمير,0,0,1,1
40847,सवालों,0,0,1,1
40846,моей,0,0,1,1
40845,toekomst,0,0,1,1
51032,undue,0,0,1,1
40843,போகிறது,0,0,1,1
40842,maddelerdir.,0,0,1,1
40839,waarschijnlijk,0,0,1,1
40838,ciddi,0,0,1,1
40835,നാർസിസയെക്കുറിച്ചും,0,0,1,1
40834,இடம்பெறலாம்.,0,0,1,1
40973,inocência,0,0,1,1
51014,начинается,0,0,1,1
50987,arbres,0,0,1,1
41102,hunde,0,0,1,1
41094,vackraste,0,0,1,1
41095,സമർപ്പിക്കപ്പെട്ടിരിക്കുന്നു.,0,0,1,1
41096,sophisticated,0,0,1,1
41097,ലഭിക്കുന്ന,0,0,1,1
41099,ഐസ്ക്രീമുകളുടെ,0,0,1,1
50995,uygulanmak,0,0,1,1
50994,opfundet,0,0,1,1
41092,gelmiş,0,0,1,1
41105,редактироваться,0,0,1,1
41107,ذوي,0,0,1,1
41109,adamları,0,0,1,1
50992,editarlos,0,0,1,1
41111,കഴിവനുസരിച്ച്,0,0,1,1
41112,suisse[ah],0,0,1,1
41093,إليها,0,0,1,1
41090,определение,0,0,1,1
51001,αλεύρι,0,0,1,1
50998,συνάντησης,0,0,1,1
41070,sølvbrød,0,0,1,1
50999,வழியாகும்.,0,0,1,1
41074,nyhetsmedia,0,0,1,1
41075,atone,0,0,1,1
41077,cantonales,0,0,1,1
41078,ജീവിതം,0,0,1,1
50997,perdiendo,0,0,1,1
41089,цифрах,0,0,1,1
41082,gehaald,0,0,1,1
41083,mätningar,0,0,1,1
41085,fejltagelse.,0,0,1,1
50996,chats,0,0,1,1
41087,ഉപയോഗിച്ച,0,0,1,1
41088,rechtes,0,0,1,1
41113,ஒழுங்கமைவுப்,0,0,1,1
41114,swami,0,0,1,1
41115,registradas,0,0,1,1
41147,acercando,0,0,1,1
41141,subfield,0,0,1,1
41142,solicitaron,0,0,1,1
50988,sugerencias.,0,0,1,1
41144,enregistré,0,0,1,1
41145,verjaardag,0,0,1,1
41146,виргиния,0,0,1,1
41148,தொடங்கப்,0,0,1,1
41116,обобщённое,0,0,1,1
41150,വിഷമിക്കുന്നുവെന്നും,0,0,1,1
41151,censurer,0,0,1,1
41152,ಬಳಸಿದರೆ,0,0,1,1
41154,possède,0,0,1,1
41155,எல்லாவற்றிற்கும்,0,0,1,1
41156,hypertekst.,0,0,1,1
41140,formulerat,0,0,1,1
50990,fui,0,0,1,1
50991,ατόμου,0,0,1,1
41137,simulation-based,0,0,1,1
41136,வரையில்,0,0,1,1
41133,القادم؟,0,0,1,1
41130,ചിഹ്നങ്ങളെയും,0,0,1,1
41129,മധ്യമാ‍ർഗത്തിനേ,0,0,1,1
41128,he •,0,0,1,1
41127,écologique »,0,0,1,1
41125,важнее,0,0,1,1
41124,kriteriet,0,0,1,1
41123,फ़्रान्सीसी,0,0,1,1
41122,liberty,0,0,1,1
41119,konsensusbeslut,0,0,1,1
41118,descrevendo,0,0,1,1
41117,பரிந்துரை,0,0,1,1
51000,കണ്ടെത്താൻ.,0,0,1,1
41068,നിലനിൽപ്പുണ്ടാവൂ.,0,0,1,1
51013,discernir,0,0,1,1
41007,picarde,0,0,1,1
41001,herinneren,0,0,1,1
41002,होना।,0,0,1,1
41003,മറാഠി,0,0,1,1
51009,റഫറൻസുകളുമായി,0,0,1,1
41004,participate.,0,0,1,1
41006,contribue,0,0,1,1
41009,gedachtegoed,0,0,1,1
40998,parfois.,0,0,1,1
41011,emprestar,0,0,1,1
41012,ആയിരം,0,0,1,1
41013,fournissent,0,0,1,1
41014,عاصفة,0,0,1,1
41015,كامل،,0,0,1,1
41016,öncesi,0,0,1,1
41000,مرتبكًا,0,0,1,1
40997,vermelho,0,0,1,1
41066,конечно.,0,0,1,1
40986,முயற்சியானது,0,0,1,1
40979,участников.,0,0,1,1
40980,وغمز,0,0,1,1
40982,உரிமை,0,0,1,1
51012,hará,0,0,1,1
40984,esthétiques,0,0,1,1
40985,ദേഷ്യമാണ്.,0,0,1,1
51011,alligevel.,0,0,1,1
40995,ಖರೀದಿಸುವುದಿಲ್ಲ,0,0,1,1
40988,нейросетях,0,0,1,1
40989,verkeerd,0,0,1,1
40991,சம்பிரதாயத்துக்காக,0,0,1,1
40992,إمتاعًا,0,0,1,1
40993,νοιαζόταν,0,0,1,1
40994,بكونها,0,0,1,1
41017,​​enorme,0,0,1,1
51007,പാഠത്തിൽ,0,0,1,1
41020,الخامسة,0,0,1,1
41057,ஆணியை,0,0,1,1
51003,écologiques,0,0,1,1
41049,fængsler,0,0,1,1
41051,ولو,0,0,1,1
41053,doctrines,0,0,1,1
41054,godkänt,0,0,1,1
41056,galês,0,0,1,1
51002,முழுவதுமாகப்,0,0,1,1
41022,​​aos,0,0,1,1
41060,monta,0,0,1,1
41061,ip-adresser.,0,0,1,1
41062,ಹೇಳುತ್ತದೆ.,0,0,1,1
41063,வரலாற்றைக்,0,0,1,1
41064,befordrad,0,0,1,1
41065,കണ്ണുകളും,0,0,1,1
41046,ಕಾರ್ಯನಿರತವಾಗಿದೆ.,0,0,1,1
41045,slecht,0,0,1,1
41044,καθόλου.,0,0,1,1
41041,verme,0,0,1,1
41040,५००००,0,0,1,1
41039,കരുതുന്നില്ല.,0,0,1,1
41038,فهل,0,0,1,1
41037,identifying,0,0,1,1
41035,injunction,0,0,1,1
41034,verlagsgesellschaft,0,0,1,1
41033,questionado,0,0,1,1
51005,отрицательное,0,0,1,1
41030,eins,0,0,1,1
41029,febrero,0,0,1,1
41025,bredt,0,0,1,1
51006,piadas,0,0,1,1
41023,dumpen.,0,0,1,1
41548,konkurrens.,0,0,1,1
41550,ஆண்கள்,0,0,1,1
41552,لزيارة,0,0,1,1
42059,تسألك,0,0,1,1
42054,traditionally,0,0,1,1
42055,visuel,0,0,1,1
42056,komik,0,0,1,1
42057,ಹೇಳಿದ್ದಳು,0,0,1,1
42058,« article,0,0,1,1
50867,المغادرة,0,0,1,1
42060,знаменитости.,0,0,1,1
42052,profite,0,0,1,1
42061,happens,0,0,1,1
42063,landen,0,0,1,1
42064,sıkışıp,0,0,1,1
42065,विद्वानों,0,0,1,1
42066,hayalleriyle,0,0,1,1
42067,hjemmeside.,0,0,1,1
42053,levrel,0,0,1,1
42051,terrestre,0,0,1,1
42033,i̇skeletor,0,0,1,1
50869,അമ്മയ്‌ക്കായി,0,0,1,1
50870,സമൂഹമാണ്വിക്കിപീഡിയരുടേത്.,0,0,1,1
42036,hart,0,0,1,1
42037,seasons,0,0,1,1
42038,critique,0,0,1,1
42039,klassieke,0,0,1,1
42040,أسقطت,0,0,1,1
42041,இழந்துவிட்டேன்,0,0,1,1
42050,raffiniert.,0,0,1,1
42045,चर्चा,0,0,1,1
42046,открыт,0,0,1,1
42047,viagem,0,0,1,1
42048,للمساعدة,0,0,1,1
42049,lægge,0,0,1,1
50868,сильны,0,0,1,1
42068,எழுந்தேன்,0,0,1,1
42070,مشغولاً.,0,0,1,1
42072,failing,0,0,1,1
42099,δρόμο.,0,0,1,1
50863,മലയാളത്തിൽ,0,0,1,1
42092,promotie,0,0,1,1
42093,हतोत्साहित,0,0,1,1
42094,lyst,0,0,1,1
42096,amenaza.,0,0,1,1
42098,négatives,0,0,1,1
42100,tornando,0,0,1,1
50865,plantera,0,0,1,1
42103,वेरिएबल्स,0,0,1,1
50861,जीता,0,0,1,1
42105,جالسين,0,0,1,1
42106,फ्लुमोक्स,0,0,1,1
42107,sketches,0,0,1,1
42108,abriter,0,0,1,1
42091,işlerin,0,0,1,1
42090,complicada,0,0,1,1
42089,எடுக்கலாமா,0,0,1,1
42088,yaparım.,0,0,1,1
42087,ikilem,0,0,1,1
42086,dime,0,0,1,1
42085,relyheavily,0,0,1,1
42084,അസ്സാമീസ്,0,0,1,1
42083,génération,0,0,1,1
42082,പരമാവധി,0,0,1,1
42081,demecinde,0,0,1,1
42079,producerar,0,0,1,1
42078,gráfico,0,0,1,1
42077,streefde,0,0,1,1
42076,μείνε,0,0,1,1
42075,dönmeme,0,0,1,1
42073,layer.,0,0,1,1
42034,அதிகமான,0,0,1,1
42032,°′″w﻿,0,0,1,1
50858,εσένα,0,0,1,1
41971,utilizados,0,0,1,1
41964,निगमों,0,0,1,1
41965,αποχαιρετήσει,0,0,1,1
41966,corporativas.,0,0,1,1
41967,uppfyllelse.,0,0,1,1
50877,f.,0,0,1,1
41970,stilzwijgend,0,0,1,1
50876,compostura.,0,0,1,1
41961,devoir,0,0,1,1
41972,ಪುನರಾರಂಭಿಸಲು,0,0,1,1
41973,antigamente,0,0,1,1
41976,مستويات,0,0,1,1
41978,பரீட்சைக்கு,0,0,1,1
41980,bemerken,0,0,1,1
41981,feature-artikler,0,0,1,1
41963,الاتفاق,0,0,1,1
41960,പിടിച്ചില്ലേ,0,0,1,1
42031,fotografia,0,0,1,1
41946,progressivement.,0,0,1,1
41938,jugar,0,0,1,1
41939,ക്യാരക്റ്റർ,0,0,1,1
41941,لنفترض,0,0,1,1
41943,forstyrret,0,0,1,1
41944,weeds,0,0,1,1
41945,еду.,0,0,1,1
41948,aprobado,0,0,1,1
41958,приближается,0,0,1,1
41949,എന്താണെന്ന്,0,0,1,1
41950,телефону,0,0,1,1
41951,പരിശീലിപ്പിക്കുക,0,0,1,1
41953,للقلق.,0,0,1,1
41955,thuiskwam,0,0,1,1
41956,näsa,0,0,1,1
41982,തിരുത്തി,0,0,1,1
41983,källkod.,0,0,1,1
50875,provoqué,0,0,1,1
42015,निर्दिष्ट,0,0,1,1
50873,जीने,0,0,1,1
42009,convenait,0,0,1,1
42010,publicadas,0,0,1,1
42011,l'international,0,0,1,1
42012,nebula,0,0,1,1
42014,разработанный,0,0,1,1
42020,மரியனை,0,0,1,1
41985,происхождение,0,0,1,1
42021,cy •,0,0,1,1
42022,adresse,0,0,1,1
42025,traced.,0,0,1,1
50871,распространение,0,0,1,1
42029,обходительный,0,0,1,1
42030,sætninger.,0,0,1,1
42008,consagrados,0,0,1,1
42007,फैसले,0,0,1,1
42006,it’s,0,0,1,1
42003,ಭಾವಿಸಿದ್ದೇನೆ,0,0,1,1
42002,robotics,0,0,1,1
42000,لتسوية,0,0,1,1
41999,பொருத்தமானதாக,0,0,1,1
41998,رسمية.,0,0,1,1
41997,hagamos,0,0,1,1
41995,τράπεζα,0,0,1,1
41994,கூறினார்,0,0,1,1
50874,systeem.,0,0,1,1
41990,вид,0,0,1,1
41989,dilemmes.,0,0,1,1
41988,forecasting,0,0,1,1
41987,mentalement,0,0,1,1
41986,ستنجح.,0,0,1,1
50859,والمناقشة.,0,0,1,1
42114,jättebra.,0,0,1,1
41553,ಗೊಂದಲಕ್ಕೀಡಾಗಿದ್ದೇನೆ,0,0,1,1
42224,coexistiram,0,0,1,1
42217,langdurig,0,0,1,1
42218,håndtere,0,0,1,1
42219,klikke,0,0,1,1
42221,വാഹന,0,0,1,1
42222,colaboró,0,0,1,1
42223,പെരുമഴയാവുകയാണ്.,0,0,1,1
42227,ಸುಲಭವಾಗಿ,0,0,1,1
42214,случайно,0,0,1,1
42228,أليكسا,0,0,1,1
42229,delicados.,0,0,1,1
50830,trem,0,0,1,1
42231,externe,0,0,1,1
42232,fédérales,0,0,1,1
42233,نجت,0,0,1,1
50832,beginnen,0,0,1,1
42213,encyclopedieën.,0,0,1,1
42194,sociaux.,0,0,1,1
42203,divulgado,0,0,1,1
42196,السويدية،,0,0,1,1
42197,трое,0,0,1,1
42198,കണ്ടതെന്ന്,0,0,1,1
50837,vermuten,0,0,1,1
42201,leyes,0,0,1,1
42202,клиффордом,0,0,1,1
42204,пользовательского,0,0,1,1
42212,délicate,0,0,1,1
42205,långsammare,0,0,1,1
42206,कॉपीराईट,0,0,1,1
50834,تدين,0,0,1,1
42207,kızgınım.,0,0,1,1
42208,графов,0,0,1,1
42211,ലഭിച്ചാൽ,0,0,1,1
42235,vont,0,0,1,1
42236,tillåtna,0,0,1,1
42237,avsiktligen,0,0,1,1
42267,umduğum,0,0,1,1
42257,poorer.,0,0,1,1
42258,καθόταν,0,0,1,1
42262,soll,0,0,1,1
42264,satisfactorios,0,0,1,1
42265,знала,0,0,1,1
42266,ಪುನರಾವರ್ತನೆ,0,0,1,1
50825,anımsattıkları”,0,0,1,1
42238,kullanılabilir,0,0,1,1
42270,जोड़ा,0,0,1,1
42271,expertförfattad,0,0,1,1
42274,persian,0,0,1,1
42275,ஊடகமாகவும்,0,0,1,1
50823,hesitando.,0,0,1,1
42278,paródias,0,0,1,1
42256,défi ,0,0,1,1
42255,non-humains,0,0,1,1
42254,discuter,0,0,1,1
42253,φωνής,0,0,1,1
42251,രാത്രിയിൽ,0,0,1,1
42250,ಹಲವಾರು,0,0,1,1
42249,اعتذارى.,0,0,1,1
42248,detta.,0,0,1,1
42247,απαντήσω,0,0,1,1
42246,βασίζεται,0,0,1,1
42245,δοκίμιό,0,0,1,1
50828,trazia,0,0,1,1
42243,مقاطعتك.,0,0,1,1
42242,respecter,0,0,1,1
50829,hattest,0,0,1,1
42240,പൂരകസംവിധാനമായാണ്‌,0,0,1,1
42239,représentativité,0,0,1,1
42195,propietario.,0,0,1,1
42193,menina,0,0,1,1
42115,επικριθεί,0,0,1,1
42143,historikern,0,0,1,1
42137,high-quality,0,0,1,1
42138,சொற்றொடரையும்,0,0,1,1
50852,s'inscrit,0,0,1,1
42140,détermine,0,0,1,1
42141,base ,0,0,1,1
50851,etikettregler,0,0,1,1
42144,förhindra,0,0,1,1
50853,sentó,0,0,1,1
50849,industrialisés.,0,0,1,1
42146,വിഭാഗങ്ങളായ്,0,0,1,1
42147,assess,0,0,1,1
50848,النطاقات,0,0,1,1
42150,onaylanmamış,0,0,1,1
50847,анонимными,0,0,1,1
42136,francophone,0,0,1,1
42133,சாப்பிடுவது,0,0,1,1
42191,unutuyor.,0,0,1,1
42122,будьте,0,0,1,1
42116,ಮರೆತುಹೋಗುತ್ತಾನೆ.,0,0,1,1
42118,préparé,0,0,1,1
42119,perpetuidad.,0,0,1,1
50857,проверку,0,0,1,1
50856,removido.,0,0,1,1
42121,mångspråkig,0,0,1,1
42123,vigtige,0,0,1,1
42132,лишь,0,0,1,1
42124,quitte,0,0,1,1
42125,मीट,0,0,1,1
42126,внесением,0,0,1,1
42127,несбалансированность,0,0,1,1
42128,नक़ल,0,0,1,1
42131,केमलकेस,0,0,1,1
42153,lineares,0,0,1,1
42154,svårare,0,0,1,1
42156,animées,0,0,1,1
42181,sociaux,0,0,1,1
42174,குறிப்பாக,0,0,1,1
42175,ಹೆಚ್ಚಿಸುವುದು,0,0,1,1
42177,قدمي,0,0,1,1
42178,കുഴഞ്ഞുമറിഞ്ഞു,0,0,1,1
42179,கொண்டிருக்கிறீர்கள்,0,0,1,1
42180,persons,0,0,1,1
42183,encontrarme,0,0,1,1
50846,bracket,0,0,1,1
42184,presidencial.,0,0,1,1
42185,l'hémisphère,0,0,1,1
50839,dramatica,0,0,1,1
42187,घोषणा,0,0,1,1
42189,continuera,0,0,1,1
42190,conversatie,0,0,1,1
42172,retorting,0,0,1,1
42171,«знание»,0,0,1,1
42170,рок,0,0,1,1
42169,slak,0,0,1,1
42168,soldats,0,0,1,1
42167,parenté,0,0,1,1
42166,شيئًا.,0,0,1,1
50843,besorgen,0,0,1,1
50844,machines.,0,0,1,1
42164,verkrachtingsincidenten,0,0,1,1
42163,स्पॉट,0,0,1,1
42162,recettes,0,0,1,1
42161,«тупой»,0,0,1,1
42160,château,0,0,1,1
42159,لمقابلة,0,0,1,1
50845,पूछना,0,0,1,1
42157,நன்றாகத்,0,0,1,1
41937,meritstatus,0,0,1,1
41936,sel,0,0,1,1
41934,ne.,0,0,1,1
50911,بالقلق,0,0,1,1
41666,sim.,0,0,1,1
41667,l'ajout,0,0,1,1
41668,الرئيس,0,0,1,1
41670,கவலைப்படுகிறாள்,0,0,1,1
50912,внешностью,0,0,1,1
41671,infantil​​,0,0,1,1
41674,vanskelig,0,0,1,1
41664,സംബന്ധിച്ചുണ്ടായ,0,0,1,1
41676,desfazem,0,0,1,1
41678,caa.,0,0,1,1
41680,fühlen,0,0,1,1
41681,تصعيد,0,0,1,1
41682,углы»,0,0,1,1
41683,email.,0,0,1,1
50913,السابقة,0,0,1,1
41663,அமைப்புகளையும்,0,0,1,1
41645,معلومات.,0,0,1,1
41651,remarquez,0,0,1,1
50916,أربع,0,0,1,1
41647,bilgiyi,0,0,1,1
41648,उदासीन,0,0,1,1
41649,desconcierto,0,0,1,1
50915,förutsätts,0,0,1,1
41650,reddettiğinden,0,0,1,1
41652,qu'« en,0,0,1,1
41661,finaliste,0,0,1,1
41655,qualificavam,0,0,1,1
41656,ممكنة,0,0,1,1
50914,« utilisateur »[l].,0,0,1,1
41658,mulheres,0,0,1,1
41659,inser,0,0,1,1
41660,μπερδέψα,0,0,1,1
41685,ellie'nin,0,0,1,1
41686,willem-alexander,0,0,1,1
41687,конференциях,0,0,1,1
41724,ومخيف.,0,0,1,1
41714,ഇതിനെക്കുറിച്ച്,0,0,1,1
41715,appar,0,0,1,1
41716,chef.,0,0,1,1
41719,कॉलेज,0,0,1,1
41720,विकिआ,0,0,1,1
50901,ederiz.,0,0,1,1
41725,मिलते,0,0,1,1
41688,വിജ്ഞാന,0,0,1,1
41726,domme,0,0,1,1
41728,documentatie,0,0,1,1
50899,contextualization,0,0,1,1
41729,اراك,0,0,1,1
50898,tummarna.,0,0,1,1
41733,conditionnant.,0,0,1,1
41713,informan,0,0,1,1
41712,മെലിസയും,0,0,1,1
50903,സംഭവിച്ച,0,0,1,1
50904,விடய,0,0,1,1
41710,отношения,0,0,1,1
50905,америке,0,0,1,1
41707,പോകുന്നുവെങ്കിൽ,0,0,1,1
41706,hunden,0,0,1,1
41705,أحضرت,0,0,1,1
41704,ಹೇಳಬೇಕಾಗಿದೆ.,0,0,1,1
41702,تعلمنا,0,0,1,1
41698,trademark,0,0,1,1
41694,النظر،,0,0,1,1
41693,பயணத்தை,0,0,1,1
41692,दक्षिण,0,0,1,1
50908,മികച്ചതുമാണ്,0,0,1,1
50909,valid.,0,0,1,1
50917,പേരുകേട്ടതാണ്,0,0,1,1
41644,varia,0,0,1,1
41933,föremål,0,0,1,1
41589,filling,0,0,1,1
41581,политику,0,0,1,1
41583,nez,0,0,1,1
41585,وعندما,0,0,1,1
41586,participante,0,0,1,1
41587,sv.m.wikipedia.org.,0,0,1,1
50927,ifadelerine,0,0,1,1
41590,nok,0,0,1,1
41576,ಕೇಳಬಹುದು.,0,0,1,1
50926,rangés,0,0,1,1
41591,revisões,0,0,1,1
41592,algorithmiques,0,0,1,1
41593,pareces,0,0,1,1
41594,авторитетные,0,0,1,1
50924,categorized,0,0,1,1
41579,μόλις,0,0,1,1
41573,internetgemenskap.,0,0,1,1
41640,expenses,0,0,1,1
41562,वोलापूक,0,0,1,1
41555,articles »,0,0,1,1
41556,finsk-,0,0,1,1
41557,hergebruikt,0,0,1,1
41558,далее».,0,0,1,1
41560,தங்கமாகவும்,0,0,1,1
41561,zone.,0,0,1,1
41563,kapıdan,0,0,1,1
41572,красивых,0,0,1,1
41564,desirable,0,0,1,1
41565,afschuwelijk.,0,0,1,1
41566,misslyckanden,0,0,1,1
41567,διαβάζω,0,0,1,1
41570,constituents,0,0,1,1
41571,referenciadas,0,0,1,1
50923,[أنا],0,0,1,1
41597,swallow,0,0,1,1
50922,தந்தி,0,0,1,1
41627,होगी।ये,0,0,1,1
41621,والضحكات,0,0,1,1
41623,türlü,0,0,1,1
50919,planning,0,0,1,1
41624,anlayışlı,0,0,1,1
41625,choices,0,0,1,1
41626,découvrir,0,0,1,1
41628,joueur,0,0,1,1
41600,deixá-los,0,0,1,1
41630,violando,0,0,1,1
41631,kop.,0,0,1,1
41632,ayer,0,0,1,1
41633,неопытных,0,0,1,1
50918,deneyimi,0,0,1,1
41639,düşündüm,0,0,1,1
41620,pt,0,0,1,1
50920,تحقق,0,0,1,1
41618,definiciones,0,0,1,1
41617,والدتك,0,0,1,1
41615,происходило,0,0,1,1
41614,adolescents,0,0,1,1
41613,contratá-lo,0,0,1,1
41612,राज्य,0,0,1,1
41611,atıp,0,0,1,1
41610,colocar,0,0,1,1
41609,una.,0,0,1,1
41608,fashion,0,0,1,1
41606,ചെയ്യുന്നില്ല.,0,0,1,1
50921,conscientes,0,0,1,1
41603,ಮುಕ್ತನಾಗಿದ್ದೇನೆ,0,0,1,1
41602,üçüncü,0,0,1,1
41601,prémio,0,0,1,1
41734,ಒಪ್ಪಲು,0,0,1,1
41740,perfil,0,0,1,1
41741,extérieures,0,0,1,1
41875,förstår,0,0,1,1
41866,ഉത്തരം,0,0,1,1
41867,τύχης,0,0,1,1
41868,“davutoğlu’nun,0,0,1,1
41870,الفستان,0,0,1,1
41871,textbook,0,0,1,1
41874,violações,0,0,1,1
50884,областях.,0,0,1,1
50886,hemligt,0,0,1,1
41880,lilla,0,0,1,1
41881,الآخرون.,0,0,1,1
41883,لجعل,0,0,1,1
41884,stupéfiant,0,0,1,1
41886,respectiva,0,0,1,1
41888,lograr,0,0,1,1
41865,entra,0,0,1,1
41862,തിരഞ്ഞെടുക്കാൻ,0,0,1,1
41742,tier,0,0,1,1
41850,résume,0,0,1,1
41843,agradáveis,0,0,1,1
41844,scholarly,0,0,1,1
41845,ceden,0,0,1,1
41846,طلبت,0,0,1,1
41847,fécond.,0,0,1,1
41849,خاصةً,0,0,1,1
41851,hatırlatmak,0,0,1,1
41861,मुस्कुराते,0,0,1,1
41852,seneste,0,0,1,1
41853,прецедентов ,0,0,1,1
41855,tempo.,0,0,1,1
41858,സൃഷ്ടിക്കാറുണ്ടെങ്കിലും,0,0,1,1
50887,alunos,0,0,1,1
41859,opdateringen,0,0,1,1
41890,imaginables,0,0,1,1
41891,fikir,0,0,1,1
41892,élections,0,0,1,1
41922,ними,0,0,1,1
41915,correcteurs,0,0,1,1
41916,இரண்டிலும்,0,0,1,1
41917,assiette,0,0,1,1
41918,plagieringar,0,0,1,1
41919,anglófono,0,0,1,1
41921,uitpraten.,0,0,1,1
41923,ಪ್ರೀತಿಸುತ್ತಿಲ್ಲ.,0,0,1,1
41896,initiativet,0,0,1,1
41925,தகவல்களின்,0,0,1,1
41926,'x',0,0,1,1
41927,கொடுக்கப்,0,0,1,1
41928,расслышал,0,0,1,1
41929,sous-sol,0,0,1,1
41930,dankeschöns,0,0,1,1
41914,ಪರೀಕ್ಷೆಗೆ,0,0,1,1
41913,ಸಂಭಾಷಣೆಯ,0,0,1,1
41911,ceb,0,0,1,1
41909,llamadas,0,0,1,1
41908,smiles,0,0,1,1
41907,wortelwoorden,0,0,1,1
41906,злотых.,0,0,1,1
41905,contredite,0,0,1,1
41904,φύσης,0,0,1,1
41903,также.,0,0,1,1
41902,mond,0,0,1,1
41901,سكان,0,0,1,1
50881,கூர்மையானது,0,0,1,1
50882,commentant,0,0,1,1
41899,ಅತ್ಯಾಚಾರ,0,0,1,1
41898,voltar,0,0,1,1
41897,hädelse,0,0,1,1
41842,آرون,0,0,1,1
41841,basen,0,0,1,1
41840,രാജകുമാരൻ,0,0,1,1
41775,genres,0,0,1,1
41769,கட்டுரைகளுக்கு,0,0,1,1
41770,veracidade,0,0,1,1
41771,vandalisering,0,0,1,1
41772,blacklist,0,0,1,1
41773,hablemos,0,0,1,1
50896,weint,0,0,1,1
41776,framför,0,0,1,1
41791,jurken,0,0,1,1
41777,ريفيو,0,0,1,1
41778,واجه,0,0,1,1
41780,artikelskrivandet,0,0,1,1
41781,يتوقف,0,0,1,1
41784,обычаями.,0,0,1,1
41787,германии,0,0,1,1
41767,exprimées,0,0,1,1
41766,പ്രപഞ്ചത്തെയും,0,0,1,1
41765,الممر.,0,0,1,1
41763,दिमाग,0,0,1,1
41761,classent,0,0,1,1
41760,நுபீடியாவிலிருந்த,0,0,1,1
41759,período,0,0,1,1
41758,στάση,0,0,1,1
41757,προχωρήστε.,0,0,1,1
41756,poderi,0,0,1,1
41755,veinte,0,0,1,1
41753,പിറക്കുകയായി.,0,0,1,1
41750,prediga,0,0,1,1
41749,ആരംഭിക്കുന്നത്,0,0,1,1
41746,universellement.,0,0,1,1
41744,alterou,0,0,1,1
41743,occitano,0,0,1,1
41789,undesirable,0,0,1,1
50894,ഇൻപുട്ടുകൾ,0,0,1,1
41839,besonders,0,0,1,1
41828,ಪಡೆದುಕೊಂಡಿದ್ದೇನೆ.,0,0,1,1
41822,referenceværk,0,0,1,1
41823,romantisme.,0,0,1,1
41824,ಫಿಕ್ಸ್‌ನಲ್ಲಿದ್ದಾಗ,0,0,1,1
41825,suffisante.,0,0,1,1
41826,bage,0,0,1,1
41827,അവർക്ക്,0,0,1,1
41829,tillåtet,0,0,1,1
41795,tätt,0,0,1,1
41832,درجة.,0,0,1,1
41833,പത്രമാസികകളും,0,0,1,1
41835,plåga,0,0,1,1
41836,jours ».,0,0,1,1
41837,levé,0,0,1,1
50889,അവയിൽ‌,0,0,1,1
41821,открытость,0,0,1,1
41818,വിക്കിപീഡിയരും,0,0,1,1
41815,सक्षम,0,0,1,1
41814,confundirse,0,0,1,1
41813,мозгу,0,0,1,1
50890,ആവശ്യപ്പെടുന്നു,0,0,1,1
41810,förolämpning,0,0,1,1
41809,« tentatives,0,0,1,1
41808,разослано,0,0,1,1
41807,отклику,0,0,1,1
50891,n'apparaît,0,0,1,1
41804,redistribución,0,0,1,1
41803,മനസ്സും,0,0,1,1
41801,fatos,0,0,1,1
41799,مجاني,0,0,1,1
41798,conozco,0,0,1,1
41796,٪.,0,0,1,1
31694,noemde,0,0,1,1
26118,نستخدم,0,0,1,1
31692,identique,0,0,1,1
10923,помедленнее,0,0,1,1
11080,शेयर,0,0,1,1
11082,பெல்,0,0,1,1
11083,kvartalet,0,0,1,1
11084,உருளைக்கிழங்கை,0,0,1,1
11086,பிழைத்திருத்தத்திற்கு,0,0,1,1
11087,luidspreker.,0,0,1,1
11088,классифицировать,0,0,1,1
11089,meilleurs,0,0,1,1
11091,uğraşısı,0,0,1,1
11092,antag,0,0,1,1
11093,அறிவித்தார்.,0,0,1,1
11094,kvalitet.,0,0,1,1
11096,ஆங்கிலப்,0,0,1,1
11097,schools.,0,0,1,1
11098,கிகில்ஸ்,0,0,1,1
11099,generando,0,0,1,1
11101,gives,0,0,1,1
11079,gentileza,0,0,1,1
11077,dejar,0,0,1,1
11076,l'utiliser.,0,0,1,1
11057,άλλως.,0,0,1,1
11050,​​wat,0,0,1,1
11051,ചോദ്യചിഹ്നത്തിലൂടെയും,0,0,1,1
11052,формы,0,0,1,1
11053,bandet,0,0,1,1
11054,incômodo,0,0,1,1
11055,σταμάτησε,0,0,1,1
11056,owned,0,0,1,1
11058,lagar,0,0,1,1
11075,trip,0,0,1,1
11062,units.,0,0,1,1
11064,habitées,0,0,1,1
11067,softwares.,0,0,1,1
11070,ಹೊಳೆಯುವ,0,0,1,1
11072,højttaler.,0,0,1,1
11073,anciens,0,0,1,1
11074,الكفاية.,0,0,1,1
11106,нагрузку,0,0,1,1
11111,நர்சிசாவைப்,0,0,1,1
11116,sounds,0,0,1,1
11152,mixed,0,0,1,1
11145,équilibrer,0,0,1,1
11146,conjectured,0,0,1,1
11147,подпадает,0,0,1,1
11148,истина»,0,0,1,1
11149,magiques,0,0,1,1
11150,انخفضت,0,0,1,1
11151,anlatıyorlar.,0,0,1,1
11153,செய்முறைப்படி,0,0,1,1
11141,iyisin,0,0,1,1
11154,micro-clusters,0,0,1,1
11155,exitosa,0,0,1,1
11157,கேட்கிறார்கள்,0,0,1,1
11159,खरीदना,0,0,1,1
11161,были.,0,0,1,1
11162,получилось,0,0,1,1
11163,d'italie »[m].,0,0,1,1
11144,നേതാക്കന്മാരുടെ,0,0,1,1
11140,bedøvet,0,0,1,1
11117,amerika'da,0,0,1,1
11128,можете.,0,0,1,1
11118,دون,0,0,1,1
11119,ಪ್ರಶ್ನೆ.,0,0,1,1
11120,ஏனைய,0,0,1,1
11122,estratégia,0,0,1,1
11124,dotée,0,0,1,1
11125,espejo,0,0,1,1
11127,mit's,0,0,1,1
11129,точку.,0,0,1,1
11138,запрашиваемых,0,0,1,1
11130,zeit.,0,0,1,1
11131,одну,0,0,1,1
11133,desktops,0,0,1,1
11134,பயன்படுத்துவதன்,0,0,1,1
11135,trampar,0,0,1,1
11136,временем.,0,0,1,1
11137,миру,0,0,1,1
11049,customarily,0,0,1,1
11048,чего-то.,0,0,1,1
11047,vilseledande,0,0,1,1
10969,garagem.,0,0,1,1
10958,analytics.,0,0,1,1
10959,auxiliar,0,0,1,1
10960,undécimo,0,0,1,1
10961,así.,0,0,1,1
10962,décourager,0,0,1,1
10964,ಪಡೆದಿದ್ದೀರಾ,0,0,1,1
10966,лучшую,0,0,1,1
10970,ondervertegenwoordigd,0,0,1,1
10956,susceptibles,0,0,1,1
10971,spreche,0,0,1,1
10972,έννοιες,0,0,1,1
10973,nefes,0,0,1,1
10974,مدريد,0,0,1,1
10975,nervous,0,0,1,1
10976,ojo,0,0,1,1
10977,älskling,0,0,1,1
10957,zamanlarda,0,0,1,1
10955,ζητήσουν,0,0,1,1
10981,generelt,0,0,1,1
10940,motivera,0,0,1,1
10926,comprendre.,0,0,1,1
10927,отблагодарить.,0,0,1,1
10929,sohbetin,0,0,1,1
10930,июля,0,0,1,1
10933,вручена,0,0,1,1
10935,soru.,0,0,1,1
10938,oprindelser,0,0,1,1
10945,pollueur-payeur,0,0,1,1
10954,powerful,0,0,1,1
10946,«значимой»,0,0,1,1
10947,obtén,0,0,1,1
10948,evaluar,0,0,1,1
10949,συγκεντρώνονται,0,0,1,1
10950,وتراجعت,0,0,1,1
10951,antigas,0,0,1,1
10953,ledig,0,0,1,1
10980,ουδετερότητας,0,0,1,1
10982,repetição.,0,0,1,1
11043,ആരാണ്,0,0,1,1
11025,siri.,0,0,1,1
11016,победил,0,0,1,1
11017,motstridiga,0,0,1,1
11018,wondering,0,0,1,1
11019,നൽകാം.,0,0,1,1
11021,публикаций.,0,0,1,1
11022,buenos.,0,0,1,1
11024,aprendendo,0,0,1,1
11026,producto,0,0,1,1
11013,عامية,0,0,1,1
11027,deskundigen,0,0,1,1
11029,കേട്ടിരിക്കാം.,0,0,1,1
11030,целом,0,0,1,1
11032,नौकरानियों।,0,0,1,1
11034,telefonsamtal,0,0,1,1
11035,والمساهمين,0,0,1,1
11039,сотрудничеству,0,0,1,1
11015,இல்லாமலேயே,0,0,1,1
11012,çalışın.,0,0,1,1
10986,cto,0,0,1,1
10998,overlap,0,0,1,1
10987,बोलचाल,0,0,1,1
10988,discussions etc..,0,0,1,1
10989,ничего.,0,0,1,1
10991,here.,0,0,1,1
10992,gözleri,0,0,1,1
10995,loslegen,0,0,1,1
10996,ನಾರ್ಸಿಸಾಳನ್ನು,0,0,1,1
11001,d'« apprendre »,0,0,1,1
11011,suspect,0,0,1,1
11002,fransa'nın,0,0,1,1
11004,ситуаций,0,0,1,1
11005,أسرة,0,0,1,1
11007,الأنماط.,0,0,1,1
11008,ورفع,0,0,1,1
11009,الأسبوع؟,0,0,1,1
11010,ಪ್ರಸಿದ್ಧ,0,0,1,1
11164,दुबारा,0,0,1,1
11165,देखकर,0,0,1,1
11166,конфигурация,0,0,1,1
11334,morse,0,0,1,1
11326,चाहेंगे,0,0,1,1
11327,uitgestorven,0,0,1,1
11328,lanzamiento,0,0,1,1
11330,идете,0,0,1,1
11331,restante,0,0,1,1
11332,exibir,0,0,1,1
11333,укрепить,0,0,1,1
11336,yaptıysa,0,0,1,1
11324,substitui,0,0,1,1
11339,llevo.,0,0,1,1
11341,ಸಹಿಸಿಕೊಳ್ಳಿ.,0,0,1,1
11343,exhibiting,0,0,1,1
11344,μόνιμα,0,0,1,1
11345,gebruikmaakten,0,0,1,1
11346,localidades,0,0,1,1
11347,épisode,0,0,1,1
11325,selvfølgelig.,0,0,1,1
11322,l'app,0,0,1,1
11350,traduzido,0,0,1,1
11305,imparcialidad,0,0,1,1
11295,transphobie.,0,0,1,1
11296,cuire,0,0,1,1
11297,porn,0,0,1,1
11299,sabedoria,0,0,1,1
11300,الغسيل,0,0,1,1
11302,நடக்காத,0,0,1,1
11304,clarified,0,0,1,1
11306,arboretums,0,0,1,1
11320,dits,0,0,1,1
11309,malaio,0,0,1,1
11310,recreate,0,0,1,1
11311,«народная,0,0,1,1
11314,autorités,0,0,1,1
11315,växer.,0,0,1,1
11317,يكفي,0,0,1,1
11319,अपशब्द,0,0,1,1
11348,concludeerde,0,0,1,1
11351,årsförbrukning.,0,0,1,1
11292,അസൈൻമെന്റുകൾ,0,0,1,1
11392,foiré.,0,0,1,1
11383,carte,0,0,1,1
11384,tat,0,0,1,1
11386,relatar,0,0,1,1
11387,traum.,0,0,1,1
11388,combinação,0,0,1,1
11390,والماس,0,0,1,1
11391,passés.,0,0,1,1
11393,объявление,0,0,1,1
11380,yayımladığı,0,0,1,1
11394,ಸೂಪ್‌ನಲ್ಲಿದ್ದೇನೆ,0,0,1,1
11395,syster,0,0,1,1
11396,ritmo,0,0,1,1
11400,चयन,0,0,1,1
11402,തികഞ്ഞ,0,0,1,1
11403,παραπονεθώ,0,0,1,1
11405,പേരിന്റെ,0,0,1,1
11382,ಕ್ಷಮೆಯನ್ನು,0,0,1,1
11379,desarrolla,0,0,1,1
11352,ചേർക്കുമ്പോൾ,0,0,1,1
11365,κοίταζαν,0,0,1,1
11356,പിടിക്കുക.,0,0,1,1
11359,αιώνες,0,0,1,1
11360,castigos,0,0,1,1
11361,लगता।,0,0,1,1
11362,ومختلفة,0,0,1,1
11363,studerende,0,0,1,1
11364,efendim,0,0,1,1
11366,ameliorate,0,0,1,1
11378,purposefully,0,0,1,1
11368,недавние,0,0,1,1
11369,المصرفي,0,0,1,1
11372,spared,0,0,1,1
11373,variables.,0,0,1,1
11374,обеспечению,0,0,1,1
11375,مستهلك,0,0,1,1
11376,χώρος,0,0,1,1
11294,தனி,0,0,1,1
11289,téléphonie,0,0,1,1
11168,முடிவிலும்,0,0,1,1
11211,reddit,0,0,1,1
11203,femmes.,0,0,1,1
11204,гипотетическую,0,0,1,1
11205,portuguese-language,0,0,1,1
11206,maison.,0,0,1,1
11207,ayaklarımı,0,0,1,1
11208,beweisen,0,0,1,1
11209,போன்றன,0,0,1,1
11213,aftes,0,0,1,1
11199,differ,0,0,1,1
11214,ήχο,0,0,1,1
11215,विनम्रता,0,0,1,1
11216,révisions,0,0,1,1
11219,sundanês,0,0,1,1
11220,خلالها,0,0,1,1
11223,mentionnent,0,0,1,1
11225,meşgulüm.,0,0,1,1
11200,förrän,0,0,1,1
11198,فاندربيلت،,0,0,1,1
11229,tagit,0,0,1,1
11182,ಅಮ್ಮನಾಗಿ,0,0,1,1
11169,நினைத்தேன்,0,0,1,1
11170,joplin,0,0,1,1
11171,-udgaven,0,0,1,1
11172,methodology,0,0,1,1
11175,comunistas,0,0,1,1
11176,l'ai,0,0,1,1
11180,positives,0,0,1,1
11183,naturae,0,0,1,1
11196,ثقافة,0,0,1,1
11185,alcanzase,0,0,1,1
11188,суде.,0,0,1,1
11189,art.,0,0,1,1
11190,libresoft,0,0,1,1
11193,reacts,0,0,1,1
11194,trabaja.,0,0,1,1
11195,драгоценными,0,0,1,1
11226,திருத்தல்,0,0,1,1
11230,sociales.,0,0,1,1
11286,vécue,0,0,1,1
11269,المكتبة؟,0,0,1,1
11262,bozuldu,0,0,1,1
11263,renginde,0,0,1,1
11264,«фазы,0,0,1,1
11265,προτίμησης,0,0,1,1
11266,d'étude,0,0,1,1
11267,raden,0,0,1,1
11268,пойду,0,0,1,1
11271,اسمحوا,0,0,1,1
11260,rencontre,0,0,1,1
11272,llegan,0,0,1,1
11274,programação,0,0,1,1
11276,dağıtma,0,0,1,1
11280,പേർക്കും,0,0,1,1
11281,l'identique,0,0,1,1
11282,« portail ».,0,0,1,1
11284,ನಡೆಯುತ್ತಿದೆ.,0,0,1,1
11261,अकाउंट,0,0,1,1
11259,fliken,0,0,1,1
11231,كينيدي.,0,0,1,1
11243,tenir,0,0,1,1
11235,misin.,0,0,1,1
11237,الجمال,0,0,1,1
11238,n’héritent,0,0,1,1
11239,ಮುಂದುವರಿಸುವ,0,0,1,1
11240,பதிவுகள்,0,0,1,1
11241,l'avènement,0,0,1,1
11242,പോകുന്നുവെന്ന്,0,0,1,1
11244,berna.,0,0,1,1
11256,grafemas,0,0,1,1
11246,convergentes.,0,0,1,1
11249,fizeram,0,0,1,1
11250,software-interface,0,0,1,1
11251,vendue,0,0,1,1
11252,fungere.,0,0,1,1
11253,публичное,0,0,1,1
11255,salads,0,0,1,1
10924,croisée,0,0,1,1
10921,ഇംഗ്ലീഷിലെ,0,0,1,1
11408,έργο,0,0,1,1
10918,bloqueadas,0,0,1,1
10572,lineales,0,0,1,1
10573,पहने,0,0,1,1
10574,vidunderligt,0,0,1,1
10577,allgemeinen,0,0,1,1
10579,collecté,0,0,1,1
10580,مناسب,0,0,1,1
10582,ووالدتها,0,0,1,1
10583,manifestant,0,0,1,1
10584,பிரமிக்க,0,0,1,1
10586,സ്വർണ്ണം,0,0,1,1
10587,etmesini,0,0,1,1
10591,टुडे,0,0,1,1
10592,sonho.,0,0,1,1
10593,θυμηθείτε.,0,0,1,1
10595,повторяется,0,0,1,1
10597,intrusions,0,0,1,1
10598,træg.,0,0,1,1
10571,archean,0,0,1,1
10570,десяти,0,0,1,1
10568,saberia,0,0,1,1
10548,يحتوي,0,0,1,1
10540,redirecionar,0,0,1,1
10541,stødende,0,0,1,1
10542,أنتما,0,0,1,1
10543,good.,0,0,1,1
10544,விளம்பரங்களைக்,0,0,1,1
10545,stabilizes,0,0,1,1
10547,صديقي,0,0,1,1
10549,процент,0,0,1,1
10567,etiquetas,0,0,1,1
10552,eons,0,0,1,1
10556,വസ്തുക്കളെ,0,0,1,1
10557,тонуть,0,0,1,1
10558,samtalen.,0,0,1,1
10560,построить,0,0,1,1
10564,തോന്നണമെങ്കിൽ,0,0,1,1
10566,चलाया,0,0,1,1
10599,portant,0,0,1,1
10600,regarda,0,0,1,1
10604,yale,0,0,1,1
10652,artists.,0,0,1,1
10638,беспорядке,0,0,1,1
10639,illaluktande,0,0,1,1
10642,quadrinhos,0,0,1,1
10643,μάθετε,0,0,1,1
10645,ærligt,0,0,1,1
10646,chaud,0,0,1,1
10649,улиток.,0,0,1,1
10655,l'imagination,0,0,1,1
10634,kızınızın,0,0,1,1
10657,belirterek,0,0,1,1
10658,visait,0,0,1,1
10662,ഇടമില്ലെന്ന്,0,0,1,1
10665,एजेंसीयों,0,0,1,1
10666,nan,0,0,1,1
10667,goostman,0,0,1,1
10668,пришло,0,0,1,1
10636,placer,0,0,1,1
10633,sock,0,0,1,1
10606,inquiétude,0,0,1,1
10617,médiathèques,0,0,1,1
10607,रहस्य,0,0,1,1
10609,tête.,0,0,1,1
10610,masters/magisterexamen,0,0,1,1
10611,verfijnd.,0,0,1,1
10613,hydrocarbon,0,0,1,1
10614,процессу,0,0,1,1
10616,स्पेनी,0,0,1,1
10619,activas,0,0,1,1
10632,байесовские,0,0,1,1
10620,aprieto,0,0,1,1
10621,læringen.,0,0,1,1
10623,لتبدو,0,0,1,1
10624,way.,0,0,1,1
10625,അത്‌,0,0,1,1
10629,refuse,0,0,1,1
10631,monitorados,0,0,1,1
10539,aus.,0,0,1,1
10536,മിനിറ്റുകൾക്കുള്ളിൽ,0,0,1,1
10535,ಭಾವಿಸುತ್ತೇನೆ,0,0,1,1
10448,menselijke,0,0,1,1
10435,улучшайте,0,0,1,1
10436,ಅರ್ಥವೇನೆಂದು,0,0,1,1
10441,souvenez-vous,0,0,1,1
10443,kullanarak,0,0,1,1
10444,weekendontdekking,0,0,1,1
10445,порнографическими.,0,0,1,1
10447,bilindiğinden,0,0,1,1
10449,trataste,0,0,1,1
10433,вирджилом,0,0,1,1
10451,hero.,0,0,1,1
10454,остального,0,0,1,1
10456,ಹೆಂಡತಿಯಾಗಿರಬೇಕು,0,0,1,1
10458,είτε,0,0,1,1
10459,programspråket,0,0,1,1
10460,« bonnes »,0,0,1,1
10462,prevented,0,0,1,1
10434,ημιτελής,0,0,1,1
10432,boende,0,0,1,1
10465,വ്യാപകമായി,0,0,1,1
10414,सह-संस्थापक,0,0,1,1
10405,verbijsterd,0,0,1,1
10406,wordt.,0,0,1,1
10407,.× kilograms,0,0,1,1
10408,தடுக்கவும்,0,0,1,1
10410,gorilas,0,0,1,1
10412,إلي.,0,0,1,1
10413,geologic,0,0,1,1
10416,heliopause.,0,0,1,1
10431,self-guided,0,0,1,1
10417,ansiklopedilerindeki,0,0,1,1
10419,inrikesdepartementets,0,0,1,1
10421,mapping,0,0,1,1
10423,appuie,0,0,1,1
10428,émilie,0,0,1,1
10429,chansons,0,0,1,1
10430,அனுமதி.,0,0,1,1
10463,hilsner,0,0,1,1
10466,interior,0,0,1,1
10534,συνέντευξη,0,0,1,1
10514,चित्र,0,0,1,1
10499,описано,0,0,1,1
10504,സ്പീക്കറുകൾ,0,0,1,1
10505,بأوسمة,0,0,1,1
10506,imiter,0,0,1,1
10507,sunulması,0,0,1,1
10508,ಉದಾಹರಣೆಗಳಂತೆ,0,0,1,1
10513,ders,0,0,1,1
10515,ಇಮೇಲ್‌ನಲ್ಲಿ,0,0,1,1
10497,dirigeerden,0,0,1,1
10516,havlu,0,0,1,1
10521,உதாரணமாகச்,0,0,1,1
10522,d'affectations,0,0,1,1
10523,publicación,0,0,1,1
10526,وwikipedia.org,0,0,1,1
10528,χρονικό,0,0,1,1
10532,causaba,0,0,1,1
10498,snabb,0,0,1,1
10496,извиниться.,0,0,1,1
10467,augustin,0,0,1,1
10476,falsa.,0,0,1,1
10468,versus,0,0,1,1
10470,يجعلها,0,0,1,1
10471,protracted,0,0,1,1
10472,elaborado,0,0,1,1
10473,mümkündür.,0,0,1,1
10474,samarbetar,0,0,1,1
10475,बायोलोजी,0,0,1,1
10482,weeds.,0,0,1,1
10495,وشرح,0,0,1,1
10484,அவருக்கு,0,0,1,1
10485,invoerdata.,0,0,1,1
10488,കാണിച്ചു,0,0,1,1
10489,cumpliesen,0,0,1,1
10490,“death,0,0,1,1
10492,probleem.,0,0,1,1
10494,beskrivelsesboksen,0,0,1,1
10669,வழங்கப்பட்டுக்,0,0,1,1
10670,யூடியூபில்,0,0,1,1
10671,саду,0,0,1,1
10843,المقالة،,0,0,1,1
10834,ಮುಖದ,0,0,1,1
10835,ಎಚ್ಚರವಾಯಿತು,0,0,1,1
10836,negotiating,0,0,1,1
10837,aceite,0,0,1,1
10838,ड्राइववे,0,0,1,1
10841,ro,0,0,1,1
10842,språkupplagan,0,0,1,1
10844,сожалению,0,0,1,1
10831,bicholim,0,0,1,1
10845,إنجليزية,0,0,1,1
10847,webbläsare,0,0,1,1
10849,intercepter,0,0,1,1
10850,والذكية,0,0,1,1
10853,абоненту,0,0,1,1
10854,имел,0,0,1,1
10855,improduktivt.,0,0,1,1
10832,வாழ்க்கையிலும்,0,0,1,1
10827,μεγαλώσετε,0,0,1,1
10858,ನೀನು,0,0,1,1
10813,مقياس,0,0,1,1
10801,είδε,0,0,1,1
10802,പത്ത്,0,0,1,1
10803,लूरी,0,0,1,1
10804,görüyorsunuz.,0,0,1,1
10807,l'artificiel ,0,0,1,1
10809,signifier,0,0,1,1
10812,släktforskare,0,0,1,1
10814,contato.,0,0,1,1
10826,zoekresultaten,0,0,1,1
10815,entraram,0,0,1,1
10818,முடியாவிட்டால்,0,0,1,1
10819,adicionada,0,0,1,1
10821,enlace,0,0,1,1
10822,മൂലം,0,0,1,1
10823,winzigen,0,0,1,1
10825,massives,0,0,1,1
10857,lags,0,0,1,1
10859,feasible,0,0,1,1
10799,accélérée,0,0,1,1
10901,अद्यतन,0,0,1,1
10891,ilegal.,0,0,1,1
10893,verspreiden.,0,0,1,1
10894,créateurs,0,0,1,1
10895,habilidad,0,0,1,1
10896,வழங்கப்போகிறேன்.,0,0,1,1
10898,frequent,0,0,1,1
10900,free-content,0,0,1,1
10905,« a,0,0,1,1
10889,просить,0,0,1,1
10906,morges,0,0,1,1
10908,speaker.,0,0,1,1
10909,individer,0,0,1,1
10910,nedenfor.,0,0,1,1
10912,академик,0,0,1,1
10915,благом,0,0,1,1
10917,yavaşça,0,0,1,1
10890,muñeca,0,0,1,1
10886,பயமாக,0,0,1,1
10860,refleksion,0,0,1,1
10870,tillförlitligheten,0,0,1,1
10861,λόγια,0,0,1,1
10862,såklart,0,0,1,1
10863,временем,0,0,1,1
10865,ലേഖനത്തിനും,0,0,1,1
10866,mönster,0,0,1,1
10868,phrases.,0,0,1,1
10869,μορφή,0,0,1,1
10871,izquierdista,0,0,1,1
10885,ستجده,0,0,1,1
10874,reference.,0,0,1,1
10875,gobbling,0,0,1,1
10877,demostrarse,0,0,1,1
10878,தீவிரமாக,0,0,1,1
10879,мессенджер,0,0,1,1
10880,ಬರುವುದಿಲ್ಲ,0,0,1,1
10881,restored,0,0,1,1
10800,απασχολημένος.,0,0,1,1
10795,yazılanın,0,0,1,1
10673,rigorous,0,0,1,1
10718,publikation,0,0,1,1
10709,mobility.,0,0,1,1
10711,d'impact.,0,0,1,1
10713,products.,0,0,1,1
10714,update,0,0,1,1
10715,proportions,0,0,1,1
10716,увижу,0,0,1,1
10717,ευχάριστο,0,0,1,1
10719,отличная,0,0,1,1
10707,aider.,0,0,1,1
10720,أمرا,0,0,1,1
10724,bots.,0,0,1,1
10725,mötesplats,0,0,1,1
10726,confunde.,0,0,1,1
10727,للذهاب,0,0,1,1
10731,ergo,0,0,1,1
10732,وأعلن,0,0,1,1
10708,തിരുത്തുവാനും,0,0,1,1
10706,perceber,0,0,1,1
10734,தொடர,0,0,1,1
10689,symbolic/knowledge-based,0,0,1,1
10674,arm,0,0,1,1
10675,picture,0,0,1,1
10679,наука,0,0,1,1
10680,والنرويجية,0,0,1,1
10684,repetiam,0,0,1,1
10685,посвящённой,0,0,1,1
10686,wäsche.,0,0,1,1
10691,tajique,0,0,1,1
10701,einzigen,0,0,1,1
10693,വരെ,0,0,1,1
10694,тайно,0,0,1,1
10695,கேட்காதபோது,0,0,1,1
10696,croît,0,0,1,1
10697,essential.,0,0,1,1
10698,الاقتصاد.,0,0,1,1
10700,linjeorganisationens,0,0,1,1
10733,ಪುರುಷರು,0,0,1,1
10735,αμέσως,0,0,1,1
10794,vaticano,0,0,1,1
10781,tane,0,0,1,1
10772,समझाता,0,0,1,1
10773,touristiques.,0,0,1,1
10776,görüşmesinde,0,0,1,1
10777,esbozo.,0,0,1,1
10778,உணவுக்கு,0,0,1,1
10779,выборки.,0,0,1,1
10780,kafanı,0,0,1,1
10783,εξηγήστε,0,0,1,1
10767,ஒரேயளவினதாய்,0,0,1,1
10784,voltaire,0,0,1,1
10785,obscenities,0,0,1,1
10786,स्थायी,0,0,1,1
10788,officielt,0,0,1,1
10791,ακολουθούν,0,0,1,1
10792,lov.,0,0,1,1
10793,والدة,0,0,1,1
10771,التغطية,0,0,1,1
10765,êtes-vous.,0,0,1,1
10740,fréquentation,0,0,1,1
10753,prato,0,0,1,1
10741,réseau ».,0,0,1,1
10742,ಗೊಂಬೆ,0,0,1,1
10744,ಎನ್,0,0,1,1
10745,ಥಂಬ್ಸ್,0,0,1,1
10749,செய்யலாம்,0,0,1,1
10750,buys,0,0,1,1
10751,empoderar,0,0,1,1
10754,paintings.,0,0,1,1
10764,spiegelbild,0,0,1,1
10755,சோம்பலாகவோ,0,0,1,1
10756,stirrede,0,0,1,1
10757,ಸಮಯದಿಂದ,0,0,1,1
10758,экономически,0,0,1,1
10759,الحساسة,0,0,1,1
10760,पड़ता।,0,0,1,1
10763,vallely,0,0,1,1
11407,hoogkwalitatieve,0,0,1,1
11409,أندرو,0,0,1,1
10403,routière,0,0,1,1
11902,stagne,0,0,1,1
12048,احتمالية,0,0,1,1
12050,wedstrijd,0,0,1,1
12051,intimidatorias,0,0,1,1
12052,caractérise ».,0,0,1,1
12053,медленный,0,0,1,1
12054,الانتقادات,0,0,1,1
12055,മന്ദത,0,0,1,1
12057,eklenebilmesine,0,0,1,1
12058,disk,0,0,1,1
12059,تعاونيًا,0,0,1,1
12060,вошла,0,0,1,1
12061,técnicos.,0,0,1,1
12065,professionella,0,0,1,1
12066,திரைப்படங்கள்,0,0,1,1
12067,மறுநாள்,0,0,1,1
12068,ஸ்லாஷ்டாட்,0,0,1,1
12069,ಅದರಿಂದ,0,0,1,1
12046,ಜಾಗದಲ್ಲಿ,0,0,1,1
12044,bilderna,0,0,1,1
12043,discount,0,0,1,1
12031,considerava,0,0,1,1
12020,ahí,0,0,1,1
12022,செயற்படுகிறது.,0,0,1,1
12023,enbomis,0,0,1,1
12025,perguntaram,0,0,1,1
12026,sederna,0,0,1,1
12029,mensageiro,0,0,1,1
12030,സ്വർണ്ണനിറത്തിലായിരുന്നപ്പോൾ,0,0,1,1
12032,редакторских,0,0,1,1
12041,sustainable.,0,0,1,1
12033,ಆಹ್ಲಾದಕರ,0,0,1,1
12034,пародий,0,0,1,1
12036,acknowledged,0,0,1,1
12037,επιχείρηση,0,0,1,1
12038,பணியாற்றியவர்,0,0,1,1
12039,உழைக்க,0,0,1,1
12040,اصطناعي.,0,0,1,1
12070,हास्यपूर्ण,0,0,1,1
12072,авторских,0,0,1,1
12073,вкладчиков,0,0,1,1
12118,تشكيل,0,0,1,1
12108,graça.,0,0,1,1
12109,séparation,0,0,1,1
12111,معًا.,0,0,1,1
12112,εκπληκτική,0,0,1,1
12114,رد,0,0,1,1
12115,ينشئا,0,0,1,1
12117,anglo-cêntrica,0,0,1,1
12119,وشخص,0,0,1,1
12104,niks,0,0,1,1
12120,المعرفة,0,0,1,1
12124,выучили,0,0,1,1
12125,حيرة,0,0,1,1
12126,geuit,0,0,1,1
12127,serve,0,0,1,1
12128,afbryder,0,0,1,1
12129,गर्म,0,0,1,1
12107,sesgadas,0,0,1,1
12103,wikipediocracy,0,0,1,1
12074,نقل,0,0,1,1
12088,البذاءة,0,0,1,1
12076,tpr,0,0,1,1
12077,телеграмму,0,0,1,1
12078,macha,0,0,1,1
12079,troepen,0,0,1,1
12080,μέρος.,0,0,1,1
12082,nærheden,0,0,1,1
12085,ബ്യൂറോക്രാറ്റുകൾ.,0,0,1,1
12091,ഉപേക്ഷിച്ചിട്ടുണ്ടെങ്കിൽ,0,0,1,1
12102,unmanned,0,0,1,1
12092,aprendido,0,0,1,1
12095,വിവരത്തെ,0,0,1,1
12096,linéaire,0,0,1,1
12097,stan.,0,0,1,1
12098,لطيفان,0,0,1,1
12099,എല്ലാവരേയും,0,0,1,1
12100,silinebilir.,0,0,1,1
12019,diyebilirsiniz.,0,0,1,1
12017,below.,0,0,1,1
12013,للمجتمع,0,0,1,1
11943,spam.,0,0,1,1
11933,पिज्जा,0,0,1,1
11934,χαμογελάσει,0,0,1,1
11935,intitulé,0,0,1,1
11939,ചേർന്ന്,0,0,1,1
11940,உதவிக்காக,0,0,1,1
11941,वास्तुकला,0,0,1,1
11942,வெளியேறினேன்,0,0,1,1
11944,വരുത്തുക,0,0,1,1
11931,modstridende,0,0,1,1
11945,ನಲ್ಲಿದ್ದೇನೆ,0,0,1,1
11946,sprechen.,0,0,1,1
11948,celestial,0,0,1,1
11949,ആയിരുന്നോ,0,0,1,1
11950,மோசமானது,0,0,1,1
11952,president-directeur,0,0,1,1
11953,கேள்வியைத்,0,0,1,1
11932,сайтов,0,0,1,1
11930,заключенные,0,0,1,1
11957,εκλεπτυσμένη.,0,0,1,1
11914,ദയാലുവാണ്.,0,0,1,1
11904,நிதி,0,0,1,1
11907,propiedad,0,0,1,1
11909,википедияудализм,0,0,1,1
11910,anglais ,0,0,1,1
11911,géomagnétique[réf.,0,0,1,1
11912,alison,0,0,1,1
11913,вандализирующими,0,0,1,1
11919,apparaten,0,0,1,1
11929,est-elle,0,0,1,1
11920,هنري,0,0,1,1
11921,للمجتمع،,0,0,1,1
11922,biologists.,0,0,1,1
11923,तेलुगू,0,0,1,1
11926,الحق,0,0,1,1
11927,appuyant,0,0,1,1
11928,ഒരാൾ,0,0,1,1
11956,divisée,0,0,1,1
11958,ಮೊದಲಿಗೆ,0,0,1,1
12012,१५००००,0,0,1,1
11999,ഒരുവീട്ടമ്മ,0,0,1,1
11987,veckotidskrift,0,0,1,1
11988,ರಹಸ್ಯವನ್ನು,0,0,1,1
11989,ಪಡೆಯುವವರೆಗೂ,0,0,1,1
11990,romeno,0,0,1,1
11992,conquistas,0,0,1,1
11993,eclat,0,0,1,1
11994,الشأن.,0,0,1,1
12000,pueblo,0,0,1,1
11985,δουλεύεις,0,0,1,1
12001,оксфордского,0,0,1,1
12003,consultable,0,0,1,1
12005,campaign,0,0,1,1
12006,frightening.,0,0,1,1
12007,τηλέφωνό,0,0,1,1
12008,klibinde,0,0,1,1
12011,quejas,0,0,1,1
11986,televisão,0,0,1,1
11983,échappent[réf.,0,0,1,1
11959,side-to-side,0,0,1,1
11969,проделал,0,0,1,1
11961,झांका।,0,0,1,1
11962,wir',0,0,1,1
11963,μάθηση,0,0,1,1
11964,بنفسك.,0,0,1,1
11966,συναρπαστικό,0,0,1,1
11967,yiyeceklerden,0,0,1,1
11968,событиях,0,0,1,1
11970,ಮನಸ್ಸು,0,0,1,1
11981,कर-मुक्त,0,0,1,1
11972,faria,0,0,1,1
11973,ഇല്ല[അവലംബം,0,0,1,1
11974,रॉय,0,0,1,1
11975,найдете,0,0,1,1
11976,وصبر,0,0,1,1
11979,التوثيق,0,0,1,1
11980,состоит,0,0,1,1
12132,güzelliğinden,0,0,1,1
12133,væsener,0,0,1,1
12134,περίπτωση,0,0,1,1
12287,оптимизации,0,0,1,1
12273,kwaliteit.,0,0,1,1
12277,der.,0,0,1,1
12279,datorer,0,0,1,1
12280,skriva/redigera,0,0,1,1
12281,ഉപയോഗിച്ചുകൊണ്ട്,0,0,1,1
12283,जताई।,0,0,1,1
12285,استعداد,0,0,1,1
12288,низкокачественные,0,0,1,1
12271,actualiser,0,0,1,1
12289,descrevendo-o,0,0,1,1
12293,συντάκτες,0,0,1,1
12294,åtta,0,0,1,1
12297,güisquipedia,0,0,1,1
12299,.a,0,0,1,1
12300,anlıyorum,0,0,1,1
12301,understood.,0,0,1,1
12272,حولها.,0,0,1,1
12270,tends,0,0,1,1
12304,composta,0,0,1,1
12256,tegenovergestelde,0,0,1,1
12246,മീറ്റിംഗ്,0,0,1,1
12248,assembled,0,0,1,1
12250,lättåtkomliga,0,0,1,1
12251,पकड़ने,0,0,1,1
12252,brief,0,0,1,1
12253,ಮಾತನಾಡಬಲ್ಲಿರಾ,0,0,1,1
12255,understand.,0,0,1,1
12257,चिह्न,0,0,1,1
12267,വെച്ച്,0,0,1,1
12258,lächeln,0,0,1,1
12259,തോന്നുന്നു,0,0,1,1
12260,strunta,0,0,1,1
12262,organisaties,0,0,1,1
12263,ಹಂತವನ್ನು,0,0,1,1
12265,[en,0,0,1,1
12266,molecule,0,0,1,1
12302,выяснила,0,0,1,1
12306,connue.,0,0,1,1
12244,especifica,0,0,1,1
12361,sædvanlige.,0,0,1,1
12350,licensen,0,0,1,1
12351,колокольчика,0,0,1,1
12352,ère,0,0,1,1
12354,أستمر,0,0,1,1
12357,nutshell,0,0,1,1
12358,testen,0,0,1,1
12360,tercümelerine,0,0,1,1
12363,demographic,0,0,1,1
12347,fixés,0,0,1,1
12365,discussieforum,0,0,1,1
12366,ಅಥವಾ.,0,0,1,1
12368,tectoniques,0,0,1,1
12369,такая,0,0,1,1
12372,condemns,0,0,1,1
12376,подписки,0,0,1,1
12377,«писать/править,0,0,1,1
12349,revolution,0,0,1,1
12346,ಸಂಜೆ,0,0,1,1
12307,business.,0,0,1,1
12321,ಹೇಳುವುದು.,0,0,1,1
12308,aceptación,0,0,1,1
12309,høflig,0,0,1,1
12314,vitesse,0,0,1,1
12316,അല്ല,0,0,1,1
12317,reparere,0,0,1,1
12319,phrased,0,0,1,1
12320,humanidade.,0,0,1,1
12325,alexa'ya,0,0,1,1
12343,s'améliorait,0,0,1,1
12326,பங்களிப்பின்,0,0,1,1
12327,mobilisent,0,0,1,1
12328,émergente,0,0,1,1
12329,geldiğinizi,0,0,1,1
12339,ആർതർ,0,0,1,1
12341,prenais,0,0,1,1
12342,αποτυχίες,0,0,1,1
12245,identificaba,0,0,1,1
12242,absurdas.,0,0,1,1
12135,exportar,0,0,1,1
12171,sortuda,0,0,1,1
12163,انتهي.,0,0,1,1
12164,लातवियाई,0,0,1,1
12165,तथा,0,0,1,1
12166,arrêté,0,0,1,1
12168,irmos,0,0,1,1
12169,ende,0,0,1,1
12170,تيرنس,0,0,1,1
12172,onlardan,0,0,1,1
12161,സമ്മതിക്കുന്നുവെന്ന്,0,0,1,1
12174,λεκτικό,0,0,1,1
12176,abaixo.,0,0,1,1
12178,„википедию“ ,0,0,1,1
12180,acheter,0,0,1,1
12181,പിന്നിലെ,0,0,1,1
12182,हास्यास्पद,0,0,1,1
12184,load-balancing,0,0,1,1
12162,réglementant,0,0,1,1
12160,müzik,0,0,1,1
12186,सटीक,0,0,1,1
12149,anglosajón.,0,0,1,1
12139,medicinal,0,0,1,1
12140,καλής,0,0,1,1
12142,adaptive,0,0,1,1
12143,важными,0,0,1,1
12144,omitted,0,0,1,1
12146,değişik,0,0,1,1
12148,picante,0,0,1,1
12150,vagn,0,0,1,1
12159,lachend,0,0,1,1
12151,erronée,0,0,1,1
12152,involved,0,0,1,1
12153,comigo.,0,0,1,1
12154,artikelhistorik,0,0,1,1
12156,dağıtım,0,0,1,1
12157,та,0,0,1,1
12158,th-most-visited,0,0,1,1
12185,फ्राई,0,0,1,1
12187,mevcut,0,0,1,1
12241,റൂമിലേക്ക്,0,0,1,1
12229,hearing.,0,0,1,1
12221,identificação.,0,0,1,1
12222,nós',0,0,1,1
12223,studerar,0,0,1,1
12224,شكل,0,0,1,1
12226,comemora,0,0,1,1
12227,construcción»,0,0,1,1
12228,μαθηματικό,0,0,1,1
12230,criarlos,0,0,1,1
12219,ഉപയോഗിക്കാം,0,0,1,1
12231,स्ट्रिप,0,0,1,1
12233,कारणों,0,0,1,1
12234,സ്ക്കൂൾ,0,0,1,1
12235,irs,0,0,1,1
12236,hong,0,0,1,1
12238,sönder,0,0,1,1
12239,விக்கியை,0,0,1,1
12220,हमला,0,0,1,1
12217,मिलन,0,0,1,1
12188,sérieux,0,0,1,1
12199,எப்படியிருந்தாலும்,0,0,1,1
12189,എടുത്ത,0,0,1,1
12190,இதுவரை,0,0,1,1
12191,d'autant,0,0,1,1
12192,knapp,0,0,1,1
12193,tilfældigvis,0,0,1,1
12196,വരുമെന്നും,0,0,1,1
12197,succinct,0,0,1,1
12202,wikipediagemeenschap,0,0,1,1
12216,வீடியோவை,0,0,1,1
12203,состоящих,0,0,1,1
12206,кажется,0,0,1,1
12207,darnos,0,0,1,1
12209,opmaak,0,0,1,1
12212,introduces,0,0,1,1
12214,ഭക്ഷ്യയോഗ്യമല്ലാത്ത,0,0,1,1
12215,والتشخيص,0,0,1,1
11903,intressant,0,0,1,1
11899,joaquín,0,0,1,1
11410,запросы,0,0,1,1
11898,pænt,0,0,1,1
11568,s'amuse,0,0,1,1
11569,klaarmaken,0,0,1,1
11570,قوانين,0,0,1,1
11571,volvería,0,0,1,1
11574,هدية,0,0,1,1
11575,ಹೊಂದಿರಬೇಕು,0,0,1,1
11576,dismissed,0,0,1,1
11577,ursäkta,0,0,1,1
11578,intrinsically,0,0,1,1
11582,depleting,0,0,1,1
11583,ignorant,0,0,1,1
11585,kloonwebsites,0,0,1,1
11586,bat.,0,0,1,1
11587,خاصة,0,0,1,1
11588,asemejan,0,0,1,1
11589,bristfällig,0,0,1,1
11590,änderte,0,0,1,1
11567,telefoneren,0,0,1,1
11566,fastslog,0,0,1,1
11563,usædvanligt,0,0,1,1
11548,jolie,0,0,1,1
11537,википедию.,0,0,1,1
11538,λέγοντας,0,0,1,1
11540,ಮಾಡಲ್ಪಟ್ಟನು.,0,0,1,1
11542,субботних,0,0,1,1
11543,ಬೆಲ್,0,0,1,1
11544,متخصصين،,0,0,1,1
11547,extensa »,0,0,1,1
11550,ಮುಂದುವರಿಸಿ,0,0,1,1
11562,portals,0,0,1,1
11551,liberal,0,0,1,1
11554,evolucionando,0,0,1,1
11555,verstehe,0,0,1,1
11556,ಮಾಡಬೇಕಾದದ್ದು.,0,0,1,1
11557,एनसिक्लोपेडिया,0,0,1,1
11558,geautomatiseerde,0,0,1,1
11559,beings.,0,0,1,1
11592,« socio-technique »,0,0,1,1
11593,ತೊಂದರೆಯುಂಟುಮಾಡುವ,0,0,1,1
11594,edersen,0,0,1,1
11641,stemmetone,0,0,1,1
11631,revise,0,0,1,1
11632,officiella,0,0,1,1
11633,« comme,0,0,1,1
11635,фильмов,0,0,1,1
11636,kökenine,0,0,1,1
11637,delats,0,0,1,1
11638,l'endroit,0,0,1,1
11642,ಗಂಭೀರವಾದ,0,0,1,1
11624,morimos,0,0,1,1
11643,ಅನುಭವವಿಲ್ಲದೆ,0,0,1,1
11644,rapide.,0,0,1,1
11649,पेशकश,0,0,1,1
11651,اللذيذ,0,0,1,1
11652,beroepsschrijvers,0,0,1,1
11653,stage.,0,0,1,1
11654,رحلتهم,0,0,1,1
11630,ഇഫക്റ്റ്,0,0,1,1
11621,വിലയിരുത്തൽ,0,0,1,1
11595,في.,0,0,1,1
11606,”smaklöst”.,0,0,1,1
11597,вклады,0,0,1,1
11598,notoires,0,0,1,1
11599,reflexo,0,0,1,1
11602,harika.,0,0,1,1
11603,türden,0,0,1,1
11604,creo.,0,0,1,1
11605,badstof.,0,0,1,1
11607,bake,0,0,1,1
11618,bardakçı,0,0,1,1
11609,выходные.,0,0,1,1
11610,получили,0,0,1,1
11611,potatis,0,0,1,1
11612,आँसुओं,0,0,1,1
11614,versies,0,0,1,1
11615,ethvert,0,0,1,1
11617,upphovspersonerna,0,0,1,1
11536,tıklayarak,0,0,1,1
11535,старые,0,0,1,1
11534,للناس,0,0,1,1
11452,durdurabilir,0,0,1,1
11445,ακούσω,0,0,1,1
11446,tereddüt.,0,0,1,1
11447,yaparak,0,0,1,1
11448,പോകാമെന്ന്,0,0,1,1
11449,поздравить,0,0,1,1
11450,σέρνουν,0,0,1,1
11451,अणुओं,0,0,1,1
11454,ശ്രദ്ധിച്ചില്ല,0,0,1,1
11442,reverses,0,0,1,1
11457,треть,0,0,1,1
11458,делаются,0,0,1,1
11460,editá-los,0,0,1,1
11461,web ,0,0,1,1
11462,कहेंगे,0,0,1,1
11463,தொடக்கத்திற்குப்,0,0,1,1
11464,θυελλώδη,0,0,1,1
11443,тобой.,0,0,1,1
11440,verständnisvoller,0,0,1,1
11468,matériels,0,0,1,1
11426,οποιεσδήποτε,0,0,1,1
11414,ಬೆಳೆಸಲು,0,0,1,1
11415,personagem,0,0,1,1
11416,différences,0,0,1,1
11418,ತೊಂದರೆಗೊಳಿಸುವುದಕ್ಕೆ,0,0,1,1
11420,உள்ளீர்கள்,0,0,1,1
11422,announcement,0,0,1,1
11425,ligar,0,0,1,1
11427,المال؟,0,0,1,1
11439,fixed,0,0,1,1
11428,ಒತ್ತುವ,0,0,1,1
11429,vivent.,0,0,1,1
11431,zamandır.,0,0,1,1
11433,സഹായകരമാണോ,0,0,1,1
11435,साधारण,0,0,1,1
11436,ontsluiten.,0,0,1,1
11437,hayali,0,0,1,1
11467,sunulmalıdır.,0,0,1,1
11469,mata,0,0,1,1
11531,ചെയ്യരുത്,0,0,1,1
11510,söyleyebilirim,0,0,1,1
11502,القدرة,0,0,1,1
11503,изданы,0,0,1,1
11504,permitiria,0,0,1,1
11505,потрясающе.,0,0,1,1
11506,accepter,0,0,1,1
11507,secundárias,0,0,1,1
11508,രത്നങ്ങളിലും,0,0,1,1
11512,απέρριψε,0,0,1,1
11500,τυχαίνει,0,0,1,1
11518,là-dessus,0,0,1,1
11519,vereiste,0,0,1,1
11525,locaux,0,0,1,1
11526,​​till,0,0,1,1
11527,голоса,0,0,1,1
11528,ആശയക്കുഴപ്പത്തിലാക്കുക,0,0,1,1
11529,बँधा,0,0,1,1
11501,sağ,0,0,1,1
11499,பெற்றுக்,0,0,1,1
11470,contienen.,0,0,1,1
11485,tabiki.,0,0,1,1
11472,ഗുണമേന്മയുള്ള,0,0,1,1
11473,occasion,0,0,1,1
11474,सूचित,0,0,1,1
11477,pair,0,0,1,1
11478,correctoras,0,0,1,1
11479,php.,0,0,1,1
11480,nederlandse,0,0,1,1
11486,tes,0,0,1,1
11498,سر.,0,0,1,1
11487,didier,0,0,1,1
11488,مؤكدة،,0,0,1,1
11490,υπομονετικά,0,0,1,1
11491,anlat,0,0,1,1
11495,defensores,0,0,1,1
11496,பெரிதாக,0,0,1,1
11497,المجتمع،,0,0,1,1
11655,редакционную,0,0,1,1
11656,एम्स्टरडाम,0,0,1,1
11658,empiriques,0,0,1,1
11825,மிகப்பெரும்,0,0,1,1
11812,genre.,0,0,1,1
11813,« gauchiste » »,0,0,1,1
11814,ಹೆಜ್ಜೆ,0,0,1,1
11815,уроке.,0,0,1,1
11816,umarım,0,0,1,1
11818,oublie.,0,0,1,1
11823,främsta,0,0,1,1
11827,സത്യസന്ധമായി,0,0,1,1
11810,sende,0,0,1,1
11828,ಹೊರತುಪಡಿಸಿ,0,0,1,1
11829,öğleden,0,0,1,1
11831,plastic,0,0,1,1
11832,ஆச்சரியப்பட்டாள்.,0,0,1,1
11833,leçon,0,0,1,1
11834,parentes,0,0,1,1
11836,olsa,0,0,1,1
11811,വിഷമിപ്പിക്കരുതെന്ന്,0,0,1,1
11809,recomenda,0,0,1,1
11838,atemberaubend,0,0,1,1
11793,استوحت,0,0,1,1
11785,account.,0,0,1,1
11786,எல்லோருக்கும்,0,0,1,1
11787,карьере»,0,0,1,1
11788,بهذه,0,0,1,1
11789,الطبي,0,0,1,1
11791,editar»,0,0,1,1
11792,agência,0,0,1,1
11796,இருப்பதைக்,0,0,1,1
11808,wait.,0,0,1,1
11798,saborosa,0,0,1,1
11799,داخلية.,0,0,1,1
11801,spiken,0,0,1,1
11803,ഫലത്തിലെത്താൻ,0,0,1,1
11804,overal,0,0,1,1
11806,sostenida,0,0,1,1
11807,προσβολή,0,0,1,1
11837,osaklig,0,0,1,1
11840,परियोजनाएं,0,0,1,1
11782,tonto.,0,0,1,1
11885,setzen.,0,0,1,1
11875,apagados,0,0,1,1
11879,istisnalar,0,0,1,1
11880,contribuyentes».,0,0,1,1
11881,ಸಂದರ್ಶನವೊಂದರಲ್ಲಿ,0,0,1,1
11882,directa.,0,0,1,1
11883,неуклонно,0,0,1,1
11884,fouille,0,0,1,1
11886,infoga,0,0,1,1
11873,privilegier,0,0,1,1
11887,வைக்கும்,0,0,1,1
11889,имела,0,0,1,1
11890,bilmediği,0,0,1,1
11891,matriz,0,0,1,1
11893,ashton,0,0,1,1
11896,récente.,0,0,1,1
11897,essenciais,0,0,1,1
11874,நிலமானது,0,0,1,1
11871,veckor,0,0,1,1
11842,remanescentes,0,0,1,1
11856,extinción,0,0,1,1
11844,resolution.,0,0,1,1
11847,operava,0,0,1,1
11848,программному,0,0,1,1
11849,episk,0,0,1,1
11850,exposure,0,0,1,1
11853,concordar,0,0,1,1
11854,مبتسمين,0,0,1,1
11859,nosotros',0,0,1,1
11870,ಅನುಮಾನಕ್ಕೆ,0,0,1,1
11860,verenigde,0,0,1,1
11861,gebrochenem,0,0,1,1
11862,ಪ್ರಕಾರಕ್ಕಿಂತ,0,0,1,1
11866,अनुदान,0,0,1,1
11867,﻿.°n,0,0,1,1
11868,avsaknad,0,0,1,1
11869,edebilirler.,0,0,1,1
11783,aşağıya,0,0,1,1
11781,tópico.,0,0,1,1
11660,организацию».,0,0,1,1
11701,begynde,0,0,1,1
11692,lived,0,0,1,1
11693,peña,0,0,1,1
11694,essentia,0,0,1,1
11695,अन्तर्राष्ट्रीय,0,0,1,1
11696,سترى,0,0,1,1
11699,даниэлем,0,0,1,1
11700,கணிப்பதில்,0,0,1,1
11703,mécaniques,0,0,1,1
11689,εγγενείς,0,0,1,1
11705,cohérence,0,0,1,1
11706,respecto.,0,0,1,1
11707,heleboel,0,0,1,1
11708,amical,0,0,1,1
11711,сэнгера,0,0,1,1
11712,titlen,0,0,1,1
11715,أصول,0,0,1,1
11691,कीजिय,0,0,1,1
11688,temporary,0,0,1,1
11718,çiviyi,0,0,1,1
11674,görüyorum,0,0,1,1
11661,கலைக்களஞ்சியத்,0,0,1,1
11663,konnte.,0,0,1,1
11664,வேலைக்காரிகள்,0,0,1,1
11665,distinctifs,0,0,1,1
11670,бизнес,0,0,1,1
11671,вялыми,0,0,1,1
11672,repose,0,0,1,1
11675,fehler.,0,0,1,1
11687,oceanography.,0,0,1,1
11676,разговоре,0,0,1,1
11678,archipelagos,0,0,1,1
11679,неточными,0,0,1,1
11681,വിലമതിക്കുന്നില്ല,0,0,1,1
11684,تكونا,0,0,1,1
11685,yazdıklarının,0,0,1,1
11686,فيولا,0,0,1,1
11716,medeniyeti'nde,0,0,1,1
11719,കേരള,0,0,1,1
11780,प्रबल,0,0,1,1
11767,нашем,0,0,1,1
11759,isteğinde,0,0,1,1
11761,والمواقع,0,0,1,1
11762,«wikipedistas»,0,0,1,1
11763,non-compliant,0,0,1,1
11764,அழைப்பாளருக்கோ,0,0,1,1
11765,évolutif,0,0,1,1
11766,लिखित,0,0,1,1
11768,drømmen,0,0,1,1
11757,πρώτος,0,0,1,1
11769,வேலையுடன்,0,0,1,1
11770,radicalement,0,0,1,1
11772,χρειάζομαι,0,0,1,1
11773,تكتب,0,0,1,1
11774,aboutir,0,0,1,1
11777,επαναλάβεις.,0,0,1,1
11779,fundamentalt,0,0,1,1
11758,αγγελιοφόρου,0,0,1,1
11756,सेवाओ,0,0,1,1
11720,gymnasieelever,0,0,1,1
11737,síntomas.,0,0,1,1
11721,إنسايدر,0,0,1,1
11722,mathebuch,0,0,1,1
11724,செய்தார்கள்,0,0,1,1
11725,ನೆಡಲು,0,0,1,1
11731,volapuque,0,0,1,1
11732,لطفاء,0,0,1,1
11734,atribuyen,0,0,1,1
11741,समारोह,0,0,1,1
11754,ശാസ്ത്രജ്ഞന്മാർ,0,0,1,1
11742,മാനദണ്ഡങ്ങളെ,0,0,1,1
11743,días,0,0,1,1
11746,продвижения,0,0,1,1
11747,metoderna,0,0,1,1
11748,hvordan',0,0,1,1
11749,الحيرة,0,0,1,1
11750,ഗ്രന്ഥങ്ങളും,0,0,1,1
10404,público.,0,0,1,1
10402,an ,0,0,1,1
12379,угрозами,0,0,1,1
8911,factuais,0,0,1,1
9064,manquant.,0,0,1,1
9065,fille.,0,0,1,1
9066,мобильным,0,0,1,1
9067,ഉൾ‍ക്കൊള്ളുന്നു.,0,0,1,1
9068,entidades,0,0,1,1
9069,ومشتق,0,0,1,1
9070,ലഭിക്കും,0,0,1,1
9071,क्रियोल,0,0,1,1
9072,peinture,0,0,1,1
9073,gittiğinde,0,0,1,1
9074,desinformar,0,0,1,1
9075,våra,0,0,1,1
9077,bedeutung.,0,0,1,1
9079,iemand.,0,0,1,1
9080,herrera,0,0,1,1
9081,self-sustaining,0,0,1,1
9082,obligada,0,0,1,1
9063,സമൂഹത്തെ,0,0,1,1
9061,bekymmer,0,0,1,1
9060,σχέδιο,0,0,1,1
9043,inovação,0,0,1,1
9030,passando,0,0,1,1
9031,നിരൂപണങ്ങൾ,0,0,1,1
9034,ತೊಂದರೆಯಿಲ್ಲದ,0,0,1,1
9038,exclusivity,0,0,1,1
9039,comprarte,0,0,1,1
9040,என்பதோடு,0,0,1,1
9041,व्यंग्य,0,0,1,1
9046,finite,0,0,1,1
9058,σ,0,0,1,1
9047,اجتازت,0,0,1,1
9048,маленькой,0,0,1,1
9049,nämns,0,0,1,1
9050,hvornår,0,0,1,1
9051,personalized,0,0,1,1
9052,upptäckt.,0,0,1,1
9057,façam.,0,0,1,1
9086,saúde,0,0,1,1
9088,लव,0,0,1,1
9092,yapacaklarını,0,0,1,1
9140,science ».,0,0,1,1
9128,latín,0,0,1,1
9129,espelho,0,0,1,1
9130,ağlamak,0,0,1,1
9133,traditioner,0,0,1,1
9134,växer,0,0,1,1
9137,κόρη.,0,0,1,1
9138,förekommande,0,0,1,1
9141,присутствовать,0,0,1,1
9126,يهدف,0,0,1,1
9142,connectionist,0,0,1,1
9144,anatomy,0,0,1,1
9145,emenda,0,0,1,1
9146,придерживаясь,0,0,1,1
9147,вредительское,0,0,1,1
9148,деятельности,0,0,1,1
9151,പ്രവേശിച്ചുവെങ്കിൽ,0,0,1,1
9127,estávamos.,0,0,1,1
9125,algoritmico.,0,0,1,1
9093,ಪ್ರಯತ್ನಿಸುವಾಗ,0,0,1,1
9108,frø,0,0,1,1
9094,مدققو,0,0,1,1
9095,operado,0,0,1,1
9096,ангелом,0,0,1,1
9098,ಬೈಟ್,0,0,1,1
9101,ಹೆಬ್ಬೆರಳು,0,0,1,1
9104,« google »,0,0,1,1
9105,dagen.,0,0,1,1
9113,excluíu,0,0,1,1
9124,laissent,0,0,1,1
9114,предотвращения,0,0,1,1
9115,protest,0,0,1,1
9116,databasen,0,0,1,1
9117,produits.,0,0,1,1
9118,confirmaba,0,0,1,1
9120,чертой,0,0,1,1
9122,εγκυκλοπαίδειες.,0,0,1,1
9029,basándose,0,0,1,1
9027,loveland,0,0,1,1
9026,permitting,0,0,1,1
8957,comestible,0,0,1,1
8948,kött,0,0,1,1
8949,ஐஸ்கிரீம்,0,0,1,1
8951,கட்டுரைகளான,0,0,1,1
8953,banklånet,0,0,1,1
8954,restrições,0,0,1,1
8955,vandálicos,0,0,1,1
8956,വേറൊരു,0,0,1,1
8958,moles,0,0,1,1
8941,സഹായിക്കാമോ,0,0,1,1
8959,donald,0,0,1,1
8960,ناقصا,0,0,1,1
8961,goals.,0,0,1,1
8962,mariée,0,0,1,1
8963,فهناك,0,0,1,1
8965,cooperación.,0,0,1,1
8966,സ്പീക്കർ,0,0,1,1
8945,mostraba,0,0,1,1
8940,heiraten,0,0,1,1
8969,vim,0,0,1,1
8927,gfdl ,0,0,1,1
8913,പറയിപെറ്റ,0,0,1,1
8915,ming,0,0,1,1
8916,எவராலும்,0,0,1,1
8921,meters,0,0,1,1
8923,читателей,0,0,1,1
8924,подбодрить,0,0,1,1
8925,kopf,0,0,1,1
8928,يتفق,0,0,1,1
8937,कॉमस्कोर,0,0,1,1
8929,доктриной,0,0,1,1
8930,japonaise,0,0,1,1
8931,горем,0,0,1,1
8932,തുടരുക,0,0,1,1
8933,rundt,0,0,1,1
8934,польском,0,0,1,1
8936,скомпрометировать,0,0,1,1
8967,ज़रूर,0,0,1,1
8971,cite,0,0,1,1
9024,parlons,0,0,1,1
9014,وتمت,0,0,1,1
9002,للمخربين,0,0,1,1
9003,إستوحت,0,0,1,1
9004,പുതുമുഖങ്ങൾക്ക്,0,0,1,1
9006,bitten.,0,0,1,1
9007,പറയുന്ന,0,0,1,1
9008,vardır,0,0,1,1
9009,favorecer,0,0,1,1
9015,parameters,0,0,1,1
8998,ഇടയിൽ,0,0,1,1
9016,الأصليون,0,0,1,1
9017,deemed,0,0,1,1
9019,πηγής,0,0,1,1
9020,gong.,0,0,1,1
9021,beroemde,0,0,1,1
9022,afectados,0,0,1,1
9023,ತುದಿ,0,0,1,1
9000,vetenskaplig,0,0,1,1
8996,energy-drink,0,0,1,1
8972,chile,0,0,1,1
8984,समय।,0,0,1,1
8973,случаю,0,0,1,1
8975,എന്നതിനെക്കുറിച്ചും.,0,0,1,1
8977,décerné,0,0,1,1
8978,irão,0,0,1,1
8981,papel,0,0,1,1
8982,вкуса.,0,0,1,1
8983,मुस्कुराने,0,0,1,1
8985,zorunluluğu,0,0,1,1
8995,mathematically,0,0,1,1
8986,γνώριζε,0,0,1,1
8987,resor,0,0,1,1
8989,arkadaşı,0,0,1,1
8990,സ്വീകരിക്കുക.,0,0,1,1
8991,στρατιώτες,0,0,1,1
8993,«интервики»-ссылки,0,0,1,1
8994,நுபீடியாவிற்கும்,0,0,1,1
9153,vinod,0,0,1,1
9154,путешествовала,0,0,1,1
9155,ögon,0,0,1,1
9324,ಒಬ್ಬರನ್ನೊಬ್ಬರು,0,0,1,1
9314,கலைக்களஞ்சியத்தை,0,0,1,1
9316,grego,0,0,1,1
9317,языковыми,0,0,1,1
9318,венгерские,0,0,1,1
9321,licensors,0,0,1,1
9322,ചോദിക്കുന്നു,0,0,1,1
9323,правительственных,0,0,1,1
9325,addresses,0,0,1,1
9310,கிளிக்,0,0,1,1
9326,pleasure,0,0,1,1
9327,لتربيهم,0,0,1,1
9331,bell,0,0,1,1
9332,യന്ത്രപഠനത്തിനു,0,0,1,1
9335,ordforråd.,0,0,1,1
9336,ثري,0,0,1,1
9337,φυσικά.,0,0,1,1
9311,zamanım,0,0,1,1
9309,இயலாது,0,0,1,1
9342,escuches,0,0,1,1
9290,og.,0,0,1,1
9280,quotidien,0,0,1,1
9281,துவக்கல்,0,0,1,1
9282,historiska,0,0,1,1
9283,وسيأتي,0,0,1,1
9286,mantuvo,0,0,1,1
9288,குழப்புவது.,0,0,1,1
9289,uttal [vɪkɪ'peːdɪa],0,0,1,1
9291,واحدة.,0,0,1,1
9306,அழுத்திப்,0,0,1,1
9293,позицию,0,0,1,1
9295,വരുത്തി,0,0,1,1
9296,तिब्बती,0,0,1,1
9298,gpus,0,0,1,1
9300,columnist,0,0,1,1
9304,l'électricité,0,0,1,1
9305,obtuvo,0,0,1,1
9338,teori,0,0,1,1
9343,psalms,0,0,1,1
9277,euros,0,0,1,1
9380,लिंग,0,0,1,1
9372,snowball,0,0,1,1
9374,इलाज,0,0,1,1
9375,stykker,0,0,1,1
9376,özrümü,0,0,1,1
9377,ಅಳುತ್ತಿದ್ದೀರಿ,0,0,1,1
9378,estabilizado,0,0,1,1
9379,sağlar.,0,0,1,1
9382,« éviter,0,0,1,1
9370,individualiste.,0,0,1,1
9383,γεννηθεί,0,0,1,1
9384,silabarios,0,0,1,1
9385,விஷயத்தில்,0,0,1,1
9387,اجتماع.,0,0,1,1
9388,documento,0,0,1,1
9391,للتماسك،,0,0,1,1
9392,católico,0,0,1,1
9371,strider,0,0,1,1
9369,обслужены,0,0,1,1
9344,बॉक्स,0,0,1,1
9357,viaje.,0,0,1,1
9346,έπαιρνα,0,0,1,1
9347,suffit,0,0,1,1
9349,ವಾರಾಂತ್ಯದ,0,0,1,1
9350,gerektiği,0,0,1,1
9353,edilmiştir.,0,0,1,1
9355,notability.,0,0,1,1
9356,बीजों,0,0,1,1
9358,pede,0,0,1,1
9368,എഴുതുന്നത്‌.,0,0,1,1
9359,katıldığımdan,0,0,1,1
9360,نفسه,0,0,1,1
9361,отправлять,0,0,1,1
9362,caso.,0,0,1,1
9363,använt.,0,0,1,1
9365,d'en,0,0,1,1
9366,hyperlinks.,0,0,1,1
9279,डाउन,0,0,1,1
9276,ölüyorum,0,0,1,1
9156,श्रृंखला,0,0,1,1
9194,ரீதியில்,0,0,1,1
9186,fizera,0,0,1,1
9187,decimotercer,0,0,1,1
9188,listada,0,0,1,1
9189,écologique.,0,0,1,1
9190,ടോഫൽ,0,0,1,1
9192,formuleerde,0,0,1,1
9193,пояснении,0,0,1,1
9195,எடுத்துக்கொண்டது,0,0,1,1
9184,സ്വപ്നത്തെക്കുറിച്ച്,0,0,1,1
9197,and/or,0,0,1,1
9198,மனித,0,0,1,1
9199,കാലെടുത്തുവച്ചാൽ,0,0,1,1
9201,зверский,0,0,1,1
9204,visions,0,0,1,1
9205,எங்களுடன்,0,0,1,1
9209,efterladt,0,0,1,1
9185,otlet,0,0,1,1
9182,തടവുകാരെ,0,0,1,1
9214,النباتات,0,0,1,1
9166,arka,0,0,1,1
9157,طويلًا,0,0,1,1
9159,datats,0,0,1,1
9160,எதையும்,0,0,1,1
9161,personas​​,0,0,1,1
9162,demandez.,0,0,1,1
9163,solicitud.,0,0,1,1
9164,ماريون,0,0,1,1
9168,article-creating,0,0,1,1
9181,etmez.,0,0,1,1
9169,корневые,0,0,1,1
9171,متحيزة،,0,0,1,1
9172,forbid,0,0,1,1
9173,sudden,0,0,1,1
9174,meistens,0,0,1,1
9175,stavefejl,0,0,1,1
9178,версиях.,0,0,1,1
9210,விஞ்சி,0,0,1,1
9216,ಆಘಾತಕ್ಕೊಳಗಾಗಿದ್ದಳು.,0,0,1,1
9274,acrecentando,0,0,1,1
9262,geheimzinnigs,0,0,1,1
9249,convertir,0,0,1,1
9250,wort.,0,0,1,1
9251,aktuella,0,0,1,1
9257,സങ്കീർണ്ണമായ,0,0,1,1
9258,étape,0,0,1,1
9259,hususlar,0,0,1,1
9260,fraile,0,0,1,1
9263,mannen.,0,0,1,1
9245,delstaten,0,0,1,1
9264,матери-нарциссе,0,0,1,1
9266,увеличения,0,0,1,1
9267,emotion,0,0,1,1
9268,cassation,0,0,1,1
9270,susceptibilidad,0,0,1,1
9272,achte,0,0,1,1
9273,sientes,0,0,1,1
9247,vengera,0,0,1,1
9242,cómo.,0,0,1,1
9217,интеллектуальным,0,0,1,1
9226,quejarse,0,0,1,1
9218,универсальной,0,0,1,1
9219,vandalizando,0,0,1,1
9221,restaurar,0,0,1,1
9222,منزعج,0,0,1,1
9223,ജ്യാമിതി,0,0,1,1
9224,finlandés,0,0,1,1
9225,ವಜ್ರಗಳಿಂದ,0,0,1,1
9227,blocage.,0,0,1,1
9241,copiaron,0,0,1,1
9229,integrity,0,0,1,1
9230,forsøgte,0,0,1,1
9231,klädd,0,0,1,1
9232,precedes,0,0,1,1
9235,யோ,0,0,1,1
9238,എനർജി,0,0,1,1
9239,американской,0,0,1,1
8912,meteors.,0,0,1,1
8909,ಹೋದರೆ,0,0,1,1
9394,fact.,0,0,1,1
8906,தகவல்,0,0,1,1
8598,câmara,0,0,1,1
8602,весь,0,0,1,1
8603,bright,0,0,1,1
8604,ന്യൂപീഡിയ,0,0,1,1
8605,περάσεις,0,0,1,1
8610,ഉറവിടങ്ങളുണ്ട്,0,0,1,1
8611,കേൾക്കാൻ,0,0,1,1
8613,android-based,0,0,1,1
8614,.அதனால்,0,0,1,1
8615,சொல்கிறாரோ,0,0,1,1
8616,தயாராகிவிட்டேன்,0,0,1,1
8617,τότε.,0,0,1,1
8618,dosyalar,0,0,1,1
8620,sorunu,0,0,1,1
8621,ошибка,0,0,1,1
8623,تصرفت,0,0,1,1
8627,l'opposition,0,0,1,1
8596,بالنسخة,0,0,1,1
8595,n'avais,0,0,1,1
8594,காவியத்தைப்,0,0,1,1
8582,slowing,0,0,1,1
8570,potencial,0,0,1,1
8572,സാമാന്യം,0,0,1,1
8574,porta-voz,0,0,1,1
8575,identifiés,0,0,1,1
8577,second.,0,0,1,1
8578,स्पार्कली,0,0,1,1
8580,грамматика,0,0,1,1
8583,публично,0,0,1,1
8592,pertinence,0,0,1,1
8584,andamán,0,0,1,1
8585,tenant,0,0,1,1
8586,أجزاء,0,0,1,1
8587,rule-learning,0,0,1,1
8588,describía,0,0,1,1
8590,tapisseries,0,0,1,1
8591,dili'ndeki,0,0,1,1
8629,fluentes,0,0,1,1
8630,американская,0,0,1,1
8631,напуган,0,0,1,1
8671,acontecido,0,0,1,1
8662,बनता,0,0,1,1
8663,लिथुआनियाई,0,0,1,1
8664,защитной,0,0,1,1
8666,παλάτι,0,0,1,1
8667,internacional.,0,0,1,1
8668,запутать,0,0,1,1
8669,go-to,0,0,1,1
8672,insinuer,0,0,1,1
8660,ഉണ്ടാവുക,0,0,1,1
8673,وبعد,0,0,1,1
8676,slice,0,0,1,1
8677,administrar,0,0,1,1
8679,drücken.,0,0,1,1
8680,يرتكب,0,0,1,1
8681,اصطدمت,0,0,1,1
8682,webos-based,0,0,1,1
8661,maddesinden,0,0,1,1
8659,técnica,0,0,1,1
8632,συχνά,0,0,1,1
8644,aufregendes,0,0,1,1
8634,bulk,0,0,1,1
8635,الأفراد,0,0,1,1
8636,gentemot,0,0,1,1
8637,स्तरों,0,0,1,1
8638,incrémentale,0,0,1,1
8641,behaviour,0,0,1,1
8643,faux,0,0,1,1
8645,hawaiianske,0,0,1,1
8657,aceptados.,0,0,1,1
8646,ook.,0,0,1,1
8648,സ്വപ്‌നം,0,0,1,1
8649,قرّر,0,0,1,1
8650,ஒருங்கிணைப்பர்.,0,0,1,1
8653,frihetens,0,0,1,1
8654,المساهمة,0,0,1,1
8655,städer.,0,0,1,1
8569,ou.,0,0,1,1
8567,rappelez-vous.,0,0,1,1
8565,മേഖല.,0,0,1,1
8479,autonomous,0,0,1,1
8470,الدينية,0,0,1,1
8471,применений,0,0,1,1
8474,പറ്റിയെഴുതുന്നു,0,0,1,1
8475,« dieu,0,0,1,1
8476,afunda,0,0,1,1
8477,кнр,0,0,1,1
8478,முகவரிகளினால்,0,0,1,1
8480,لاستخدامها,0,0,1,1
8468,ήρεμος,0,0,1,1
8481,curtindo,0,0,1,1
8482,رسم,0,0,1,1
8485,alabilir,0,0,1,1
8486,использую.,0,0,1,1
8487,hjärna,0,0,1,1
8488,remerciant,0,0,1,1
8490,wetenschappen,0,0,1,1
8469,данного,0,0,1,1
8467,amin,0,0,1,1
8494,kvantiteten,0,0,1,1
8451,തിരികെ,0,0,1,1
8436,contenus.,0,0,1,1
8437,проведённое,0,0,1,1
8438,descumprem,0,0,1,1
8441,sigue,0,0,1,1
8446,увидела,0,0,1,1
8449,inclusionismo.,0,0,1,1
8450,« wikimedia »,0,0,1,1
8452,сша.,0,0,1,1
8466,leken,0,0,1,1
8453,l'apprentissage.,0,0,1,1
8455,सर्व,0,0,1,1
8458,blackberry,0,0,1,1
8459,एनर्जी,0,0,1,1
8463,enfatizando,0,0,1,1
8464,sophistiqué.,0,0,1,1
8465,militär,0,0,1,1
8493,fotograf,0,0,1,1
8495,verspreid.,0,0,1,1
8564,തെറ്റാണ്.,0,0,1,1
8550,arrêt,0,0,1,1
8541,കോമൺസ്,0,0,1,1
8542,sınavınız,0,0,1,1
8543,universally,0,0,1,1
8544,സംഭവിക്കാത്ത,0,0,1,1
8545,wijziging,0,0,1,1
8546,ನೋಡುತ್ತಿದ್ದರೆ.,0,0,1,1
8548,lumières,0,0,1,1
8554,treffen.,0,0,1,1
8538,أظهر,0,0,1,1
8555,إقراضي,0,0,1,1
8557,large.,0,0,1,1
8559, gb,0,0,1,1
8560,residentes.,0,0,1,1
8561,bedava,0,0,1,1
8562,وقدم,0,0,1,1
8563,votes,0,0,1,1
8540,stieg,0,0,1,1
8534,prédiction,0,0,1,1
8496,re-investment,0,0,1,1
8514,туристической,0,0,1,1
8499,täcker,0,0,1,1
8501,consigue,0,0,1,1
8504,combien,0,0,1,1
8505,الفوضى,0,0,1,1
8507,chiste,0,0,1,1
8511,olmadan,0,0,1,1
8512,കൃത്യതയെ,0,0,1,1
8515,cumulant,0,0,1,1
8531,  km,0,0,1,1
8517,gek.,0,0,1,1
8519,ukrainien.,0,0,1,1
8520,لصديقهما,0,0,1,1
8523,préjugés,0,0,1,1
8524,ದ,0,0,1,1
8527,gittiler,0,0,1,1
8530,yazan,0,0,1,1
8684,nacheinander,0,0,1,1
8687,संबोधित,0,0,1,1
8688,godaste,0,0,1,1
8839,എവിടെയാണെന്ന്,0,0,1,1
8829,ജോലിയുടെ,0,0,1,1
8832,contestée].,0,0,1,1
8833,exprimée,0,0,1,1
8834,إسرائيلية,0,0,1,1
8835,shortening,0,0,1,1
8837,hissediyorum.,0,0,1,1
8838,दिलाया,0,0,1,1
8841,قيودًا,0,0,1,1
8827,'l.a.,0,0,1,1
8844,interior.,0,0,1,1
8845,bodies.,0,0,1,1
8846,sidde,0,0,1,1
8847,निगरानी,0,0,1,1
8849,electronica-wedstrijd.,0,0,1,1
8850,അനായാസമായ,0,0,1,1
8851,വിജ്ഞാനകോശമാണ്.,0,0,1,1
8828,sofort.,0,0,1,1
8826,elimination,0,0,1,1
8853,clúster,0,0,1,1
8813,ознакомления,0,0,1,1
8803,викимедиа» ,0,0,1,1
8806,боже.,0,0,1,1
8807,interna,0,0,1,1
8808,ನಿಮ್ಮಲ್ಲಿ,0,0,1,1
8809,соответствующий,0,0,1,1
8810,manifestes,0,0,1,1
8812,офисы,0,0,1,1
8814,എന്തുപറയുന്നു,0,0,1,1
8825,بصراحة,0,0,1,1
8815,hemsk,0,0,1,1
8816,सूत्रपात,0,0,1,1
8817,ಸಿಲುಕಿಕೊಂಡಿದ್ದೀರಿ,0,0,1,1
8818,arıyorsanız,0,0,1,1
8821,apparence,0,0,1,1
8822,merak,0,0,1,1
8823,descargar,0,0,1,1
8852,aptal,0,0,1,1
8855,polémicos.,0,0,1,1
8801,tisch,0,0,1,1
8896,பட்சத்தில்,0,0,1,1
8886,inspira,0,0,1,1
8887,verkligen.,0,0,1,1
8888,persistencia,0,0,1,1
8889,khosla,0,0,1,1
8892,ಕೋಷ್ಟಕಕ್ಕೆ,0,0,1,1
8893,премии,0,0,1,1
8895,'onzichtbaar,0,0,1,1
8897,optaria,0,0,1,1
8882,lagstiftning,0,0,1,1
8898,деятельности.,0,0,1,1
8899,نصًا,0,0,1,1
8900,γλυκιάς,0,0,1,1
8901,snavs,0,0,1,1
8903,citerad,0,0,1,1
8904,kunt.,0,0,1,1
8905,omfattas,0,0,1,1
8883,ഹൃദയത്തിലേക്ക്,0,0,1,1
8881,திட்டங்கள்,0,0,1,1
8856,koruyabilir,0,0,1,1
8864,pioneer,0,0,1,1
8857,ämnesområden.,0,0,1,1
8858,மொழிகளைக்,0,0,1,1
8859,إعلانات،,0,0,1,1
8860,سأخذه.,0,0,1,1
8861,செய்திகளில்,0,0,1,1
8862,autorización.,0,0,1,1
8863,يلقى,0,0,1,1
8865,இருந்ததா,0,0,1,1
8880,s'inspirer,0,0,1,1
8866,baka,0,0,1,1
8870,town.,0,0,1,1
8873,ദീർഘനാളായി,0,0,1,1
8874,ihop.,0,0,1,1
8876,موافق.,0,0,1,1
8878,குறுங்கட்டுரையாகவே,0,0,1,1
8879,değiştirme,0,0,1,1
8802,google​,0,0,1,1
8800,albumet,0,0,1,1
8689,tumor,0,0,1,1
8732,தெரிந்த,0,0,1,1
8716,preguiçosos,0,0,1,1
8717,vertegenwoordigers,0,0,1,1
8722,πόδια,0,0,1,1
8727,ağladığın,0,0,1,1
8728,tout.,0,0,1,1
8730,मनोनीत,0,0,1,1
8731,accurately,0,0,1,1
8733,responsabilités,0,0,1,1
8712,لتأثير,0,0,1,1
8735,bulundukları,0,0,1,1
8736,разве,0,0,1,1
8739,αργότερα,0,0,1,1
8740,informal,0,0,1,1
8741,téléphoniques.,0,0,1,1
8742,മടുപ്പില്ല,0,0,1,1
8743,asiáticas,0,0,1,1
8713,देखूंगा।,0,0,1,1
8711,filters,0,0,1,1
8747,дополнение,0,0,1,1
8697,hypothétique,0,0,1,1
8690,comparar,0,0,1,1
8691,πηγαίνουμε,0,0,1,1
8692,ಆವಿಷ್ಕಾರ,0,0,1,1
8693,συμμετεχόντων,0,0,1,1
8694,exhibits,0,0,1,1
8695,салаты,0,0,1,1
8696,caes,0,0,1,1
8698,ставить,0,0,1,1
8710,sondage,0,0,1,1
8699,لطيف,0,0,1,1
8702,புழுக்கமாகப்,0,0,1,1
8703,അഭിപ്രായ,0,0,1,1
8704,chariot,0,0,1,1
8705,interesseret,0,0,1,1
8706,προγράμματα,0,0,1,1
8708,job.,0,0,1,1
8744,négatif,0,0,1,1
8748,பற்றிய,0,0,1,1
8799,отзыв,0,0,1,1
8785,cultureel,0,0,1,1
8777,perdido.,0,0,1,1
8778,hävdade,0,0,1,1
8779,worse,0,0,1,1
8781,topic.,0,0,1,1
8782,lignende-knappen,0,0,1,1
8783,subsanadas,0,0,1,1
8784,ടെറൻസും,0,0,1,1
8786,macedónio,0,0,1,1
8775,जेल,0,0,1,1
8787,വസ്തുതകൾ,0,0,1,1
8788,ಹಿಸಿದ್ದೇನೆ.,0,0,1,1
8790,gesamte,0,0,1,1
8791,interrumpirte.,0,0,1,1
8793,beweerde,0,0,1,1
8794,yakalayamadıysan,0,0,1,1
8798,cyclones,0,0,1,1
8776,функционирование.,0,0,1,1
8773,seyahatleri,0,0,1,1
8751,membres,0,0,1,1
8760,redaktionella,0,0,1,1
8752,இவற்றோடு,0,0,1,1
8753,ответ»,0,0,1,1
8754,jemals,0,0,1,1
8755,merk,0,0,1,1
8757,crudivorismo,0,0,1,1
8758,representación.,0,0,1,1
8759,captó,0,0,1,1
8761,واكتب,0,0,1,1
8772,ನಂಬಲಾಗದ,0,0,1,1
8762,analys,0,0,1,1
8763,réveillé,0,0,1,1
8765,സെൽ,0,0,1,1
8767,onderkend,0,0,1,1
8768,ദക്ഷതയോടെ,0,0,1,1
8769,fruittopics,0,0,1,1
8770,cumulatively,0,0,1,1
9393,smartmobiler,0,0,1,1
9395,tadı,0,0,1,1
10400,ഡാറ്റാ,0,0,1,1
9906,anfang.,0,0,1,1
10071,vogel,0,0,1,1
10076,geoinformation.,0,0,1,1
10079,tirou,0,0,1,1
10081,നല്കിയിരിക്കുന്നു.,0,0,1,1
10082,kinderspiel,0,0,1,1
10083,русском,0,0,1,1
10084,stratégiquement,0,0,1,1
10086,функционал,0,0,1,1
10091,ضخم,0,0,1,1
10092,allvarligt,0,0,1,1
10096,सीख,0,0,1,1
10097,ما،,0,0,1,1
10100,success,0,0,1,1
10101,unterricht,0,0,1,1
10102,മാണിക്യത്തിന്റെ,0,0,1,1
10105,acusam-na,0,0,1,1
10106,approuvés,0,0,1,1
10068,имеющейся,0,0,1,1
10067,में।इसके,0,0,1,1
10066,wikis.,0,0,1,1
10046,نيوبيديا،,0,0,1,1
10035,quickly.,0,0,1,1
10038,അളവിലുള്ള,0,0,1,1
10039,modales,0,0,1,1
10040,financieele,0,0,1,1
10043,كجزء,0,0,1,1
10044,deneyim,0,0,1,1
10045,நுபீடியாவானது,0,0,1,1
10048,uitgebalanceerde,0,0,1,1
10064,brandväggen,0,0,1,1
10051,kvinna,0,0,1,1
10054,ಹೋಗುತ್ತೇವೆ,0,0,1,1
10055,ചൈനീസ്,0,0,1,1
10056,علامة,0,0,1,1
10057,உதவியாக,0,0,1,1
10060,dispostos,0,0,1,1
10061,χαμόγελα,0,0,1,1
10107,l'étude,0,0,1,1
10108,öğrenebilirsiniz.,0,0,1,1
10111,പ്രശ്നത്തേക്കാൾ,0,0,1,1
10153,bloquées.,0,0,1,1
10143,läget.,0,0,1,1
10144,फ्रेंको,0,0,1,1
10146,textes.,0,0,1,1
10147,തെറ്റിദ്ധരിച്ചതായി,0,0,1,1
10148,പെടുന്ന,0,0,1,1
10149,تسميتها,0,0,1,1
10152,questionada,0,0,1,1
10154,يتمكن,0,0,1,1
10138,emotion.,0,0,1,1
10157,ഏതു,0,0,1,1
10158,الفظيعة,0,0,1,1
10159,denying,0,0,1,1
10160,cazaque,0,0,1,1
10162,கொண்டிருந்தார்கள்,0,0,1,1
10163,صحتها،,0,0,1,1
10164,uncovered,0,0,1,1
10141,إم.,0,0,1,1
10137,സൂപ്പിലോ,0,0,1,1
10112,ortnamn.,0,0,1,1
10125,dich.,0,0,1,1
10113,ejaculação,0,0,1,1
10114,بالعربية,0,0,1,1
10118,sammanslagning,0,0,1,1
10119,пароль,0,0,1,1
10121,ಅಭಿಪ್ರಾಯವೇನು,0,0,1,1
10122,community ...,0,0,1,1
10124,originales.,0,0,1,1
10126,werkwoordsvorm,0,0,1,1
10136,vestimentaire,0,0,1,1
10127,vision.,0,0,1,1
10128,முரண்பாடு,0,0,1,1
10129,rendimiento,0,0,1,1
10130,istemezdim.,0,0,1,1
10131,actualización,0,0,1,1
10132,الخادمات,0,0,1,1
10135,gérant,0,0,1,1
10034,இது.,0,0,1,1
10033,kırptı.,0,0,1,1
10032,onderbreek.,0,0,1,1
9954,каких-либо,0,0,1,1
9943,пределами,0,0,1,1
9945,предпочтения,0,0,1,1
9946,besleyelim.,0,0,1,1
9947,развития»,0,0,1,1
9948,omitiendo,0,0,1,1
9951,ക്രിക്കറ്റ്,0,0,1,1
9952,incluyen,0,0,1,1
9957,sujeira,0,0,1,1
9936,ಸಂತೋಷವಾಗಿದ್ದೇನೆ,0,0,1,1
9958,dönüştürme,0,0,1,1
9959,καταπληκτικός.,0,0,1,1
9961,തുടക്കംകുറിച്ചത്.,0,0,1,1
9962,faltas,0,0,1,1
9964,framsteg,0,0,1,1
9966,ಅವ್ಯವಸ್ಥೆಯಲ್ಲಿದ್ದೇನೆ,0,0,1,1
9967,yönergesi,0,0,1,1
9941,katkıların,0,0,1,1
9934,qualité ,0,0,1,1
9969,ஒன்றாகும்,0,0,1,1
9918,fiquei,0,0,1,1
9910,utgivaren,0,0,1,1
9911,işiniz,0,0,1,1
9912,القيمة,0,0,1,1
9913,uppsatsens,0,0,1,1
9914,geçmişinde,0,0,1,1
9916,märkspråk.,0,0,1,1
9917,واسع.,0,0,1,1
9919,تفسرها,0,0,1,1
9933,تستخدم,0,0,1,1
9920,supprimée,0,0,1,1
9921,'verwendet.,0,0,1,1
9924,viajaban,0,0,1,1
9925,discordando.,0,0,1,1
9929,രീതിയിലേക്ക്,0,0,1,1
9931,कापमपंगन,0,0,1,1
9932,tillgängligt,0,0,1,1
9968,உள்ளடக்கங்களையும்,0,0,1,1
9970,warten.,0,0,1,1
10031,wikiwikiweb.,0,0,1,1
10015,wikipedia',0,0,1,1
10004,« quelle,0,0,1,1
10005,നിർദ്ദേശങ്ങൾ.,0,0,1,1
10006,semestre,0,0,1,1
10008,κινείται,0,0,1,1
10010,ನೋಡಿಕೊಳ್ಳಿ.,0,0,1,1
10011,farkında,0,0,1,1
10012,asian,0,0,1,1
10016,hypotheses,0,0,1,1
10001,ενδιαφέρει,0,0,1,1
10017,ഉച്ചരിക്കുകയാണെന്ന്,0,0,1,1
10020,returns,0,0,1,1
10022,şeyleri,0,0,1,1
10023,zei.,0,0,1,1
10026,areas.,0,0,1,1
10029,kurallarından,0,0,1,1
10030,alın,0,0,1,1
10003,besökares,0,0,1,1
10000,sormak,0,0,1,1
9971,secret.,0,0,1,1
9983,дисперсией,0,0,1,1
9972,ஆசிரியராகப்,0,0,1,1
9974,haarlem,0,0,1,1
9976,tillämpliga,0,0,1,1
9977,proppen,0,0,1,1
9978,yazarlarından,0,0,1,1
9981,большим,0,0,1,1
9982,பெரியதும்,0,0,1,1
9986,allez.,0,0,1,1
9998,compararam,0,0,1,1
9988,സൃഷ്ടിച്ച്,0,0,1,1
9989,apaixonadamente,0,0,1,1
9991,सलाद,0,0,1,1
9992,വിജ്ഞാനതൃഷ്ണയും,0,0,1,1
9993,mencionan,0,0,1,1
9996,έθιμα,0,0,1,1
9997,gardner.,0,0,1,1
10166,മറുപടി,0,0,1,1
10167,söylemektir,0,0,1,1
10168,специальных,0,0,1,1
10324,diskuteras,0,0,1,1
10315,सीमित,0,0,1,1
10316,ബാങ്കിനോട്,0,0,1,1
10317,संस्कृत,0,0,1,1
10318,skat,0,0,1,1
10319,användarnamn,0,0,1,1
10320,उर्दू,0,0,1,1
10321,குறைவாகக்,0,0,1,1
10327,nominated,0,0,1,1
10313,burayı,0,0,1,1
10328,واجب,0,0,1,1
10329,geïnteresseerd,0,0,1,1
10331,schlaf,0,0,1,1
10332,२२,0,0,1,1
10333,ಪ್ರವಾಸಿಗನು,0,0,1,1
10335,plats.,0,0,1,1
10337,financiación,0,0,1,1
10314,blijven,0,0,1,1
10312,hébergent,0,0,1,1
10342,nous',0,0,1,1
10296,independente,0,0,1,1
10286,næse,0,0,1,1
10287,heart,0,0,1,1
10288,അൽഗോരിതങ്ങൾ,0,0,1,1
10290,столь,0,0,1,1
10293,വീഡിയോയുടെ,0,0,1,1
10294,webpagina,0,0,1,1
10295,وgerman،,0,0,1,1
10297,выборки ,0,0,1,1
10309,discutiu,0,0,1,1
10299,beschikbare,0,0,1,1
10300,dynamics,0,0,1,1
10302,inbördeskriget.,0,0,1,1
10304,conscientious,0,0,1,1
10305,salud,0,0,1,1
10306,ومتطور.,0,0,1,1
10308,calidad.,0,0,1,1
10341,classificados,0,0,1,1
10345,meat,0,0,1,1
10284,hjertet,0,0,1,1
10386,ödevlerle,0,0,1,1
10376,marianne,0,0,1,1
10377,denis,0,0,1,1
10379,പോർട്ടൽ,0,0,1,1
10380,माध्यमिक,0,0,1,1
10381,diariamente,0,0,1,1
10382,гарантирует,0,0,1,1
10383,динамику.,0,0,1,1
10387,എത്തിച്ചേരേണ്ട,0,0,1,1
10373,„википедию“»,0,0,1,1
10388,mauvais.,0,0,1,1
10389,العناء.,0,0,1,1
10390,välmodig,0,0,1,1
10392,فارس.,0,0,1,1
10393,fa •,0,0,1,1
10394,okuldan,0,0,1,1
10399,reparos,0,0,1,1
10374,говорят,0,0,1,1
10372,siderian,0,0,1,1
10346,آخر.,0,0,1,1
10359,períodos,0,0,1,1
10347,yolculuk,0,0,1,1
10349,एनलाइटएनमेंट,0,0,1,1
10351,encantadora,0,0,1,1
10355,adivinhado,0,0,1,1
10356,decentralizing,0,0,1,1
10357,.हम,0,0,1,1
10358,تتعلق,0,0,1,1
10360,site[j],0,0,1,1
10371,doktoranders,0,0,1,1
10361,renseignement,0,0,1,1
10363,मिश्रित,0,0,1,1
10364,स्टैनफोर्ड,0,0,1,1
10365,conservé,0,0,1,1
10366,производстве,0,0,1,1
10368,некорректным,0,0,1,1
10370,марион.,0,0,1,1
10285,ödül,0,0,1,1
10283,sorrindo,0,0,1,1
10169,hierover,0,0,1,1
10208,citadas,0,0,1,1
10200,commis,0,0,1,1
10201,telaşa,0,0,1,1
10203,путешествий,0,0,1,1
10204,അറിവുള്ള,0,0,1,1
10205,belge,0,0,1,1
10206,научного,0,0,1,1
10207,energetic,0,0,1,1
10209,ώρα.,0,0,1,1
10198,supérieures,0,0,1,1
10210,प्रवक्ता,0,0,1,1
10211,جودة,0,0,1,1
10212,staan.,0,0,1,1
10213,fout.,0,0,1,1
10214,recognition‏،,0,0,1,1
10215,permitirse,0,0,1,1
10218,шварцем,0,0,1,1
10199,märkbart,0,0,1,1
10196,danois,0,0,1,1
10221,raciste,0,0,1,1
10184,yoktur.,0,0,1,1
10171,almam,0,0,1,1
10172,ξεφλουδίστηκε,0,0,1,1
10173,bardak,0,0,1,1
10177,написанное,0,0,1,1
10178,சேர்க்கப்பட்டதும்,0,0,1,1
10181,питтсбургского,0,0,1,1
10182,ves.,0,0,1,1
10185,ಸವಾರಿಯ,0,0,1,1
10195,αρκετά,0,0,1,1
10186,struktur,0,0,1,1
10187,vulgariser,0,0,1,1
10189,subkultur,0,0,1,1
10190,hizmetlileri,0,0,1,1
10191,punt,0,0,1,1
10192,medier,0,0,1,1
10193,prinses,0,0,1,1
10219,because.,0,0,1,1
10222,venga.,0,0,1,1
10282,courants,0,0,1,1
10270,krävas,0,0,1,1
10260,verifiable,0,0,1,1
10261,തിരുത്തുന്നു,0,0,1,1
10262,gesloten,0,0,1,1
10263,processus.,0,0,1,1
10264,μπερδέψεις,0,0,1,1
10265,جالسة,0,0,1,1
10268,ഇന്റർനെറ്റിലും,0,0,1,1
10271,whereby,0,0,1,1
10258,deles,0,0,1,1
10272,incorporation,0,0,1,1
10273,е. д. свердлов,0,0,1,1
10276,αποδέχομαι,0,0,1,1
10277,svagt,0,0,1,1
10278,cbn,0,0,1,1
10279,വ്യവസ്ഥിതിയാണ്,0,0,1,1
10281,pertenecientes,0,0,1,1
10259,இயக்கத்துக்கு,0,0,1,1
10256,nisan,0,0,1,1
10224,hundreds,0,0,1,1
10237,புளூமாக்ஸாக,0,0,1,1
10225,शिक्षक,0,0,1,1
10229,domains.,0,0,1,1
10231,paternité-partage,0,0,1,1
10233,opbeuren,0,0,1,1
10234,wikipe-tan,0,0,1,1
10235,எளிமையான,0,0,1,1
10236,में-,0,0,1,1
10238,σημαίνει.,0,0,1,1
10255,manuais,0,0,1,1
10239,ursprünge,0,0,1,1
10243,подъехала,0,0,1,1
10244,الآيس,0,0,1,1
10245,تهمه,0,0,1,1
10251,ukrainian,0,0,1,1
10252,accordant,0,0,1,1
10253,propres[s].,0,0,1,1
9909,botanists,0,0,1,1
9905,celles-ci,0,0,1,1
9399,ಬೆಳ್ಳಿಯನ್ನು,0,0,1,1
9904,berätta.,0,0,1,1
9553,superou,0,0,1,1
9559,ком-то,0,0,1,1
9560,matarna,0,0,1,1
9563,കടന്നുപോകാൻ,0,0,1,1
9565,ಪರಿಪೂರ್ಣವಾದ,0,0,1,1
9566,secrète,0,0,1,1
9567,apresentação,0,0,1,1
9568,s’accroissait,0,0,1,1
9570,medfølgende,0,0,1,1
9571,humoristiques,0,0,1,1
9572,ಹುಚ್ಚನಂತೆ.,0,0,1,1
9574,overhand,0,0,1,1
9575,piltangenter,0,0,1,1
9576,dignos,0,0,1,1
9577,söylediğin,0,0,1,1
9578,.[needs,0,0,1,1
9579,ಟೋಫ್ಲ್,0,0,1,1
9552,அதிர்ச்சியடைந்தாள்.,0,0,1,1
9551,общедоступным,0,0,1,1
9550,сердится,0,0,1,1
9536,recommends,0,0,1,1
9522,verlegenheit.,0,0,1,1
9526,“மைசீக்குவல்”,0,0,1,1
9528,encyclopédique,0,0,1,1
9530,δική,0,0,1,1
9532,evening,0,0,1,1
9534,ethnicities,0,0,1,1
9535,wikiformat,0,0,1,1
9537,erreur.,0,0,1,1
9549,deliberadamente,0,0,1,1
9538,contraste,0,0,1,1
9539,παραδέχεστε,0,0,1,1
9540,тесте,0,0,1,1
9541,rik,0,0,1,1
9543,അവസാനിച്ചിട്ടില്ല.,0,0,1,1
9544,dão,0,0,1,1
9547,πλανήτη,0,0,1,1
9580,reutilização,0,0,1,1
9582,‘இணைய,0,0,1,1
9584,prontitud,0,0,1,1
9640,wiktionnaire,0,0,1,1
9631,inger,0,0,1,1
9632,corporativa,0,0,1,1
9634,ಸೋಲಿಸುತ್ತಾನೆ.,0,0,1,1
9636,japonesa.,0,0,1,1
9637,ужасна.,0,0,1,1
9638,diferenciada,0,0,1,1
9639,stimulus-triggered,0,0,1,1
9642,dîner,0,0,1,1
9629,வருக.,0,0,1,1
9643,constitution,0,0,1,1
9645,arasında,0,0,1,1
9646,सुसंस्कृत,0,0,1,1
9647,administratörer,0,0,1,1
9648,partager,0,0,1,1
9649,சந்திப்பேன்,0,0,1,1
9650,പോലെയാണ്.,0,0,1,1
9630,değiştirmesiyle,0,0,1,1
9627,വായിച്ച്,0,0,1,1
9585,عليها.,0,0,1,1
9610,உடன்படவில்லை.,0,0,1,1
9586,பள்ளியிலிருந்து,0,0,1,1
9588,exploitée,0,0,1,1
9591,bibliotheek,0,0,1,1
9595,drukning,0,0,1,1
9600,découle,0,0,1,1
9604,αγγλική,0,0,1,1
9605,لاحقة،,0,0,1,1
9612,எடுத்துக்காட்டுகளைப்,0,0,1,1
9625,dijeron,0,0,1,1
9613,verificadas.,0,0,1,1
9614,priority ...,0,0,1,1
9615,suppression,0,0,1,1
9616,ಬ್ರೆಡ್ನಲ್ಲಿ,0,0,1,1
9618,hitwise,0,0,1,1
9619,απίστευτα,0,0,1,1
9620,ആരംഭിക്കുന്നതിനുള്ള,0,0,1,1
9521,effort.,0,0,1,1
9519,réunie,0,0,1,1
9517,സാക്ഷാത്കരിക്കപ്പെട്ടാൽ,0,0,1,1
9441,являющейся,0,0,1,1
9434,разделах.,0,0,1,1
9435,wenig,0,0,1,1
9436,reliée,0,0,1,1
9437,مراجعته,0,0,1,1
9438,ನಾರುವ,0,0,1,1
9439,ഉരുളക്കിഴങ്ങ്,0,0,1,1
9440,ομορφιά.,0,0,1,1
9442,решающее,0,0,1,1
9430,остановить,0,0,1,1
9443,പാഴ്‌മെയിലാണോയെന്ന്,0,0,1,1
9444,சோர்வாகவும்,0,0,1,1
9445,avantage,0,0,1,1
9446,entrenamiento.,0,0,1,1
9447,civilisé.,0,0,1,1
9448,processen.,0,0,1,1
9451,τύχη.,0,0,1,1
9431,женихи,0,0,1,1
9429,نبرة,0,0,1,1
9453,carry,0,0,1,1
9410,സുപ്രധാനനേട്ടവും,0,0,1,1
9401,കാണുമ്പോൾ,0,0,1,1
9402,χρυσός,0,0,1,1
9403,ಒಳ್ಳೆಯವರಾಗಿದ್ದಾರೆ,0,0,1,1
9404,മുൻപ്,0,0,1,1
9405,जताया,0,0,1,1
9407,வைக்கிறேன்.,0,0,1,1
9408,வாழ்ந்தார்.,0,0,1,1
9411,d'apparence,0,0,1,1
9424,ലേഖകസംഘം,0,0,1,1
9412,பார்ப்பேன்.,0,0,1,1
9413,ಹೇಳಲಾರೆ.,0,0,1,1
9415,ಅದೃಷ್ಟವಂತ,0,0,1,1
9420,'enciclopedia',0,0,1,1
9421,initiating,0,0,1,1
9422,besteden.,0,0,1,1
9423,സൈർ,0,0,1,1
9452,испечь,0,0,1,1
9454,الأمريكية,0,0,1,1
9513,ಆಳವಾಗಿ,0,0,1,1
9500,важно,0,0,1,1
9487,firent,0,0,1,1
9488,propuesta.,0,0,1,1
9490,шутка.,0,0,1,1
9491,granskat,0,0,1,1
9492,argumentée,0,0,1,1
9496,ವಿವಾಹದ,0,0,1,1
9497,образовано,0,0,1,1
9502,influencé,0,0,1,1
9485,വളർത്താൻ,0,0,1,1
9503,ásia,0,0,1,1
9504,n'avait,0,0,1,1
9505,faydalı,0,0,1,1
9506,लीजिए,0,0,1,1
9509,padronizações,0,0,1,1
9511,sanmıyorum.,0,0,1,1
9512,ಸೀನುವಾಗ,0,0,1,1
9486,mystery.,0,0,1,1
9482,kunst,0,0,1,1
9456,verabschieden.,0,0,1,1
9470,архитектуру.,0,0,1,1
9458,конечная,0,0,1,1
9461,ഇല്ലായിരുന്നു,0,0,1,1
9462,செய்யவில்லை.,0,0,1,1
9465,bedekken,0,0,1,1
9466,πρόσβασης.,0,0,1,1
9467,econômica,0,0,1,1
9468,dejlige,0,0,1,1
9471,http//de.wikipedia.org,0,0,1,1
9481,универсальная,0,0,1,1
9472,dibujada,0,0,1,1
9473,സ്കൂൾ,0,0,1,1
9474,parlait,0,0,1,1
9475,katılıyorum.,0,0,1,1
9478,ಕೂಡಿದೆ,0,0,1,1
9479,comedian,0,0,1,1
9480,oprettet,0,0,1,1
9652,ಗೆದ್ದಿದೆ,0,0,1,1
9654,представленного,0,0,1,1
9655,செய்யத்,0,0,1,1
9819,smagseksempel.,0,0,1,1
9807,länders,0,0,1,1
9808,push,0,0,1,1
9813,терпеливо,0,0,1,1
9815,mapean,0,0,1,1
9816,finger,0,0,1,1
9817,ലേർണിങ്machine,0,0,1,1
9818,sabırla,0,0,1,1
9820,വിഷമിക്കേണ്ടതില്ല,0,0,1,1
9804,múltiplos,0,0,1,1
9824,இதுபோன்ற,0,0,1,1
9825,text-based,0,0,1,1
9826,έμαθα,0,0,1,1
9827,بمقياس,0,0,1,1
9832,ansiklopediler,0,0,1,1
9835,ζητήσετε,0,0,1,1
9836,acredito,0,0,1,1
9805,traducciones,0,0,1,1
9803,robótica.,0,0,1,1
9838,несвободные,0,0,1,1
9788,instancia.,0,0,1,1
9775,धैर्य,0,0,1,1
9776,неэкспертами,0,0,1,1
9777,विकटियोनरी,0,0,1,1
9780,conduits,0,0,1,1
9781,extrasolar,0,0,1,1
9783,പ്രശസ്തമായ,0,0,1,1
9784,ಟೈಪ್,0,0,1,1
9789,återgavs,0,0,1,1
9802,coordination,0,0,1,1
9791,sink,0,0,1,1
9792,basquir,0,0,1,1
9793,espuria,0,0,1,1
9794,развитии,0,0,1,1
9796,قبول,0,0,1,1
9798,സ്ഥാപിതമായതും,0,0,1,1
9799,publicering.,0,0,1,1
9837,règle,0,0,1,1
9840,ابتهج.,0,0,1,1
9773,annenin,0,0,1,1
9888,തയ്യാറാക്കുന്നത്.,0,0,1,1
9877,d'ajouter,0,0,1,1
9878,prouver,0,0,1,1
9880,ratios,0,0,1,1
9881,langsommere.,0,0,1,1
9883,друзьям,0,0,1,1
9884,annotated,0,0,1,1
9885,suscribirse,0,0,1,1
9889,गैर-लाभकारी,0,0,1,1
9875,assuming,0,0,1,1
9890,censuráveis,0,0,1,1
9891,karısı,0,0,1,1
9892,leyó,0,0,1,1
9893,izleme,0,0,1,1
9894,verir,0,0,1,1
9900,gibt,0,0,1,1
9901,edip,0,0,1,1
9876,amerikaanse,0,0,1,1
9874,personas.,0,0,1,1
9843,ಹೇಳುತ್ತಿದ್ದೀರಿ.,0,0,1,1
9860,separar,0,0,1,1
9846,ಉತ್ತಮ.,0,0,1,1
9847,rijk,0,0,1,1
9848,приписывается,0,0,1,1
9849,alpha,0,0,1,1
9850,возможны,0,0,1,1
9857,फेडरल,0,0,1,1
9859,ಅರಮನೆಯಲ್ಲಿ,0,0,1,1
9861,olduğun,0,0,1,1
9873,hen.,0,0,1,1
9862,बनाम,0,0,1,1
9863,وغيرت,0,0,1,1
9864,هاواي,0,0,1,1
9868,കോളിൽ,0,0,1,1
9869,أنف,0,0,1,1
9871,almorzar,0,0,1,1
9872,geçtiğini,0,0,1,1
9774,ಪದ.,0,0,1,1
9772,desarrollados,0,0,1,1
9656,இருந்தாள்.,0,0,1,1
9698,γνωστή,0,0,1,1
9690,measurement,0,0,1,1
9691,pub.,0,0,1,1
9692,uyandım,0,0,1,1
9694,regelbundna,0,0,1,1
9695,lekkerste,0,0,1,1
9696,sentado,0,0,1,1
9697,emeğiniz,0,0,1,1
9699,شريحة,0,0,1,1
9688,لكنك,0,0,1,1
9700,éviter,0,0,1,1
9701,बोलियों,0,0,1,1
9704,воздействию,0,0,1,1
9707,complementos,0,0,1,1
9708,voorbaat.,0,0,1,1
9710,exigindo,0,0,1,1
9712,തളർന്നില്ലെന്ന്,0,0,1,1
9689,africans,0,0,1,1
9687,ಸಂಪತ್ತು,0,0,1,1
9717,உருவாக்கப்பட்டது.,0,0,1,1
9672,вашем,0,0,1,1
9658,رئيس,0,0,1,1
9660,വേണ്ടെന്ന്.,0,0,1,1
9661,गोपनीयता,0,0,1,1
9663,dramatic,0,0,1,1
9664,குழப்பமடைந்தால்,0,0,1,1
9665,teorier,0,0,1,1
9670,gå.,0,0,1,1
9673,fiable.,0,0,1,1
9685,успешно,0,0,1,1
9675,reacción,0,0,1,1
9676,لغتا,0,0,1,1
9677,formuleringar.,0,0,1,1
9678,പറയുകയായിരുന്നു.,0,0,1,1
9682,« wikipedia ».,0,0,1,1
9683,boyfriend,0,0,1,1
9684,afirmam,0,0,1,1
9714,genotipo,0,0,1,1
9718,tedavi,0,0,1,1
9771,överflödigt,0,0,1,1
9757,propôs,0,0,1,1
9748,വേണമെങ്കിൽ,0,0,1,1
9749,tomó,0,0,1,1
9750,musea,0,0,1,1
9751,ಪ್ರತಿಯೊಬ್ಬರೂ,0,0,1,1
9752,kurulmuştur,0,0,1,1
9754,оценки.,0,0,1,1
9755,établit,0,0,1,1
9759,gemenskapen,0,0,1,1
9746,ringa,0,0,1,1
9764,vocation,0,0,1,1
9765,ಎರಡನೆಯ,0,0,1,1
9766,urban,0,0,1,1
9767,இவற்றுள்,0,0,1,1
9768,inédites,0,0,1,1
9769,думаю.,0,0,1,1
9770,inclusion,0,0,1,1
9747,politicamente,0,0,1,1
9744,tremendos,0,0,1,1
9719,بنصيب,0,0,1,1
9729,വരുന്ന,0,0,1,1
9720,ഒറ്റ,0,0,1,1
9721,betydelsen,0,0,1,1
9722,العلوي,0,0,1,1
9723,ബാങ്കിങ്,0,0,1,1
9724,catedral,0,0,1,1
9725,fins.,0,0,1,1
9726,свободным,0,0,1,1
9731,bom.,0,0,1,1
9742,مساعدتي,0,0,1,1
9732,вошёл,0,0,1,1
9736,transmitiu,0,0,1,1
9737,учётных,0,0,1,1
9738,uyarılmaktadır.,0,0,1,1
9739,diyorum.,0,0,1,1
9740,zusterproject,0,0,1,1
9741,upphovsrättsbrott,0,0,1,1
12378,enteros,0,0,1,1
12381,يكرر,0,0,1,1
8431,вчера,0,0,1,1
14787,domestic,0,0,1,1
14930,قليلة,0,0,1,1
14931,существительных,0,0,1,1
14932,iseniz,0,0,1,1
14935,обедом,0,0,1,1
14937,θετικό,0,0,1,1
14938,destruction,0,0,1,1
14939,കേൾക്കുക.,0,0,1,1
14940,resa.,0,0,1,1
14941,സഹായിക്കാനായി,0,0,1,1
14943,« good,0,0,1,1
14944,moeite.,0,0,1,1
14945,kontakten.,0,0,1,1
14947,ими,0,0,1,1
14948,indique,0,0,1,1
14949,companhia,0,0,1,1
14950,användarnas,0,0,1,1
14954,odds,0,0,1,1
14929,raises,0,0,1,1
14927,زاوية,0,0,1,1
14926,आठ,0,0,1,1
14912,s'estompe,0,0,1,1
14898,επισκεφτούν,0,0,1,1
14899,марта,0,0,1,1
14901,gruwelijk,0,0,1,1
14902,investigador,0,0,1,1
14905,புளூமாக்ஸிற்குப்,0,0,1,1
14906,പുനരാരംഭിക്കാൻ‌,0,0,1,1
14911,theorists,0,0,1,1
14914,supposed,0,0,1,1
14925,такое,0,0,1,1
14916,ചെയ്ത,0,0,1,1
14917,connaissez-vous,0,0,1,1
14918,talere,0,0,1,1
14919,educated,0,0,1,1
14921,disséquées,0,0,1,1
14922,encontrados.,0,0,1,1
14923,أذكرك,0,0,1,1
14955,ಉಲ್ಲೇಖಿಸಬೇಡಿ.,0,0,1,1
14956,текстового,0,0,1,1
14957,ചെയ്തതിന്,0,0,1,1
15004,wikipédia[nota,0,0,1,1
14992,enfaticamente,0,0,1,1
14996,exposiciones,0,0,1,1
14997,காதலி,0,0,1,1
14998,costumamos,0,0,1,1
14999,​​enkele,0,0,1,1
15000,consigo,0,0,1,1
15003,അറിയാമോ,0,0,1,1
15006,expertgenererat,0,0,1,1
14990,tentativa,0,0,1,1
15010,ಕೈದಿಗಳಿಗೆ,0,0,1,1
15011,ഇന്നും,0,0,1,1
15012,مسؤولون,0,0,1,1
15013,agent,0,0,1,1
15015,violents,0,0,1,1
15016,похожим,0,0,1,1
15017,αντανάκλαση,0,0,1,1
14991,d'octobre,0,0,1,1
14987,pensamiento,0,0,1,1
14958,domestiques,0,0,1,1
14973,trophy,0,0,1,1
14959,വരുമ്പോൾ,0,0,1,1
14960,مساءً.,0,0,1,1
14964,därifrån.,0,0,1,1
14965,αμβλείος,0,0,1,1
14966,ಪಡುತ್ತಿದ್ದೆ.,0,0,1,1
14969,ഭാഗ്യവാൻ,0,0,1,1
14970,ανόητο,0,0,1,1
14974,ειδήσεις,0,0,1,1
14986,بتصميم,0,0,1,1
14975,села,0,0,1,1
14976,തൂപ്പുകാരുമാണ്,0,0,1,1
14977,tarjetas,0,0,1,1
14978, ,0,0,1,1
14979,comedic,0,0,1,1
14981,പലതുള്ളി,0,0,1,1
14985,ಎಲ್ಲವು,0,0,1,1
14897,doutoranda,0,0,1,1
14896,الطلاب,0,0,1,1
14895,spisestuen,0,0,1,1
14829,kız,0,0,1,1
14816,человека.,0,0,1,1
14821,பதிக்கப்பட்டிருந்தது,0,0,1,1
14822,போர்ட்டலுக்குள்,0,0,1,1
14824,máximo,0,0,1,1
14826,operadores,0,0,1,1
14827,отдельные,0,0,1,1
14828,vendría,0,0,1,1
14830,सिटिज़नडियम,0,0,1,1
14810,ಅಧಿಕೃತ,0,0,1,1
14831,மாற்றமடையும்,0,0,1,1
14834,szl •,0,0,1,1
14835,കണ്ടുപിടിക്കലാണ്,0,0,1,1
14836,articulation,0,0,1,1
14837,അസാധ്യമായ,0,0,1,1
14838,company.,0,0,1,1
14843,cometió,0,0,1,1
14812,உதவுகிறது.,0,0,1,1
14808,غيغابايت,0,0,1,1
14847,विशेषकर,0,0,1,1
14797,declines,0,0,1,1
14789,واضحة.,0,0,1,1
14790,дела.,0,0,1,1
14791,ಎಲ್ಲದಕ್ಕೂ,0,0,1,1
14792,ಗ್ಮಾಟ್,0,0,1,1
14793,الشعبية,0,0,1,1
14794,espalhar,0,0,1,1
14795,കരച്ചിൽ,0,0,1,1
14798,yansımasına,0,0,1,1
14807,हित,0,0,1,1
14800,قناة,0,0,1,1
14801,incommensurables,0,0,1,1
14802,الصراع,0,0,1,1
14803,ഭാഷകൾ,0,0,1,1
14804,தூண்டுகிறது,0,0,1,1
14805,அதிகாரத்,0,0,1,1
14806,ഫോണ്ട്,0,0,1,1
14844,sıcak,0,0,1,1
14848,опытов,0,0,1,1
14894,lesma,0,0,1,1
14885,ವೈಫಲ್ಯಗಳ,0,0,1,1
14877,financiers.,0,0,1,1
14878,webbaserad,0,0,1,1
14879,தரக்கணிப்பீட்டு,0,0,1,1
14880,théorique,0,0,1,1
14881,مديرو,0,0,1,1
14883,caísse,0,0,1,1
14884,تأسيس,0,0,1,1
14886,കൈവരിക്കാൻ,0,0,1,1
14875,uttalet,0,0,1,1
14887,utvecklingen,0,0,1,1
14888,húngaro,0,0,1,1
14889,soplo,0,0,1,1
14890,ноги,0,0,1,1
14891,σύνδεσμο,0,0,1,1
14892,открыта,0,0,1,1
14893,desacordos,0,0,1,1
14876,encyclopedically,0,0,1,1
14874,tormentosa,0,0,1,1
14849,ಚಲನಚಿತ್ರಗಳನ್ನು,0,0,1,1
14861,développées,0,0,1,1
14850,geo-location,0,0,1,1
14851,istediğiniz,0,0,1,1
14852,مدة,0,0,1,1
14854,лондоне.,0,0,1,1
14855,ഡിസന്റ്,0,0,1,1
14857,terfi,0,0,1,1
14860,procès,0,0,1,1
14862,android-enheter.,0,0,1,1
14873,representerats,0,0,1,1
14863,самостоятельно,0,0,1,1
14864,மாற்றங்களையும்,0,0,1,1
14866,умышленно,0,0,1,1
14867,നിർവചനത്തെയാണ്,0,0,1,1
14868,βλέπεις,0,0,1,1
14869,uppdatera,0,0,1,1
14872,ταξιδιών,0,0,1,1
15018,لإزعاجك.,0,0,1,1
15019,الميزات,0,0,1,1
15020,monobook,0,0,1,1
15174,தயங்குகிறது.,0,0,1,1
15167,τέρι,0,0,1,1
15168,φολιδωτή,0,0,1,1
15169,மின்னஞ்சலில்,0,0,1,1
15170,глобальной,0,0,1,1
15171,libro.,0,0,1,1
15172,hombres.,0,0,1,1
15173,ಮಾತನಾಡೋಣ.,0,0,1,1
15177,പോസിറ്റീവും,0,0,1,1
15165,detalles,0,0,1,1
15178,являлось,0,0,1,1
15180,لصحيفة,0,0,1,1
15182,പതിപ്പുകളിൽ,0,0,1,1
15184,silverbröd,0,0,1,1
15186,références »,0,0,1,1
15187,ಪಡೆಯುವುದಿಲ್ಲ,0,0,1,1
15190,രോഗികളുടെ,0,0,1,1
15166,വിശദീകരിച്ചു.,0,0,1,1
15161,reparera,0,0,1,1
15194,esboços,0,0,1,1
15148,mencionou,0,0,1,1
15137,beschreibungsfeld,0,0,1,1
15138,aufzupassen.,0,0,1,1
15141,zoos,0,0,1,1
15142,verbeter,0,0,1,1
15143,mariage.,0,0,1,1
15144,тарелке,0,0,1,1
15146,последняя,0,0,1,1
15149,correctement.,0,0,1,1
15160,математика.,0,0,1,1
15150,உலகெங்கிலுமுள்ள,0,0,1,1
15151,запросов,0,0,1,1
15152,prisões,0,0,1,1
15153,இதயத்திற்கு,0,0,1,1
15154,compraria,0,0,1,1
15156,ನಕಲಿಸಲು,0,0,1,1
15159,എഴുതാവുന്നതുകൊണ്ട്,0,0,1,1
15191,voluntarily,0,0,1,1
15195,восхищенные,0,0,1,1
15135,witty,0,0,1,1
15239,നല്കേണ്ട,0,0,1,1
15227,calúnia,0,0,1,1
15229,εκείνους,0,0,1,1
15230,tillräckligt.,0,0,1,1
15232,excesiva,0,0,1,1
15234,onion.,0,0,1,1
15236,kochten,0,0,1,1
15238,orígenes,0,0,1,1
15240,écrasements,0,0,1,1
15225,αμερόληπτα,0,0,1,1
15241,सम्मानित,0,0,1,1
15242,интерфейсы.,0,0,1,1
15245,பகுதிகளில்,0,0,1,1
15246,forståelig,0,0,1,1
15247,വകതിരിക്കാൻ,0,0,1,1
15248,dificultades,0,0,1,1
15249,தலைப்புச்,0,0,1,1
15226,делать.,0,0,1,1
15223,contrariée,0,0,1,1
15196,kaufen,0,0,1,1
15212,കാണപ്പെടുന്നത്,0,0,1,1
15197,movement.,0,0,1,1
15198,imprecise,0,0,1,1
15200,claros,0,0,1,1
15201,tears.,0,0,1,1
15203,manieren,0,0,1,1
15204,udvise,0,0,1,1
15207,jonger,0,0,1,1
15213,أشارت,0,0,1,1
15222,financeiros,0,0,1,1
15214,محادثة؟,0,0,1,1
15215,« réconciliation »,0,0,1,1
15216,القول.,0,0,1,1
15217,исследованиями.,0,0,1,1
15219,ಇಡೀ,0,0,1,1
15220,depth.,0,0,1,1
15221,masiva,0,0,1,1
15136,sidvisningar,0,0,1,1
15134,преувеличить.,0,0,1,1
15021,başlatabilirler.,0,0,1,1
15063,independiente,0,0,1,1
15055,folk.,0,0,1,1
15056,مغرورًا,0,0,1,1
15057,réservée,0,0,1,1
15058,طلاقة,0,0,1,1
15059,d'accéder,0,0,1,1
15060,нарушения,0,0,1,1
15062,soldado,0,0,1,1
15064,ತಾಯಿಯಾಗಿದ್ದು,0,0,1,1
15053,серверах,0,0,1,1
15065,omhelzen,0,0,1,1
15066,tilted,0,0,1,1
15067,avant.,0,0,1,1
15068,expertas,0,0,1,1
15069,poliert.,0,0,1,1
15070,أدناه.,0,0,1,1
15071,assert,0,0,1,1
15054,valresultaten.,0,0,1,1
15052,серебряный,0,0,1,1
15073,royaume-uni,0,0,1,1
15039,smartphones,0,0,1,1
15023,entscheidungen,0,0,1,1
15024,participate,0,0,1,1
15025,ക്ലാസിക്കൽ,0,0,1,1
15028,gewesen,0,0,1,1
15030,stehen,0,0,1,1
15032,algoritmische,0,0,1,1
15034,वॉचलिस्ट,0,0,1,1
15040,fixa.,0,0,1,1
15051,produjo,0,0,1,1
15041,разработки,0,0,1,1
15044,chances,0,0,1,1
15045,enojes,0,0,1,1
15046,nedan,0,0,1,1
15047,சந்திப்புக்கு,0,0,1,1
15048,സത്യവിരുദ്ധമായ,0,0,1,1
15050,αγγλικές,0,0,1,1
15072,circumstances.,0,0,1,1
15074,центральных,0,0,1,1
15132,المجتمعية،,0,0,1,1
15121,традиционных,0,0,1,1
15111,ορίζουν,0,0,1,1
15112,stödja,0,0,1,1
15114,प्रतिपादित,0,0,1,1
15115,нравятся,0,0,1,1
15117,spids,0,0,1,1
15119,സംരംഭം,0,0,1,1
15120,wenigen,0,0,1,1
15122,autonomie,0,0,1,1
15107,salió,0,0,1,1
15123,eetkamer,0,0,1,1
15126,verbijsterd.,0,0,1,1
15127,നല്ലതുപോലെയാണ്,0,0,1,1
15128,जावा,0,0,1,1
15129,مكثفة،,0,0,1,1
15130,инноваторству,0,0,1,1
15131,voyez.,0,0,1,1
15109,gebruiksvriendelijk,0,0,1,1
15106,لشبكات,0,0,1,1
15076,imprimables,0,0,1,1
15086,персонажами,0,0,1,1
15077,классную,0,0,1,1
15078,norvégien,0,0,1,1
15079,إثارة,0,0,1,1
15080,തുടക്കത്തിൽ,0,0,1,1
15081,जुलती,0,0,1,1
15082,ernaast,0,0,1,1
15085,kapitalistiska,0,0,1,1
15087,التجاري,0,0,1,1
15104,оставили,0,0,1,1
15091,constituyeron,0,0,1,1
15092,സ്രോതസ്സ്,0,0,1,1
15093,ويعتمد,0,0,1,1
15096,വ്യക്തിപരമായി,0,0,1,1
15098,rendez-vous.,0,0,1,1
15102,விரும்பத்தகாத,0,0,1,1
15103,கோட்டை,0,0,1,1
14788,kombination,0,0,1,1
14786,informó,0,0,1,1
15252,وتذكر,0,0,1,1
14785,hoffentlich,0,0,1,1
14473,öfkeliydi,0,0,1,1
14474,സംഭാഷണത്തിൽ‌,0,0,1,1
14475,traerte,0,0,1,1
14476,الذهبية,0,0,1,1
14478,deberían,0,0,1,1
14479,преуспевать.,0,0,1,1
14480,γουικιπίντια,0,0,1,1
14481,kodning,0,0,1,1
14482,голодаю,0,0,1,1
14484,revisados,0,0,1,1
14485,يهم.,0,0,1,1
14487,പാമരനും,0,0,1,1
14488,semenciers,0,0,1,1
14489,samenvatting,0,0,1,1
14491,dagelijkse,0,0,1,1
14492,amar,0,0,1,1
14493,അഭിപ്രായമിടുന്നതിലൂടെ,0,0,1,1
14472,பட்டியலைப்,0,0,1,1
14471,لعقد,0,0,1,1
14470,gülümsüyor,0,0,1,1
14449,έλλειψη,0,0,1,1
14440,чьих,0,0,1,1
14442,internetcensur,0,0,1,1
14444,γρήγορους,0,0,1,1
14445,guarantees,0,0,1,1
14446,സന്നദ്ധരായവരെ,0,0,1,1
14447,வேறுபட்டிருப்பதைக்,0,0,1,1
14448,sudamérica.,0,0,1,1
14453,प्रसंग,0,0,1,1
14467,facettes,0,0,1,1
14454,φυτέψω,0,0,1,1
14455,bibliotek,0,0,1,1
14458,ഒട്ടുമിക്ക,0,0,1,1
14460,auch.,0,0,1,1
14462,istediğini,0,0,1,1
14463,ഭാവിയിലെ,0,0,1,1
14465,പണികളിലേതെങ്കിലും,0,0,1,1
14494,तार्किक,0,0,1,1
14496,எழுதப்பட்டது.,0,0,1,1
14498,licenciés,0,0,1,1
14536,adaptée,0,0,1,1
14527,открытое,0,0,1,1
14528,ступит,0,0,1,1
14529,clin,0,0,1,1
14530,populära,0,0,1,1
14531,iterative,0,0,1,1
14533,experiências.,0,0,1,1
14534,നല്ലതാണെന്ന്,0,0,1,1
14538,yanında,0,0,1,1
14524,doldurma,0,0,1,1
14540,mucho.,0,0,1,1
14543,കൃത്യതയും,0,0,1,1
14544,distinguen​,0,0,1,1
14545,ലൈബ്രറി,0,0,1,1
14546,பயணி,0,0,1,1
14547,resumo,0,0,1,1
14548,വ്യാപിച്ചു,0,0,1,1
14526,geleden.,0,0,1,1
14523,கட்டுரை”யொன்று,0,0,1,1
14499,müssen.,0,0,1,1
14512,daring,0,0,1,1
14501,wegen,0,0,1,1
14503,года ,0,0,1,1
14505,ತಟ್ಟೆಯಲ್ಲಿ,0,0,1,1
14506,ಕೋನವಾಗಿದ್ದು,0,0,1,1
14509,потерянное,0,0,1,1
14510,schéma,0,0,1,1
14511,höfliche,0,0,1,1
14513,ഇന്ത്യാ,0,0,1,1
14522,sigues,0,0,1,1
14514,hésitant.,0,0,1,1
14515,miró,0,0,1,1
14516,fallstudie,0,0,1,1
14517,başlıca,0,0,1,1
14519,القلب,0,0,1,1
14520,மங்கலான,0,0,1,1
14521,தொகுப்பானது,0,0,1,1
14439,आपसी,0,0,1,1
14438,compensaban,0,0,1,1
14437,يجعلني,0,0,1,1
14348,внесена,0,0,1,1
14338,الموقف,0,0,1,1
14340,marata,0,0,1,1
14341,избегая,0,0,1,1
14342,ذا,0,0,1,1
14343,großartiger,0,0,1,1
14345,δίκαιη,0,0,1,1
14346,puéril,0,0,1,1
14349,नामक,0,0,1,1
14335,πριν.,0,0,1,1
14350,ника,0,0,1,1
14354,möjliggör,0,0,1,1
14361,sauvage,0,0,1,1
14364,காரணமாகும்.,0,0,1,1
14365,justifiée,0,0,1,1
14366,секунду.,0,0,1,1
14367,yapın.,0,0,1,1
14337,الدمية,0,0,1,1
14334,cenar,0,0,1,1
14371,ريتشارد,0,0,1,1
14318,tweede,0,0,1,1
14308,مخزنة,0,0,1,1
14311,بالك؟,0,0,1,1
14312,gezocht,0,0,1,1
14313,உயர்த்தலாம்.,0,0,1,1
14315,lindo,0,0,1,1
14316,पैसों,0,0,1,1
14317,познакомиться.,0,0,1,1
14319,förtal,0,0,1,1
14331,പോകുകയാണെങ്കിൽ.,0,0,1,1
14320,للتحرير،,0,0,1,1
14322,சூப்பில்,0,0,1,1
14323,μάτι,0,0,1,1
14324,tillbaka,0,0,1,1
14326,പറയുന്നതായും,0,0,1,1
14328,fraudes,0,0,1,1
14329,غرفة,0,0,1,1
14368,kullanılmasını,0,0,1,1
14372,عصفور,0,0,1,1
14436,обо,0,0,1,1
14424,documentos,0,0,1,1
14412,മെല്ലിയോടും,0,0,1,1
14416,coauteurs,0,0,1,1
14417,fortsetzt.,0,0,1,1
14419,വളരെക്കാലമായിരിക്കുന്നു,0,0,1,1
14420,विजित,0,0,1,1
14421,ബ്യൂറോക്രാറ്റുകൾ,0,0,1,1
14422,opgemerkt,0,0,1,1
14425,судейская,0,0,1,1
14408,synergies,0,0,1,1
14426,idi.,0,0,1,1
14427,extracellular,0,0,1,1
14428,brister.,0,0,1,1
14429,supplémentaire.,0,0,1,1
14431,obterá,0,0,1,1
14433,вернулась,0,0,1,1
14435,இதற்கான,0,0,1,1
14409,bloquer,0,0,1,1
14407,lisanslanmaktadır.,0,0,1,1
14375,തമാശയാണ്,0,0,1,1
14387,വാർത്ത,0,0,1,1
14376,hälsningar,0,0,1,1
14377,التنفيذي,0,0,1,1
14378,ಉಸಿರಾಡಲು,0,0,1,1
14379,человеческий,0,0,1,1
14383,segundos,0,0,1,1
14384,متعددة,0,0,1,1
14385,مايو,0,0,1,1
14388,комментарием.,0,0,1,1
14404,verbessern,0,0,1,1
14392,précondition,0,0,1,1
14393,ಉದಾಹರಣೆಗಳನ್ನು,0,0,1,1
14396,législation,0,0,1,1
14400,birmanês,0,0,1,1
14401,master,0,0,1,1
14402,puppets,0,0,1,1
14403,الهائلة,0,0,1,1
14550,വസ്ത്രങ്ങൾ,0,0,1,1
14551,среднем,0,0,1,1
14552,«иракская,0,0,1,1
14715,അർത്ഥമെന്താണെന്ന്,0,0,1,1
14705,आर्द्रभूमि,0,0,1,1
14706,என்றும்,0,0,1,1
14707,வெறித்தனமாக,0,0,1,1
14708,कठिन,0,0,1,1
14709,hörs,0,0,1,1
14710,ഇഷ്ടമാണെന്ന്,0,0,1,1
14711,وطريقة,0,0,1,1
14716,notablemente,0,0,1,1
14702,serait-ce,0,0,1,1
14719,ಸರಿ.,0,0,1,1
14721,télégramme,0,0,1,1
14722,z',0,0,1,1
14723,cadaver,0,0,1,1
14724,слове,0,0,1,1
14725,സൃഷ്ടിക്കും.,0,0,1,1
14727,titres,0,0,1,1
14704,سيطرة,0,0,1,1
14701,रोजमर्रा,0,0,1,1
14729,convencidas,0,0,1,1
14686,porcentaje,0,0,1,1
14672,berömda,0,0,1,1
14673,άκουσα.,0,0,1,1
14675,आंकडों,0,0,1,1
14676,catalogue,0,0,1,1
14677,மாட்டீர்கள்,0,0,1,1
14679,வழங்குகின்றது.,0,0,1,1
14685,istekte,0,0,1,1
14687,വിഷയത്തിലെ,0,0,1,1
14699,bone,0,0,1,1
14688,शुक्रिया,0,0,1,1
14689,kibarca,0,0,1,1
14690,gözyaşlarına,0,0,1,1
14691,migrated,0,0,1,1
14695,отведу,0,0,1,1
14697,sprechersymbol,0,0,1,1
14698,zor,0,0,1,1
14728,inégalitaire,0,0,1,1
14731,интервью,0,0,1,1
14670,rättvis,0,0,1,1
14774,ονομάζεται.,0,0,1,1
14765,بلغات,0,0,1,1
14766,publique,0,0,1,1
14767,fordele,0,0,1,1
14768,தேர்வில்,0,0,1,1
14770,incierto,0,0,1,1
14772,necessary,0,0,1,1
14773,تتحدث,0,0,1,1
14775,മണിക്കൂറിലും,0,0,1,1
14763,salvar,0,0,1,1
14776,l'artificiel,0,0,1,1
14777,பதிலளிக்க,0,0,1,1
14779,fluido,0,0,1,1
14780,ഉദാഹരണത്തിന്.,0,0,1,1
14781,يمتلك,0,0,1,1
14783,குரலின்,0,0,1,1
14784,sufrió,0,0,1,1
14764,യന്ത്രപഠനത്തിലാകട്ടെ,0,0,1,1
14762,दिलचस्पी,0,0,1,1
14733,görünüyordu.,0,0,1,1
14745,اثنين,0,0,1,1
14734,ಪ್ರಯಾಣವನ್ನು,0,0,1,1
14737,financement,0,0,1,1
14738,полезным,0,0,1,1
14739,نوعا,0,0,1,1
14741,പറ്റില്ല,0,0,1,1
14742,കരയരുതെന്ന്,0,0,1,1
14744,decidió,0,0,1,1
14746,واستضافة,0,0,1,1
14761,peuplements,0,0,1,1
14749,convention,0,0,1,1
14750,elección,0,0,1,1
14752,he-man,0,0,1,1
14754,embrasser,0,0,1,1
14755,твёрдым,0,0,1,1
14759,gekleidet,0,0,1,1
14760,ബുഷ്.,0,0,1,1
14671,ಅಳುತ್ತಿದ್ದರೆ,0,0,1,1
14669,precisión.,0,0,1,1
14553,primære,0,0,1,1
14591,notorias,0,0,1,1
14579,इयर,0,0,1,1
14580,latinos,0,0,1,1
14583,riddare.,0,0,1,1
14585,خطط,0,0,1,1
14586,إضافات,0,0,1,1
14587,ändrat,0,0,1,1
14589,взволнованы,0,0,1,1
14595,சுயாதீனமாக,0,0,1,1
14577,لنصبح,0,0,1,1
14596,journée,0,0,1,1
14598,ಸಿದ್ಧವಾಗಿದೆ,0,0,1,1
14599,ಸಂಬಂಧವಿದೆ,0,0,1,1
14600,coréenne,0,0,1,1
14601,диска,0,0,1,1
14602,prédictive,0,0,1,1
14604,negativt.,0,0,1,1
14578,election,0,0,1,1
14576,arkadaşlarına,0,0,1,1
14607,الوقت،,0,0,1,1
14562,medley,0,0,1,1
14554,gwh,0,0,1,1
14555,éditoriale ,0,0,1,1
14556,പുറത്തുള്ള,0,0,1,1
14558,états,0,0,1,1
14559,primario,0,0,1,1
14560,évolué,0,0,1,1
14561,hjemmesider,0,0,1,1
14563,testet,0,0,1,1
14575,gewonnen,0,0,1,1
14565,μάλλον,0,0,1,1
14567,ഒരിക്കൽ,0,0,1,1
14569,நெடு,0,0,1,1
14570,uppnå,0,0,1,1
14571,cruzamiento,0,0,1,1
14573,ficaram,0,0,1,1
14574,diaria.,0,0,1,1
14606,traummutter,0,0,1,1
14608,فيديو.,0,0,1,1
14668,détecter,0,0,1,1
14650,உணர்த்தியது.,0,0,1,1
14641,yiyebileceğim,0,0,1,1
14643,jour-là,0,0,1,1
14644,passé,0,0,1,1
14646,ಹೆದರುತ್ತಿದ್ದೆ,0,0,1,1
14647,desværre,0,0,1,1
14648,citat,0,0,1,1
14649,കോടതിയോ,0,0,1,1
14655,السعي,0,0,1,1
14636,بإنشاء,0,0,1,1
14656,balkongen,0,0,1,1
14658,değiştirilebilir,0,0,1,1
14660,பெயர்ச்சொல்லாக,0,0,1,1
14662,കൂട്ടിച്ചേർത്തെന്നുവരും.,0,0,1,1
14663,réagir,0,0,1,1
14664,privilege,0,0,1,1
14665,l'atmosphère,0,0,1,1
14640,all-inclusive,0,0,1,1
14635,खींचें।,0,0,1,1
14609,acéfalo,0,0,1,1
14619,personaje,0,0,1,1
14610,spelen,0,0,1,1
14611,ആഗ്രഹിക്കുന്നില്ല.,0,0,1,1
14612,الحالات.,0,0,1,1
14613,ಕಣ್ಣೀರಿಗೆ,0,0,1,1
14615,ನಿಖರವಾಗಿ,0,0,1,1
14616,يتقاضون,0,0,1,1
14617,sanger's,0,0,1,1
14620,allmänheten,0,0,1,1
14632,vakfı'nın,0,0,1,1
14621,paulo,0,0,1,1
14622,gitmeme,0,0,1,1
14624,பயன்படுத்துகிறோம்,0,0,1,1
14625,مصحح,0,0,1,1
14627,rein,0,0,1,1
14630,haveria,0,0,1,1
14631,igual,0,0,1,1
15250,ξαφνικά,0,0,1,1
15254,reasoning,0,0,1,1
14306,extent.,0,0,1,1
15758,معاديًا,0,0,1,1
15915,​​for,0,0,1,1
15916,നടത്തി,0,0,1,1
15917,diversified.,0,0,1,1
15919,нанесён,0,0,1,1
15921,മറന്നതിനാൽ,0,0,1,1
15922,instaladas,0,0,1,1
15923,പ്രശ്നങ്ങളൊന്നും,0,0,1,1
15924,пришел,0,0,1,1
15927,obviedad.,0,0,1,1
15928,അഭിനയിക്കുന്നവരാരെല്ലാം,0,0,1,1
15929,энергией,0,0,1,1
15930,эксперимента,0,0,1,1
15932,speed.,0,0,1,1
15933,separación,0,0,1,1
15934,appropriately,0,0,1,1
15937,l'organisation,0,0,1,1
15941,पुनर्वितरण,0,0,1,1
15912,لطيفين,0,0,1,1
15911,செய்ய.,0,0,1,1
15909,elkaar.,0,0,1,1
15894,ഉദാഹരണം,0,0,1,1
15882,acelerado,0,0,1,1
15884,mecaniste,0,0,1,1
15885,ήρθα,0,0,1,1
15886,simple •,0,0,1,1
15889,görkemli,0,0,1,1
15892,λίθους,0,0,1,1
15893,αμερόληπτη,0,0,1,1
15895,anlatırken,0,0,1,1
15908,dieux.,0,0,1,1
15896,названный,0,0,1,1
15897,clou,0,0,1,1
15898,الدعم,0,0,1,1
15901,ρωτώ,0,0,1,1
15902,peer-reviewed,0,0,1,1
15905,récuse,0,0,1,1
15906,предоставлением,0,0,1,1
15942,வாக்கியத்தில்,0,0,1,1
15945,yöntemleri,0,0,1,1
15946,المائدة,0,0,1,1
15993,bayer,0,0,1,1
15984,हल्का,0,0,1,1
15985,போன்றவற்றிலிருந்து,0,0,1,1
15986,அமைந்திருந்தது.,0,0,1,1
15988,персонаж,0,0,1,1
15989,successful.,0,0,1,1
15991,तिहाई,0,0,1,1
15992,ಮೊಂಡಾದದ್ದನ್ನು,0,0,1,1
15994,alojado,0,0,1,1
15982,hüzünlü,0,0,1,1
15996,journey.,0,0,1,1
15998,нами,0,0,1,1
15999,أجل,0,0,1,1
16002,உசாத்துணைப்,0,0,1,1
16003,cumplimiento,0,0,1,1
16004,programında,0,0,1,1
16006,ಕುಳಿತಿದ್ದ,0,0,1,1
15983,قسم,0,0,1,1
15981,conheço.,0,0,1,1
15947,وبالنسبة,0,0,1,1
15961,ಉತ್ತಮವಾಗಿರುತ್ತದೆ,0,0,1,1
15948,التقاء.,0,0,1,1
15949,வேண்டியதெல்லாம்,0,0,1,1
15950,eras,0,0,1,1
15951,word-sense,0,0,1,1
15955,متحيزًا.,0,0,1,1
15958,clés,0,0,1,1
15960,വലിച്ചിടുന്നതോ,0,0,1,1
15965,súper,0,0,1,1
15978,estender,0,0,1,1
15966,கட்டுரையொன்றை,0,0,1,1
15967,notice,0,0,1,1
15968,verhalten,0,0,1,1
15970,adapted,0,0,1,1
15972,fru,0,0,1,1
15973,கொண்டு,0,0,1,1
15977,davam,0,0,1,1
15879,technieken,0,0,1,1
15878,infieren,0,0,1,1
15877,competitive,0,0,1,1
15801,നടത്തുന്നതിനാണ്,0,0,1,1
15791,പൂർത്തിയാക്കട്ടെ.,0,0,1,1
15793,நடுநிலைமையை,0,0,1,1
15794,yazdıkları,0,0,1,1
15795,ನೇಮಿಸಿಕೊಳ್ಳಬೇಕು,0,0,1,1
15796,αναφέρονται,0,0,1,1
15797,dækker,0,0,1,1
15800,ethics,0,0,1,1
15803,vitalist,0,0,1,1
15786,schaut,0,0,1,1
15804,ಯಾರು,0,0,1,1
15807,commentaire,0,0,1,1
15808,ويليز,0,0,1,1
15809,έχουν,0,0,1,1
15810,assisté,0,0,1,1
15811,religions.,0,0,1,1
15813,erbjuder.,0,0,1,1
15788,κάνω.,0,0,1,1
15785,únicos.,0,0,1,1
15817,небольшие,0,0,1,1
15769,anime,0,0,1,1
15761,mandou,0,0,1,1
15762,उपसमुच्चय,0,0,1,1
15763,sumado,0,0,1,1
15765,produktiva.,0,0,1,1
15766,glædeligt,0,0,1,1
15767,péjorative,0,0,1,1
15768,скачивания,0,0,1,1
15770,gigaoctets,0,0,1,1
15784,underbart,0,0,1,1
15773,ficamos,0,0,1,1
15774,обобщённой,0,0,1,1
15775,многими,0,0,1,1
15780,ассоциации,0,0,1,1
15781,கேட்டிருக்கலாம்,0,0,1,1
15782,αντίχειρες,0,0,1,1
15783,recognized.,0,0,1,1
15815,للمناقشة,0,0,1,1
15818,escritura,0,0,1,1
15874,eksempel.,0,0,1,1
15860,coordination.,0,0,1,1
15852,desnecessário,0,0,1,1
15853,wikinoticias,0,0,1,1
15855,कॉपीलेफ्ट,0,0,1,1
15856,платьев,0,0,1,1
15857,surveillés.,0,0,1,1
15858,üzülmeyin.,0,0,1,1
15859,ಎದೆಗುಂದಿದಳು,0,0,1,1
15861,نظرك,0,0,1,1
15850,colder.,0,0,1,1
15862,написать,0,0,1,1
15865,production ,0,0,1,1
15866,زيارات,0,0,1,1
15868,iron,0,0,1,1
15869,no».,0,0,1,1
15870,θυμάστε.,0,0,1,1
15872,высмеивают,0,0,1,1
15851,häufiges,0,0,1,1
15848,blicke,0,0,1,1
15819,demanda,0,0,1,1
15832,repetitive,0,0,1,1
15822,مرصعة,0,0,1,1
15823,ladies,0,0,1,1
15824,register.,0,0,1,1
15825,karıştırdım,0,0,1,1
15826,slovaque,0,0,1,1
15827,crash,0,0,1,1
15830,поговорить.,0,0,1,1
15833,schrok,0,0,1,1
15847,ресторан,0,0,1,1
15835,ಜಿಗಿದರೆ,0,0,1,1
15836,denunciado,0,0,1,1
15837,bekler,0,0,1,1
15839,reconoce,0,0,1,1
15842,சுற்றுலாப்,0,0,1,1
15844,nessas,0,0,1,1
15845,എന്നതിൽ,0,0,1,1
16007,объектов,0,0,1,1
16009,ಪ್ರಕಾರ.,0,0,1,1
16011,dissimilar.,0,0,1,1
16185,नान,0,0,1,1
16175,العمومية.,0,0,1,1
16177,capturar,0,0,1,1
16178,നൽകുന്നുണ്ട്‌.,0,0,1,1
16179,femenino,0,0,1,1
16180,يضيء,0,0,1,1
16182,σπασμένη,0,0,1,1
16183,कैसी,0,0,1,1
16187,potentiel,0,0,1,1
16173,esquecem,0,0,1,1
16188,stuck,0,0,1,1
16189,capítulos,0,0,1,1
16190,wann,0,0,1,1
16191,ವಾಟ್ಸಾಪ್,0,0,1,1
16194,votações,0,0,1,1
16196,ಬಂದಿದ್ದೇನೆ,0,0,1,1
16197,infört,0,0,1,1
16174,ತಿಳಿದಿದ್ದರಿಂದ,0,0,1,1
16172,exata,0,0,1,1
16199,сомнительными,0,0,1,1
16158,വിറ്റതെന്ന്,0,0,1,1
16146,नोट,0,0,1,1
16147,rejse.,0,0,1,1
16150,treffpunkt,0,0,1,1
16151,चाहता।,0,0,1,1
16152,பங்களிப்புக்களை,0,0,1,1
16153,seventh,0,0,1,1
16154,schlecht,0,0,1,1
16160,contribuciones.,0,0,1,1
16170,smiling,0,0,1,1
16161,–.,0,0,1,1
16162,επιτυχής,0,0,1,1
16164,concours,0,0,1,1
16165,süß.,0,0,1,1
16167,populaire.,0,0,1,1
16168,low-quality,0,0,1,1
16169,extensive,0,0,1,1
16198,expertos.,0,0,1,1
16200,ನಿಧಾನಗೊಳಿಸುತ್ತದೆ,0,0,1,1
16141,unconscious,0,0,1,1
16249,ದೀರ್ಘಕಾಲದವರೆಗೆ,0,0,1,1
16236,olvida.,0,0,1,1
16240,secretive,0,0,1,1
16242,நுழைந்தார்கள்,0,0,1,1
16243,يهتم,0,0,1,1
16244,littéral,0,0,1,1
16247,olhou,0,0,1,1
16248,تماما.,0,0,1,1
16250,[...].,0,0,1,1
16232,metodudur.,0,0,1,1
16251,inhuren,0,0,1,1
16254,थाई,0,0,1,1
16258,ζεστό,0,0,1,1
16261,fared,0,0,1,1
16262,zamanı,0,0,1,1
16263,användaridentitet,0,0,1,1
16265,henvender,0,0,1,1
16234,eenmaal,0,0,1,1
16231,surgir,0,0,1,1
16201,estímulo,0,0,1,1
16212,eğitim,0,0,1,1
16202,sammanfattade,0,0,1,1
16203,ತನ್ನನ್ನು,0,0,1,1
16205,शुक्रिया।,0,0,1,1
16206,úteis,0,0,1,1
16207,вопросительным,0,0,1,1
16209,ಪ್ರಯಾಣಿಸಿತು.,0,0,1,1
16210,surpreender,0,0,1,1
16213,صاغ,0,0,1,1
16229,милю,0,0,1,1
16215,diversité,0,0,1,1
16218,drömmamma,0,0,1,1
16219,பழக்கவழக்கங்கள்,0,0,1,1
16220,केस,0,0,1,1
16222,إيه,0,0,1,1
16223,http//www.wikipedia.de/,0,0,1,1
16225,bodde,0,0,1,1
16145,poids,0,0,1,1
16139,сумасшедшие».,0,0,1,1
16015,misspellings,0,0,1,1
16053,ശാഖയുടെ,0,0,1,1
16044,chien,0,0,1,1
16046,പരസ്പരവിരുദ്ധമായ,0,0,1,1
16047,anställa,0,0,1,1
16048,identitet,0,0,1,1
16049,popüler,0,0,1,1
16050,ubicó,0,0,1,1
16051,publié.,0,0,1,1
16055,accumulation.,0,0,1,1
16042,poca.,0,0,1,1
16056,ദൂരവ്യാപകമായി,0,0,1,1
16058,теоретическим,0,0,1,1
16060,favoriet,0,0,1,1
16061,boven,0,0,1,1
16062,anlamları,0,0,1,1
16063,ledigt,0,0,1,1
16064,ಪಾಠದಲ್ಲಿ,0,0,1,1
16043,പത്രവാർത്തകളും,0,0,1,1
16040,çünkü.,0,0,1,1
16070,ಭೀಕರ,0,0,1,1
16027,revertidas,0,0,1,1
16016,wikinotícias,0,0,1,1
16017,takımın,0,0,1,1
16019,didn't.,0,0,1,1
16023,ಉಡುಪಿನಲ್ಲಿದ್ದಾಗ,0,0,1,1
16024,المطور,0,0,1,1
16025,البعض،,0,0,1,1
16026,воздействий,0,0,1,1
16028,forskningsstandarder.,0,0,1,1
16039,плакал,0,0,1,1
16029,elegante,0,0,1,1
16030,homo,0,0,1,1
16031,'x'،,0,0,1,1
16033,realización,0,0,1,1
16035,assurent,0,0,1,1
16037,funcionalidade,0,0,1,1
16038,observe.,0,0,1,1
16067,værre,0,0,1,1
16071,споров.,0,0,1,1
16138,والـ,0,0,1,1
16123,persoonlijk,0,0,1,1
16112,നിർമ്മാണം,0,0,1,1
16115,goudgoud,0,0,1,1
16116,existía,0,0,1,1
16117,combiné,0,0,1,1
16120,librement,0,0,1,1
16121,هما,0,0,1,1
16122,متنوع،,0,0,1,1
16124,glycoproteins.,0,0,1,1
16102,olgulara,0,0,1,1
16125,ошеломленным,0,0,1,1
16128,kinderspiel.,0,0,1,1
16129,رغم,0,0,1,1
16132,വിജയിച്ചാൽ,0,0,1,1
16135,listening.,0,0,1,1
16136,gevraagd,0,0,1,1
16137,dualisme,0,0,1,1
16108,vaste.,0,0,1,1
16101,ಹಾಯಿಸಿದರು.,0,0,1,1
16074,chanceux,0,0,1,1
16085,sete,0,0,1,1
16075,onmiddellijk,0,0,1,1
16076,ആവശ്യത്തിന്,0,0,1,1
16077,gillat,0,0,1,1
16078,അംഗീകരിക്കപ്പെട്ടിരിക്കുന്ന,0,0,1,1
16079,combinou,0,0,1,1
16081,enviarei,0,0,1,1
16083,δίνω,0,0,1,1
16086,pornographically,0,0,1,1
16100,латинский,0,0,1,1
16088,एईजेसब्रांड,0,0,1,1
16090,ونميل,0,0,1,1
16093,звук,0,0,1,1
16094,lesser,0,0,1,1
16095,utsatt,0,0,1,1
16096,reproducción,0,0,1,1
16098,datasets,0,0,1,1
15759,forests,0,0,1,1
15756,ഭൂരിപക്ഷം,0,0,1,1
15255,участник,0,0,1,1
15754,πρόσβασής,0,0,1,1
15421,забавное,0,0,1,1
15422,autoencoders,0,0,1,1
15423,ನೋಡುವಾಗ,0,0,1,1
15424,знак,0,0,1,1
15426,കുട്ടിക്ക്,0,0,1,1
15427,പരാമർശിച്ചിട്ടില്ല,0,0,1,1
15428,uykusunda,0,0,1,1
15430,പരിപാലിക്കുക,0,0,1,1
15431,recognition،,0,0,1,1
15433,ക്രിയയായി,0,0,1,1
15434,conventionally,0,0,1,1
15435,достоверности,0,0,1,1
15436,yiyemiyorum,0,0,1,1
15437,bereiken.,0,0,1,1
15438,coreano,0,0,1,1
15439,« pays,0,0,1,1
15440,sözcüğünden,0,0,1,1
15420,стороны.,0,0,1,1
15419,savoir.,0,0,1,1
15414,herşey,0,0,1,1
15393,yasaklanmasını,0,0,1,1
15382,dröm.,0,0,1,1
15383,ilerlemek,0,0,1,1
15385,sätt.,0,0,1,1
15386,പൂരകസംവിധാനമായി,0,0,1,1
15387,निति,0,0,1,1
15388,ಸಂಜೆ.,0,0,1,1
15392,les.,0,0,1,1
15394,avancerade,0,0,1,1
15412,നാർസിസയുടെ,0,0,1,1
15396,പറയാമോ,0,0,1,1
15398,overrasker,0,0,1,1
15400,കാണുന്ന,0,0,1,1
15403,demektir.,0,0,1,1
15404,άλλαξε,0,0,1,1
15406,προχωρήστε,0,0,1,1
15407,корни,0,0,1,1
15441,uppfattningar,0,0,1,1
15442,adoraria,0,0,1,1
15443,المفضل,0,0,1,1
15488,characterizing,0,0,1,1
15477,кто-нибудь,0,0,1,1
15479,vidas,0,0,1,1
15480,malo,0,0,1,1
15482,популярный,0,0,1,1
15484,сработает.,0,0,1,1
15485,trees.,0,0,1,1
15487,παρέα,0,0,1,1
15490,category.,0,0,1,1
15474,ужин,0,0,1,1
15493,d'éventuelles,0,0,1,1
15495,ممثلون,0,0,1,1
15496,pode.,0,0,1,1
15497,natten,0,0,1,1
15498,weniger,0,0,1,1
15500,സൗന്ദര്യമല്ലാതെ,0,0,1,1
15502,rockez,0,0,1,1
15476,directement,0,0,1,1
15472,frankrig,0,0,1,1
15444,anticonsenso,0,0,1,1
15456,கூட்டாகத்,0,0,1,1
15448,rediseñó,0,0,1,1
15449,abandonné.,0,0,1,1
15450,للاهتمام,0,0,1,1
15451,privilégio,0,0,1,1
15452,dinamarquês,0,0,1,1
15453,leckersten,0,0,1,1
15455,duda,0,0,1,1
15457,மணமான,0,0,1,1
15470,lgbt,0,0,1,1
15458,prémunir,0,0,1,1
15459,orienté,0,0,1,1
15460,испанской,0,0,1,1
15461,averió,0,0,1,1
15462,oh.you're,0,0,1,1
15463,άλλο.,0,0,1,1
15466,d'images.,0,0,1,1
15380,وتعددت,0,0,1,1
15378,conhecer,0,0,1,1
15377,നു,0,0,1,1
15294,صديقتك,0,0,1,1
15283,имеется,0,0,1,1
15284,ஆடை,0,0,1,1
15287,femhundra,0,0,1,1
15289,siguiendo,0,0,1,1
15291,[källa behövs],0,0,1,1
15292,modtager,0,0,1,1
15293,amerikalının,0,0,1,1
15295,informella,0,0,1,1
15281,പ്രവർത്തനങ്ങളിലൂടെ,0,0,1,1
15298,നിഷ്കളങ്കമായി,0,0,1,1
15299,​​ham.,0,0,1,1
15302,actif,0,0,1,1
15308,английском.,0,0,1,1
15309,ഒരുപക്ഷേ,0,0,1,1
15310,lita,0,0,1,1
15311,lyckades,0,0,1,1
15282,fomentado,0,0,1,1
15279,christianisme,0,0,1,1
15313,optaram,0,0,1,1
15265,clubic,0,0,1,1
15256,slutningen,0,0,1,1
15257,பணிவுடன்,0,0,1,1
15259,polémiques,0,0,1,1
15261,ಸುಂದರವಾಗಿದ್ದನ್ನು,0,0,1,1
15262,affedersiniz,0,0,1,1
15263,மூவரும்,0,0,1,1
15264,anime-se,0,0,1,1
15268,documented,0,0,1,1
15278,hice,0,0,1,1
15269,दिनों,0,0,1,1
15270,обнаружить,0,0,1,1
15271,ulsfo,0,0,1,1
15272,лечатся.,0,0,1,1
15273,internetentreprenören,0,0,1,1
15274,magisches,0,0,1,1
15275,മാസത്തിൽ,0,0,1,1
15312,hicieras.,0,0,1,1
15314,приводит,0,0,1,1
15376,säkert,0,0,1,1
15364,conocidas,0,0,1,1
15350,absoluta,0,0,1,1
15353,değiştirmektedir.,0,0,1,1
15354,മഹാരാഷ്ട്രയും,0,0,1,1
15358,évaluant,0,0,1,1
15360,सुनते,0,0,1,1
15361,बेवकूफी,0,0,1,1
15362,«wikileaks»​,0,0,1,1
15365,.мы,0,0,1,1
15348,planètes.,0,0,1,1
15366,adapt,0,0,1,1
15367,diferenciar,0,0,1,1
15369,बनाया,0,0,1,1
15370,validation ,0,0,1,1
15372,مصداقيتها,0,0,1,1
15373,суд,0,0,1,1
15375,atteint,0,0,1,1
15349,diffèrent,0,0,1,1
15347,तोड़,0,0,1,1
15317,distant,0,0,1,1
15330,olmaktan,0,0,1,1
15318,amüsanteste,0,0,1,1
15320,لمحاولات,0,0,1,1
15322,renovar,0,0,1,1
15323,rankad,0,0,1,1
15324,gubernamental,0,0,1,1
15327,установило,0,0,1,1
15329,संसद,0,0,1,1
15332,smaken,0,0,1,1
15345,nono,0,0,1,1
15333,ρωτήσετε.,0,0,1,1
15334,aanvullend,0,0,1,1
15335,wildlife,0,0,1,1
15336,πλήρως.,0,0,1,1
15337,istiyor,0,0,1,1
15340,parvint,0,0,1,1
15341,certainement,0,0,1,1
15504,управление,0,0,1,1
15506,cœur,0,0,1,1
15507,прощения,0,0,1,1
15680,manifestations,0,0,1,1
15665,afbryde,0,0,1,1
15666,contratarte,0,0,1,1
15667,വിക്കിയിൽ,0,0,1,1
15668,отражаться,0,0,1,1
15671,सिलीसियाई,0,0,1,1
15672,scharfe,0,0,1,1
15676,regardé,0,0,1,1
15683,observando-a.,0,0,1,1
15663,bezoek,0,0,1,1
15684,hinton.,0,0,1,1
15685,மற்றவர்களிடம்,0,0,1,1
15686,biyografi,0,0,1,1
15687,കാര്യനിർവ്വാഹകരുടെ,0,0,1,1
15688,platt,0,0,1,1
15689,أقدم,0,0,1,1
15691,أغسطس،,0,0,1,1
15664,preguntaron,0,0,1,1
15661,bevakar,0,0,1,1
15695,«андрушевской,0,0,1,1
15644,özensizlik,0,0,1,1
15637,uitzonderlijk,0,0,1,1
15638,désormais,0,0,1,1
15639,तुरंत,0,0,1,1
15640,téléchargeables,0,0,1,1
15641,जानने,0,0,1,1
15642,keskinliği,0,0,1,1
15643,istersen,0,0,1,1
15645,curta,0,0,1,1
15656,kans,0,0,1,1
15646,lehrer,0,0,1,1
15649,дампа,0,0,1,1
15650,malheureux.,0,0,1,1
15651,prompted,0,0,1,1
15652,reversiones,0,0,1,1
15654,helg.,0,0,1,1
15655,indonesian,0,0,1,1
15692,relativos,0,0,1,1
15696,மரகதங்களின்,0,0,1,1
15634,கேட்கலாம்,0,0,1,1
15742,unterbrechen.,0,0,1,1
15730,ಹೇಳೋಣ,0,0,1,1
15733,qu'auparavant.,0,0,1,1
15734,минуту,0,0,1,1
15738,automatiques,0,0,1,1
15739,s'accordent,0,0,1,1
15740,متوازن,0,0,1,1
15741,opgewonden,0,0,1,1
15743,опасения,0,0,1,1
15728,περιγραφής,0,0,1,1
15745,siècle.,0,0,1,1
15746,друзьями.,0,0,1,1
15747,mesafede,0,0,1,1
15748,fin.,0,0,1,1
15749,punhado,0,0,1,1
15750,अवलोकित,0,0,1,1
15753,கோணமாகும்,0,0,1,1
15729,outlining,0,0,1,1
15727,வகையை,0,0,1,1
15697,controvertidos​,0,0,1,1
15709,ऊपरी,0,0,1,1
15698,ಅತ್ಯುತ್ತಮವಾದದ್ದು,0,0,1,1
15699,bibliothek,0,0,1,1
15702,വെയ്കാനും,0,0,1,1
15703,पोस्टिंग,0,0,1,1
15705,أخرى؟,0,0,1,1
15706,instans,0,0,1,1
15707,denen,0,0,1,1
15710,consta,0,0,1,1
15725,оторваться.,0,0,1,1
15711,basket,0,0,1,1
15712,croissante,0,0,1,1
15713,sevdiğini,0,0,1,1
15716,தளையறு,0,0,1,1
15717,tomasz,0,0,1,1
15719,അസൈൻമെന്റുകളിൽ,0,0,1,1
15721,çoğu,0,0,1,1
15635,أسأل,0,0,1,1
15633,ഓണത്തെപ്പറ്റി,0,0,1,1
15509,أمره,0,0,1,1
15551,പാവയും,0,0,1,1
15542,ρυθμός.,0,0,1,1
15543,αναφέρετε.,0,0,1,1
15544,признаете,0,0,1,1
15546,дням,0,0,1,1
15547,konuşalım.,0,0,1,1
15548,παγκόσμιο,0,0,1,1
15549,aldığınızda,0,0,1,1
15552,l'âme,0,0,1,1
15540,transport,0,0,1,1
15553,uitlegde,0,0,1,1
15554,surprise,0,0,1,1
15555,മനസാണ്.,0,0,1,1
15558,சாலடுகள்,0,0,1,1
15560,vetting,0,0,1,1
15563,intressanta,0,0,1,1
15565,ಸಂತೋಷ.,0,0,1,1
15541,pierres,0,0,1,1
15538,participa,0,0,1,1
15568,सर्वाधिक,0,0,1,1
15522,mantidos,0,0,1,1
15510,eventuellt,0,0,1,1
15511,hoparlör,0,0,1,1
15513,guerre,0,0,1,1
15515,étions-nous.,0,0,1,1
15517,instituida,0,0,1,1
15518,ai-specific,0,0,1,1
15519,charge.,0,0,1,1
15524,mensajero,0,0,1,1
15537,بالتالي,0,0,1,1
15530,noche.,0,0,1,1
15531,മാനദണ്ഡങ്ങളുപയോഗിച്ചാണ്,0,0,1,1
15532,കണ്ടെത്തിയാൽ,0,0,1,1
15533,அச்சத்தினாலும்,0,0,1,1
15534,учётной,0,0,1,1
15535,ende.,0,0,1,1
15536,coincé,0,0,1,1
15567,computerprogrammeur,0,0,1,1
15571,africano,0,0,1,1
15632,comprometido,0,0,1,1
15618,ഇക്കാരണം,0,0,1,1
15607,lachen,0,0,1,1
15608,العشاء,0,0,1,1
15609,данными,0,0,1,1
15611,забираете,0,0,1,1
15612,endereço,0,0,1,1
15616,prétendants,0,0,1,1
15617,الاعتماد،,0,0,1,1
15620,mh,0,0,1,1
15605,അഹംഭാവമുള്ള,0,0,1,1
15622,பெறுகிறேன்.,0,0,1,1
15623,genstand,0,0,1,1
15624,volken,0,0,1,1
15625,गुजराती,0,0,1,1
15628,« facebook »,0,0,1,1
15629,schauen,0,0,1,1
15630,autorisé,0,0,1,1
15606,गणित.,0,0,1,1
15603,sırrı,0,0,1,1
15572,δεξιά,0,0,1,1
15585,عيوب,0,0,1,1
15573,القديم,0,0,1,1
15574,cuba,0,0,1,1
15578,நடத்தப்படும்.,0,0,1,1
15581,preocupaba,0,0,1,1
15582,elektronisk,0,0,1,1
15583,വന്നത്,0,0,1,1
15584,поняли,0,0,1,1
15588,வழக்கமான.,0,0,1,1
15601,motsvarigheter.,0,0,1,1
15590,ذكية.,0,0,1,1
15594,அதே,0,0,1,1
15595,fonde,0,0,1,1
15596,डूबना,0,0,1,1
15597,leiden.,0,0,1,1
15599,egotistical,0,0,1,1
15600,-month,0,0,1,1
14307,intéressé.,0,0,1,1
14305,tomaras,0,0,1,1
12384,فضلك.,0,0,1,1
12882,ತೆಗೆದುಕೊಳ್ಳಬೇಕೆಂದು,0,0,1,1
13044,ville.,0,0,1,1
13045,odasına,0,0,1,1
13046,drömde,0,0,1,1
13049,ertrage,0,0,1,1
13050,wirtschaft,0,0,1,1
13051,पड़े,0,0,1,1
13052,تنوي,0,0,1,1
13054,müssen,0,0,1,1
13055,aims,0,0,1,1
13056,kwamen.,0,0,1,1
13058,ಹತ್ತಿದಳು,0,0,1,1
13060,almuerzo,0,0,1,1
13063,nua.,0,0,1,1
13064,ρουμπίνι,0,0,1,1
13066,avbryter,0,0,1,1
13067,funcionalidad,0,0,1,1
13068,получаете.,0,0,1,1
13041,tilbage,0,0,1,1
13040,എന്താണെന്ന്‌,0,0,1,1
13038,pocas,0,0,1,1
13018,smuts,0,0,1,1
13006,town,0,0,1,1
13007,ζητήσει,0,0,1,1
13010,الجميع,0,0,1,1
13011,zusammenhang,0,0,1,1
13012,« reconnaître,0,0,1,1
13014,artikelrekommendation,0,0,1,1
13017,ഉപയോക്താക്കളിൽ,0,0,1,1
13023,ಆಶ್ಚರ್ಯವಾದರೆ,0,0,1,1
13037,kutusuna,0,0,1,1
13024,vas-tu,0,0,1,1
13026,d'intervention,0,0,1,1
13027,gabinete,0,0,1,1
13028,mammalian,0,0,1,1
13029,فريد,0,0,1,1
13033,visiteur,0,0,1,1
13036,reptiles,0,0,1,1
13069,يفوق,0,0,1,1
13070,processadas,0,0,1,1
13071,удовольствием.,0,0,1,1
13114,بإجمالي,0,0,1,1
13104,χαρούμενος,0,0,1,1
13105,измерения,0,0,1,1
13106,وتحصل,0,0,1,1
13109,ತೊಂದರೆಯಿಲ್ಲ.,0,0,1,1
13110,இணையத்தொடர்பையும்,0,0,1,1
13111,afripédia,0,0,1,1
13112,shelf.,0,0,1,1
13115,يقاس,0,0,1,1
13102,su •,0,0,1,1
13116,lieblings-smart-wort,0,0,1,1
13117,lichte,0,0,1,1
13118,ಪ್ರಾರಂಭಿಸಲಿದ್ದರೆ.,0,0,1,1
13119,αδιάφορος,0,0,1,1
13120,opgestart,0,0,1,1
13121,enciclopédico,0,0,1,1
13122,культурный,0,0,1,1
13103,interrelated,0,0,1,1
13101,describir,0,0,1,1
13072,fellow,0,0,1,1
13086,популярной,0,0,1,1
13075,சென்றார்கள்,0,0,1,1
13077,combine,0,0,1,1
13078,enlace.,0,0,1,1
13080,حاول,0,0,1,1
13081,campos,0,0,1,1
13082,displaced,0,0,1,1
13085,لذلك؟,0,0,1,1
13088,μπριτάννικα,0,0,1,1
13100,işte,0,0,1,1
13090,drown,0,0,1,1
13092,gratulera,0,0,1,1
13093,ಮಗುವಿಗೆ,0,0,1,1
13096,المجال,0,0,1,1
13097,probabilístico,0,0,1,1
13098,ख़राब,0,0,1,1
13099,ശക്തമായി,0,0,1,1
13005,включаемых,0,0,1,1
13004,விளக்கும்,0,0,1,1
13000,vandals,0,0,1,1
12926,veelen,0,0,1,1
12917,உள்ளுணர்வைக்,0,0,1,1
12918,nuevo.,0,0,1,1
12919,источник],0,0,1,1
12921,kk •,0,0,1,1
12922,perspective,0,0,1,1
12923,ആയിരക്കണക്കിനു,0,0,1,1
12925,mois.,0,0,1,1
12927,negativos,0,0,1,1
12914,arrive,0,0,1,1
12929,വന്ന്,0,0,1,1
12930,procent.,0,0,1,1
12934,έξυπνων,0,0,1,1
12935,incluían,0,0,1,1
12936,свете.,0,0,1,1
12941,somente,0,0,1,1
12942,telefonumu,0,0,1,1
12916,criterion,0,0,1,1
12913,högre,0,0,1,1
12948,porno-actrices,0,0,1,1
12895,underhållande,0,0,1,1
12885,fortune,0,0,1,1
12886,ಯಾರು.,0,0,1,1
12888,телефоном,0,0,1,1
12889,है[कृपया,0,0,1,1
12892,impossível,0,0,1,1
12893,apoiam,0,0,1,1
12894,маленькие,0,0,1,1
12896,omitidas,0,0,1,1
12908,partide,0,0,1,1
12897,удивительно.,0,0,1,1
12898,المحادثة.,0,0,1,1
12900,выборкой.,0,0,1,1
12901,दर्शाता,0,0,1,1
12903,edges,0,0,1,1
12906,لنا,0,0,1,1
12907,ನಾಳೆಗಾಗಿ,0,0,1,1
12944,protective,0,0,1,1
12949,ಕನ್ನಡಿಯಲ್ಲಿ,0,0,1,1
12995,intresserad,0,0,1,1
12981,والمتألقة.,0,0,1,1
12973,assuntos,0,0,1,1
12975,landscape,0,0,1,1
12976,забывает,0,0,1,1
12977,executados,0,0,1,1
12978,ಅವರೊಂದಿಗೆ,0,0,1,1
12979,مجموع,0,0,1,1
12980,compared,0,0,1,1
12983,agradecerles,0,0,1,1
12971,criba,0,0,1,1
12987,സാധിക്കണമെങ്കിൽ,0,0,1,1
12988,duyduğunuzda.,0,0,1,1
12990,ബിസിനസ്സ്,0,0,1,1
12991,വിരസമാണ്.,0,0,1,1
12992,إِلى,0,0,1,1
12993,bedt,0,0,1,1
12994,இடத்தைக்,0,0,1,1
12972,नेपाल,0,0,1,1
12970,phrase.,0,0,1,1
12950,ret.,0,0,1,1
12959,dicionário,0,0,1,1
12951,aseguraría,0,0,1,1
12953,aufhalten,0,0,1,1
12954,संकलित,0,0,1,1
12955,capacity,0,0,1,1
12956,பராக்,0,0,1,1
12957,كبير.,0,0,1,1
12958,എഴുതപ്പെടുന്ന,0,0,1,1
12960,anges,0,0,1,1
12969,intersidéral.,0,0,1,1
12961,ಗೊತ್ತಿಲ್ಲ,0,0,1,1
12962,ടെസ്റ്റിൽ‌,0,0,1,1
12963,موثوقة،,0,0,1,1
12964,volumétrie,0,0,1,1
12966,kurallar,0,0,1,1
12967,chacun.,0,0,1,1
12968,تمثيلا,0,0,1,1
13124,pipa,0,0,1,1
13126,wealthy,0,0,1,1
13129,प्लेटफोर्म,0,0,1,1
13282,déterminé,0,0,1,1
13273,himmel,0,0,1,1
13274,severler,0,0,1,1
13275,dolu,0,0,1,1
13276,verrichten.,0,0,1,1
13277,சொற்றொடர்.,0,0,1,1
13279,δημοφιλούς,0,0,1,1
13281,τώρα.,0,0,1,1
13283,legitimiteten,0,0,1,1
13270,രണ്ടാം,0,0,1,1
13284,создававшихся,0,0,1,1
13286,velozpedia,0,0,1,1
13287,महत्त्व,0,0,1,1
13290,tíbet,0,0,1,1
13291,компетентным,0,0,1,1
13292,இருந்தன.,0,0,1,1
13293,deveríamos,0,0,1,1
13272,വരുന്നുണ്ടെന്നും,0,0,1,1
13269,lipnet,0,0,1,1
13295,ആണി,0,0,1,1
13257,​​tag,0,0,1,1
13248,एकत्रित,0,0,1,1
13249,ஆவண,0,0,1,1
13250,extensiones,0,0,1,1
13251,afogamento,0,0,1,1
13253,deinem,0,0,1,1
13254,борисом,0,0,1,1
13255,சகோதரியாகவோ,0,0,1,1
13258,alcanzaron,0,0,1,1
13267,yere,0,0,1,1
13259,tillod,0,0,1,1
13260,comenzado,0,0,1,1
13262,ஆறு,0,0,1,1
13263,gerçekleşirse.,0,0,1,1
13264,tırnağa,0,0,1,1
13265,moois,0,0,1,1
13266,principer.,0,0,1,1
13294,sémantiques,0,0,1,1
13296,s'excuser.,0,0,1,1
13243,d'europe »,0,0,1,1
13339,marinarkeologi,0,0,1,1
13325,schon.,0,0,1,1
13329,iniciais,0,0,1,1
13330,wreed,0,0,1,1
13331,görüşemedik.,0,0,1,1
13333,kone,0,0,1,1
13335,yayımlanmış,0,0,1,1
13337,literature.,0,0,1,1
13340,ಅಷ್ಟೇನೂ,0,0,1,1
13323,दिया।विकिपीडिया,0,0,1,1
13342,дилемма.,0,0,1,1
13343,l'activité,0,0,1,1
13344,കോഫി,0,0,1,1
13345,actuele,0,0,1,1
13346,rot,0,0,1,1
13347,आयोजन,0,0,1,1
13348,സംസ്കാരവും,0,0,1,1
13324,skyldig,0,0,1,1
13321,противоречивые,0,0,1,1
13297,സ്വപ്നമാണെന്നും,0,0,1,1
13306,paciencia,0,0,1,1
13298,mannelijk,0,0,1,1
13299,наверное,0,0,1,1
13300,aulas,0,0,1,1
13301,परत,0,0,1,1
13302,interwikis,0,0,1,1
13303,مجلس,0,0,1,1
13305,عيني,0,0,1,1
13308,ബസ്,0,0,1,1
13320,catalão,0,0,1,1
13309,espere.,0,0,1,1
13310,ಸಮಸ್ಯೆಗಿಂತ,0,0,1,1
13311,encantaría,0,0,1,1
13312,publicités,0,0,1,1
13317,en.mobile.wikipedia.org,0,0,1,1
13318,[t]he,0,0,1,1
13319,разделения,0,0,1,1
13246,ontworpen.,0,0,1,1
13242,religieuse,0,0,1,1
13130,مجتمعة,0,0,1,1
13172,अन्डू,0,0,1,1
13162,കൊടുങ്കാറ്റ്,0,0,1,1
13163,humaines.,0,0,1,1
13164,instalado,0,0,1,1
13165,imkansız,0,0,1,1
13168,adding,0,0,1,1
13169,mantente,0,0,1,1
13170,étrangère,0,0,1,1
13173,கண்டறியப்பட்டது.,0,0,1,1
13160,والمساهمين،,0,0,1,1
13176,πια,0,0,1,1
13177,யோங்களே,0,0,1,1
13178,icke-vetenskaplig,0,0,1,1
13179,एडिटोरिअल,0,0,1,1
13180,repentinamente,0,0,1,1
13181,ಬೃಹತ್,0,0,1,1
13184,wiki-enciclopédias,0,0,1,1
13161,ocultados,0,0,1,1
13158,nagel,0,0,1,1
13187,fear,0,0,1,1
13147,بلودجيت,0,0,1,1
13131,frankreich,0,0,1,1
13133,многократно,0,0,1,1
13135,kennisgevingen,0,0,1,1
13137,borró,0,0,1,1
13139,croisés.,0,0,1,1
13143,repetition.,0,0,1,1
13144,والرجل,0,0,1,1
13148,घिरे,0,0,1,1
13157,riktig,0,0,1,1
13149,nederlandstalige,0,0,1,1
13150,கொண்டுள்ளது,0,0,1,1
13152,procrastination,0,0,1,1
13153,préparée,0,0,1,1
13154,നടത്തുന്നുമുണ്ട്.,0,0,1,1
13155,oficinas,0,0,1,1
13156,devia,0,0,1,1
13185,built-in,0,0,1,1
13188,dumt,0,0,1,1
13241,voulez-vous,0,0,1,1
13230,​​het,0,0,1,1
13219,உணவை,0,0,1,1
13224,empezar.,0,0,1,1
13225,источников,0,0,1,1
13226,d’idéalisme,0,0,1,1
13227,αντιμετωπίζονται.,0,0,1,1
13228,बर्क्मेन,0,0,1,1
13229,øjne,0,0,1,1
13231,серьезно,0,0,1,1
13217,weather.,0,0,1,1
13233,ಹೊಂದುವ,0,0,1,1
13234,débattues.,0,0,1,1
13235,llevaré,0,0,1,1
13236,написание,0,0,1,1
13237,optimisation.,0,0,1,1
13239,التالية,0,0,1,1
13240,affirmations,0,0,1,1
13218,أعلم.,0,0,1,1
13216,معضلة,0,0,1,1
13190,ചേരുന്നവരെ,0,0,1,1
13201,cult-like,0,0,1,1
13191,अन्तरभाषिक,0,0,1,1
13193,initiaux,0,0,1,1
13195,hond,0,0,1,1
13196,calunioso,0,0,1,1
13197,taraflarına,0,0,1,1
13198,έξι,0,0,1,1
13200,ഹായ്,0,0,1,1
13202,donations.,0,0,1,1
13214,признал,0,0,1,1
13203,katılamadım.,0,0,1,1
13204,desea,0,0,1,1
13205,vereyim,0,0,1,1
13206,magisteruppsats,0,0,1,1
13207,perdu,0,0,1,1
13209,постоянно,0,0,1,1
13212,أصدقاء,0,0,1,1
12883,جذرية,0,0,1,1
12881,برنامجا,0,0,1,1
13350,чьи,0,0,1,1
12876,violant,0,0,1,1
12532,fel.,0,0,1,1
12533,പോകണം,0,0,1,1
12534,वार्षिक,0,0,1,1
12535,nature/culture.,0,0,1,1
12536,ढांचा,0,0,1,1
12537,opgezet,0,0,1,1
12538,വ്യവസ്ഥിതികളുടെയും,0,0,1,1
12540,confusión.,0,0,1,1
12541,episodio,0,0,1,1
12542,trust,0,0,1,1
12544,blik,0,0,1,1
12545,oro.,0,0,1,1
12549,vriend.,0,0,1,1
12553,गाने,0,0,1,1
12555,நைட்,0,0,1,1
12556,житомирской,0,0,1,1
12557,coup.,0,0,1,1
12531,തങ്ങൾക്ക്,0,0,1,1
12530,inscrits,0,0,1,1
12528,bezighoudt,0,0,1,1
12513,configurations,0,0,1,1
12503,gustado,0,0,1,1
12504,exclusivement,0,0,1,1
12505,تغرق,0,0,1,1
12506,ಎನರ್ಜಿ,0,0,1,1
12509,falsch.,0,0,1,1
12511,placements.,0,0,1,1
12512,varnande,0,0,1,1
12514,بالملابس,0,0,1,1
12527,fantastik,0,0,1,1
12515,جزء,0,0,1,1
12519,leaves.,0,0,1,1
12520,الأوساخ,0,0,1,1
12521,pantalla,0,0,1,1
12522,besser.,0,0,1,1
12523,aufgeregt,0,0,1,1
12525,l'assemblée,0,0,1,1
12558,reemplazo,0,0,1,1
12560,தொடருங்கள்,0,0,1,1
12561,culturas.,0,0,1,1
12603,году».,0,0,1,1
12591,أوائل,0,0,1,1
12592,തമ്മിലുള്ള,0,0,1,1
12595,tids,0,0,1,1
12597,الجامعة,0,0,1,1
12598,excitant,0,0,1,1
12599,espace,0,0,1,1
12601,δημιουργικής,0,0,1,1
12605,udgivet.,0,0,1,1
12589,jeopardy,0,0,1,1
12606,süslü,0,0,1,1
12607,goal-seeking,0,0,1,1
12608,yttrande-,0,0,1,1
12609,കണക്കാക്കാറില്ല.,0,0,1,1
12611,interrupting,0,0,1,1
12612,l'entendement,0,0,1,1
12613,desordenado,0,0,1,1
12590,ಸಂಖ್ಯೆಯನ್ನು,0,0,1,1
12588,åkturen,0,0,1,1
12563,தலைமை,0,0,1,1
12574,تحطمت,0,0,1,1
12565,веб-серверов,0,0,1,1
12568,வழிகளைத்,0,0,1,1
12569,இருக்கின்றன,0,0,1,1
12570,സ്വാഭാവികമായി,0,0,1,1
12571,signing,0,0,1,1
12572,pace.,0,0,1,1
12573,necesidades,0,0,1,1
12576,κωδικό,0,0,1,1
12587,samband,0,0,1,1
12578,tembel,0,0,1,1
12579,biodiversity.,0,0,1,1
12580,японскими,0,0,1,1
12582,forsinkelse,0,0,1,1
12583,المشاريع,0,0,1,1
12584,sq •,0,0,1,1
12586,sunduğu,0,0,1,1
12501,d'appeler,0,0,1,1
12500,inédite,0,0,1,1
12499,pudiendo,0,0,1,1
12427,ತಲುಪಿದಾಗ,0,0,1,1
12417,sv •,0,0,1,1
12418,модные,0,0,1,1
12420,दौड़ी,0,0,1,1
12422,bob,0,0,1,1
12423,maden,0,0,1,1
12424,nourrir,0,0,1,1
12426,bilda,0,0,1,1
12428,fermée,0,0,1,1
12414,excuses,0,0,1,1
12429,felicitaciones,0,0,1,1
12430,filha.,0,0,1,1
12431,vienen,0,0,1,1
12433,мае,0,0,1,1
12434,rağmen,0,0,1,1
12436,பெறப்பட்டது.,0,0,1,1
12437,nouveau.,0,0,1,1
12415,البيروقراطيون،,0,0,1,1
12413,справочником,0,0,1,1
12440,tunisien,0,0,1,1
12401,ही।,0,0,1,1
12385,சொற்களைத்,0,0,1,1
12386,خاص,0,0,1,1
12390,naar.,0,0,1,1
12394,reconnaissant,0,0,1,1
12395,الهدف,0,0,1,1
12396,тюрьмах,0,0,1,1
12397,ಪ್ರಪಂಚದಾದ್ಯಂತ,0,0,1,1
12402,содержащий,0,0,1,1
12412,വീട്ടിലെത്തിയപ്പോൾ,0,0,1,1
12403,വിശേഷിപ്പിക്കുന്നുഅഭിപ്രായസ്വാതന്ത്ര്യം,0,0,1,1
12404,महीने,0,0,1,1
12406,പരിശീലിക്കാനുള്ള,0,0,1,1
12408,erfarenhet,0,0,1,1
12409,fuertes,0,0,1,1
12410,ثقيلة,0,0,1,1
12411,associações,0,0,1,1
12438,transformée,0,0,1,1
12441,delta,0,0,1,1
12498,സൂക്ഷ്മത,0,0,1,1
12483,பங்களிப்புகளைப்,0,0,1,1
12473,യന്ത്രത്തിൻറെ,0,0,1,1
12475,зрения.,0,0,1,1
12477,ದೇವರೇ,0,0,1,1
12479,mitigate,0,0,1,1
12480,रॉक,0,0,1,1
12481,ಪಂದ್ಯವನ್ನು,0,0,1,1
12482,латинские,0,0,1,1
12484,conservador,0,0,1,1
12471,своему,0,0,1,1
12485,ತಿರುಗಿಸಿದೆ.,0,0,1,1
12488,वस्तुओं,0,0,1,1
12492,narcisse.,0,0,1,1
12493,personligt,0,0,1,1
12494,ejemplo.,0,0,1,1
12495,folkrepubliken,0,0,1,1
12496,exemplifierar,0,0,1,1
12472,ತಯಾರಿಸಲು,0,0,1,1
12470,t'ai,0,0,1,1
12442,adverte,0,0,1,1
12457,n'avaient,0,0,1,1
12443,meritsystemverktyg,0,0,1,1
12445,связывания,0,0,1,1
12447,decirnos,0,0,1,1
12449,исходным,0,0,1,1
12451,разрешение.,0,0,1,1
12454,इयर्स,0,0,1,1
12456,framförs,0,0,1,1
12458,ನಿನ್ನೆ,0,0,1,1
12469,prenumerera,0,0,1,1
12459,'we're,0,0,1,1
12460,अलाइक,0,0,1,1
12463,высшим,0,0,1,1
12464,bretón,0,0,1,1
12465,söylemek.,0,0,1,1
12467,ദൈവത്തെപ്പോലെ,0,0,1,1
12468,yiyecek,0,0,1,1
12614,lecteurs.,0,0,1,1
12615,egendom”,0,0,1,1
12616,infeliz.,0,0,1,1
12796,anlattı,0,0,1,1
12778,kritiska,0,0,1,1
12781,seriously,0,0,1,1
12783,الإداريون,0,0,1,1
12785,you.if,0,0,1,1
12786,أعضاء,0,0,1,1
12789,correções,0,0,1,1
12793,observadores,0,0,1,1
12797,التي،,0,0,1,1
12775,руководствуются,0,0,1,1
12798,ಹಿಂತಿರುಗಿಸುತ್ತೇನೆ.,0,0,1,1
12799,listor,0,0,1,1
12800,लोड,0,0,1,1
12803,redigerat,0,0,1,1
12804,abla,0,0,1,1
12805,различна,0,0,1,1
12808,vakgebieden,0,0,1,1
12777,teneinde,0,0,1,1
12774,നേരിട്ടുള്ള,0,0,1,1
12810,பேச்சுப்பக்கத்தைப்,0,0,1,1
12759,விதத்தில்,0,0,1,1
12750,मानक,0,0,1,1
12751,identification.,0,0,1,1
12752,रूचि,0,0,1,1
12753,contribution »,0,0,1,1
12755,الشديد.,0,0,1,1
12757,mundiais,0,0,1,1
12758,overleden,0,0,1,1
12760,اقتباس,0,0,1,1
12772,neiging,0,0,1,1
12761,बड़ी,0,0,1,1
12762,correos,0,0,1,1
12763,തടസ്സപ്പെടുത്തുന്നു.,0,0,1,1
12764,متجهة,0,0,1,1
12766,ζωή.,0,0,1,1
12768,ей,0,0,1,1
12771,reformed,0,0,1,1
12809,അതിശയിപ്പിച്ചു,0,0,1,1
12811,behandeld.,0,0,1,1
12743,belirtmek,0,0,1,1
12858,meridional,0,0,1,1
12847,criminosas,0,0,1,1
12850,планет»,0,0,1,1
12851,себе.,0,0,1,1
12852,compuesta,0,0,1,1
12855,interrogação.,0,0,1,1
12856,сети.,0,0,1,1
12857,موسوعي,0,0,1,1
12859,waardeer,0,0,1,1
12845,– million,0,0,1,1
12863,പരസ്യപ്രചരണമോ,0,0,1,1
12864,galeries,0,0,1,1
12865,sueca,0,0,1,1
12867,بالعودة,0,0,1,1
12868,genişti,0,0,1,1
12872,datter.,0,0,1,1
12873,guarantee,0,0,1,1
12846,besøge,0,0,1,1
12844,टक्कर,0,0,1,1
12813,повысили,0,0,1,1
12829,വിക്കിയിലെ,0,0,1,1
12815,değiştirmiştir.,0,0,1,1
12816,ettiğinizden,0,0,1,1
12817,εκτυπωθεί.,0,0,1,1
12818,deelname,0,0,1,1
12819,पांच,0,0,1,1
12820,cultured,0,0,1,1
12828,combined,0,0,1,1
12830,établies,0,0,1,1
12843,macro,0,0,1,1
12832,autrui,0,0,1,1
12834,conversar,0,0,1,1
12835,discrepó,0,0,1,1
12836,флорида.,0,0,1,1
12837,ചോദിക്കുമ്പോൾ,0,0,1,1
12841,compensations,0,0,1,1
12842,நர்சிசாவின்,0,0,1,1
12749,навсегда,0,0,1,1
12742,திட்டமாக,0,0,1,1
12618,означающей,0,0,1,1
12658,troops,0,0,1,1
12649,[la],0,0,1,1
12650,compañeros,0,0,1,1
12651,ಪಕ್ಕದಲ್ಲಿರುವ,0,0,1,1
12652,சேனலான,0,0,1,1
12653,frappez,0,0,1,1
12654,голосов,0,0,1,1
12657,विकिसोर्स,0,0,1,1
12659,γλυκό,0,0,1,1
12647,உரையாடலின்,0,0,1,1
12660,ontvoering,0,0,1,1
12661,thousand,0,0,1,1
12664,gebruikmaakte,0,0,1,1
12668,taşlarından,0,0,1,1
12670,لvice,0,0,1,1
12671,perjuicio,0,0,1,1
12672,sporters,0,0,1,1
12648,fotografias,0,0,1,1
12645,düster,0,0,1,1
12675,desinformation.,0,0,1,1
12630,stunning.,0,0,1,1
12619,visant,0,0,1,1
12621,പ്രതിബിംബത്തിൽ,0,0,1,1
12622,ನೋಡುತ್ತೀರಿ,0,0,1,1
12623,dropping,0,0,1,1
12624,cnet,0,0,1,1
12625,regardait,0,0,1,1
12626,حياديتها،,0,0,1,1
12631,values.,0,0,1,1
12644,varsågod.,0,0,1,1
12632,يضم,0,0,1,1
12635,नंबर्स,0,0,1,1
12637,tropics,0,0,1,1
12638,granska,0,0,1,1
12639,asturies,0,0,1,1
12642,dutch,0,0,1,1
12643,എഴുതാൻപോരുന്നവരാ‍യാൽ,0,0,1,1
12673,рунета,0,0,1,1
12677,التفرد,0,0,1,1
12738,wikipediaförfattarna,0,0,1,1
12728,ಸಂಗತಿಯಿದೆ,0,0,1,1
12714,informático,0,0,1,1
12718,preparé,0,0,1,1
12719,أربكتك,0,0,1,1
12721,falava,0,0,1,1
12724,blocked,0,0,1,1
12725,séparable,0,0,1,1
12726,ммм.,0,0,1,1
12730,zh-min-nan •,0,0,1,1
12711,неразумным.,0,0,1,1
12731,sözcüğü,0,0,1,1
12732,istiyorsanız.,0,0,1,1
12733,البرمجية،,0,0,1,1
12734,нарцис.,0,0,1,1
12735,dê,0,0,1,1
12736,sürekli,0,0,1,1
12737,mulher,0,0,1,1
12713,الاقتباس,0,0,1,1
12710,proponía,0,0,1,1
12679,نشرت,0,0,1,1
12693,जोर,0,0,1,1
12681,πνιγεί,0,0,1,1
12682,μέσω,0,0,1,1
12685,lift,0,0,1,1
12686,tuyau,0,0,1,1
12687,jihadistes,0,0,1,1
12688,عروض.,0,0,1,1
12689,gymnasieexamen,0,0,1,1
12694,infrequent,0,0,1,1
12708,أبريل,0,0,1,1
12695,இவை,0,0,1,1
12697,owing,0,0,1,1
12700,wikcionario,0,0,1,1
12701,राजनीतिक,0,0,1,1
12703,unreliable.,0,0,1,1
12706,ശൂന്യമായ,0,0,1,1
12707,ऑकिटन,0,0,1,1
13349,absolutely,0,0,1,1
13351,mènent,0,0,1,1
14304,viveria,0,0,1,1
13824,permettrait,0,0,1,1
13980,नही।,0,0,1,1
13983,дочерью,0,0,1,1
13985,связывают,0,0,1,1
13986,uitsluitend,0,0,1,1
13987,åtminstone,0,0,1,1
13988,tillåter,0,0,1,1
13989,transformative,0,0,1,1
13992,المستقل,0,0,1,1
13995,движок,0,0,1,1
13996,ಹಾಕಿದರೆ,0,0,1,1
13998,krydser,0,0,1,1
13999,unikke,0,0,1,1
14000,учителя,0,0,1,1
14001,kaynaklarla,0,0,1,1
14005,sociólogos,0,0,1,1
14006,காப்புரிமை,0,0,1,1
14007,செய்யும்.,0,0,1,1
13979,कृत्रिम,0,0,1,1
13978,dantas.,0,0,1,1
13977,narcisse's,0,0,1,1
13965,snail,0,0,1,1
13955,आत्महत्या,0,0,1,1
13956,incompatibles,0,0,1,1
13957,उत्पीड़क,0,0,1,1
13958,தொடர்பில்,0,0,1,1
13960,maruz,0,0,1,1
13963,rapporte,0,0,1,1
13964,принято,0,0,1,1
13966,அழைத்துச்,0,0,1,1
13976,aristotle,0,0,1,1
13967,grafia,0,0,1,1
13969,കൃത്രിമ,0,0,1,1
13970,പ്രക്രിയയിലൂടെ,0,0,1,1
13972,galego,0,0,1,1
13973,disseram,0,0,1,1
13974,tranche,0,0,1,1
13975,islas,0,0,1,1
14008,финансирование.,0,0,1,1
14010,प्रोग्रामिंग,0,0,1,1
14011,روعة,0,0,1,1
14058,başarılı,0,0,1,1
14046,anthropique.,0,0,1,1
14049,அதையே,0,0,1,1
14052,protegidos,0,0,1,1
14053,टूट,0,0,1,1
14054,பரிசீலித்து,0,0,1,1
14055,ναρκισσισμός,0,0,1,1
14056,logistique,0,0,1,1
14060,लम्बे,0,0,1,1
14044,myntas,0,0,1,1
14063,بالعرض,0,0,1,1
14065,skribenterna.,0,0,1,1
14068,തിരുത്താനും,0,0,1,1
14071,തിരിച്ചറിയാൻ,0,0,1,1
14073,france-presse,0,0,1,1
14074,duyduğunuzda,0,0,1,1
14075,prétentieux,0,0,1,1
14045,ಯೋಚಿಸಲು,0,0,1,1
14041,gördüğünden,0,0,1,1
14013,ഉദാഹരണങ്ങളിലെ,0,0,1,1
14026,cliquant,0,0,1,1
14014,individuo,0,0,1,1
14018,théoriques,0,0,1,1
14021,içeriklerinde,0,0,1,1
14022,ocidental,0,0,1,1
14023,saai.,0,0,1,1
14024,compréhensive,0,0,1,1
14025,potentiel.,0,0,1,1
14027,فصاعدًا.,0,0,1,1
14040,आलोचनाओं,0,0,1,1
14028,ईमानदारी,0,0,1,1
14030,ഉറങ്ങുമ്പോൾ,0,0,1,1
14031,historians,0,0,1,1
14033,niet-bestaande,0,0,1,1
14034,ವಿವರಿಸುತ್ತಾರೆ.,0,0,1,1
14037,кэшем,0,0,1,1
14039,ഉണ്ടായിരിക്കണമെന്ന്,0,0,1,1
13953,gaming,0,0,1,1
13949,affranchir,0,0,1,1
13948,real-world,0,0,1,1
13869,installations,0,0,1,1
13857,drunkning,0,0,1,1
13858,المحررين،,0,0,1,1
13861,ನಿಲ್ಲಿಸಿದಂತೆ,0,0,1,1
13862,collectif,0,0,1,1
13863,personnes[ai],0,0,1,1
13864,developmental,0,0,1,1
13868,التعتيم,0,0,1,1
13870,யூ,0,0,1,1
13852,favoriete,0,0,1,1
13872,apparition,0,0,1,1
13875,kalifornien.,0,0,1,1
13876,woordenboek,0,0,1,1
13878,fonctionnement ,0,0,1,1
13879,filarkivet,0,0,1,1
13880,ليسوا,0,0,1,1
13881,dört,0,0,1,1
13854,وإحلال,0,0,1,1
13851,squelette,0,0,1,1
13884,डॉङ्ग,0,0,1,1
13835,हंसना,0,0,1,1
13826,പാടേ,0,0,1,1
13828,değiştirmekte,0,0,1,1
13830,сасаи,0,0,1,1
13831,पाठों,0,0,1,1
13832,ψηφιακή,0,0,1,1
13833,അപേക്ഷിച്ച്,0,0,1,1
13834,κανόνααλλά,0,0,1,1
13837,மேற்பார்வையின்,0,0,1,1
13849,திருமணத்தில்,0,0,1,1
13840,copo,0,0,1,1
13841,d'applications,0,0,1,1
13842,équilibrés,0,0,1,1
13843,membre,0,0,1,1
13845,نذهب,0,0,1,1
13846,roles,0,0,1,1
13847,l'expérimentation,0,0,1,1
13882,октябре,0,0,1,1
13885,massivement,0,0,1,1
13945,bars,0,0,1,1
13929,aramada,0,0,1,1
13920,الكهولة.,0,0,1,1
13922,приходят,0,0,1,1
13923,limonpedia,0,0,1,1
13925,accompagné,0,0,1,1
13926,ηχείο.,0,0,1,1
13927,narsizaydı,0,0,1,1
13928,quieras,0,0,1,1
13932,adicionais,0,0,1,1
13917,castelo,0,0,1,1
13933,« passage,0,0,1,1
13934,τύπος,0,0,1,1
13936,rahatsızlık,0,0,1,1
13938,asunto.,0,0,1,1
13939,foton,0,0,1,1
13941,proje,0,0,1,1
13944,forfærdelig,0,0,1,1
13918,présidentielles,0,0,1,1
13913,மூழ்குவதைக்,0,0,1,1
13886,azul,0,0,1,1
13898,बजे,0,0,1,1
13887,drop,0,0,1,1
13888,المحررون,0,0,1,1
13889,lección,0,0,1,1
13892,पाऊँगी।,0,0,1,1
13894,neglen,0,0,1,1
13896,рой,0,0,1,1
13897,utiliseriez,0,0,1,1
13902,перевода,0,0,1,1
13912,освещения,0,0,1,1
13903,foran,0,0,1,1
13904,votos,0,0,1,1
13907,velocipedia.,0,0,1,1
13908,probabilidades,0,0,1,1
13909,buildings,0,0,1,1
13910,olhada,0,0,1,1
13911,allés,0,0,1,1
14077,استخدم,0,0,1,1
14078,seyahatlerini,0,0,1,1
14080,الحظر,0,0,1,1
14246,ποτήρι,0,0,1,1
14236,konst,0,0,1,1
14237,irgendwie,0,0,1,1
14239,ശരിയാക്കിയിട്ടുണ്ടോ,0,0,1,1
14240,ಸೆಕೆಂಡಿಗೆ,0,0,1,1
14241,сюда,0,0,1,1
14242,خطيرة،,0,0,1,1
14244,hornear,0,0,1,1
14247,broma,0,0,1,1
14231,பள்ளியில்,0,0,1,1
14248,non-avian,0,0,1,1
14249,вставлять,0,0,1,1
14250,l’occasion,0,0,1,1
14251,blindtester,0,0,1,1
14252,شروط,0,0,1,1
14253,ನಿಲ್ಲಿಸಿ,0,0,1,1
14254,wilson,0,0,1,1
14232,ökningen,0,0,1,1
14230,neutraliteten,0,0,1,1
14256,obtusa.,0,0,1,1
14214,pedazo,0,0,1,1
14195,duymak,0,0,1,1
14196,onafhankelijk,0,0,1,1
14198,conmigo.,0,0,1,1
14199,lei.,0,0,1,1
14204,identifierade,0,0,1,1
14207,ನಡೆಯುತ್ತಿಲ್ಲ,0,0,1,1
14208,ಒಲವು,0,0,1,1
14215,പഠിക്കാൻ,0,0,1,1
14229,ordenadas,0,0,1,1
14216,tested,0,0,1,1
14217,«нейтральной,0,0,1,1
14218,συμβεί,0,0,1,1
14221,المساعدة,0,0,1,1
14223,ನೆಚ್ಚಿನ,0,0,1,1
14227,indivíduos,0,0,1,1
14228,suscribirte,0,0,1,1
14255,bioinformatics,0,0,1,1
14258,assuré,0,0,1,1
14193,forçait,0,0,1,1
14294,обучаемой,0,0,1,1
14286,ficaria,0,0,1,1
14287,évidence.,0,0,1,1
14289,beschäftigt.,0,0,1,1
14290,മുന്നോട്ടുപോകുന്നത്.,0,0,1,1
14291,மறந்துவிடுவார்.,0,0,1,1
14292,заблокировать,0,0,1,1
14293,βικιταξίδια,0,0,1,1
14295,விஷயம்.,0,0,1,1
14284,discouraged.,0,0,1,1
14297,lages,0,0,1,1
14298,eua.,0,0,1,1
14299,உருவாக்கி,0,0,1,1
14300,connaissances ».,0,0,1,1
14301,предметов,0,0,1,1
14302,yemeği,0,0,1,1
14303,കിട്ടുന്ന,0,0,1,1
14285,diretora,0,0,1,1
14282,staarde,0,0,1,1
14259,имеющей,0,0,1,1
14270,сбудется,0,0,1,1
14260,количеством,0,0,1,1
14261,långsammare.,0,0,1,1
14264,blunt,0,0,1,1
14265,evliliği,0,0,1,1
14266,ഇരുപതിനായിരം,0,0,1,1
14268,തേടുകയാണ്,0,0,1,1
14269,സഹായിക്കുമോ,0,0,1,1
14271,comparación,0,0,1,1
14281,जाएगी।,0,0,1,1
14272,metin,0,0,1,1
14273,ursprungligen,0,0,1,1
14274,polerad,0,0,1,1
14275,reich,0,0,1,1
14276,şaşırttığında,0,0,1,1
14279,фразу.,0,0,1,1
14280,നടുങ്ങിപ്പോയി,0,0,1,1
14194,ಕ್ಷಣದಲ್ಲಿ,0,0,1,1
14192,ನಕಾರಾತ್ಮಕ,0,0,1,1
14081,dåsedansk,0,0,1,1
14120,derivative,0,0,1,1
14113,لكتاباتهم،,0,0,1,1
14114,فأحب,0,0,1,1
14115,captar,0,0,1,1
14116,suscripción,0,0,1,1
14117,gelmesi,0,0,1,1
14118,पदोन्नति,0,0,1,1
14119,ifølge,0,0,1,1
14122,προχώρα.,0,0,1,1
14111,குழுவொன்று,0,0,1,1
14123,неверными,0,0,1,1
14124,अंग्रेजी-भाषा,0,0,1,1
14125,​​persoon,0,0,1,1
14127,d'objectifs,0,0,1,1
14128,пользователям,0,0,1,1
14129,പരിശീലനങ്ങളെക്കുറിച്ചും,0,0,1,1
14130,cape,0,0,1,1
14112,ಮಧ್ಯಾಹ್ನದ,0,0,1,1
14110,സന്തുലിതമായ,0,0,1,1
14135,கட்டுரையைத்,0,0,1,1
14096,administração,0,0,1,1
14084,ക്രൂരതയും,0,0,1,1
14085,التعبير,0,0,1,1
14087,argumentava,0,0,1,1
14092,refoulée,0,0,1,1
14093,ello.,0,0,1,1
14094,बनाये,0,0,1,1
14095,படையினருக்கு,0,0,1,1
14097,медалью,0,0,1,1
14107,καταλάβει,0,0,1,1
14099,d'anthropomorphisme ».,0,0,1,1
14101,никаких,0,0,1,1
14102,فمثلا.,0,0,1,1
14103,மேஜையில்,0,0,1,1
14104,τάση,0,0,1,1
14105,scared,0,0,1,1
14106,hossein,0,0,1,1
14131,grausam.,0,0,1,1
14136,oförenligt,0,0,1,1
14191,corresponsales,0,0,1,1
14180,διάφορες,0,0,1,1
14171,τρομερό,0,0,1,1
14172,précaution,0,0,1,1
14173,approfondir,0,0,1,1
14174,ಕಾರ್ಯಯೋಜನೆಗಳಿವೆ,0,0,1,1
14175,كفعل,0,0,1,1
14176,لاحق,0,0,1,1
14178,फ़रवरी,0,0,1,1
14181,प्यारा,0,0,1,1
14169,læsere,0,0,1,1
14183,registra,0,0,1,1
14184,bilden,0,0,1,1
14185,ശാഖയായ,0,0,1,1
14186,μπαράκ,0,0,1,1
14188,എന്തുണ്ട്,0,0,1,1
14189,dull.,0,0,1,1
14190,wetenschappers,0,0,1,1
14170,заметьте,0,0,1,1
14167,vänta.,0,0,1,1
14138,épidémique,0,0,1,1
14150,délicieux,0,0,1,1
14140,قدمت,0,0,1,1
14141,συνάντησε,0,0,1,1
14143,ಯಾವುದರ,0,0,1,1
14144,ಬಳಕೆಗಾಗಿ,0,0,1,1
14145,kilomètre,0,0,1,1
14147,വൃത്തികെട്ട,0,0,1,1
14148,kanun,0,0,1,1
14151,mejore,0,0,1,1
14166,foros,0,0,1,1
14153,സിസോപ്പുകൾ,0,0,1,1
14155,estimado,0,0,1,1
14156,الجيد.,0,0,1,1
14159,spécificité,0,0,1,1
14162,gfdl[e].,0,0,1,1
14164,ಸುಸೇವ್,0,0,1,1
14165,സമാനമായത്,0,0,1,1
13825,ಮೆಸೆಂಜರ್,0,0,1,1
13823,aussieht,0,0,1,1
13352,survives,0,0,1,1
13822,സുഹൃത്തിനെ,0,0,1,1
13508,prochain,0,0,1,1
13509,feit,0,0,1,1
13510,améliorer ».,0,0,1,1
13511,تتعرض,0,0,1,1
13512,backpropagated,0,0,1,1
13514,२०००००,0,0,1,1
13517,v.ogvimage_optionsin,0,0,1,1
13518,zomer,0,0,1,1
13519,المنزلي,0,0,1,1
13520,climatique,0,0,1,1
13521,destacando,0,0,1,1
13522,d'interrogation.,0,0,1,1
13523,immediate,0,0,1,1
13527,aldı.,0,0,1,1
13529,മാതൃകകളെ,0,0,1,1
13530,chain,0,0,1,1
13531,தூங்கும்போது,0,0,1,1
13507,ವರ್ತಿಸಿದ,0,0,1,1
13506,പതിപ്പാണ്‌,0,0,1,1
13505,adım,0,0,1,1
13487,находящейся,0,0,1,1
13476,ಕಾಣಿಸುತ್ತಾನೆ.,0,0,1,1
13478,anti-consensus,0,0,1,1
13480,uppringare,0,0,1,1
13483,फेसबुक,0,0,1,1
13484,souhaitée.,0,0,1,1
13485,people”,0,0,1,1
13486,fonctionnent,0,0,1,1
13490,naturalistes,0,0,1,1
13504,രെക്കഗ്നിഷൻ,0,0,1,1
13491,englen,0,0,1,1
13493,கடவுளே,0,0,1,1
13494,l'encyclopédie[t],0,0,1,1
13496,يغرق,0,0,1,1
13497,permaneció,0,0,1,1
13498,നിർബന്ധമില്ല.,0,0,1,1
13500,ارتباط,0,0,1,1
13532,kvartal,0,0,1,1
13535,ηλεκτρονική,0,0,1,1
13538,arbitraje,0,0,1,1
13581,நிறுத்த,0,0,1,1
13573,उपडोमेन,0,0,1,1
13574,nævnt,0,0,1,1
13575,ابق,0,0,1,1
13576,presentan,0,0,1,1
13577,بإصلاح,0,0,1,1
13578,motivations,0,0,1,1
13580,préoccupe,0,0,1,1
13582,ഒന്നിച്ച്,0,0,1,1
13570,വംശജരെക്കാളും,0,0,1,1
13584,valeurs….,0,0,1,1
13585,addressed.,0,0,1,1
13586,conocerte,0,0,1,1
13587,éditorial.,0,0,1,1
13590,tomado,0,0,1,1
13591,gelişimini,0,0,1,1
13592,projeler,0,0,1,1
13572,nie,0,0,1,1
13566,المسجليين.,0,0,1,1
13540,essen.,0,0,1,1
13553,neuroscience,0,0,1,1
13543,شاهدها,0,0,1,1
13544,качаетесь,0,0,1,1
13545,déclarer,0,0,1,1
13546,написал,0,0,1,1
13547,crossed,0,0,1,1
13551,i-faktor,0,0,1,1
13552,ro •,0,0,1,1
13554,ഡച്ച്,0,0,1,1
13565,समुच्चय,0,0,1,1
13556,ക്ലസ്റ്ററിംഗ്,0,0,1,1
13557,d'archives.,0,0,1,1
13558,внесёнными,0,0,1,1
13559,ಪದಕ್ಕೆ,0,0,1,1
13560,preguntarte,0,0,1,1
13563,casarse,0,0,1,1
13564,internautas,0,0,1,1
13475,offrent,0,0,1,1
13474,intermingled,0,0,1,1
13472,идут,0,0,1,1
13397,milliers,0,0,1,1
13385,oprichtte,0,0,1,1
13387,appelées,0,0,1,1
13388,процессе.,0,0,1,1
13389,сестра,0,0,1,1
13390,aliments,0,0,1,1
13395,поколение,0,0,1,1
13396,samples.,0,0,1,1
13398,bitirmeme,0,0,1,1
13380,kvalitetssäkring,0,0,1,1
13399,l'aspect,0,0,1,1
13400,φανταστείτε,0,0,1,1
13401,assign,0,0,1,1
13402,da.m.wikipedia.org,0,0,1,1
13403,كثيرين,0,0,1,1
13405,ಹುಡುಕಾಟದಲ್ಲಿ,0,0,1,1
13406,færre,0,0,1,1
13381,vatten,0,0,1,1
13379,meleğe,0,0,1,1
13410,workaround,0,0,1,1
13364,manned,0,0,1,1
13353,κρύο,0,0,1,1
13354,gyldent,0,0,1,1
13358,reappeared.,0,0,1,1
13359,библиотеки».,0,0,1,1
13360,l'article[p].,0,0,1,1
13361,zweiten,0,0,1,1
13363,праве.,0,0,1,1
13365,സഹോദരിയേ,0,0,1,1
13378,société.,0,0,1,1
13366,собрания,0,0,1,1
13367,slott,0,0,1,1
13368,modificación,0,0,1,1
13370,decrease,0,0,1,1
13371,savait,0,0,1,1
13373,hardcore,0,0,1,1
13376,கூட.,0,0,1,1
13409,beynimizi,0,0,1,1
13411,geïnteresseerd.,0,0,1,1
13470,principios​,0,0,1,1
13455,உதவும்,0,0,1,1
13444,दोंनों,0,0,1,1
13445,ക്രൂരമായിരുന്നു,0,0,1,1
13447,अनावश्यक,0,0,1,1
13448,लिखती,0,0,1,1
13450,மாலை,0,0,1,1
13451,våren,0,0,1,1
13452,ценю,0,0,1,1
13456,оценочный,0,0,1,1
13441,ಅದೃಷ್ಟಶಾಲಿ,0,0,1,1
13457,barn.,0,0,1,1
13458,قبيح,0,0,1,1
13459,kenne.,0,0,1,1
13462,വിശദീകരിച്ചു,0,0,1,1
13463,nupedias,0,0,1,1
13464,मालूम।,0,0,1,1
13469,corrections,0,0,1,1
13443,pertinence.,0,0,1,1
13440,sözünü,0,0,1,1
13412,பயனரோ,0,0,1,1
13423,konstaterar,0,0,1,1
13414,imprimir,0,0,1,1
13415,suivante,0,0,1,1
13416,fairness,0,0,1,1
13417,മനുഷ്യനാണ്,0,0,1,1
13419,computación,0,0,1,1
13420,edelim,0,0,1,1
13422,almalıyız,0,0,1,1
13428,surpreendentemente,0,0,1,1
13439,счёт,0,0,1,1
13430,stad.,0,0,1,1
13431,pushing,0,0,1,1
13434,gern,0,0,1,1
13435,altı,0,0,1,1
13436,നൽകുന്നതിന്,0,0,1,1
13437,vikidia,0,0,1,1
13438,desconsolada,0,0,1,1
13593,ಮಾಂಸದ,0,0,1,1
13594,represalias.,0,0,1,1
13595,составление,0,0,1,1
13750,limitada,0,0,1,1
13738,hörde,0,0,1,1
13739,προσωπικά,0,0,1,1
13740,äter,0,0,1,1
13742,paramètres,0,0,1,1
13745,исследовательский,0,0,1,1
13746,приятным.,0,0,1,1
13749,wife-to-be,0,0,1,1
13752,ആദ്യതാളിൽ,0,0,1,1
13736,نائمة,0,0,1,1
13753,goudbrood,0,0,1,1
13756,¿cuáles,0,0,1,1
13757,ദുസ്വപ്നം,0,0,1,1
13758,столкнулся,0,0,1,1
13759,палец,0,0,1,1
13760,kapitalismen,0,0,1,1
13761,طرق,0,0,1,1
13737,caracterización,0,0,1,1
13733,إدارتها,0,0,1,1
13766,عمومًا،,0,0,1,1
13721,കാര്യനിർവ്വാഹകരെ,0,0,1,1
13713,കാണപ്പെട്ടു,0,0,1,1
13714,dichotomiquement,0,0,1,1
13715,والآخر,0,0,1,1
13716,kent,0,0,1,1
13717,അതു,0,0,1,1
13718,experiments,0,0,1,1
13720,almanızı,0,0,1,1
13722,asustado,0,0,1,1
13732,happened,0,0,1,1
13723,пять,0,0,1,1
13724,beroende,0,0,1,1
13725,[المزيد].,0,0,1,1
13726,സാക്ഷാത്കരിക്കുമെന്ന്,0,0,1,1
13727,прогнозирования,0,0,1,1
13729,aniversario,0,0,1,1
13730,ക്രൂരമാണ്.,0,0,1,1
13765,உற்சாகப்படுத்த,0,0,1,1
13768,επιθετικό,0,0,1,1
13711,وطعمه,0,0,1,1
13809,dédié,0,0,1,1
13799,практически,0,0,1,1
13800,الموسوعتين,0,0,1,1
13802,الاجتماعي,0,0,1,1
13803,genoemde,0,0,1,1
13804,крутятся,0,0,1,1
13806,grant,0,0,1,1
13807,представительств.,0,0,1,1
13810,التوفل,0,0,1,1
13797,montrer,0,0,1,1
13811,فسوف,0,0,1,1
13813,restées,0,0,1,1
13815,lacking.,0,0,1,1
13816,മൂലയിൽത്തന്നെ,0,0,1,1
13819,manzara,0,0,1,1
13820,darme,0,0,1,1
13821,французский,0,0,1,1
13798,называемые,0,0,1,1
13795,chinois,0,0,1,1
13770,lindos,0,0,1,1
13782,высоко-,0,0,1,1
13771,critiquent,0,0,1,1
13774,ഉറക്കമുണർന്നു,0,0,1,1
13775,wilde,0,0,1,1
13777,الأمير,0,0,1,1
13779,b.,0,0,1,1
13780,മുൻ,0,0,1,1
13781,требовал,0,0,1,1
13784,like.,0,0,1,1
13793,великолепного,0,0,1,1
13785,बीस,0,0,1,1
13786,свободных,0,0,1,1
13787,humain,0,0,1,1
13788,systematically,0,0,1,1
13789,مني.,0,0,1,1
13790,मार्मिक,0,0,1,1
13792,fitzerald,0,0,1,1
13712,hija.,0,0,1,1
13710,अनुभाग,0,0,1,1
13597,propuestas,0,0,1,1
13638,[a],0,0,1,1
13630,drückt,0,0,1,1
13631,надёжность,0,0,1,1
13632,risos,0,0,1,1
13633,вела,0,0,1,1
13634,क्रम,0,0,1,1
13635,träffas.,0,0,1,1
13636,faktarutor.,0,0,1,1
13640,собираюсь,0,0,1,1
13625,episkt,0,0,1,1
13642,baker,0,0,1,1
13643,കുറിച്ചും,0,0,1,1
13644,determinando,0,0,1,1
13645,βυθίζεται,0,0,1,1
13646,χτυπάτε,0,0,1,1
13647,χρησιμοποιημένη,0,0,1,1
13649,ಬಡ್ತಿ,0,0,1,1
13629,prêter,0,0,1,1
13624,المسكينة,0,0,1,1
13651,daquele,0,0,1,1
13612,മാനഭംഗക്കേസുകളിൽ,0,0,1,1
13598,canales,0,0,1,1
13603,geloven,0,0,1,1
13605,uniform,0,0,1,1
13606,отменить,0,0,1,1
13607,edemezsiniz-,0,0,1,1
13610,federais,0,0,1,1
13611,compactness,0,0,1,1
13613,departure,0,0,1,1
13623,artikelmaterial,0,0,1,1
13614,mean[s],0,0,1,1
13615,американских,0,0,1,1
13616,призваны,0,0,1,1
13618,corridors,0,0,1,1
13619,صديقين,0,0,1,1
13621,шесть,0,0,1,1
13622,werkervaring,0,0,1,1
13650,கடக்கிறீர்கள்.,0,0,1,1
13652,hazırlanan,0,0,1,1
13708,മങ്ങിയ,0,0,1,1
13697,argument,0,0,1,1
13687,മികച്ചതായിരിക്കും.,0,0,1,1
13688,eerlijk,0,0,1,1
13689,दें।,0,0,1,1
13690,negligenciáveis,0,0,1,1
13691,irishtimes.com​​,0,0,1,1
13693,motkultur,0,0,1,1
13695,jardín,0,0,1,1
13698,ನಿಜವಾದ,0,0,1,1
13684,فعله,0,0,1,1
13700,equipped,0,0,1,1
13701,eventuele,0,0,1,1
13702,better-written,0,0,1,1
13703,izlerken,0,0,1,1
13704,selvom.,0,0,1,1
13705,entropía,0,0,1,1
13707,مجهودك.,0,0,1,1
13685,تشرفت,0,0,1,1
13683,encontrará,0,0,1,1
13653,vehicles,0,0,1,1
13668,turistin,0,0,1,1
13655,மேற்பார்வையிடல்களுக்குப்,0,0,1,1
13658,wikibooks.,0,0,1,1
13659,plagiarism,0,0,1,1
13661,düğmesini,0,0,1,1
13662,in.,0,0,1,1
13664,wikipediaartiklar.,0,0,1,1
13665,मिस्री,0,0,1,1
13671,termes,0,0,1,1
13681,isn't,0,0,1,1
13672,parallèlement,0,0,1,1
13673,mogelijk,0,0,1,1
13676,കുറ്റകരമായ,0,0,1,1
13677,वित्त,0,0,1,1
13678,diecisiete,0,0,1,1
13679,മായ്ച്ചുകളയുന്നതും,0,0,1,1
13680,rotulada,0,0,1,1
8433,skarpa,0,0,1,1
8430,διάστημα,0,0,1,1
16267,प्रतियोगिता,0,0,1,1
2907,prendendo,1,1,0,1
3080,abbiano,1,1,0,1
3081,acquisita,1,1,0,1
3082,mangi.,1,1,0,1
3085,addestrare,1,1,0,1
3087,culturali,1,1,0,1
3088,valutato,1,1,0,1
3089,democrazia.,1,1,0,1
3090,difendere,1,1,0,1
3091,«le,1,1,0,1
3092,incompleto,1,1,0,1
3093,pretendenti,1,1,0,1
3094,razionale,1,1,0,1
3095,webmasters,1,1,0,1
3096,egoista,1,1,0,1
3097,condivisibile,1,1,0,1
3098,stile,1,1,0,1
3099,soldati,1,1,0,1
3079,inesistente,1,1,0,1
3077,vettori,1,1,0,1
3076,collaboratori.,1,1,0,1
3056,entrato,1,1,0,1
3047,dimostrazione,1,1,0,1
3049,rallegrati.,1,1,0,1
3050,detenuto,1,1,0,1
3052,pubblicarle».,1,1,0,1
3053,diritto,1,1,0,1
3054,insufficienza,1,1,0,1
3055,sbagli.,1,1,0,1
3058,carattere,1,1,0,1
3073,suona,1,1,0,1
3061,sbalordito,1,1,0,1
3063,noi',1,1,0,1
3065,conteneva,1,1,0,1
3067,[ˌwɪkiˈpiːdiə],1,1,0,1
3069,stesse.,1,1,0,1
3070,informazioni.,1,1,0,1
3071,osservati.,1,1,0,1
3100,un'occhiata,1,1,0,1
3101,apporta,1,1,0,1
3102,giorni.,1,1,0,1
3153,analitiche,1,1,0,1
3137,volere,1,1,0,1
3139,l'elemento,1,1,0,1
3143,un'esplosione,1,1,0,1
3144,autonoma,1,1,0,1
3147,puzzle,1,1,0,1
3149,volontaria,1,1,0,1
3150,dell'umanità,1,1,0,1
3154,pattern.,1,1,0,1
3134,luminosi,1,1,0,1
3156,controverso.,1,1,0,1
3157,elaborare,1,1,0,1
3158,anticipa,1,1,0,1
3159,portare,1,1,0,1
3161,carta.,1,1,0,1
3163,originariamente,1,1,0,1
3165,puzzolente,1,1,0,1
3136,sbalorditivo,1,1,0,1
3133,perdere,1,1,0,1
3103,offra,1,1,0,1
3117,cattura,1,1,0,1
3104,dall'assunzione,1,1,0,1
3105,dinamico.,1,1,0,1
3106,nell'ottobre,1,1,0,1
3109,immaginassero,1,1,0,1
3110,accadono,1,1,0,1
3111,modellizzare,1,1,0,1
3114,discussione,1,1,0,1
3118,'nah.,1,1,0,1
3131,straordinario,1,1,0,1
3119,l',1,1,0,1
3121,accettano,1,1,0,1
3122,subisce,1,1,0,1
3123,ondulatoria,1,1,0,1
3125,cambiamento,1,1,0,1
3127,ripresa,1,1,0,1
3128,d'informazione.,1,1,0,1
3043,cambia,1,1,0,1
3042,svolti,1,1,0,1
3041,solleva,1,1,0,1
2955,effetto,1,1,0,1
2940,uccello,1,1,0,1
2941,distinti.,1,1,0,1
2946,patate,1,1,0,1
2947,iniziare,1,1,0,1
2948,includendo,1,1,0,1
2950,generalizzazione.,1,1,0,1
2954,lacune,1,1,0,1
2956,spadolini,1,1,0,1
2938,l'economia,1,1,0,1
2957,positivi,1,1,0,1
2958,collaborano,1,1,0,1
2959,basano,1,1,0,1
2962,settimana.,1,1,0,1
2963,sorrisi,1,1,0,1
2966,contenessero,1,1,0,1
2967,leggermente,1,1,0,1
2939,evolve,1,1,0,1
2937,collaboratore,1,1,0,1
2970,giorni,1,1,0,1
2922,steward,1,1,0,1
2910,sento,1,1,0,1
2911,capitoli,1,1,0,1
2913,prettamente,1,1,0,1
2914,comprare,1,1,0,1
2915,l'altro,1,1,0,1
2917,raccontare.,1,1,0,1
2921,origini,1,1,0,1
2924,definizioni,1,1,0,1
2935,partecipata,1,1,0,1
2925,rimanere,1,1,0,1
2926,inserzionisti,1,1,0,1
2927,ottenute,1,1,0,1
2928,derivato,1,1,0,1
2930,studiano,1,1,0,1
2931,nell'information,1,1,0,1
2934,affidata,1,1,0,1
2969,punizione,1,1,0,1
2972,occitano.,1,1,0,1
3040,zamolli.,1,1,0,1
3026,quantità,1,1,0,1
3016,qualcos'altro.,1,1,0,1
3017,maggiormente,1,1,0,1
3018,corpo,1,1,0,1
3019,difficilmente,1,1,0,1
3023,web»,1,1,0,1
3024,madrelingua,1,1,0,1
3025,riportava,1,1,0,1
3028,adesso.,1,1,0,1
3013,dubbi,1,1,0,1
3029,copiare,1,1,0,1
3030,ricerca.,1,1,0,1
3031,incontrerò,1,1,0,1
3032,imparando,1,1,0,1
3035,intensifica,1,1,0,1
3038,dell'oceano,1,1,0,1
3039,sogno.,1,1,0,1
3015,quantificare,1,1,0,1
3012,disprezzo,1,1,0,1
2974,simile,1,1,0,1
2989,appropriato,1,1,0,1
2975,provi,1,1,0,1
2976,fattore,1,1,0,1
2979,tempestosa,1,1,0,1
2981,dipende,1,1,0,1
2983,stretti,1,1,0,1
2987,seduti,1,1,0,1
2988,edicole.,1,1,0,1
2991,esseri,1,1,0,1
3007,/peˈdia/,1,1,0,1
2992,ambito,1,1,0,1
2998,approssimativamente,1,1,0,1
2999,migliorano,1,1,0,1
3000,viaggio.,1,1,0,1
3003,adeguata,1,1,0,1
3004,self-organization.,1,1,0,1
3006,maniere,1,1,0,1
3167,tirare,1,1,0,1
3168,cancellano,1,1,0,1
3169,sottoposti,1,1,0,1
3379,comparato,1,1,0,1
3368,energetico,1,1,0,1
3369,esistenza,1,1,0,1
3370,operativa.,1,1,0,1
3371,scaturisce,1,1,0,1
3372,solito,1,1,0,1
3373,specifico,1,1,0,1
3378,pronte,1,1,0,1
3380,importanza,1,1,0,1
3362,guardando.,1,1,0,1
3381,l'espresso,1,1,0,1
3386,pezzo,1,1,0,1
3388,sfera,1,1,0,1
3389,all'ora,1,1,0,1
3392,attribuiti,1,1,0,1
3396,possiede,1,1,0,1
3397,critiche,1,1,0,1
3367,profilo,1,1,0,1
3359,controversie.,1,1,0,1
3401,promosso,1,1,0,1
3331,fonte.,1,1,0,1
3320,troppe,1,1,0,1
3321,fratelli,1,1,0,1
3324,significato».,1,1,0,1
3325,fiacco.,1,1,0,1
3327,sguardi,1,1,0,1
3329,mattina,1,1,0,1
3330,evoluzione,1,1,0,1
3332,ea,1,1,0,1
3357,nate,1,1,0,1
3333,ore,1,1,0,1
3335,organizzata,1,1,0,1
3336,aiutarti.,1,1,0,1
3344,editoriale,1,1,0,1
3345,telegramma,1,1,0,1
3346,soprannominata,1,1,0,1
3355,riuscito,1,1,0,1
3399,dell'accademico,1,1,0,1
3402,dall'esercito,1,1,0,1
3318,discrepanza,1,1,0,1
3452,incontrarti,1,1,0,1
3443,domini,1,1,0,1
3444,tradeoff,1,1,0,1
3445,figlia.,1,1,0,1
3446,modellati,1,1,0,1
3448,affermò,1,1,0,1
3449,fukushima.,1,1,0,1
3450,underfitting.,1,1,0,1
3456,statistica.,1,1,0,1
3438,sforzo,1,1,0,1
3458,misurato,1,1,0,1
3460,pagamento.,1,1,0,1
3461,includere,1,1,0,1
3463,tuttora,1,1,0,1
3464,jōichi,1,1,0,1
3466,digita,1,1,0,1
3467,mangio,1,1,0,1
3442,categorizzazione,1,1,0,1
3436,spera.,1,1,0,1
3405,dall'autore,1,1,0,1
3420,guardarono,1,1,0,1
3406,/ˈviki/,1,1,0,1
3407,aiutami,1,1,0,1
3408,pianeta,1,1,0,1
3412,derivati.,1,1,0,1
3414,indipendenti.,1,1,0,1
3417,tentare,1,1,0,1
3419,illustrati,1,1,0,1
3422,nell'identificare,1,1,0,1
3433,banche,1,1,0,1
3424,suono,1,1,0,1
3425,scalpore,1,1,0,1
3426,salutare,1,1,0,1
3429,«pochi,1,1,0,1
3430,lavorativa.,1,1,0,1
3431,farebbe.,1,1,0,1
3432,[che,1,1,0,1
3319,sensori.,1,1,0,1
3317,logico,1,1,0,1
3172,ripetere,1,1,0,1
3214,newsweek,1,1,0,1
3202,incoraggia,1,1,0,1
3205,dall'argomento,1,1,0,1
3206,noioso,1,1,0,1
3207,commerciali,1,1,0,1
3210,antiche,1,1,0,1
3212,dà,1,1,0,1
3213,distribuita,1,1,0,1
3215,riguardano,1,1,0,1
3199,esterne,1,1,0,1
3216,lamentele,1,1,0,1
3221,personale,1,1,0,1
3226,valore,1,1,0,1
3228,costituite,1,1,0,1
3229,momenti,1,1,0,1
3230,backpropagation,1,1,0,1
3231,considerato,1,1,0,1
3200,cercano,1,1,0,1
3198,l'evoluzione,1,1,0,1
3234,interventi,1,1,0,1
3185,cinesi,1,1,0,1
3173,stampati,1,1,0,1
3174,seymour,1,1,0,1
3175,indicizza,1,1,0,1
3176,fortunata,1,1,0,1
3177,vissuto,1,1,0,1
3181,accetta,1,1,0,1
3183,superavano,1,1,0,1
3187,quell'angelo,1,1,0,1
3197,l'equivalente,1,1,0,1
3188,deriva,1,1,0,1
3189,traffico,1,1,0,1
3191,un'intervista,1,1,0,1
3192,contrassegnato,1,1,0,1
3193,distolse,1,1,0,1
3194,editoriali,1,1,0,1
3196,domani.,1,1,0,1
3232,dell'analisi,1,1,0,1
3235,eppure,1,1,0,1
3315,venduta,1,1,0,1
3301,troverebbe,1,1,0,1
3287,commentare,1,1,0,1
3288,parliamo,1,1,0,1
3289,pubblico.,1,1,0,1
3293,linguistico,1,1,0,1
3297,catalizzatore,1,1,0,1
3298,permanenti,1,1,0,1
3299,contenute,1,1,0,1
3303,scientifico,1,1,0,1
3285,limitano,1,1,0,1
3304,accuratezza,1,1,0,1
3305,if-else,1,1,0,1
3306,prezzi,1,1,0,1
3308,seguito.,1,1,0,1
3310,possiamo,1,1,0,1
3312,italianizzate,1,1,0,1
3314,riscontrabili,1,1,0,1
3286,«…per,1,1,0,1
3282,l'enciclopedia.,1,1,0,1
3239,mandare,1,1,0,1
3255,piacessero,1,1,0,1
3240,raddoppiate,1,1,0,1
3241,glielo,1,1,0,1
3242,scuse.,1,1,0,1
3250,sequenziamento,1,1,0,1
3251,integrata,1,1,0,1
3252,semplice,1,1,0,1
3254,commentato,1,1,0,1
3256,boccone,1,1,0,1
3280,confermare,1,1,0,1
3261,necessità,1,1,0,1
3262,riprendi,1,1,0,1
3265,bibliotecari,1,1,0,1
3266,secoli,1,1,0,1
3274,espresse,1,1,0,1
3276,pilastri,1,1,0,1
3278,elenchi,1,1,0,1
2909,l'approccio,1,1,0,1
2906,dispositivi.,1,1,0,1
3474,dispongono,1,1,0,1
2905,matematici,1,1,0,1
2549,derivate,1,1,0,1
2550,salvati,1,1,0,1
2551,accettabile,1,1,0,1
2552,vorrebbe,1,1,0,1
2553,sull'analisi,1,1,0,1
2555,epico,1,1,0,1
2556,respingeva,1,1,0,1
2557,immunitario,1,1,0,1
2559,/wikiˈpidja/,1,1,0,1
2560,prontamente,1,1,0,1
2562,rallegrare,1,1,0,1
2564,dall'esperienza,1,1,0,1
2565,l'inglese,1,1,0,1
2568,autorevole,1,1,0,1
2569,utilizzatori,1,1,0,1
2570,gestisce,1,1,0,1
2572,analitico,1,1,0,1
2548,rimanesse,1,1,0,1
2547,consigliata.,1,1,0,1
2546,bias-variance,1,1,0,1
2531,dibattito,1,1,0,1
2515,probabilisticamente,1,1,0,1
2518,loghi,1,1,0,1
2521,elaborazione,1,1,0,1
2522,telefonata,1,1,0,1
2526,sconosciute,1,1,0,1
2528,polacchi.,1,1,0,1
2530,ottimali,1,1,0,1
2534,contribuzione,1,1,0,1
2545,rapporto,1,1,0,1
2535,esaminata,1,1,0,1
2536,ripreso,1,1,0,1
2537,rallentamento,1,1,0,1
2539,identificare,1,1,0,1
2540,edizione,1,1,0,1
2541,ambiguità.,1,1,0,1
2543,processa,1,1,0,1
2574,l'incentivo,1,1,0,1
2575,vero.,1,1,0,1
2576,perfetto,1,1,0,1
2619,colloca,1,1,0,1
2606,efficiente.,1,1,0,1
2607,leggendo,1,1,0,1
2608,giappone.,1,1,0,1
2609,ottanta,1,1,0,1
2612,contribuirvi,1,1,0,1
2613,interessate,1,1,0,1
2616,cavallo,1,1,0,1
2623,faith-based,1,1,0,1
2603,stabili.,1,1,0,1
2624,personalizzazione,1,1,0,1
2625,fantasiose,1,1,0,1
2627,menzionato,1,1,0,1
2629,click.,1,1,0,1
2630,imparassero,1,1,0,1
2632,adorabile,1,1,0,1
2633,rimanga,1,1,0,1
2605,emiliano,1,1,0,1
2600,cancellazione,1,1,0,1
2577,complicati,1,1,0,1
2586,compatibile,1,1,0,1
2578,sullo,1,1,0,1
2579,generazione,1,1,0,1
2580,classificazione,1,1,0,1
2581,usino,1,1,0,1
2582,reati,1,1,0,1
2583,amata,1,1,0,1
2585,noto,1,1,0,1
2587,divenuta,1,1,0,1
2599,conclude,1,1,0,1
2588,collaborare,1,1,0,1
2590,affermano,1,1,0,1
2591,invasi,1,1,0,1
2593,lavoro.,1,1,0,1
2596,sole,1,1,0,1
2597,sembravano,1,1,0,1
2598,''sportello,1,1,0,1
2512,presunti,1,1,0,1
2510,interessanti.,1,1,0,1
2506,un'ora.,1,1,0,1
2407,impiego,1,1,0,1
2393,loro.,1,1,0,1
2395,naso,1,1,0,1
2397,management,1,1,0,1
2402,operazioni,1,1,0,1
2403,smeraldi,1,1,0,1
2404,annegamento,1,1,0,1
2406,errate,1,1,0,1
2409,oggettiva.,1,1,0,1
2387,un'opinione,1,1,0,1
2410,attento.,1,1,0,1
2411,costituirsi,1,1,0,1
2412,sezione,1,1,0,1
2415,ampiezza,1,1,0,1
2417,essendo,1,1,0,1
2418,piedi,1,1,0,1
2421,lingua.»,1,1,0,1
2391,merito.,1,1,0,1
2386,cinese,1,1,0,1
2423,cambiò,1,1,0,1
2369,orientamenti,1,1,0,1
2353,fecero,1,1,0,1
2354,posizioni,1,1,0,1
2356,altoparlanti,1,1,0,1
2357,capisco,1,1,0,1
2358,ricordarti,1,1,0,1
2365,addetti,1,1,0,1
2368,studiati.,1,1,0,1
2371,cresceva,1,1,0,1
2384,anti-elitaria,1,1,0,1
2372,sorridere,1,1,0,1
2373,dell'omonimo,1,1,0,1
2375,ficcanaso,1,1,0,1
2378,opinioni.,1,1,0,1
2379,simbolici,1,1,0,1
2380,gustoso,1,1,0,1
2382,napoletano,1,1,0,1
2422,sardo,1,1,0,1
2424,dall'apprendimento,1,1,0,1
2504,statistico.,1,1,0,1
2481,l'inventore,1,1,0,1
2469,contempo,1,1,0,1
2471,descrizioni,1,1,0,1
2472,«il,1,1,0,1
2473,rappresentativa,1,1,0,1
2475,mostrati,1,1,0,1
2477,dell'italiano,1,1,0,1
2479,all'ottimizzazione,1,1,0,1
2482,lezione.,1,1,0,1
2462,doppio,1,1,0,1
2483,errore.,1,1,0,1
2486,ricca,1,1,0,1
2488,calibratura,1,1,0,1
2490,comun,1,1,0,1
2497,svolto.,1,1,0,1
2501,negoziabile,1,1,0,1
2503,avvenuto,1,1,0,1
2467,relazionali,1,1,0,1
2461,po',1,1,0,1
2425,addosso,1,1,0,1
2442,frega,1,1,0,1
2426,abbandonato,1,1,0,1
2429,un'ampia,1,1,0,1
2431,ulteriore,1,1,0,1
2433,reperibile,1,1,0,1
2435,l'intento,1,1,0,1
2437,giornalista,1,1,0,1
2441,sfruttare,1,1,0,1
2443,inizialmente,1,1,0,1
2460,stessa.,1,1,0,1
2446,voto»,1,1,0,1
2447,attive.,1,1,0,1
2448,morendo,1,1,0,1
2449,linz,1,1,0,1
2451,codice,1,1,0,1
2453,rosenblatt,1,1,0,1
2454,tesoro,1,1,0,1
2634,friulano,1,1,0,1
2635,sapeva,1,1,0,1
2636,lancio,1,1,0,1
2819,progettata,1,1,0,1
2808,sacco,1,1,0,1
2809,cammina,1,1,0,1
2811,impatto,1,1,0,1
2813,piani,1,1,0,1
2814,costituisca,1,1,0,1
2816,fermò,1,1,0,1
2818,spirito,1,1,0,1
2822,cunningham.,1,1,0,1
2804,l'attribuzione,1,1,0,1
2823,compilata,1,1,0,1
2824,finanziamento,1,1,0,1
2825,stupefacente.,1,1,0,1
2827,docente,1,1,0,1
2828,comprerei,1,1,0,1
2829,grandioso.,1,1,0,1
2831,discesa,1,1,0,1
2807,registrazione,1,1,0,1
2802,fianco,1,1,0,1
2833,poi.,1,1,0,1
2783,decisione.,1,1,0,1
2771,lottato,1,1,0,1
2772,l'adaline,1,1,0,1
2773,tenute,1,1,0,1
2776,cancellare,1,1,0,1
2777,aspetta,1,1,0,1
2779,lati,1,1,0,1
2782,bambino,1,1,0,1
2785,calmati,1,1,0,1
2801,parametri,1,1,0,1
2786,condivide,1,1,0,1
2787,oscillando,1,1,0,1
2788,palesemente,1,1,0,1
2792,eccezionalmente,1,1,0,1
2797,dietro,1,1,0,1
2799,profit,1,1,0,1
2800,attribuite,1,1,0,1
2832,goliardiche,1,1,0,1
2834,maremoto,1,1,0,1
2769,seguire,1,1,0,1
2886,colpevoli,1,1,0,1
2869,tradotte,1,1,0,1
2872,discretamente,1,1,0,1
2873,guardarla.,1,1,0,1
2881,organizzano,1,1,0,1
2882,udito.,1,1,0,1
2884,alvinn,1,1,0,1
2885,strategia,1,1,0,1
2888,terzo,1,1,0,1
2867,spiegare,1,1,0,1
2890,spezzato,1,1,0,1
2894,confusione,1,1,0,1
2897,volontari.,1,1,0,1
2900,scopi».,1,1,0,1
2902,un'organizzazione,1,1,0,1
2903,troverai,1,1,0,1
2904,dell'encyclopædia,1,1,0,1
2868,x,1,1,0,1
2866,input.,1,1,0,1
2836,prendessi,1,1,0,1
2848,operativa,1,1,0,1
2838,ladina,1,1,0,1
2839,esaltano,1,1,0,1
2840,specializzato,1,1,0,1
2841,seguenti,1,1,0,1
2842,anglosassone,1,1,0,1
2843,decidibile.,1,1,0,1
2847,mutazione,1,1,0,1
2850,risatine,1,1,0,1
2864,modificati,1,1,0,1
2852,affinché,1,1,0,1
2857,avviata,1,1,0,1
2858,incrociate,1,1,0,1
2859,albero,1,1,0,1
2861,comprato,1,1,0,1
2862,accontentarsi.,1,1,0,1
2863,straordinario.,1,1,0,1
2770,pubbliche,1,1,0,1
2767,cuocere,1,1,0,1
2637,umana.,1,1,0,1
2676,accanto,1,1,0,1
2665,negativamente,1,1,0,1
2666,critico,1,1,0,1
2668,bellissimo.,1,1,0,1
2670,diteci,1,1,0,1
2671,particolari,1,1,0,1
2674,macedonia,1,1,0,1
2675,ispirato,1,1,0,1
2679,aggiornate,1,1,0,1
2662,rappresentato,1,1,0,1
2684,vediamo,1,1,0,1
2687,navigazione,1,1,0,1
2689,citino,1,1,0,1
2690,approssimazione,1,1,0,1
2692,sysop,1,1,0,1
2694,proporre,1,1,0,1
2696,attraversato,1,1,0,1
2663,negativo.,1,1,0,1
2661,correggere,1,1,0,1
2702,riportano,1,1,0,1
2648,affidabilità.,1,1,0,1
2639,dell'anno,1,1,0,1
2640,informatica.,1,1,0,1
2641,indirizza,1,1,0,1
2642,tecnologico,1,1,0,1
2644,affine,1,1,0,1
2645,variegata,1,1,0,1
2646,quell'anno.,1,1,0,1
2650,primarie,1,1,0,1
2659,prime,1,1,0,1
2651,entrambe.,1,1,0,1
2652,«sebbene,1,1,0,1
2653,nacque,1,1,0,1
2654,sviluppatosi,1,1,0,1
2655,pensava,1,1,0,1
2656,tendenza,1,1,0,1
2657,specifici,1,1,0,1
2701,causando,1,1,0,1
2705,improvvisamente,1,1,0,1
2766,sofferto,1,1,0,1
2750,tempestata,1,1,0,1
2742,rallegrati,1,1,0,1
2743,avrebbe,1,1,0,1
2744,tratte,1,1,0,1
2745,mese.,1,1,0,1
2746,diventasse,1,1,0,1
2747,suggerì,1,1,0,1
2749,quantitativo,1,1,0,1
2751,interrompo.,1,1,0,1
2738,temporale.,1,1,0,1
2752,avevi,1,1,0,1
2753,vanno,1,1,0,1
2754,linden,1,1,0,1
2756,selezioni,1,1,0,1
2762,bloccato,1,1,0,1
2763,incontrare,1,1,0,1
2765,stesura,1,1,0,1
2741,esistenti,1,1,0,1
2737,parlarne.,1,1,0,1
2706,ottimizzazione.,1,1,0,1
2723,piange,1,1,0,1
2711,soap,1,1,0,1
2712,contenuti.,1,1,0,1
2714,conoscerti.,1,1,0,1
2716,leggibilità,1,1,0,1
2717,raggiungendo,1,1,0,1
2719,vederla,1,1,0,1
2722,lasciato,1,1,0,1
2724,acconsente,1,1,0,1
2736,tradizionali.,1,1,0,1
2726,moderatori,1,1,0,1
2727,giunsero,1,1,0,1
2729,famose,1,1,0,1
2731,mensili,1,1,0,1
2732,cullare,1,1,0,1
2734,all'editor,1,1,0,1
2735,dimentica.,1,1,0,1
3473,descritta,1,1,0,1
3475,l'assegnazione,1,1,0,1
2351,nell'ultimo,1,1,0,1
4016,meraviglioso,1,1,0,1
4176,elogi,1,1,0,1
4177,andando,1,1,0,1
4178,soggetto,1,1,0,1
4179,provino,1,1,0,1
4182,aumentata,1,1,0,1
4184,immagazzinare,1,1,0,1
4185,esci,1,1,0,1
4186,affrontato,1,1,0,1
4187,esercitati,1,1,0,1
4190,conclusa,1,1,0,1
4191,giardino,1,1,0,1
4193,fattibile,1,1,0,1
4194,svolgono,1,1,0,1
4195,trattava,1,1,0,1
4198,affermate,1,1,0,1
4201,cárceles,0,0,1,1
4202,informative.,0,0,1,1
4171,ragione.,1,1,0,1
4169,limitate.,1,1,0,1
4168,paritaria,1,1,0,1
4153,arrabbiata,1,1,0,1
4144,sostantivo,1,1,0,1
4145,inserita,1,1,0,1
4146,vedrai,1,1,0,1
4148,purtroppo,1,1,0,1
4150,palmari,1,1,0,1
4151,passaggio,1,1,0,1
4152,ecc,1,1,0,1
4154,atti,1,1,0,1
4165,dall'iwa,1,1,0,1
4155,giocando,1,1,0,1
4156,racconta,1,1,0,1
4157,minuscolo,1,1,0,1
4158,lettera,1,1,0,1
4160,avverando,1,1,0,1
4162,sociologico-culturale,1,1,0,1
4163,mandato,1,1,0,1
4203,ತಿಳಿದಿದೆಯೇ,0,0,1,1
4205,ವಹಿಸಿ.,0,0,1,1
4206,onderzoekers,0,0,1,1
4249,लें,0,0,1,1
4236,riesige,0,0,1,1
4237,വ്യക്തിയുടെ,0,0,1,1
4238,expansion.,0,0,1,1
4242,будете,0,0,1,1
4243,sunmuştur.,0,0,1,1
4245,अनुमानतः,0,0,1,1
4248,tarafsızlık,0,0,1,1
4250,சஞ்சிகை,0,0,1,1
4232,ωστόσο,0,0,1,1
4251,acabó,0,0,1,1
4253,ಸ್ನೇಹಿತ,0,0,1,1
4254,вандалов.,0,0,1,1
4256,«страница,0,0,1,1
4258,self-replicating,0,0,1,1
4259,problemáticas,0,0,1,1
4260,schönheit.,0,0,1,1
4234,πανεπιστήμιο,0,0,1,1
4231,verwijst,0,0,1,1
4207,popular.,0,0,1,1
4218,difficilement,0,0,1,1
4210,calidad​,0,0,1,1
4211,по-новому»,0,0,1,1
4212,région,0,0,1,1
4213,computation,0,0,1,1
4214,ನೀನೇನು,0,0,1,1
4216,dilema.,0,0,1,1
4217,luck.,0,0,1,1
4219,αργού,0,0,1,1
4228,யூடியூப்,0,0,1,1
4220,интеллекта,0,0,1,1
4221,पैरों,0,0,1,1
4222,galactica.,0,0,1,1
4223,en-dehors,0,0,1,1
4224,supervivencia,0,0,1,1
4226,தட்டில்,0,0,1,1
4227,içerikli,0,0,1,1
4143,riparazione,1,1,0,1
4142,funzionali.,1,1,0,1
4141,macchina.,1,1,0,1
4061,preparazione,1,1,0,1
4048,cresciute,1,1,0,1
4049,banca,1,1,0,1
4051,preventivo,1,1,0,1
4053,uichipèdia,1,1,0,1
4054,un'opera,1,1,0,1
4057,dicono,1,1,0,1
4058,spallanzani,1,1,0,1
4062,similarità,1,1,0,1
4045,sofisticato,1,1,0,1
4063,preparata,1,1,0,1
4064,viaggiando,1,1,0,1
4066,quarto,1,1,0,1
4067,passi,1,1,0,1
4068,pronunce,1,1,0,1
4070,adottano,1,1,0,1
4073,commento,1,1,0,1
4047,riferimenti,1,1,0,1
4044,ipotetico,1,1,0,1
4075,desiderato,1,1,0,1
4027,riservato,1,1,0,1
4018,prestigio,1,1,0,1
4019,giudiziarie.,1,1,0,1
4020,città.,1,1,0,1
4021,brossura,1,1,0,1
4022,lineare,1,1,0,1
4024,sorella,1,1,0,1
4025,simulata.,1,1,0,1
4028,antepongono,1,1,0,1
4042,magazine[senza fonte].,1,1,0,1
4030,preferibile,1,1,0,1
4031,qrpedia,1,1,0,1
4033,aver,1,1,0,1
4034,l'opposto,1,1,0,1
4035,l'esperienza,1,1,0,1
4040,tenere,1,1,0,1
4041,previsione.,1,1,0,1
4074,otterresti,1,1,0,1
4076,lamentandosi,1,1,0,1
4140,grandioso,1,1,0,1
4127,iniziamo.,1,1,0,1
4116,amico.,1,1,0,1
4117,successivo,1,1,0,1
4119,accurata,1,1,0,1
4121,pamphlet,1,1,0,1
4122,dimensione,1,1,0,1
4125,sbagliato.,1,1,0,1
4126,porta,1,1,0,1
4129,prevede,1,1,0,1
4112,stanno,1,1,0,1
4130,episodi,1,1,0,1
4133,settimo,1,1,0,1
4134,provengano,1,1,0,1
4135,cane,1,1,0,1
4137,finiti,1,1,0,1
4138,sostituendo,1,1,0,1
4139,magici,1,1,0,1
4115,tranne,1,1,0,1
4110,segnalate,1,1,0,1
4078,scusa.,1,1,0,1
4096,testa,1,1,0,1
4079,facessi.,1,1,0,1
4084,chiedevo,1,1,0,1
4085,conosco,1,1,0,1
4088,esservi,1,1,0,1
4089,tradizionali.»,1,1,0,1
4091,conduca,1,1,0,1
4093,avveri,1,1,0,1
4097,umano,1,1,0,1
4109,dorato,1,1,0,1
4098,gofai,1,1,0,1
4102,colloquio,1,1,0,1
4103,veramente,1,1,0,1
4104,mandargli,1,1,0,1
4106,dall'enciclopedia,1,1,0,1
4107,sims,1,1,0,1
4108,tipo.,1,1,0,1
4261,ಕಷ್ಟವಾಯಿತು,0,0,1,1
4262,കുടുങ്ങുമ്പോൾ,0,0,1,1
4263,söylemektir.,0,0,1,1
4435,yakalama,0,0,1,1
4419,lång.,0,0,1,1
4423,obteniez,0,0,1,1
4426,بموجب,0,0,1,1
4430,சீரான,0,0,1,1
4431,தோற்றங்களைக்,0,0,1,1
4433,indian,0,0,1,1
4434,τέρρι,0,0,1,1
4436,ökar.,0,0,1,1
4417,ഐ,0,0,1,1
4437,identity,0,0,1,1
4438,aún,0,0,1,1
4439,данная,0,0,1,1
4440,h.,0,0,1,1
4441,வாசிக்கும்,0,0,1,1
4443,deyim,0,0,1,1
4445,dérive,0,0,1,1
4418,virgil,0,0,1,1
4416,spørgsmålstegn.,0,0,1,1
4448,κοίταξα,0,0,1,1
4400,многих,0,0,1,1
4387,ಫಿಕ್ಸ್‌ನಲ್ಲಿ,0,0,1,1
4389,ουρανός,0,0,1,1
4390,problemática.,0,0,1,1
4391,vandalizados,0,0,1,1
4395,دموعك.,0,0,1,1
4396,താക്കീതുകൾ,0,0,1,1
4399,ضعيف,0,0,1,1
4401,وجمل,0,0,1,1
4414,ссылки.,0,0,1,1
4402,soulignées,0,0,1,1
4407,contestados,0,0,1,1
4408,saludos,0,0,1,1
4409,أعطيك,0,0,1,1
4410,बाद।,0,0,1,1
4411,excités,0,0,1,1
4413,ερωτηματικό.,0,0,1,1
4446,குழந்தைக்கோ,0,0,1,1
4450,axis,0,0,1,1
4385,wordpress.com,0,0,1,1
4489,usaria,0,0,1,1
4480,സ്ത്രീ,0,0,1,1
4482,okunulacak,0,0,1,1
4483,parentheses.,0,0,1,1
4485,usagers,0,0,1,1
4486,रोचक,0,0,1,1
4487,arkadaşımı,0,0,1,1
4488,refereras,0,0,1,1
4490,« notes,0,0,1,1
4477,التباطؤ,0,0,1,1
4492,länkas,0,0,1,1
4493,سريعة,0,0,1,1
4494,images.,0,0,1,1
4495,प्रोग्राम,0,0,1,1
4497,abonnere,0,0,1,1
4498,schloss,0,0,1,1
4501,well-defined,0,0,1,1
4479,feiten,0,0,1,1
4476,உள்ளதோடு,0,0,1,1
4451,решения,0,0,1,1
4464,llamado,0,0,1,1
4452,ejakulation,0,0,1,1
4455,недостоверная,0,0,1,1
4458,memoria,0,0,1,1
4460,pænere,0,0,1,1
4461,noie,0,0,1,1
4462,பீடியா,0,0,1,1
4463,любая,0,0,1,1
4465,bidragsgivare.,0,0,1,1
4475,называемая,0,0,1,1
4467,geophysiological,0,0,1,1
4468,плохое,0,0,1,1
4469,написан,0,0,1,1
4470,çocuğum,0,0,1,1
4471,böcker,0,0,1,1
4472,பிரிட்டானிக்கா,0,0,1,1
4474,ಹಾಗೆ.,0,0,1,1
4386,ಹಿಡಿಯಲಿಲ್ಲವೇ,0,0,1,1
4384,скромной,0,0,1,1
4264,الطعن,0,0,1,1
4303,dönmüş,0,0,1,1
4295,esbozos.,0,0,1,1
4296,അമ്പരന്നു,0,0,1,1
4297,മകളും,0,0,1,1
4299,remplacé,0,0,1,1
4300,subodh,0,0,1,1
4301,exercée,0,0,1,1
4302,oyla,0,0,1,1
4304,podcast,0,0,1,1
4293,حقول,0,0,1,1
4305,оспорено,0,0,1,1
4306,quantrill,0,0,1,1
4307,minimization,0,0,1,1
4308,ومعترف,0,0,1,1
4309,social.,0,0,1,1
4311,isterdim,0,0,1,1
4313,பதிலாகத்,0,0,1,1
4294,préoccupations,0,0,1,1
4292,آراء,0,0,1,1
4316,भागीदारी,0,0,1,1
4277,network.,0,0,1,1
4265,ಕರೆಯಬಹುದು,0,0,1,1
4266,தொகுப்பதன்,0,0,1,1
4268,narcisa'nın,0,0,1,1
4270,പ്രവർത്തനത്തിലൂടെ,0,0,1,1
4272,получение,0,0,1,1
4274,цитируются,0,0,1,1
4275,dagbladet,0,0,1,1
4279,βικιπαίδειας.,0,0,1,1
4291,enkelte,0,0,1,1
4280,движение,0,0,1,1
4281,birleşiminden,0,0,1,1
4283,ತಿರಸ್ಕರಿಸಿದಳು,0,0,1,1
4287,красная,0,0,1,1
4288,formation,0,0,1,1
4289,seslendirilmiş,0,0,1,1
4290,byen.,0,0,1,1
4314,rechazó,0,0,1,1
4317,doctorandos,0,0,1,1
4383,полная,0,0,1,1
4365,أبعد,0,0,1,1
4353,verwende,0,0,1,1
4356,ഉണ്ടാക്കുമെന്ന്,0,0,1,1
4357,خائفًا,0,0,1,1
4359,പൊതുവായി,0,0,1,1
4361,rubriker,0,0,1,1
4363,underrepresented.,0,0,1,1
4364,höger,0,0,1,1
4366,narzissmus,0,0,1,1
4350,लाइब्रेरी,0,0,1,1
4371,நோக்கம்,0,0,1,1
4372,ಅಪ್ರಸ್ತುತವಾಗುತ್ತದೆ,0,0,1,1
4374,wikiproject.,0,0,1,1
4376,sérieuse,0,0,1,1
4377,suites,0,0,1,1
4378,ಅಲ್ಲವೇ,0,0,1,1
4379,இல்லாது,0,0,1,1
4352,orientados,0,0,1,1
4349,stansifer,0,0,1,1
4318,huit,0,0,1,1
4331,اعتبار,0,0,1,1
4319,brugbarheden,0,0,1,1
4320,penny,0,0,1,1
4321,സൗകര്യമുണ്ട്.,0,0,1,1
4324,écouter,0,0,1,1
4325,three.,0,0,1,1
4326,migrado,0,0,1,1
4330,ആഗ്രഹിക്കുകയും,0,0,1,1
4335,συστήματα,0,0,1,1
4348,ατρόμητη,0,0,1,1
4339,existência,0,0,1,1
4340,الإداريين,0,0,1,1
4341,εχεις,0,0,1,1
4342,lições,0,0,1,1
4343,toplamda,0,0,1,1
4344,ales,0,0,1,1
4346,liegst,0,0,1,1
4017,compact,1,1,0,1
4015,non-lineari,1,1,0,1
3477,fondazione,1,1,0,1
4014,manipolare,1,1,0,1
3669,consigliate,1,1,0,1
3670,reiterato.,1,1,0,1
3671,dell'innata,1,1,0,1
3673,frammentazione,1,1,0,1
3675,ampia,1,1,0,1
3676,lievi,1,1,0,1
3677,credere,1,1,0,1
3678,esistiti,1,1,0,1
3680,condivisi,1,1,0,1
3681,ridistribuirli,1,1,0,1
3682,bilico,1,1,0,1
3683,dov'è,1,1,0,1
3684,preparati,1,1,0,1
3686,frequenza,1,1,0,1
3687,sorta,1,1,0,1
3688,supporti,1,1,0,1
3690,sposa,1,1,0,1
3666,linguistica,1,1,0,1
3665,beneficiato,1,1,0,1
3663,intenzionale,1,1,0,1
3648,imparziale,1,1,0,1
3636,notevole,1,1,0,1
3638,potrà,1,1,0,1
3642,piano,1,1,0,1
3644,portando,1,1,0,1
3645,diresse,1,1,0,1
3646,sorgono,1,1,0,1
3647,stabilite,1,1,0,1
3649,sovrappone,1,1,0,1
3661,scusi,1,1,0,1
3650,collegamento,1,1,0,1
3651,fitness,1,1,0,1
3652,spazi,1,1,0,1
3655,animale,1,1,0,1
3656,sfruttando,1,1,0,1
3657,migliora,1,1,0,1
3660,l'identificazione,1,1,0,1
3692,auto.,1,1,0,1
3694,diventata,1,1,0,1
3698,ridere,1,1,0,1
3746,belli,1,1,0,1
3738,qualcos'altro,1,1,0,1
3739,consigliando,1,1,0,1
3740,equamente,1,1,0,1
3741,inedite,1,1,0,1
3743,autorevoli,1,1,0,1
3744,pubblico,1,1,0,1
3745,replicato,1,1,0,1
3747,titoli,1,1,0,1
3735,induttivo,1,1,0,1
3748,questione,1,1,0,1
3749,d'informazione,1,1,0,1
3750,disciplinate,1,1,0,1
3751,generalizzare,1,1,0,1
3752,aprile,1,1,0,1
3753,classificandosi,1,1,0,1
3755,comunque.,1,1,0,1
3737,ossia,1,1,0,1
3734,pezzi,1,1,0,1
3699,magico,1,1,0,1
3713,connessa,1,1,0,1
3700,eccoti,1,1,0,1
3701,conseguono,1,1,0,1
3703,aiutarmi,1,1,0,1
3704,tettonica,1,1,0,1
3708,livelli,1,1,0,1
3709,dichiara,1,1,0,1
3712,mondo.,1,1,0,1
3716,vede.,1,1,0,1
3733,manderò,1,1,0,1
3718,veste,1,1,0,1
3724,proteina,1,1,0,1
3725,rapidamente,1,1,0,1
3726,stimolando,1,1,0,1
3727,finire.,1,1,0,1
3728,dicesse,1,1,0,1
3732,riuscire,1,1,0,1
3635,società.,1,1,0,1
3633,unica,1,1,0,1
3630,lavora,1,1,0,1
3545,distribuendo,1,1,0,1
3532,dinamici,1,1,0,1
3533,prescindere,1,1,0,1
3537,offensivo,1,1,0,1
3539,cellulari,1,1,0,1
3540,castello,1,1,0,1
3541,scintillanti.,1,1,0,1
3543,sposarmi,1,1,0,1
3547,wikiwikiweb,1,1,0,1
3530,all'istante,1,1,0,1
3552,fermati,1,1,0,1
3553,salì,1,1,0,1
3556,affogando,1,1,0,1
3557,avvertimento,1,1,0,1
3558,foscolo,1,1,0,1
3561,vada,1,1,0,1
3564,francoprovenzale,1,1,0,1
3531,ipertestuali,1,1,0,1
3528,dell'autorità,1,1,0,1
3568,provenga,1,1,0,1
3502,quest'anno,1,1,0,1
3480,completezza,1,1,0,1
3483,l'una,1,1,0,1
3488,regolata,1,1,0,1
3492,simulare,1,1,0,1
3493,incontri,1,1,0,1
3497,temi,1,1,0,1
3501,contava,1,1,0,1
3505,cellulare,1,1,0,1
3527,pone,1,1,0,1
3506,avrei,1,1,0,1
3508,decidere,1,1,0,1
3510,diceva,1,1,0,1
3517,sgarbatamente,1,1,0,1
3518,teorica,1,1,0,1
3524,microfono,1,1,0,1
3525,prigionieri.,1,1,0,1
3565,venire,1,1,0,1
3569,aumentare,1,1,0,1
3628,adottato,1,1,0,1
3615,informato,1,1,0,1
3603,insindacabile,1,1,0,1
3604,bagno,1,1,0,1
3607,addirittura,1,1,0,1
3610,moglie,1,1,0,1
3612,locali,1,1,0,1
3613,aggiudica,1,1,0,1
3614,vicina,1,1,0,1
3616,dollari,1,1,0,1
3600,esplora,1,1,0,1
3621,aggiornata,1,1,0,1
3622,vocabolari,1,1,0,1
3623,farlo.,1,1,0,1
3624,foresta,1,1,0,1
3625,riprenditi,1,1,0,1
3626,riscoperta,1,1,0,1
3627,costruisce,1,1,0,1
3601,bicchiere,1,1,0,1
3598,concerto,1,1,0,1
3571,specialistici.,1,1,0,1
3583,facciamo,1,1,0,1
3572,esplicite.,1,1,0,1
3573,lasciando,1,1,0,1
3574,etiche.,1,1,0,1
3575,arrivo,1,1,0,1
3576,tenta,1,1,0,1
3577,dell'abbigliamento,1,1,0,1
3580,bambina,1,1,0,1
3584,uniformandosi,1,1,0,1
3597,partite,1,1,0,1
3586,curata,1,1,0,1
3587,funziona,1,1,0,1
3589,false.,1,1,0,1
3590,invito,1,1,0,1
3594,redistribuzione,1,1,0,1
3595,rotto,1,1,0,1
3596,aiuteresti,1,1,0,1
3756,dell'arte,1,1,0,1
3757,sbaglia.,1,1,0,1
3758,compilazione,1,1,0,1
3931,fondatori,1,1,0,1
3919,ambiguità,1,1,0,1
3923,immaginaria.,1,1,0,1
3924,offerte.,1,1,0,1
3925,simboleggiare,1,1,0,1
3926,trattate,1,1,0,1
3927,adorabili,1,1,0,1
3928,umida,1,1,0,1
3932,dell'html,1,1,0,1
3917,fissavano,1,1,0,1
3934,elettronica,1,1,0,1
3940,argomento,1,1,0,1
3941,vocale.,1,1,0,1
3946,educatamente.,1,1,0,1
3947,sostenuta,1,1,0,1
3948,francesi,1,1,0,1
3950,commenti,1,1,0,1
3918,adatta,1,1,0,1
3916,presenziare,1,1,0,1
3953,sufficiente,1,1,0,1
3901,averlo,1,1,0,1
3892,neutralità,1,1,0,1
3893,consegnato,1,1,0,1
3894,organizzato,1,1,0,1
3897,rilevare,1,1,0,1
3898,giudicare,1,1,0,1
3899,sr.,1,1,0,1
3900,inizio,1,1,0,1
3904,gemme,1,1,0,1
3915,sottolineare,1,1,0,1
3906,divenute,1,1,0,1
3907,informali,1,1,0,1
3909,pensi,1,1,0,1
3910,addestrando,1,1,0,1
3911,regressione,1,1,0,1
3913,approfondimento,1,1,0,1
3914,decenni,1,1,0,1
3951,attualità,1,1,0,1
3955,l'esposizione,1,1,0,1
3890,appartiene,1,1,0,1
3996,inevitabile,1,1,0,1
3986,curati,1,1,0,1
3987,sconcertata,1,1,0,1
3988,basti,1,1,0,1
3989,uichipìdia,1,1,0,1
3990,utilizzo,1,1,0,1
3991,consulente,1,1,0,1
3995,visitano,1,1,0,1
4000,perde,1,1,0,1
3984,diagnosi,1,1,0,1
4002,spontaneamente,1,1,0,1
4003,crowdsourcing.,1,1,0,1
4004,concentrando,1,1,0,1
4005,negativi,1,1,0,1
4006,l'utente,1,1,0,1
4007,selezionate,1,1,0,1
4011,l'organizzazione,1,1,0,1
3985,l'atteggiamento,1,1,0,1
3983,obbligatoria,1,1,0,1
3957,trattati.,1,1,0,1
3969,formasse,1,1,0,1
3958,completa,1,1,0,1
3959,d'oro.,1,1,0,1
3960,trattavi,1,1,0,1
3964,basare,1,1,0,1
3966,berkeley,1,1,0,1
3967,riesco,1,1,0,1
3968,legate,1,1,0,1
3972,riassunte,1,1,0,1
3981,sicuro.,1,1,0,1
3973,corpi,1,1,0,1
3974,immagina,1,1,0,1
3975,individuare,1,1,0,1
3976,indiano,1,1,0,1
3977,palazzo,1,1,0,1
3978,utilizzare,1,1,0,1
3979,lucio,1,1,0,1
3891,limitazioni,1,1,0,1
3888,ristorante,1,1,0,1
3759,wafer,1,1,0,1
3814,la.,1,1,0,1
3797,umano.,1,1,0,1
3798,mando,1,1,0,1
3800,informazioni'',1,1,0,1
3801,attuò,1,1,0,1
3802,ospitata,1,1,0,1
3805,intrusioni,1,1,0,1
3810,contestati,1,1,0,1
3815,it.wiki,1,1,0,1
3791,coordinati,1,1,0,1
3816,congratulazioni,1,1,0,1
3817,classismo.,1,1,0,1
3818,wikivoyage.,1,1,0,1
3819,association.,1,1,0,1
3822,assistenza,1,1,0,1
3823,paradosso,1,1,0,1
3825,dio.,1,1,0,1
3796,.che,1,1,0,1
3789,muoversi,1,1,0,1
3827,sembra,1,1,0,1
3775,attraversò,1,1,0,1
3762,presso,1,1,0,1
3763,dell'edizione,1,1,0,1
3765,definire,1,1,0,1
3767,farei,1,1,0,1
3772,racchiuderne,1,1,0,1
3773,svegliato,1,1,0,1
3774,l'occhiolino.,1,1,0,1
3776,l'impegno.,1,1,0,1
3788,semi-supervisionato,1,1,0,1
3777,avvertiti,1,1,0,1
3778,sun-times,1,1,0,1
3779,hinton,1,1,0,1
3782,assoluto.,1,1,0,1
3783,definitivamente,1,1,0,1
3784,itō,1,1,0,1
3785,caricate,1,1,0,1
3826,bisogna,1,1,0,1
3828,aggiustare,1,1,0,1
3885,umile,1,1,0,1
3872,l'icona,1,1,0,1
3863,chicago,1,1,0,1
3865,cedette,1,1,0,1
3866,stabilendo,1,1,0,1
3868,chiamante,1,1,0,1
3869,catalano,1,1,0,1
3870,attendibilità,1,1,0,1
3871,genetici.,1,1,0,1
3874,richiedono,1,1,0,1
3860,crescita,1,1,0,1
3875,verrebbe,1,1,0,1
3876,scherzo,1,1,0,1
3877,restando,1,1,0,1
3878,progettando.,1,1,0,1
3880,guardò,1,1,0,1
3881,balcone,1,1,0,1
3883,impedito,1,1,0,1
3862,ugo,1,1,0,1
3859,sofisticato.,1,1,0,1
3829,lasciami,1,1,0,1
3844,cosiddetta,1,1,0,1
3831,apprezzo,1,1,0,1
3837,marchi,1,1,0,1
3838,un'esperienza,1,1,0,1
3839,disturbarti.,1,1,0,1
3840,probabilmente,1,1,0,1
3841,vestiti,1,1,0,1
3843,l'ho,1,1,0,1
3845,trasduzione,1,1,0,1
3858,obiezioni,1,1,0,1
3846,sostegno,1,1,0,1
3848,intellettuale,1,1,0,1
3850,superficiali».,1,1,0,1
3852,fiacca,1,1,0,1
3853,guardato,1,1,0,1
3854,carceri,1,1,0,1
3856,cancellando,1,1,0,1
2352,dipenda,1,1,0,1
2350,«[wikipedia],1,1,0,1
4503,ശൈലികളെയും,0,0,1,1
565,codifica,1,1,0,1
747,sempre.,1,1,0,1
748,riunione.,1,1,0,1
750,tipicamente,1,1,0,1
752,respirare,1,1,0,1
753,normale,1,1,0,1
754,piangi,1,1,0,1
755,preparato,1,1,0,1
757,«dati,1,1,0,1
759,sostenitori.,1,1,0,1
760,rilascia,1,1,0,1
763,proprio.,1,1,0,1
765,aspetti,1,1,0,1
766,rimosse,1,1,0,1
768,carino,1,1,0,1
770,razzismo,1,1,0,1
773,necessita,1,1,0,1
776,intrusi,1,1,0,1
745,divano.,1,1,0,1
741,diffamazione,1,1,0,1
740,voluto,1,1,0,1
726,soggetta,1,1,0,1
709,letteratura,1,1,0,1
714,mediche,1,1,0,1
716,turbato,1,1,0,1
718,trucco,1,1,0,1
719,consolidati,1,1,0,1
720,ringraziarti,1,1,0,1
725,preferirei,1,1,0,1
728,specchio,1,1,0,1
739,rivendicazione,1,1,0,1
729,altoparlante,1,1,0,1
730,applausi,1,1,0,1
731,dimmi,1,1,0,1
732,paese,1,1,0,1
733,gestione,1,1,0,1
734,risolvibili,1,1,0,1
738,appreso,1,1,0,1
778,accademici.,1,1,0,1
779,congratularsi,1,1,0,1
780,motivazione,1,1,0,1
841,collaborazione,1,1,0,1
829,ampio,1,1,0,1
830,esempi.,1,1,0,1
832,carico,1,1,0,1
834,sull'uragano,1,1,0,1
836,immangiabile,1,1,0,1
838,nostra,1,1,0,1
839,precisione,1,1,0,1
842,linguaggi,1,1,0,1
824,programmare,1,1,0,1
843,gpu,1,1,0,1
844,lenti,1,1,0,1
846,danneggiare,1,1,0,1
847,[ˌwiːkiˈpiːdiə],1,1,0,1
850,dall'obiettivo,1,1,0,1
853,affatto,1,1,0,1
855,seguirono.,1,1,0,1
827,aggiungendovi,1,1,0,1
820,ricercatrice,1,1,0,1
781,esitante.,1,1,0,1
796,milionesima,1,1,0,1
784,campo.,1,1,0,1
785,l'accesso,1,1,0,1
787,contributo,1,1,0,1
788,comuni.,1,1,0,1
791,riprendere,1,1,0,1
793,guardi,1,1,0,1
794,controverse.,1,1,0,1
801,vederti,1,1,0,1
819,divenendo,1,1,0,1
803,impossibile,1,1,0,1
804,casella,1,1,0,1
805,iniziale.,1,1,0,1
808,probabilistici.,1,1,0,1
810,succedono,1,1,0,1
811,freddo,1,1,0,1
815,aiuto,1,1,0,1
707,permissivo,1,1,0,1
705,saggi,1,1,0,1
699,contare,1,1,0,1
622,lui»,1,1,0,1
605,precedente,1,1,0,1
609,partecipazione,1,1,0,1
611,nell'angolo,1,1,0,1
614,predispone,1,1,0,1
615,simpatici,1,1,0,1
616,nascono,1,1,0,1
621,rigorosamente,1,1,0,1
624,karcher.,1,1,0,1
601,condiviso,1,1,0,1
625,aule,1,1,0,1
627,visibili.,1,1,0,1
630,assoluto,1,1,0,1
631,coincidere,1,1,0,1
632,abbonamenti,1,1,0,1
635,intitolata,1,1,0,1
637,applicabili,1,1,0,1
603,logici,1,1,0,1
597,nell'enciclopedia,1,1,0,1
641,riprogrammazione,1,1,0,1
578,zuppa,1,1,0,1
567,cosiddette,1,1,0,1
568,tentativi,1,1,0,1
569,attività,1,1,0,1
572,intelligenza,1,1,0,1
573,l'accuratezza,1,1,0,1
574,correzione,1,1,0,1
575,rimasta,1,1,0,1
579,buono.,1,1,0,1
596,aziendali,1,1,0,1
580,multipli,1,1,0,1
581,automatiche.,1,1,0,1
583,organi,1,1,0,1
584,mammifero,1,1,0,1
585,nell'articolo,1,1,0,1
588,italia,1,1,0,1
589,parlare.,1,1,0,1
638,renderà,1,1,0,1
642,affonda,1,1,0,1
696,minimizzazione,1,1,0,1
684,sottostante,1,1,0,1
673,supporto.,1,1,0,1
674,sostenuti,1,1,0,1
677,esisteva,1,1,0,1
678,rapidi,1,1,0,1
680,wikipress,1,1,0,1
681,intraprendere,1,1,0,1
683,coinvolti.,1,1,0,1
685,venisse,1,1,0,1
671,disc,1,1,0,1
686,rintracciabili,1,1,0,1
687,ipotesi.,1,1,0,1
688,collar,1,1,0,1
689,prenderai,1,1,0,1
691,giornali,1,1,0,1
692,specialistico,1,1,0,1
694,sistematico,1,1,0,1
672,appoggia,1,1,0,1
670,pasticcio,1,1,0,1
643,supera,1,1,0,1
651,rifiorire,1,1,0,1
644,provate,1,1,0,1
645,stargli,1,1,0,1
646,digitali,1,1,0,1
647,dagli,1,1,0,1
648,attendibili,1,1,0,1
649,spaventato,1,1,0,1
650,classifica,1,1,0,1
655,incompetente,1,1,0,1
668,oggettivo,1,1,0,1
656,informale,1,1,0,1
657,diminuisce.,1,1,0,1
658,usanze,1,1,0,1
659,stupido.,1,1,0,1
663,prolungate,1,1,0,1
664,conoscenza.,1,1,0,1
665,ufficiale.,1,1,0,1
857,secondaria.,1,1,0,1
858,vialetto.,1,1,0,1
862,qual'è,1,1,0,1
1070,risultati,1,1,0,1
1058,euro,1,1,0,1
1059,sognato.,1,1,0,1
1060,scrivono.,1,1,0,1
1062,piacevole,1,1,0,1
1064,accetto,1,1,0,1
1066,nell'esempio,1,1,0,1
1068,denotare,1,1,0,1
1071,dirigono,1,1,0,1
1056,artificiali,1,1,0,1
1072,pdf,1,1,0,1
1073,sapresti,1,1,0,1
1076,applicato,1,1,0,1
1078,zolle,1,1,0,1
1080,alternativa.,1,1,0,1
1081,svezia,1,1,0,1
1082,semplificato,1,1,0,1
1057,dedicate,1,1,0,1
1055,arrivati.,1,1,0,1
1085,emozioniamo,1,1,0,1
1038,informativo,1,1,0,1
1020,traduzioni,1,1,0,1
1022,miliardi,1,1,0,1
1023,ottimistico,1,1,0,1
1024,«l'enciclopedia,1,1,0,1
1028,esempio.,1,1,0,1
1031,comportato,1,1,0,1
1033,gioco.,1,1,0,1
1043,affari,1,1,0,1
1054,assicurano,1,1,0,1
1044,controversi,1,1,0,1
1045,prendo.,1,1,0,1
1046,minima,1,1,0,1
1047,andati,1,1,0,1
1048,luciano,1,1,0,1
1052,sconosciuta,1,1,0,1
1053,abito,1,1,0,1
1083,l'hanno,1,1,0,1
1087,nati,1,1,0,1
1018,bravi,1,1,0,1
1136,fermo,1,1,0,1
1123,rappresentare.,1,1,0,1
1124,provò,1,1,0,1
1127,colpito,1,1,0,1
1131,fossero,1,1,0,1
1132,desiderati,1,1,0,1
1133,autorità,1,1,0,1
1135,blocchi,1,1,0,1
1137,cartaceo,1,1,0,1
1120,diventeranno,1,1,0,1
1139,sale,1,1,0,1
1140,infelice.,1,1,0,1
1141,partecipazione.,1,1,0,1
1142,distribuiti,1,1,0,1
1143,anticipo.,1,1,0,1
1147,determinarne,1,1,0,1
1148,rendere,1,1,0,1
1121,wc.,1,1,0,1
1119,d'uso,1,1,0,1
1088,funzionerà.,1,1,0,1
1099,suonare,1,1,0,1
1090,complessivo,1,1,0,1
1092,ottieni.,1,1,0,1
1093,particelle,1,1,0,1
1094,complesso,1,1,0,1
1095,quotidiano,1,1,0,1
1096,molecolare,1,1,0,1
1097,aggiunti,1,1,0,1
1100,col,1,1,0,1
1117,formattazione,1,1,0,1
1108,anglicizzanti,1,1,0,1
1109,dell'avventore,1,1,0,1
1110,internazionale,1,1,0,1
1111,sufficienti,1,1,0,1
1112,sull'edizione,1,1,0,1
1113,pomeriggio,1,1,0,1
1115,impraticabile,1,1,0,1
1019,neutroni,1,1,0,1
1017,permettimi,1,1,0,1
863,sottogruppi,1,1,0,1
917,tendiamo,1,1,0,1
899,ereditato,1,1,0,1
902,sviluppatori,1,1,0,1
910,prende,1,1,0,1
911,acculturato…,1,1,0,1
913,riflesso,1,1,0,1
915,l'intonazione.,1,1,0,1
916,competenza,1,1,0,1
920,qualifica,1,1,0,1
897,conosciuto,1,1,0,1
922,collaboratori.»,1,1,0,1
923,scelta,1,1,0,1
925,computazione,1,1,0,1
926,minuti.,1,1,0,1
929,aggregatore,1,1,0,1
932,vorresti.,1,1,0,1
933,cambiata,1,1,0,1
898,l'infrastruttura,1,1,0,1
896,disgregazione,1,1,0,1
938,andò,1,1,0,1
882,sedeva,1,1,0,1
867,luce,1,1,0,1
868,segretamente,1,1,0,1
871,miglioramenti,1,1,0,1
872,preceduta,1,1,0,1
876,ascoltando.,1,1,0,1
878,farai,1,1,0,1
879,batte.,1,1,0,1
883,legali,1,1,0,1
895,dell'elaborazione,1,1,0,1
885,riconoscere,1,1,0,1
887,problematici,1,1,0,1
888,stampata.,1,1,0,1
889,l'esito,1,1,0,1
890,osserva,1,1,0,1
891,perfezione.,1,1,0,1
892,autorizzazione.,1,1,0,1
936,risulta,1,1,0,1
939,collegate,1,1,0,1
1011,altrove,1,1,0,1
996,però,1,1,0,1
984,interessato,1,1,0,1
985,quattromila,1,1,0,1
986,abbiamo,1,1,0,1
989,«quando,1,1,0,1
990,widrow.,1,1,0,1
991,computazione.,1,1,0,1
994,piacerebbe,1,1,0,1
997,vecchia,1,1,0,1
978,svolgimento,1,1,0,1
1001,regolarità,1,1,0,1
1002,complementare,1,1,0,1
1003,fammelo,1,1,0,1
1004,provarono,1,1,0,1
1005,dormiva,1,1,0,1
1008,superato,1,1,0,1
1010,problematiche,1,1,0,1
983,segue,1,1,0,1
977,visuale,1,1,0,1
941,visione.,1,1,0,1
951,faziosi,1,1,0,1
942,così.,1,1,0,1
943,doppia,1,1,0,1
944,essi,1,1,0,1
945,tipico,1,1,0,1
946,codici,1,1,0,1
947,«a,1,1,0,1
950,facenti,1,1,0,1
954,l'individuazione,1,1,0,1
976,voleva,1,1,0,1
956,equilibrate,1,1,0,1
959,oversight,1,1,0,1
963,neurali.,1,1,0,1
964,ritirato,1,1,0,1
967,indiana,1,1,0,1
969,tenuti,1,1,0,1
973,ingressi,1,1,0,1
566,.stiamo,1,1,0,1
564,tante,1,1,0,1
1150,'a,1,1,0,1
563,nonostante,1,1,0,1
166,rappresentare,1,1,0,1
169,gelato,1,1,0,1
173,scorsa,1,1,0,1
175,tornato,1,1,0,1
180,privilegiate,1,1,0,1
181,laggiù,1,1,0,1
182,vendita.,1,1,0,1
184,condotto,1,1,0,1
189,famiglie,1,1,0,1
190,voragine,1,1,0,1
191,scrittura,1,1,0,1
192,l'importanza,1,1,0,1
196,appartenere,1,1,0,1
197,diamanti,1,1,0,1
199,contribuisce,1,1,0,1
200,risorse,1,1,0,1
201,l'esame,1,1,0,1
165,vera,1,1,0,1
164,remunerati,1,1,0,1
162,susan,1,1,0,1
146,simbolico,1,1,0,1
135,all'epoca,1,1,0,1
136,piantare,1,1,0,1
137,attività.,1,1,0,1
138,spiegano,1,1,0,1
139,ampie,1,1,0,1
142,gratuiti,1,1,0,1
144,previsione,1,1,0,1
148,impone,1,1,0,1
161,edite,1,1,0,1
153,boyd,1,1,0,1
154,riuscendo,1,1,0,1
155,casualmente,1,1,0,1
157,presi,1,1,0,1
158,potete,1,1,0,1
159,fondatore,1,1,0,1
160,sonno,1,1,0,1
202,guardando,1,1,0,1
203,d'autore,1,1,0,1
204,cancellazioni,1,1,0,1
253,prossimo,1,1,0,1
240,legami,1,1,0,1
242,prenderti,1,1,0,1
246,lanciati,1,1,0,1
247,accusata,1,1,0,1
248,eri,1,1,0,1
249,scusandosi.,1,1,0,1
252,giusto,1,1,0,1
254,lingue.,1,1,0,1
232,cameriera,1,1,0,1
255,svolta,1,1,0,1
258,considerandolo,1,1,0,1
260,possesso,1,1,0,1
261,avviene,1,1,0,1
262,ragazza,1,1,0,1
263,spingono,1,1,0,1
264,piccoli,1,1,0,1
234,l'enorme,1,1,0,1
231,dirla,1,1,0,1
205,rimettiti,1,1,0,1
214,ammetti,1,1,0,1
206,finito,1,1,0,1
208,vogliono,1,1,0,1
209,starnutito,1,1,0,1
210,cambiato,1,1,0,1
211,significato,1,1,0,1
212,farai.,1,1,0,1
213,bontà,1,1,0,1
218,costituisce,1,1,0,1
229,campioni.,1,1,0,1
219,piatto,1,1,0,1
220,ammirati,1,1,0,1
221,riportata,1,1,0,1
222,stupefacente,1,1,0,1
223,giudizio.,1,1,0,1
224,etichettati,1,1,0,1
225,chiodo,1,1,0,1
134,generazione.,1,1,0,1
133,cailliau,1,1,0,1
131,otto,1,1,0,1
54,poterlo,1,1,0,1
39,trovare,1,1,0,1
45,'impegnato,1,1,0,1
46,conterrà,1,1,0,1
48,autorizza,1,1,0,1
49,fornendo,1,1,0,1
50,esperti.,1,1,0,1
52,l'uscita,1,1,0,1
57,stilistiche.,1,1,0,1
32,trattazione,1,1,0,1
59,utilizzando,1,1,0,1
61,crescerà,1,1,0,1
62,posizione,1,1,0,1
63,scorrono,1,1,0,1
64,impareremo,1,1,0,1
65,avevo,1,1,0,1
66,assai,1,1,0,1
36,acquisizione,1,1,0,1
29,lavanderia.,1,1,0,1
71,redistribuiti,1,1,0,1
11,naturale.,1,1,0,1
2,rimasto,1,1,0,1
4,redazionale,1,1,0,1
6,descriverle,1,1,0,1
7,memoriam,1,1,0,1
8,fai.,1,1,0,1
9,sopravvissuta».,1,1,0,1
10,magnifico,1,1,0,1
14,libero.,1,1,0,1
28,speranza.»,1,1,0,1
15,pazientemente,1,1,0,1
17,aggiornabile,1,1,0,1
18,premendo,1,1,0,1
21,raddoppiando,1,1,0,1
23,apprese,1,1,0,1
26,additandole,1,1,0,1
27,sorgenti,1,1,0,1
70,caratteristiche,1,1,0,1
72,focalizza,1,1,0,1
130,tentativo,1,1,0,1
120,profondamente,1,1,0,1
111,elica,1,1,0,1
112,scapito,1,1,0,1
115,presentano,1,1,0,1
116,ricorrenze,1,1,0,1
117,ottimizzazione,1,1,0,1
118,signore,1,1,0,1
119,fermata,1,1,0,1
121,entrambi,1,1,0,1
108,formano,1,1,0,1
123,commentando,1,1,0,1
124,difensori,1,1,0,1
125,ripetizione.,1,1,0,1
126,augurare,1,1,0,1
127,pubblicabili,1,1,0,1
128,inaffidabile.,1,1,0,1
129,buco,1,1,0,1
109,affondare,1,1,0,1
107,d'acqua,1,1,0,1
73,formulati,1,1,0,1
87,comprensivo,1,1,0,1
76,originali.,1,1,0,1
77,citato,1,1,0,1
78,fallo,1,1,0,1
79,genoma,1,1,0,1
83,convenzioni,1,1,0,1
85,statico,1,1,0,1
86,preoccuparti.,1,1,0,1
88,musica.,1,1,0,1
104,controversie,1,1,0,1
89,argento,1,1,0,1
91,libere,1,1,0,1
93,guidare,1,1,0,1
95,attualità.,1,1,0,1
96,pronunciarlo,1,1,0,1
97,preferenze.,1,1,0,1
99,tasso,1,1,0,1
265,spicco,1,1,0,1
266,negativi.,1,1,0,1
267,notevole.,1,1,0,1
465,minimo,1,1,0,1
452,esagerare.,1,1,0,1
455,quei,1,1,0,1
456,stupro,1,1,0,1
457,pubblicano,1,1,0,1
458,«uno,1,1,0,1
459,dell'articolo,1,1,0,1
460,diversità,1,1,0,1
468,conferma,1,1,0,1
450,identificano,1,1,0,1
472,intenzioni,1,1,0,1
474,esplorativa,1,1,0,1
475,nazionali,1,1,0,1
476,richiamate,1,1,0,1
477,lettere,1,1,0,1
479,politica,1,1,0,1
481,un'estensione,1,1,0,1
451,tirati,1,1,0,1
449,direttamente,1,1,0,1
483,all'evoluzione,1,1,0,1
424,gay,1,1,0,1
410,tavola,1,1,0,1
411,nemmeno,1,1,0,1
413,confondere,1,1,0,1
415,interpellati,1,1,0,1
416,modificabile,1,1,0,1
419,l'autore,1,1,0,1
423,spiega.,1,1,0,1
426,sorridendosi,1,1,0,1
446,rilevante,1,1,0,1
430,visibili,1,1,0,1
433,cibo.,1,1,0,1
435,specifica,1,1,0,1
438,decennio,1,1,0,1
440,indicarne,1,1,0,1
441,stia,1,1,0,1
443,definito,1,1,0,1
482,pulito,1,1,0,1
484,fantastici,1,1,0,1
407,dell'enciclopedia.,1,1,0,1
544,romancio,1,1,0,1
534,insalate,1,1,0,1
535,rese,1,1,0,1
536,manutenzione,1,1,0,1
537,wikinotizie,1,1,0,1
538,polinomiale.,1,1,0,1
539,citiamo,1,1,0,1
543,discreta,1,1,0,1
545,controtendenza,1,1,0,1
531,come',1,1,0,1
546,ripeta,1,1,0,1
548,soprattutto,1,1,0,1
549,campioni,1,1,0,1
557,attualmente,1,1,0,1
559,predittiva.,1,1,0,1
561,magari,1,1,0,1
562,inammissibili.,1,1,0,1
532,carlo,1,1,0,1
529,notorietà,1,1,0,1
490,wikiversità,1,1,0,1
506,dovremmo,1,1,0,1
492,apertamente,1,1,0,1
494,economici,1,1,0,1
495,ciò.,1,1,0,1
498,seduto,1,1,0,1
500,comportare,1,1,0,1
501,carriera.»,1,1,0,1
505,volevamo,1,1,0,1
509,responsabilità,1,1,0,1
524,transazione,1,1,0,1
510,evitare,1,1,0,1
515,costruendo,1,1,0,1
517,triplicate,1,1,0,1
519,«per,1,1,0,1
521,biologica.,1,1,0,1
522,nomi,1,1,0,1
523,donazioni,1,1,0,1
408,elia,1,1,0,1
405,bellissima,1,1,0,1
268,fruitori,1,1,0,1
321,scopi,1,1,0,1
306,letterarie,1,1,0,1
308,inondazione,1,1,0,1
309,all'università,1,1,0,1
314,differenze,1,1,0,1
315,sicuramente,1,1,0,1
318,povera,1,1,0,1
320,espliciti,1,1,0,1
322,fonemi,1,1,0,1
304,usiamo,1,1,0,1
323,aveva.,1,1,0,1
324,febbraio,1,1,0,1
326,raffinato,1,1,0,1
327,promossa,1,1,0,1
328,reso,1,1,0,1
329,quell'altoparlante.,1,1,0,1
331,dichiararono,1,1,0,1
305,importare,1,1,0,1
302,appositi,1,1,0,1
337,spaventoso,1,1,0,1
277,rivederti,1,1,0,1
269,matto.,1,1,0,1
271,idealmente,1,1,0,1
272,sostenendo,1,1,0,1
273,geografici,1,1,0,1
274,dettaglio.,1,1,0,1
275,classico,1,1,0,1
276,capito.,1,1,0,1
282,nell'apprendimento,1,1,0,1
296,conseguenza.,1,1,0,1
283,decisi,1,1,0,1
289,colloquiale,1,1,0,1
290,faceva,1,1,0,1
291,minuti,1,1,0,1
293,etimologicamente,1,1,0,1
294,tecniche.,1,1,0,1
295,perso,1,1,0,1
332,commutazione,1,1,0,1
338,assumerti,1,1,0,1
403,vediamo.,1,1,0,1
386,coesistettero,1,1,0,1
373,irrilevanti,1,1,0,1
379,mioglobina,1,1,0,1
381,diciamo,1,1,0,1
382,'e,1,1,0,1
383,assieme,1,1,0,1
384,semplificata,1,1,0,1
385,provocativo,1,1,0,1
387,testa.,1,1,0,1
368,stupendi,1,1,0,1
393,giunto,1,1,0,1
395,storico,1,1,0,1
398,particolarità,1,1,0,1
399,inadatte,1,1,0,1
400,robuste,1,1,0,1
401,malevole,1,1,0,1
402,incontrato,1,1,0,1
369,progresso,1,1,0,1
365,inserimenti,1,1,0,1
339,trascinare,1,1,0,1
353,esercitarsi,1,1,0,1
340,addio,1,1,0,1
341,gustosi,1,1,0,1
343,l'interrogativo,1,1,0,1
344,inserite,1,1,0,1
345,/wikiˈpɛdja/,1,1,0,1
346,avvera.,1,1,0,1
349,creativa,1,1,0,1
354,dolce.,1,1,0,1
364,corrette,1,1,0,1
355,desiderato.,1,1,0,1
356,ieri,1,1,0,1
358,crusca,1,1,0,1
359,pecora,1,1,0,1
361,vicino.,1,1,0,1
362,dell'animazione,1,1,0,1
363,osservato.,1,1,0,1
1149,interrogativo.,1,1,0,1
1153,timida,1,1,0,1
2348,sottolineò,1,1,0,1
1734,all'abilità,1,1,0,1
1927,sposarti,1,1,0,1
1928,vado,1,1,0,1
1929,anche.,1,1,0,1
1930,fetta,1,1,0,1
1931,dall'hawaiano,1,1,0,1
1933,salutarono,1,1,0,1
1934,dizionari,1,1,0,1
1937,perché.,1,1,0,1
1938,collaborativo,1,1,0,1
1939,ricco,1,1,0,1
1940,mancare,1,1,0,1
1942,piemontese,1,1,0,1
1944,aspettare.,1,1,0,1
1946,posto.,1,1,0,1
1947,reale.,1,1,0,1
1949,integrate,1,1,0,1
1950,chiusi,1,1,0,1
1926,combinata,1,1,0,1
1925,ricompensa,1,1,0,1
1924,ricostruire,1,1,0,1
1904,riporta,1,1,0,1
1884,ottimizzare,1,1,0,1
1885,proprietaria,1,1,0,1
1890,saluti,1,1,0,1
1891,chiedo,1,1,0,1
1894,unito,1,1,0,1
1900,sostenne,1,1,0,1
1902,partecipativa,1,1,0,1
1906,fiducia,1,1,0,1
1921,giapponese.,1,1,0,1
1907,competenza.,1,1,0,1
1910,ligure,1,1,0,1
1911,nient'altro,1,1,0,1
1912,un'origine,1,1,0,1
1914,immagine.,1,1,0,1
1916,straordinariamente,1,1,0,1
1919,responsabilità.,1,1,0,1
1951,preoccupazioni.,1,1,0,1
1952,vocabolario.,1,1,0,1
1955,apportare,1,1,0,1
2018,incorporato,1,1,0,1
2005,algoritmi.,1,1,0,1
2006,contatto.,1,1,0,1
2010,meritare,1,1,0,1
2011,grafica,1,1,0,1
2012,influenza,1,1,0,1
2016,wikizionario,1,1,0,1
2017,enciclopedici.,1,1,0,1
2023,efficacemente,1,1,0,1
1999,diventando,1,1,0,1
2025,sapore,1,1,0,1
2027,sotto.,1,1,0,1
2030,nucleare,1,1,0,1
2031,velocità,1,1,0,1
2037,inglese –,1,1,0,1
2038,considerevole,1,1,0,1
2040,milione.,1,1,0,1
2001,teoretici,1,1,0,1
1998,matrimoni,1,1,0,1
1957,naturali,1,1,0,1
1972,strade,1,1,0,1
1959,lettori.,1,1,0,1
1960,rispettivo,1,1,0,1
1961,aspetto,1,1,0,1
1963,violare,1,1,0,1
1964,premuto,1,1,0,1
1965,giuria,1,1,0,1
1968,applicata,1,1,0,1
1973,accompagnato,1,1,0,1
1996,oggettiva,1,1,0,1
1976,collabora,1,1,0,1
1984,pubblicità,1,1,0,1
1985,computazionale.,1,1,0,1
1986,darci,1,1,0,1
1992,suggerimenti.,1,1,0,1
1993,utilizzate,1,1,0,1
1994,«l'atteggiamento,1,1,0,1
1882,inferenza.,1,1,0,1
1880,seguendo,1,1,0,1
1879,rivisto,1,1,0,1
1792,programmatori,1,1,0,1
1781,togliere,1,1,0,1
1782,occupato.,1,1,0,1
1783,venissero,1,1,0,1
1786,muove,1,1,0,1
1787,incrementato,1,1,0,1
1790,induttivi.,1,1,0,1
1791,produzione,1,1,0,1
1793,intrinsecamente,1,1,0,1
1778,avvale,1,1,0,1
1796,annuale,1,1,0,1
1797,effettivamente,1,1,0,1
1798,inviato.,1,1,0,1
1799,ecc..,1,1,0,1
1804,fissione,1,1,0,1
1805,visitatori,1,1,0,1
1807,«chi,1,1,0,1
1780,papert,1,1,0,1
1775,impegnato,1,1,0,1
1811,commento.,1,1,0,1
1754,dover,1,1,0,1
1739,«…rappresenta,1,1,0,1
1740,acquistano,1,1,0,1
1741,generalizzato,1,1,0,1
1742,citazione,1,1,0,1
1743,avrà,1,1,0,1
1748,spinge,1,1,0,1
1749,casuale.,1,1,0,1
1756,agiscono,1,1,0,1
1770,uscite,1,1,0,1
1757,incompatibili,1,1,0,1
1760,presentandole,1,1,0,1
1761,scarsa,1,1,0,1
1762,specialmente,1,1,0,1
1765,l'esempio,1,1,0,1
1767,soltanto,1,1,0,1
1769,strada,1,1,0,1
1810,annegare,1,1,0,1
1812,it.wikipedia.org.,1,1,0,1
1878,l'offerta.,1,1,0,1
1857,svedese,1,1,0,1
1847,compilativa,1,1,0,1
1848,ottico,1,1,0,1
1850,personaggi,1,1,0,1
1851,consegnati,1,1,0,1
1852,visti,1,1,0,1
1853,significati,1,1,0,1
1855,omogeneizzando,1,1,0,1
1861,denominatore,1,1,0,1
1843,specifiche.,1,1,0,1
1866,pensata,1,1,0,1
1867,probabilistici,1,1,0,1
1869,resisti,1,1,0,1
1872,modalità.,1,1,0,1
1874,conferenze,1,1,0,1
1875,esaminati,1,1,0,1
1877,riescono,1,1,0,1
1844,attribuendoli,1,1,0,1
1842,ottuso.,1,1,0,1
1813,aggressivo,1,1,0,1
1830,burocrati,1,1,0,1
1814,senses,1,1,0,1
1818,ruolo,1,1,0,1
1819,riceve,1,1,0,1
1820,menti,1,1,0,1
1824,chiedi.,1,1,0,1
1826,distacco,1,1,0,1
1829,ritengono,1,1,0,1
1831,rinforzo.,1,1,0,1
1841,realistico,1,1,0,1
1832,chiederti,1,1,0,1
1833,hawaiano,1,1,0,1
1836,distinto,1,1,0,1
1837,iscritti,1,1,0,1
1838,consultati,1,1,0,1
1839,secondi,1,1,0,1
1840,fonda,1,1,0,1
2042,nostri,1,1,0,1
2043,irregolare».,1,1,0,1
2046,accade,1,1,0,1
2267,distinzioni,1,1,0,1
2251,modificarli,1,1,0,1
2252,cadere,1,1,0,1
2255,considerando,1,1,0,1
2256,assomigli,1,1,0,1
2257,cibi,1,1,0,1
2261,ognuno,1,1,0,1
2265,apprenderanno,1,1,0,1
2269,lamenta,1,1,0,1
2248,compensi,1,1,0,1
2270,modificata,1,1,0,1
2271,provengono,1,1,0,1
2272,attivi.,1,1,0,1
2274,revisioni,1,1,0,1
2275,d'argento,1,1,0,1
2276,ormai,1,1,0,1
2278,puntando,1,1,0,1
2250,bell'uomo,1,1,0,1
2247,io',1,1,0,1
2281,l'esecuzione,1,1,0,1
2231,vennero,1,1,0,1
2219,impegnarsi,1,1,0,1
2221,e-book,1,1,0,1
2223,raccoglie,1,1,0,1
2225,specializzazione,1,1,0,1
2226,c-.,1,1,0,1
2227,manipolano,1,1,0,1
2229,consultata,1,1,0,1
2235,includono,1,1,0,1
2246,secondo.,1,1,0,1
2236,disperse,1,1,0,1
2238,imprecisioni,1,1,0,1
2240,istanza,1,1,0,1
2242,dall'inglese,1,1,0,1
2243,obiettività,1,1,0,1
2244,variante,1,1,0,1
2245,studi.,1,1,0,1
2280,mantenga,1,1,0,1
2282,letargiche,1,1,0,1
2216,pesante,1,1,0,1
2329,renda,1,1,0,1
2317,positivamente,1,1,0,1
2318,classificati,1,1,0,1
2319,collegate.,1,1,0,1
2320,raccolte,1,1,0,1
2322,sottoposto,1,1,0,1
2325,sbagliato».,1,1,0,1
2328,cosiddetti,1,1,0,1
2331,sguardo,1,1,0,1
2315,qualora,1,1,0,1
2336,persino,1,1,0,1
2337,svilupparono,1,1,0,1
2338,partecipando,1,1,0,1
2342,sufficientemente,1,1,0,1
2343,danno,1,1,0,1
2344,fondi,1,1,0,1
2345,addestrate,1,1,0,1
2316,omogenei.,1,1,0,1
2314,neutrale.,1,1,0,1
2284,intensificare,1,1,0,1
2300,presuppone,1,1,0,1
2286,caffè.,1,1,0,1
2287,popolarità.,1,1,0,1
2288,incroci,1,1,0,1
2289,separato,1,1,0,1
2290,villaggio,1,1,0,1
2291,sfrutta,1,1,0,1
2292,lacrime.,1,1,0,1
2301,telegiornale,1,1,0,1
2313,cominciò,1,1,0,1
2302,chiaro,1,1,0,1
2305,eventuali,1,1,0,1
2306,barzelletta,1,1,0,1
2308,stavano,1,1,0,1
2310,sistema.,1,1,0,1
2311,entità,1,1,0,1
2312,evidenziato,1,1,0,1
2217,suggerito,1,1,0,1
2212,'lento,1,1,0,1
2049,professione,1,1,0,1
2106,guscio,1,1,0,1
2094,l’apprendimento,1,1,0,1
2095,sentire,1,1,0,1
2096,stamattina,1,1,0,1
2098,matto,1,1,0,1
2099,sbalorditiva.,1,1,0,1
2102,descrivevano,1,1,0,1
2105,azioni,1,1,0,1
2108,complesse,1,1,0,1
2088,siamo,1,1,0,1
2110,paesi,1,1,0,1
2111,tanto.,1,1,0,1
2112,attivamente,1,1,0,1
2116,relazioni,1,1,0,1
2117,wikiquette.,1,1,0,1
2118,descrizione,1,1,0,1
2121,stabilito,1,1,0,1
2093,sull'argomento,1,1,0,1
2087,quotidiana.,1,1,0,1
2127,richieste.,1,1,0,1
2064,molta,1,1,0,1
2051,professori,1,1,0,1
2054,vichipedìa,1,1,0,1
2056,amica,1,1,0,1
2057,interessati,1,1,0,1
2058,dichiarazioni,1,1,0,1
2059,icona,1,1,0,1
2062,bambola,1,1,0,1
2066,sì.,1,1,0,1
2084,grado.,1,1,0,1
2068,fattibilità,1,1,0,1
2070,usarli,1,1,0,1
2071,esame,1,1,0,1
2072,rumore,1,1,0,1
2075,eravamo.,1,1,0,1
2080,nominata,1,1,0,1
2082,dall'unione,1,1,0,1
2124,entrò,1,1,0,1
2131,certo.,1,1,0,1
2211,garantendo,1,1,0,1
2181,dimostrato».,1,1,0,1
2167,vìchi,1,1,0,1
2168,restringere,1,1,0,1
2169,testimonianza,1,1,0,1
2171,successive,1,1,0,1
2173,qualunque,1,1,0,1
2176,nasa,1,1,0,1
2180,inconsistenze,1,1,0,1
2183,mandarti,1,1,0,1
2165,l'avere,1,1,0,1
2184,avesse,1,1,0,1
2186,uichipedìa,1,1,0,1
2187,l'informazione,1,1,0,1
2188,capace,1,1,0,1
2189,progettare,1,1,0,1
2201,observatory,1,1,0,1
2202,sera.,1,1,0,1
2166,energetica,1,1,0,1
2164,puoi.,1,1,0,1
2132,trovo,1,1,0,1
2149,regolarmente,1,1,0,1
2133,ingiustamente,1,1,0,1
2136,misurazione,1,1,0,1
2138,vuole.,1,1,0,1
2143,dirgli,1,1,0,1
2145,almanacchi,1,1,0,1
2146,canada,1,1,0,1
2148,merito,1,1,0,1
2150,differenti.,1,1,0,1
2161,'stanco,1,1,0,1
2151,ripristinare,1,1,0,1
2152,svolgeva,1,1,0,1
2153,tagliato,1,1,0,1
2154,dichiarò,1,1,0,1
2156,distribuzioni,1,1,0,1
2159,scientifica.,1,1,0,1
2160,trasferito,1,1,0,1
1735,rivolge,1,1,0,1
1733,coperti,1,1,0,1
1154,gradi.,1,1,0,1
1731,iniziata,1,1,0,1
1320,visita,1,1,0,1
1322,collettiva,1,1,0,1
1323,primato,1,1,0,1
1324,riferimento.,1,1,0,1
1329,scoraggiando,1,1,0,1
1330,'ringraziandoti,1,1,0,1
1332,statunitense.,1,1,0,1
1333,blocco,1,1,0,1
1337,cronologia,1,1,0,1
1339,iscriverti,1,1,0,1
1341,td-gammon,1,1,0,1
1343,occasioni.,1,1,0,1
1344,te.,1,1,0,1
1346,modificano,1,1,0,1
1347,personaggio,1,1,0,1
1348,accesso,1,1,0,1
1351,entusiasmanti,1,1,0,1
1319,definite,1,1,0,1
1317,topologia,1,1,0,1
1314,linguisticamente,1,1,0,1
1297,considerare,1,1,0,1
1288,potessi,1,1,0,1
1289,archiviate,1,1,0,1
1291,qr,1,1,0,1
1292,essersi,1,1,0,1
1294,truppe,1,1,0,1
1295,pianto,1,1,0,1
1296,prelevarne,1,1,0,1
1298,l'hardware,1,1,0,1
1311,famosa,1,1,0,1
1300,dicendomi,1,1,0,1
1302,d'attualità».,1,1,0,1
1303,modellazione.,1,1,0,1
1304,eccitante,1,1,0,1
1305,descrivere,1,1,0,1
1306,collaborativa,1,1,0,1
1309,latino,1,1,0,1
1353,degustazione,1,1,0,1
1355,arbitrale.,1,1,0,1
1357,minori.,1,1,0,1
1415,sentirai,1,1,0,1
1404,affrontare,1,1,0,1
1405,dov'eravamo,1,1,0,1
1406,riscontrati,1,1,0,1
1408,risponde,1,1,0,1
1409,amico,1,1,0,1
1413,fastidio,1,1,0,1
1414,raggiungimento,1,1,0,1
1417,survey.,1,1,0,1
1394,viveva,1,1,0,1
1418,apporto,1,1,0,1
1420,efficaci,1,1,0,1
1424,veneto,1,1,0,1
1425,proporzione,1,1,0,1
1428,semplificare,1,1,0,1
1429,giorno.,1,1,0,1
1433,avvicinarsi,1,1,0,1
1403,portabilità,1,1,0,1
1393,rileva,1,1,0,1
1358,ricorda.,1,1,0,1
1371,l'aspetto,1,1,0,1
1359,sphinxsystem,1,1,0,1
1360,espressi,1,1,0,1
1362,riportato,1,1,0,1
1363,accadeva,1,1,0,1
1366,annualmente,1,1,0,1
1367,convinzione,1,1,0,1
1368,confondi,1,1,0,1
1373,eccetto,1,1,0,1
1392,minacce,1,1,0,1
1374,nupedia.com,1,1,0,1
1376,sbatté,1,1,0,1
1379,romagnolo.,1,1,0,1
1380,secolo,1,1,0,1
1381,discipline.,1,1,0,1
1383,britannico,1,1,0,1
1391,concedere,1,1,0,1
1285,comparativo,1,1,0,1
1284,gamma,1,1,0,1
1283,palomar,1,1,0,1
1210,supponiamo,1,1,0,1
1198,abbracciare,1,1,0,1
1200,dell'ozono,1,1,0,1
1201,viaggio,1,1,0,1
1204,classi,1,1,0,1
1205,dolly,1,1,0,1
1206,interessato.,1,1,0,1
1209,intervallo,1,1,0,1
1211,dorate,1,1,0,1
1193,tarantino.,1,1,0,1
1213,sfoggio».,1,1,0,1
1214,casuale,1,1,0,1
1221,wiki-,1,1,0,1
1222,venivano,1,1,0,1
1224,raggi,1,1,0,1
1225,amici.,1,1,0,1
1227,distribuibile.,1,1,0,1
1196,lui».,1,1,0,1
1190,settimane,1,1,0,1
1229,veicoli,1,1,0,1
1168,svariati,1,1,0,1
1156,un'analisi,1,1,0,1
1157,offrirti,1,1,0,1
1158,linguistici,1,1,0,1
1160,interattiva,1,1,0,1
1161,classica,1,1,0,1
1164,primitivi,1,1,0,1
1166,solito.,1,1,0,1
1169,attive,1,1,0,1
1189,diversi.,1,1,0,1
1172,modellazione,1,1,0,1
1179,all'inserimento,1,1,0,1
1180,g.,1,1,0,1
1182,conferisce,1,1,0,1
1184,specializzate,1,1,0,1
1185,dell'interpretazione,1,1,0,1
1187,costituire,1,1,0,1
1228,catturata,1,1,0,1
1230,dicono.,1,1,0,1
1282,dovrai,1,1,0,1
1269,commesso,1,1,0,1
1262,errati,1,1,0,1
1263,incredibilmente,1,1,0,1
1264,priva,1,1,0,1
1265,l'apprendimento.,1,1,0,1
1266,fluenti,1,1,0,1
1267,contraddittorie,1,1,0,1
1268,introduction,1,1,0,1
1270,gravi,1,1,0,1
1258,volume,1,1,0,1
1272,pronunciare,1,1,0,1
1273,prefisso,1,1,0,1
1274,guadagno,1,1,0,1
1275,canepari,1,1,0,1
1276,controllati,1,1,0,1
1280,abbi,1,1,0,1
1281,reciproche,1,1,0,1
1261,opposti,1,1,0,1
1257,volutamente,1,1,0,1
1231,ispirati,1,1,0,1
1244,giovanni,1,1,0,1
1234,addestrati,1,1,0,1
1236,imparato,1,1,0,1
1237,delizioso,1,1,0,1
1238,ottimo,1,1,0,1
1239,importanza.,1,1,0,1
1242,apparisse,1,1,0,1
1243,sostiene,1,1,0,1
1245,dall'ottenere,1,1,0,1
1256,risultato,1,1,0,1
1246,troll,1,1,0,1
1247,vivente.,1,1,0,1
1248,sopra,1,1,0,1
1251,onestamente,1,1,0,1
1253,spostano,1,1,0,1
1254,nessuno,1,1,0,1
1255,dell'efficacia,1,1,0,1
1436,verità,1,1,0,1
1437,pregiudizievoli,1,1,0,1
1438,ecco,1,1,0,1
1654,pappas,1,1,0,1
1640,fermarti,1,1,0,1
1641,l'accademia,1,1,0,1
1643,coniato,1,1,0,1
1648,accettato,1,1,0,1
1649,rimosso.,1,1,0,1
1650,documentata,1,1,0,1
1653,supposta,1,1,0,1
1655,necessaria.,1,1,0,1
1635,enciclopedici,1,1,0,1
1656,autobus,1,1,0,1
1657,strutturali,1,1,0,1
1660,nasce,1,1,0,1
1662,istituti,1,1,0,1
1665,ottobre,1,1,0,1
1666,definibile,1,1,0,1
1667,uniforme,1,1,0,1
1636,caldo,1,1,0,1
1633,marmellate.,1,1,0,1
1670,incorporati,1,1,0,1
1618,useresti,1,1,0,1
1601,casi.,1,1,0,1
1603,crescerli,1,1,0,1
1604,scritto,1,1,0,1
1607,strutture,1,1,0,1
1610,danah,1,1,0,1
1614,pensanti,1,1,0,1
1616,«curare,1,1,0,1
1619,cognitivi.,1,1,0,1
1630,consultazione.,1,1,0,1
1620,/wikipeˈdia/,1,1,0,1
1621,istituzionale,1,1,0,1
1622,preoccupare.,1,1,0,1
1624,motivi,1,1,0,1
1625,all'enorme,1,1,0,1
1626,sull'arte,1,1,0,1
1629,epoca,1,1,0,1
1668,considerano,1,1,0,1
1673,l'aggiunta,1,1,0,1
1596,adattivi,1,1,0,1
1715,stabilita,1,1,0,1
1704,generare,1,1,0,1
1706,aperte,1,1,0,1
1708,poeta,1,1,0,1
1709,letto,1,1,0,1
1711,wikipediano,1,1,0,1
1712,pigro.,1,1,0,1
1714,dell'esperimento,1,1,0,1
1716,migrata,1,1,0,1
1702,svolgere,1,1,0,1
1718,ambizioso,1,1,0,1
1719,implicite,1,1,0,1
1720,seduta,1,1,0,1
1721,finire,1,1,0,1
1725,comparabili,1,1,0,1
1727,dell'opera,1,1,0,1
1728,utilità,1,1,0,1
1703,rappresentano,1,1,0,1
1701,esatti,1,1,0,1
1674,continua,1,1,0,1
1687,l'albero,1,1,0,1
1675,supplementari,1,1,0,1
1676,l'output,1,1,0,1
1677,poter,1,1,0,1
1679,sovrappongono,1,1,0,1
1681,viaggi,1,1,0,1
1682,costruire,1,1,0,1
1685,volessi,1,1,0,1
1688,tardo,1,1,0,1
1698,passarmi,1,1,0,1
1691,vandalizzata,1,1,0,1
1692,prestigiose,1,1,0,1
1693,metodologici,1,1,0,1
1694,applicare,1,1,0,1
1695,circondano,1,1,0,1
1696,supervisione,1,1,0,1
1697,equilibrato,1,1,0,1
1599,indicato,1,1,0,1
1595,scarsa.,1,1,0,1
1442,appartenente,1,1,0,1
1496,peggio,1,1,0,1
1482,benvenuti,1,1,0,1
1485,comprensione,1,1,0,1
1486,celesti,1,1,0,1
1487,scelte,1,1,0,1
1490,stabiliscono,1,1,0,1
1492,facendo.,1,1,0,1
1493,pensate,1,1,0,1
1497,dimenticano,1,1,0,1
1479,tematiche,1,1,0,1
1498,impedire,1,1,0,1
1499,all'accuratezza.,1,1,0,1
1500,clonazione,1,1,0,1
1501,abusata,1,1,0,1
1502,italiano.,1,1,0,1
1503,partita,1,1,0,1
1505,portoghese,1,1,0,1
1480,inizia,1,1,0,1
1478,fallimenti,1,1,0,1
1510,legislativo,1,1,0,1
1461,chiave,1,1,0,1
1446,scrisse,1,1,0,1
1447,sappi,1,1,0,1
1451,incontrarmi,1,1,0,1
1452,rendi,1,1,0,1
1454,alfabeti,1,1,0,1
1455,avanzamenti,1,1,0,1
1459,obiettivi,1,1,0,1
1462,compone,1,1,0,1
1477,restrittiva,1,1,0,1
1463,aggiunta,1,1,0,1
1465,scena,1,1,0,1
1469,reputazione,1,1,0,1
1471,vocabolario,1,1,0,1
1472,dominavano,1,1,0,1
1474,buone,1,1,0,1
1476,valida,1,1,0,1
1508,sbalordita,1,1,0,1
1511,professionale,1,1,0,1
1593,farsi,1,1,0,1
1578,digitalizzati,1,1,0,1
1560,bevanda,1,1,0,1
1563,cavaliere.,1,1,0,1
1564,utilizzano,1,1,0,1
1565,facoltà,1,1,0,1
1566,benvenuto.,1,1,0,1
1569,l'eliminazione,1,1,0,1
1576,povero,1,1,0,1
1580,ero,1,1,0,1
1554,brutto,1,1,0,1
1584,lombardo.,1,1,0,1
1585,l'annata.,1,1,0,1
1586,pazienza,1,1,0,1
1587,plausi,1,1,0,1
1588,'gli,1,1,0,1
1590,blair.»,1,1,0,1
1591,smussato,1,1,0,1
1558,incrociate.,1,1,0,1
1551,coniò,1,1,0,1
1513,esistevano,1,1,0,1
1537,ripeterlo.,1,1,0,1
1517,lavorava,1,1,0,1
1518,sposati,1,1,0,1
1519,scientifici.,1,1,0,1
1522,prestarmi,1,1,0,1
1529,rosso.,1,1,0,1
1533,espressa,1,1,0,1
1536,biforcazione,1,1,0,1
1538,sua.,1,1,0,1
1549,malefatta,1,1,0,1
1539,considerazione,1,1,0,1
1540,specializzati,1,1,0,1
1544,esibire,1,1,0,1
1545,chiarire,1,1,0,1
1546,sesto,1,1,0,1
1547,efficiente,1,1,0,1
1548,l'episodio.,1,1,0,1
4502,prøver,0,0,1,1
4505,النقاد,0,0,1,1
8427,erbjudande.,0,0,1,1
6989,administradores.,0,0,1,1
7151,кэширующих,0,0,1,1
7152,declined,0,0,1,1
7154,magnifique.,0,0,1,1
7155,لها.,0,0,1,1
7156,соответствующую,0,0,1,1
7159,அழுத்துவதன்,0,0,1,1
7161,освещение,0,0,1,1
7162,попадете,0,0,1,1
7163,உலகம்,0,0,1,1
7164,gange.,0,0,1,1
7166,medverkan,0,0,1,1
7168,والعبارات,0,0,1,1
7169,нужен,0,0,1,1
7171,взял,0,0,1,1
7173,محاولة,0,0,1,1
7174,കൂടുതലും,0,0,1,1
7176,وجود,0,0,1,1
7150,வந்தது,0,0,1,1
7148,स्कॉटिश,0,0,1,1
7147,bones,0,0,1,1
7129,рекорд,0,0,1,1
7115,குறுக்கிட்டதற்கு,0,0,1,1
7116,ಬಳಸಬಾರದು.,0,0,1,1
7120,atribuir,0,0,1,1
7124,നിങ്ങൾക്കത്,0,0,1,1
7125,обновлённый,0,0,1,1
7126,heb.,0,0,1,1
7128,நினைத்தாள்.,0,0,1,1
7134,ideias.,0,0,1,1
7146,رحلتك.,0,0,1,1
7135,خاصة.,0,0,1,1
7137,совсем,0,0,1,1
7138,azb •,0,0,1,1
7139,anlatabilir,0,0,1,1
7141,hayas,0,0,1,1
7142,kalifornien,0,0,1,1
7145,نقاش,0,0,1,1
7177,favoriniz,0,0,1,1
7180,guldbrød,0,0,1,1
7181,turner,0,0,1,1
7221,chateado.,0,0,1,1
7210,напомнить,0,0,1,1
7211,ümmete,0,0,1,1
7212,الأفارقة,0,0,1,1
7214,doorheeft,0,0,1,1
7215,заставило,0,0,1,1
7216,stiegler,0,0,1,1
7218,തോന്നുന്നതുപോലെ,0,0,1,1
7222,saati,0,0,1,1
7207,محتواها,0,0,1,1
7223,kvantitativ,0,0,1,1
7225,സമ്പർക്കം,0,0,1,1
7227,schmeckendes,0,0,1,1
7228,высокий,0,0,1,1
7229,വാക്കിനെക്കുറിച്ച്,0,0,1,1
7230,gekeken.,0,0,1,1
7231,ಉದ್ಯೋಗವನ್ನು,0,0,1,1
7208,existé,0,0,1,1
7206,повторила,0,0,1,1
7182,pretendientes,0,0,1,1
7192,पात्र,0,0,1,1
7184,κήπο,0,0,1,1
7185,المساء,0,0,1,1
7186,இல்லாத,0,0,1,1
7187,πιάτο,0,0,1,1
7188,colonisés.,0,0,1,1
7190,ನೆನಪಿಸಲು,0,0,1,1
7191,universiteit,0,0,1,1
7193,senere,0,0,1,1
7204,exactitud,0,0,1,1
7194,olsaydı,0,0,1,1
7196,az •,0,0,1,1
7197,पर्यटक,0,0,1,1
7199,fortsätt.,0,0,1,1
7200,لتخبره,0,0,1,1
7202,verloren,0,0,1,1
7203,ремонтом,0,0,1,1
7113,мировой,0,0,1,1
7112,ತೊಂದರೆಗೊಳಿಸಿದ್ದಕ್ಕೆ,0,0,1,1
7110,füße,0,0,1,1
7035,alias.,0,0,1,1
7022,உங்களால்,0,0,1,1
7023,सबस्क्रिप्शन-ओनली,0,0,1,1
7024,दर्जे,0,0,1,1
7025,índice,0,0,1,1
7026,لمنتدى,0,0,1,1
7028,aangenaam,0,0,1,1
7031,judiciaires.,0,0,1,1
7036,ಮಾಡಲಿದೆ,0,0,1,1
7019,самоорганизацией.,0,0,1,1
7037,tadic,0,0,1,1
7038,الأخيرة.,0,0,1,1
7040,വസ്ത്രധാരണരീതി,0,0,1,1
7041,വിളിക്കാൻ,0,0,1,1
7042,الألعاب,0,0,1,1
7043,revenue,0,0,1,1
7044,بالطبع.,0,0,1,1
7021,baserade,0,0,1,1
7018,juridiques,0,0,1,1
7047,mémoire,0,0,1,1
7002,ursprungliga,0,0,1,1
6992,s'oppose,0,0,1,1
6993,bag,0,0,1,1
6996,actuales.,0,0,1,1
6997,eraan,0,0,1,1
6998,independentemente,0,0,1,1
7000,शिक्षाविदों,0,0,1,1
7001,εμείς',0,0,1,1
7003,l'attention,0,0,1,1
7017,καλοσύνης,0,0,1,1
7004,kızmışım,0,0,1,1
7008,കർണ്ണാടകയും,0,0,1,1
7009,фотографиями,0,0,1,1
7010,telgraf,0,0,1,1
7012,adlı,0,0,1,1
7014,açıda,0,0,1,1
7016,condenou,0,0,1,1
7046,travlt.,0,0,1,1
7048,المتطوعين،,0,0,1,1
7109,ಹಸಿವಿನಿಂದ,0,0,1,1
7092,οκτώ,0,0,1,1
7080,esfuerzos,0,0,1,1
7082,комитеты,0,0,1,1
7085,знаком.,0,0,1,1
7086,adjö,0,0,1,1
7089,yield,0,0,1,1
7090,terra.,0,0,1,1
7091,roger,0,0,1,1
7093,aplicações,0,0,1,1
7078,geléias,0,0,1,1
7097,exemplos.,0,0,1,1
7098,semejanza,0,0,1,1
7099,ملحمي,0,0,1,1
7100,criterios.,0,0,1,1
7101,δω.,0,0,1,1
7102,читателям,0,0,1,1
7107,overdrive,0,0,1,1
7079,золота.,0,0,1,1
7077,விடுங்கள்.,0,0,1,1
7049,διαδικτυακή,0,0,1,1
7061,passerait,0,0,1,1
7050,مختلف,0,0,1,1
7051,diferencia,0,0,1,1
7052,சம்பவங்கள்,0,0,1,1
7053,vapeur,0,0,1,1
7057,technological,0,0,1,1
7058,வித்தியாசமாகக்,0,0,1,1
7060,وكلمات,0,0,1,1
7062,raderingspolicy.,0,0,1,1
7076,comunicación.,0,0,1,1
7063,cruelle,0,0,1,1
7067,conseguiu.,0,0,1,1
7069,ecoregion,0,0,1,1
7070,accepteert,0,0,1,1
7072,independencias,0,0,1,1
7074,perhaps,0,0,1,1
7075,framträdande,0,0,1,1
7233,respetarla.,0,0,1,1
7234,quarta,0,0,1,1
7235,​​en,0,0,1,1
7394,não-ficção,0,0,1,1
7385,syrien,0,0,1,1
7387,شاكرا,0,0,1,1
7388,fishing,0,0,1,1
7389,некоторого,0,0,1,1
7391,relevé,0,0,1,1
7392,sansade,0,0,1,1
7393,बाधित,0,0,1,1
7395,മൂർച്ചയെ,0,0,1,1
7383,desejar,0,0,1,1
7398,messages,0,0,1,1
7399,stinkende,0,0,1,1
7400,والسياسية.,0,0,1,1
7401,ಇತ್ತು,0,0,1,1
7402,آرثر,0,0,1,1
7403,കാണുന്നില്ലെങ്കിൽ.,0,0,1,1
7404,الأوربية,0,0,1,1
7384,codfw,0,0,1,1
7381,താൽപ്പര്യമില്ല,0,0,1,1
7408,anlaman,0,0,1,1
7364,exploratory,0,0,1,1
7353,كاتب,0,0,1,1
7355,static,0,0,1,1
7358,visie,0,0,1,1
7359,слышал,0,0,1,1
7360,редактируется,0,0,1,1
7362,d'exclure,0,0,1,1
7363,difíciles,0,0,1,1
7367,τουρίστας,0,0,1,1
7380,plotkin,0,0,1,1
7368,класс,0,0,1,1
7370,fournit,0,0,1,1
7371,неполными,0,0,1,1
7372,şükür,0,0,1,1
7373,beispiele,0,0,1,1
7374,quería,0,0,1,1
7376,ബുദ്ധിയുടെ,0,0,1,1
7407,скорее,0,0,1,1
7409,« vitaliste »,0,0,1,1
7351,interglaciaires,0,0,1,1
7458,പാട്ടുകളിൽ,0,0,1,1
7447,ಮಹಾಕಾವ್ಯವನ್ನು,0,0,1,1
7448,организациями,0,0,1,1
7449,παγκόσμια,0,0,1,1
7450,രചയിതാവില്ല.,0,0,1,1
7453,autocorregirse.,0,0,1,1
7454,recommandations,0,0,1,1
7456,редактора,0,0,1,1
7459,özgürlüğüm,0,0,1,1
7442,arcaísmo,0,0,1,1
7461,.nous,0,0,1,1
7462,தேவதையைப்,0,0,1,1
7463,φοβάμαι.,0,0,1,1
7464,införandet,0,0,1,1
7465,ettim.,0,0,1,1
7466,செய்யப்பட்டுள்ளன.,0,0,1,1
7467,بخلاف,0,0,1,1
7444,skriverier,0,0,1,1
7441,οδηγίες,0,0,1,1
7410,الأولى،,0,0,1,1
7425,مراجعة.,0,0,1,1
7414,обобщению,0,0,1,1
7415,formidable,0,0,1,1
7418,presos.,0,0,1,1
7419,grec.,0,0,1,1
7420,asegúrate,0,0,1,1
7422,умного,0,0,1,1
7424,“poor,0,0,1,1
7426,ederseniz,0,0,1,1
7440,മാതൃകയിലുള്ള,0,0,1,1
7427,judaïque,0,0,1,1
7429,konuşuyordun,0,0,1,1
7433,வேண்டுமானாலும்,0,0,1,1
7434,കരയുന്നത്,0,0,1,1
7435,wiknic,0,0,1,1
7438,сон.,0,0,1,1
7439,فظة,0,0,1,1
7352,voldtægtshændelser,0,0,1,1
7350,canapé.,0,0,1,1
7236,بالمائة،,0,0,1,1
7273,l’on,0,0,1,1
7262,oproportionerligt,0,0,1,1
7266,viktig.,0,0,1,1
7267,geschehen.,0,0,1,1
7268,викисклада,0,0,1,1
7269,spring,0,0,1,1
7270,bebek,0,0,1,1
7271,internetencyclopedie,0,0,1,1
7275,nachts,0,0,1,1
7260,'wikipedian,0,0,1,1
7277,necrológicas,0,0,1,1
7278,προέλευση,0,0,1,1
7280,forestil,0,0,1,1
7281,யாரும்,0,0,1,1
7282,d'évolution,0,0,1,1
7283,älskade,0,0,1,1
7286,amazon,0,0,1,1
7261,справа,0,0,1,1
7259,மாண்டி’,0,0,1,1
7288,हों।इन,0,0,1,1
7245,mordaza,0,0,1,1
7237,précisant ,0,0,1,1
7238,അമ്മയായിരുന്നു,0,0,1,1
7239,പുറത്താക്കിയത്,0,0,1,1
7240,போகும்,0,0,1,1
7241,والكورية،,0,0,1,1
7242,ஆனது,0,0,1,1
7243,teklifini,0,0,1,1
7246,religiously,0,0,1,1
7258,ох,0,0,1,1
7247,பார்த்தபோது,0,0,1,1
7248,πληρώσει,0,0,1,1
7249,kanala,0,0,1,1
7250,fodre,0,0,1,1
7253,icke-engelska,0,0,1,1
7255,remercie,0,0,1,1
7256,وأقول,0,0,1,1
7287,மறைக்க,0,0,1,1
7291,легче,0,0,1,1
7349,hypotheses.,0,0,1,1
7333,ejército,0,0,1,1
7321,प्रणालीगत,0,0,1,1
7323,inseridas,0,0,1,1
7324,воспроизводимость.,0,0,1,1
7325,översvämning,0,0,1,1
7327,carbon,0,0,1,1
7329,അല്ലാത്തവയെയും,0,0,1,1
7332,divisant,0,0,1,1
7334,قرض,0,0,1,1
7319,driveway.,0,0,1,1
7335,animales,0,0,1,1
7336,الطفولة،,0,0,1,1
7339,ownership,0,0,1,1
7341,philosophy[ak],0,0,1,1
7343,bem-educado,0,0,1,1
7344,ചെയ്യാമെന്ന്,0,0,1,1
7345,nimmst,0,0,1,1
7320,по-английски,0,0,1,1
7314,அதைக்,0,0,1,1
7292,aldın,0,0,1,1
7300,வார்த்தைகளுக்கு,0,0,1,1
7293,снилось.,0,0,1,1
7294,ஒருங்கிணைந்து,0,0,1,1
7295,keuzes,0,0,1,1
7296,latitudinal,0,0,1,1
7297,हटाया,0,0,1,1
7298,exibição,0,0,1,1
7299,el •,0,0,1,1
7302,flahault,0,0,1,1
7313,l’utilisateur,0,0,1,1
7304,m.m.e.,0,0,1,1
7305,ಹೊರಬಂದು,0,0,1,1
7306,asteroid,0,0,1,1
7307,ساعدني,0,0,1,1
7308,കാണാനായതിൽ,0,0,1,1
7309,محق,0,0,1,1
7312,incógnito,0,0,1,1
6991,പലരുണ്ടാവും.അവരുടെ,0,0,1,1
6987,hours.,0,0,1,1
7474,ചീത്തയാണോ,0,0,1,1
6986,войны.,0,0,1,1
6654,юнеско,0,0,1,1
6657,wunderschön,0,0,1,1
6658,μεγαλώσει,0,0,1,1
6661,отличный,0,0,1,1
6663,filme,0,0,1,1
6665,créationniste,0,0,1,1
6668,badly,0,0,1,1
6671,primair,0,0,1,1
6672,« wikipedia »,0,0,1,1
6676,restricted,0,0,1,1
6677,„ахиллесовой,0,0,1,1
6678,контента,0,0,1,1
6680,വളരെയധികമില്ല.,0,0,1,1
6681,السيبوانية,0,0,1,1
6683,bilgisayara,0,0,1,1
6686,ഉദാ‍ഹരണത്തിന്,0,0,1,1
6687,eigendom,0,0,1,1
6653,someone.,0,0,1,1
6652,attribution-sharealike,0,0,1,1
6651,переживает,0,0,1,1
6631,law',0,0,1,1
6616,bewildered,0,0,1,1
6617,طبيعي,0,0,1,1
6619,வாரம்,0,0,1,1
6623,tvärt,0,0,1,1
6627,وارد,0,0,1,1
6628,emprega,0,0,1,1
6630,вдохновлённые,0,0,1,1
6635,माइक्रोसोफ्ट,0,0,1,1
6650,второе,0,0,1,1
6636,wikimedia ,0,0,1,1
6637,påbörja,0,0,1,1
6640,प्रतिनिधित्व,0,0,1,1
6643,yunan,0,0,1,1
6645,\}},0,0,1,1
6646,wikiwikiweb[ad].,0,0,1,1
6649,varsayılmaktadır.,0,0,1,1
6688,derecho,0,0,1,1
6690,придумана,0,0,1,1
6691,incompletas.,0,0,1,1
6735,وبالمثل،,0,0,1,1
6724,सही-सही,0,0,1,1
6726,adjö.,0,0,1,1
6727,reportaje,0,0,1,1
6728,смотрели,0,0,1,1
6729,figurant,0,0,1,1
6733,शो,0,0,1,1
6734,globally.,0,0,1,1
6736,سروري.,0,0,1,1
6721,matbordet,0,0,1,1
6737,resimler,0,0,1,1
6739,жизни.,0,0,1,1
6740,verdadeiras,0,0,1,1
6742,descrito,0,0,1,1
6744,jornalista,0,0,1,1
6745,thick,0,0,1,1
6746,तारास्कीविका,0,0,1,1
6723,കൂടെ,0,0,1,1
6720,ಪಡೆಯಬೇಕು,0,0,1,1
6692,ഓഫറുകൾ,0,0,1,1
6705,സ്റ്റോപ്പ്,0,0,1,1
6696,motsvarar,0,0,1,1
6697,गूंगा,0,0,1,1
6698,propelling,0,0,1,1
6699,californien.,0,0,1,1
6700,आंकडे,0,0,1,1
6703,ಪಕ್ಷಿಗಳಂತೆ,0,0,1,1
6704,toulouse,0,0,1,1
6706,república,0,0,1,1
6719,erreurs.,0,0,1,1
6707,مناقشة,0,0,1,1
6710,проведено,0,0,1,1
6713,fylla,0,0,1,1
6714,собираемся,0,0,1,1
6715,subvenciones,0,0,1,1
6717,​​du,0,0,1,1
6718,greek,0,0,1,1
6613,surgiram.,0,0,1,1
6612,doublé ,0,0,1,1
6610,ദിനപത്രങ്ങളാണ്.,0,0,1,1
6539,corporativa.,0,0,1,1
6527,extending,0,0,1,1
6529,प्रविष्टियां,0,0,1,1
6531,പഠിച്ചു,0,0,1,1
6532,हिसाब,0,0,1,1
6533,kaba,0,0,1,1
6535,പദമാണ്.,0,0,1,1
6536,malheureusement,0,0,1,1
6540,ಉದಾಹರಣೆ.,0,0,1,1
6525,конфликтам,0,0,1,1
6541,‘கணினிச்,0,0,1,1
6542,الرطبة,0,0,1,1
6543,περιμένει.,0,0,1,1
6544,takılmıyorsun,0,0,1,1
6546,получив,0,0,1,1
6547,फर्जी,0,0,1,1
6548,oturan,0,0,1,1
6526,सारी,0,0,1,1
6523,fixe ,0,0,1,1
6551,ht •,0,0,1,1
6505,employees,0,0,1,1
6492,columbia,0,0,1,1
6495,immanente,0,0,1,1
6496,oprichters,0,0,1,1
6497,pedofilia,0,0,1,1
6500,विनैरे,0,0,1,1
6502,nodige,0,0,1,1
6504,alamaz.,0,0,1,1
6506,mer.,0,0,1,1
6519,revient,0,0,1,1
6507,इमिलियाई-रोमग्नोल,0,0,1,1
6508,പഠനത്തിലൂടെ,0,0,1,1
6509,പ്രവർത്തിക്കുമെന്ന്,0,0,1,1
6510,പഠിക്കുന്നുണ്ടെങ്കിൽ‌,0,0,1,1
6511,വരുമ്പൊൾ,0,0,1,1
6517,എത്രത്തോളമാവണം,0,0,1,1
6518,चित्रमाला,0,0,1,1
6550,गाइडस्टार,0,0,1,1
6552,профессиональных,0,0,1,1
6609,meşhur,0,0,1,1
6590,çalışmanız,0,0,1,1
6580,கொள்ளாதீர்கள்.,0,0,1,1
6581,программное,0,0,1,1
6582,வழங்கிகள்,0,0,1,1
6584,också.,0,0,1,1
6585,بينهم،,0,0,1,1
6586,أقبل,0,0,1,1
6588,owners,0,0,1,1
6591,കണക്ക്,0,0,1,1
6578,плюрипотентности,0,0,1,1
6592,بإغرائهم,0,0,1,1
6593,maravilhada,0,0,1,1
6594,coloquialmente,0,0,1,1
6597,skrivstugor,0,0,1,1
6599,entgegen,0,0,1,1
6601,ಹೋದರು.,0,0,1,1
6608,assiste,0,0,1,1
6579,αργός,0,0,1,1
6576,abd'nin,0,0,1,1
6553,exposición,0,0,1,1
6565,taxonomía,0,0,1,1
6556,чудовищный,0,0,1,1
6557,тегами,0,0,1,1
6558,attachées,0,0,1,1
6560,общим,0,0,1,1
6561,årevis,0,0,1,1
6562,सोचिए,0,0,1,1
6563,قمت,0,0,1,1
6566,ಫ್ರೆಂಚ್,0,0,1,1
6574,mandiberg,0,0,1,1
6567,μιλούσε,0,0,1,1
6568,eklemeler,0,0,1,1
6569,ದುರಸ್ತಿ,0,0,1,1
6570,rodord,0,0,1,1
6571,குறிப்பிடப்படுகிறது.,0,0,1,1
6572,healing,0,0,1,1
6573,colonisation,0,0,1,1
6747,медлительный,0,0,1,1
6748,ideográmicos,0,0,1,1
6749,harte.,0,0,1,1
6915,alltag,0,0,1,1
6907,localizados,0,0,1,1
6909,knapphändigt,0,0,1,1
6910,willkommen,0,0,1,1
6911,وسأل,0,0,1,1
6912,ಶುಕ್ರವಾರವಾಗಿದ್ದರೆ.,0,0,1,1
6913,ड्रिंक,0,0,1,1
6914,представлена,0,0,1,1
6916,nämnt,0,0,1,1
6903,அப்பால்,0,0,1,1
6917,эксперименты,0,0,1,1
6918,ಪ್ರಾಣಿ.,0,0,1,1
6919,अभिनय,0,0,1,1
6921,tembelleştiriyor,0,0,1,1
6922,مستويين,0,0,1,1
6924,sulter,0,0,1,1
6925,teknik,0,0,1,1
6905,unavailability,0,0,1,1
6902,mobilanpassade,0,0,1,1
6929,sitzen.,0,0,1,1
6887,صرح,0,0,1,1
6878,സ്വപ്നങ്ങളുടെ,0,0,1,1
6880,animaux ,0,0,1,1
6881,жаргоне,0,0,1,1
6882,zusammen.,0,0,1,1
6884,haberlerde,0,0,1,1
6885,engelsksprogede,0,0,1,1
6886,الإشارة,0,0,1,1
6888,hävdar,0,0,1,1
6898,millimètre[réf.,0,0,1,1
6890,μένα.,0,0,1,1
6891,تفضل.,0,0,1,1
6892,d'analyses,0,0,1,1
6893,собственности[неавторитетный,0,0,1,1
6895,തീര്ച്ചയായും,0,0,1,1
6896,பிற்பகுதியில்,0,0,1,1
6897,беспорядок.,0,0,1,1
6926,minutiae.,0,0,1,1
6931,الكسل,0,0,1,1
6875,eenieder,0,0,1,1
6973,оскорбительными,0,0,1,1
6963,revoir,0,0,1,1
6967,pick,0,0,1,1
6968,стивен,0,0,1,1
6969,внимательно,0,0,1,1
6970,സർവ്വകലാശാലയിൽ,0,0,1,1
6971,abarcar,0,0,1,1
6972,கடந்துவிட்டீர்கள்,0,0,1,1
6974,acéfalo.,0,0,1,1
6961,समानता,0,0,1,1
6976,«trabajadores,0,0,1,1
6979,διακόψαμε.,0,0,1,1
6980,நிச்சயமாக.,0,0,1,1
6981,മാസങ്ങളിൽ,0,0,1,1
6983,предыдущей,0,0,1,1
6984,கண்டீர்கள்,0,0,1,1
6985,waarbij,0,0,1,1
6962,барак,0,0,1,1
6960,argentine,0,0,1,1
6938,شخصياتها,0,0,1,1
6949,¿y,0,0,1,1
6939,इंडेक्सिंग।,0,0,1,1
6941,तीखे,0,0,1,1
6943,[[चित्रwiki,0,0,1,1
6944,corrigi-los,0,0,1,1
6945,spændende,0,0,1,1
6947,escudo,0,0,1,1
6948,yapılabilir.,0,0,1,1
6950,entités,0,0,1,1
6959,edelsteinen,0,0,1,1
6951,recorde,0,0,1,1
6952,وضعت,0,0,1,1
6954,മനുഷ്യനിർമിതമായ,0,0,1,1
6955,понимающей,0,0,1,1
6956,dérange-t-il,0,0,1,1
6957,colaborou,0,0,1,1
6958,χρησιμοποιήθηκε,0,0,1,1
6877,ಅವುಗಳ,0,0,1,1
6874,വിക്കിപീഡിയരേയും,0,0,1,1
6755,inverificáveis,0,0,1,1
6803,secretamente,0,0,1,1
6791,refere,0,0,1,1
6792,ansvarlige,0,0,1,1
6793,xvii°siècle,0,0,1,1
6795,തടയുവാനായി,0,0,1,1
6798,uteslutande,0,0,1,1
6800,വിവരിക്കുന്നുള്ളൂ,0,0,1,1
6801,mühim,0,0,1,1
6804,பயணம்,0,0,1,1
6788,привлечь,0,0,1,1
6805,inclusief,0,0,1,1
6806,collaborativement,0,0,1,1
6807,انعكاسه,0,0,1,1
6808,कॉर्सिकाई,0,0,1,1
6809,«нупедии» ,0,0,1,1
6810,officer,0,0,1,1
6815,ന്യൂപീഡിയയെ,0,0,1,1
6790,zweedstalige,0,0,1,1
6786,altavoz.,0,0,1,1
6817,faune,0,0,1,1
6767,procedures,0,0,1,1
6756,d'affiliation,0,0,1,1
6758,título,0,0,1,1
6759,théologico-politique,0,0,1,1
6761,способный,0,0,1,1
6764,رأسه.,0,0,1,1
6765,dragging,0,0,1,1
6766,legislação,0,0,1,1
6768,alguma.,0,0,1,1
6783,yakalayana,0,0,1,1
6770,tillämpa,0,0,1,1
6771,edifícios,0,0,1,1
6772,координационным,0,0,1,1
6776,magiske,0,0,1,1
6779,zoekmachines,0,0,1,1
6780,concurrents.,0,0,1,1
6782,செய்யப்படுகின்றன.,0,0,1,1
6816,human-made,0,0,1,1
6818,présenté,0,0,1,1
6873,журналов.,0,0,1,1
6857,redistribuí-lo,0,0,1,1
6845,années ».,0,0,1,1
6846,நடந்த,0,0,1,1
6849,hatan,0,0,1,1
6853,брендом,0,0,1,1
6854,moeilijke,0,0,1,1
6855,belangrijke,0,0,1,1
6856,महिला,0,0,1,1
6858,sorge.,0,0,1,1
6843,π.χ.,0,0,1,1
6861,ಎಳೆಯಿರಿ.,0,0,1,1
6862,otobüsümüz,0,0,1,1
6863,ഘട്ടത്തിലും,0,0,1,1
6865,бесполезен,0,0,1,1
6866,webbtjänsten,0,0,1,1
6869,сводятся,0,0,1,1
6870,amplia,0,0,1,1
6844,പറ്റിയെഴുതുന്നു.,0,0,1,1
6842,بطء,0,0,1,1
6820,perfecta.,0,0,1,1
6830,неестественно.,0,0,1,1
6821,d’interprétabilité,0,0,1,1
6822,مستنقع,0,0,1,1
6824,précédentes,0,0,1,1
6826,categoría,0,0,1,1
6827,égoïste,0,0,1,1
6828,savez.,0,0,1,1
6829,débattre,0,0,1,1
6831,المشاركون,0,0,1,1
6840,subsidiaria,0,0,1,1
6832,μπαλκόνι,0,0,1,1
6834,эразма.,0,0,1,1
6835,تشجيعاً,0,0,1,1
6836,гавайского,0,0,1,1
6837,എഡിറ്റ്,0,0,1,1
6838,उपलब्धियों,0,0,1,1
6839,اللاحق,0,0,1,1
7471,ಮಂದ,0,0,1,1
7475,noem,0,0,1,1
6490,وتركز,0,0,1,1
7948,zim,0,0,1,1
8100,lagts,0,0,1,1
8101,ಕೆಟ್ಟ,0,0,1,1
8103,ஹவாய்,0,0,1,1
8105,hjørnet,0,0,1,1
8106,telegramm,0,0,1,1
8107,tuzu,0,0,1,1
8110,verticale,0,0,1,1
8111,يد,0,0,1,1
8112,cantonês,0,0,1,1
8113,ಸರಿಯಾಗಿದ್ದೇನೆ,0,0,1,1
8115,неточностей ,0,0,1,1
8116,താഴെയാണ്.,0,0,1,1
8118,ज़ेड,0,0,1,1
8119,lis,0,0,1,1
8120,naturalmente,0,0,1,1
8122,högskola,0,0,1,1
8124,rumano,0,0,1,1
8098,قصة,0,0,1,1
8094,seas,0,0,1,1
8092,çıkarmaktadır-,0,0,1,1
8078,opted,0,0,1,1
8067,ಉಲ್ಲೇಖಿಸಿಲ್ಲ,0,0,1,1
8068,मेजबान,0,0,1,1
8069,ജർമ്മൻ,0,0,1,1
8071,buffon,0,0,1,1
8072,solzhenitsyn,0,0,1,1
8074,സ്രോതസ്സുകളുടെ,0,0,1,1
8075,ziyarete,0,0,1,1
8079,നിങ്ങൾ.,0,0,1,1
8090,இருந்து,0,0,1,1
8082,പ്രവർത്തനങ്ങളിൽ,0,0,1,1
8083,solvable,0,0,1,1
8084,citada,0,0,1,1
8085,கொண்டிருக்கிறீர்கள்.,0,0,1,1
8086,guiñaron,0,0,1,1
8087,കണ്ടുമുട്ടുന്നു,0,0,1,1
8088,ecosystems,0,0,1,1
8125,الرائعة,0,0,1,1
8126,آخذك,0,0,1,1
8127,மைஸ்பேஸ்,0,0,1,1
8170,поднять,0,0,1,1
8161,eenzijdiger,0,0,1,1
8162,høj,0,0,1,1
8163,girl.,0,0,1,1
8165,gemensamma,0,0,1,1
8166,ಸಮಾಚಾರ,0,0,1,1
8167,commercialisé,0,0,1,1
8169,вставкам,0,0,1,1
8172,style.,0,0,1,1
8159,eukaryotes.,0,0,1,1
8173,förhållanden,0,0,1,1
8174,proposition.,0,0,1,1
8175,bornes,0,0,1,1
8176,ಕ್ರೀಮ್,0,0,1,1
8177,сохранить,0,0,1,1
8179,कब,0,0,1,1
8180,отсутствующим.,0,0,1,1
8160,personnage,0,0,1,1
8158,അറിയാമെങ്കിൽ,0,0,1,1
8128,vida».,0,0,1,1
8142,ஓட்டங்கள்,0,0,1,1
8129,ಖರೀದಿಸಿದ,0,0,1,1
8130,mıyım,0,0,1,1
8134,pies,0,0,1,1
8135,anti-elitism,0,0,1,1
8138,चांदी,0,0,1,1
8139,liaison,0,0,1,1
8140,knol ,0,0,1,1
8143,rapporte.,0,0,1,1
8156,«природа» ,0,0,1,1
8144,selamlar,0,0,1,1
8147,удивит,0,0,1,1
8149,ettim,0,0,1,1
8150,condamné,0,0,1,1
8151,verbazingwekkend.,0,0,1,1
8154,liant,0,0,1,1
8155,conocer,0,0,1,1
8066,vermektedir.,0,0,1,1
8065,bovendien,0,0,1,1
8064,colecciones,0,0,1,1
7989,front-end,0,0,1,1
7978,revoir.,0,0,1,1
7980,сентябре,0,0,1,1
7981,مكتوبة,0,0,1,1
7982,pojke,0,0,1,1
7984,دورية,0,0,1,1
7986,internetencyklopædi,0,0,1,1
7988,distributing,0,0,1,1
7990,constantemente,0,0,1,1
7976,sixth-most-used,0,0,1,1
7991,plane,0,0,1,1
7993,grander,0,0,1,1
7997,forskningspublikationer.,0,0,1,1
7998,volontairement,0,0,1,1
7999,definitivt,0,0,1,1
8000,esthétique.,0,0,1,1
8001,språkliga,0,0,1,1
7977,prisioneiros,0,0,1,1
7973,φορέματα,0,0,1,1
8003,birisine,0,0,1,1
7960,എന്നതുപോലെയാണ്,0,0,1,1
7951,அதோடு,0,0,1,1
7952,deve-se,0,0,1,1
7953,saisies,0,0,1,1
7954,sayfayı,0,0,1,1
7955,trouverez,0,0,1,1
7957,beautiful.,0,0,1,1
7958,captured,0,0,1,1
7961,अवसर,0,0,1,1
7972,intéressantes.,0,0,1,1
7962,instantáneamente,0,0,1,1
7963,wikipedia.[bron],0,0,1,1
7965,macroecosystem,0,0,1,1
7966,ലാബിൽ,0,0,1,1
7968,ജീവിതത്തിലെ,0,0,1,1
7969,etsem,0,0,1,1
7971,d'informations,0,0,1,1
8002,d'exploitation,0,0,1,1
8006,descendente,0,0,1,1
8063,याचिका,0,0,1,1
8053,animaux,0,0,1,1
8040,uyurken,0,0,1,1
8041,istemek.,0,0,1,1
8042,அச்சுவழிப்,0,0,1,1
8044,включала,0,0,1,1
8045,suscité,0,0,1,1
8048,telefónica,0,0,1,1
8049,கவலைப்படாதீர்கள்,0,0,1,1
8054,सूप,0,0,1,1
8038,памяти.,0,0,1,1
8055,الأحيان.,0,0,1,1
8057,lutté,0,0,1,1
8058,plagued,0,0,1,1
8059,tradicionais.,0,0,1,1
8060,sexuais,0,0,1,1
8061,stück,0,0,1,1
8062,बहुभाषी,0,0,1,1
8039,вводится,0,0,1,1
8037,constaté,0,0,1,1
8009,ನಿರರ್ಗಳವಾಗಲು,0,0,1,1
8022,kütüphanenin,0,0,1,1
8011,stance,0,0,1,1
8012,reunir,0,0,1,1
8014,användarkonto,0,0,1,1
8015,ஆகியவற்றுக்கு,0,0,1,1
8017,fransk,0,0,1,1
8018,രഥം,0,0,1,1
8020,tolka,0,0,1,1
8023,supported,0,0,1,1
8036,dissected,0,0,1,1
8024,மற்றொன்று,0,0,1,1
8026,பக்கம்’,0,0,1,1
8030,radiophoniques,0,0,1,1
8031,обучение.,0,0,1,1
8033,ovenfra,0,0,1,1
8034,прилагающаяся,0,0,1,1
8035,acusado,0,0,1,1
8181,fleisch,0,0,1,1
8182,hervat,0,0,1,1
8183,transparency ...,0,0,1,1
8366,какую-либо,0,0,1,1
8358,advantage,0,0,1,1
8359,served,0,0,1,1
8360,apprenant,0,0,1,1
8361,ರೋಮಾಂಚನಕಾರಿ,0,0,1,1
8362,обучаться,0,0,1,1
8364,വിശക്കുന്നു.,0,0,1,1
8365,época,0,0,1,1
8368,jogo.,0,0,1,1
8355,köpte,0,0,1,1
8369,d'idées,0,0,1,1
8370,establecidos,0,0,1,1
8371,فلنطعمك,0,0,1,1
8373,världskriget.,0,0,1,1
8374,fint.,0,0,1,1
8375,vandalizadoras,0,0,1,1
8376,الإجتماعيين,0,0,1,1
8356,d’autant,0,0,1,1
8354,ويكيبديا،,0,0,1,1
8378,المقال.,0,0,1,1
8339,σχετική,0,0,1,1
8326,والدتهما,0,0,1,1
8327,чью-либо,0,0,1,1
8330,seje,0,0,1,1
8332,arrêter,0,0,1,1
8334,синонимами.,0,0,1,1
8335,φταρνίστηκε,0,0,1,1
8336,ಜ್ಯಾಮಿತಿ,0,0,1,1
8341,ವ್ಯಕ್ತಿಯು,0,0,1,1
8353,frikostigt,0,0,1,1
8344,தகுதியானவள்,0,0,1,1
8345,എന്നതുപോലുള്ള,0,0,1,1
8346,واللغات,0,0,1,1
8348,perdi,0,0,1,1
8349,συγχωρείς,0,0,1,1
8350,ಧರಿಸಿದ್ದರು,0,0,1,1
8351,garantiza,0,0,1,1
8377,yapmaya,0,0,1,1
8379,मिलेंगे।,0,0,1,1
8318,medido,0,0,1,1
8415,повседневного,0,0,1,1
8406,एसोसिएशन,0,0,1,1
8408,خططًا,0,0,1,1
8409,ബന്ധപ്പെട്ടിരിക്കുന്നു.,0,0,1,1
8410,പെരുവെള്ളം,0,0,1,1
8411,misinformation.,0,0,1,1
8412,eğlenceli,0,0,1,1
8414,கவலைப்பட்டார்,0,0,1,1
8416,specificity,0,0,1,1
8404,മാതൃ,0,0,1,1
8417,уволены,0,0,1,1
8418,elevate,0,0,1,1
8419,மூலையில்,0,0,1,1
8420,असंभव,0,0,1,1
8422,d'échecs,0,0,1,1
8423,закончить.,0,0,1,1
8425,since.,0,0,1,1
8405,«,0,0,1,1
8403,έπεσε,0,0,1,1
8380,наибольшее,0,0,1,1
8393,ونأمل,0,0,1,1
8381,pudo.,0,0,1,1
8382,​​कि,0,0,1,1
8383,alma.,0,0,1,1
8386,полномочия,0,0,1,1
8387,نومها,0,0,1,1
8388,interpretadas,0,0,1,1
8390,выполняя,0,0,1,1
8394,secuencia,0,0,1,1
8402,north,0,0,1,1
8395,बाहरी,0,0,1,1
8396,பார்க்கிறீர்கள்.,0,0,1,1
8397,rudely,0,0,1,1
8398,आज़माएँ,0,0,1,1
8399,சொல்லுக்கு,0,0,1,1
8400,नवाचार,0,0,1,1
8401,amazing.,0,0,1,1
8320,रहो।,0,0,1,1
8317,കനത്ത,0,0,1,1
8186,sexist,0,0,1,1
8229,lyssna,0,0,1,1
8220,rejection,0,0,1,1
8221,hoparlöre,0,0,1,1
8222,ecstatic,0,0,1,1
8223,നാർസിസയെ,0,0,1,1
8224,ρωτάω,0,0,1,1
8225,llegaste,0,0,1,1
8226,res,0,0,1,1
8230,جورنال,0,0,1,1
8218,policiam,0,0,1,1
8231,arduamente,0,0,1,1
8232,lagrade,0,0,1,1
8241,vahşet,0,0,1,1
8242,objet,0,0,1,1
8243,profundo.,0,0,1,1
8244,conexão,0,0,1,1
8245,കഴിയാത്തതിനാൽ,0,0,1,1
8219,hospedados.,0,0,1,1
8213,المعروفين,0,0,1,1
8249,ситуация,0,0,1,1
8198,γεύση,0,0,1,1
8187,hors-ligne,0,0,1,1
8188,داخل,0,0,1,1
8190,obscenity,0,0,1,1
8191,लेंग्वेज,0,0,1,1
8192,düşünmüyorum.,0,0,1,1
8195,மகளைப்,0,0,1,1
8196,ಬಂದಾಗ,0,0,1,1
8200,பெயரில்,0,0,1,1
8210,main-d'œuvre,0,0,1,1
8201,பொருந்தக்கூடிய,0,0,1,1
8202,نيويورك،,0,0,1,1
8203,mencionado,0,0,1,1
8204,устраняются.,0,0,1,1
8205,иерархическая,0,0,1,1
8207,crearles,0,0,1,1
8209,infrecuentes,0,0,1,1
8247,koldt,0,0,1,1
8250,restriktioner,0,0,1,1
8316,പറയാനാകുമോ,0,0,1,1
8296,أكتوبر,0,0,1,1
8287,единственном,0,0,1,1
8289,geldi.,0,0,1,1
8290,plagiarizing,0,0,1,1
8292,reemplazado,0,0,1,1
8293,shared,0,0,1,1
8294,eettafel,0,0,1,1
8295,σύγχυση,0,0,1,1
8298,cambiado,0,0,1,1
8282,തിരുത്തലുകളും,0,0,1,1
8299,உலகப்,0,0,1,1
8300,frente.,0,0,1,1
8302,حقيقي,0,0,1,1
8309,серьёзный,0,0,1,1
8311,horen,0,0,1,1
8312,fysiska,0,0,1,1
8313,الـ,0,0,1,1
8283,shakespeare.,0,0,1,1
8277,visões,0,0,1,1
8251,देती,0,0,1,1
8266,இருப்பது.,0,0,1,1
8253,consultant,0,0,1,1
8254,идеологической.,0,0,1,1
8255,hoort,0,0,1,1
8260,méritos,0,0,1,1
8261,ağlamayı,0,0,1,1
8263,ajudar.,0,0,1,1
8264,belgeleme,0,0,1,1
8267,சுதந்திரமாக,0,0,1,1
8276,wiki-form,0,0,1,1
8268,सर्बियाई,0,0,1,1
8269,ليدعم,0,0,1,1
8270,fornærmelse,0,0,1,1
8271,coffee,0,0,1,1
8272,multidisciplinært,0,0,1,1
8274,πάρετε.,0,0,1,1
8275,ಹೇಳಿದೆ,0,0,1,1
7950,выпустить,0,0,1,1
7946,culpable,0,0,1,1
7476,кого-нибудь,0,0,1,1
7943,klassiske,0,0,1,1
7628,korrelerat,0,0,1,1
7630,வேலைக்கு,0,0,1,1
7631,elva,0,0,1,1
7633,λειτουργεί,0,0,1,1
7634,boneca,0,0,1,1
7635,أنت.,0,0,1,1
7637,ثمل.,0,0,1,1
7638,trage,0,0,1,1
7639,fnissar,0,0,1,1
7640,സമ്പൂർണവുമായ,0,0,1,1
7641,forneça,0,0,1,1
7642,”can,0,0,1,1
7643,bundan,0,0,1,1
7644,deleting,0,0,1,1
7645,diamonds,0,0,1,1
7646,hause.,0,0,1,1
7647,യൂട്യൂബിൽ,0,0,1,1
7627,​​opmerking,0,0,1,1
7625,للامتحان,0,0,1,1
7624,acusações,0,0,1,1
7604,υπερβολικά,0,0,1,1
7594,raymond,0,0,1,1
7595,otimizam,0,0,1,1
7598,réalise.,0,0,1,1
7599,kommer.,0,0,1,1
7600,способность,0,0,1,1
7601,sidan.,0,0,1,1
7602,ಹಾಸಿಗೆಯ,0,0,1,1
7606,avbryta,0,0,1,1
7623,« nécessaire »,0,0,1,1
7607,clouds,0,0,1,1
7609,maç,0,0,1,1
7611,जागरूकता,0,0,1,1
7612,σαν.,0,0,1,1
7616,nyheden,0,0,1,1
7619,advice.,0,0,1,1
7620,espinoza,0,0,1,1
7649,чём,0,0,1,1
7650,erbij.,0,0,1,1
7652,ഗംഭീരവുമായ,0,0,1,1
7688,panjabi,0,0,1,1
7681,yılında,0,0,1,1
7682,എന്നതൊക്കെ,0,0,1,1
7683,adequadas,0,0,1,1
7684,ಉದಾಹರಣೆಗೆ.,0,0,1,1
7685,grekiskans,0,0,1,1
7686,sammen.,0,0,1,1
7687,smakend,0,0,1,1
7691,anonymes,0,0,1,1
7679,gevolgen,0,0,1,1
7693,அமைப்பதாக,0,0,1,1
7694,instrument,0,0,1,1
7695,energética.,0,0,1,1
7696,doll,0,0,1,1
7697,ويكي،,0,0,1,1
7698,ಸ್ಟುಪೆಂಡಸ್,0,0,1,1
7699,тупого,0,0,1,1
7680,ಜಾಮ್‌ಗಳನ್ನು,0,0,1,1
7677,guter,0,0,1,1
7654,bulacaksınız.,0,0,1,1
7663,conjunction,0,0,1,1
7655,оценено,0,0,1,1
7656,урегулирования,0,0,1,1
7657,regista,0,0,1,1
7658,மூக்கைக்,0,0,1,1
7659,ανθρώπους,0,0,1,1
7660,abril.,0,0,1,1
7662,open-collaborative,0,0,1,1
7664,പോർട്ടലിലൂടെ,0,0,1,1
7676,duração.,0,0,1,1
7665,sens ».,0,0,1,1
7666,проверены,0,0,1,1
7667,minoritetsuppfattningar,0,0,1,1
7669,ധനികനും,0,0,1,1
7673,റാണിയില്ലാത്ത,0,0,1,1
7674,webportaal.,0,0,1,1
7675,ಬದಲಾಯಿಸಿದಳು,0,0,1,1
7593,осуществлён.,0,0,1,1
7590,vokse,0,0,1,1
7589,ποτό,0,0,1,1
7516,tapez,0,0,1,1
7506,oroar,0,0,1,1
7508,country,0,0,1,1
7509,പറയുക,0,0,1,1
7511,prohibit,0,0,1,1
7512,nooit,0,0,1,1
7514,بالمائة.,0,0,1,1
7515,inativado,0,0,1,1
7517,ആഗ്രഹിക്കുന്ന,0,0,1,1
7504,torsdag,0,0,1,1
7518,tidigare.,0,0,1,1
7519,अच्छा।,0,0,1,1
7520,манске.,0,0,1,1
7521,sugerencias,0,0,1,1
7522,बिलकुल।,0,0,1,1
7524,damos,0,0,1,1
7526,escala.,0,0,1,1
7505,découlant,0,0,1,1
7503,perceived,0,0,1,1
7528,растерянной,0,0,1,1
7490,എടുത്തുക്കൊള്ളാം.,0,0,1,1
7477,cumhurbaşkanı,0,0,1,1
7480,تعليقات,0,0,1,1
7482,ಗೂಗಲ್‌ಗೆ,0,0,1,1
7483,παρακολούθηση.,0,0,1,1
7484,πρόσωπό,0,0,1,1
7485,étudiés,0,0,1,1
7488,प्राप्ति,0,0,1,1
7491,falsos,0,0,1,1
7502,l’inverse.,0,0,1,1
7492,فهم,0,0,1,1
7493,وقبل,0,0,1,1
7494,assertions,0,0,1,1
7496,माल्टी,0,0,1,1
7498,l’interprétabilité,0,0,1,1
7499,«usuarios»,0,0,1,1
7500,എങ്ങനെയുണ്ട്,0,0,1,1
7527,nacemos,0,0,1,1
7530,أصليًا.,0,0,1,1
7588,रूपों,0,0,1,1
7575,καρδιά,0,0,1,1
7562,योरूबा,0,0,1,1
7563,bidragen,0,0,1,1
7565,allesomvattende,0,0,1,1
7566,opôs-se,0,0,1,1
7568,pleure,0,0,1,1
7569,заявив,0,0,1,1
7570,इलोकानो,0,0,1,1
7576,ударилась,0,0,1,1
7560,contratado,0,0,1,1
7578,φράσεις.,0,0,1,1
7582,reemplazados,0,0,1,1
7583,probablement,0,0,1,1
7584,pagerank,0,0,1,1
7585,അദ്ദേഹത്തിന്റെ,0,0,1,1
7586,ಬೇರುಗಳನ್ನು,0,0,1,1
7587,d’outils,0,0,1,1
7561,κρατήσετε,0,0,1,1
7559,providers,0,0,1,1
7532,definitief,0,0,1,1
7540,ആശയം,0,0,1,1
7533,nine,0,0,1,1
7534,ಮೈಲಿಗೆ,0,0,1,1
7535,ശബ്ദത്തിന്റെ,0,0,1,1
7536,إيقافك,0,0,1,1
7537,nacimiento.,0,0,1,1
7538,freundin,0,0,1,1
7539,δώσετε,0,0,1,1
7542,ಹೇಳಿದ್ದೇನೆ,0,0,1,1
7554,вручении,0,0,1,1
7544,bildiğin,0,0,1,1
7545,تتمتع,0,0,1,1
7546,единственной,0,0,1,1
7548,vain »,0,0,1,1
7550,balcony,0,0,1,1
7552,egenintresse,0,0,1,1
7553,correcto.,0,0,1,1
7700,veritabanından,0,0,1,1
7702,ഓടി,0,0,1,1
7704,സന്നദ്ധനാണ്,0,0,1,1
7869,கொள்கையாக,0,0,1,1
7858,context-dependent,0,0,1,1
7860,hoşgeldin.,0,0,1,1
7861,edilir.,0,0,1,1
7862,ಪಾದಗಳನ್ನು,0,0,1,1
7866,traités.,0,0,1,1
7867,وتحريره,0,0,1,1
7868,sunmaya,0,0,1,1
7871,categorización,0,0,1,1
7854,memnuniyet,0,0,1,1
7872,ജൂലൈ,0,0,1,1
7875,commons ,0,0,1,1
7876,تراكمت,0,0,1,1
7877,verschiedene,0,0,1,1
7880,bevara,0,0,1,1
7882,impose,0,0,1,1
7884,تحت,0,0,1,1
7855,الثانية،,0,0,1,1
7853,soe,0,0,1,1
7887,donantes,0,0,1,1
7841,ಹೇಳುವಂತೆ,0,0,1,1
7833,mezcla,0,0,1,1
7834,rudemente,0,0,1,1
7835,ونفس,0,0,1,1
7836,dormindo,0,0,1,1
7837,läsare.,0,0,1,1
7838,выросла,0,0,1,1
7840,noam,0,0,1,1
7842,അവരിലൊരാളായി,0,0,1,1
7852,தூதர்,0,0,1,1
7843,दस्तावेजों,0,0,1,1
7844,phenomena.,0,0,1,1
7845,no •,0,0,1,1
7846,автоматизированный,0,0,1,1
7847,successives,0,0,1,1
7849,python.,0,0,1,1
7851,разграничение,0,0,1,1
7886,government.,0,0,1,1
7888,وتحمل,0,0,1,1
7831,alcanzaba,0,0,1,1
7931,principe.,0,0,1,1
7922,retain,0,0,1,1
7923,proliferate,0,0,1,1
7924,ரொட்டியால்,0,0,1,1
7925,amoralidade,0,0,1,1
7926,hosting,0,0,1,1
7927,экземпляре,0,0,1,1
7928,अहंकारी,0,0,1,1
7932,للمستخدمين,0,0,1,1
7918,courte,0,0,1,1
7933,கேட்கலாம்.,0,0,1,1
7935,poignée,0,0,1,1
7937,beräknades,0,0,1,1
7938,somehow,0,0,1,1
7939,حاولت,0,0,1,1
7940,station,0,0,1,1
7941,“change,0,0,1,1
7919,размещены,0,0,1,1
7917,non-trivial,0,0,1,1
7889,skyldes,0,0,1,1
7903,complaining,0,0,1,1
7892,tillhandahålls,0,0,1,1
7893,draws,0,0,1,1
7894,பிறகு.,0,0,1,1
7896,équipés,0,0,1,1
7897,partit,0,0,1,1
7898,manipulates,0,0,1,1
7902,interesantes.,0,0,1,1
7905,количество,0,0,1,1
7916,imprimée,0,0,1,1
7906,ontwikkeld.,0,0,1,1
7907,निरंतर,0,0,1,1
7908,geht's.,0,0,1,1
7909,fornøjelse.,0,0,1,1
7911,proving,0,0,1,1
7914,സ്വതന്ത്രവിജ്ഞാനകോശം,0,0,1,1
7915,पूछें।,0,0,1,1
7832,حديثًا,0,0,1,1
7830,التهنئة,0,0,1,1
7705,dicionário.,0,0,1,1
7753,vándalos,0,0,1,1
7737,veya.,0,0,1,1
7738,framework,0,0,1,1
7740,παράδοξη,0,0,1,1
7741,anomalous,0,0,1,1
7744,l'association,0,0,1,1
7748,vaknade,0,0,1,1
7750,വെള്ളം,0,0,1,1
7754,abandonné,0,0,1,1
7734,games,0,0,1,1
7755,oudengels.,0,0,1,1
7757,bindi,0,0,1,1
7758,réductible,0,0,1,1
7759,cèdent,0,0,1,1
7760,visualisera,0,0,1,1
7761,благодарен.,0,0,1,1
7764,имеющих,0,0,1,1
7736,लिखूंगा,0,0,1,1
7733,ಅಪ್,0,0,1,1
7768,dois.,0,0,1,1
7719,κατασκευασμένη,0,0,1,1
7706,'பொதுவில்,0,0,1,1
7707,تفضل,0,0,1,1
7709,cujas,0,0,1,1
7711,prestação,0,0,1,1
7714,anúncios.,0,0,1,1
7716,revistos,0,0,1,1
7718,paradoxa,0,0,1,1
7720,ക്ഷമാപണം,0,0,1,1
7732,അർത്ഥമാക്കുന്നതിന്,0,0,1,1
7721,kvalitetsbrister,0,0,1,1
7722,publicación.,0,0,1,1
7723,salvo,0,0,1,1
7726,olanı,0,0,1,1
7727,mascotas,0,0,1,1
7729,ஆவார்.,0,0,1,1
7730,مينج,0,0,1,1
7766,líderes.,0,0,1,1
7772,problemas​.,0,0,1,1
7828,biliyorsunuz.,0,0,1,1
7814,другим»,0,0,1,1
7806,पीटर,0,0,1,1
7807,günüyse.,0,0,1,1
7808,دكتوراه,0,0,1,1
7810,d'existence,0,0,1,1
7811,weit,0,0,1,1
7812,society.,0,0,1,1
7813,two.,0,0,1,1
7817,مهذب,0,0,1,1
7802,вы.,0,0,1,1
7819,weltkriegs,0,0,1,1
7820,كلية,0,0,1,1
7821,retórico,0,0,1,1
7824,ಕನಸನ್ನು,0,0,1,1
7825,basis.,0,0,1,1
7826,vertus,0,0,1,1
7827,verstehen.,0,0,1,1
7803,görünmesini,0,0,1,1
7801,casuais.,0,0,1,1
7775,ഉപയോഗിക്കുന്നത്.,0,0,1,1
7786,manuscrits,0,0,1,1
7777,прекрасно.,0,0,1,1
7779,ojämn,0,0,1,1
7780,protestataire,0,0,1,1
7781,நண்பர்,0,0,1,1
7782,nombrar,0,0,1,1
7784,двенадцатитомное,0,0,1,1
7785,επαφή.,0,0,1,1
7787,சதுப்புநிலம்,0,0,1,1
7799,держала,0,0,1,1
7789,tenías,0,0,1,1
7790,beskrivs,0,0,1,1
7791,മറയ്‌ക്കാൻ‌,0,0,1,1
7792,விரைவு,0,0,1,1
7793,എഴുതിയ,0,0,1,1
7794,lächelten,0,0,1,1
7797,hoefler,0,0,1,1
6491,antérieurs,0,0,1,1
6488,confine,0,0,1,1
4506,skickade,0,0,1,1
5010,файлы,0,0,1,1
5168,ബുദ്ധിശൂന്യതയാണെന്നാണ്,0,0,1,1
5169,فرنسية,0,0,1,1
5170,professionnelle.,0,0,1,1
5171,l'insa,0,0,1,1
5172,chevron-texaco,0,0,1,1
5173,fêtes,0,0,1,1
5174,δροσερό,0,0,1,1
5175,جنوني,0,0,1,1
5176,proyectos​,0,0,1,1
5177,всей,0,0,1,1
5179,atualizado,0,0,1,1
5180,συγχαρητήρια,0,0,1,1
5181,söyler,0,0,1,1
5186,പിടിക്കാത്തതിനാൽ,0,0,1,1
5187,φεύγω,0,0,1,1
5188,സംരംഭമാണ്,0,0,1,1
5189,κλαις,0,0,1,1
5167,gången,0,0,1,1
5166,englischsprachigen,0,0,1,1
5165,wikípedo,0,0,1,1
5153,கண்காணிக்கப்படுகின்றன.,0,0,1,1
5141,συμφωνήσω,0,0,1,1
5142,kararının,0,0,1,1
5143,reikte,0,0,1,1
5145,uppenbart,0,0,1,1
5146,bedanken,0,0,1,1
5151,wikipediaanvändare,0,0,1,1
5152,stanislas,0,0,1,1
5154,cosmological,0,0,1,1
5164,vatikanen,0,0,1,1
5156,основанием,0,0,1,1
5157,koyamadığım,0,0,1,1
5158,gott,0,0,1,1
5159,profiel,0,0,1,1
5160,underground,0,0,1,1
5161,стрессовых,0,0,1,1
5163,rob,0,0,1,1
5190,взяла,0,0,1,1
5192,موقعا,0,0,1,1
5193,сейчас.,0,0,1,1
5247,والخوادم,0,0,1,1
5232,ಮಾಲ್‌ನಲ್ಲಿ,0,0,1,1
5235,центральным,0,0,1,1
5237,авторства,0,0,1,1
5239,நடந்துகொண்டது,0,0,1,1
5242,lessem,0,0,1,1
5243,obtienes,0,0,1,1
5244,réparations.,0,0,1,1
5248,voeten,0,0,1,1
5229,e-postamda,0,0,1,1
5254,அரைப்,0,0,1,1
5255,openanyone,0,0,1,1
5257,satisfactoria,0,0,1,1
5261,idioma»,0,0,1,1
5263,വലിക്കുക.,0,0,1,1
5264,αγόρασαν,0,0,1,1
5265,vriendin,0,0,1,1
5231,ocultas,0,0,1,1
5228,питером,0,0,1,1
5194,específico,0,0,1,1
5208,αναρωτιόμουν,0,0,1,1
5197,inférieur,0,0,1,1
5200,áustria,0,0,1,1
5201,സോഫ്റ്റ്,0,0,1,1
5202,प्यू,0,0,1,1
5203,совместно,0,0,1,1
5204,hielt,0,0,1,1
5207,permit,0,0,1,1
5210,உடைந்தாள்,0,0,1,1
5227,അശ്ലീല,0,0,1,1
5211,ಸಿಗದಿದ್ದಾಗ,0,0,1,1
5216,contenía,0,0,1,1
5217,αδερφή,0,0,1,1
5220,வேர்கள்,0,0,1,1
5221,ಮತ್ತೊಮ್ಮೆ,0,0,1,1
5222,berühmten,0,0,1,1
5224,الأحوال,0,0,1,1
5140,பலவிதமான,0,0,1,1
5139,இருவருக்கும்,0,0,1,1
5137,exposed,0,0,1,1
5057,verloop,0,0,1,1
5046,എന്നിവയൊക്കെ,0,0,1,1
5047,respectivas,0,0,1,1
5048,авторы,0,0,1,1
5050,சரியா,0,0,1,1
5051,προτού,0,0,1,1
5052,αλλάξει,0,0,1,1
5056,इण्डोनेशियाई,0,0,1,1
5058,μεταφορά,0,0,1,1
5043,intimement,0,0,1,1
5059,etmekle.,0,0,1,1
5061,രസകരമാണ്.,0,0,1,1
5062,gelächelt,0,0,1,1
5065,എന്ത്,0,0,1,1
5066,d’avoir,0,0,1,1
5067,birisidir.,0,0,1,1
5069,ಸಮತೋಲಿತ,0,0,1,1
5044,nätgemenskap,0,0,1,1
5042,joint,0,0,1,1
5072,sub-surface,0,0,1,1
5028,kostte,0,0,1,1
5012,बनाते,0,0,1,1
5014,oceans.,0,0,1,1
5015,qu’en,0,0,1,1
5019,बचाव,0,0,1,1
5020,خدمة,0,0,1,1
5024,avdelning,0,0,1,1
5025,encoding,0,0,1,1
5029,structuur.,0,0,1,1
5041,вайнбергером.,0,0,1,1
5031,schönes,0,0,1,1
5033,दें,0,0,1,1
5035,validated,0,0,1,1
5036,¿verdad,0,0,1,1
5037,izinli,0,0,1,1
5038,നിയമസംഹിതയോ,0,0,1,1
5040,trouvent,0,0,1,1
5070,मंगोलियाई,0,0,1,1
5074,destacados,0,0,1,1
5135,foregår,0,0,1,1
5118,περιγράφεται,0,0,1,1
5110,atacadas,0,0,1,1
5111,tills,0,0,1,1
5113,sociétés.,0,0,1,1
5114,åkte,0,0,1,1
5115,sohbet,0,0,1,1
5116,erinnern,0,0,1,1
5117,kullanılmak,0,0,1,1
5119,wij,0,0,1,1
5107,guían,0,0,1,1
5120,أحمر,0,0,1,1
5121,kräver,0,0,1,1
5123,εκτιμώ.,0,0,1,1
5125,വിവിധഘട്ടങ്ങളെ,0,0,1,1
5128,മനസ്സിലാക്കുന്നത്,0,0,1,1
5129,deixou,0,0,1,1
5131,plagiat,0,0,1,1
5108,صلة،,0,0,1,1
5104,artikelförfattarna,0,0,1,1
5076,yatağa,0,0,1,1
5087,المتوازنة,0,0,1,1
5077,newsletter,0,0,1,1
5080,троллями,0,0,1,1
5081,употребляемое,0,0,1,1
5082,വസ്ത്രത്തിൽ,0,0,1,1
5083,المجلات,0,0,1,1
5085,направляемых,0,0,1,1
5086,வந்த,0,0,1,1
5090,выборе,0,0,1,1
5103,chronicle,0,0,1,1
5092,வைத்திருக்கிறேன்.,0,0,1,1
5094,üst,0,0,1,1
5095,ισορροπημένες,0,0,1,1
5096,മീറ്റിംഗിന്,0,0,1,1
5097,അഭിമുഖത്തിലോ,0,0,1,1
5100,freunden.,0,0,1,1
5102,turned,0,0,1,1
5268,selecionado,0,0,1,1
5271,μεγαλύτερο,0,0,1,1
5273,central.,0,0,1,1
5435,agi,0,0,1,1
5423,ഉപയോഗിക്കാനുള്ള,0,0,1,1
5426,“எச்.டி.எம்.எல்.”,0,0,1,1
5427,häftigt,0,0,1,1
5429,recherche ,0,0,1,1
5431,grundprinciper,0,0,1,1
5433,auffordert,0,0,1,1
5434,s'y,0,0,1,1
5438,almacén,0,0,1,1
5420,lekkere,0,0,1,1
5439,ലിപിയിൽ,0,0,1,1
5440,culturelles ,0,0,1,1
5442,المنطقي,0,0,1,1
5443,zukam.,0,0,1,1
5444,അതൊട്ട്‌,0,0,1,1
5445,الاطلاق.,0,0,1,1
5448,സുഹൃത്തുക്കളും,0,0,1,1
5421,obtuviste,0,0,1,1
5419,vraag.,0,0,1,1
5450,ಆವರಿಸಬಹುದೇ,0,0,1,1
5408,subject.,0,0,1,1
5395,иметься,0,0,1,1
5396,جامعيًا,0,0,1,1
5399,классификаторы.,0,0,1,1
5400,reunião.,0,0,1,1
5401,endless.,0,0,1,1
5402,« ne,0,0,1,1
5405,действие,0,0,1,1
5409,norwich,0,0,1,1
5418,básico,0,0,1,1
5410,ஆச்சரியமாகக்,0,0,1,1
5411,eenvoudige,0,0,1,1
5413,mangez.,0,0,1,1
5414,التعليق,0,0,1,1
5415,γραμματική,0,0,1,1
5416,végétale.,0,0,1,1
5417,അവധി,0,0,1,1
5449,kommunistiska,0,0,1,1
5454,self-driving,0,0,1,1
5392,flow,0,0,1,1
5503,സമൂഹത്തിന്,0,0,1,1
5490,thermally,0,0,1,1
5493,दिसंबर,0,0,1,1
5495,ecologically,0,0,1,1
5497,المعارض,0,0,1,1
5498,للمشاركة.,0,0,1,1
5499,arun,0,0,1,1
5501,connaît,0,0,1,1
5504,relegada,0,0,1,1
5487,ടെസ്റ്റിലെ,0,0,1,1
5505,sakligt,0,0,1,1
5506,அதிகப்,0,0,1,1
5507,गणना,0,0,1,1
5509,யார்,0,0,1,1
5510,mücadele,0,0,1,1
5514,incomodá-lo.,0,0,1,1
5516,ശ്രദ്ധിക്കുക.,0,0,1,1
5488,lingüística.,0,0,1,1
5485,occasionnée,0,0,1,1
5455,устаю,0,0,1,1
5468,सलेक्शन,0,0,1,1
5456,وبنائها,0,0,1,1
5457,réglé,0,0,1,1
5458,ξεκίνησε,0,0,1,1
5459,long-standing,0,0,1,1
5462,normalde,0,0,1,1
5464,പോലെ,0,0,1,1
5465,obtus.,0,0,1,1
5469,compromise,0,0,1,1
5484,pt.m.wikipedia.org,0,0,1,1
5470,questions.,0,0,1,1
5472,d'insulte,0,0,1,1
5476,காண,0,0,1,1
5479,οπτική,0,0,1,1
5480,google'a,0,0,1,1
5481,udenfor,0,0,1,1
5482,क्वाडि्ृगा,0,0,1,1
5393,famoso».,0,0,1,1
5391,മോശമായിത്തീർന്നത്,0,0,1,1
5274,sürümünde,0,0,1,1
5320,содержал,0,0,1,1
5310,சலிப்பாக,0,0,1,1
5311,pixelgrootte,0,0,1,1
5312,hawaii,0,0,1,1
5314,இணைப்பை,0,0,1,1
5316,വിശ്വസിക്കുന്നവരിപ്പോൾ,0,0,1,1
5317,mobiltelefoner.,0,0,1,1
5318,contém,0,0,1,1
5321,koncepten,0,0,1,1
5306,அன்பான,0,0,1,1
5322,வினை,0,0,1,1
5323,ಫೋನ್‌ನಲ್ಲಿ,0,0,1,1
5324,ευχαρίστησή,0,0,1,1
5325,texas,0,0,1,1
5327,durduğunda,0,0,1,1
5329,chegado,0,0,1,1
5331,составления,0,0,1,1
5307,வகைப்படுத்தப்படும்.,0,0,1,1
5305,know'',0,0,1,1
5333,knowing,0,0,1,1
5285,envisager,0,0,1,1
5276,സൗകര്യപ്രദമാണ്.,0,0,1,1
5277,வைரங்களில்,0,0,1,1
5278,leverde,0,0,1,1
5279,parcourant,0,0,1,1
5281,bèta-wetenschapper,0,0,1,1
5282,utformad,0,0,1,1
5283,подписаться,0,0,1,1
5289,implícita,0,0,1,1
5304,félicitations,0,0,1,1
5291,kartoffeln,0,0,1,1
5292,oudste,0,0,1,1
5294,pre-socratic,0,0,1,1
5296,lagförslag,0,0,1,1
5299,roupa,0,0,1,1
5300,bazar,0,0,1,1
5302,bénéficient,0,0,1,1
5332,geçmişinden,0,0,1,1
5334,पत्नी,0,0,1,1
5390,samkör,0,0,1,1
5379,delivered,0,0,1,1
5371,மூழ்கிவிடுவார்கள்,0,0,1,1
5372,rechtsboven,0,0,1,1
5373,caducar,0,0,1,1
5374,vrijwillige,0,0,1,1
5375,mühe,0,0,1,1
5376,ಅದೃಷ್ಟವನ್ನು,0,0,1,1
5377,hobbes,0,0,1,1
5380,visites,0,0,1,1
5368,druk.,0,0,1,1
5381,abertas,0,0,1,1
5382,germany,0,0,1,1
5385,பழைய,0,0,1,1
5386,παρακαλώ.,0,0,1,1
5387,décennies,0,0,1,1
5388,durée.,0,0,1,1
5389,göreceli,0,0,1,1
5370,einde,0,0,1,1
5367,മൂല്യം,0,0,1,1
5335,parecían,0,0,1,1
5355,uppdateras,0,0,1,1
5336,bijdrage,0,0,1,1
5338,autoorganisé,0,0,1,1
5339,الإناث.,0,0,1,1
5340,hittas,0,0,1,1
5343,universität,0,0,1,1
5352,термины,0,0,1,1
5353,وهؤلاء,0,0,1,1
5356,.ഇത്,0,0,1,1
5366,ಅಭ್ಯಾಸವನ್ನು,0,0,1,1
5357,insiders,0,0,1,1
5358,അതിഭീകരരായ,0,0,1,1
5360,μετά.,0,0,1,1
5361,d'alembert,0,0,1,1
5363,parcialidad,0,0,1,1
5364,zihinde,0,0,1,1
5365,bâtiments,0,0,1,1
5011,ಫ್ಲಮ್ಮೋಕ್ಸ್ಡ್,0,0,1,1
5008,αντίθετο,0,0,1,1
5518,ആവാറുണ്ട്.,0,0,1,1
5006,продолжай.,0,0,1,1
4673,werk.,0,0,1,1
4675,пятой“,0,0,1,1
4677,sølv,0,0,1,1
4678,एटरीब्यूशन-शेयर,0,0,1,1
4681,sk •,0,0,1,1
4682,низкие,0,0,1,1
4683,gekregen,0,0,1,1
4685,попрактиковаться,0,0,1,1
4686,एसएमएस,0,0,1,1
4688,glitrende,0,0,1,1
4693,organisée,0,0,1,1
4696,نتابع,0,0,1,1
4699,proteção,0,0,1,1
4700,стратегию,0,0,1,1
4701,ಟೇಬಲ್,0,0,1,1
4703,മുഖത്തേക്ക്,0,0,1,1
4704,ihnen.,0,0,1,1
4670,dehors,0,0,1,1
4668,ಇದ್ದಕ್ಕಿದ್ದಂತೆ,0,0,1,1
4667,നിസാര,0,0,1,1
4652,azzam,0,0,1,1
4640,köşedeki,0,0,1,1
4642,monthly,0,0,1,1
4643,اعتقاده,0,0,1,1
4644,comentario.,0,0,1,1
4646,κλάμα,0,0,1,1
4648,കൊട്ടാരത്തിൽ,0,0,1,1
4651,pular,0,0,1,1
4653,ತದನಂತರ,0,0,1,1
4665,പറഞ്ഞയച്ചത്,0,0,1,1
4655,desinformação.,0,0,1,1
4656,onderzoeksveld,0,0,1,1
4657,لاتيني,0,0,1,1
4658,statistique,0,0,1,1
4660,parcial,0,0,1,1
4662,असंगति,0,0,1,1
4663,« é »,0,0,1,1
4706,இன்றிரவு,0,0,1,1
4707,distinguir,0,0,1,1
4708,decía,0,0,1,1
4750,tepeden,0,0,1,1
4739,இணைப்பாக,0,0,1,1
4740,underpolicyer.,0,0,1,1
4741,tips,0,0,1,1
4744,it •,0,0,1,1
4747,suivantes ,0,0,1,1
4748,جوجل.,0,0,1,1
4749,அதிகரிப்பதன்,0,0,1,1
4751,observa,0,0,1,1
4737,generated,0,0,1,1
4755,kenmerkend,0,0,1,1
4756,शाम,0,0,1,1
4758,inancıyla,0,0,1,1
4760,haklısın.,0,0,1,1
4761,english،,0,0,1,1
4762,நேசித்தாள்,0,0,1,1
4764,कहें,0,0,1,1
4738,beschikken,0,0,1,1
4736,reinforcing,0,0,1,1
4709,vejret,0,0,1,1
4723,isterse,0,0,1,1
4710,आकाश,0,0,1,1
4713,υψηλό,0,0,1,1
4714,fourth-highest,0,0,1,1
4716,اللوحات,0,0,1,1
4717,ಮಾಣಿಕ್ಯಗಳ,0,0,1,1
4720,traducidos,0,0,1,1
4722,लिम्बुर्गियाई,0,0,1,1
4724,முன்னால்,0,0,1,1
4734,dúvidas,0,0,1,1
4725,zehn,0,0,1,1
4726,தரங்கள்,0,0,1,1
4727,répartition,0,0,1,1
4728,verdenskrig.,0,0,1,1
4730,തടയുന്നില്ല.,0,0,1,1
4731,फिलोसोफी,0,0,1,1
4732,വാക്യങ്ങൾ‌.,0,0,1,1
4638,telefonda,0,0,1,1
4635,podrías,0,0,1,1
4634,drink,0,0,1,1
4558,intresseväckande,0,0,1,1
4547,acreditada,0,0,1,1
4548,जाएं,0,0,1,1
4549,experiencia.,0,0,1,1
4552,handlede,0,0,1,1
4553,dilim,0,0,1,1
4555,அழுகிற,0,0,1,1
4557,air.,0,0,1,1
4566,útiles,0,0,1,1
4544,prazer.,0,0,1,1
4570,faisons,0,0,1,1
4571,denunció,0,0,1,1
4573,palace,0,0,1,1
4574,வழி.,0,0,1,1
4575,लगाते,0,0,1,1
4576,ഭക്ഷണവും,0,0,1,1
4577,educado.,0,0,1,1
4545,ansiklopedilerden,0,0,1,1
4543,galerie,0,0,1,1
4580,procurá-la,0,0,1,1
4525,besuchen.,0,0,1,1
4507,ಹಸಿದಿದ್ದೇನೆ.,0,0,1,1
4511,wikizine,0,0,1,1
4512,'αυτό,0,0,1,1
4517,irgendetwas,0,0,1,1
4522,buscan,0,0,1,1
4523,संबंधित,0,0,1,1
4524,الذهب.,0,0,1,1
4529,ключевым,0,0,1,1
4541,objectives,0,0,1,1
4530,дэвидом,0,0,1,1
4531,inexperientes.,0,0,1,1
4533,vergeten,0,0,1,1
4535,पैसे,0,0,1,1
4536,توقفنا,0,0,1,1
4537,naviguer,0,0,1,1
4540,'αυτήν,0,0,1,1
4579,samarês,0,0,1,1
4581,citerade,0,0,1,1
4631,ведомства,0,0,1,1
4621,знаменитой,0,0,1,1
4610,weiteres,0,0,1,1
4613,droit ,0,0,1,1
4614,humor.,0,0,1,1
4615,pu,0,0,1,1
4616,κάνει.,0,0,1,1
4617,disruptively.,0,0,1,1
4619,'clicks,0,0,1,1
4622,القرصنة,0,0,1,1
4608,existentes.,0,0,1,1
4623,சிரிக்கத்,0,0,1,1
4624,ബ്രെഡിൽ,0,0,1,1
4625,يأتون,0,0,1,1
4626,المسائل,0,0,1,1
4627,jugé,0,0,1,1
4629,മകളുടെ,0,0,1,1
4630,« seuls,0,0,1,1
4609,попасть,0,0,1,1
4606,الخلوي؟,0,0,1,1
4582,sahte,0,0,1,1
4594,ಕೇಳಬಹುದಾದ,0,0,1,1
4586,डेल्ही,0,0,1,1
4587,jerga,0,0,1,1
4588,വാക്യങ്ങളോ,0,0,1,1
4590,resuméer,0,0,1,1
4591,claude,0,0,1,1
4592,concentrée,0,0,1,1
4593,निषिद्ध,0,0,1,1
4595,dayan.,0,0,1,1
4605,состояние.,0,0,1,1
4596,армией,0,0,1,1
4597,laboral.,0,0,1,1
4598,pluripotency,0,0,1,1
4599,gidemezsiniz.,0,0,1,1
4601,χαρακτηριστικά,0,0,1,1
4603,skillnader.,0,0,1,1
4604,работе.,0,0,1,1
4766,salée.,0,0,1,1
4767,brincam,0,0,1,1
4768,besteht,0,0,1,1
4937,koblet,0,0,1,1
4924,पंथ,0,0,1,1
4926,животное,0,0,1,1
4929,concrétisation,0,0,1,1
4932,définitivement,0,0,1,1
4933,tilgå,0,0,1,1
4934,weken,0,0,1,1
4936,soin.,0,0,1,1
4940,kalt.,0,0,1,1
4921,γραμματοσειρά,0,0,1,1
4941,gegeven.,0,0,1,1
4942,intresserade,0,0,1,1
4945,vågnede,0,0,1,1
4946,transcendentalism,0,0,1,1
4947,целью,0,0,1,1
4948,ಸುಸಂಸ್ಕೃತ,0,0,1,1
4951,använt,0,0,1,1
4922,flore,0,0,1,1
4920,toman,0,0,1,1
4953,dvd.wikimedia.org.,0,0,1,1
4906,ταξίδεψε,0,0,1,1
4898,مثالية,0,0,1,1
4899,अत्याचारपूर्ण,0,0,1,1
4900,cherche,0,0,1,1
4902,учитель,0,0,1,1
4903,gebruikers,0,0,1,1
4904,datamining,0,0,1,1
4905,typografisk,0,0,1,1
4907,deformed,0,0,1,1
4919,needed.,0,0,1,1
4908,admiring,0,0,1,1
4909,article »[aa],0,0,1,1
4910,præcision,0,0,1,1
4912,वॉन,0,0,1,1
4913,போகிறோம்,0,0,1,1
4915,stelle,0,0,1,1
4918,incluía,0,0,1,1
4952,ಕಲಿಯಲು,0,0,1,1
4954,تي,0,0,1,1
4895,heldere,0,0,1,1
4993,साइटने,0,0,1,1
4982,σταυρωμένα,0,0,1,1
4985,cerveau-machine ,0,0,1,1
4986,قدم,0,0,1,1
4988,uur.,0,0,1,1
4989,unutma,0,0,1,1
4990,இருந்தன,0,0,1,1
4992,அறிவும்,0,0,1,1
4994,​​vraag,0,0,1,1
4980,выучить,0,0,1,1
4997,casser,0,0,1,1
4998,ψεύτικο,0,0,1,1
4999,വാർത്തയിൽ,0,0,1,1
5000,damerna,0,0,1,1
5001,reisen,0,0,1,1
5002,cahiers,0,0,1,1
5005,ಹಣವಿದೆ,0,0,1,1
4981,redistributing,0,0,1,1
4978,small.,0,0,1,1
4955,إحساسها,0,0,1,1
4965,wij',0,0,1,1
4956,έδαφος,0,0,1,1
4957,подошел,0,0,1,1
4958,النظرية.,0,0,1,1
4960,minderårig,0,0,1,1
4961,ചിത്രങ്ങളും,0,0,1,1
4962,flytande.,0,0,1,1
4964,авторитетность,0,0,1,1
4967,enciclopédico.,0,0,1,1
4977,basingstoke,0,0,1,1
4969,produziu,0,0,1,1
4970,tillbaka.,0,0,1,1
4971,विज्ञापनों,0,0,1,1
4972,ಸಿದ್ಧಪಡಿಸಿದ್ದೇನೆ,0,0,1,1
4973,colegial,0,0,1,1
4974,afterward.,0,0,1,1
4975,seasons.,0,0,1,1
4896,mestadels,0,0,1,1
4894,உறுதிப்படுத்தப்படுகின்றன.,0,0,1,1
4771,esquina,0,0,1,1
4810,बनायें.,0,0,1,1
4802,bepaalde,0,0,1,1
4803,отслеживать,0,0,1,1
4804,emblématique,0,0,1,1
4806,voir ,0,0,1,1
4807,студент,0,0,1,1
4808,منقوشة,0,0,1,1
4809,evening.,0,0,1,1
4814,டிகிரிக்குக்,0,0,1,1
4798,ficará,0,0,1,1
4815,mañana.,0,0,1,1
4818,ಮಧ್ಯದಲ್ಲಿದ್ದೀರಿ,0,0,1,1
4820,ತಲುಪಲು,0,0,1,1
4825,преодолении,0,0,1,1
4826,koltuğunuzda,0,0,1,1
4827,registrarse.,0,0,1,1
4828,computerprogramma's,0,0,1,1
4799,heraus,0,0,1,1
4795,когда-то,0,0,1,1
4831,содержала,0,0,1,1
4784,«invirtió,0,0,1,1
4772,الألمانية،,0,0,1,1
4774,disent.,0,0,1,1
4775,pişirmeme,0,0,1,1
4778,duyun.,0,0,1,1
4779,overschreden,0,0,1,1
4781,проявляется,0,0,1,1
4782,ihtiyacım,0,0,1,1
4785,aralık,0,0,1,1
4794,നല്ലൊരു,0,0,1,1
4786,complétés,0,0,1,1
4787,stopped,0,0,1,1
4788,fils,0,0,1,1
4789,മനസിലാക്കാൻ,0,0,1,1
4790,londinense,0,0,1,1
4791,जानवर,0,0,1,1
4793,utilisons,0,0,1,1
4830,ವಿರೋಧಾಭಾಸ,0,0,1,1
4837,métaphysique.,0,0,1,1
4891,рекламу.,0,0,1,1
4877,diretor,0,0,1,1
4868,oneindig,0,0,1,1
4870,uninitiated,0,0,1,1
4871,primitif,0,0,1,1
4872,هائل,0,0,1,1
4873,ordagrant,0,0,1,1
4874,unnecessary,0,0,1,1
4875,forment,0,0,1,1
4878,presione,0,0,1,1
4866,necesarios,0,0,1,1
4880,rocken,0,0,1,1
4881,गुजरते,0,0,1,1
4882,desciclopédia,0,0,1,1
4886,செயல்படுகிறீர்களானால்,0,0,1,1
4887,laureada,0,0,1,1
4888,l'allée.,0,0,1,1
4889,ιδεολογιών,0,0,1,1
4867,சொற்றொடர்களைப்,0,0,1,1
4865,d'opinion,0,0,1,1
4838,yaşanırsa,0,0,1,1
4853,لهجات,0,0,1,1
4839,opiniones.,0,0,1,1
4841,पृष्टों,0,0,1,1
4843,equidad,0,0,1,1
4844,زيادة,0,0,1,1
4848,humain.,0,0,1,1
4849,återgivningsrätt.,0,0,1,1
4850,statistiskt,0,0,1,1
4855,semi-protegidas,0,0,1,1
4864,действии,0,0,1,1
4856,ಸ್ಪಾಟ್,0,0,1,1
4857,ಸಾಲ,0,0,1,1
4858,hände,0,0,1,1
4859,nobody,0,0,1,1
4860,விளம்பரங்களின்,0,0,1,1
4861,редактируются,0,0,1,1
4862,contended,0,0,1,1
5517,تيمز,0,0,1,1
5519,возможности.,0,0,1,1
6485,engineers,0,0,1,1
5997,indicada,0,0,1,1
6138,identifié.,0,0,1,1
6139,страх,0,0,1,1
6140,غاضب,0,0,1,1
6142,meramente,0,0,1,1
6143,raw,0,0,1,1
6144,выводы.,0,0,1,1
6146,tab,0,0,1,1
6147,comenzaba,0,0,1,1
6149,rol,0,0,1,1
6150,മുഴുവനും,0,0,1,1
6152,zinken,0,0,1,1
6153,n’existait,0,0,1,1
6154,sociedad.,0,0,1,1
6155,phenomenon,0,0,1,1
6156,λέξης.,0,0,1,1
6157,implied,0,0,1,1
6158,стадии,0,0,1,1
6137,отмечено,0,0,1,1
6136,fontenelle,0,0,1,1
6135,കൂടുതലുള്ളതും,0,0,1,1
6121,adopta,0,0,1,1
6109,ramen,0,0,1,1
6110,நலமாக,0,0,1,1
6113,l'expression,0,0,1,1
6114,eksisteret,0,0,1,1
6116,vinklade,0,0,1,1
6117,заносят,0,0,1,1
6120,نبحث,0,0,1,1
6123,dynamiques,0,0,1,1
6134,അയയ്ക്കാനോ,0,0,1,1
6126,занимался,0,0,1,1
6127,förväntade,0,0,1,1
6129,قريبا.,0,0,1,1
6130,انتقل,0,0,1,1
6131,فلنفعل,0,0,1,1
6132,مقالاتها،,0,0,1,1
6133,ഇരിക്കുന്നതുപോലെയാണ്,0,0,1,1
6161,arrangeras,0,0,1,1
6163,sällan,0,0,1,1
6164,monday,0,0,1,1
6219,l'esprit.,0,0,1,1
6201,تنس,0,0,1,1
6203,prolog,0,0,1,1
6212,erreichen,0,0,1,1
6213,ışıltılı,0,0,1,1
6214,.-pladsen,0,0,1,1
6216,заявлении,0,0,1,1
6217,dormía,0,0,1,1
6220,neurophysiologiste,0,0,1,1
6196,placés,0,0,1,1
6221,സമ്മാനം,0,0,1,1
6223,dirigido.,0,0,1,1
6225,forming,0,0,1,1
6226,refléter,0,0,1,1
6227,περισσότερο,0,0,1,1
6228,делал.,0,0,1,1
6229,تعايش,0,0,1,1
6199,falsehoods.,0,0,1,1
6195,വീഡിയോയ്ക്ക്,0,0,1,1
6170,supporte-moi,0,0,1,1
6182,عقولنا,0,0,1,1
6172,نزاعات,0,0,1,1
6175,behoud,0,0,1,1
6176,делаю,0,0,1,1
6177,eder,0,0,1,1
6178,kathryn,0,0,1,1
6180,تلو,0,0,1,1
6181,заданий,0,0,1,1
6183,மாவு,0,0,1,1
6194,ура,0,0,1,1
6184,പിസ്സ,0,0,1,1
6185,шутишь,0,0,1,1
6187,hænger,0,0,1,1
6188,sattın,0,0,1,1
6190,محررو,0,0,1,1
6191,எதிர்மாறாக,0,0,1,1
6193,akşam.,0,0,1,1
6108,révèle,0,0,1,1
6107,πω.,0,0,1,1
6106,falhas,0,0,1,1
6043,منهجي،,0,0,1,1
6029,ελληνική,0,0,1,1
6032,realizaram,0,0,1,1
6033,ऑक्सफ़ोर्ड,0,0,1,1
6037,hierarchical,0,0,1,1
6039,korkmuştu,0,0,1,1
6041,doneren,0,0,1,1
6042,geçide,0,0,1,1
6044,விரும்புகிறேன்.,0,0,1,1
6026,añadidura,0,0,1,1
6045,ಕರೆಯಲ್ಲಿ,0,0,1,1
6046,رحلاته,0,0,1,1
6048,volatil,0,0,1,1
6051,doutrina,0,0,1,1
6052,skewed,0,0,1,1
6053,existed,0,0,1,1
6054,diagnose,0,0,1,1
6028,henne.,0,0,1,1
6025,financée,0,0,1,1
6057,destacado,0,0,1,1
6011,l’intégralité,0,0,1,1
6002,ಹಳ್ಳಿಯಲ್ಲಿ,0,0,1,1
6003,ഡ്രിങ്ക്,0,0,1,1
6005,المعلقة,0,0,1,1
6006,ஏற்கிறது.,0,0,1,1
6007,olacağım.,0,0,1,1
6008,يرام.,0,0,1,1
6009,ഉണ്ടാവും.,0,0,1,1
6012,millimetre.,0,0,1,1
6024,चेक,0,0,1,1
6013,هاتفية,0,0,1,1
6014,jamais.,0,0,1,1
6016,hemmelighed.,0,0,1,1
6017,بوقاحة,0,0,1,1
6018,échappent,0,0,1,1
6019,пальцы.,0,0,1,1
6021,sorudan,0,0,1,1
6055,المتحدثون,0,0,1,1
6058,ಮೆಲ್ಲೀ,0,0,1,1
6105,a-t-elle,0,0,1,1
6093,स्लोवाक,0,0,1,1
6085,கிடைக்காதபோது,0,0,1,1
6087,hopefully,0,0,1,1
6088,ആർട്ടിഫിഷ്യൽ,0,0,1,1
6089,хуже,0,0,1,1
6090,اليكم,0,0,1,1
6091,mama.,0,0,1,1
6092,எழுதப்படுகின்றன.,0,0,1,1
6095,instruments,0,0,1,1
6083,beds.,0,0,1,1
6096,continents.,0,0,1,1
6097,föreslår,0,0,1,1
6099,भेजूंगा,0,0,1,1
6101,неплохо.,0,0,1,1
6102,technique.,0,0,1,1
6103,december.,0,0,1,1
6104,fizesse.,0,0,1,1
6084,playing,0,0,1,1
6081,museum,0,0,1,1
6059,inglês.,0,0,1,1
6068,ναρκίσσας,0,0,1,1
6060,certainly,0,0,1,1
6061,förstående,0,0,1,1
6063,தூக்கத்தில்,0,0,1,1
6064,kulağa,0,0,1,1
6065,kinderpornografie,0,0,1,1
6066,alto-falante.,0,0,1,1
6067,rapportés,0,0,1,1
6069,தாக்குதலுக்குள்ளாகும்,0,0,1,1
6080,olvidan,0,0,1,1
6070,ιππότης.,0,0,1,1
6071,escrita.,0,0,1,1
6072,പതാകവാഹക.,0,0,1,1
6074,värre,0,0,1,1
6076,identifique.,0,0,1,1
6077,ക്രൂരമാണ്,0,0,1,1
6079,soportes.,0,0,1,1
6230,dialects,0,0,1,1
6231,ಕೇವಲ,0,0,1,1
6232,положении.,0,0,1,1
6408,bijzijn,0,0,1,1
6396,vanwege,0,0,1,1
6398,contrastes.,0,0,1,1
6399,reden.,0,0,1,1
6400,പ്രിയങ്കരമെന്നും,0,0,1,1
6401,facing,0,0,1,1
6405,singulière,0,0,1,1
6407,ಒಪ್ಪಿಕೊಳ್ಳಿ.,0,0,1,1
6410,संगोष्ठी,0,0,1,1
6391,débuts.,0,0,1,1
6411,erste,0,0,1,1
6412,organic,0,0,1,1
6413,இதழ்,0,0,1,1
6415,компании,0,0,1,1
6416,يلجأ,0,0,1,1
6417,'gibi,0,0,1,1
6418,прачечную.,0,0,1,1
6392,ആളുണ്ടെന്നർഥം.,0,0,1,1
6390,успокойся,0,0,1,1
6423,ledere,0,0,1,1
6376,demandes,0,0,1,1
6369,சதுப்புநிலமானது,0,0,1,1
6370,sitesine,0,0,1,1
6371,basin.,0,0,1,1
6372,gebrekkig,0,0,1,1
6373,ekmekle,0,0,1,1
6374,petit ».,0,0,1,1
6375,सौ,0,0,1,1
6377,high-,0,0,1,1
6389,ρωτάτε,0,0,1,1
6378,выпустила,0,0,1,1
6380,britse,0,0,1,1
6381,weinig.,0,0,1,1
6382,l’« homme,0,0,1,1
6383,constituted,0,0,1,1
6385,ikinci,0,0,1,1
6387,betygsätta,0,0,1,1
6420,universelle »,0,0,1,1
6425,भूमण्डल,0,0,1,1
6366,सियोल,0,0,1,1
6470,lie,0,0,1,1
6459,corrigi-los.,0,0,1,1
6460,conforme,0,0,1,1
6461,inscrever-se,0,0,1,1
6462,mad.,0,0,1,1
6464,başta,0,0,1,1
6465,निर्भर,0,0,1,1
6466,webbtrafik,0,0,1,1
6472,недели,0,0,1,1
6456,அழகும்,0,0,1,1
6473,onaylanmış,0,0,1,1
6474,ಎಲ್ಲವನ್ನೂ,0,0,1,1
6479,determined,0,0,1,1
6480,लीब्रे,0,0,1,1
6482,விக்கிப்பீடியாவானது,0,0,1,1
6483,உருவாக்கும்,0,0,1,1
6484,ಉಚ್ಚರಿಸುತ್ತಿದ್ದೀರಿ,0,0,1,1
6458,еде,0,0,1,1
6455,administratör,0,0,1,1
6427,yansır.,0,0,1,1
6436,biélorusse,0,0,1,1
6428,ಮಂಚದ,0,0,1,1
6429,notskrift,0,0,1,1
6430,revenues.,0,0,1,1
6432,высоко,0,0,1,1
6433,وحده,0,0,1,1
6434,vi •,0,0,1,1
6435,nn •,0,0,1,1
6437,satmanı,0,0,1,1
6454,englische,0,0,1,1
6439,ಇನ್ನೊಂದಕ್ಕೆ,0,0,1,1
6445,foreslå,0,0,1,1
6446,объяснениях,0,0,1,1
6447,gördüğünde,0,0,1,1
6448,means.,0,0,1,1
6449,probabiliste,0,0,1,1
6453,സവാരിക്ക്,0,0,1,1
6367,out.,0,0,1,1
6364,gidin,0,0,1,1
6234,declarações,0,0,1,1
6284,തിരുത്തിക്കോളും,0,0,1,1
6274,ridende,0,0,1,1
6276,adivinhar,0,0,1,1
6277,அட்டவணை,0,0,1,1
6278,silesiano,0,0,1,1
6280,noticiário.,0,0,1,1
6281,l'appareil,0,0,1,1
6282,среда,0,0,1,1
6285,reminds,0,0,1,1
6268,स्नो,0,0,1,1
6286,செய்துவிட்டதாகவும்,0,0,1,1
6287,l'autorité,0,0,1,1
6288,noyade,0,0,1,1
6290,تحويها,0,0,1,1
6291,توقفت,0,0,1,1
6292,autoconfirmed,0,0,1,1
6295,إحدى,0,0,1,1
6273,gældende,0,0,1,1
6263,ನನ್ನೊಂದಿಗೆ,0,0,1,1
6298,ಅನುಭವವನ್ನು,0,0,1,1
6246,probabilidad,0,0,1,1
6235,سُئلت,0,0,1,1
6237,similares,0,0,1,1
6238,anpassas,0,0,1,1
6240,repetidos,0,0,1,1
6241,falto.,0,0,1,1
6242,للتعلم,0,0,1,1
6245,സഞ്ചരിച്ചിരുന്ന,0,0,1,1
6248,acessíveis,0,0,1,1
6262,frage.,0,0,1,1
6249,kalbi,0,0,1,1
6251,நாட்களாக,0,0,1,1
6253,общественным,0,0,1,1
6255,пытаются,0,0,1,1
6257,dulce.,0,0,1,1
6259,mg •,0,0,1,1
6261,begik,0,0,1,1
6297,periodismo,0,0,1,1
6300,figaro,0,0,1,1
6362,incita,0,0,1,1
6349,ноябре,0,0,1,1
6337,homogénéité,0,0,1,1
6339,proceeds.,0,0,1,1
6341,bloqueando,0,0,1,1
6343,ತೀಕ್ಷ್ಣವಾದ,0,0,1,1
6344,éditeur,0,0,1,1
6346,plane.,0,0,1,1
6347,applicants,0,0,1,1
6351,hazır,0,0,1,1
6333,நத்தை,0,0,1,1
6352,avaliado,0,0,1,1
6353,utformat,0,0,1,1
6354,എന്തുചെയ്യും,0,0,1,1
6355,zweimal.,0,0,1,1
6356,ನೋಡುತ್ತಿದ್ದಾರೆ,0,0,1,1
6357,covid-,0,0,1,1
6358,заказ,0,0,1,1
6336,चली,0,0,1,1
6331,englisch.,0,0,1,1
6301,задаваемых,0,0,1,1
6315,декабрь,0,0,1,1
6306,इनकार,0,0,1,1
6307,ज़ोर,0,0,1,1
6308,vio,0,0,1,1
6309,sökbar,0,0,1,1
6310,contraignants,0,0,1,1
6311,i̇çeriğinin,0,0,1,1
6312,protester».,0,0,1,1
6316,வில்லை.,0,0,1,1
6330,обязательно,0,0,1,1
6320,annuaire,0,0,1,1
6321,olmuştu,0,0,1,1
6322,interpretações.,0,0,1,1
6325,processeurs,0,0,1,1
6327,transcendance,0,0,1,1
6328,θυμωμένος.,0,0,1,1
6329,മലയാള,0,0,1,1
6001,redaktörer,0,0,1,1
5996,bidragydere,0,0,1,1
5521,μάθημα.,0,0,1,1
5995,مرخص,0,0,1,1
5676,करेंगी,0,0,1,1
5677,triviais,0,0,1,1
5678,قارات,0,0,1,1
5679,اغتيال,0,0,1,1
5682,മറ്റുള്ളവർക്ക്,0,0,1,1
5683,referans,0,0,1,1
5684,anneyi,0,0,1,1
5685,presentados.,0,0,1,1
5686,jeu.,0,0,1,1
5688,ಸಾಮಾನ್ಯ.,0,0,1,1
5689,arreglado,0,0,1,1
5692,estudiante​,0,0,1,1
5693,ಇದರ,0,0,1,1
5694,വിലകൾക്ക്,0,0,1,1
5695,التاريخ,0,0,1,1
5696,nås,0,0,1,1
5697,रोमान्श,0,0,1,1
5675,വിവര,0,0,1,1
5674,hizo,0,0,1,1
5670,πληκτρολογήστε,0,0,1,1
5655,അഭിനന്ദിക്കുന്നു.,0,0,1,1
5640,compromises,0,0,1,1
5644,ansigt,0,0,1,1
5645,kaldet.,0,0,1,1
5646,нейтральной,0,0,1,1
5648,மாதங்களில்,0,0,1,1
5649,sahiptir,0,0,1,1
5650,സംശയത്തിന്,0,0,1,1
5656,reparar,0,0,1,1
5668,wikifika,0,0,1,1
5657,escuchaste,0,0,1,1
5659,baffling,0,0,1,1
5660,amatörernas,0,0,1,1
5661,vandal,0,0,1,1
5662,dactylographié,0,0,1,1
5666,النوع,0,0,1,1
5667,interesado,0,0,1,1
5701,старому,0,0,1,1
5702,இருக்கவும்,0,0,1,1
5705,sinemaya,0,0,1,1
5744,olmana,0,0,1,1
5735,tarihinde,0,0,1,1
5736,казались,0,0,1,1
5737,schreiben.,0,0,1,1
5738,territoires,0,0,1,1
5741,وما,0,0,1,1
5742,excluded,0,0,1,1
5743,விரும்புவீர்கள்,0,0,1,1
5745,रेटिंग,0,0,1,1
5733,bernard,0,0,1,1
5748,താഴെയുമാണ്.,0,0,1,1
5749,videodaki,0,0,1,1
5750,ജോലിയും,0,0,1,1
5751,falsch,0,0,1,1
5752,online.,0,0,1,1
5756,operates,0,0,1,1
5757,melhoram,0,0,1,1
5734,utilisées,0,0,1,1
5732,riktlinjerna,0,0,1,1
5708,serveurs[quand ],0,0,1,1
5719,invalidado,0,0,1,1
5710,monument,0,0,1,1
5711,μιλήσουμε,0,0,1,1
5713,apropiado,0,0,1,1
5715,.നാമെല്ലാവരും,0,0,1,1
5716,çocuğa,0,0,1,1
5717,رأيين,0,0,1,1
5718,convoluted,0,0,1,1
5721,thematic,0,0,1,1
5731,rubin,0,0,1,1
5722,തീരുമാനമാണ്,0,0,1,1
5724,impreso.,0,0,1,1
5725,unhappy.,0,0,1,1
5726,فيديو,0,0,1,1
5727,moeilijk,0,0,1,1
5728,multimídias.,0,0,1,1
5729,basée,0,0,1,1
5639,ಸ್ನೇಹಿತರೆಲ್ಲರೂ,0,0,1,1
5638,primitive,0,0,1,1
5637,так.,0,0,1,1
5564,«знания».,0,0,1,1
5555,stürmisches,0,0,1,1
5557,سخيف.,0,0,1,1
5559,modernes.,0,0,1,1
5560,civility,0,0,1,1
5561,limités,0,0,1,1
5562,høje,0,0,1,1
5563,sinken.,0,0,1,1
5565,forklare,0,0,1,1
5552,reconstruction,0,0,1,1
5566,rasgos,0,0,1,1
5567,.hepimiz,0,0,1,1
5568,bekend.,0,0,1,1
5569,« robots »,0,0,1,1
5570,autres ,0,0,1,1
5572,выражая,0,0,1,1
5573,edemezsin,0,0,1,1
5553,έχεις,0,0,1,1
5551,majeurs,0,0,1,1
5576,αντίο,0,0,1,1
5532,உதவியுடன்,0,0,1,1
5523,ಮಗು,0,0,1,1
5525,violated.,0,0,1,1
5526,d’inclure,0,0,1,1
5527,servrar[b],0,0,1,1
5529,afslutte.,0,0,1,1
5530,entsetzlich,0,0,1,1
5531,géré,0,0,1,1
5533,d'accroître,0,0,1,1
5550,diyor.,0,0,1,1
5534,descubrir,0,0,1,1
5537,நகைச்சுவை,0,0,1,1
5540,algorithm.,0,0,1,1
5542,grundaren,0,0,1,1
5543,ಸ್ಮೈಲ್ಸ್,0,0,1,1
5544,geheimen,0,0,1,1
5547,المشروع.,0,0,1,1
5575,перелицензировать,0,0,1,1
5577,scorpionsfeatures,0,0,1,1
5636,creerlo,0,0,1,1
5626,продвижении,0,0,1,1
5616,functional,0,0,1,1
5617,право,0,0,1,1
5618,statesman,0,0,1,1
5620,بالعلوم.,0,0,1,1
5621,любимым,0,0,1,1
5622,landsby,0,0,1,1
5623,репутацией,0,0,1,1
5627,ഗുണമേന്മയ്ക്കു,0,0,1,1
5613,concepten,0,0,1,1
5628,«офис»,0,0,1,1
5629,gilla,0,0,1,1
5630,भागीदार,0,0,1,1
5631,δώστε,0,0,1,1
5632,вандализирована.,0,0,1,1
5633,имею.,0,0,1,1
5635,يستحوذ,0,0,1,1
5615,polysémique,0,0,1,1
5612,комик,0,0,1,1
5579,turkije,0,0,1,1
5593,अचंभित,0,0,1,1
5580,görmek,0,0,1,1
5583,astonishing.,0,0,1,1
5587,വിജ്ഞാനശകലങ്ങൾചേർക്കുന്നവർക്കുണ്ടായേക്കാവുന്ന,0,0,1,1
5589,بجد,0,0,1,1
5590,потерял,0,0,1,1
5591,ನಿಯೋಜನೆಗಳೊಂದಿಗೆ,0,0,1,1
5592,​​ontmoetingsplaats,0,0,1,1
5596,değmediğini,0,0,1,1
5611,verebilirsin,0,0,1,1
5599,தொடங்குங்கள்,0,0,1,1
5602,missvisande,0,0,1,1
5604,grossièrement,0,0,1,1
5606,உருவாக்கினர்.,0,0,1,1
5608,isolées,0,0,1,1
5609,εξασκηθείτε,0,0,1,1
5610,нарцисс,0,0,1,1
5758,coreia,0,0,1,1
5760,god's,0,0,1,1
5761,desigual.,0,0,1,1
5928,persist,0,0,1,1
5912,båda.,0,0,1,1
5914,l'inadéquation,0,0,1,1
5916,प्रासंगिक,0,0,1,1
5919,watchlist,0,0,1,1
5921,планировалось,0,0,1,1
5924,தோட்டத்தில்,0,0,1,1
5925,prácticas,0,0,1,1
5929,·i,0,0,1,1
5910,statements.,0,0,1,1
5930,cart,0,0,1,1
5931,possuindo,0,0,1,1
5932,conservatrice,0,0,1,1
5934,verket,0,0,1,1
5936,നിർത്തുക,0,0,1,1
5937,«знания»,0,0,1,1
5938,معيبة,0,0,1,1
5911,{{section,0,0,1,1
5908,suscetibilidade,0,0,1,1
5941,والانتقادات,0,0,1,1
5887,entornos,0,0,1,1
5880,சொல்லை,0,0,1,1
5881,großartig,0,0,1,1
5882,recogida,0,0,1,1
5883,isologo,0,0,1,1
5884,एहसास,0,0,1,1
5885,juego,0,0,1,1
5886,matta,0,0,1,1
5890,பிடித்துக்,0,0,1,1
5903,പെർഫക്റ്റാവണം,0,0,1,1
5891,teşekkürler,0,0,1,1
5894,proche,0,0,1,1
5895,ಜನರಿಗೆ,0,0,1,1
5897,ಭಾವಿಸಿದ್ದೀರಿ,0,0,1,1
5898,piada.,0,0,1,1
5899,projet.,0,0,1,1
5900,illustrée,0,0,1,1
5939,ابنتك,0,0,1,1
5943,മാസങ്ങളോ,0,0,1,1
5876,lisanslama,0,0,1,1
5982,ಪ್ರದೇಶವನ್ನು,0,0,1,1
5971,förändrats,0,0,1,1
5973,“விக்கிமீடீயா”,0,0,1,1
5974,estágios,0,0,1,1
5975,berlim,0,0,1,1
5978,português.,0,0,1,1
5979,eruit,0,0,1,1
5980,filtrados,0,0,1,1
5984,شخصية,0,0,1,1
5967,lapso.,0,0,1,1
5987,angebote,0,0,1,1
5988,ആശയസംഘട്ടനങ്ങൾ,0,0,1,1
5989,ആവശ്യപ്പെടാത്തപ്പോൾ,0,0,1,1
5991,πως',0,0,1,1
5992,ನಡೆಯುತ್ತಿದ್ದರೆ,0,0,1,1
5993,arkadaşların,0,0,1,1
5994,നിലനിൽക്കുന്നതായി,0,0,1,1
5970,سرا,0,0,1,1
5965,என்பதைச்,0,0,1,1
5944,unfeasible,0,0,1,1
5955,intención,0,0,1,1
5945,полезно,0,0,1,1
5946,convencional.,0,0,1,1
5947,cinéaste,0,0,1,1
5948,afirmación,0,0,1,1
5951,financière,0,0,1,1
5952,പരിഹരിക്കപ്പെടുമെന്നാണ്,0,0,1,1
5954,χρυσό.,0,0,1,1
5956,നിങ്ങളെത്തന്നെ,0,0,1,1
5964,fugles,0,0,1,1
5957,написанием,0,0,1,1
5958,суток.,0,0,1,1
5959,synapses,0,0,1,1
5960,changed.,0,0,1,1
5961,stand,0,0,1,1
5962,этими,0,0,1,1
5963,oublient,0,0,1,1
5879,असमिया,0,0,1,1
5875,nutricionista,0,0,1,1
5762,kamu,0,0,1,1
5804,raison.,0,0,1,1
5790,démissionne,0,0,1,1
5792,[ˌwɪkɨˈpiːdiə],0,0,1,1
5794,características.,0,0,1,1
5797,tic,0,0,1,1
5798,encontram-se,0,0,1,1
5800,voorzichtig.,0,0,1,1
5802,സംസാരിക്കുന്നത്,0,0,1,1
5805,bueno.,0,0,1,1
5788,view.,0,0,1,1
5806,مرعوب,0,0,1,1
5807,мысль,0,0,1,1
5808,ostenten,0,0,1,1
5809,concluíram,0,0,1,1
5811,تجري,0,0,1,1
5812,नियमों,0,0,1,1
5816,street.,0,0,1,1
5789,chicos.,0,0,1,1
5785,trend.,0,0,1,1
5819,είστε.,0,0,1,1
5772,gonna.,0,0,1,1
5764,избранные,0,0,1,1
5765,للزواج.,0,0,1,1
5766,veda,0,0,1,1
5768,« tapez,0,0,1,1
5769,τρώω,0,0,1,1
5770,perda,0,0,1,1
5771,सशक्त,0,0,1,1
5773,idade,0,0,1,1
5784,doméstico,0,0,1,1
5775,объёму,0,0,1,1
5776,çevrimiçi,0,0,1,1
5777,tartışmalı,0,0,1,1
5778,klokkeikonet,0,0,1,1
5779,l'accusant,0,0,1,1
5781,nyttigt,0,0,1,1
5783,محتوياتها؛.,0,0,1,1
5818,السهل,0,0,1,1
5820,bakıyordu,0,0,1,1
5873,s'efforcer,0,0,1,1
5858,buluşmaya,0,0,1,1
5848,மறந்துவிடுகிறார்கள்,0,0,1,1
5849,d'émissions,0,0,1,1
5850,διοικούνται,0,0,1,1
5851,pools,0,0,1,1
5852,filosóficas,0,0,1,1
5856,iğrenç,0,0,1,1
5857,algae.,0,0,1,1
5861,instrumento,0,0,1,1
5845,അവസാനത്തിലും,0,0,1,1
5862,നൽകണം,0,0,1,1
5865,initialement,0,0,1,1
5867,utforma,0,0,1,1
5868,हूवरिंग,0,0,1,1
5869,സൗരയൂഥത്തിൽ,0,0,1,1
5871,wikiprincipen,0,0,1,1
5872,vrijgave,0,0,1,1
5846,secuencias,0,0,1,1
5844,sophistiqués,0,0,1,1
5821,hawaïen,0,0,1,1
5830,amongst,0,0,1,1
5822,صموئيل،,0,0,1,1
5823,ಮಾಡೋಣ.,0,0,1,1
5825,അസ്വസ്ഥമാകരുത്.,0,0,1,1
5826,neutraal,0,0,1,1
5827,источники,0,0,1,1
5828,вызванных,0,0,1,1
5829,العلمي،,0,0,1,1
5832,arctic,0,0,1,1
5843,മനുഷ്യനും.,0,0,1,1
5833,predeterminada,0,0,1,1
5834,fantastisch.,0,0,1,1
5835,específico.,0,0,1,1
5838,ubicación,0,0,1,1
5839,lignende,0,0,1,1
5841,septième,0,0,1,1
5842,olhares,0,0,1,1
16266,bestond.,0,0,1,1
16268,previsões,0,0,1,1
31691,reasoning.,0,0,1,1
26402,wikiprojeto,0,0,1,1
26575,embarcar,0,0,1,1
26576,folga,0,0,1,1
26577,théorique…,0,0,1,1
26578,лицензию,0,0,1,1
26579,اثنا,0,0,1,1
26580,mestre,0,0,1,1
26581,попросить,0,0,1,1
26582,thereby,0,0,1,1
26583,zoekopdracht,0,0,1,1
26585,sous-domaine,0,0,1,1
26586,webcomic,0,0,1,1
26589,graden.,0,0,1,1
26590,spontanément,0,0,1,1
26591,ಕಾಣಿಸುತ್ತಿದ್ದಳು,0,0,1,1
26592,प्लेट,0,0,1,1
26593,डूबने,0,0,1,1
26594,point-of-view,0,0,1,1
26571,википедией ,0,0,1,1
26570,എന്നതിനാൽ,0,0,1,1
26568,continues.,0,0,1,1
26556,frecuencia,0,0,1,1
26544,يتحرك,0,0,1,1
26545,تخبره,0,0,1,1
26547,சாயங்காலம்.,0,0,1,1
26548,விருப்பமான,0,0,1,1
26551,voluntariamente,0,0,1,1
26552,verändert.,0,0,1,1
26554,kitabınızı,0,0,1,1
26557,ದೇವದೂತರೊಂದಿಗೆ,0,0,1,1
26567,anulada,0,0,1,1
26559,فلماذا,0,0,1,1
26560,yarayacağını,0,0,1,1
26562,с англ.,0,0,1,1
26563,ಸುತ್ತುವ,0,0,1,1
26564,ಕಣ್ಣು,0,0,1,1
26565,२००३,0,0,1,1
26566,അതിശയകരമായിരിക്കും,0,0,1,1
26595,chamou,0,0,1,1
26597,μίλι,0,0,1,1
26599,trompent.,0,0,1,1
26646,ಮಾಡುತ್ತದೆ.,0,0,1,1
26636,используя,0,0,1,1
26638,والجدال,0,0,1,1
26639,reporting,0,0,1,1
26641,skillnaden,0,0,1,1
26643,حركة,0,0,1,1
26644,would.,0,0,1,1
26645,идея.,0,0,1,1
26647,l'enrichir,0,0,1,1
26634,crust.,0,0,1,1
26648,toetsing,0,0,1,1
26649,दिखता,0,0,1,1
26650,allégorique,0,0,1,1
26652,f.eks.,0,0,1,1
26653,maalesef,0,0,1,1
26656,дартмутского,0,0,1,1
26657,connectivity.,0,0,1,1
26635,l'augmentation,0,0,1,1
26633,διασχίζετε,0,0,1,1
26600,envoyez-vous,0,0,1,1
26610,schön.,0,0,1,1
26601,роб,0,0,1,1
26602,άλλους,0,0,1,1
26603,reconhecido.,0,0,1,1
26605,ಉತ್ತರಿಸಲು,0,0,1,1
26607,വസ്ത്രധാരണത്തിൽ,0,0,1,1
26608,traditionnelle,0,0,1,1
26609,إنترنت.,0,0,1,1
26612,fortsætte,0,0,1,1
26630,grusomt,0,0,1,1
26615,anonymity,0,0,1,1
26616,sizes,0,0,1,1
26621,ബട്ടണും,0,0,1,1
26624,закончится,0,0,1,1
26625,reichtümer,0,0,1,1
26627,மனமார்ந்த,0,0,1,1
26629,latim,0,0,1,1
26543,yokmuş,0,0,1,1
26542,trabalhado,0,0,1,1
26540,hayranlarının,0,0,1,1
26447,предложениям,0,0,1,1
26434,μοίρες.,0,0,1,1
26436,stötande,0,0,1,1
26437,övergav,0,0,1,1
26441,«activas»,0,0,1,1
26442,खरीदा,0,0,1,1
26443,lembre-se.,0,0,1,1
26444,сайте.,0,0,1,1
26448,kabuğumun,0,0,1,1
26431,twenty,0,0,1,1
26449,profond.,0,0,1,1
26451,escribe,0,0,1,1
26453,കാണിക്കാൻ,0,0,1,1
26454,балкона,0,0,1,1
26459,sicher.,0,0,1,1
26460,lendo,0,0,1,1
26464,ഹലോ,0,0,1,1
26432,ஆரம்பமானது.,0,0,1,1
26430,utilisation.,0,0,1,1
26471,istemediğimde,0,0,1,1
26416,surrounded,0,0,1,1
26406,piensas,0,0,1,1
26410,запрашивая,0,0,1,1
26411,तिमाही,0,0,1,1
26412,acheté,0,0,1,1
26413,overeenkomstige,0,0,1,1
26414,tillfälligt,0,0,1,1
26415,religionskritik,0,0,1,1
26417,മെയ്,0,0,1,1
26427,επιβάλλουν,0,0,1,1
26418,பகுதியில்,0,0,1,1
26419,düşünün.,0,0,1,1
26420,voudrait,0,0,1,1
26421,expressou,0,0,1,1
26423,probable,0,0,1,1
26424,humanidad».,0,0,1,1
26426,चिड़िया,0,0,1,1
26466,guy,0,0,1,1
26472,råka,0,0,1,1
26539,തുടക്കംകുറിച്ചത്‌.,0,0,1,1
26520,verklaring,0,0,1,1
26504,applicable,0,0,1,1
26505,épaisse,0,0,1,1
26506,herói,0,0,1,1
26507,ഡൈനിംഗ്,0,0,1,1
26510,wensen.,0,0,1,1
26515,мнению,0,0,1,1
26516,denuncia,0,0,1,1
26521,citizens,0,0,1,1
26502,вялости,0,0,1,1
26523,പഞ്ചാബി,0,0,1,1
26524,பாதுகாக்கப்படுகின்றன.,0,0,1,1
26528,ಮೀರಿ,0,0,1,1
26530,उबाऊ,0,0,1,1
26531,ನಿಯಮಗಳನ್ನು,0,0,1,1
26533,ayudarte,0,0,1,1
26535,weinen.,0,0,1,1
26503,presenterats,0,0,1,1
26501,asombrosa,0,0,1,1
26473,widersprüchliche,0,0,1,1
26489,सह,0,0,1,1
26477,معروف,0,0,1,1
26478,sjunker,0,0,1,1
26479,ಹಿಡಿಯಲಿಲ್ಲ,0,0,1,1
26481,instantanément,0,0,1,1
26483,aangeboden,0,0,1,1
26484,التأكيد,0,0,1,1
26486,stond,0,0,1,1
26491,enfocada,0,0,1,1
26500,bid,0,0,1,1
26492,extinct.,0,0,1,1
26493,ആചാരങ്ങളാൽ,0,0,1,1
26494,марион,0,0,1,1
26495,sugestões.,0,0,1,1
26496,sencillo,0,0,1,1
26497,henüz,0,0,1,1
26499,ಹುಡುಗರಲ್ಲಿ,0,0,1,1
26658,സിന്ധൂനദീതടസംസ്കാരം,0,0,1,1
26659,níveis,0,0,1,1
26660,sinnet,0,0,1,1
26828,listed,0,0,1,1
26812,вреда.,0,0,1,1
26815,ಯಾವುವು,0,0,1,1
26820,agraciada,0,0,1,1
26821,trafic.,0,0,1,1
26822,прошлой,0,0,1,1
26824,विकिपीडिया।,0,0,1,1
26827,espirrou,0,0,1,1
26829,discute,0,0,1,1
26809,chinois ,0,0,1,1
26831,يو,0,0,1,1
26832,ಕೆಳಕ್ಕೆ,0,0,1,1
26834,kullanıcıları,0,0,1,1
26835,höra,0,0,1,1
26836,updates,0,0,1,1
26837,ತುಂಬಿಸಲು,0,0,1,1
26838,terry.,0,0,1,1
26811,relicenciar,0,0,1,1
26808,примерно,0,0,1,1
26840,convaincre,0,0,1,1
26794,collecte,0,0,1,1
26785,எட்டப்படுகிறது.,0,0,1,1
26787,ihn.,0,0,1,1
26788,ಹೇಗಿದ್ದೀರಿ,0,0,1,1
26790,lithify,0,0,1,1
26791,confidence,0,0,1,1
26792,سابق,0,0,1,1
26793,നാർസിസിന്റെ,0,0,1,1
26795,அடித்தீர்கள்.,0,0,1,1
26807,centralt,0,0,1,1
26797,funcionalidades,0,0,1,1
26798,تشاركها,0,0,1,1
26799,visités,0,0,1,1
26800,yakutların,0,0,1,1
26803,ತೊಂದರೆಗೊಳಗಾಗಿದ್ದೇನೆ,0,0,1,1
26804,infeasible.,0,0,1,1
26806,falsos.,0,0,1,1
26839,örnekler,0,0,1,1
26841,argumentó,0,0,1,1
26781,blanda,0,0,1,1
26884,ಹಾಕುತ್ತಿದ್ದೇನೆ.,0,0,1,1
26876,associadas,0,0,1,1
26877,personnellement,0,0,1,1
26878,waved,0,0,1,1
26879,गले,0,0,1,1
26881,കേൾക്കുന്നില്ല.,0,0,1,1
26882,எளிதில்,0,0,1,1
26883,تنطبق,0,0,1,1
26885,ഭയന്ന്,0,0,1,1
26872,സംസാരിക്കാം.,0,0,1,1
26886,viejo,0,0,1,1
26889,αυτοί,0,0,1,1
26890,ദീർഘനേരം,0,0,1,1
26892,ändras.,0,0,1,1
26893,norteamericana,0,0,1,1
26894,paper,0,0,1,1
26895,നിന്നാണ്.,0,0,1,1
26873,ويبكي.,0,0,1,1
26871,αναστατωθεί,0,0,1,1
26844,‘குழுச்,0,0,1,1
26855,überstrapaziertes,0,0,1,1
26845,concentrated,0,0,1,1
26846,отмечая,0,0,1,1
26847,parar,0,0,1,1
26848,தெரிவிப்பதன்,0,0,1,1
26851,savunmaktadır.,0,0,1,1
26853,بمصادر,0,0,1,1
26854,genus,0,0,1,1
26857,utrolige,0,0,1,1
26866,guldbrødet,0,0,1,1
26859,amendment,0,0,1,1
26860,basura,0,0,1,1
26861,«срезать,0,0,1,1
26862,وعملت,0,0,1,1
26863,ಭಾವಿಸುವ,0,0,1,1
26864,इनके,0,0,1,1
26865,gratuitamente,0,0,1,1
26783,publicerats,0,0,1,1
26780,philosophiques,0,0,1,1
26661,« l'art,0,0,1,1
26704,இணையத்தளம்.,0,0,1,1
26693,narsizaya,0,0,1,1
26694,d’attribuer,0,0,1,1
26696,diskussionssidan.,0,0,1,1
26699,concluent,0,0,1,1
26700,indirilmesi,0,0,1,1
26701,pangaea,0,0,1,1
26703,appear.,0,0,1,1
26706,ഭാഗ്യത്തിന്റെ,0,0,1,1
26689,reter,0,0,1,1
26707,paradigms,0,0,1,1
26709,بالقرب,0,0,1,1
26710,persistent,0,0,1,1
26711,grafías,0,0,1,1
26712,l'analogisme,0,0,1,1
26714,worthy,0,0,1,1
26715,scientology,0,0,1,1
26692,erstaunlicher,0,0,1,1
26688,voortbestaan,0,0,1,1
26717,klonen,0,0,1,1
26669,zamanlar,0,0,1,1
26662,yazdım,0,0,1,1
26663,familie,0,0,1,1
26664,deadnames,0,0,1,1
26665,μιλήσεις,0,0,1,1
26666,chefe,0,0,1,1
26667,amerika.,0,0,1,1
26668,வியப்படைந்தாள்,0,0,1,1
26670,vanmorgen,0,0,1,1
26687,والنزاعات,0,0,1,1
26671,ലൈക്ക്,0,0,1,1
26672,allons.,0,0,1,1
26673,operation,0,0,1,1
26674,вопросами.,0,0,1,1
26675,oud,0,0,1,1
26677,objektif,0,0,1,1
26679,embaixo,0,0,1,1
26716,particulière.,0,0,1,1
26718,показывает,0,0,1,1
26778,aner,0,0,1,1
26766,uz •,0,0,1,1
26751,inferencial,0,0,1,1
26754,wap-sidor,0,0,1,1
26755,ağlayarak,0,0,1,1
26759,редакционных,0,0,1,1
26761,медицине,0,0,1,1
26762,imitation,0,0,1,1
26764,придумал,0,0,1,1
26767,ಮರೆಯಬೇಡಿ.,0,0,1,1
26748,பதிவுசெய்த,0,0,1,1
26769,المحتوى،,0,0,1,1
26771,கொண்டிருந்தாலும்,0,0,1,1
26772,judicial,0,0,1,1
26773,لمقالة،,0,0,1,1
26774,l'exhaustivité,0,0,1,1
26776,influencées,0,0,1,1
26777,souple,0,0,1,1
26749,поставлена,0,0,1,1
26747,участие.,0,0,1,1
26719,ஐ,0,0,1,1
26730,precipitation.,0,0,1,1
26720,symbolistes.,0,0,1,1
26723,-минутный,0,0,1,1
26725,база,0,0,1,1
26726,abonnementsknappen,0,0,1,1
26727,விக்கிப்பீடியாவுக்கு,0,0,1,1
26728,кластеры,0,0,1,1
26729,animada,0,0,1,1
26731,популярность,0,0,1,1
26746,« lois »,0,0,1,1
26737,curtir,0,0,1,1
26738,côtés,0,0,1,1
26739,kadın,0,0,1,1
26740,руководствам,0,0,1,1
26741,konudaki,0,0,1,1
26743,avisam,0,0,1,1
26745,sends,0,0,1,1
26404,boursier ,0,0,1,1
26401,miroir,0,0,1,1
26898,ഏവർക്കുമറിവുള്ളതാണല്ലോ.,0,0,1,1
26400,упомянули,0,0,1,1
26085,quente,0,0,1,1
26086,возможных,0,0,1,1
26088,ചെയ്യാനാവുന്ന,0,0,1,1
26089,nationales,0,0,1,1
26092,«объект,0,0,1,1
26093,udgiver,0,0,1,1
26096,onderzoeksresultaten,0,0,1,1
26097,young,0,0,1,1
26098,secondaires,0,0,1,1
26100,eficientes,0,0,1,1
26101,innate,0,0,1,1
26102,génome,0,0,1,1
26103,граффити,0,0,1,1
26104,grafo,0,0,1,1
26105,lenguajes,0,0,1,1
26106,re-enters,0,0,1,1
26107,tártaro,0,0,1,1
26083,classification.,0,0,1,1
26082,இதற்குப்,0,0,1,1
26081,brev,0,0,1,1
26069,κεφάλι.,0,0,1,1
26058,النيكل؛,0,0,1,1
26059,σωστή,0,0,1,1
26060,numarasını,0,0,1,1
26061,sattın.,0,0,1,1
26064,supplies,0,0,1,1
26066,நகரத்தின்,0,0,1,1
26068,soldiers,0,0,1,1
26070,glimlachte,0,0,1,1
26080,പുനരാരംഭിക്കുകയും,0,0,1,1
26071,மென்பொருளில்,0,0,1,1
26073,licenciada,0,0,1,1
26074,temores,0,0,1,1
26075,l'est.,0,0,1,1
26076,चीजों,0,0,1,1
26077,koud,0,0,1,1
26079,casarme,0,0,1,1
26108,bissen,0,0,1,1
26109,alamazsınız,0,0,1,1
26110,there’s,0,0,1,1
26153,प्राधिकृत,0,0,1,1
26145,tanıştığıma,0,0,1,1
26146,altavoz,0,0,1,1
26147,news'.,0,0,1,1
26148,उँगलियों,0,0,1,1
26149,haftalarca,0,0,1,1
26151,παρανόηση,0,0,1,1
26152,φτιάξετε,0,0,1,1
26154,olduğunda,0,0,1,1
26143,d’individus,0,0,1,1
26155,symbolistes,0,0,1,1
26157,إضافية,0,0,1,1
26158,outcomes,0,0,1,1
26160,treated,0,0,1,1
26161,couramment,0,0,1,1
26162,mattebok,0,0,1,1
26165,sürdürmelerini,0,0,1,1
26144,minderheidstalen,0,0,1,1
26137,മാർഗദർശിത,0,0,1,1
26113,внешнему,0,0,1,1
26124,خذ,0,0,1,1
26114,ಭಾಷಿಕರು,0,0,1,1
26116,alıştırması,0,0,1,1
26117,patrones.,0,0,1,1
1,disponibilità,1,1,0,1
26120,galilée.,0,0,1,1
26122,brandchannel,0,0,1,1
26123,entschuldigung.,0,0,1,1
26125,വാക്യത്തിന്റെ,0,0,1,1
26136,biotope.,0,0,1,1
26128,indonesio,0,0,1,1
26129,गंभीरता,0,0,1,1
26130,местности,0,0,1,1
26131,pride,0,0,1,1
26132,magtmisbrug.,0,0,1,1
26133,compositeur,0,0,1,1
26135,उत्प्रेरक,0,0,1,1
26057,autobús,0,0,1,1
26055,എന്നതിന്,0,0,1,1
26054,svensk,0,0,1,1
25984,soumise,0,0,1,1
25976,الفائدة,0,0,1,1
25977,هذا.,0,0,1,1
25978,வெளித்தொகுப்புக்களை,0,0,1,1
25979,उन्हने,0,0,1,1
25980,practica,0,0,1,1
25981,ускорить,0,0,1,1
25983,पब्लिक,0,0,1,1
25987,ಫಿಕ್ಸ್‌ನ,0,0,1,1
25973,vergadering,0,0,1,1
25988,പേരുടെ,0,0,1,1
25989,ekmekten,0,0,1,1
25990,തണുപ്പാണ്,0,0,1,1
25991,ಒಪ್ಪುವುದಿಲ್ಲ.,0,0,1,1
25992,autónoma,0,0,1,1
25994,méritais,0,0,1,1
25995,അല്ലയോ,0,0,1,1
25974,matematikbog,0,0,1,1
25972,adopted.,0,0,1,1
25997,вики.,0,0,1,1
25955,estatísticos.,0,0,1,1
25942,capitalistas.,0,0,1,1
25944,முடிவை,0,0,1,1
25946,etc..,0,0,1,1
25947,моих,0,0,1,1
25948,unterschiedlichen,0,0,1,1
25950,करोड़,0,0,1,1
25953,microecosystem.,0,0,1,1
25956,ವಿವರಿಸುವಾಗ,0,0,1,1
25971,soumis,0,0,1,1
25958,க்மாட்டை,0,0,1,1
25959,organisatie.,0,0,1,1
25960,juge,0,0,1,1
25961,klas,0,0,1,1
25962,eerder.,0,0,1,1
25964,τίποτα.,0,0,1,1
25965,അന്തരീക്ഷത്തിന്,0,0,1,1
25996,¿podrías,0,0,1,1
25998,φανταχτερά,0,0,1,1
26050,sümüklüböcek,0,0,1,1
26040,erdoğan,0,0,1,1
26029,persona​,0,0,1,1
26031,الطبيعية,0,0,1,1
26034,tarefas,0,0,1,1
26035,pedanteri,0,0,1,1
26036,concluye,0,0,1,1
26037,manglende,0,0,1,1
26039,பிரமாதத்திற்கு,0,0,1,1
26041,obviedad,0,0,1,1
26024,ഉറപ്പുവരുത്തുവാൻ,0,0,1,1
26042,gong,0,0,1,1
26043,scenes,0,0,1,1
26044,ആവേശകരവും,0,0,1,1
26045,removed,0,0,1,1
26046,cometer,0,0,1,1
26047,funny,0,0,1,1
26049,seite,0,0,1,1
26028,sequência,0,0,1,1
26021,обращается,0,0,1,1
25999,universele,0,0,1,1
26010,ಬಂದನು.,0,0,1,1
26000,engelsktalende,0,0,1,1
26002,suspendre,0,0,1,1
26004,afstemninger.,0,0,1,1
26005,zorlandı,0,0,1,1
26006,ಫಿಕ್ಸ್‌ನಲ್ಲಿದೆ,0,0,1,1
26008,وعليك,0,0,1,1
26009,ವಹಿಸುತ್ತೇನೆ,0,0,1,1
26011,подавляющее,0,0,1,1
26020,creates,0,0,1,1
26012,വായനക്കാരുടേയും,0,0,1,1
26014,journalisme,0,0,1,1
26015,detectados,0,0,1,1
26016,dekken,0,0,1,1
26017,muero,0,0,1,1
26018,palats,0,0,1,1
26019,kısık,0,0,1,1
26166,ருசிக்கும்,0,0,1,1
26167,போர்டல்,0,0,1,1
26168,πηδήσω,0,0,1,1
26334,« naturelle »,0,0,1,1
26322,इन्सटाल,0,0,1,1
26323,organizadas,0,0,1,1
26324,बान्युमासन,0,0,1,1
26327,متاحة,0,0,1,1
26328,एडिटर-इन-चीफ,0,0,1,1
26329,bölgeden,0,0,1,1
26330,formais,0,0,1,1
26335,filtro,0,0,1,1
26320,δελχί,0,0,1,1
26336,राष्ट्रीय,0,0,1,1
26337,arrojó,0,0,1,1
26338,regresión.,0,0,1,1
26340,ಹೋಗುವುದಿಲ್ಲ,0,0,1,1
26341,runs,0,0,1,1
26343,തോന്നാത്ത,0,0,1,1
26344,majoritaire.,0,0,1,1
26321,текста,0,0,1,1
26318,ಅವರನ್ನು,0,0,1,1
26346,ಉತ್ತಮಗೊಳಿಸುವುದು.,0,0,1,1
26301,വലിച്ചിടുക,0,0,1,1
26289,privée,0,0,1,1
26291,traag.,0,0,1,1
26293,ಪ್ರಯತ್ನಕ್ಕೆ,0,0,1,1
26296,चीयर्स,0,0,1,1
26297,بعنوان,0,0,1,1
26299,स्वाहा,0,0,1,1
26300,ರೀತಿಯದ್ದಾಗಿದೆ,0,0,1,1
26303,plucker.,0,0,1,1
26316,ligt,0,0,1,1
26304,h,0,0,1,1
26306,strike-slip,0,0,1,1
26307,analyseras,0,0,1,1
26309,testigos,0,0,1,1
26310,compete,0,0,1,1
26314,discuta,0,0,1,1
26315,muertas,0,0,1,1
26345,point-of-sale,0,0,1,1
26347,ज़ाज़ाकी,0,0,1,1
26287,tust.,0,0,1,1
26386,interessant,0,0,1,1
26378,تتعلم,0,0,1,1
26379,تفعله,0,0,1,1
26380,பொறி,0,0,1,1
26381,though.,0,0,1,1
26382,utilisateur,0,0,1,1
26383,sesin,0,0,1,1
26385,σταθερά,0,0,1,1
26388,dillerde,0,0,1,1
26375,interesseret.,0,0,1,1
26389,gefällt,0,0,1,1
26390,l'orthographe,0,0,1,1
26391,cometidos,0,0,1,1
26393,händelser,0,0,1,1
26394,plötzlich,0,0,1,1
26398,echte,0,0,1,1
26399,clasificarse,0,0,1,1
26376,klänningarna,0,0,1,1
26374,l’invention,0,0,1,1
26349,hazırlandığını,0,0,1,1
26358,vandalisme',0,0,1,1
26350,drunkna,0,0,1,1
26351,freund.,0,0,1,1
26352,narcisse'in,0,0,1,1
26353,fingrarna,0,0,1,1
26354,برنامجه،,0,0,1,1
26355,παλιό,0,0,1,1
26357,ಟವು,0,0,1,1
26362,aspects,0,0,1,1
26373,ശരിയാക്കി,0,0,1,1
26364,المتزايد,0,0,1,1
26365,versuchen,0,0,1,1
26367,தகவல்களை,0,0,1,1
26368,oiseaux.,0,0,1,1
26369,ಪ್ರಶ್ನೆಗೆ,0,0,1,1
26370,aktivera,0,0,1,1
26372,omission,0,0,1,1
26288,kartofler,0,0,1,1
26286,atmospherewithin,0,0,1,1
26171,തന്നെയില്ല.,0,0,1,1
26209,रफ्तार,0,0,1,1
26196,झुलस,0,0,1,1
26198,sınıfın,0,0,1,1
26200,العقل,0,0,1,1
26203,низкокачественной,0,0,1,1
26206,britisk,0,0,1,1
26207,indígenas.,0,0,1,1
26208,språklänkar,0,0,1,1
26214,countless,0,0,1,1
26193,volop,0,0,1,1
26215,çeyrekte,0,0,1,1
26216,ಸಿಕ್ಕಿದ್ದೇನೆ,0,0,1,1
26218,നല്കുന്നതുമായ,0,0,1,1
26219,मेलिस्सा,0,0,1,1
26222,ytterligare,0,0,1,1
26225,ഭ്രാന്താണ്.,0,0,1,1
26226,valioso,0,0,1,1
26195,ಭಾಗವು,0,0,1,1
26192,википедияинклюзионизм.,0,0,1,1
26230,നിർമാതാവും,0,0,1,1
26179,roten,0,0,1,1
26172,boşum,0,0,1,1
26173,avais,0,0,1,1
26174,görebildiğim,0,0,1,1
26175,permitió,0,0,1,1
26176,gebrauch,0,0,1,1
26177,атрибутированием,0,0,1,1
26178,αναφέρει,0,0,1,1
26180,கொண்டிருந்தீர்கள்.,0,0,1,1
26191,enslashdot,0,0,1,1
26181,rendezvous-smart-wort,0,0,1,1
26184,polaco.,0,0,1,1
26185,avance,0,0,1,1
26187,കടം,0,0,1,1
26188,friend.,0,0,1,1
26189,അംഗീകരിക്കാൻ,0,0,1,1
26190,хабрахабр.,0,0,1,1
26227,கட்டமைப்பு”க்கு,0,0,1,1
26232,sérieuse.,0,0,1,1
26285,generalizations,0,0,1,1
26274,gelse,0,0,1,1
26267,तय,0,0,1,1
26268,önümüzdeki,0,0,1,1
26269,விளைவிக்கும்,0,0,1,1
26270,achar,0,0,1,1
26271,probieren,0,0,1,1
26272,использовано,0,0,1,1
26273,heiraten.,0,0,1,1
26275,।,0,0,1,1
26264,വാക്യ,0,0,1,1
26277,recuperó,0,0,1,1
26278,suspicions,0,0,1,1
26279,παραπονεθεί,0,0,1,1
26280,sons....,0,0,1,1
26282,ಪುರುಷರನ್ನು,0,0,1,1
26283,wurzelwörter,0,0,1,1
26284,wonderful,0,0,1,1
26265,schmieden.,0,0,1,1
26263,utgår,0,0,1,1
26233,மனம்,0,0,1,1
26251,tiers,0,0,1,1
26234,wikipedia-artiklar,0,0,1,1
26242,lasst,0,0,1,1
26243,भाषी,0,0,1,1
26245,surprises,0,0,1,1
26246,взглянуть,0,0,1,1
26247,θαυμαστικές,0,0,1,1
26249,interesaron,0,0,1,1
26252,kräver.,0,0,1,1
26261,drawings,0,0,1,1
26254,acceptée,0,0,1,1
26255,sunulmasındaki,0,0,1,1
26256,لله,0,0,1,1
26257,குறைவாகவும்,0,0,1,1
26258,battleground,0,0,1,1
26259,skrivstuga.,0,0,1,1
26260,زرع,0,0,1,1
26896,अर्स,0,0,1,1
26900,обама,0,0,1,1
25940,به.,0,0,1,1
27382,описываются,0,0,1,1
27529,surgiu,0,0,1,1
27531,hydrogen,0,0,1,1
27532,parenthèses,0,0,1,1
27533,terme.,0,0,1,1
27534,напиток,0,0,1,1
27536,yemekte,0,0,1,1
27537,referente,0,0,1,1
27538,prinz,0,0,1,1
27546,foods,0,0,1,1
27547,स्कॉलरपीडिया,0,0,1,1
27549,interesantes,0,0,1,1
27552,podían,0,0,1,1
27553,உதவிக்குறிப்பை,0,0,1,1
27554,يصنع,0,0,1,1
27557,testées,0,0,1,1
27559,verificación​,0,0,1,1
27560,vaguely,0,0,1,1
27528,umursayamam,0,0,1,1
27521,läsarens,0,0,1,1
27520,tayyip,0,0,1,1
27503,convirtiéndose,0,0,1,1
27495,ಇಷ್ಟಪಟ್ಟಿದ್ದೀರಿ,0,0,1,1
27496,thème ,0,0,1,1
27497,ولكنه,0,0,1,1
27498,أهلاً,0,0,1,1
27499,वियतनामी,0,0,1,1
27500,piecewise,0,0,1,1
27501,संकेत,0,0,1,1
27504,fondent,0,0,1,1
27518,appointment,0,0,1,1
27505,kollaborativa,0,0,1,1
27507,столлмана.,0,0,1,1
27508,früheres,0,0,1,1
27512,arıyorsun,0,0,1,1
27513,realizando,0,0,1,1
27514,lieblich,0,0,1,1
27517,paradigme,0,0,1,1
27561,maximum,0,0,1,1
27562,круто.,0,0,1,1
27563,बोस्नियाई,0,0,1,1
27618,распределённую,0,0,1,1
27604,أيضا،,0,0,1,1
27605,कराते,0,0,1,1
27606,мгновенно,0,0,1,1
27607,estúpido,0,0,1,1
27608,medicine's,0,0,1,1
27616,मिशन,0,0,1,1
27617,l'univers »,0,0,1,1
27619,людям.,0,0,1,1
27601,सम्मेलनों,0,0,1,1
27622,அவதூறான,0,0,1,1
27624,मनोरंजक,0,0,1,1
27625,typographic,0,0,1,1
27626,hot,0,0,1,1
27627,போலவும்,0,0,1,1
27628,побудило,0,0,1,1
27631,как.,0,0,1,1
27603,altan,0,0,1,1
27600,കാര്യ,0,0,1,1
27564,befinden,0,0,1,1
27576,simgesine,0,0,1,1
27565,eis,0,0,1,1
27566,spetsig,0,0,1,1
27567,reprendre,0,0,1,1
27570,गोर्मनने,0,0,1,1
27571,principle[note,0,0,1,1
27572,tiver,0,0,1,1
27575,demás,0,0,1,1
27577,pequeno,0,0,1,1
27599,нарцису,0,0,1,1
27579,desmentida,0,0,1,1
27581,sujeta,0,0,1,1
27583,maddenin,0,0,1,1
27586,bijdragen,0,0,1,1
27589,llega,0,0,1,1
27592,entropy,0,0,1,1
27594,meestal,0,0,1,1
27494,save,0,0,1,1
27493,കഴിക്കുന്നു.,0,0,1,1
27492,acompanhar,0,0,1,1
27416,främjas,0,0,1,1
27407,minorités.,0,0,1,1
27408,bifurcaciones,0,0,1,1
27409,encorajar,0,0,1,1
27410,لصدفة,0,0,1,1
27411,kopf.,0,0,1,1
27413,trials,0,0,1,1
27415,l'article[r].,0,0,1,1
27417,ಮೃದುವಾದ,0,0,1,1
27405,അപ്പ്,0,0,1,1
27418,प्रसारित,0,0,1,1
27420,reage,0,0,1,1
27421,years.,0,0,1,1
27422,provocerande,0,0,1,1
27423,англоязычной,0,0,1,1
27424,verdelen,0,0,1,1
27428,preference,0,0,1,1
27406,роли,0,0,1,1
27404,taha,0,0,1,1
27430,suspect.,0,0,1,1
27392,πίτσα,0,0,1,1
27384,labyrinthine,0,0,1,1
27385,കുഴപ്പത്തിലാണ്,0,0,1,1
27386,سنة,0,0,1,1
27387,широко,0,0,1,1
27388,chiffrer,0,0,1,1
27389,kaynakları,0,0,1,1
27390,ശാന്തമാക്കുക.,0,0,1,1
27394,vinkade,0,0,1,1
27402,yaptıysanız,0,0,1,1
27395,leraar,0,0,1,1
27396,έκδοσή,0,0,1,1
27397,profondes ».,0,0,1,1
27398,للوصول,0,0,1,1
27399,ಚಿಹ್ನೆಯೊಂದಿಗೆ,0,0,1,1
27400,സുന്ദരിയാണെന്ന്,0,0,1,1
27401,toparla,0,0,1,1
27429,شخصًا.,0,0,1,1
27431,സംസാരിക്കുന്ന,0,0,1,1
27491,qu'avoir,0,0,1,1
27476,brisés.,0,0,1,1
27466,നൽകുകയും,0,0,1,1
27469,المنسقة,0,0,1,1
27470,lagra,0,0,1,1
27472,ಉದಾಹರಣೆಯಲ್ಲಿ,0,0,1,1
27473,ತಮಾಷೆಯ,0,0,1,1
27474,ತನ್ನದೇ,0,0,1,1
27475,മെല്ലെയായിരുന്നു.,0,0,1,1
27477,uitgebreider,0,0,1,1
27462,documentada,0,0,1,1
27479,ജോലികൾക്കു,0,0,1,1
27481,«седьмой,0,0,1,1
27483,നാട്ടറിവുകൾ,0,0,1,1
27485,تعافى,0,0,1,1
27488,flórida.,0,0,1,1
27489,நடவடிக்கையின்,0,0,1,1
27490,الماضي.,0,0,1,1
27465,bulamadığın,0,0,1,1
27461,englischen,0,0,1,1
27432,।flummoxed,0,0,1,1
27448,jv •,0,0,1,1
27433,icône,0,0,1,1
27434,giyinmiş,0,0,1,1
27438,ಆಸಕ್ತಿ,0,0,1,1
27441,نشاطاً،,0,0,1,1
27443,tratamento,0,0,1,1
27445,operan,0,0,1,1
27447,garaj,0,0,1,1
27449,mujer.,0,0,1,1
27459,gestopt,0,0,1,1
27450,المبادئ,0,0,1,1
27451,além.,0,0,1,1
27452,സഹായിക്കൂ,0,0,1,1
27453,películas,0,0,1,1
27454,subtropicale[réf.,0,0,1,1
27456,ergebnis,0,0,1,1
27457,overzichtsartikelen,0,0,1,1
27633,engelskspråkigt,0,0,1,1
27634,olağan.,0,0,1,1
27635,feces,0,0,1,1
27797,définit,0,0,1,1
27787,farine,0,0,1,1
27790,filtrera,0,0,1,1
27791,தெரிவித்தது.,0,0,1,1
27792,nueva,0,0,1,1
27793,बालकनी,0,0,1,1
27794,s’avérer,0,0,1,1
27796,формул,0,0,1,1
27799,blokere,0,0,1,1
27783,चीज़,0,0,1,1
27800,escritor,0,0,1,1
27801,ഉണ്ടാകും.,0,0,1,1
27807,beğen,0,0,1,1
27808,trouvant,0,0,1,1
27809,உங்களுக்குச்,0,0,1,1
27810,ഇഷ്ടപ്പെടുന്നു,0,0,1,1
27813,منفرج.,0,0,1,1
27785,прекрасно,0,0,1,1
27781,découverte.,0,0,1,1
27815,implementation,0,0,1,1
27769,collagen,0,0,1,1
27759,ആക്യുറസി,0,0,1,1
27761,ഭാഗമാണ്.,0,0,1,1
27762,yok,0,0,1,1
27763,τρόποι,0,0,1,1
27766,zümrüt,0,0,1,1
27767,ieee-,0,0,1,1
27768,d'appel,0,0,1,1
27770,concluait,0,0,1,1
27780,किर्घिज़,0,0,1,1
27771,വ്യാകരണം,0,0,1,1
27772,messager,0,0,1,1
27774,møde.,0,0,1,1
27775,insats.,0,0,1,1
27777,angry.,0,0,1,1
27778,galardones,0,0,1,1
27779,ಕ್ಯಾಸಲ್,0,0,1,1
27814,estuve,0,0,1,1
27816,zoophilia,0,0,1,1
27757,ಶುಕ್ರವಾರ,0,0,1,1
27863,раз.,0,0,1,1
27852,мужчине,0,0,1,1
27853,കണ്ടിട്ടുള്ളതിൽ,0,0,1,1
27856,चेतावनी,0,0,1,1
27857,nutzlos,0,0,1,1
27860,mensuelles,0,0,1,1
27861,devrions-nous,0,0,1,1
27862,καλές,0,0,1,1
27866,ആവശ്യമാണ്].,0,0,1,1
27849,reír,0,0,1,1
27867,« victimes ».,0,0,1,1
27868,боролась,0,0,1,1
27869,t.ex.,0,0,1,1
27870,पुरुषों,0,0,1,1
27871,ನಿದ್ರೆಯಲ್ಲಿ,0,0,1,1
27873,compreensiva,0,0,1,1
27874,varav,0,0,1,1
27850,«рандеву»,0,0,1,1
27848,алгоритмы,0,0,1,1
27818,शूट,0,0,1,1
27828,d'allégories.,0,0,1,1
27819,процесса.,0,0,1,1
27820,terre.,0,0,1,1
27821,cream,0,0,1,1
27822,διαμάντια,0,0,1,1
27823,ದೌರ್ಜನ್ಯದ,0,0,1,1
27825,rules.,0,0,1,1
27827,başbakanı,0,0,1,1
27829,masturbação,0,0,1,1
27847,سمعته,0,0,1,1
27830,указывают,0,0,1,1
27833,тяжелый,0,0,1,1
27834,سأغادر,0,0,1,1
27835,ಅಲ್ಲ,0,0,1,1
27839,realizó,0,0,1,1
27842,he-man.,0,0,1,1
27846,mp'ün,0,0,1,1
27758,reemplazada,0,0,1,1
27756,antworten,0,0,1,1
27636,equivocadas,0,0,1,1
27672,sorundan,0,0,1,1
27665,viam,0,0,1,1
27666,выходящие,0,0,1,1
27667,الفيضان,0,0,1,1
27668,sodass,0,0,1,1
27669,fart,0,0,1,1
27670,verenigd,0,0,1,1
27671,nicer,0,0,1,1
27674,européens.,0,0,1,1
27663,نشرها.,0,0,1,1
27676,wildlife.,0,0,1,1
27677,सात,0,0,1,1
27680,settle,0,0,1,1
27685,recherches,0,0,1,1
27686,étiquetées,0,0,1,1
27687,getrouwd.,0,0,1,1
27688,يخضع,0,0,1,1
27664,inconsistência,0,0,1,1
27662,​​அவர்,0,0,1,1
27690,оценка,0,0,1,1
27648,judiciaire…,0,0,1,1
27637,electric,0,0,1,1
27638,tercera,0,0,1,1
27641,segredo,0,0,1,1
27642,riesgos,0,0,1,1
27644,uzatır,0,0,1,1
27646,milhão.,0,0,1,1
27647,للحواسيب,0,0,1,1
27650,formu,0,0,1,1
27661,पड़ा,0,0,1,1
27651,sorabileceğin,0,0,1,1
27652,haydi.,0,0,1,1
27654,configuration,0,0,1,1
27655,облажался.,0,0,1,1
27656,emnet,0,0,1,1
27657,kitaplarda,0,0,1,1
27659,verification.,0,0,1,1
27689,esfuerzo.,0,0,1,1
27692,türban,0,0,1,1
27752,röportajda,0,0,1,1
27741,spijker,0,0,1,1
27732,desconcertar,0,0,1,1
27735,çabası,0,0,1,1
27736,concluyó,0,0,1,1
27737,информацию.,0,0,1,1
27738,تنتشر,0,0,1,1
27739,trubbiga,0,0,1,1
27740,sattığını,0,0,1,1
27742,சந்தித்ததில்,0,0,1,1
27726,be-tarask •,0,0,1,1
27743,maastricht,0,0,1,1
27745,veelvoorkomend,0,0,1,1
27747,fastnar,0,0,1,1
27748,kaydı,0,0,1,1
27749,περισσότερο.,0,0,1,1
27750,встречаетесь,0,0,1,1
27751,ήμασταν.,0,0,1,1
27731,estadísticas.,0,0,1,1
27725,ചുവന്ന,0,0,1,1
27694,vergessen,0,0,1,1
27709,unuturlar,0,0,1,1
27695,لكى,0,0,1,1
27696,indesejável.,0,0,1,1
27698,проверить,0,0,1,1
27699,kant,0,0,1,1
27701,involving,0,0,1,1
27702,സ്ഥലത്തെ,0,0,1,1
27707,കണ്ടെത്തും,0,0,1,1
27712,ಕಾಣುತ್ತಿದ್ದರು,0,0,1,1
27724,तीनों,0,0,1,1
27713,கூறுகிறது.,0,0,1,1
27714,இருங்கள்,0,0,1,1
27717,biology.,0,0,1,1
27718,divertido,0,0,1,1
27719,borrado,0,0,1,1
27722,miré,0,0,1,1
27723,произведённых,0,0,1,1
27383,ಕೋನವಾಗಿದೆ.,0,0,1,1
27380,ഓ.,0,0,1,1
26902,കിടക്കുകയാണ്.,0,0,1,1
27379,ky •,0,0,1,1
27043,products,0,0,1,1
27048,localizado,0,0,1,1
27049,trouvé,0,0,1,1
27050,udsigt,0,0,1,1
27052,exploitent,0,0,1,1
27053,ആവേശത്തിലാണ്.,0,0,1,1
27054,φόβος,0,0,1,1
27056,разрешающими,0,0,1,1
27057,asırlardır,0,0,1,1
27059,старых,0,0,1,1
27061,tackling,0,0,1,1
27063,உறுதிப்படுத்தப்படாத,0,0,1,1
27064,bagunçado,0,0,1,1
27065,velocidad.,0,0,1,1
27067,olhando,0,0,1,1
27071,എടുക്കുന്നു,0,0,1,1
27072,pleures,0,0,1,1
27041,إتش,0,0,1,1
27040,integrated,0,0,1,1
27039,கணிப்பிடும்,0,0,1,1
27022,supernatural.,0,0,1,1
27014,مجلدًا,0,0,1,1
27015,अस्थिर,0,0,1,1
27016,நினைத்திருந்தது.,0,0,1,1
27017,أخفيه,0,0,1,1
27018,இருந்தனர்,0,0,1,1
27019,माफी,0,0,1,1
27020,вежливо,0,0,1,1
27023,rewards,0,0,1,1
27038,gülümsemesini,0,0,1,1
27024,press,0,0,1,1
27025,يعانون,0,0,1,1
27026,اختصاص،,0,0,1,1
27029,feliciteren,0,0,1,1
27031,धारणा,0,0,1,1
27032,πάρτι,0,0,1,1
27035,качаешься,0,0,1,1
27074,específica,0,0,1,1
27076,decentralizes,0,0,1,1
27077,queixa,0,0,1,1
27119,språkversionen,0,0,1,1
27110,நபருக்கு,0,0,1,1
27111,dedikerede,0,0,1,1
27112,τρομερή,0,0,1,1
27113,பயனரின்,0,0,1,1
27116,وفَر,0,0,1,1
27117,مشكلة.,0,0,1,1
27118,അടിക്കുന്നു.,0,0,1,1
27120,madrid.,0,0,1,1
27107,முன்னதான,0,0,1,1
27124,avoided,0,0,1,1
27126,राजस्व,0,0,1,1
27127,क्रियाओं,0,0,1,1
27128,classificatie,0,0,1,1
27129,remplazada,0,0,1,1
27130,मीठी,0,0,1,1
27133,cultiver,0,0,1,1
27108,ಸುದ್ದಿ,0,0,1,1
27106,सातवीं,0,0,1,1
27078,അൽഗോരിതം,0,0,1,1
27091,ಅಂತಹ,0,0,1,1
27079,afternoon,0,0,1,1
27080,സുന്ദരനാണെന്ന്,0,0,1,1
27082,تشكر,0,0,1,1
27084,संवेदनशीलता,0,0,1,1
27086,forskares,0,0,1,1
27089,gütmeyen,0,0,1,1
27090,خطأي.,0,0,1,1
27092,  voitures,0,0,1,1
27105,permanence.,0,0,1,1
27093,совершённое,0,0,1,1
27096,instruções,0,0,1,1
27099,счастливым,0,0,1,1
27100,rommelig,0,0,1,1
27102,администраторов,0,0,1,1
27103,поддельному,0,0,1,1
27104,दिवेही,0,0,1,1
27013,vred.,0,0,1,1
27011,القاسي,0,0,1,1
27010,opposing,0,0,1,1
26939,രുചിയുടെ,0,0,1,1
26932,nedenfor,0,0,1,1
26933,liknande-knappen,0,0,1,1
26934,الحلم.,0,0,1,1
26935,jaren,0,0,1,1
26936,mcculloch,0,0,1,1
26937,oprit.,0,0,1,1
26938,iluminação,0,0,1,1
26940,initiatieven,0,0,1,1
26930,തർക്ക,0,0,1,1
26941,cheaper,0,0,1,1
26942,regardez,0,0,1,1
26943,متحمسون,0,0,1,1
26944,isteyebilirim,0,0,1,1
26945,sparkly,0,0,1,1
26947,classificação,0,0,1,1
26950,akilleshäl.,0,0,1,1
26931,l’accent,0,0,1,1
26928,decade,0,0,1,1
26954,tollen,0,0,1,1
26912,संयुक्त,0,0,1,1
26904,വിടപറഞ്ഞു,0,0,1,1
26905,opt-in,0,0,1,1
26906,sammanhållande,0,0,1,1
26908,appreciation,0,0,1,1
26909,വെള്ളിയാഴ്ചയാണെന്ന്,0,0,1,1
26910,licenciado,0,0,1,1
26911,காரியத்தைச்,0,0,1,1
26913,nasıl',0,0,1,1
26926,blanket,0,0,1,1
26914,traits.,0,0,1,1
26916,विज्ञापनदाता,0,0,1,1
26917,പുറമേ,0,0,1,1
26919,упоминай,0,0,1,1
26922,ajude,0,0,1,1
26923,الدروس,0,0,1,1
26924,सुविचारित,0,0,1,1
26953,ಸೈನ್ಯವು,0,0,1,1
26956,വിശദീകരിക്കുന്ന,0,0,1,1
27006,ഓർക്കുക,0,0,1,1
26992,ചേർക്കാനാണ്,0,0,1,1
26982,المقالات.,0,0,1,1
26984,onthouden.,0,0,1,1
26985,utgivare,0,0,1,1
26986,snapte,0,0,1,1
26987,रचना,0,0,1,1
26990,obviamente,0,0,1,1
26991,öğreniyorsan,0,0,1,1
26993,importância,0,0,1,1
26979,forskningsciteringar,0,0,1,1
26994,चाइना,0,0,1,1
26996,வழமையாக,0,0,1,1
26997,estompée,0,0,1,1
26998,ലഭ്യമായാൽ,0,0,1,1
27001,deserved.,0,0,1,1
27002,adivinara,0,0,1,1
27004,attribuent,0,0,1,1
26980,зайдите,0,0,1,1
26978,sevmesiydi,0,0,1,1
26958,विवरण,0,0,1,1
26967,abertos,0,0,1,1
26959,தந்திரமான,0,0,1,1
26961,existían,0,0,1,1
26962,απαραίτητοι,0,0,1,1
26963,ಕೇಳುತ್ತೇನೆ,0,0,1,1
26964,qu’on,0,0,1,1
26965,संज्ञाओं,0,0,1,1
26966,நகைச்சுவையைச்,0,0,1,1
26968,internetanvändare,0,0,1,1
26977,занимала,0,0,1,1
26969,ليلة,0,0,1,1
26971,inscrit,0,0,1,1
26972,σκεφτώ,0,0,1,1
26973,لعبتك,0,0,1,1
26974,nuit-là,0,0,1,1
26975,аннотируя,0,0,1,1
26976,கூட்டாக்க,0,0,1,1
27134,ονειρεμένη,0,0,1,1
27135,innehållsdrivet,0,0,1,1
27136,ಪ್ರತಿಕ್ರಿಯಿಸಲು,0,0,1,1
27300,pertinente,0,0,1,1
27291,உணர,0,0,1,1
27292,metadados,0,0,1,1
27293,புதிதாக,0,0,1,1
27294,давай.,0,0,1,1
27295,benedicto,0,0,1,1
27296,suggesties.,0,0,1,1
27298,indicators,0,0,1,1
27301,escribir.,0,0,1,1
27288,satirique,0,0,1,1
27303,anns,0,0,1,1
27304,avond.,0,0,1,1
27305,സൂക്ഷിച്ച്,0,0,1,1
27306,ಶೀತವಾಗಿದೆ,0,0,1,1
27307,filosofen,0,0,1,1
27309,stakes.,0,0,1,1
27312,ಹೇಳುತ್ತೇನೆ.,0,0,1,1
27290,നല്ലതാണെന്ന,0,0,1,1
27286,ga •,0,0,1,1
27314,cogito,0,0,1,1
27272,ಕುದುರೆಯಂತಹ,0,0,1,1
27262,juiste,0,0,1,1
27263,jedoch,0,0,1,1
27264,«unos,0,0,1,1
27266,fornece,0,0,1,1
27267,ongelooflijk,0,0,1,1
27268,distribuable,0,0,1,1
27270,jongens.,0,0,1,1
27273,impedir,0,0,1,1
27285,primária,0,0,1,1
27274,enfant,0,0,1,1
27275,strickland,0,0,1,1
27276,наличию,0,0,1,1
27278,சொந்தமான,0,0,1,1
27279,glittrande,0,0,1,1
27280,требованиям,0,0,1,1
27283,ubiquiste,0,0,1,1
27313,aynada,0,0,1,1
27315,convenir,0,0,1,1
27260,glaciers.,0,0,1,1
27359,vivaient,0,0,1,1
27350,wikitekniken,0,0,1,1
27351,ಆಹಾರದ,0,0,1,1
27352,ആകുവാൻ,0,0,1,1
27353,breed,0,0,1,1
27354,especializadas,0,0,1,1
27355,troisième,0,0,1,1
27356,connotations.,0,0,1,1
27361,принесу,0,0,1,1
27347,βεβαιωθείτε,0,0,1,1
27362,gutaussehender,0,0,1,1
27363,opdoen,0,0,1,1
27369,κορυφαίες,0,0,1,1
27371,éducatif,0,0,1,1
27372,πέρα,0,0,1,1
27374,करायेगा।,0,0,1,1
27377,ദേഷ്യപ്പെടുന്നു,0,0,1,1
27348,ужасными,0,0,1,1
27346,internacionales,0,0,1,1
27318,нее.,0,0,1,1
27328,русская ,0,0,1,1
27319,εισαι,0,0,1,1
27320,fakir.,0,0,1,1
27321,{onionspotatoes}⇒{burger}{\displaystyle,0,0,1,1
27322,முக்கியமான,0,0,1,1
27323,fniser,0,0,1,1
27325,beats,0,0,1,1
27326,متقاطعة,0,0,1,1
27331,confondre,0,0,1,1
27345,ലിപികളും,0,0,1,1
27332,الجماعي،,0,0,1,1
27333,розенцвейг,0,0,1,1
27334,destansı,0,0,1,1
27336,artiklen,0,0,1,1
27338,ಉದಾಹರಣೆಯೆಂದರೆ,0,0,1,1
27339,ويدعو,0,0,1,1
27340,sohbette,0,0,1,1
27261,l'habituel.,0,0,1,1
27259,immune,0,0,1,1
27137,биологических,0,0,1,1
27181,மீறல்,0,0,1,1
27169,произошло,0,0,1,1
27170,hardly,0,0,1,1
27174,ಮುಳುಗಿಸುವುದು,0,0,1,1
27177,ತಪ್ಪಾದ,0,0,1,1
27178,diretivo,0,0,1,1
27179,ayudar.,0,0,1,1
27180,என்பதில்,0,0,1,1
27182,पहुँचने,0,0,1,1
27163,പരിഹാരത്തിനുപകരം,0,0,1,1
27183,नाराज,0,0,1,1
27185,procure,0,0,1,1
27187,രണ്ടോ,0,0,1,1
27188,इट,0,0,1,1
27190,ilustrador,0,0,1,1
27191,grusomme,0,0,1,1
27192,لدراسة,0,0,1,1
27165,दिशानिर्देश,0,0,1,1
27162,ಕಾರ್ಯನಿರ್ವಹಿಸದಿದ್ದರೆ,0,0,1,1
27196,gehirn,0,0,1,1
27150,sloot,0,0,1,1
27138,supervisé,0,0,1,1
27141,போகிறதென்றால்,0,0,1,1
27142,பதிப்பில்,0,0,1,1
27144,autocensuró,0,0,1,1
27145,വേർതിരിക്കുന്നത്,0,0,1,1
27147,дня,0,0,1,1
27148,término.,0,0,1,1
27151,crosses,0,0,1,1
27161,aufnehmen,0,0,1,1
27152,തർക്കം.,0,0,1,1
27153,сборы,0,0,1,1
27154,computertijdschrift,0,0,1,1
27156,വിതരണം,0,0,1,1
27157,tritt,0,0,1,1
27158,applikationer,0,0,1,1
27159,ocurriendo,0,0,1,1
27195,νερό,0,0,1,1
27197,amateur-astronoom,0,0,1,1
27258,bénéfice,0,0,1,1
27244,ಹಲೋ,0,0,1,1
27236,mujer,0,0,1,1
27237,suddas,0,0,1,1
27238,അസ്വസ്ഥനാകരുതെന്ന്,0,0,1,1
27239,தொடங்கியது.,0,0,1,1
27240,graphes,0,0,1,1
27241,δουλεύετε,0,0,1,1
27243,സാമ്യതയുള്ളവയെ,0,0,1,1
27246,തെളിവുകളുണ്ടാകണം.,0,0,1,1
27234,kelimeyle,0,0,1,1
27247,முனைப்பான,0,0,1,1
27248,bekräftar,0,0,1,1
27250,geestdriftige,0,0,1,1
27251,இம்முறைமையின்,0,0,1,1
27254,e-post,0,0,1,1
27255,ಮಾಹಿತಿಗಾಗಿ,0,0,1,1
27257,பீட்சா,0,0,1,1
27235,telefonunu,0,0,1,1
27231,والمصرية,0,0,1,1
27199,ven.,0,0,1,1
27212,yaparsın.,0,0,1,1
27201,tido,0,0,1,1
27202,kazanmış,0,0,1,1
27203,എല്ലിക്കും,0,0,1,1
27204,compleet,0,0,1,1
27205,reads,0,0,1,1
27210,écrite,0,0,1,1
27211,redan.,0,0,1,1
27215,recommenceras,0,0,1,1
27230,detta[förtydliga],0,0,1,1
27219,الادعاء.,0,0,1,1
27220,ಸುಂದರವಾಗಿದ್ದಾಳೆಂದು,0,0,1,1
27221,रीस्टोर,0,0,1,1
27222,محتواها.,0,0,1,1
27223,reparler,0,0,1,1
27227,അഭിനന്ദനങ്ങൾ,0,0,1,1
27229,excited,0,0,1,1
25941,അറിയില്ലെന്ന്,0,0,1,1
25939,dominerande,0,0,1,1
27877,никогда,0,0,1,1
24524,webbliknande,0,0,1,1
24666,ദുഷ്പ്രവൃത്തി,0,0,1,1
24667,obtienes.,0,0,1,1
24668,الحالات,0,0,1,1
24669,எப்போதுமே,0,0,1,1
24671,пожелать,0,0,1,1
24673,acercó,0,0,1,1
24674,внезапно,0,0,1,1
24675,दोहराएंगे,0,0,1,1
24677,ಮರೆಯಬೇಡಿ,0,0,1,1
24679,чей,0,0,1,1
24681,cooperation.,0,0,1,1
24682,вышедших,0,0,1,1
24683,da.wikipedia.org,0,0,1,1
24684,kurier,0,0,1,1
24685,മറ്റേയാൾ,0,0,1,1
24686,уровне,0,0,1,1
24687,sauriez-vous,0,0,1,1
24664,обед,0,0,1,1
24663,married,0,0,1,1
24662,எழுத்துப்பிழைகளைத்,0,0,1,1
24648,معطل.,0,0,1,1
24638,ماي,0,0,1,1
24640,plaignants,0,0,1,1
24641,துல்லியமின்மை,0,0,1,1
24642,kaum,0,0,1,1
24644,φόρμας,0,0,1,1
24646,pannotia,0,0,1,1
24647,παίρνετε,0,0,1,1
24649,ಮಾಡಬೇಕಾಗಿದೆ,0,0,1,1
24660,bio-informatique,0,0,1,1
24650,resource-consuming,0,0,1,1
24651,кнопка.,0,0,1,1
24652,നിന്നുള്ള,0,0,1,1
24653,petición,0,0,1,1
24655,karaktäriseras,0,0,1,1
24656,ориентирован,0,0,1,1
24658,எனக்,0,0,1,1
24688,barack.,0,0,1,1
24689,assimilable,0,0,1,1
24690,déisme ,0,0,1,1
24728,скорости,0,0,1,1
24719,guise.,0,0,1,1
24721,obtaining,0,0,1,1
24722,vikipedistler,0,0,1,1
24723,интересуют,0,0,1,1
24725,historiques,0,0,1,1
24726,المشارك,0,0,1,1
24727,eletrônico.,0,0,1,1
24729,cümleler,0,0,1,1
24716,ചോദ്യങ്ങൾക്ക്,0,0,1,1
24730,номинациях,0,0,1,1
24731,jardin,0,0,1,1
24735,s'était,0,0,1,1
24736,обработка,0,0,1,1
24737,aurait,0,0,1,1
24738,शब्दजाल,0,0,1,1
24739,पठन,0,0,1,1
24717,fejler,0,0,1,1
24715,വന്നിട്ടുണ്ടെന്നും,0,0,1,1
24693,respond,0,0,1,1
24702,ತೋಟದಲ್ಲಿ,0,0,1,1
24694,kullandığında,0,0,1,1
24696,suavizando,0,0,1,1
24697,explanation,0,0,1,1
24698,provet.,0,0,1,1
24699,പരിശോധിച്ച,0,0,1,1
24700,disminuyendo,0,0,1,1
24701,tappar,0,0,1,1
24703,nilsson's,0,0,1,1
24714,النسبة,0,0,1,1
24704,rigorous.,0,0,1,1
24705,модифицировано,0,0,1,1
24706,матерью,0,0,1,1
24707,zaken,0,0,1,1
24708,terry'ye,0,0,1,1
24709,incompetentes.,0,0,1,1
24713,[from,0,0,1,1
24637,dammit,0,0,1,1
24634,utvecklad,0,0,1,1
24624,jean-pierre,0,0,1,1
24560,damen,0,0,1,1
24551,équilibre,0,0,1,1
24552,bienvenue,0,0,1,1
24553,адекватному,0,0,1,1
24554,тема,0,0,1,1
24555,çeviri,0,0,1,1
24557,uğramasını,0,0,1,1
24558,فربما,0,0,1,1
24561,അമർത്തിക്കൊണ്ട്,0,0,1,1
24549,общенаучных,0,0,1,1
24563,മകൾ,0,0,1,1
24564,rostros,0,0,1,1
24565,слизняк,0,0,1,1
24567,ഒന്ന്,0,0,1,1
24568,importara.,0,0,1,1
24569,версию,0,0,1,1
24570,lister,0,0,1,1
24550,performansı,0,0,1,1
24548,darüber.,0,0,1,1
24572,ಕೇಳದಿದ್ದಾಗ,0,0,1,1
24537,воплощение,0,0,1,1
24527,skyldiga,0,0,1,1
24529,man.,0,0,1,1
24530,officially,0,0,1,1
24532,пиццы,0,0,1,1
24533,المتوافقة.,0,0,1,1
24535,informaticien,0,0,1,1
24536,promu,0,0,1,1
24538,constructivos.,0,0,1,1
24547,editorial​​,0,0,1,1
24539,forest,0,0,1,1
24540,സന്തോഷവാനാണ്,0,0,1,1
24541,ಪ್ರಯತ್ನಿಸಿ.,0,0,1,1
24543,двойных,0,0,1,1
24544,países.,0,0,1,1
24545,பயனாளிகள்,0,0,1,1
24546,അതിനുപകരം,0,0,1,1
24571,дедуктивное,0,0,1,1
24573,attracts,0,0,1,1
24623,ഇതൊരു,0,0,1,1
24610,yalan,0,0,1,1
24601,mercis.,0,0,1,1
24602,roumain,0,0,1,1
24603,популярным,0,0,1,1
24604,ಟೀಕಿಸಿ,0,0,1,1
24607,பாடத்தில்,0,0,1,1
24608,вошли,0,0,1,1
24609,distribute,0,0,1,1
24611,cuides,0,0,1,1
24598,entourent,0,0,1,1
24612,правила.,0,0,1,1
24614,basisgroeten,0,0,1,1
24617,parmakları,0,0,1,1
24618,க்கும்,0,0,1,1
24619,deciden,0,0,1,1
24620,biographical,0,0,1,1
24622,semestermånader,0,0,1,1
24600,fiscale,0,0,1,1
24597,άγγελος,0,0,1,1
24574,beskrivande,0,0,1,1
24582,haus,0,0,1,1
24575,percent',0,0,1,1
24576,correto.,0,0,1,1
24577,машинами,0,0,1,1
24578,horrific,0,0,1,1
24579,பொம்மை,0,0,1,1
24580,woordgroepen,0,0,1,1
24581,своим,0,0,1,1
24583, milhões,0,0,1,1
24594,امتحان,0,0,1,1
24584,مثل.,0,0,1,1
24585,küçücük,0,0,1,1
24588,правка,0,0,1,1
24589,modifié.,0,0,1,1
24591,nærmede,0,0,1,1
24592,robôs,0,0,1,1
24593,fødder,0,0,1,1
24741,المتخصصين.,0,0,1,1
24743,coluna,0,0,1,1
24744,குறைவான,0,0,1,1
24907,താൽ‌പ്പര്യമുണ്ടെങ്കിൽ‌,0,0,1,1
24897,decimale,0,0,1,1
24898,τρελαθεί,0,0,1,1
24899,erróneos.,0,0,1,1
24900,pose.,0,0,1,1
24901,tnr,0,0,1,1
24904,автобус,0,0,1,1
24906,fauna,0,0,1,1
24908,മൃതമായി,0,0,1,1
24895,conexiones,0,0,1,1
24909,ചെയ്യാതെ,0,0,1,1
24910,σελίδες.,0,0,1,1
24912,добровольных,0,0,1,1
24914,typographie,0,0,1,1
24917,wealth.,0,0,1,1
24920,ஆசிரியர்,0,0,1,1
24925,analisado,0,0,1,1
24896,kanıdır,0,0,1,1
24894,múnich,0,0,1,1
24927,genererat,0,0,1,1
24880,aften.,0,0,1,1
24864,ಹೊಡೆದಿದ್ದೀರಿ.,0,0,1,1
24867,sedimentary,0,0,1,1
24869,существенное,0,0,1,1
24871,objectifs,0,0,1,1
24876,உள்ளடக்கங்களும்,0,0,1,1
24877,bevæger,0,0,1,1
24879,albanês,0,0,1,1
24883,renewable,0,0,1,1
24892,προτέρων.,0,0,1,1
24884,سألتقي,0,0,1,1
24885,användes,0,0,1,1
24886,fusión,0,0,1,1
24887,nere,0,0,1,1
24889,பயன்படுத்த,0,0,1,1
24890,bayésien,0,0,1,1
24891,inzamelen,0,0,1,1
24926,شخص،,0,0,1,1
24928,traîner,0,0,1,1
24862,அழுவதைப்,0,0,1,1
24968,صنف,0,0,1,1
24959,посмотрим,0,0,1,1
24960,ages.,0,0,1,1
24961,ചോദ്യങ്ങളിൽ,0,0,1,1
24962,sahip,0,0,1,1
24964,attribuer,0,0,1,1
24966,igneous,0,0,1,1
24967,importar,0,0,1,1
24969,πλούτη,0,0,1,1
24957,högerperspektiv.,0,0,1,1
24970,« modes,0,0,1,1
24971,बिन्दुओं,0,0,1,1
24972,ಇದಕ್ಕೆ,0,0,1,1
24973,meeting.,0,0,1,1
24974,impacta,0,0,1,1
24975,بعدم,0,0,1,1
24976,continuité,0,0,1,1
24958,knol[कृपया,0,0,1,1
24956,ailleurs,0,0,1,1
24929,لويكيبيديا،,0,0,1,1
24939,ഏറെ,0,0,1,1
24930,الحادث,0,0,1,1
24931,précédente.,0,0,1,1
24932,приводят,0,0,1,1
24933,grine,0,0,1,1
24936,içeriğe,0,0,1,1
24937,erosion.,0,0,1,1
24938,eu',0,0,1,1
24941,പത്രങ്ങൾ,0,0,1,1
24955,уловка-.,0,0,1,1
24944,«психбольницу,0,0,1,1
24945,tem-se,0,0,1,1
24949,закрывают,0,0,1,1
24950,पिछले,0,0,1,1
24951,empezar,0,0,1,1
24952,prontitud.,0,0,1,1
24954,министром,0,0,1,1
24863,ödeviniz,0,0,1,1
24859,startsidan,0,0,1,1
24745,croata,0,0,1,1
24779,தவறாக,0,0,1,1
24772,médicale,0,0,1,1
24773,интересных,0,0,1,1
24774,propensas,0,0,1,1
24775,forretning,0,0,1,1
24776,rivers.,0,0,1,1
24777,टिप्पणीकारों,0,0,1,1
24778,പൊതുവായതും,0,0,1,1
24781,summarizing,0,0,1,1
24770,standard.,0,0,1,1
24782,gebruikelijke.,0,0,1,1
24784,d’indifférenciation,0,0,1,1
24785,services.,0,0,1,1
24786,feito.,0,0,1,1
24788,disparidad,0,0,1,1
24790,moléculas,0,0,1,1
24791,eronder,0,0,1,1
24771,confinée,0,0,1,1
24768,ഇല്ലെന്നല്ല.,0,0,1,1
24795,rebellion,0,0,1,1
24754,énumérées,0,0,1,1
24746,toevoegen.,0,0,1,1
24747,ಕಾಣುತ್ತದೆ,0,0,1,1
24748,lastly,0,0,1,1
24750,संकेतबद्ध,0,0,1,1
24751,generality,0,0,1,1
24752,envis,0,0,1,1
24753,synder.,0,0,1,1
24755,ρουμπίνια,0,0,1,1
24767,exposition,0,0,1,1
24756,добьетесь,0,0,1,1
24757,réaction,0,0,1,1
24759,അയയ്ക്കും,0,0,1,1
24761,ಕೊನೆಯಲ್ಲಿ,0,0,1,1
24762,எனும்,0,0,1,1
24764,inanamıyorum.,0,0,1,1
24766,jeopardy.,0,0,1,1
24792,бегло.,0,0,1,1
24796,höll,0,0,1,1
24858,κοντά,0,0,1,1
24846,asegúrese,0,0,1,1
24833,प्रसारण,0,0,1,1
24834,bobo,0,0,1,1
24838,grupparbetet,0,0,1,1
24839,conteúdo.,0,0,1,1
24840,schlimmer,0,0,1,1
24841,synker,0,0,1,1
24842,maravilloso,0,0,1,1
24848,भौतिक,0,0,1,1
24830,номинирована,0,0,1,1
24850,destinés,0,0,1,1
24851,alrededor,0,0,1,1
24852,latitude.,0,0,1,1
24853,londonien,0,0,1,1
24854,interactividad,0,0,1,1
24856,abstraite,0,0,1,1
24857,olmasın,0,0,1,1
24832,يحاول,0,0,1,1
24829,различного,0,0,1,1
24798,απόψεων,0,0,1,1
24810,variedad,0,0,1,1
24801,lindo.,0,0,1,1
24802,voorbereid,0,0,1,1
24803,ഗൃഹപാഠം,0,0,1,1
24805,«открытие,0,0,1,1
24806,mümkün,0,0,1,1
24808,للمقالات,0,0,1,1
24809,अर्थशास्त्री,0,0,1,1
24814,ícono,0,0,1,1
24828,worstelde,0,0,1,1
24818,portuguese,0,0,1,1
24819,duidt,0,0,1,1
24820,elk,0,0,1,1
24823,μικρά,0,0,1,1
24824,ce •,0,0,1,1
24825,instrui,0,0,1,1
24826,sueño.,0,0,1,1
24526,fraser.,0,0,1,1
24522,ಪದದಿಂದ,0,0,1,1
24979,relevantes,0,0,1,1
24521,heurística,0,0,1,1
24188,kullanmıyorsunuz,0,0,1,1
24189,neutres,0,0,1,1
24190,വസ്ത്രം,0,0,1,1
24191,«[l]o,0,0,1,1
24192,октябрю,0,0,1,1
24193,കഷ്ണം,0,0,1,1
24194,нос,0,0,1,1
24195,٬٬,0,0,1,1
24196,rápido,0,0,1,1
24197,تملي,0,0,1,1
24200,security”.,0,0,1,1
24201,anlatsaydı,0,0,1,1
24202,अनुवाद,0,0,1,1
24204,ولكي,0,0,1,1
24206,anlamamı,0,0,1,1
24208,مضى,0,0,1,1
24209,теме»,0,0,1,1
24187,nesta,0,0,1,1
24186,मूलभूत,0,0,1,1
24185,வெளிப்படையான,0,0,1,1
24169,рандеву.,0,0,1,1
24161,miroitements,0,0,1,1
24162,συναντάς,0,0,1,1
24163,золотым,0,0,1,1
24164,ஆச்சரியமான,0,0,1,1
24165,കൂടാതെ,0,0,1,1
24166,hiperligações,0,0,1,1
24168,അമ്മയെക്കുറിച്ച്,0,0,1,1
24170,spelkonsoler,0,0,1,1
24180,bósnio,0,0,1,1
24172,الفكرية,0,0,1,1
24174,parlementaires.,0,0,1,1
24175,accordait,0,0,1,1
24176,രാജകുമാരനെയോ,0,0,1,1
24177,amoreel,0,0,1,1
24178,xviiie siècles,0,0,1,1
24179,инструкции.,0,0,1,1
24210,नगरीय,0,0,1,1
24211,பெண்கள்,0,0,1,1
24213,kontroversiell,0,0,1,1
24254,sängmamma,0,0,1,1
24242,വഴിക്കുള്ള,0,0,1,1
24244,हेलर,0,0,1,1
24247,ogen,0,0,1,1
24249,ಒಳ್ಳೆಯವರಾಗಿದ್ದರು,0,0,1,1
24250,fouten.,0,0,1,1
24252,வேலையும்,0,0,1,1
24253,matematiska,0,0,1,1
24257,commençons.,0,0,1,1
24239,предназначенная,0,0,1,1
24258,permitiendo,0,0,1,1
24259,spills.,0,0,1,1
24260,majorité,0,0,1,1
24261,zil,0,0,1,1
24262,verification,0,0,1,1
24263,coordinación,0,0,1,1
24265,reliance,0,0,1,1
24240,βικιφθέγματα,0,0,1,1
24238,حافلتنا,0,0,1,1
24214,mismo.,0,0,1,1
24227,σκληροί,0,0,1,1
24215,сложно,0,0,1,1
24216,fingern,0,0,1,1
24217,she's,0,0,1,1
24218,loin,0,0,1,1
24222,encyklopedi,0,0,1,1
24225,прекрасных,0,0,1,1
24226,revolución,0,0,1,1
24228,ഉപയോക്താക്കളും,0,0,1,1
24237,yeterince,0,0,1,1
24229,nourriture.,0,0,1,1
24230,sveriges,0,0,1,1
24232,éditoriaux,0,0,1,1
24233,imposible,0,0,1,1
24234,rörde,0,0,1,1
24235,usamos,0,0,1,1
24236,étions-nous,0,0,1,1
24160,comente,0,0,1,1
24159,exhibit,0,0,1,1
24156,polegar,0,0,1,1
24083,voici,0,0,1,1
24073,வரிசை’யில்,0,0,1,1
24074,कहीं,0,0,1,1
24075,« bots »,0,0,1,1
24076,പാസ്‌വേഡ്,0,0,1,1
24077,teklif,0,0,1,1
24078,حار,0,0,1,1
24080,kullanılarak,0,0,1,1
24084,नाय्नोर्स्क,0,0,1,1
24070,സന്തോഷമായിരിക്കാനും,0,0,1,1
24086,présentait,0,0,1,1
24087,donnez-lui,0,0,1,1
24088,мариан,0,0,1,1
24089,burnu,0,0,1,1
24091,पत्रकारों,0,0,1,1
24092,hogere,0,0,1,1
24093,girişi,0,0,1,1
24071,permitidas,0,0,1,1
24069,smelly,0,0,1,1
24095,цели,0,0,1,1
24055,bezaaid,0,0,1,1
24045,«викимедиа.ру»,0,0,1,1
24046,سفراء,0,0,1,1
24047,avançados,0,0,1,1
24048,placed,0,0,1,1
24051,zangado,0,0,1,1
24052,ναρκίσσους.,0,0,1,1
24053,έλα,0,0,1,1
24056,l'implémentation,0,0,1,1
24068,bekymringer.,0,0,1,1
24058,multinacionales,0,0,1,1
24060,примечательно,0,0,1,1
24063,официальной,0,0,1,1
24064,തനതുവ്യക്തിത്വമുള്ള,0,0,1,1
24065,असंगत,0,0,1,1
24066,என்சைக்ளோபீடியாவிலிருந்து,0,0,1,1
24067,дитя,0,0,1,1
24094,ضد,0,0,1,1
24098,artful,0,0,1,1
24154,réponses,0,0,1,1
24141,gubernamentales,0,0,1,1
24130,الصباح,0,0,1,1
24132,expansion,0,0,1,1
24134,ಹೇಳಿದಾಗ,0,0,1,1
24135,marcando,0,0,1,1
24136,لبعض,0,0,1,1
24137,beiden,0,0,1,1
24138,أنهم,0,0,1,1
24142,geçip,0,0,1,1
24127,பெறும்,0,0,1,1
24145,مؤقتًا.,0,0,1,1
24146,vies,0,0,1,1
24147,equivalente,0,0,1,1
24148,lua,0,0,1,1
24150,proprietary,0,0,1,1
24152,nog.,0,0,1,1
24153,धीमी,0,0,1,1
24128,верификации,0,0,1,1
24125,الحلم,0,0,1,1
24100,நடவு,0,0,1,1
24112,persa,0,0,1,1
24101,order.,0,0,1,1
24102,caída,0,0,1,1
24103,внесённые,0,0,1,1
24106,бриллиантами,0,0,1,1
24108,helft,0,0,1,1
24109,الإبداعي,0,0,1,1
24110,قبل.,0,0,1,1
24113,كذلك؟,0,0,1,1
24124,исследователь,0,0,1,1
24114,ye.,0,0,1,1
24115,sentou-se,0,0,1,1
24116,dokümanların,0,0,1,1
24118,मूल्य,0,0,1,1
24120,mau,0,0,1,1
24121,bibliothèques,0,0,1,1
24123,utilizando,0,0,1,1
24266,пообщаться,0,0,1,1
24269,sou,0,0,1,1
24270,universitario,0,0,1,1
24452,കാര്യനിർവ്വാഹകർ.,0,0,1,1
24439,immangeable,0,0,1,1
24440,أوصلك,0,0,1,1
24441,الشكوك,0,0,1,1
24444,maitrise,0,0,1,1
24445,législateur,0,0,1,1
24446,أكله,0,0,1,1
24450,είμαστε,0,0,1,1
24453,low-dimensional,0,0,1,1
24435,.'da,0,0,1,1
24455,grof,0,0,1,1
24456,rough,0,0,1,1
24457,difundiendo,0,0,1,1
24458,agence,0,0,1,1
24461,specify,0,0,1,1
24462,الحين,0,0,1,1
24463,archive,0,0,1,1
24437,arkadaşlarınızdan,0,0,1,1
24433,massornas,0,0,1,1
24465,ഭാര്യയായിരിക്കേണ്ട,0,0,1,1
24416,ومنشورات,0,0,1,1
24405,கேட்கக்கூடிய,0,0,1,1
24406,oriental,0,0,1,1
24407,exposer,0,0,1,1
24408,സമ്പൂർണ്ണലേഖനം,0,0,1,1
24410,existem.,0,0,1,1
24414,അസന്തുഷ്ടിയും,0,0,1,1
24415,tradutores,0,0,1,1
24417,adequadamente,0,0,1,1
24429,scales,0,0,1,1
24420,заболоченный,0,0,1,1
24422,പദ്ധതികൾരൂപീകരിക്കുന്നു.,0,0,1,1
24424,दुविधा,0,0,1,1
24425,owe,0,0,1,1
24426,त्रुटियों,0,0,1,1
24427,फ्रांसिस्को,0,0,1,1
24428,corrió,0,0,1,1
24464,स्वाहिली,0,0,1,1
24466,வாதங்களையும்,0,0,1,1
24403,interrupt,0,0,1,1
24511,ತಿರುಗಿಸಿದೆ,0,0,1,1
24497,βοηθούσες,0,0,1,1
24498,shopping,0,0,1,1
24502,novio,0,0,1,1
24504,πηγή,0,0,1,1
24507,കാഴ്ചപ്പാടുകളെ,0,0,1,1
24509,preocupação,0,0,1,1
24510,tabulated,0,0,1,1
24512,bakken,0,0,1,1
24495,vigtigste,0,0,1,1
24513,pnb •,0,0,1,1
24514,posse,0,0,1,1
24515,källhänvisningar,0,0,1,1
24516,hoes,0,0,1,1
24517,güzellerdi.,0,0,1,1
24519,identidad,0,0,1,1
24520,terço,0,0,1,1
24496,carona,0,0,1,1
24494,consommation,0,0,1,1
24467,cobrir,0,0,1,1
24476,ತರುತ್ತೇನೆ,0,0,1,1
24469,നിസ്സാരനായിരിക്കാം,0,0,1,1
24470,traduit.,0,0,1,1
24471,tillhör,0,0,1,1
24472,contestada,0,0,1,1
24473,goldgoldenem,0,0,1,1
24474,الرحلة.,0,0,1,1
24475,breathe,0,0,1,1
24481,março,0,0,1,1
24492,spiegel,0,0,1,1
24482,പ്രവർത്തിക്കുന്നുണ്ടെങ്കിൽ,0,0,1,1
24483,cruels,0,0,1,1
24486,blockeras.,0,0,1,1
24487,ನೋಡಲು,0,0,1,1
24489,işi.,0,0,1,1
24490,faria.,0,0,1,1
24491,determinar,0,0,1,1
24404,சார்,0,0,1,1
24401,അർത്ഥമാണ്,0,0,1,1
24272,வெள்ளம்,0,0,1,1
24316,meinung.,0,0,1,1
24305,military,0,0,1,1
24308,overturned,0,0,1,1
24309,താഴേയ്‌ക്ക്,0,0,1,1
24310,встречи.,0,0,1,1
24311,editörü,0,0,1,1
24312,høre,0,0,1,1
24314,கலைக்களஞ்சியங்களைப்,0,0,1,1
24320,d'information.,0,0,1,1
24301,cravejada,0,0,1,1
24321,ஆள்களப்,0,0,1,1
24322,sandım.,0,0,1,1
24326,έστειλε,0,0,1,1
24327,onmogelijke,0,0,1,1
24329,écritures,0,0,1,1
24331,assignment,0,0,1,1
24333,soep,0,0,1,1
24302,അതത്,0,0,1,1
24300,gefangen,0,0,1,1
24335,إيجابيًا,0,0,1,1
24288,infinito,0,0,1,1
24273,ಡ್ರೈವಾಲ್,0,0,1,1
24274,pronouncing,0,0,1,1
24275,gleich,0,0,1,1
24278,இருந்திருந்தால்,0,0,1,1
24279,reutilizar,0,0,1,1
24280,règles.,0,0,1,1
24287,hyldede,0,0,1,1
24289,разработанная,0,0,1,1
24299,வேகமாக,0,0,1,1
24290,скопировать,0,0,1,1
24291,inferences,0,0,1,1
24292,കണ്ണാടിയിലോ,0,0,1,1
24295,lointain,0,0,1,1
24296,tese,0,0,1,1
24297,хлебом,0,0,1,1
24298,baseret,0,0,1,1
24334,vanvittigt.,0,0,1,1
24338,brødbrød,0,0,1,1
24400,быстрые,0,0,1,1
24384,saxe,0,0,1,1
24369,சுட,0,0,1,1
24373,arrangement.,0,0,1,1
24376,кого-то.,0,0,1,1
24377,следовали,0,0,1,1
24378,السبب,0,0,1,1
24379,opretholde,0,0,1,1
24380,birçoğunu,0,0,1,1
24385,penses,0,0,1,1
24367,possuíam,0,0,1,1
24387,inseriu,0,0,1,1
24390,lançamento,0,0,1,1
24391,മാതൃകയിൽപ്പോലും,0,0,1,1
24392,मानचित्र,0,0,1,1
24396,вносимые,0,0,1,1
24397,الحادثة،,0,0,1,1
24399,പ്രമുഖരുടെ,0,0,1,1
24368,périodes,0,0,1,1
24365,ಪ್ರತಿಕ್ರಿಯೆಯೊಂದಿಗೆ,0,0,1,1
24339,bahsederken,0,0,1,1
24349,additions,0,0,1,1
24340,لتهنئة,0,0,1,1
24341,серьёзных,0,0,1,1
24342,ഉപയോഗശൂന്യമായിരുന്നു,0,0,1,1
24343,visent,0,0,1,1
24345,ಫಿಕ್ಸ್,0,0,1,1
24347,നാല്പത്തഞ്ച്,0,0,1,1
24348,geïntensiveerd,0,0,1,1
24351,كمقالات,0,0,1,1
24363,يسألك,0,0,1,1
24352,دروسي,0,0,1,1
24354,irresponsible,0,0,1,1
24355,பரிசைக்,0,0,1,1
24356,миллион,0,0,1,1
24358,narciss,0,0,1,1
24361,velho,0,0,1,1
24362,« dépassé,0,0,1,1
24978,kultiveret,0,0,1,1
24980,credenciados,0,0,1,1
25938,étranger,0,0,1,1
25475,предполагает,0,0,1,1
25628,ದಿನನಿತ್ಯದ,0,0,1,1
25629,föreställ,0,0,1,1
25630,aka,0,0,1,1
25631,dictionaries,0,0,1,1
25632,déclaraient,0,0,1,1
25634,décider,0,0,1,1
25635,വേണ്ടത്.,0,0,1,1
25636,tidsperiod,0,0,1,1
25641,generel,0,0,1,1
25644,nachzudenken,0,0,1,1
25646,uiteindelijk.,0,0,1,1
25647,भरा,0,0,1,1
25648,والإحصاء,0,0,1,1
25651,studier,0,0,1,1
25652,precedentes,0,0,1,1
25653,महाद्वीपों,0,0,1,1
25654,ലക്ഷത്തിനടുത്ത്,0,0,1,1
25627,ನಡತೆ,0,0,1,1
25626,urbaines,0,0,1,1
25625,сайта.,0,0,1,1
25613,έμοιαζε,0,0,1,1
25594,microsystem,0,0,1,1
25595,نوعًا,0,0,1,1
25597,wikipedia”,0,0,1,1
25600,الصعب,0,0,1,1
25601,krypteringen,0,0,1,1
25607,knutna,0,0,1,1
25610,كذلك.,0,0,1,1
25614,obscur.,0,0,1,1
25624,functie,0,0,1,1
25615,مدى,0,0,1,1
25616,promueven,0,0,1,1
25619,bevorderd,0,0,1,1
25620,mining.,0,0,1,1
25621,viagens,0,0,1,1
25622,taler,0,0,1,1
25623,bookstores.,0,0,1,1
25655,friere,0,0,1,1
25656,mantidas,0,0,1,1
25657,istemiyorsa.,0,0,1,1
25698,സിനിമ,0,0,1,1
25688,sorts,0,0,1,1
25690,tryckt,0,0,1,1
25692,എന്നെഴുതുന്നു.,0,0,1,1
25693,cercana,0,0,1,1
25694,tamamlanmış,0,0,1,1
25695,ടെറിയോടും,0,0,1,1
25696,tedbir,0,0,1,1
25699,llevan,0,0,1,1
25686,válida,0,0,1,1
25700,പുഞ്ചിരിയായിരുന്നു,0,0,1,1
25701,இருக்கிறீர்கள்.,0,0,1,1
25702,hindi,0,0,1,1
25703,sabrosa,0,0,1,1
25704,८,0,0,1,1
25705,dois-je,0,0,1,1
25706,spurgt,0,0,1,1
25687,rationnelles,0,0,1,1
25685,ओबामा,0,0,1,1
25659,попадет,0,0,1,1
25669,avons,0,0,1,1
25660,مقالة،,0,0,1,1
25663,coutumes,0,0,1,1
25664,بناءً,0,0,1,1
25665,ستعيش,0,0,1,1
25666,.estamos,0,0,1,1
25667,νάρκισσος.,0,0,1,1
25668,décomptant,0,0,1,1
25670,träffat,0,0,1,1
25683,nacimiento,0,0,1,1
25671,medieråd,0,0,1,1
25672,querría,0,0,1,1
25676,அவர்களுக்கு,0,0,1,1
25677,யூகித்தாலும்,0,0,1,1
25678,française.,0,0,1,1
25681,وكل,0,0,1,1
25682,വിഷയങ്ങളിലെ,0,0,1,1
25593,sales,0,0,1,1
25592,обоим,0,0,1,1
25591,ಬೇಕಾದುದಾದರೆ,0,0,1,1
25513,وأصبحت,0,0,1,1
25504,ödmjuk,0,0,1,1
25505,neuronal,0,0,1,1
25506,ställer,0,0,1,1
25508,naturelle.,0,0,1,1
25510,tareas,0,0,1,1
25511,بنصب,0,0,1,1
25512,общее,0,0,1,1
25514,सिन्धी,0,0,1,1
25501,viquipedia,0,0,1,1
25515,stoppet,0,0,1,1
25516,إذ,0,0,1,1
25521,devez,0,0,1,1
25523,désignait,0,0,1,1
25524,meningsmotståndare,0,0,1,1
25525,lasting,0,0,1,1
25527,قارئ،,0,0,1,1
25503,aprenden,0,0,1,1
25500,point-for-point,0,0,1,1
25530,ξύπνησα,0,0,1,1
25487,wikipedia-skribenter,0,0,1,1
25477,മെഷീൻ,0,0,1,1
25478,encontrarás,0,0,1,1
25479,ψυχικά,0,0,1,1
25480,llanto,0,0,1,1
25482,mr •,0,0,1,1
25483,fingre.,0,0,1,1
25486,приходили,0,0,1,1
25488,നുഴഞ്ഞുകയറിയിട്ടുണ്ടായേക്കാവുന്ന,0,0,1,1
25499,accessdatum,0,0,1,1
25489,« italie »,0,0,1,1
25490,नींद,0,0,1,1
25491,намерения.,0,0,1,1
25493,примите,0,0,1,1
25495,என்சிச்லோபெடியா,0,0,1,1
25496,பயன்படுத்தினால்,0,0,1,1
25497,март,0,0,1,1
25528,tornadoes,0,0,1,1
25533,oferecer,0,0,1,1
25590,yaşamınızda,0,0,1,1
25574,brook,0,0,1,1
25566,distribuciones,0,0,1,1
25568,cuestiones,0,0,1,1
25569,third-generation,0,0,1,1
25570,vandrare.,0,0,1,1
25571,importante.,0,0,1,1
25572,användargenererat,0,0,1,1
25573,trompez.,0,0,1,1
25575,художник,0,0,1,1
25563,تشغلها,0,0,1,1
25578,ഇവർ,0,0,1,1
25580,अश्लील,0,0,1,1
25581,amérique,0,0,1,1
25582,agerade,0,0,1,1
25583,« or,0,0,1,1
25584,ஒப்புக்கொண்டால்,0,0,1,1
25586,«потрясающе,0,0,1,1
25564,रखा।,0,0,1,1
25562,الفظة.,0,0,1,1
25535,ucraniano.,0,0,1,1
25550,habría,0,0,1,1
25538,yasalara,0,0,1,1
25539,подлог,0,0,1,1
25542,ಹೋಗುವಾಗ,0,0,1,1
25544,disruptive,0,0,1,1
25545,χωριό,0,0,1,1
25546,الآخرين،,0,0,1,1
25549,സമർപ്പിക്കുക.,0,0,1,1
25551,அழுகிறார்கள்,0,0,1,1
25561,بلا,0,0,1,1
25552,രണ്ടെണ്ണം,0,0,1,1
25553,phyla,0,0,1,1
25554,num,0,0,1,1
25555,sonhou.,0,0,1,1
25557,vele,0,0,1,1
25558,പ്രതിപാദനത്തെയും,0,0,1,1
25560,المستخدمين...,0,0,1,1
25707,albedo,0,0,1,1
25708,ekmekten.,0,0,1,1
25709,icat,0,0,1,1
25866,செய்யப்பட்டன.,0,0,1,1
25857,പകർത്താൻ,0,0,1,1
25858,reputação,0,0,1,1
25859,attitudes,0,0,1,1
25861,görüşleriniz,0,0,1,1
25863,юнлэ,0,0,1,1
25864,убедитесь,0,0,1,1
25865,затопление,0,0,1,1
25867,ശരിയാണ്.,0,0,1,1
25853,administratörer.,0,0,1,1
25868,faites-moi,0,0,1,1
25869,bakayım.,0,0,1,1
25870,compañero,0,0,1,1
25871,corrélation,0,0,1,1
25872,للتحدث,0,0,1,1
25873,américaines,0,0,1,1
25874,புத்தகத்தில்,0,0,1,1
25854,ущербной,0,0,1,1
25852,новостях,0,0,1,1
25877,création.,0,0,1,1
25837,διαφορετικές,0,0,1,1
25828,telephone,0,0,1,1
25829,tryckfriheten,0,0,1,1
25830,samhället,0,0,1,1
25831,للقواعد,0,0,1,1
25832,lagged,0,0,1,1
25833,extremt,0,0,1,1
25835,لا.,0,0,1,1
25838,منهجية,0,0,1,1
25848,restringidas,0,0,1,1
25839,മലയാളത്തില്,0,0,1,1
25840,സുഹൃത്തുക്കളോട്,0,0,1,1
25841,ребята.,0,0,1,1
25843,власти.,0,0,1,1
25845,ställe.,0,0,1,1
25846,चाहें,0,0,1,1
25847,മുന്നോട്ടുപോയില്ല.,0,0,1,1
25875,«неудобных»,0,0,1,1
25880,borrando,0,0,1,1
25826,blur,0,0,1,1
25924,göstermiştir.,0,0,1,1
25913,denkt.,0,0,1,1
25914,आश्चर्यचकित,0,0,1,1
25916,മേഖലകളുണ്ട്.,0,0,1,1
25920,recopier,0,0,1,1
25921,malodorante,0,0,1,1
25922,postlisterne.,0,0,1,1
25923,dna.,0,0,1,1
25925,வடிவமைக்கப்,0,0,1,1
25909,சிறந்தவர்,0,0,1,1
25926,singapur,0,0,1,1
25927,المعتاد.,0,0,1,1
25932,യോജിക്കുന്നു.,0,0,1,1
25933,प्रस्तावना,0,0,1,1
25934,أكبرها،,0,0,1,1
25936,அடையச்,0,0,1,1
25937,enforce,0,0,1,1
25911,eo •,0,0,1,1
25908,представителя,0,0,1,1
25882,svälter,0,0,1,1
25892,whose,0,0,1,1
25883,introduisit,0,0,1,1
25884,παραδώσει,0,0,1,1
25885,sett.,0,0,1,1
25886,trumps,0,0,1,1
25887,lacunes,0,0,1,1
25889,coopération,0,0,1,1
25890,benadrukken,0,0,1,1
25895,işin,0,0,1,1
25907,تدور,0,0,1,1
25896,einverstanden,0,0,1,1
25897,cep,0,0,1,1
25898,probeerde,0,0,1,1
25900,sucedidas,0,0,1,1
25901,ഗ്രോഡിയന്റേ,0,0,1,1
25903,dou-lhe,0,0,1,1
25906,нем.,0,0,1,1
25827,nomeados,0,0,1,1
25825,ಬೆರಳುಗಳ,0,0,1,1
25710,mrs,0,0,1,1
25753,vivante.,0,0,1,1
25742,जाऊँगा।,0,0,1,1
25746,accordingly.,0,0,1,1
25747,ethnographique,0,0,1,1
25748,semi-automaticamente,0,0,1,1
25750,öbeğini,0,0,1,1
25751,مساء.,0,0,1,1
25752,lisent,0,0,1,1
25754,δυστυχισμένο.,0,0,1,1
25738,knight.,0,0,1,1
25755,നിർവഹിക്കാൻ,0,0,1,1
25757,يعتقد,0,0,1,1
25759,மனிதன்,0,0,1,1
25760,യഥാർത്ഥ,0,0,1,1
25763,lämnat,0,0,1,1
25764,расходятся,0,0,1,1
25765,различных,0,0,1,1
25739,cavalgada,0,0,1,1
25737,поступок.,0,0,1,1
25768,“tax,0,0,1,1
25724,rigorosos,0,0,1,1
25712,ഒരാളെ,0,0,1,1
25713,gfdl-,0,0,1,1
25714,requisitos.,0,0,1,1
25716,отвечающие,0,0,1,1
25718,kanalen,0,0,1,1
25720,defendido,0,0,1,1
25721,സന്തോഷ,0,0,1,1
25726,परियोजनाएं-जैसे,0,0,1,1
25736,gags,0,0,1,1
25727,ongeluk,0,0,1,1
25728,rig,0,0,1,1
25729,ಅಡ್ಡಿಪಡಿಸಲು,0,0,1,1
25730,photographie,0,0,1,1
25732,بروابط,0,0,1,1
25733,கொண்டுள்ளேன்.,0,0,1,1
25735,ensaladas,0,0,1,1
25766,ദയവായി.,0,0,1,1
25769,incorporés,0,0,1,1
25824,migrés,0,0,1,1
25810,avsiktlig,0,0,1,1
25802,mensualmente,0,0,1,1
25803,ademen,0,0,1,1
25804,القليلة,0,0,1,1
25805,hanımların,0,0,1,1
25807,gestionar,0,0,1,1
25808,dado.,0,0,1,1
25809,annenize,0,0,1,1
25812,uddybende,0,0,1,1
25800,बलात्कार,0,0,1,1
25813,numerical,0,0,1,1
25815,टैब्स,0,0,1,1
25816,filipino,0,0,1,1
25817,threats,0,0,1,1
25819,യാന്ത്രികമായാണ്,0,0,1,1
25822,പിന്നിൽ,0,0,1,1
25823,выглядишь,0,0,1,1
25801,slut.,0,0,1,1
25797,நுழைந்தால்,0,0,1,1
25770,നീങ്ങുക.,0,0,1,1
25779,spiegelsites,0,0,1,1
25771,partis,0,0,1,1
25772,haría,0,0,1,1
25773,dimension,0,0,1,1
25774,impossibilitadas,0,0,1,1
25776,irréductibles,0,0,1,1
25777,periodicidad,0,0,1,1
25778,diyorsun,0,0,1,1
25780,raffiniert,0,0,1,1
25791,συνεχίστε.,0,0,1,1
25781,लातिन,0,0,1,1
25783,arbitraire,0,0,1,1
25784,жёстки.,0,0,1,1
25785,boisson,0,0,1,1
25786,materiales,0,0,1,1
25788,ഇന്റർപീഡിയ,0,0,1,1
25790,государственную,0,0,1,1
25476,فموسوعة,0,0,1,1
25473,sauvages,0,0,1,1
24981,.அவள்,0,0,1,1
25471,melissa.,0,0,1,1
25143,inland,0,0,1,1
25145,προσλάβουμε,0,0,1,1
25146,αρέσει,0,0,1,1
25147,çarptığı,0,0,1,1
25148,pouce,0,0,1,1
25149,bleiben.,0,0,1,1
25151,fivethirtyeight,0,0,1,1
25152,intègrent,0,0,1,1
25153,sr •,0,0,1,1
25154,geht.,0,0,1,1
25155,grüße,0,0,1,1
25156,зеландии,0,0,1,1
25157,concierto,0,0,1,1
25158,preguntado,0,0,1,1
25159,प्रिंट,0,0,1,1
25161,فكل,0,0,1,1
25162,уровней,0,0,1,1
25140,стиль,0,0,1,1
25139,avråder,0,0,1,1
25138,kaliforniya'da,0,0,1,1
25127,ശ്രമിക്കുക.,0,0,1,1
25118,расследования,0,0,1,1
25119,året,0,0,1,1
25120,कोने,0,0,1,1
25121,ನೋಡಬಹುದಾದ,0,0,1,1
25122,fdims,0,0,1,1
25123,lévi-strauss.,0,0,1,1
25124,auparavant,0,0,1,1
25128,os-tan,0,0,1,1
25137,deveriam.,0,0,1,1
25129,engajar,0,0,1,1
25130,ಹತ್ತು,0,0,1,1
25132,allmänt,0,0,1,1
25133,ειδικά,0,0,1,1
25134,pronto.,0,0,1,1
25135,sistémica,0,0,1,1
25136,constara,0,0,1,1
25163,എഡിറ്റർമാർ,0,0,1,1
25165,федеральный,0,0,1,1
25166,പ്രപഞ്ചത്തിലെ,0,0,1,1
25203,cryptologue,0,0,1,1
25192,знака,0,0,1,1
25193,соответствующей,0,0,1,1
25194,إدارة,0,0,1,1
25195,ಮನೋರಂಜನಾ,0,0,1,1
25197,o/oooo,0,0,1,1
25199,സ്വകാര്യലാഭത്തിനു,0,0,1,1
25202,diyorlar.,0,0,1,1
25204,annat.,0,0,1,1
25190,используем,0,0,1,1
25205,kommentarbereich,0,0,1,1
25207,actuación,0,0,1,1
25208,tersi,0,0,1,1
25209,رموز,0,0,1,1
25210,disponíveis.,0,0,1,1
25211,δροσερός,0,0,1,1
25212,അവസാനം,0,0,1,1
25191,intensivo,0,0,1,1
25189,ಲಾಂಡ್ರಿಗೆ,0,0,1,1
25167,rette,0,0,1,1
25178,चयनित,0,0,1,1
25168,etmek.”,0,0,1,1
25169,control ·sustainability ·പാഴ്വസ്തു,0,0,1,1
25170,brion,0,0,1,1
25171,अल्पकालिक,0,0,1,1
25172,wijd,0,0,1,1
25174,ನೋಡುತ್ತಿದ್ದೇನೆ.,0,0,1,1
25177,ಆಶಾದಾಯಕವಾಗಿ,0,0,1,1
25179,അർബുദം,0,0,1,1
25188,väluppfostrad,0,0,1,1
25180,limitações,0,0,1,1
25181,nl,0,0,1,1
25183,sets.,0,0,1,1
25184,klikken,0,0,1,1
25185,பக்கங்களை,0,0,1,1
25186,reversión,0,0,1,1
25187,مخاوف,0,0,1,1
25113,πώς.,0,0,1,1
25112,आवाज़,0,0,1,1
25111,l'étymologie,0,0,1,1
25026,acelerou,0,0,1,1
25013,वेर्कस्टाट,0,0,1,1
25017,prompts,0,0,1,1
25018,получивший,0,0,1,1
25019,kalınarak,0,0,1,1
25023,गैलिक,0,0,1,1
25024,pedras,0,0,1,1
25025,desastrosas,0,0,1,1
25028,rce,0,0,1,1
25009,cevaplamak,0,0,1,1
25032,moderação,0,0,1,1
25033,चारों,0,0,1,1
25035,مجتمعية,0,0,1,1
25036,людьми».,0,0,1,1
25037,berömmet,0,0,1,1
25039,συνομιλίας,0,0,1,1
25041,pekala,0,0,1,1
25012,تخيل,0,0,1,1
25008,mostrar,0,0,1,1
25046,تنشأ,0,0,1,1
24992,наплевать,0,0,1,1
24982,ಜನರು,0,0,1,1
24984,എൻട്രോപ്പി,0,0,1,1
24985,bootstrap,0,0,1,1
24986,ativistas,0,0,1,1
24988,disproportionately,0,0,1,1
24989,αποθήκη,0,0,1,1
24991,काल्पनिक,0,0,1,1
24993,agradável,0,0,1,1
25007,നട്ടുപിടിപ്പിക്കാൻ,0,0,1,1
24994,отправиться,0,0,1,1
24995,amerikansk,0,0,1,1
24999,பார்க்கும்,0,0,1,1
25000,errónea,0,0,1,1
25002,γράφεται,0,0,1,1
25004,tecnológico,0,0,1,1
25005,ögon.,0,0,1,1
25043,soupe,0,0,1,1
25047,ചീത്തയായി,0,0,1,1
25110,avoid,0,0,1,1
25093,فلنتحدث,0,0,1,1
25084,هبوط,0,0,1,1
25085,promise,0,0,1,1
25086,chat,0,0,1,1
25087,കൂട്ടായ്മയിൽ,0,0,1,1
25089,st-century,0,0,1,1
25090,ഗ്രാമത്തിൽ,0,0,1,1
25091,dimensionality,0,0,1,1
25094,eqord,0,0,1,1
25082,тематики.,0,0,1,1
25095,eqiad,0,0,1,1
25099,loi,0,0,1,1
25100,sayede,0,0,1,1
25102,parodian.,0,0,1,1
25103,копилефт-лицензиями,0,0,1,1
25104,equator,0,0,1,1
25106,editoriales,0,0,1,1
25083,ingick,0,0,1,1
25081,σημασία.,0,0,1,1
25048,காட்டாது,0,0,1,1
25064,finir.,0,0,1,1
25052,håll,0,0,1,1
25053,brødet,0,0,1,1
25055,учтиво,0,0,1,1
25056,eclipsando,0,0,1,1
25059,திட்டங்களையும்,0,0,1,1
25060,reclamando,0,0,1,1
25063,véhicule,0,0,1,1
25065,överdriva,0,0,1,1
25080,புத்தகமாகத்,0,0,1,1
25068,episode's,0,0,1,1
25069,élément,0,0,1,1
25070,сделан,0,0,1,1
25073,amie,0,0,1,1
25074,എൻസൈക്ലോപീഡിയ,0,0,1,1
25076,pouvoir,0,0,1,1
25078,собравшей,0,0,1,1
25213,आगंतुक,0,0,1,1
25216,jugée,0,0,1,1
25217,ಬಳಿ,0,0,1,1
25394,تجاوزت,0,0,1,1
25385,തലച്ചോറിനെ,0,0,1,1
25387,ought,0,0,1,1
25388,«todo,0,0,1,1
25389,городе.,0,0,1,1
25390,« livres »,0,0,1,1
25392,приготовилась,0,0,1,1
25393,permanently,0,0,1,1
25395,பக்கத்தின்,0,0,1,1
25383,necesita,0,0,1,1
25398,تتسكع,0,0,1,1
25401,preguntando,0,0,1,1
25402,migrent,0,0,1,1
25403,aprendiesen.,0,0,1,1
25404,atarsa,0,0,1,1
25405,اكتسبت,0,0,1,1
25406,കൊണ്ടാണ്.,0,0,1,1
25384,അസാധാരണമായി,0,0,1,1
25382,दृश्य,0,0,1,1
25409,അവലംബങ്ങളും==ഉരുൾപൊട്ടൽ,0,0,1,1
25366,engendra,0,0,1,1
25350,धीरे,0,0,1,1
25351,yung-lo,0,0,1,1
25354,viande,0,0,1,1
25355,अवधारणा,0,0,1,1
25356,ಬಳಸುವುದು,0,0,1,1
25357,ودقتها.,0,0,1,1
25364,cifras,0,0,1,1
25370,அச்சுறுத்தல்,0,0,1,1
25380,മാച്ചു,0,0,1,1
25371,promouvoir,0,0,1,1
25373,talar,0,0,1,1
25374,mentionnez,0,0,1,1
25375,ಮಟ್ಟಿಗೆ,0,0,1,1
25376,respondem,0,0,1,1
25377,inserida,0,0,1,1
25378,подборку,0,0,1,1
25408,dispensés,0,0,1,1
25411,прецедентам,0,0,1,1
25348,forme.,0,0,1,1
25457,“சி.எசு.எசு.”,0,0,1,1
25447,äktenskap,0,0,1,1
25448,prononcez,0,0,1,1
25450,لبعضهما,0,0,1,1
25451,stocker,0,0,1,1
25452,retoma,0,0,1,1
25453,contemporain,0,0,1,1
25454,customers,0,0,1,1
25458,αλήθεια.,0,0,1,1
25444,guerel,0,0,1,1
25460,பயணித்தது.,0,0,1,1
25462,formuleringsarbetet,0,0,1,1
25463,क्रोएशियाई,0,0,1,1
25464,register,0,0,1,1
25465,рекламы.,0,0,1,1
25466,verkade,0,0,1,1
25470,contradictory,0,0,1,1
25445,intellectuel,0,0,1,1
25443,முரட்டுத்தனமாக,0,0,1,1
25412,prisoners,0,0,1,1
25422,movida,0,0,1,1
25413,microsystems,0,0,1,1
25415,spécialisés,0,0,1,1
25416,motivated,0,0,1,1
25417,neutralt,0,0,1,1
25418,ವಿಷಾದಿಸುತ್ತೇನೆ.,0,0,1,1
25420,റിക്ക്,0,0,1,1
25421,contribuem,0,0,1,1
25426,ಅಳಬೇಡ,0,0,1,1
25441,செயற்பட,0,0,1,1
25427,रुचि,0,0,1,1
25428,проснулся,0,0,1,1
25430,отличие,0,0,1,1
25433,vegetabilia,0,0,1,1
25434,voices,0,0,1,1
25436,decisivas,0,0,1,1
25438,lv •,0,0,1,1
25349,'si,0,0,1,1
25347,ifadeler.,0,0,1,1
25218,विकिकोटे,0,0,1,1
25261,annesine,0,0,1,1
25248,d'édition,0,0,1,1
25251,neerzet.,0,0,1,1
25254,disso.,0,0,1,1
25255,espagnole.,0,0,1,1
25257,oriente,0,0,1,1
25259,كاذبة,0,0,1,1
25260,حادثة,0,0,1,1
25264,moles.,0,0,1,1
25246,ക്രിയേറ്റീവ്,0,0,1,1
25266,paralelos,0,0,1,1
25267,беспокою,0,0,1,1
25268,ممل,0,0,1,1
25269,list.,0,0,1,1
25271,umursamıyorsun.,0,0,1,1
25273,وفهرسة,0,0,1,1
25279,தொடர்வதற்கு,0,0,1,1
25247,humorísticas,0,0,1,1
25245,jouait,0,0,1,1
25281,controversiales,0,0,1,1
25228,πεινάτε,0,0,1,1
25219,глаза.,0,0,1,1
25220,oprindelse,0,0,1,1
25221,blague.,0,0,1,1
25222,o'reilly,0,0,1,1
25223,læser,0,0,1,1
25226,librarianship,0,0,1,1
25227,കമ്പ്യൂട്ടറുകളെ,0,0,1,1
25229,sevgili,0,0,1,1
25244,exceptionally,0,0,1,1
25232,مجلة أدبيات,0,0,1,1
25233,لذلك.,0,0,1,1
25235,ವೈಯಕ್ತಿಕವಾಗಿ,0,0,1,1
25237,ग्रह,0,0,1,1
25238,øje,0,0,1,1
25241,منه.,0,0,1,1
25242,முடிந்துவிடும்,0,0,1,1
25280,மூழ்கிவிடும்,0,0,1,1
25282,мясо,0,0,1,1
25346,manske,0,0,1,1
25337,ಹೇಳುವದನ್ನು,0,0,1,1
25322,प्राधिकरण,0,0,1,1
25323,unie,0,0,1,1
25325,middelen,0,0,1,1
25329,இங்கே.,0,0,1,1
25330,lusófona,0,0,1,1
25331,yielded,0,0,1,1
25333,γεμίσουμε,0,0,1,1
25338,incorporate,0,0,1,1
25318,wikipedia-artikler.,0,0,1,1
25339,entities,0,0,1,1
25340,retirar,0,0,1,1
25341,использована,0,0,1,1
25342,ലഭിച്ചില്ല,0,0,1,1
25343,microfilm.,0,0,1,1
25344,അവതരിപ്പിക്കുമ്പോൾ,0,0,1,1
25345,åttonde,0,0,1,1
25319,jämförde,0,0,1,1
25317,culturais.,0,0,1,1
25289,sedan.,0,0,1,1
25299,നിർത്തിയപ്പോൾ,0,0,1,1
25290,الشقيقة،,0,0,1,1
25292,rápido»​,0,0,1,1
25293,lithosphere,0,0,1,1
25294,വിനീതവും,0,0,1,1
25295,publicasse,0,0,1,1
25297,بنظرة,0,0,1,1
25298,¿tengo,0,0,1,1
25300,правильной,0,0,1,1
25314,серьезной,0,0,1,1
25302,некоторое,0,0,1,1
25304,ifrågasatts,0,0,1,1
25306,referencias,0,0,1,1
25307,ಗೊಂದಲಕ್ಕೊಳಗಾದ,0,0,1,1
25308,duits-,0,0,1,1
25311,kararı,0,0,1,1
25312,wezens,0,0,1,1
27876,ആരുണ്ടാക്കി,0,0,1,1
27878,بالشفرة,0,0,1,1
24042,допустил,0,0,1,1
30247,billions,0,0,1,1
30390,എമ്മിൽ,0,0,1,1
30392,имеешь,0,0,1,1
30393,brusca,0,0,1,1
30394,ಚತುರನಾಗಿದ್ದನು.,0,0,1,1
30395,இக்,0,0,1,1
30396,συνέχεια,0,0,1,1
30398,commandement,0,0,1,1
30399,हिब्रू,0,0,1,1
30402,prit,0,0,1,1
30404,requiring,0,0,1,1
30405,names.,0,0,1,1
30408,genoegen,0,0,1,1
30409,lleve,0,0,1,1
30410,математического,0,0,1,1
30411,നേടിയിട്ടുണ്ടെങ്കിൽ,0,0,1,1
30412,eye,0,0,1,1
30413,जावानी,0,0,1,1
30389,connecting,0,0,1,1
30388,herzlich,0,0,1,1
30387,ediyordum.,0,0,1,1
30372,وسأكون,0,0,1,1
30363,عفوا؟,0,0,1,1
30364,panela.,0,0,1,1
30365,зол.,0,0,1,1
30368,نحن',0,0,1,1
30369,défendent,0,0,1,1
30370,totally,0,0,1,1
30371,recovery,0,0,1,1
30373,മോശമായ,0,0,1,1
30386,कील,0,0,1,1
30374,пересматривают,0,0,1,1
30375,ಹೆಣಗಾಡುತ್ತಿದ್ದ,0,0,1,1
30377,kurohin.,0,0,1,1
30380,невозможную,0,0,1,1
30381,çıktı,0,0,1,1
30383,euh.,0,0,1,1
30385,anônima,0,0,1,1
30415,upptäckte,0,0,1,1
30418,പതിപ്പുകളുണ്ട്.,0,0,1,1
30421,использованием,0,0,1,1
30464,حقوق,0,0,1,1
30456,« violation,0,0,1,1
30457,consideremos,0,0,1,1
30458,भत्ते,0,0,1,1
30460,crédito,0,0,1,1
30461,കാണാൻ.,0,0,1,1
30462,escolas,0,0,1,1
30463,الخيارات,0,0,1,1
30467,hangi,0,0,1,1
30454,rosário,0,0,1,1
30469,förklara,0,0,1,1
30470,ஊமை,0,0,1,1
30471,الضابطة,0,0,1,1
30472,المقاومة,0,0,1,1
30473,cevap,0,0,1,1
30474,വേണ്ടത്ര,0,0,1,1
30476,உட்பட்டுவரும்,0,0,1,1
30455,நினைத்துப்,0,0,1,1
30452,sauvegarde,0,0,1,1
30422,ആദ്യത്തേത്,0,0,1,1
30436,предлагаемой,0,0,1,1
30423,feed,0,0,1,1
30424,ഉണ്ടാവാം.,0,0,1,1
30425,συνδυασμό,0,0,1,1
30427,ಹೆಸರನ್ನು,0,0,1,1
30429,ошибка.,0,0,1,1
30431,seront,0,0,1,1
30434,шоу,0,0,1,1
30439,रेडियो,0,0,1,1
30451,टर्म,0,0,1,1
30440,αναζήτηση,0,0,1,1
30443,yorker,0,0,1,1
30444,neurales',0,0,1,1
30446,woordenschat,0,0,1,1
30447,ದಾಟುತ್ತೀರಿ.,0,0,1,1
30449,d'annulations,0,0,1,1
30450,redigeringsgränssnitt,0,0,1,1
30362,pai,0,0,1,1
30361,assistindo,0,0,1,1
30360,raisonnement,0,0,1,1
30289,ஒருவரைச்,0,0,1,1
30281,كثيرا.,0,0,1,1
30282,«bibliotecario»,0,0,1,1
30283,प्रारम्भ,0,0,1,1
30284,ranches,0,0,1,1
30285,പ്രയോഗിച്ചുകൊണ്ടാണ്.,0,0,1,1
30286,continent,0,0,1,1
30288,neatly,0,0,1,1
30290,طورت,0,0,1,1
30278,géants,0,0,1,1
30293,நோக்கற்ற,0,0,1,1
30294,बचना।,0,0,1,1
30295,atende,0,0,1,1
30296,antigüedad.,0,0,1,1
30297,നിർഭാഗ്യവശാൽ,0,0,1,1
30298,മടിക്കുന്നു.,0,0,1,1
30299,låst,0,0,1,1
30280,acepto,0,0,1,1
30277,kanılara,0,0,1,1
30301,gráfico.,0,0,1,1
30259,bekle.,0,0,1,1
30251,अमान्य,0,0,1,1
30252,talimatları,0,0,1,1
30253,pitts,0,0,1,1
30254,ψάχνετε,0,0,1,1
30255,progressivement,0,0,1,1
30256,جوعا,0,0,1,1
30258,தேர்வுகள்,0,0,1,1
30260,envision,0,0,1,1
30276,உரையாடலையும்,0,0,1,1
30262,däremot,0,0,1,1
30263,दिखायी,0,0,1,1
30265,beleidigend,0,0,1,1
30271,ಪ್ರಜ್ಞೆಯು,0,0,1,1
30272,ಕೊಡುವಷ್ಟು,0,0,1,1
30274,المحايدة،,0,0,1,1
30275,[any,0,0,1,1
30300,vikipedisine,0,0,1,1
30302,bahsetmişken,0,0,1,1
30359,بليدًا,0,0,1,1
30343,bekämpar,0,0,1,1
30334,clásicas,0,0,1,1
30335,niveles,0,0,1,1
30337,gepubliceerd,0,0,1,1
30338,servrarna,0,0,1,1
30340,ആവർത്തനം,0,0,1,1
30341,എന്നില്ല.,0,0,1,1
30342,അടിച്ചേൽപ്പിക്കാൻ,0,0,1,1
30344,ಸಾಮಾನ್ಯವಾಗಿ,0,0,1,1
30332,चेहरे,0,0,1,1
30348,chiques,0,0,1,1
30349,inherited,0,0,1,1
30351,juges,0,0,1,1
30353,disseminá-lo,0,0,1,1
30354,πλούσιος,0,0,1,1
30355,τρομερός,0,0,1,1
30356,لإصلاحها.,0,0,1,1
30333,izin.,0,0,1,1
30329,esszimmer,0,0,1,1
30304,sebeple,0,0,1,1
30314,الأمريكية،,0,0,1,1
30305,djupintervjuer,0,0,1,1
30306,ಬೆರಗುಗೊಳಿಸುವ.,0,0,1,1
30307,källförteckningens,0,0,1,1
30308,mêmes,0,0,1,1
30309,fundó,0,0,1,1
30310,ستساعدني,0,0,1,1
30313,fundamentalmente,0,0,1,1
30316,türk,0,0,1,1
30328,weggeschickt,0,0,1,1
30317,nationale,0,0,1,1
30318,ओ,0,0,1,1
30319,oxfordsystemet,0,0,1,1
30321,disagree.,0,0,1,1
30323,ആവശ്യമാണെന്ന്,0,0,1,1
30324,whom,0,0,1,1
30326,hemel,0,0,1,1
30478,”the,0,0,1,1
30479,soumises,0,0,1,1
30480,झिझक,0,0,1,1
30635,للكلمة,0,0,1,1
30626,വ്യവസ്ഥിതിയുടെ,0,0,1,1
30627,лауреат,0,0,1,1
30628,எவ்வாறு,0,0,1,1
30629,pratik,0,0,1,1
30630,கற்றுக்கொண்டோம்,0,0,1,1
30631,kedeligt.,0,0,1,1
30633,electrónico,0,0,1,1
30636,renforcement.,0,0,1,1
30624,synthetic,0,0,1,1
30640,occur,0,0,1,1
30642,oradaki,0,0,1,1
30643,ಬೀಜಗಳನ್ನು,0,0,1,1
30644,şövalye,0,0,1,1
30645,ख्मेर,0,0,1,1
30648,d'empirisme,0,0,1,1
30649,utilizó,0,0,1,1
30625,позиционирует,0,0,1,1
30622,değmez,0,0,1,1
30654,ast •,0,0,1,1
30610,επανάληψη.,0,0,1,1
30597,l'intervalle,0,0,1,1
30598,يفسر,0,0,1,1
30601,പരിശീലിപ്പിക്കുകയാണെങ്കിൽ,0,0,1,1
30602,søde,0,0,1,1
30605,vision‏,0,0,1,1
30606,читаю,0,0,1,1
30609,arrastar,0,0,1,1
30611,conterem,0,0,1,1
30620,insan,0,0,1,1
30612,καροτσάκι,0,0,1,1
30613,μάθουμε,0,0,1,1
30614,остановка,0,0,1,1
30616,പുഞ്ചിരി,0,0,1,1
30617,பிடிப்பு,0,0,1,1
30618,английского,0,0,1,1
30619,applicants.,0,0,1,1
30652,staten,0,0,1,1
30655,ചേർത്തുകൊള്ളണം,0,0,1,1
30595,विवाद,0,0,1,1
30695,d'assurer,0,0,1,1
30686,ದೂರುವುದು,0,0,1,1
30688,tråkigt.,0,0,1,1
30689,nine-tenths,0,0,1,1
30690,demuestre,0,0,1,1
30691,இதிலுள்ள,0,0,1,1
30693,бедной,0,0,1,1
30694,fotosafari,0,0,1,1
30698,eğilimindeyiz.,0,0,1,1
30683,diferença,0,0,1,1
30700,ηρεμήσεις,0,0,1,1
30701,δημιουργηθεί,0,0,1,1
30702,comparatif,0,0,1,1
30704,ಜೈಲುಗಳಲ್ಲಿ,0,0,1,1
30705,வருத்தப்படுகிறார்.,0,0,1,1
30708,pojkvän,0,0,1,1
30709,truthfulness,0,0,1,1
30684,அனுப்புங்கள்,0,0,1,1
30682,செய்யக்கூடாது,0,0,1,1
30656,പ്രവർത്തിച്ചവർ,0,0,1,1
30667,activist,0,0,1,1
30657,boede,0,0,1,1
30658,communauté.,0,0,1,1
30659,glada,0,0,1,1
30660,புரியாத,0,0,1,1
30662,helpen.,0,0,1,1
30663,ಉಪಯುಕ್ತ,0,0,1,1
30665,kvalitestsbrister,0,0,1,1
30670,contrat.,0,0,1,1
30681,élever,0,0,1,1
30671,reais,0,0,1,1
30672,выполнения,0,0,1,1
30674,കേരളത്തിലുള്ളവർക്ക്,0,0,1,1
30675,basarak,0,0,1,1
30678,ചപ്പും,0,0,1,1
30679,gerenommeerde,0,0,1,1
30680,företeelse,0,0,1,1
30596,waarvan,0,0,1,1
30594,продуктов,0,0,1,1
30481,أوباما,0,0,1,1
30516,பாராட்டுகிறேன்.,0,0,1,1
30508,strategisk,0,0,1,1
30509,ചെയ്തിട്ടില്ലെങ്കിൽ,0,0,1,1
30510,judío,0,0,1,1
30511,அன்றிலிருந்து,0,0,1,1
30512,véneto,0,0,1,1
30514,yaptığınız,0,0,1,1
30515,وبراون،,0,0,1,1
30517,قلت,0,0,1,1
30506,« ville,0,0,1,1
30518,detaljerat,0,0,1,1
30520,yapmamız,0,0,1,1
30521,λογότυπο,0,0,1,1
30522,ವಿಷಯವನ್ನು,0,0,1,1
30523,правилам,0,0,1,1
30524,हालांकि,0,0,1,1
30525,اختباري,0,0,1,1
30507,τελειώσουν,0,0,1,1
30505,പ്രാധാന്യമുണ്ട്.,0,0,1,1
30529,developing,0,0,1,1
30492,hittade,0,0,1,1
30482,guia,0,0,1,1
30485,غدا؟,0,0,1,1
30486,вижу,0,0,1,1
30487,difamá-los.,0,0,1,1
30489,география,0,0,1,1
30490,വിക്കിപീഡിയർക്കോ,0,0,1,1
30491,sayfasını,0,0,1,1
30494,discern,0,0,1,1
30503,karakter,0,0,1,1
30495,ряд,0,0,1,1
30497,indo.,0,0,1,1
30498,publicitaire[réf.,0,0,1,1
30499,grupparbeten,0,0,1,1
30500,മാന്ത്രികജീവികളായിരുന്നു,0,0,1,1
30501,molten,0,0,1,1
30502,sonra.,0,0,1,1
30527,sevdiğin,0,0,1,1
30532,சொல்கிறது.,0,0,1,1
30593,overused,0,0,1,1
30582,predesignated,0,0,1,1
30572,kwaad,0,0,1,1
30574,ശ്രമകരമായിത്തോന്നാം.,0,0,1,1
30575,कॉर्निश,0,0,1,1
30576,sostienen,0,0,1,1
30577,المجاني,0,0,1,1
30578,döndü.,0,0,1,1
30580,conférences,0,0,1,1
30583,സുവേ,0,0,1,1
30570,नार्सिसस,0,0,1,1
30585,وهما,0,0,1,1
30587,....क्या,0,0,1,1
30588,medewerkers.,0,0,1,1
30589,പരിഹാരത്തിലായിരിക്കുമ്പോൾ,0,0,1,1
30590,होमवर्क,0,0,1,1
30591,اعتن,0,0,1,1
30592,çevreleyen,0,0,1,1
30571,ulteriores,0,0,1,1
30568,jobs,0,0,1,1
30535,verschijnen.,0,0,1,1
30549,arbejder,0,0,1,1
30537,சாப்பிடு.,0,0,1,1
30538,survival,0,0,1,1
30541,كاليفورنيا,0,0,1,1
30542,oviedo,0,0,1,1
30545,yanındaki,0,0,1,1
30547,funções,0,0,1,1
30548,പ്രമുഖ,0,0,1,1
30551,fracaso,0,0,1,1
30567,ನೀಡೋಣ.,0,0,1,1
30555,സുന്ദരിയാകാൻ,0,0,1,1
30556,rechazado,0,0,1,1
30561,மார்ச்,0,0,1,1
30562,сидят,0,0,1,1
30564,опубликовавшими,0,0,1,1
30565,incompatibles.,0,0,1,1
30566,διεθνής,0,0,1,1
30248,inteiramente,0,0,1,1
30246,إفراغ,0,0,1,1
30712,schatz,0,0,1,1
30245,soffa.,0,0,1,1
29922,автоматизация,0,0,1,1
29924,motsätter,0,0,1,1
29925,recombined,0,0,1,1
29926,യന്ത്രപഠനമാണ്.,0,0,1,1
29927,தயாரித்தேன்,0,0,1,1
29928,déplace,0,0,1,1
29930,scoren,0,0,1,1
29931,excel,0,0,1,1
29932,arkivversionen,0,0,1,1
29934,s'impose,0,0,1,1
29935,frotté,0,0,1,1
29936,indonésio,0,0,1,1
29937,dérange,0,0,1,1
29941,wikiscanner.,0,0,1,1
29942,कोमी,0,0,1,1
29943,tebrik,0,0,1,1
29945,ಖಂಡಿತ.,0,0,1,1
29920,retirados,0,0,1,1
29919,கேள்வியைக்,0,0,1,1
29917,ಮಾತನಾಡುತ್ತಾ,0,0,1,1
29905,திருமணத்திற்கு,0,0,1,1
29895,d'animaux,0,0,1,1
29896,mediawiki's,0,0,1,1
29897,l'enseignement,0,0,1,1
29900,اقتراحك.,0,0,1,1
29901,citem,0,0,1,1
29902,விளக்குங்கள்,0,0,1,1
29904,cümlenin,0,0,1,1
29906,diz...,0,0,1,1
29916,nonprofit,0,0,1,1
29907,विकिपिडियन,0,0,1,1
29908,privada.,0,0,1,1
29909,vorschläge.,0,0,1,1
29910,ಸಾಧ್ಯವಾಗದಿದ್ದರೆ,0,0,1,1
29911,l'après-midi,0,0,1,1
29914,taïwan.,0,0,1,1
29915,llevas,0,0,1,1
29946,dichotomy,0,0,1,1
29947,siga,0,0,1,1
29948,живём,0,0,1,1
29993,остановить»,0,0,1,1
29983,doğrulanabilecek,0,0,1,1
29984,खोये,0,0,1,1
29985,политической,0,0,1,1
29986,سيئة,0,0,1,1
29988,ludique,0,0,1,1
29990,t'inquiète,0,0,1,1
29991,olsam,0,0,1,1
29994,diferencias,0,0,1,1
29980,എസ്എംഎസ്,0,0,1,1
29996,hábitos,0,0,1,1
29997,tijdschrift.,0,0,1,1
29998,d'indexation,0,0,1,1
29999,clustering.,0,0,1,1
30000,οικουμενικής,0,0,1,1
30001,mbh,0,0,1,1
30002,أراه,0,0,1,1
29982,probeert,0,0,1,1
29979,വിവരസ്രോതസ്സുകളും,0,0,1,1
29950,движется,0,0,1,1
29963,हीरों,0,0,1,1
29953,şaşırdı.,0,0,1,1
29954,landed,0,0,1,1
29955,märkspråk,0,0,1,1
29956,não-wiki,0,0,1,1
29959,hapşırdığında,0,0,1,1
29960,டிரைவ்வேயை,0,0,1,1
29961,meines,0,0,1,1
29964,γεωμετρία,0,0,1,1
29978,geträumt,0,0,1,1
29969,marmeladen,0,0,1,1
29970,fing,0,0,1,1
29972,മുൻപുള്ള,0,0,1,1
29973,തിരഞ്ഞെടുപ്പുകളെക്കുറിച്ച്,0,0,1,1
29974,eski,0,0,1,1
29976,proíbem,0,0,1,1
29977,problemáticos,0,0,1,1
29894,semibeskyttet,0,0,1,1
29892,главной,0,0,1,1
29891,adopción,0,0,1,1
29817,license.,0,0,1,1
29809,larmes.,0,0,1,1
29810,biodiésel.,0,0,1,1
29811,yiyecekler,0,0,1,1
29813,பொருள்படும்,0,0,1,1
29814,கிராமத்தில்,0,0,1,1
29815,tänt,0,0,1,1
29816,unbeschreiblich,0,0,1,1
29818,अंगूठा,0,0,1,1
29807,aldeia,0,0,1,1
29820,بنهاية,0,0,1,1
29821,ಸಲಾಡ್,0,0,1,1
29823,barnstars,0,0,1,1
29824,levens,0,0,1,1
29825,ages,0,0,1,1
29826,الجميلة.,0,0,1,1
29828,നൽ‌കും.,0,0,1,1
29808,kino,0,0,1,1
29806,vérification,0,0,1,1
29830,konsultera,0,0,1,1
29795,частично,0,0,1,1
29787,poängterar,0,0,1,1
29789,primeiras,0,0,1,1
29790,bloqué,0,0,1,1
29791,måneden.,0,0,1,1
29792,برقية,0,0,1,1
29793,исследования.,0,0,1,1
29794,கொண்டிருந்தாள்.,0,0,1,1
29796,இராணுவத்தால்,0,0,1,1
29805,pl •,0,0,1,1
29797,inhoudelijke,0,0,1,1
29799,വിക്കിപീഡിയയിൽ.,0,0,1,1
29800,tribunal.,0,0,1,1
29801,अनजाने,0,0,1,1
29802,albümüdür,0,0,1,1
29803,categorize,0,0,1,1
29804,ಪ್ರಯತ್ನಿಸಿ,0,0,1,1
29829,έρχονται,0,0,1,1
29831,ನಾರ್ಸಿಸಾದ,0,0,1,1
29890,téléspectateurs,0,0,1,1
29878,ಎತ್ತಿಕೊಳ್ಳಲಾಗಿದೆ.,0,0,1,1
29866,പക്ഷിയുടെതുപോലെയുള്ള,0,0,1,1
29867,serbian,0,0,1,1
29869,فيوجد,0,0,1,1
29871,attorney,0,0,1,1
29873,végétaux,0,0,1,1
29874,publikationer,0,0,1,1
29876,benutze.,0,0,1,1
29879,wortnummer,0,0,1,1
29862,breaks”,0,0,1,1
29882,വരുത്തുവാൻ,0,0,1,1
29883,certas,0,0,1,1
29884,praticar,0,0,1,1
29885,labels.,0,0,1,1
29887,التكرار.,0,0,1,1
29888,gidelim,0,0,1,1
29889,miradas,0,0,1,1
29863,لمجادلتهم.,0,0,1,1
29860,പടയാളികളും,0,0,1,1
29834,умно,0,0,1,1
29847,φυλακισμένοι,0,0,1,1
29837,നിർമ്മിക്കുവാനുള്ള,0,0,1,1
29839,κρατήσουμε,0,0,1,1
29840,s'illustrera,0,0,1,1
29843,ജനനം,0,0,1,1
29844,கூட்டுப்,0,0,1,1
29845,helion,0,0,1,1
29846,«быть,0,0,1,1
29848,forem,0,0,1,1
29859,gemensamt,0,0,1,1
29849,ಬಸವನ,0,0,1,1
29850,agréable,0,0,1,1
29851,hackernoon,0,0,1,1
29852,«быстро»,0,0,1,1
29853,разведывательного,0,0,1,1
29857,ಬೆಳ್ಳಿ,0,0,1,1
29858,distinguant,0,0,1,1
30003,cavaleiro.,0,0,1,1
30004,daarbij,0,0,1,1
30005,underholdende,0,0,1,1
30175,десятка».,0,0,1,1
30165,domaine ,0,0,1,1
30166,وترى,0,0,1,1
30167,ಡ್ರಿಂಕ್‌ನೊಂದಿಗೆ,0,0,1,1
30169,jean,0,0,1,1
30170,मई,0,0,1,1
30172,फ़िनिश,0,0,1,1
30173,constable,0,0,1,1
30176,split,0,0,1,1
30163,hoaxen,0,0,1,1
30179,ahogarse,0,0,1,1
30182,journalists,0,0,1,1
30183,ख़बरों,0,0,1,1
30184,टूटा,0,0,1,1
30185,reinvention,0,0,1,1
30186,dessus,0,0,1,1
30188,उल्लेखनीय,0,0,1,1
30164,أسئلة,0,0,1,1
30162,produce.,0,0,1,1
30190,आना,0,0,1,1
30144,lustres,0,0,1,1
30134,granskning.,0,0,1,1
30136,esforços,0,0,1,1
30137,ನೋಡುತ್ತದೆ.,0,0,1,1
30140,terugkomen.,0,0,1,1
30141,занимает,0,0,1,1
30142,الجانب,0,0,1,1
30143,ചാടിയാൽ,0,0,1,1
30147,vacilando.,0,0,1,1
30159,derniers,0,0,1,1
30148,konversation,0,0,1,1
30149,ಅಭಿನಂದನೆಗಳು,0,0,1,1
30150,forkert.,0,0,1,1
30152,द्वितीय,0,0,1,1
30153,sanırım,0,0,1,1
30155,ಒಪ್ಪುವುದಿಲ್ಲ,0,0,1,1
30156,públicos,0,0,1,1
30189,regrouper,0,0,1,1
30194,polícia,0,0,1,1
30131,isimli,0,0,1,1
30231,للطريقة,0,0,1,1
30223,சந்திக்கிறீர்கள்,0,0,1,1
30224,lezers,0,0,1,1
30226,phenomena,0,0,1,1
30227,kelimelerinin,0,0,1,1
30228,ഉത്സാഹം,0,0,1,1
30229,bitecek.,0,0,1,1
30230,signifie.,0,0,1,1
30232,cpus,0,0,1,1
30221,vuil,0,0,1,1
30236,மந்தமாகிவிட்டது,0,0,1,1
30237,уловкой-,0,0,1,1
30239,தோல்விகளுக்குப்,0,0,1,1
30240,ரூபி,0,0,1,1
30242,fato,0,0,1,1
30243,encouraged,0,0,1,1
30244,bemærke,0,0,1,1
30222,verschiedenen,0,0,1,1
30220,emocionamos,0,0,1,1
30197,உள்ள,0,0,1,1
30207,secondaire,0,0,1,1
30198,gewaltig,0,0,1,1
30199,desfrutam,0,0,1,1
30200,دعنى,0,0,1,1
30202,euskera,0,0,1,1
30203,discrepancy,0,0,1,1
30204,webben.,0,0,1,1
30206,தமக்கு,0,0,1,1
30208,स्वयंसेवक,0,0,1,1
30218,retener,0,0,1,1
30209,κάποτε,0,0,1,1
30210,плачете,0,0,1,1
30211,administrados,0,0,1,1
30212,intelligens,0,0,1,1
30214,millennium,0,0,1,1
30215,artists,0,0,1,1
30217,processamento,0,0,1,1
30133,நினைத்தேன்.,0,0,1,1
30130,specialistische,0,0,1,1
30006,glaciation.,0,0,1,1
30050,ekmeme,0,0,1,1
30040,ಗೊಂದಲಕ್ಕೊಳಗಾಗಿದ್ದರೆ,0,0,1,1
30041,നിന്നെക്കുറിച്ച്,0,0,1,1
30042,l'obligation,0,0,1,1
30043,കാര്യം,0,0,1,1
30044,anglaises,0,0,1,1
30047,υπενθυμίσω.,0,0,1,1
30048,nivå,0,0,1,1
30051,ಹಿಂಜರಿಯುತ್ತಿದೆ.,0,0,1,1
30033,energiebeispiel,0,0,1,1
30054,വെള്ളപ്പൊക്കം,0,0,1,1
30056,betroffen,0,0,1,1
30058,எட்டு,0,0,1,1
30059,lütfen.,0,0,1,1
30062,അർത്ഥമാക്കുന്നു.,0,0,1,1
30063,இலக்கணம்,0,0,1,1
30064,μαριάν,0,0,1,1
30039,genera,0,0,1,1
30032,proveito,0,0,1,1
30068,ಕೇಳುತ್ತಿದ್ದಾರೆ,0,0,1,1
30016,partner,0,0,1,1
30007,സംസാരിച്ചിരിക്കാം,0,0,1,1
30008,parecía,0,0,1,1
30009,உச்சரிப்பைக்,0,0,1,1
30010,referendum,0,0,1,1
30013,മാതൃകകളിൽ,0,0,1,1
30014,humana,0,0,1,1
30015,göra.,0,0,1,1
30017,males,0,0,1,1
30030,инкубаторе.,0,0,1,1
30018,yazılarına,0,0,1,1
30019,பணக்காரர்,0,0,1,1
30020,implementar,0,0,1,1
30024,[...]»,0,0,1,1
30025,ಐಸ್,0,0,1,1
30028,gøres,0,0,1,1
30029,consacrés,0,0,1,1
30065,नमस्ते,0,0,1,1
30069,importo,0,0,1,1
30129,falsedad,0,0,1,1
30112,видите,0,0,1,1
30102,formerly,0,0,1,1
30104,begegnete,0,0,1,1
30105,ಜೋಸೆಫ್,0,0,1,1
30108,¿tienes,0,0,1,1
30109,അത്ഭുതപ്പെട്ടു.,0,0,1,1
30110,пытался,0,0,1,1
30111,«зверство»,0,0,1,1
30113,michelle,0,0,1,1
30100,πρώτη,0,0,1,1
30115,ആഗ്രഹിക്കുന്നതെന്തും,0,0,1,1
30116,cierto,0,0,1,1
30120,पैमाने,0,0,1,1
30121,प्रेमिका,0,0,1,1
30122,بالحيرة,0,0,1,1
30125,human-like,0,0,1,1
30128,empêchant,0,0,1,1
30101,caltech-studenten,0,0,1,1
30099,« instruction »,0,0,1,1
30070,sammanhang,0,0,1,1
30081,]de,0,0,1,1
30072,semantisk,0,0,1,1
30075,d’extrapolation.,0,0,1,1
30076,ശക്തി.,0,0,1,1
30077,للهوية,0,0,1,1
30078,conspirar.,0,0,1,1
30079,عزا,0,0,1,1
30080,награды,0,0,1,1
30083,البيانات،,0,0,1,1
30097,தெரியவில்லை,0,0,1,1
30084,  cd-rom,0,0,1,1
30085,parçasını,0,0,1,1
30086,என்பதற்குப்,0,0,1,1
30087,comboio,0,0,1,1
30088,politik,0,0,1,1
30092,الجامعات،,0,0,1,1
30095,conselho,0,0,1,1
30710,доступен,0,0,1,1
30713,confusion,0,0,1,1
29785,.wir,0,0,1,1
31220,modifiable,0,0,1,1
31378,تسأله.,0,0,1,1
31382,governamental,0,0,1,1
31383,ನೋಡುವುದಿಲ್ಲ,0,0,1,1
31384,великобритании,0,0,1,1
31385,случаются,0,0,1,1
31386,κοχύλι,0,0,1,1
31388,विकियात्रा,0,0,1,1
31389,محرك,0,0,1,1
31390,besöka,0,0,1,1
31391,anarchism,0,0,1,1
31392,زمن,0,0,1,1
31394,uruguay.,0,0,1,1
31395,உபயோகிக்கப்படுகின்றது.,0,0,1,1
31396,ഉണ്ടായത്,0,0,1,1
31397,accountability,0,0,1,1
31398,صرف,0,0,1,1
31400,ടെലിഗ്രാം,0,0,1,1
31377,बेहतरीन,0,0,1,1
31375,സ്ഥാനക്കയറ്റം,0,0,1,1
31374,denoting,0,0,1,1
31358,mythique,0,0,1,1
31350,archief,0,0,1,1
31351,fantastiques,0,0,1,1
31352,ಸಾಮಾನ್ಯಕ್ಕಿಂತ.,0,0,1,1
31353,mönstret,0,0,1,1
31354,coule,0,0,1,1
31356,ആഗ്രഹിക്കുന്നില്ല,0,0,1,1
31357,சாப்பிடமுடியாத,0,0,1,1
31359,regulate,0,0,1,1
31370,ziyaret,0,0,1,1
31363,crash.,0,0,1,1
31364,lavar,0,0,1,1
31365,våldtäktsincidenterna,0,0,1,1
31366,désacralisé,0,0,1,1
31367,mediawikiservern.,0,0,1,1
31368,respekterar,0,0,1,1
31369,ಕಾಣುತ್ತಿದ್ದೀರಿ,0,0,1,1
31401,sevk,0,0,1,1
31403,decision-making,0,0,1,1
31404,amaba,0,0,1,1
31447,angenehmes,0,0,1,1
31437,ಸಂದರ್ಭದಲ್ಲಿ,0,0,1,1
31438,glücklich,0,0,1,1
31440,ഇഷ്ടമാണ്,0,0,1,1
31442,للتغيير.,0,0,1,1
31443,глобальное,0,0,1,1
31444,وأبل,0,0,1,1
31446,season,0,0,1,1
31449,renvoie,0,0,1,1
31435,resultaram,0,0,1,1
31451,plaatsen.,0,0,1,1
31453,ജോലിഭാരം,0,0,1,1
31455,சுற்றி,0,0,1,1
31456,absurd,0,0,1,1
31457,யோசித்துக்கொண்டிருந்தேன்.,0,0,1,1
31458,bağımsız,0,0,1,1
31459,d'engendrement,0,0,1,1
31436,qualitatif,0,0,1,1
31434,डैनिश,0,0,1,1
31405,расстроен,0,0,1,1
31416,schmutz,0,0,1,1
31406,hulpmiddelen,0,0,1,1
31407,japanse,0,0,1,1
31409,добровольцев,0,0,1,1
31411,haklarından,0,0,1,1
31412,очереди,0,0,1,1
31413,γίνουμε,0,0,1,1
31415,clara.,0,0,1,1
31417,sürümleri,0,0,1,1
31432,annorlunda,0,0,1,1
31419,gezicht,0,0,1,1
31422,утонченным,0,0,1,1
31423,лишена,0,0,1,1
31426,посетителям,0,0,1,1
31428,conçue,0,0,1,1
31429,போலல்லாது,0,0,1,1
31430,syftar,0,0,1,1
31349,ನೀವಿರಿ,0,0,1,1
31348,पुनः,0,0,1,1
31347,mentally,0,0,1,1
31261,разговор,0,0,1,1
31254,αντιφατικούς,0,0,1,1
31255,kända,0,0,1,1
31256,indsats.,0,0,1,1
31257,குறிப்பிட்டுள்ளது.,0,0,1,1
31258,conceitos,0,0,1,1
31259,γέλια,0,0,1,1
31260,العادات,0,0,1,1
31262,планете,0,0,1,1
31252,учреждений,0,0,1,1
31264,teniendo,0,0,1,1
31266,خاطئًا,0,0,1,1
31267,ta •,0,0,1,1
31270,recolección,0,0,1,1
31271,bence,0,0,1,1
31273,aménagés,0,0,1,1
31274,pessoalmente,0,0,1,1
31253,تعقب,0,0,1,1
31251,значительное,0,0,1,1
31279,هيا.,0,0,1,1
31238,raderats.,0,0,1,1
31223,corroborado,0,0,1,1
31225,समझाएं,0,0,1,1
31227,contributrices,0,0,1,1
31228,tons,0,0,1,1
31229,formål,0,0,1,1
31230,anexadas,0,0,1,1
31234,лицо,0,0,1,1
31239,чихнул,0,0,1,1
31249,biomedical,0,0,1,1
31240,quantité.,0,0,1,1
31241,ik',0,0,1,1
31242,resultados​,0,0,1,1
31243,propia.,0,0,1,1
31245,resources.,0,0,1,1
31246,ತಪ್ಪಿಸುವುದು.,0,0,1,1
31247,transcendentalist,0,0,1,1
31278,പറയണം.,0,0,1,1
31282,doutorado,0,0,1,1
31345,touriste,0,0,1,1
31326,ദിവസവും,0,0,1,1
31317,திரும்புவார்,0,0,1,1
31318,properly,0,0,1,1
31321,avantajları,0,0,1,1
31322,அவளை,0,0,1,1
31323,историография,0,0,1,1
31324,impulsó,0,0,1,1
31325,factibles,0,0,1,1
31327,страницах.,0,0,1,1
31314,ενθουσιασμένοι,0,0,1,1
31331,transcendantalistes,0,0,1,1
31332,vibber,0,0,1,1
31334,இணையத்தில்,0,0,1,1
31339,llamaron,0,0,1,1
31342,hänvisning,0,0,1,1
31343,espantoso.,0,0,1,1
31344,تحلم.,0,0,1,1
31315,утонуть,0,0,1,1
31312,recognition.,0,0,1,1
31283,الأخطاء,0,0,1,1
31294,கிளாஸ்,0,0,1,1
31285,تصويره,0,0,1,1
31286,ಕರೆದೊಯ್ಯಿರಿ,0,0,1,1
31287,التعليمية,0,0,1,1
31288,unifiés ,0,0,1,1
31289,verificación,0,0,1,1
31290,σχόλιο,0,0,1,1
31291,وحتى,0,0,1,1
31295,inégalités.,0,0,1,1
31310,добровольцев»,0,0,1,1
31296,titta,0,0,1,1
31299,ಪಡೆದಾಗ,0,0,1,1
31301,uzlaşamamasına,0,0,1,1
31303,extraordinaire,0,0,1,1
31304,ತೆಗೆದುಕೊಂಡನು.,0,0,1,1
31305,harboring,0,0,1,1
31307,ഞാൻ.,0,0,1,1
31464,frío,0,0,1,1
31465,hasard,0,0,1,1
31467,envolvidas,0,0,1,1
31623,аароном,0,0,1,1
31612,становится,0,0,1,1
31615,undersökts.,0,0,1,1
31617,concurreert.,0,0,1,1
31618,επίσημη,0,0,1,1
31619,brilhantes.,0,0,1,1
31620,elizabeth,0,0,1,1
31621,നടത്തേണ്ടതുണ്ടെന്നും,0,0,1,1
31624,coğrafyada,0,0,1,1
31610,практику»,0,0,1,1
31625,ನೀವು.,0,0,1,1
31627,superar,0,0,1,1
31628,elefantes,0,0,1,1
31629,परिचय,0,0,1,1
31630,ऑफिस,0,0,1,1
31635,connaissance.,0,0,1,1
31637,contacted,0,0,1,1
31611,ಅನುಮತಿ.,0,0,1,1
31608,കാണിക്കുന്ന,0,0,1,1
31640,ноябрь,0,0,1,1
31594,европейском,0,0,1,1
31582,प्रथम,0,0,1,1
31583,ताजिक,0,0,1,1
31587,değilim,0,0,1,1
31590,вызывают,0,0,1,1
31591,«усилия,0,0,1,1
31592,försumbara,0,0,1,1
31593,våtmark,0,0,1,1
31595,поймали,0,0,1,1
31607,diciéndola,0,0,1,1
31599,മറ്റേയാൾക്ക്,0,0,1,1
31600,എന്തും,0,0,1,1
31601,ambiguidade,0,0,1,1
31602,youtube's,0,0,1,1
31604,tendo,0,0,1,1
31605,सइबरआर्ट्स,0,0,1,1
31606,bak.,0,0,1,1
31638,politically,0,0,1,1
31641,गम,0,0,1,1
31579,ಹಾಳುಮಾಡಿದೆ.,0,0,1,1
31678,предприняты,0,0,1,1
31670,открытием,0,0,1,1
31671,உடன்படவில்லை,0,0,1,1
31672,കിട്ടി,0,0,1,1
31673,görmediğinizde,0,0,1,1
31675,grundat,0,0,1,1
31676,നിർദ്ദേശിച്ചിട്ടുള്ള,0,0,1,1
31677,relaties,0,0,1,1
31680,forced,0,0,1,1
31668,symptoms.,0,0,1,1
31681,عليه.,0,0,1,1
31683,எனவும்,0,0,1,1
31684,cohesiveness,0,0,1,1
31686,ചായ്‌വ്,0,0,1,1
31688,heet,0,0,1,1
31689,choix,0,0,1,1
31690,somalí,0,0,1,1
31669,fetzer,0,0,1,1
31667,проекте.,0,0,1,1
31642,definir,0,0,1,1
31651,bırakmamı,0,0,1,1
31643,conspiracy,0,0,1,1
31644,encontró,0,0,1,1
31645,yasaklı,0,0,1,1
31646,public.,0,0,1,1
31647,aprende,0,0,1,1
31648,место.,0,0,1,1
31650,рассказал,0,0,1,1
31652,grafema,0,0,1,1
31666,biosphère.,0,0,1,1
31654,நம்புகிறேன்,0,0,1,1
31657,प्रकाशन,0,0,1,1
31658,കണ്ടെത്തലുകളും,0,0,1,1
31659,تتطلب,0,0,1,1
31662,sinkt,0,0,1,1
31663,ಎಂಟು,0,0,1,1
31665,wurden.,0,0,1,1
31580,kullanılan,0,0,1,1
31578,قالت,0,0,1,1
31468,വിയോജിക്കുകയും,0,0,1,1
31511,أدرك,0,0,1,1
31499,resúmenes,0,0,1,1
31502,zwinkerten,0,0,1,1
31503,deberíamos,0,0,1,1
31506,distribución.,0,0,1,1
31508,jugements,0,0,1,1
31509,الجمهور,0,0,1,1
31510,d'œil.,0,0,1,1
31512,sophistiqué,0,0,1,1
31497,sécurité.,0,0,1,1
31513,முன்னரே,0,0,1,1
31514,taux,0,0,1,1
31515,essence,0,0,1,1
31516,ешь.,0,0,1,1
31517,حيادية,0,0,1,1
31518,exponencial,0,0,1,1
31521,геометрии,0,0,1,1
31498,vandalized,0,0,1,1
31496,severas,0,0,1,1
31523,kültürel,0,0,1,1
31482,modificables,0,0,1,1
31469,ಪೋಯ್ಸ್ಡ್,0,0,1,1
31470,مربى,0,0,1,1
31473,പരിഹാരത്തിലും,0,0,1,1
31474,hu •,0,0,1,1
31475,connections,0,0,1,1
31476,وجهات,0,0,1,1
31481,സങ്കീർണ്ണത,0,0,1,1
31483,deseo,0,0,1,1
31495,تتضمن,0,0,1,1
31484,المذاق,0,0,1,1
31485,വാഗ്ദാനം,0,0,1,1
31487,സ്താനാർബുദം,0,0,1,1
31488,initiate,0,0,1,1
31491,inné »,0,0,1,1
31493,beantwoorden,0,0,1,1
31494,ayudarme,0,0,1,1
31522,noun,0,0,1,1
31524,satírico,0,0,1,1
31577,विफलताओं,0,0,1,1
31562,incentiva,0,0,1,1
31552,börjat,0,0,1,1
31553,ಮಾತನಾಡುತ್ತಿದ್ದೀರಿ,0,0,1,1
31554,macrolinguagem,0,0,1,1
31556,ordförråd,0,0,1,1
31557,ökar,0,0,1,1
31558,обработки,0,0,1,1
31561,πάρεις,0,0,1,1
31563,المتكررين,0,0,1,1
31550,auktoriteten.,0,0,1,1
31564,வளர்ந்த,0,0,1,1
31565,medicate,0,0,1,1
31568,verdringen.,0,0,1,1
31571,bois,0,0,1,1
31573,redistribuer,0,0,1,1
31575,പ്രാവർത്തികമാക്കാനുള്ള,0,0,1,1
31576,فريق,0,0,1,1
31551,habillé,0,0,1,1
31549,modernere,0,0,1,1
31525,orientadas,0,0,1,1
31533,أدوات,0,0,1,1
31526,nomeadamente,0,0,1,1
31527,'fouten',0,0,1,1
31528,സിനിമകളിലേക്ക്,0,0,1,1
31529,législations[u].,0,0,1,1
31530,quo.,0,0,1,1
31531,പോയാൽ,0,0,1,1
31532,എടുക്കരുത്.,0,0,1,1
31534,பழக்கவழக்கங்களால்,0,0,1,1
31548,புதியகட்டுரை,0,0,1,1
31535,juridiquement,0,0,1,1
31536,respectent,0,0,1,1
31537,провести,0,0,1,1
31538,ممكن,0,0,1,1
31539,ಸಮಸ್ಯೆಯಾಗಿದೆ.,0,0,1,1
31542,crossed.,0,0,1,1
31543,givet,0,0,1,1
31221,udnytte,0,0,1,1
31218,छींक,0,0,1,1
30714,ούτε,0,0,1,1
31217,privileged,0,0,1,1
30872,wikipedia».,0,0,1,1
30876,erasmus.,0,0,1,1
30877,المقابلة,0,0,1,1
30878,سيناريو,0,0,1,1
30879,kvalitetssäkrade,0,0,1,1
30880,front,0,0,1,1
30881,देशी,0,0,1,1
30882,tillykke,0,0,1,1
30883,d'attendre.,0,0,1,1
30885,d'articles ,0,0,1,1
30888,வாழ்க்கையை,0,0,1,1
30892,houden.,0,0,1,1
30893,البيانية,0,0,1,1
30894,generally[vague],0,0,1,1
30895,normdatei,0,0,1,1
30896,framtida,0,0,1,1
30897,интерфейс,0,0,1,1
30871,refletir,0,0,1,1
30870,установлена,0,0,1,1
30867,ravi,0,0,1,1
30852,പരിചയപ്പെടാം.,0,0,1,1
30838,vienne,0,0,1,1
30839,dernière.,0,0,1,1
30841,engelinin,0,0,1,1
30845,أستمع.,0,0,1,1
30846,astounding,0,0,1,1
30848,ordem,0,0,1,1
30850,बुलाया,0,0,1,1
30854,apelaram,0,0,1,1
30865,arena,0,0,1,1
30855,мэриан,0,0,1,1
30856,cardon,0,0,1,1
30857,الاغتصاب,0,0,1,1
30858,nourris,0,0,1,1
30861,اللغات،,0,0,1,1
30863,colloquial,0,0,1,1
30864,strengthened,0,0,1,1
30898,werd.,0,0,1,1
30899,unterwegs,0,0,1,1
30900,ontmoet,0,0,1,1
30948,forbløffende.,0,0,1,1
30937,nintendo,0,0,1,1
30939,ஏற்கவும்.,0,0,1,1
30940,dilemma-smart-wörter.,0,0,1,1
30941,plaît.,0,0,1,1
30944,définir,0,0,1,1
30945,صراحة,0,0,1,1
30947,lieber.,0,0,1,1
30950,machte,0,0,1,1
30933,ihtiyacınız,0,0,1,1
30951,ramené,0,0,1,1
30952,undergone,0,0,1,1
30953,ಬೇಕಾಗಿಲ್ಲ,0,0,1,1
30954,culture »,0,0,1,1
30955,berörde,0,0,1,1
30956,kører,0,0,1,1
30961,overzicht,0,0,1,1
30936,exacta,0,0,1,1
30932,falsedades.,0,0,1,1
30901,γραφής.,0,0,1,1
30915,voies,0,0,1,1
30904,الطبعة،,0,0,1,1
30906,страны,0,0,1,1
30907,juli,0,0,1,1
30909,γυναίκα,0,0,1,1
30910,ഐക്കണും,0,0,1,1
30912,दिन-प्रतिदिन,0,0,1,1
30913,gebräuchliche,0,0,1,1
30916,ലേഖകരുടെ,0,0,1,1
30930,beheerd,0,0,1,1
30918,maximale,0,0,1,1
30919,geprägt,0,0,1,1
30921,br •,0,0,1,1
30922,constitutional,0,0,1,1
30924,катализатор,0,0,1,1
30925,كبيراً,0,0,1,1
30928,meleğiyim,0,0,1,1
30837,പറഞ്ഞിട്ടുണ്ട്,0,0,1,1
30836,kontrollera,0,0,1,1
30834,proost,0,0,1,1
30749,capteurs,0,0,1,1
30741,autopromoción»​,0,0,1,1
30742,ஒப்புக்கொள்வது,0,0,1,1
30743,finalités,0,0,1,1
30744,iphone-enheter,0,0,1,1
30745,puedas,0,0,1,1
30747,physicsthe,0,0,1,1
30748,taraškievica,0,0,1,1
30750,exagerarla.,0,0,1,1
30738,wishes.,0,0,1,1
30751,souhaitée],0,0,1,1
30752,d'afficher,0,0,1,1
30753,cessé,0,0,1,1
30756,«cómo,0,0,1,1
30757,‘சியாகோமோ,0,0,1,1
30759,comentando,0,0,1,1
30760,ഭാഷാസ്വാധീനമുണ്ടാവും.,0,0,1,1
30739,ethnologues,0,0,1,1
30737,सॉफ़्टवेयर,0,0,1,1
30763,gamle,0,0,1,1
30722,книги,0,0,1,1
30715,मर्दानी,0,0,1,1
30716,equation,0,0,1,1
30717,بالضغط,0,0,1,1
30718,sills,0,0,1,1
30719,വിക്കിപീഡിയരുണ്ട്.,0,0,1,1
30720,intelectualmente,0,0,1,1
30721,adicional.,0,0,1,1
30724,schienen,0,0,1,1
30736,исследовании,0,0,1,1
30725,சென்றால்,0,0,1,1
30726,üzerime,0,0,1,1
30728,instalan,0,0,1,1
30730,рисунками.,0,0,1,1
30731,mirrors,0,0,1,1
30733,laccoliths,0,0,1,1
30734,திட்டமிட்டுள்ளேன்,0,0,1,1
30761,universitarios.,0,0,1,1
30766,व्युत्पन्न,0,0,1,1
30830,അല്പം,0,0,1,1
30819,ಇಳಿಸಿದರೆ,0,0,1,1
30803,புன்னகைக்கச்,0,0,1,1
30806,heerlijk,0,0,1,1
30807,semi-formal,0,0,1,1
30809,основных,0,0,1,1
30810,актов,0,0,1,1
30814,ano.,0,0,1,1
30815,lund,0,0,1,1
30820,мышей,0,0,1,1
30801,figuram.,0,0,1,1
30821,editoriales.,0,0,1,1
30822,ನಿಮ್ಮಂತೆಯೇ,0,0,1,1
30823,brits,0,0,1,1
30824,τακτικά,0,0,1,1
30826,geschreven,0,0,1,1
30827,ødelagt,0,0,1,1
30829,resultant,0,0,1,1
30802,día.,0,0,1,1
30800,நாசீஸின்,0,0,1,1
30768,углу,0,0,1,1
30782,μεμονωμένο,0,0,1,1
30769,لحظة,0,0,1,1
30771,ಅರಿತುಕೊಳ್ಳಬೇಕಾದ,0,0,1,1
30773,ediyorlarmış,0,0,1,1
30775,amélioration,0,0,1,1
30776,зданий,0,0,1,1
30780,légitime,0,0,1,1
30781,identifiant,0,0,1,1
30783,സംഘം,0,0,1,1
30795,kontrol,0,0,1,1
30785,categorisation,0,0,1,1
30786,ലഭിച്ചു.,0,0,1,1
30787,sätt',0,0,1,1
30788,பயனற்றது,0,0,1,1
30790,vänster,0,0,1,1
30791,утонченный.,0,0,1,1
30792,vectors.,0,0,1,1
30965,primero.,0,0,1,1
30966,gordon,0,0,1,1
30967,signal.,0,0,1,1
31131,நிலைமை.,0,0,1,1
31118,dizer-me,0,0,1,1
31119,tröskeln,0,0,1,1
31120,indígenas,0,0,1,1
31127,suaíli,0,0,1,1
31128,ಒಬ್ಬರು,0,0,1,1
31129,guldbröd,0,0,1,1
31130,karikatüründe,0,0,1,1
31132,devras,0,0,1,1
31115,naamwoord,0,0,1,1
31133,zware,0,0,1,1
31134,достоинств,0,0,1,1
31135,erro.,0,0,1,1
31137,durabilité,0,0,1,1
31138,opérationnelle.,0,0,1,1
31141,wikipediadag.,0,0,1,1
31143,நினைக்கலாம்,0,0,1,1
31117,जनरल,0,0,1,1
31114,δυστυχώς,0,0,1,1
31146,toleransen,0,0,1,1
31103,пользователя.,0,0,1,1
31091,perceptibles.,0,0,1,1
31093,hubo,0,0,1,1
31095,svagheter,0,0,1,1
31096,kredisine,0,0,1,1
31097,शूरवीर,0,0,1,1
31098,டெல்லியில்,0,0,1,1
31100,introduce,0,0,1,1
31104,skrivandet.,0,0,1,1
31113,riktlinjer.,0,0,1,1
31105,ആക്കി,0,0,1,1
31106,السينما,0,0,1,1
31108,gars.,0,0,1,1
31109,σμαράγδια,0,0,1,1
31110,gezegd,0,0,1,1
31111,vitaliste,0,0,1,1
31112,herbert,0,0,1,1
31144,parmaklarımda,0,0,1,1
31148,ذروته,0,0,1,1
31088,ಹೇಳದೆ,0,0,1,1
31201,tg •,0,0,1,1
31188,patentlerle,0,0,1,1
31190,ಪಡೆಯುತ್ತೀರಿ.,0,0,1,1
31191,s’est,0,0,1,1
31192,abschied,0,0,1,1
31194,подвержены,0,0,1,1
31195,ഒഴിവാക്കാറുണ്ട്.,0,0,1,1
31197,qualifié,0,0,1,1
31202,respectivamente,0,0,1,1
31186,متصل,0,0,1,1
31206,ಉತ್ತರಿಸಬಹುದು,0,0,1,1
31207,l'été,0,0,1,1
31209,d'énergie.,0,0,1,1
31210,erwähne,0,0,1,1
31211,verktygs,0,0,1,1
31215,യാത്രയ്ക്കിടയിലോ,0,0,1,1
31216,fameux,0,0,1,1
31187,violado.,0,0,1,1
31185,മനസ്സിലായില്ല,0,0,1,1
31149,ಗಣಿತ,0,0,1,1
31164,d'actualité,0,0,1,1
31151,alten,0,0,1,1
31153,désaccord.,0,0,1,1
31154,« actif »,0,0,1,1
31155,decreases.,0,0,1,1
31156,omöjlig,0,0,1,1
31162,l'appellation,0,0,1,1
31163,избранных,0,0,1,1
31166,impresionante.,0,0,1,1
31184,मलय,0,0,1,1
31168,வந்தான்.,0,0,1,1
31169,ವಿವರಿಸಿ,0,0,1,1
31170,tallrik,0,0,1,1
31173,gewerkt,0,0,1,1
31175,இலவசமா,0,0,1,1
31176,investigaciones,0,0,1,1
31180,begin,0,0,1,1
31089,worry.,0,0,1,1
31087,trabajadas.,0,0,1,1
30968,kanunu'nda,0,0,1,1
31017,ದುರದೃಷ್ಟವಶಾತ್,0,0,1,1
31007,señalar,0,0,1,1
31008,interrogación.,0,0,1,1
31009,är.,0,0,1,1
31011,oturup,0,0,1,1
31013,достоверность,0,0,1,1
31014,ka •,0,0,1,1
31015,enviada,0,0,1,1
31018,достоянии.,0,0,1,1
31003,chinês,0,0,1,1
31019,avser,0,0,1,1
31021,issu,0,0,1,1
31022,профессионализму,0,0,1,1
31023,obligados,0,0,1,1
31024,viss,0,0,1,1
31025,television's,0,0,1,1
31027,sedento,0,0,1,1
31004,negras,0,0,1,1
31001,നോക്കാം.,0,0,1,1
31030,ஆழமாக,0,0,1,1
30979,безумие.,0,0,1,1
30970,программ,0,0,1,1
30971,learnt,0,0,1,1
30972,hence,0,0,1,1
30973,katılımcılar,0,0,1,1
30974,существами,0,0,1,1
30977,antártida,0,0,1,1
30978,adquirir,0,0,1,1
30981,consideró,0,0,1,1
31000,नाहुआतल,0,0,1,1
30982,സമവായത്തിലൂടെ,0,0,1,1
30983,fact-challenged,0,0,1,1
30984,नीपोलिटाई,0,0,1,1
30987,coola,0,0,1,1
30992,tremendously,0,0,1,1
30995,amerikanerne,0,0,1,1
30997,förväntas,0,0,1,1
31029,«новости»,0,0,1,1
31031,സാമാന്യവത്കരണത്തെയും,0,0,1,1
31084,starting,0,0,1,1
31071,ಬಯಸಿದರೆ.,0,0,1,1
31062,wert.,0,0,1,1
31064,qualify,0,0,1,1
31066,கட்டுரையையும்,0,0,1,1
31067,chrétien,0,0,1,1
31068,mês.,0,0,1,1
31069,discutez-en.,0,0,1,1
31070,nationaal,0,0,1,1
31073,വെയിൽ‌സ്,0,0,1,1
31060,стоило,0,0,1,1
31074,зрения»,0,0,1,1
31075,popcultuur,0,0,1,1
31078,ಸೂಕ್ತವಾಗಿದೆ,0,0,1,1
31080,computationally,0,0,1,1
31081,centralized,0,0,1,1
31082,الإضافة,0,0,1,1
31083,göremezsiniz.,0,0,1,1
31061,indispensables,0,0,1,1
31059,disruptivas,0,0,1,1
31032,ಶಾಲೆಯಿಂದ,0,0,1,1
31041,пальчиках,0,0,1,1
31033,childcare.,0,0,1,1
31034,ತ್ರೈಮಾಸಿಕದಲ್ಲಿ,0,0,1,1
31035,nützliche,0,0,1,1
31036,tropas.,0,0,1,1
31038,والفرنسية,0,0,1,1
31039,preguiçosas,0,0,1,1
31040,correcta,0,0,1,1
31042,إنترويكي،,0,0,1,1
31057,aquifers,0,0,1,1
31044,llamaba,0,0,1,1
31049,ape,0,0,1,1
31051,പ്രത്യേകം,0,0,1,1
31052,kullandıkları,0,0,1,1
31053,kevin,0,0,1,1
31054,обсуждения,0,0,1,1
31056,rapporterade,0,0,1,1
29786,étroites,0,0,1,1
29783,жаловаться,0,0,1,1
27879,konfliktlösning,0,0,1,1
28348,backen,0,0,1,1
28520,بجامعة,0,0,1,1
28521,endorheic,0,0,1,1
28522,wafflingencouraged,0,0,1,1
28523,réalités,0,0,1,1
28524,under-utilized,0,0,1,1
28525,जाएगा।,0,0,1,1
28527,допустим,0,0,1,1
28528,ευχηθείτε,0,0,1,1
28531,ascendieron,0,0,1,1
28532,douradas,0,0,1,1
28535,सकें.,0,0,1,1
28536,δομημένων,0,0,1,1
28539,πορεία,0,0,1,1
28540,naken,0,0,1,1
28542,chiffre,0,0,1,1
28543,radera,0,0,1,1
28544,flydende.,0,0,1,1
28518,динамика,0,0,1,1
28517,കാത്തിരിക്കാൻ,0,0,1,1
28514,gravitation.,0,0,1,1
28498,listo,0,0,1,1
28482,sınavda,0,0,1,1
28488,вялого,0,0,1,1
28489,ரியோக்காசு,0,0,1,1
28493,racistas,0,0,1,1
28494,wijdde,0,0,1,1
28495,ip-adressen.,0,0,1,1
28497,mordida,0,0,1,1
28499,ελα.,0,0,1,1
28513,उंगलियां,0,0,1,1
28500,تكرار,0,0,1,1
28501,noticed,0,0,1,1
28502,இழுப்பதாகவோ,0,0,1,1
28509,receiver,0,0,1,1
28510,reproduce,0,0,1,1
28511,supuesto.,0,0,1,1
28512,देगा,0,0,1,1
28545,تتلقى,0,0,1,1
28546,கற்றல்,0,0,1,1
28547,deposunda,0,0,1,1
28586,പദങ്ങൾക്കും,0,0,1,1
28577,ayudarías,0,0,1,1
28579,സന്തോഷമുണ്ട്.,0,0,1,1
28580,technologically,0,0,1,1
28581,ज़ीलैण्डी,0,0,1,1
28582,انطلق,0,0,1,1
28583,востребованным»,0,0,1,1
28585,نسبيًا,0,0,1,1
28587,fortfahren,0,0,1,1
28574,spin.,0,0,1,1
28588,bienvenido.,0,0,1,1
28589,dili,0,0,1,1
28590,கேட்கிறேன்,0,0,1,1
28591,patates,0,0,1,1
28592,l'as,0,0,1,1
28593,ಹೇಳಿದರೆ.,0,0,1,1
28594,kleines,0,0,1,1
28575,المطولة,0,0,1,1
28573,enheten,0,0,1,1
28548,собственных,0,0,1,1
28558,आर्मिनियाई,0,0,1,1
28549,värdelöst,0,0,1,1
28550,haberleri,0,0,1,1
28551,σκοπεύω,0,0,1,1
28553,biografias,0,0,1,1
28554,stycken,0,0,1,1
28556,vocabulario.,0,0,1,1
28557,تصنيفها،,0,0,1,1
28559,encyclopedia»,0,0,1,1
28572,vue »,0,0,1,1
28560,விக்கியைப்,0,0,1,1
28561,തടയുന്നു.,0,0,1,1
28563,ключевыми,0,0,1,1
28565,другая,0,0,1,1
28568,sah.,0,0,1,1
28570,étroitement,0,0,1,1
28571,spektrum,0,0,1,1
28481,культура,0,0,1,1
28479,personally,0,0,1,1
28477,mío,0,0,1,1
28401,« modifications,0,0,1,1
28385,വെക്കുന്നുണ്ട്.,0,0,1,1
28387,அதனால்,0,0,1,1
28389,ಸುಂದರವಾದ,0,0,1,1
28390,ലഭിക്കുന്നതിന്,0,0,1,1
28394,пойти,0,0,1,1
28396,εκατομμύριο,0,0,1,1
28397,puppe,0,0,1,1
28402,முதன்மைக்,0,0,1,1
28382,ಸರಿಯಾಗಿದೆ.,0,0,1,1
28403,ಕನಸು.,0,0,1,1
28404,hydrological,0,0,1,1
28405,famílias,0,0,1,1
28406,språkversion,0,0,1,1
28407,förespråkare,0,0,1,1
28408,الانتظار,0,0,1,1
28410,corrección,0,0,1,1
28384,άρεσαν,0,0,1,1
28381,مفتوحًا,0,0,1,1
28412,mande,0,0,1,1
28364,partagés,0,0,1,1
28353,цифровой,0,0,1,1
28354,appréhender,0,0,1,1
28355,கலைக்களஞ்சியம்',0,0,1,1
28356,divergent,0,0,1,1
28358,प्राचीन,0,0,1,1
28359,sitzen,0,0,1,1
28362,argumentaram,0,0,1,1
28365,buss,0,0,1,1
28379,legitimidad,0,0,1,1
28367,ധരിച്ചിട്ടുണ്ടെന്നും,0,0,1,1
28368,هذا؟,0,0,1,1
28369,മാതൃവെബ്സൈറ്റിനെയും,0,0,1,1
28371,हैं।विशेष,0,0,1,1
28374,பயன்படுத்துவது,0,0,1,1
28375,shortly,0,0,1,1
28377,популярное,0,0,1,1
28411,ಮಾಡಬಹುದೇ,0,0,1,1
28417,nåd,0,0,1,1
28475,ചേർക്കുന്നു,0,0,1,1
28460,çoğalmıştır.,0,0,1,1
28452,தவறு.,0,0,1,1
28453,تحتاج,0,0,1,1
28455,пародировал,0,0,1,1
28456,passada,0,0,1,1
28457,devastation.,0,0,1,1
28458,durable,0,0,1,1
28459,implementations,0,0,1,1
28462,observe,0,0,1,1
28448,великой,0,0,1,1
28465,पृष्ट,0,0,1,1
28466,ചിലതിന്,0,0,1,1
28467,வெளிப்படுத்தினேன்,0,0,1,1
28468,granskade,0,0,1,1
28470,sofistikerad.,0,0,1,1
28471,skiva,0,0,1,1
28472,blair,0,0,1,1
28450,دلهي,0,0,1,1
28446,gazetesi,0,0,1,1
28418,веб-сайт,0,0,1,1
28429,ಹೇಳಬಹುದಾದ,0,0,1,1
28419,grandissante,0,0,1,1
28420,toxic,0,0,1,1
28421,jämnt,0,0,1,1
28422,لنذهب,0,0,1,1
28424,digesting,0,0,1,1
28426,consultations/modifications,0,0,1,1
28427,कार्यालय,0,0,1,1
28430,environnementale.,0,0,1,1
28445,interesadamente.,0,0,1,1
28432,contents.,0,0,1,1
28433,استثنائي,0,0,1,1
28436,ушли,0,0,1,1
28437,എടുത്താൽ,0,0,1,1
28439,ansiktet,0,0,1,1
28440,تامبا،,0,0,1,1
28441,« aide »,0,0,1,1
28598,incompetent,0,0,1,1
28600,لحل,0,0,1,1
28601,académicos,0,0,1,1
28773,lecturers,0,0,1,1
28763,rapidement.,0,0,1,1
28764,démarches,0,0,1,1
28765,ಓದುತ್ತಿದ್ದೇನೆ,0,0,1,1
28766,zugeben,0,0,1,1
28769,просмотренных,0,0,1,1
28771,έλεγες,0,0,1,1
28772,interativo,0,0,1,1
28776,laisse-moi,0,0,1,1
28759,augen,0,0,1,1
28778,repareren,0,0,1,1
28779,parametrar.,0,0,1,1
28780,ursäkt.,0,0,1,1
28782,നന്നായിരിക്കും,0,0,1,1
28784,uniques.,0,0,1,1
28785,оценок,0,0,1,1
28786,вопрос.,0,0,1,1
28760,tradicional.,0,0,1,1
28758,விதிவிலக்காக,0,0,1,1
28788,kökenleri,0,0,1,1
28740,தாய்க்கு,0,0,1,1
28725,facteur,0,0,1,1
28728,wikiversidade,0,0,1,1
28732,automatizar,0,0,1,1
28733,മെസഞ്ചർ,0,0,1,1
28736,ائتمانًا,0,0,1,1
28738,والواراي,0,0,1,1
28739,erstaunt,0,0,1,1
28742,редакционным,0,0,1,1
28757,yavaştır,0,0,1,1
28745,வந்ததும்,0,0,1,1
28747,zeros.,0,0,1,1
28749,بغض,0,0,1,1
28750,brains.,0,0,1,1
28753,ودعوا,0,0,1,1
28754,சனிக்கிழமை,0,0,1,1
28756,chato.,0,0,1,1
28787,स्वीकृतियों,0,0,1,1
28789,désordre,0,0,1,1
28718,intervention.,0,0,1,1
28832,‘பேச்சுப்,0,0,1,1
28820,completamente.,0,0,1,1
28821,nyttige,0,0,1,1
28822,removal,0,0,1,1
28823,duymuşsunuzdur,0,0,1,1
28829,fællesskab,0,0,1,1
28830,neuen,0,0,1,1
28831,blois,0,0,1,1
28837,pre-history,0,0,1,1
28815,détournées,0,0,1,1
28839,øjne.,0,0,1,1
28841,الموضوع.,0,0,1,1
28842,പ്രൊജക്റ്റിനു,0,0,1,1
28843,codificación,0,0,1,1
28844,மாற்றங்கள்’,0,0,1,1
28845,تتجاهل,0,0,1,1
28846,പോലീസോ,0,0,1,1
28818,neerlandês,0,0,1,1
28814,ആരംഭിച്ചപ്പോഴാണ്.,0,0,1,1
28790,പെരുപ്പിച്ചു,0,0,1,1
28801,great.,0,0,1,1
28792,ouro.,0,0,1,1
28793,planter,0,0,1,1
28794,дальнейшее,0,0,1,1
28795,вялым.,0,0,1,1
28796,स्टेवर्डशिप,0,0,1,1
28798,разделом.,0,0,1,1
28799,транспорте,0,0,1,1
28802,explicar,0,0,1,1
28813,ನಗಲು,0,0,1,1
28804,d'aristote.,0,0,1,1
28805,kontrolleras,0,0,1,1
28806,أسابيع,0,0,1,1
28808,hormiga,0,0,1,1
28810,professors,0,0,1,1
28811,പരിഗണിക്കുന്നു.,0,0,1,1
28812,ανεβάζετε,0,0,1,1
28720,suivi »,0,0,1,1
28717,одед,0,0,1,1
28603,omslaget,0,0,1,1
28641,öğreniyorum,0,0,1,1
28632,obtendría,0,0,1,1
28633,assassination,0,0,1,1
28634,പൂർവ്വസ്ഥിതിയിലായി.,0,0,1,1
28636,salyangoz,0,0,1,1
28638,சாப்பாட்டு,0,0,1,1
28639,откусил,0,0,1,1
28640,पोस्ट,0,0,1,1
28643,haag,0,0,1,1
28629,سرعان,0,0,1,1
28644,cirkelen,0,0,1,1
28646,avsluta.,0,0,1,1
28648,ficticia,0,0,1,1
28650,обращает,0,0,1,1
28651,ændret,0,0,1,1
28652,rechten,0,0,1,1
28653,l'éclosion,0,0,1,1
28631,उम्र,0,0,1,1
28628,bedank,0,0,1,1
28655,leave,0,0,1,1
28614,téléchargées[ae].,0,0,1,1
28604,visiblement,0,0,1,1
28606,έρχεται,0,0,1,1
28608,ödevi,0,0,1,1
28609,χώρα,0,0,1,1
28610,morrendo,0,0,1,1
28612,رجل,0,0,1,1
28613,സുന്ദരനായിരുന്നു,0,0,1,1
28616,ansiklopedisi.,0,0,1,1
28627,angleterre,0,0,1,1
28617,कैलीफ़ोर्निया,0,0,1,1
28620,صعد,0,0,1,1
28621,antemano.,0,0,1,1
28622,अभियोगपत्र,0,0,1,1
28623,unfortunately,0,0,1,1
28624,கட்டுரை,0,0,1,1
28625,vb.,0,0,1,1
28654,сбитым,0,0,1,1
28658,ba •,0,0,1,1
28716,parciales,0,0,1,1
28701,массовое,0,0,1,1
28692,description.,0,0,1,1
28693,hängst,0,0,1,1
28695,influenced,0,0,1,1
28696,servrar,0,0,1,1
28697,inférieure,0,0,1,1
28698,révélant,0,0,1,1
28700,πρόσφατα,0,0,1,1
28703,remind,0,0,1,1
28688,evitan,0,0,1,1
28704,положение,0,0,1,1
28706,open-door,0,0,1,1
28707,bibliograaf,0,0,1,1
28708,sterker,0,0,1,1
28711,diagrams.,0,0,1,1
28713,blacking,0,0,1,1
28715,suivre »,0,0,1,1
28691,arbre,0,0,1,1
28687,والفكاهة,0,0,1,1
28659,വിക്കിസോഫ്റ്റ്,0,0,1,1
28668,herhaalt.,0,0,1,1
28660,ചങ്ങാതിമാരും,0,0,1,1
28661,hindra,0,0,1,1
28662,buradan,0,0,1,1
28663,reinvestment.,0,0,1,1
28665,братские,0,0,1,1
28666,hjärtat,0,0,1,1
28667,améliorations,0,0,1,1
28671,ஐகானையும்,0,0,1,1
28685,stumpfen,0,0,1,1
28673,سخيف,0,0,1,1
28675,plateau,0,0,1,1
28677,hjemmesiden,0,0,1,1
28680,ಮೂಲಕ.,0,0,1,1
28681,ഇരിക്കുന്നതായും,0,0,1,1
28682,χάος,0,0,1,1
28683,engraved,0,0,1,1
28351,ಇದ್ದವು,0,0,1,1
28347,niña,0,0,1,1
28850,societies,0,0,1,1
28345,catholiques,0,0,1,1
28030,அருமையாக,0,0,1,1
28031,élaboré,0,0,1,1
28032,presión.,0,0,1,1
28033,balanserade,0,0,1,1
28035,يونجل,0,0,1,1
28036,подход,0,0,1,1
28037,versionshantering.,0,0,1,1
28038,rubí,0,0,1,1
28041,finalidade,0,0,1,1
28042,minoritaire,0,0,1,1
28043,tagalo,0,0,1,1
28044,использовал,0,0,1,1
28045,स्टाप,0,0,1,1
28047,opmerking.,0,0,1,1
28048,yazar,0,0,1,1
28049,планирую,0,0,1,1
28051,[réf.,0,0,1,1
28029,adamın,0,0,1,1
28028,pelarna,0,0,1,1
28027,تزيد,0,0,1,1
28014,вышла,0,0,1,1
28002,صخرة,0,0,1,1
28004,fusão,0,0,1,1
28009,adil,0,0,1,1
28010,tercümesi,0,0,1,1
28011,नीदरलैंड,0,0,1,1
28012,etablerad,0,0,1,1
28013,sig.,0,0,1,1
28015,fatih,0,0,1,1
28026,styrke,0,0,1,1
28016,täckte,0,0,1,1
28018,выпустило,0,0,1,1
28019,sliep,0,0,1,1
28020,hemisphere.,0,0,1,1
28022,подожди,0,0,1,1
28023,അറിയാവുന്ന,0,0,1,1
28024,best-known,0,0,1,1
28055,hábil,0,0,1,1
28056,digg,0,0,1,1
28057,mécanismes,0,0,1,1
28102,merkezinde,0,0,1,1
28091,ederek,0,0,1,1
28093,κόκκινο,0,0,1,1
28094,где-то,0,0,1,1
28096,capté,0,0,1,1
28098,situada,0,0,1,1
28099,подготовка,0,0,1,1
28101,تقليدية.,0,0,1,1
28103,exhaustivo,0,0,1,1
28086,അങ്ങനെയുള്ള,0,0,1,1
28104,مرتبات،,0,0,1,1
28108,triumphing,0,0,1,1
28109,بالمحتوى,0,0,1,1
28110,ειλικρινά,0,0,1,1
28111,occupée…,0,0,1,1
28112,d'aventures,0,0,1,1
28117,d.,0,0,1,1
28088,കഴിഞ്ഞത്,0,0,1,1
28084,saute,0,0,1,1
28059,betrat,0,0,1,1
28069,validade,0,0,1,1
28061,critiquée,0,0,1,1
28062,निमंत्रण,0,0,1,1
28063,netter,0,0,1,1
28065,आप.............जानते,0,0,1,1
28066,belgique,0,0,1,1
28067,s'intéresse,0,0,1,1
28068,വിത്തുകൾ,0,0,1,1
28070,കണ്ടതിൽ,0,0,1,1
28083,candidate.,0,0,1,1
28071,стакан,0,0,1,1
28072,génie,0,0,1,1
28073,ഗ്ലാസ്,0,0,1,1
28074,graines,0,0,1,1
28075,समझना,0,0,1,1
28080,t'en,0,0,1,1
28081,расширена,0,0,1,1
28001,കൊടുത്തിരുന്ന,0,0,1,1
28000,wochen,0,0,1,1
27999,abonnement,0,0,1,1
27921,insult,0,0,1,1
27912,பயணத்தின்போது,0,0,1,1
27913,angive,0,0,1,1
27914,músico,0,0,1,1
27916,побежала,0,0,1,1
27917,സ്നേഹിക്കുന്നു.,0,0,1,1
27918,inappropriées.,0,0,1,1
27919,kalitede,0,0,1,1
27923,extralimitan,0,0,1,1
27909,formaliserat,0,0,1,1
27924,الاعتذار.,0,0,1,1
27925,விதைகளை,0,0,1,1
27926,confusos,0,0,1,1
27927,وجودة,0,0,1,1
27928,ದಯವಿಟ್ಟು.,0,0,1,1
27929,αναγράφεται,0,0,1,1
27930,reputado,0,0,1,1
27911,ദ്യോഗിക,0,0,1,1
27908,നാനാവിധ,0,0,1,1
27932,dahil,0,0,1,1
27892,पायी,0,0,1,1
27880,मार,0,0,1,1
27882,المحظوظ,0,0,1,1
27883,ignora,0,0,1,1
27885,chronométrez,0,0,1,1
27886,afkomstig,0,0,1,1
27887,siquiera,0,0,1,1
27888,φοβερό,0,0,1,1
27893,लिगुरियाई,0,0,1,1
27907,версий.,0,0,1,1
27894,verbform,0,0,1,1
27897,landform,0,0,1,1
27900,kwijt,0,0,1,1
27901,кем-то,0,0,1,1
27903,обоката,0,0,1,1
27904,തടയേണ്ട,0,0,1,1
27905,kallt,0,0,1,1
27931,apresentada,0,0,1,1
27934,soil,0,0,1,1
27998,cubierto,0,0,1,1
27988,தட்டச்சு,0,0,1,1
27980,ಚೂಪಾದವು,0,0,1,1
27981,rencontré,0,0,1,1
27982,kişilerden,0,0,1,1
27983,മുറിച്ചുകടക്കുമെന്നും,0,0,1,1
27984,consultar,0,0,1,1
27985,-minute,0,0,1,1
27987,классифицирующий,0,0,1,1
27989,plagiering,0,0,1,1
27978,помогать,0,0,1,1
27990,ಬಯಸದಿದ್ದರೆ.,0,0,1,1
27992,विचार-विमर्श,0,0,1,1
27993,mark.,0,0,1,1
27994,adn,0,0,1,1
27995,دعم,0,0,1,1
27996,codes,0,0,1,1
27997,polis.,0,0,1,1
27979,κολλήσετε,0,0,1,1
27976,بالو,0,0,1,1
27937,katkıda,0,0,1,1
27955,ಆಟದ,0,0,1,1
27938,പുഞ്ചിരിച്ചു.,0,0,1,1
27941,വേണ്ടി,0,0,1,1
27942,manners,0,0,1,1
27944,encyclopedias.,0,0,1,1
27947,chegando,0,0,1,1
27953,gigantesques,0,0,1,1
27954,getroffen,0,0,1,1
27957,botste,0,0,1,1
27973,войск,0,0,1,1
27958,friedrich,0,0,1,1
27961,கடைப்பிடிக்கப்படுகிறது.,0,0,1,1
27962,odf,0,0,1,1
27963,الإجابة,0,0,1,1
27970,teller,0,0,1,1
27971,crazy.,0,0,1,1
27972,verdrink,0,0,1,1
28121,ಹೆದರುವುದಿಲ್ಲ.,0,0,1,1
28122,préhistoire,0,0,1,1
28123,constamment,0,0,1,1
28282,плюрипотентное,0,0,1,1
28270,للقوانين,0,0,1,1
28271,μαγικά,0,0,1,1
28272,flippede,0,0,1,1
28275,commenting,0,0,1,1
28278,üniversiteye,0,0,1,1
28279,பட்டினி,0,0,1,1
28281,tidsskrifter,0,0,1,1
28284,telefonopkald,0,0,1,1
28267,മര്യാദ,0,0,1,1
28286,subjects.,0,0,1,1
28287,സാങർ,0,0,1,1
28288,வலியுறுத்துவது,0,0,1,1
28289,المزيد.,0,0,1,1
28290,échoué,0,0,1,1
28291,ತಿರುಗುತ್ತಾನೆ,0,0,1,1
28292,télévisé,0,0,1,1
28268,récemment.,0,0,1,1
28264,grecque,0,0,1,1
28296,shirky,0,0,1,1
28246,couches ,0,0,1,1
28238,renouvelables,0,0,1,1
28239,купили,0,0,1,1
28240,திருகினேன்,0,0,1,1
28241,escolhas,0,0,1,1
28243,ädelstenar,0,0,1,1
28244,تسعة,0,0,1,1
28245,വിലാസത്തിന്റെ,0,0,1,1
28248,relating,0,0,1,1
28262,لأطلب,0,0,1,1
28249,counting,0,0,1,1
28255,ética,0,0,1,1
28256,filtreringen.,0,0,1,1
28258,illustrative,0,0,1,1
28259,dini,0,0,1,1
28260,teoría,0,0,1,1
28261,अडिग,0,0,1,1
28293,écoute.,0,0,1,1
28297,såväl,0,0,1,1
28235,شخصياً,0,0,1,1
28334,диалекты,0,0,1,1
28325,utsträckning,0,0,1,1
28326,είδατε.,0,0,1,1
28327,follow-up,0,0,1,1
28329, ومؤسسة,0,0,1,1
28331,avancée,0,0,1,1
28332,universitetsnivå,0,0,1,1
28333,interpretations.,0,0,1,1
28335,exceptionellt,0,0,1,1
28323,emocionante,0,0,1,1
28336,देंगे,0,0,1,1
28337,κάθονται,0,0,1,1
28339,descrever,0,0,1,1
28340,adoptado,0,0,1,1
28342,wiki-editáveis,0,0,1,1
28343,d'incompréhensible.,0,0,1,1
28344,സാധ്യമല്ല.,0,0,1,1
28324,различия,0,0,1,1
28322,microfilm,0,0,1,1
28299,تستطيع,0,0,1,1
28310,mathématique.,0,0,1,1
28301,टेबल,0,0,1,1
28302,добивается,0,0,1,1
28304,aburrido.,0,0,1,1
28305,añadir,0,0,1,1
28307,videodur,0,0,1,1
28308,bridle,0,0,1,1
28309,stalin,0,0,1,1
28311,resimlerin,0,0,1,1
28321,ms •,0,0,1,1
28313,leute.,0,0,1,1
28314,പ്രവർത്തകർ,0,0,1,1
28315,crioulo,0,0,1,1
28316,slag,0,0,1,1
28317,representantes,0,0,1,1
28318,estabelecidos.,0,0,1,1
28320,ഏറി,0,0,1,1
28237,magnificent,0,0,1,1
28234,പ്രവൃത്തി,0,0,1,1
28124,மோசமான,0,0,1,1
28156,layout,0,0,1,1
28149,styrkor,0,0,1,1
28150,ameaças,0,0,1,1
28151,gisteravond,0,0,1,1
28152,bredvid,0,0,1,1
28153,hierarkisk,0,0,1,1
28154,illegal,0,0,1,1
28155,கொடுங்கள்,0,0,1,1
28157,pt.mobile.wikipedia.org,0,0,1,1
28147,apoyando,0,0,1,1
28158,viajes,0,0,1,1
28159,сетей.,0,0,1,1
28160,omfattande,0,0,1,1
28161,கண்,0,0,1,1
28163,недостатков.,0,0,1,1
28166,يركزون,0,0,1,1
28168,विस्मयित,0,0,1,1
28148,घूर,0,0,1,1
28146,vienes,0,0,1,1
28171,förberedde,0,0,1,1
28135,librepedia,0,0,1,1
28125,l'union,0,0,1,1
28127,connaître,0,0,1,1
28129,вики-проекты,0,0,1,1
28130,rendra,0,0,1,1
28131, года.,0,0,1,1
28132,الحين.,0,0,1,1
28134,poussée,0,0,1,1
28136,تشتكي,0,0,1,1
28145,المنخفضة,0,0,1,1
28137,tohumları,0,0,1,1
28138,διαφορετικούς,0,0,1,1
28139,месте,0,0,1,1
28140,onları,0,0,1,1
28142,basisinstructies,0,0,1,1
28143,chanceuse,0,0,1,1
28144,desenvolver,0,0,1,1
28169,rendueles,0,0,1,1
28172,tandis,0,0,1,1
28233,reisde,0,0,1,1
28216,france.,0,0,1,1
28204,noticiado,0,0,1,1
28205,contribuiu,0,0,1,1
28207,participating,0,0,1,1
28208,മീറ്റിംഗായിരുന്നു,0,0,1,1
28209,integrando,0,0,1,1
28210,dieciséis,0,0,1,1
28215,ओक्स्फोर्ड,0,0,1,1
28217,åbne,0,0,1,1
28202,थोडा,0,0,1,1
28220,voorstel.,0,0,1,1
28222,भागों,0,0,1,1
28225,france[ag],0,0,1,1
28226,തരംതിരിക്കാൻ,0,0,1,1
28227,изменение,0,0,1,1
28230,readability,0,0,1,1
28232,comblé,0,0,1,1
28203,ഘടകങ്ങളാണ്.,0,0,1,1
28201,hakikaten,0,0,1,1
28173,ಬದಲಿಗೆ,0,0,1,1
28184,കണ്ണടച്ചു.,0,0,1,1
28174,الأمريكيين,0,0,1,1
28175,intégrale,0,0,1,1
28177,jarre,0,0,1,1
28179,الاختلافات,0,0,1,1
28180,जानेमन,0,0,1,1
28182,continuación.,0,0,1,1
28183,अध्यायों,0,0,1,1
28187,குனூ,0,0,1,1
28198,ejemplos.,0,0,1,1
28188,convite,0,0,1,1
28189,gemeenschappen,0,0,1,1
28193,déterminations,0,0,1,1
28194,corrija,0,0,1,1
28195,والآراء,0,0,1,1
28196,журналистике,0,0,1,1
28197,مخالف,0,0,1,1
28849,കാര്യത്തെക്കുറിച്ച്,0,0,1,1
28851,bahsetmediniz,0,0,1,1
29781,यूजमोडविकी,0,0,1,1
29324,matchen,0,0,1,1
29472,tartışılır,0,0,1,1
29473,floride,0,0,1,1
29478,வெளியிடுவதாகவே,0,0,1,1
29479,está.,0,0,1,1
29480,естественно,0,0,1,1
29481,monte,0,0,1,1
29484,immediately.,0,0,1,1
29485,സമതുലിതമായ,0,0,1,1
29487,aufzumuntern,0,0,1,1
29488,हमारी,0,0,1,1
29489,أهتم,0,0,1,1
29490,बगीचे,0,0,1,1
29491,அழகானவர்,0,0,1,1
29493,verifiera,0,0,1,1
29494,økonomien,0,0,1,1
29495,'den,0,0,1,1
29496,وانفتاحًا,0,0,1,1
29470,മാംസം,0,0,1,1
29469,صنع,0,0,1,1
29468,ihåg.,0,0,1,1
29453,व्याकरण,0,0,1,1
29444,утверждают,0,0,1,1
29446,цитируемых,0,0,1,1
29447,pratiquer,0,0,1,1
29448,vormen,0,0,1,1
29449,أضع,0,0,1,1
29451,publicité,0,0,1,1
29452,[അവലംബം,0,0,1,1
29454,elefante,0,0,1,1
29466,themselves.,0,0,1,1
29455,marx.,0,0,1,1
29457,песнях,0,0,1,1
29458,உயர்ந்தது.,0,0,1,1
29460,muscles,0,0,1,1
29461,halsizlik,0,0,1,1
29462,പ്ലാനിങ്,0,0,1,1
29464,mooiste,0,0,1,1
29497,англоязычную,0,0,1,1
29498,tempestuosa,0,0,1,1
29502,உள்ளதாகத்,0,0,1,1
29539,الابتسامات,0,0,1,1
29531,माइस्पेस,0,0,1,1
29532,എല്ലാവരോടും,0,0,1,1
29533,والثروات,0,0,1,1
29535,aboutit,0,0,1,1
29536,வாசகரும்,0,0,1,1
29537,чувствуете,0,0,1,1
29538,matemáticos.,0,0,1,1
29540,hermosos,0,0,1,1
29528,kaynaklarıyla,0,0,1,1
29541,ಕಾಲದಲ್ಲಿ,0,0,1,1
29542,modificaron,0,0,1,1
29543,hoch,0,0,1,1
29544,വിടുകയാണെന്ന്,0,0,1,1
29547,anlatırsa,0,0,1,1
29548,'intelligent',0,0,1,1
29549,சொற்களில்,0,0,1,1
29530,cezaevlerinde,0,0,1,1
29527,örneğinde,0,0,1,1
29503,it-entreprenören,0,0,1,1
29513,संज्ञा,0,0,1,1
29505,парадокс,0,0,1,1
29506,benden,0,0,1,1
29508,kwartaal,0,0,1,1
29509,создают,0,0,1,1
29510,تفهمًا,0,0,1,1
29511,savoir-faire.,0,0,1,1
29512,مستحيلًا,0,0,1,1
29514,πότε,0,0,1,1
29526,sløv,0,0,1,1
29515,periods,0,0,1,1
29516,conduzido,0,0,1,1
29519,يضربني.,0,0,1,1
29521,पहुँचे,0,0,1,1
29522,utvecklat,0,0,1,1
29524,s'exercent,0,0,1,1
29525,préfère,0,0,1,1
29443,digitizing,0,0,1,1
29442,artikelhistoriken,0,0,1,1
29440,gradiente.,0,0,1,1
29362,sketch,0,0,1,1
29354,ಪ್ರವಾಸವನ್ನು,0,0,1,1
29355,отрасли.,0,0,1,1
29356,bajada,0,0,1,1
29358,والجزء,0,0,1,1
29359,ಹಸಿದಿಲ್ಲ,0,0,1,1
29360,ஜோசப்,0,0,1,1
29361,абзацев,0,0,1,1
29363,infantil.,0,0,1,1
29352,lecture,0,0,1,1
29365,बनाता,0,0,1,1
29366,encuentro.,0,0,1,1
29367,സമീപനത്തിന്,0,0,1,1
29368,diamants,0,0,1,1
29369,الجلوس,0,0,1,1
29370,prejudicial,0,0,1,1
29373,sparas.,0,0,1,1
29353,tanınıyor,0,0,1,1
29351,ಪ್ರಶ್ನೆಗಳಿಗೆ,0,0,1,1
29376,ടെസ്റ്റു,0,0,1,1
29335,عالية,0,0,1,1
29326,εθελοντές,0,0,1,1
29327,- ,0,0,1,1
29328,spegeln,0,0,1,1
29330,adotada,0,0,1,1
29331,kafaları,0,0,1,1
29332,selv.,0,0,1,1
29333,kunskaper,0,0,1,1
29336,temporarily,0,0,1,1
29349,robijnrode,0,0,1,1
29338,wikimini,0,0,1,1
29340,especificados,0,0,1,1
29341,അതിശയകരമായത്,0,0,1,1
29342,расположенных,0,0,1,1
29343,repente,0,0,1,1
29345,=,0,0,1,1
29347,appropriately.,0,0,1,1
29375,αγενή,0,0,1,1
29377,consulté »,0,0,1,1
29438,достать,0,0,1,1
29424,разнообразию,0,0,1,1
29414,wikiscanning-historien,0,0,1,1
29415,столе,0,0,1,1
29416,teklifler,0,0,1,1
29417,وصُفت,0,0,1,1
29418,lämnar,0,0,1,1
29419,அவரை,0,0,1,1
29422,escasa,0,0,1,1
29425,finaste,0,0,1,1
29412,несогласия.,0,0,1,1
29426,chief,0,0,1,1
29427,multitudinaria,0,0,1,1
29428,sea.,0,0,1,1
29429,ಸುಳಿವು,0,0,1,1
29430,ನೋಡಿಲ್ಲ,0,0,1,1
29434,पीड्मॉण्टी,0,0,1,1
29437,anlayışı,0,0,1,1
29413,desenhos,0,0,1,1
29411,обеспечение,0,0,1,1
29379,​​of,0,0,1,1
29391,oavsett,0,0,1,1
29380,ಕೆಲಸವಿದೆ,0,0,1,1
29381,stupide,0,0,1,1
29383,microbes,0,0,1,1
29384,والوسائط,0,0,1,1
29385,спектр,0,0,1,1
29387,ചിലമേഖലകളെ,0,0,1,1
29390,déclaré,0,0,1,1
29396,yazı,0,0,1,1
29409,تشاهدون.,0,0,1,1
29397,गिलास,0,0,1,1
29398,أضاف,0,0,1,1
29399,verificadores,0,0,1,1
29402,rigen.,0,0,1,1
29404,ആശ്ചര്യകരമായ,0,0,1,1
29405,στρατεύματα,0,0,1,1
29406,high-end,0,0,1,1
29550,നേരിട്ട്,0,0,1,1
29551,ಗದ್ದೆ,0,0,1,1
29553,étiquettes,0,0,1,1
29711,bureaucracy,0,0,1,1
29703,dependence,0,0,1,1
29705,അടിച്ചു.,0,0,1,1
29706,بأنك,0,0,1,1
29707,resultatet,0,0,1,1
29708,പുരുഷന്മാരെ,0,0,1,1
29709,eliminó,0,0,1,1
29710,путешествие.,0,0,1,1
29712,förklaringen,0,0,1,1
29701,associada,0,0,1,1
29713,संपदा,0,0,1,1
29714,universeel,0,0,1,1
29715,трудно,0,0,1,1
29716,viable,0,0,1,1
29717,والإجراءات,0,0,1,1
29718,பின்னரே,0,0,1,1
29719,സ്ഥാപനമാണ്,0,0,1,1
29702,غبي,0,0,1,1
29699,ठंडी,0,0,1,1
29724,olsaydın,0,0,1,1
29681,naturligtvis,0,0,1,1
29670,γνωστό,0,0,1,1
29671,ರೆಸ್ಟೋರೆಂಟ್,0,0,1,1
29673,عارض,0,0,1,1
29674,programmering,0,0,1,1
29678,sh •,0,0,1,1
29679,λήμματά,0,0,1,1
29680,opzetten,0,0,1,1
29682,overhovedet,0,0,1,1
29697,ನಿಧಾನಗತಿಯಲ್ಲಿ,0,0,1,1
29687,प्रिक्स,0,0,1,1
29688,ലക്ഷത്തിൽ,0,0,1,1
29690,soğuk,0,0,1,1
29691,மறுத்துரைத்த,0,0,1,1
29692,мэттьюс,0,0,1,1
29693,बढ़ावा,0,0,1,1
29696,ಕಾಮೆಂಟ್‌ಗಳ,0,0,1,1
29721,ಬದಲಾಗಿ,0,0,1,1
29725,ತೆಗೆದುಕೊಳ್ಳಬೇಡಿ.,0,0,1,1
29668,tillstånd.,0,0,1,1
29768,ചെയ്യുകയായിരുന്നു.,0,0,1,1
29756,الأكبر،,0,0,1,1
29757,αδύνατη,0,0,1,1
29760,الرسوم,0,0,1,1
29761,maintenant.,0,0,1,1
29764,buysa,0,0,1,1
29765,filho,0,0,1,1
29767,الأغاني,0,0,1,1
29769,restoran.,0,0,1,1
29754,vänstermarginal.,0,0,1,1
29774,анонимного,0,0,1,1
29775,compraram,0,0,1,1
29776,erişime,0,0,1,1
29777,catalyst,0,0,1,1
29778,sağladı,0,0,1,1
29779,scenario,0,0,1,1
29780,formeel,0,0,1,1
29755,«активизируйте,0,0,1,1
29751,relations,0,0,1,1
29726,συνειδητοποιήσω,0,0,1,1
29738,oxygenation,0,0,1,1
29728,chamber,0,0,1,1
29729,союзе.,0,0,1,1
29730,यूक्रेनी,0,0,1,1
29731,марка,0,0,1,1
29733,weiß.,0,0,1,1
29734,exponentially,0,0,1,1
29735,kalmaktadır.,0,0,1,1
29739,izing,0,0,1,1
29750,നയിക്കും.,0,0,1,1
29740,draaide,0,0,1,1
29741,لمستخدمها,0,0,1,1
29742,connexion.,0,0,1,1
29745,vaincre,0,0,1,1
29746,«сообщить,0,0,1,1
29747,harsh,0,0,1,1
29749,जीते।,0,0,1,1
29669,integrating,0,0,1,1
29666,கட்டுரையிலும்,0,0,1,1
29554,प्राधिकारी,0,0,1,1
29593,διστάζω.,0,0,1,1
29582,предположим,0,0,1,1
29584,.vi,0,0,1,1
29586,surutilisé,0,0,1,1
29587,потерпи,0,0,1,1
29588,റൊട്ടിയുമായി,0,0,1,1
29589,подтверждает,0,0,1,1
29591,bloquea,0,0,1,1
29594,wesen,0,0,1,1
29580,coexistieron,0,0,1,1
29595,assinatura,0,0,1,1
29597,replace,0,0,1,1
29598,équatoriale,0,0,1,1
29599,ಬ್ಯಾಂಕ್‌ಗೆ,0,0,1,1
29600,bidra,0,0,1,1
29601,läsas,0,0,1,1
29602,sprecher,0,0,1,1
29581,frivilligt,0,0,1,1
29579,fark,0,0,1,1
29605,aziz,0,0,1,1
29565,lunar,0,0,1,1
29556,refus,0,0,1,1
29558,alia.,0,0,1,1
29559,rewrite,0,0,1,1
29560,islands,0,0,1,1
29562,page's,0,0,1,1
29563,telefônica,0,0,1,1
29564,d'hybrides,0,0,1,1
29567,meter,0,0,1,1
29578,μπράβο,0,0,1,1
29568,wunderbar,0,0,1,1
29569,ഉണ്ടാവില്ലെന്നർത്ഥം.,0,0,1,1
29571,предполагающих,0,0,1,1
29572,онлайн-энциклопедии.,0,0,1,1
29574,concluding,0,0,1,1
29575,upptäcka,0,0,1,1
29576,lyden,0,0,1,1
29603,wikipediaresurser,0,0,1,1
29606,editado,0,0,1,1
29665,பரவாயில்லை,0,0,1,1
29654,ಒಳ್ಳೆಯವರು,0,0,1,1
29641,விரும்புவதில்லை.,0,0,1,1
29644,μπροστά,0,0,1,1
29645,renunciou,0,0,1,1
29646,« significative,0,0,1,1
29648,considerarla,0,0,1,1
29649,ماريون.,0,0,1,1
29651,medias,0,0,1,1
29655,constitute,0,0,1,1
29638,करेगा,0,0,1,1
29656,voren,0,0,1,1
29657,magnifikt,0,0,1,1
29658,координируются,0,0,1,1
29659,in-jokes,0,0,1,1
29661,bron,0,0,1,1
29662,televisionhow,0,0,1,1
29663,renovable,0,0,1,1
29640,effects.,0,0,1,1
29636,élevés,0,0,1,1
29607,lyckligt,0,0,1,1
29617,comets,0,0,1,1
29609,arkadaşım,0,0,1,1
29611,ವಾರಗಳು,0,0,1,1
29612,எடுத்துக்காட்டில்,0,0,1,1
29613,sendte,0,0,1,1
29614,dada.,0,0,1,1
29615,debería,0,0,1,1
29616,actuelles,0,0,1,1
29618,ementas,0,0,1,1
29635,agilizar,0,0,1,1
29620,tv'de,0,0,1,1
29622,zukünftige,0,0,1,1
29623,gillar,0,0,1,1
29626,व्यतीत,0,0,1,1
29628,exercício,0,0,1,1
29630,நீங்கள்.,0,0,1,1
29634,किसने,0,0,1,1
29325,einkaufszentrum,0,0,1,1
29321,belonged,0,0,1,1
28852,يتعلَّم,0,0,1,1
29320,forty-two,0,0,1,1
28991,beeldmateriaal,0,0,1,1
28993,tilskynder,0,0,1,1
28995,لوصف,0,0,1,1
28996,отсюда.,0,0,1,1
28998,kommentere,0,0,1,1
28999,participative,0,0,1,1
29001,bære,0,0,1,1
29002,velkommen.,0,0,1,1
29004,times.,0,0,1,1
29005,शायरियां,0,0,1,1
29009,direct,0,0,1,1
29010,redigido,0,0,1,1
29011,yüzüme,0,0,1,1
29012,combinatoire.,0,0,1,1
29013,الأنماط,0,0,1,1
29015,impresión,0,0,1,1
29017,καλύπτει.,0,0,1,1
28990,பயனர்களும்,0,0,1,1
28989,планов.,0,0,1,1
28987,hakaretlere,0,0,1,1
28968,blackout,0,0,1,1
28959,sustained,0,0,1,1
28960,double,0,0,1,1
28961,.som,0,0,1,1
28963,نفسها،,0,0,1,1
28964,пытаетесь,0,0,1,1
28966,വൈകുന്നേരം,0,0,1,1
28967,νωρίτερα,0,0,1,1
28969,söylüyor.,0,0,1,1
28986,trovärdig,0,0,1,1
28974,والإيطالية,0,0,1,1
28979,pensait,0,0,1,1
28980,tolereras,0,0,1,1
28982,towards,0,0,1,1
28983,حافزًا,0,0,1,1
28984,eneste,0,0,1,1
28985,ужасном,0,0,1,1
29019,uttal,0,0,1,1
29020,rotord,0,0,1,1
29021,d'ordinateurs,0,0,1,1
29059,uppfattningar.,0,0,1,1
29050,n'es,0,0,1,1
29052,evlenme,0,0,1,1
29053,компания-владелец,0,0,1,1
29055,narcisa'ya,0,0,1,1
29056,ultimate,0,0,1,1
29057,معاملة,0,0,1,1
29058,وسائل,0,0,1,1
29060,பட்டியலில்,0,0,1,1
29046,comes.,0,0,1,1
29063,katıldığını,0,0,1,1
29067,baixa,0,0,1,1
29070,almennyttig,0,0,1,1
29071,yerini,0,0,1,1
29072,reclama,0,0,1,1
29073,essayait,0,0,1,1
29074,utgångspunkt.,0,0,1,1
29048,l'optique,0,0,1,1
29045,dagblad,0,0,1,1
29022,للتنفس,0,0,1,1
29034,p. ,0,0,1,1
29023,تسوية,0,0,1,1
29025,أدى,0,0,1,1
29027,êxtase,0,0,1,1
29028,தம்மிடையேயான,0,0,1,1
29030,vía,0,0,1,1
29031,الاسم,0,0,1,1
29032,பஸ்,0,0,1,1
29035,मिनांगकाबाउ,0,0,1,1
29043,expression,0,0,1,1
29036,дело,0,0,1,1
29037,смотрел,0,0,1,1
29038,franska,0,0,1,1
29039,gränssnitt,0,0,1,1
29040,शराबी,0,0,1,1
29041,eu •,0,0,1,1
29042,إجازة,0,0,1,1
28957,جننت,0,0,1,1
28956,amazed,0,0,1,1
28955,डेविड,0,0,1,1
28890,импакт-фактор,0,0,1,1
28883,διανεμηθεί,0,0,1,1
28884,l'offre.,0,0,1,1
28885,تستأنف,0,0,1,1
28886,acted,0,0,1,1
28887,сравнить,0,0,1,1
28888,ಸಭೆ.,0,0,1,1
28889,répondu,0,0,1,1
28891,حدد,0,0,1,1
28880,plage,0,0,1,1
28892,начаты,0,0,1,1
28895,உதவிகரமாக,0,0,1,1
28896,поймешь,0,0,1,1
28899,गड़बड़,0,0,1,1
28900,.if,0,0,1,1
28901,incrivelmente,0,0,1,1
28902,självmord,0,0,1,1
28882,interestingness.,0,0,1,1
28878,pré-adolescente,0,0,1,1
28905,puinhoop,0,0,1,1
28865,pekat,0,0,1,1
28855,പരുഷമായി,0,0,1,1
28856,communiqué,0,0,1,1
28858,μπερδευτείτε,0,0,1,1
28859,ബന്ധങ്ങൾ,0,0,1,1
28860,towns,0,0,1,1
28861,संपर्क,0,0,1,1
28862,discussão.,0,0,1,1
28866,uppsatser,0,0,1,1
28877,krama,0,0,1,1
28867,onani,0,0,1,1
28868,perdón.,0,0,1,1
28869,ಉಡುಪಿನಲ್ಲಿ,0,0,1,1
28873,فيرجينيا,0,0,1,1
28874,hæren,0,0,1,1
28875,hug,0,0,1,1
28876,foncière,0,0,1,1
28903,beschweren,0,0,1,1
28906,പദത്തിന്,0,0,1,1
28954,لوحي,0,0,1,1
28944,repositório.,0,0,1,1
28935,முயற்சிக்கு,0,0,1,1
28936,sekiz,0,0,1,1
28937,definan,0,0,1,1
28939,ಇಬ್ಬರೂ,0,0,1,1
28940,complet,0,0,1,1
28941,கேள்விப்பட்டிருக்கிறீர்கள்,0,0,1,1
28942,galactica,0,0,1,1
28945,urdu,0,0,1,1
28931,sucesivos,0,0,1,1
28946,ವಯಸ್ಸಿನ,0,0,1,1
28947,blijf,0,0,1,1
28948,énormément,0,0,1,1
28950,surgem,0,0,1,1
28951,करेगा।,0,0,1,1
28952,нем,0,0,1,1
28953,indépendants,0,0,1,1
28933,läroböcker,0,0,1,1
28929,signs,0,0,1,1
28907,geliştireceği,0,0,1,1
28916,इंगित,0,0,1,1
28909,βελτιώστε,0,0,1,1
28910,durmiendo,0,0,1,1
28911,தவிர்ப்பது.,0,0,1,1
28912,sofra,0,0,1,1
28913,rattachés,0,0,1,1
28914,ಗೆಳತಿ,0,0,1,1
28915,дорабатывали,0,0,1,1
28917,तूफानी,0,0,1,1
28928,تحديد,0,0,1,1
28918,longo,0,0,1,1
28919,schommelt,0,0,1,1
28920,συνεχίσουμε,0,0,1,1
28923,meanings,0,0,1,1
28924,явно,0,0,1,1
28925,største,0,0,1,1
28927,iletişimde,0,0,1,1
29076,arguably,0,0,1,1
29077,anunciaram,0,0,1,1
29079,ijsbrand,0,0,1,1
29249,implementaciones,0,0,1,1
29239,அடைந்தார்.,0,0,1,1
29243,skönhet.,0,0,1,1
29244,arg.,0,0,1,1
29245,гриффитом,0,0,1,1
29246,продолжим,0,0,1,1
29247,costumes,0,0,1,1
29248,contienen,0,0,1,1
29250,varlıklardı,0,0,1,1
29237,deviendra,0,0,1,1
29252,ken.,0,0,1,1
29253,case.,0,0,1,1
29254,установил,0,0,1,1
29255,müstakbel,0,0,1,1
29256,كلمتك,0,0,1,1
29257,tirar,0,0,1,1
29261,помещаю,0,0,1,1
29238,comê-lo,0,0,1,1
29236,पुस्तकें,0,0,1,1
29263,سانجر،,0,0,1,1
29220,kullanabilirler,0,0,1,1
29205,редактируемой,0,0,1,1
29208,dedicaba,0,0,1,1
29210,opsummeringer,0,0,1,1
29211,korku,0,0,1,1
29214,coincided,0,0,1,1
29215,görülebilir.,0,0,1,1
29219,разочарованием,0,0,1,1
29222,traditionellt,0,0,1,1
29235,التكنولوجيا.,0,0,1,1
29223,إطلاقه,0,0,1,1
29227,bons.,0,0,1,1
29229,chair,0,0,1,1
29230,sheets.,0,0,1,1
29231,fr •,0,0,1,1
29233,improvements,0,0,1,1
29234,damaging,0,0,1,1
29262,afirmando,0,0,1,1
29264,பொறுமையாகவும்,0,0,1,1
29201,prinzen,0,0,1,1
29305,وصيغة,0,0,1,1
29294,ಬಳಸಲು,0,0,1,1
29297,dens,0,0,1,1
29299,περιγράψετε,0,0,1,1
29300,αναφοράς,0,0,1,1
29301,träge.,0,0,1,1
29303,തിരുത്തലുകളോട്,0,0,1,1
29304,புகழ்பெற்ற,0,0,1,1
29307,preferences,0,0,1,1
29291,transclusão,0,0,1,1
29308,കർഷകൻ,0,0,1,1
29309,считает,0,0,1,1
29310,sendes,0,0,1,1
29312,३९,0,0,1,1
29313,coordinate,0,0,1,1
29315,vaud,0,0,1,1
29319,preferindo,0,0,1,1
29292,современных,0,0,1,1
29289,поддерживаемые,0,0,1,1
29265,преданная,0,0,1,1
29274,paced.,0,0,1,1
29266,exponencialmente,0,0,1,1
29267,ಕುಳಿತುಕೊಳ್ಳುವ,0,0,1,1
29268,deren,0,0,1,1
29270,ಅತೃಪ್ತಿಯನ್ನು,0,0,1,1
29271,arbetar,0,0,1,1
29272,examples/tasks,0,0,1,1
29273,ഇവിടെയെത്തി,0,0,1,1
29277,χρυσές,0,0,1,1
29288,yalnızca,0,0,1,1
29279,diminishing,0,0,1,1
29280,الوصمي.,0,0,1,1
29281,تنحاز,0,0,1,1
29282,medewerker,0,0,1,1
29283,துறையில்,0,0,1,1
29286,நகலெடுக்க,0,0,1,1
29287,zihinsel,0,0,1,1
29202,εγχειρίδια,0,0,1,1
29200,katılım,0,0,1,1
29080,सामान्य।,0,0,1,1
29130,oylamalarına,0,0,1,1
29117,ಯೋಚಿಸೋಣ.,0,0,1,1
29118,duplicating,0,0,1,1
29120,पैसा,0,0,1,1
29121,рецензированы,0,0,1,1
29124,ಹೋಗಬೇಕು,0,0,1,1
29128,principios,0,0,1,1
29129,klass.,0,0,1,1
29131,ചിലരാകട്ടെ,0,0,1,1
29115,controlled,0,0,1,1
29132,ستفعل,0,0,1,1
29135,cameron,0,0,1,1
29136,بمعايير,0,0,1,1
29137,ರವಾನಿಸಬಹುದು,0,0,1,1
29138,шумиха,0,0,1,1
29139,വെള്ളിയാഴ്ചയാണെങ്കിൽ.,0,0,1,1
29142,signpost,0,0,1,1
29116,совокупность,0,0,1,1
29114,يجيب,0,0,1,1
29144,opiniones,0,0,1,1
29099,مروع,0,0,1,1
29081,geistig,0,0,1,1
29084,उठाये,0,0,1,1
29086,மாட்டாள்,0,0,1,1
29087,अरागोनियाई,0,0,1,1
29090,έκδοση,0,0,1,1
29093,പരാജയങ്ങൾക്ക്,0,0,1,1
29098,illimité,0,0,1,1
29100,particulier ,0,0,1,1
29113,hazırsınız,0,0,1,1
29101,jp.dk,0,0,1,1
29102,bénévoles.,0,0,1,1
29103,lt •,0,0,1,1
29108,ശ്രമിക്കുകയായിരുന്നു,0,0,1,1
29109,gecultiveerd,0,0,1,1
29110,fortsætter,0,0,1,1
29112,للبنك,0,0,1,1
29143,politikasıdır.,0,0,1,1
29145,παζλ,0,0,1,1
29199,sensacional.,0,0,1,1
29184,«wikiality».,0,0,1,1
29176,spiel.,0,0,1,1
29177,évoluent,0,0,1,1
29178,считать,0,0,1,1
29179,gefängnissen,0,0,1,1
29181,definerer,0,0,1,1
29182,uhr.,0,0,1,1
29183,serres,0,0,1,1
29185,ridge,0,0,1,1
29171,sneezed,0,0,1,1
29186,परिभाषायें,0,0,1,1
29187,repasse,0,0,1,1
29188,நடத்தை,0,0,1,1
29189,ax,0,0,1,1
29191,kød,0,0,1,1
29195,head.,0,0,1,1
29196,الحاسوب,0,0,1,1
29175,കോണാണ്,0,0,1,1
29170,representante,0,0,1,1
29146,வழங்கிக்,0,0,1,1
29154,sökmotorer,0,0,1,1
29147,പെരുമാറിയ,0,0,1,1
29148,உத்தியோகபூர்வ,0,0,1,1
29149,máster,0,0,1,1
29150,morality.,0,0,1,1
29151,основным,0,0,1,1
29152,mature,0,0,1,1
29153,publiquement,0,0,1,1
29155,சொற்களின்,0,0,1,1
29169,abraçar,0,0,1,1
29156,capacidad,0,0,1,1
29157,κανένα,0,0,1,1
29158,viens,0,0,1,1
29161,இயல்பாக,0,0,1,1
29162,ഉദ്യമമായി,0,0,1,1
29164,ஆண்டுகளாக,0,0,1,1
29166,sabatier,0,0,1,1
24043,ഘട്ടത്തിൽ,0,0,1,1
24041,relecture,0,0,1,1
16269,лучшее,0,0,1,1
18699,vérifiables,0,0,1,1
18852,υγρότοπου,0,0,1,1
18853,desigualdades,0,0,1,1
18854,viessem,0,0,1,1
18856,προτιμούσα,0,0,1,1
18857,warst.,0,0,1,1
18858,full-length,0,0,1,1
18859,الكلام,0,0,1,1
18860,ложные,0,0,1,1
18861,spiser.,0,0,1,1
18862,matérielle.,0,0,1,1
18863,kleidungssinn,0,0,1,1
18864,സുഖമാണോ,0,0,1,1
18865,spannends,0,0,1,1
18867,ജോലികൾ,0,0,1,1
18868,deux.,0,0,1,1
18869,आंद्रे,0,0,1,1
18870,подмигнули.,0,0,1,1
18851,viola,0,0,1,1
18850,ಮಾಡಿದ್ದರೆ,0,0,1,1
18849,garantir,0,0,1,1
18832,prettiest,0,0,1,1
18825,ईमेल,0,0,1,1
18826,одноимённым,0,0,1,1
18827,الواحد.,0,0,1,1
18828,kæpheste,0,0,1,1
18829,gegevens.,0,0,1,1
18830,enciclopédicos,0,0,1,1
18831,relire,0,0,1,1
18839,employée,0,0,1,1
18848,സമ്പ്രദായത്തെ,0,0,1,1
18840,functionality,0,0,1,1
18841,اللحظة,0,0,1,1
18842,gekopieerde,0,0,1,1
18843,bienvenidos,0,0,1,1
18844,محظوظًا,0,0,1,1
18846,കന്നഡ,0,0,1,1
18847,துடிக்கிறது.,0,0,1,1
18873,sl •,0,0,1,1
18874,menino,0,0,1,1
18875,désignées,0,0,1,1
18921,leckeren,0,0,1,1
18909,destinadas,0,0,1,1
18911,reviendra,0,0,1,1
18912,mystère,0,0,1,1
18913,स्लेव,0,0,1,1
18915,eminim,0,0,1,1
18916,അലക്കു,0,0,1,1
18920,sebebiyet,0,0,1,1
18922,पक्षपातहीन,0,0,1,1
18907,ταξίδευαν,0,0,1,1
18923,vän.,0,0,1,1
18924,cümleleri,0,0,1,1
18925,अति,0,0,1,1
18927,χαζή,0,0,1,1
18928,reporters,0,0,1,1
18929,ಕೋನದಲ್ಲಿ,0,0,1,1
18930,veckotidskrifterna,0,0,1,1
18908,cayo,0,0,1,1
18906,l’animisme,0,0,1,1
18876,cumplan,0,0,1,1
18886,delecionismo,0,0,1,1
18878,സംസാരിക്കുന്നുണ്ടാകാം,0,0,1,1
18879,anlamadınız,0,0,1,1
18881,октября,0,0,1,1
18882,diep,0,0,1,1
18883,haklıydın,0,0,1,1
18884,ننتقل,0,0,1,1
18885,deletionism,0,0,1,1
18887,കണ്ടിട്ടില്ലെന്നാണ്,0,0,1,1
18905,റഷ്യൻ,0,0,1,1
18890,δολάρια,0,0,1,1
18891,centradas,0,0,1,1
18893,neerlandesa,0,0,1,1
18896,simbólicos,0,0,1,1
18899,logowedstrijd,0,0,1,1
18900,spectre,0,0,1,1
18904,ಸೈನಿಕರಿಗೆ,0,0,1,1
18824,sigue.,0,0,1,1
18823,d'influence,0,0,1,1
18822,participative ».,0,0,1,1
18740,amplo,0,0,1,1
18731,مولاي,0,0,1,1
18732,اللازم,0,0,1,1
18734,.therefore,0,0,1,1
18736,متى,0,0,1,1
18737,ಎಲ್ಲೋ,0,0,1,1
18738,ensaísticos,0,0,1,1
18739,trist,0,0,1,1
18741,όμορφα,0,0,1,1
18725,திருத்தங்கள்,0,0,1,1
18743,riesigen,0,0,1,1
18744,feeder,0,0,1,1
18746,solutions,0,0,1,1
18747,permises[x].,0,0,1,1
18748,городе,0,0,1,1
18749,partenariats,0,0,1,1
18753,havaiana,0,0,1,1
18728,подверженных,0,0,1,1
18724,ആസ്പദമാക്കി,0,0,1,1
18757,വിളിച്ചു,0,0,1,1
18710,befinner,0,0,1,1
18702,अम्हारिक,0,0,1,1
18703,παρακολουθείτε.,0,0,1,1
18704,உரைக்கு,0,0,1,1
18705,особенности,0,0,1,1
18706,डबल,0,0,1,1
18708,raisonnable »,0,0,1,1
18709,originalartiklar,0,0,1,1
18711,tian'anmen,0,0,1,1
18723,неизвестна.,0,0,1,1
18712,permissão.,0,0,1,1
18715,incompatible,0,0,1,1
18716,സംസ്കാരത്തെപ്പറ്റിയുമൊക്കെയുള്ള,0,0,1,1
18717,лицензируются,0,0,1,1
18720,γενικά,0,0,1,1
18721,عقليًا,0,0,1,1
18722,caught,0,0,1,1
18755,सिर,0,0,1,1
18758,ಎಂಬುದರಂತೆ,0,0,1,1
18821,udgav,0,0,1,1
18806,begreppet,0,0,1,1
18799,aude,0,0,1,1
18800,υπήρχε,0,0,1,1
18801,ortak,0,0,1,1
18802,« dans,0,0,1,1
18803,grijze,0,0,1,1
18804,yapmanı,0,0,1,1
18805,d'évaluation,0,0,1,1
18807,artistic,0,0,1,1
18796,evidencia,0,0,1,1
18808,hittat,0,0,1,1
18809,unverifiable,0,0,1,1
18812,موظفين,0,0,1,1
18815,évidentes.,0,0,1,1
18817,टेलीविजन,0,0,1,1
18818,ನೆನಪಿಡಿ,0,0,1,1
18820,choro,0,0,1,1
18798,nascor,0,0,1,1
18793,लगेगा,0,0,1,1
18760,ಕೊರತೆಯನ್ನು,0,0,1,1
18775,ക്ഷീണവും,0,0,1,1
18763,ദിനമായി,0,0,1,1
18764,sökningen,0,0,1,1
18765,mücadeleyi,0,0,1,1
18767,en.m.wikipedia.org.,0,0,1,1
18768,cadeau,0,0,1,1
18769,ഭ്രാന്തൻ,0,0,1,1
18774,dårligt.,0,0,1,1
18778,скрестите,0,0,1,1
18791,réalisation,0,0,1,1
18779,мужчин,0,0,1,1
18780,turkiet,0,0,1,1
18781,lícita.,0,0,1,1
18786,reflejarse,0,0,1,1
18788,анализом,0,0,1,1
18789,διανομή,0,0,1,1
18790,prohíbe,0,0,1,1
18932,ಯೂಟ್ಯೂಬ್‌ನಲ್ಲಿ,0,0,1,1
18933,enfants,0,0,1,1
18934,ξεχνάει.,0,0,1,1
19088,خارجية،,0,0,1,1
19080,നഷ്‌ടപ്പെട്ടു,0,0,1,1
19081,relus,0,0,1,1
19082, علمية,0,0,1,1
19083,replaces,0,0,1,1
19084,roda,0,0,1,1
19086,comentários,0,0,1,1
19087,abartmak,0,0,1,1
19091,बुगिनी,0,0,1,1
19077,معنا,0,0,1,1
19092,أخبرني,0,0,1,1
19094,approved,0,0,1,1
19095,تتصدر,0,0,1,1
19096,encargado,0,0,1,1
19097,tränen,0,0,1,1
19098,दयालु,0,0,1,1
19099,fleste,0,0,1,1
19078,servantes,0,0,1,1
19076,صغيرة.,0,0,1,1
19101,afastando-se,0,0,1,1
19060,mantle,0,0,1,1
19049,raro,0,0,1,1
19050,formatering.,0,0,1,1
19051,വ്യാജ,0,0,1,1
19052,foregik,0,0,1,1
19054,hjerne,0,0,1,1
19055,വേണ്ടെന്ന്,0,0,1,1
19057,قولها.,0,0,1,1
19061,gerçekleşir,0,0,1,1
19075,надёжности,0,0,1,1
19063,hamburger,0,0,1,1
19065,ஒழுங்கமைக்கப்பட்டிருக்கும்.,0,0,1,1
19067,flooding,0,0,1,1
19068,കർമ്മ,0,0,1,1
19069,أمس,0,0,1,1
19073,sun.,0,0,1,1
19074,utgåvorna,0,0,1,1
19100,femininas,0,0,1,1
19103,സാഹചര്യത്തെ,0,0,1,1
19047,nodes,0,0,1,1
19140,علاوة,0,0,1,1
19131,दान,0,0,1,1
19132,பயிற்சி,0,0,1,1
19133,problème.,0,0,1,1
19134,teveel,0,0,1,1
19135,terminal.,0,0,1,1
19136,searching.,0,0,1,1
19137,crescente.,0,0,1,1
19141,écrivit,0,0,1,1
19128,planeo,0,0,1,1
19142,hatam.,0,0,1,1
19143,estén,0,0,1,1
19146,mirando,0,0,1,1
19147,energética,0,0,1,1
19148,van.,0,0,1,1
19149,​larry,0,0,1,1
19150,s'arrêtait,0,0,1,1
19130,संसाधन,0,0,1,1
19127,domination,0,0,1,1
19104,മറക്കരുത്,0,0,1,1
19114,நிர்வாகிகளினால்,0,0,1,1
19105,பாருங்கள்.,0,0,1,1
19107,javanês,0,0,1,1
19108,потрясающе»,0,0,1,1
19109,प्रकाशनों,0,0,1,1
19110,संदेह,0,0,1,1
19112,കണക്കാക്കാം.,0,0,1,1
19113,requeria,0,0,1,1
19115,statistiquement,0,0,1,1
19125,ಕ್ರಿಯಾಪದವಾಗಿ,0,0,1,1
19117,neutral»,0,0,1,1
19118,p.m..,0,0,1,1
19119,حياتها,0,0,1,1
19120,கருத்தொருமிப்புப்,0,0,1,1
19121,cycle,0,0,1,1
19122,rakesh,0,0,1,1
19124,impulsado,0,0,1,1
19048,स्कोप,0,0,1,1
19045,الإتمامِ,0,0,1,1
18935,proposer,0,0,1,1
18974,ಮುಕ್ತರಾಗಿದ್ದೀರಾ,0,0,1,1
18964,இருந்தார்கள்.,0,0,1,1
18965,وسيم,0,0,1,1
18966,mínima,0,0,1,1
18967,आयी,0,0,1,1
18970,commentary,0,0,1,1
18972,ഇന്ത്യയിൽ,0,0,1,1
18973,inexacta,0,0,1,1
18975,oturuyor.,0,0,1,1
18960,übliche.,0,0,1,1
18976,வெளியேற,0,0,1,1
18977,الويكي.,0,0,1,1
18978,चुपके,0,0,1,1
18979,തീരുമാനമാണെന്നും,0,0,1,1
18980,trabalhista,0,0,1,1
18981,അല്ല.,0,0,1,1
18982,operations.,0,0,1,1
18961,« d'entraînement »,0,0,1,1
18959,fria,0,0,1,1
18984,பார்த்தான்,0,0,1,1
18946,invite,0,0,1,1
18936,poliment.,0,0,1,1
18939,n'étaient,0,0,1,1
18940,سياق,0,0,1,1
18942,неспособность,0,0,1,1
18943,altruista,0,0,1,1
18944,βοηθήσω.,0,0,1,1
18945,permiso.,0,0,1,1
18947,πάρω.,0,0,1,1
18958,igualmente,0,0,1,1
18948,kaffee,0,0,1,1
18950,معا,0,0,1,1
18952,تضع,0,0,1,1
18953,ಗೋಲ್ಡನ್,0,0,1,1
18954,उत्साहित,0,0,1,1
18955,उठाते,0,0,1,1
18956,δροσερές,0,0,1,1
18983,unreliable,0,0,1,1
18985,defecto,0,0,1,1
19044,wonder,0,0,1,1
19033,funktionsprincip,0,0,1,1
19023,luminosity,0,0,1,1
19025,startet.,0,0,1,1
19026,varient,0,0,1,1
19028,tipografía,0,0,1,1
19029,prefixo,0,0,1,1
19030,மீளமைக்கப்படக்,0,0,1,1
19031,ontmoeten.,0,0,1,1
19034,leída,0,0,1,1
19021,इलेक्ट्रोनिका,0,0,1,1
19035,മറക്കുന്നു.,0,0,1,1
19036,ich',0,0,1,1
19038,évoquant,0,0,1,1
19040,معقولة,0,0,1,1
19041,naïvement,0,0,1,1
19042,ложной,0,0,1,1
19043,பரவாயில்லை.,0,0,1,1
19022,அழுகிறீர்கள்,0,0,1,1
19020,ಖಂಡಿತವಾಗಿಯೂ,0,0,1,1
18986,تبكي؟,0,0,1,1
19000,любила,0,0,1,1
18987,diseases.,0,0,1,1
18988,വിശ്വസിക്കാൻ,0,0,1,1
18989,усталым,0,0,1,1
18992,cuadro,0,0,1,1
18994,regeln,0,0,1,1
18997,gagner,0,0,1,1
18999,decomposition,0,0,1,1
19001,beskytte,0,0,1,1
19019,कूद,0,0,1,1
19004,உயரிய,0,0,1,1
19005,valendo,0,0,1,1
19006,boken,0,0,1,1
19009,klottrares,0,0,1,1
19010,हेल्लो,0,0,1,1
19014,நியூயார்க்கைச்,0,0,1,1
19016,أسمع,0,0,1,1
18701,разрешает,0,0,1,1
18698,entran,0,0,1,1
19154,açıklar.,0,0,1,1
18695,ஏதோ,0,0,1,1
18359,praktiken,0,0,1,1
18360,أتمنى,0,0,1,1
18362,обсерватории»,0,0,1,1
18364,ശാസ്ത്രം ·geosciences ·soil,0,0,1,1
18368,жена,0,0,1,1
18371,κεντρικής,0,0,1,1
18374,«sensibles»,0,0,1,1
18375,защита.,0,0,1,1
18376,гриллини,0,0,1,1
18377,lågkvalitetsändringar,0,0,1,1
18379,китайских,0,0,1,1
18380,تعديلات،,0,0,1,1
18381,disent,0,0,1,1
18382,ഓൺലൈൻ',0,0,1,1
18384,credentials,0,0,1,1
18385,numériques,0,0,1,1
18386,frygtelige,0,0,1,1
18358,വിറ്റു,0,0,1,1
18357,pareciam,0,0,1,1
18356,ചവറും,0,0,1,1
18344,отдельных,0,0,1,1
18335,güzelliğe,0,0,1,1
18336,quick,0,0,1,1
18338,उदास,0,0,1,1
18340,ತಿನ್ನಬಹುದಾದ,0,0,1,1
18341,belongs.,0,0,1,1
18342,wanted,0,0,1,1
18343,oneetbaar,0,0,1,1
18346,लेखकों,0,0,1,1
18355,suggérant,0,0,1,1
18347,visually,0,0,1,1
18348,ಮುಳುಗುವುದು,0,0,1,1
18350,എഴുതുന്നത്.,0,0,1,1
18351,estagnação,0,0,1,1
18352,artificiell,0,0,1,1
18353,bildiğim,0,0,1,1
18354,ننظر,0,0,1,1
18388,bs •,0,0,1,1
18389,hugely,0,0,1,1
18390,kanunlarına,0,0,1,1
18426,இலவச,0,0,1,1
18418,المشاريع،,0,0,1,1
18419,raccorder,0,0,1,1
18420,നോക്കിയിരുന്നു,0,0,1,1
18421,απόψεις.,0,0,1,1
18422,denir.,0,0,1,1
18423,conozcas,0,0,1,1
18424,слово».,0,0,1,1
18427,sidst.,0,0,1,1
18416,पैन्सिलवेनियाई,0,0,1,1
18428,بلاد,0,0,1,1
18431,news.,0,0,1,1
18434,மறக்காதீர்கள்,0,0,1,1
18435,offering.,0,0,1,1
18436,സൃഷ്ടികളേയും,0,0,1,1
18437,സത്യം,0,0,1,1
18438,επίσης.,0,0,1,1
18417,скрещенные,0,0,1,1
18415,أعداد,0,0,1,1
18391,migration.,0,0,1,1
18403,विख्याति,0,0,1,1
18392,செயல்களைப்,0,0,1,1
18396,keşfi,0,0,1,1
18397,ചതുപ്പ്,0,0,1,1
18398,ஸ்டுபண்டஸ்,0,0,1,1
18399,asien,0,0,1,1
18401,हेंडलिंग,0,0,1,1
18402,ടൈപ്പുചെയ്യുക,0,0,1,1
18404,yapabilirim,0,0,1,1
18414,ಅವಕಾಶವಿಲ್ಲ,0,0,1,1
18405,croyances,0,0,1,1
18406,πληροφορίες,0,0,1,1
18407,datters,0,0,1,1
18409,உருவாக்கப்பட்ட,0,0,1,1
18411,भयावह,0,0,1,1
18412,çalışmayı,0,0,1,1
18413,пошли,0,0,1,1
18332,opmuntre,0,0,1,1
18331,момента,0,0,1,1
18329,fanger,0,0,1,1
18237,сайты,0,0,1,1
18226,précédente,0,0,1,1
18227,جزءًا,0,0,1,1
18230,المدهشة,0,0,1,1
18231,ഭാഗ്യവാനായ,0,0,1,1
18232,privata,0,0,1,1
18233,revolves,0,0,1,1
18235,aanleidinggevend,0,0,1,1
18239,ಕಲಿಯಿರಿ,0,0,1,1
18224,högskola.,0,0,1,1
18240,பசியாக,0,0,1,1
18241,прекрасна,0,0,1,1
18242,clasificado,0,0,1,1
18244,الكتب,0,0,1,1
18245,belle.,0,0,1,1
18246,lagstiftningen,0,0,1,1
18247,ακαδημαϊκό,0,0,1,1
18225,പ്രസിദ്ധീകരണങ്ങളും,0,0,1,1
18223,صالح,0,0,1,1
18253,σαλάτες,0,0,1,1
18209,للاستفادة,0,0,1,1
18194,geográfica,0,0,1,1
18195,письме,0,0,1,1
18197,اقبل,0,0,1,1
18200,അഭിപ്രായമില്ല.,0,0,1,1
18204,målet,0,0,1,1
18206,psychologie,0,0,1,1
18208,nordkorea,0,0,1,1
18210,isst.,0,0,1,1
18222,വിവരങ്ങളലൂടെ,0,0,1,1
18211,பதிப்பொன்றை,0,0,1,1
18212,встретить,0,0,1,1
18213,toets,0,0,1,1
18215,முதற்பக்கத்தில்,0,0,1,1
18218,peace,0,0,1,1
18220,βαθιά,0,0,1,1
18221,crítico,0,0,1,1
18251,internacionalmente,0,0,1,1
18254,interdit,0,0,1,1
18328,commentaire.,0,0,1,1
18314,நடைமுறையை,0,0,1,1
18306,स्लेशडॉट,0,0,1,1
18308,fassiez,0,0,1,1
18309,velkommen,0,0,1,1
18310,åldrarna,0,0,1,1
18311,anlatabilirsiniz.,0,0,1,1
18312,കഴിക്കേണ്ടതുണ്ട്,0,0,1,1
18313,எதிரான,0,0,1,1
18315,حولها,0,0,1,1
18303,युद्ध,0,0,1,1
18316,fremstille,0,0,1,1
18319,பார்ப்போம்.,0,0,1,1
18320,الطحين,0,0,1,1
18321,नेपाली,0,0,1,1
18322,wil.,0,0,1,1
18324,पीपुल्स,0,0,1,1
18326,слубице,0,0,1,1
18304,உருவாக்கத்திற்கான,0,0,1,1
18302,verwarren.,0,0,1,1
18255,exigir,0,0,1,1
18272,«отделения,0,0,1,1
18256,afluencia,0,0,1,1
18258,gouvernance,0,0,1,1
18259,വലുതാണെന്ന്,0,0,1,1
18260,ಪ್ರೀತಿಯ,0,0,1,1
18261,raakte,0,0,1,1
18262,abiertas,0,0,1,1
18265,τηλεγραφήματος,0,0,1,1
18273,steady,0,0,1,1
18297,نشطة.,0,0,1,1
18275,övergett,0,0,1,1
18279,സ്ഥാനത്ത്,0,0,1,1
18285,последнюю,0,0,1,1
18288,группу,0,0,1,1
18290,ಅರ್ಪಿಸಿದ್ದಕ್ಕಾಗಿ,0,0,1,1
18292,dwaze,0,0,1,1
18293,يساهم,0,0,1,1
18439,مستاء,0,0,1,1
18440,أتزوجك,0,0,1,1
18442,كلها,0,0,1,1
18610,writing.,0,0,1,1
18599,nacional,0,0,1,1
18600,تطوّر,0,0,1,1
18601,ഭാഗ്യവാനാണെന്ന്,0,0,1,1
18602,ലോകം,0,0,1,1
18604,homework,0,0,1,1
18605,நிறுவனமான,0,0,1,1
18608,planları,0,0,1,1
18611,äter.,0,0,1,1
18594,تتبعهم،,0,0,1,1
18612,nelerdir,0,0,1,1
18614,رأيت.,0,0,1,1
18615,fuhr,0,0,1,1
18619,baixos.,0,0,1,1
18621,acarrearía,0,0,1,1
18622,trevligare,0,0,1,1
18623,огромного,0,0,1,1
18596,versionshistorik,0,0,1,1
18593,l'import,0,0,1,1
18630,niesde,0,0,1,1
18578,лицензированная,0,0,1,1
18567,أقسام,0,0,1,1
18571,μοντέλο,0,0,1,1
18572,kende,0,0,1,1
18573,clear.,0,0,1,1
18574,'kan,0,0,1,1
18575,triggered,0,0,1,1
18576,വായനക്കാരന്റെ,0,0,1,1
18581,എത്തിച്ചേരുകയാണ്,0,0,1,1
18592,aplicar,0,0,1,1
18583,caps,0,0,1,1
18584,intimate,0,0,1,1
18585,mdp.,0,0,1,1
18586,arménio,0,0,1,1
18587,persistaient,0,0,1,1
18588,تلتقي,0,0,1,1
18590,verkeert,0,0,1,1
18627,pornografía,0,0,1,1
18631,egoïstische,0,0,1,1
18563,achtergelaten,0,0,1,1
18686,ಬೆರಳುಗಳು,0,0,1,1
18673,അന്താരാഷ്ട്ര,0,0,1,1
18674,exceto,0,0,1,1
18675,matthews,0,0,1,1
18679,diyelim,0,0,1,1
18680,entry.,0,0,1,1
18682,قائلاً،,0,0,1,1
18684,ಕೆಲವೇ,0,0,1,1
18687,sowieso,0,0,1,1
18670,βυθιστεί,0,0,1,1
18688,servers.,0,0,1,1
18689,जापान,0,0,1,1
18690,zevkle.,0,0,1,1
18691,participação.,0,0,1,1
18692,utgivningsbevis,0,0,1,1
18693,defendem,0,0,1,1
18694,voorstellen.,0,0,1,1
18672,изменчивое,0,0,1,1
18667,சொல்வதைச்,0,0,1,1
18633,சாதாரண,0,0,1,1
18650,revelado,0,0,1,1
18637,ಮುಂದುವರಿಯಲು,0,0,1,1
18639,görünmesine,0,0,1,1
18640,kullanılıyordu,0,0,1,1
18642,токио,0,0,1,1
18644,διαμαρτύρεται,0,0,1,1
18647,tests,0,0,1,1
18649,بيزنس,0,0,1,1
18651,sistêmicos.,0,0,1,1
18666,komende,0,0,1,1
18652,таинственное,0,0,1,1
18655,marcher.,0,0,1,1
18659,lægger,0,0,1,1
18660,qualificatif,0,0,1,1
18661,والإسبانية,0,0,1,1
18663,интернет-энциклопедия,0,0,1,1
18664,δύσκολη,0,0,1,1
18564,chemistry,0,0,1,1
18562,ಕ್ಷಮೆಯಾಚಿಸುತ್ತಿದೆ.,0,0,1,1
18443,diste,0,0,1,1
18483,suporte,0,0,1,1
18473,egal.,0,0,1,1
18474,ಮನುಷ್ಯನಿಗೆ,0,0,1,1
18477,dantas,0,0,1,1
18478,ചിലപ്പോഴെല്ലാം,0,0,1,1
18479,huvudet.,0,0,1,1
18480,ಶುಭಾಶಯಗಳು,0,0,1,1
18482,சைர்,0,0,1,1
18484,اليومي,0,0,1,1
18470,ಸಮಯಕ್ಕೆ,0,0,1,1
18485,திட்டங்களைச்,0,0,1,1
18487,minuto.,0,0,1,1
18488,promotional,0,0,1,1
18489,dépositaire,0,0,1,1
18490,जितना,0,0,1,1
18491,rebanada,0,0,1,1
18493,സാമുവൽ,0,0,1,1
18471,wikipediaprojektets,0,0,1,1
18469,outnumbered,0,0,1,1
18496,skillnad,0,0,1,1
18455,контринтуитивную,0,0,1,1
18444,importants,0,0,1,1
18447,interrelated.,0,0,1,1
18448,pestañas,0,0,1,1
18449,την.,0,0,1,1
18450,undgår,0,0,1,1
18451,accord,0,0,1,1
18454,तुम।,0,0,1,1
18456,dikes,0,0,1,1
18468,حدث,0,0,1,1
18460,[i]t,0,0,1,1
18461,σιγουρευτείτε,0,0,1,1
18463,weinberger en.,0,0,1,1
18464,bereit,0,0,1,1
18465,वेंबेर्गेर,0,0,1,1
18466,പിടിച്ചില്ല.,0,0,1,1
18467,ಮೊದಲನೆಯದನ್ನು,0,0,1,1
18494,história,0,0,1,1
18497,hazırlayıp,0,0,1,1
18561,cinste,0,0,1,1
18546,alloué,0,0,1,1
18533,இணையதளம்,0,0,1,1
18534,συγχαρώ,0,0,1,1
18535,demeliyim.,0,0,1,1
18536,meget.,0,0,1,1
18537,ആഗ്രഹിക്കുന്നുവെന്നും,0,0,1,1
18540,fortement,0,0,1,1
18541,editando,0,0,1,1
18548,verkozen.,0,0,1,1
18531,opposé,0,0,1,1
18549,continuam,0,0,1,1
18551,acudirse,0,0,1,1
18552,contradictoires.,0,0,1,1
18553,communes,0,0,1,1
18555,μαθητές,0,0,1,1
18559,выиграла,0,0,1,1
18560,programmeur,0,0,1,1
18532,ഉയർത്തുകയും,0,0,1,1
18530,обзор,0,0,1,1
18499,निका,0,0,1,1
18511,indkøbscentret,0,0,1,1
18500,ಓಡಿಹೋದಳು,0,0,1,1
18502,равен,0,0,1,1
18503,narsis,0,0,1,1
18505,energia,0,0,1,1
18508,univers,0,0,1,1
18509,википе́дия,0,0,1,1
18510,volgt,0,0,1,1
18512,yapılmış,0,0,1,1
18529,hoe.,0,0,1,1
18513,webbgränssnitt,0,0,1,1
18516,focalicen,0,0,1,1
18519,विकिट्रेवल,0,0,1,1
18520,fotografering,0,0,1,1
18523,connectée.,0,0,1,1
18527,litígios.,0,0,1,1
18528,स्टेटस,0,0,1,1
19151,ಹಣವನ್ನು,0,0,1,1
19155,συμπεριλαμβανομένης,0,0,1,1
18191,misleidende,0,0,1,1
19647,fictitious,0,0,1,1
19791,superan,0,0,1,1
19793,computadora.,0,0,1,1
19795,suddenly,0,0,1,1
19796,rape,0,0,1,1
19797,സാധ്യമാക്കിയത്,0,0,1,1
19798,مهلا,0,0,1,1
19799,regularly,0,0,1,1
19801,начнем.,0,0,1,1
19803,nuttige,0,0,1,1
19805,simplificadas,0,0,1,1
19806,المختلفة,0,0,1,1
19807,delivers,0,0,1,1
19808,alweer,0,0,1,1
19810,toptijdschriften,0,0,1,1
19811,ಬನ್ನಿ.,0,0,1,1
19815,autoritário.,0,0,1,1
19817,dilerim.,0,0,1,1
19790,उत्कृष्ट-विरोधी,0,0,1,1
19789,jedes,0,0,1,1
19787,продала,0,0,1,1
19773,ಉಪ್ಪು,0,0,1,1
19763,iie siècle,0,0,1,1
19764,الهدف.,0,0,1,1
19767,engeller.,0,0,1,1
19769,ದೇವದೂತನಂತೆ,0,0,1,1
19770,overemphasis,0,0,1,1
19771,killen,0,0,1,1
19772,langages,0,0,1,1
19776,enquête,0,0,1,1
19785,سيفوليلي,0,0,1,1
19777,traînes,0,0,1,1
19778,മൂർച്ചയുള്ളതും,0,0,1,1
19780,रहना।,0,0,1,1
19781,bundestag,0,0,1,1
19782,trataron,0,0,1,1
19783,ligeglad,0,0,1,1
19784,വാക്കുകൾക്കപ്പുറത്ത്,0,0,1,1
19818,koymayı,0,0,1,1
19819,गैर-विकी,0,0,1,1
19820,ஆக்க,0,0,1,1
19867,fotos,0,0,1,1
19855,அழைக்கப்படும்,0,0,1,1
19857,utsätts,0,0,1,1
19859,إضافي,0,0,1,1
19860,rouge,0,0,1,1
19861,ستنمو,0,0,1,1
19863,bate.,0,0,1,1
19864,gradientes.,0,0,1,1
19868,jefe,0,0,1,1
19853,استخراج,0,0,1,1
19869,ذكر,0,0,1,1
19871,استطعت,0,0,1,1
19873,neuronaux,0,0,1,1
19874,substituída,0,0,1,1
19876,pares​,0,0,1,1
19878,pesquisando,0,0,1,1
19879,أفعل.,0,0,1,1
19854,diskussionssida,0,0,1,1
19851,haklarında,0,0,1,1
19821,तीसरी,0,0,1,1
19833,l'écriture.,0,0,1,1
19822,relaterade,0,0,1,1
19823,ஆண்டில்,0,0,1,1
19825,дисков.,0,0,1,1
19826,effectuées,0,0,1,1
19827,написаны,0,0,1,1
19828,συνέβαινε,0,0,1,1
19832, بريتانيكا.,0,0,1,1
19836,vermektedir,0,0,1,1
19849,författad,0,0,1,1
19838,കാര്യങ്ങൾക്ക്,0,0,1,1
19841,imputáveis,0,0,1,1
19843,നല്ലവരായിരുന്നു,0,0,1,1
19844,donnant,0,0,1,1
19845,örneğin.,0,0,1,1
19847,perpetrator,0,0,1,1
19848,historik,0,0,1,1
19762,साक्षात्कारों,0,0,1,1
19760,confiança,0,0,1,1
19757,فعلت,0,0,1,1
19686,ജോലിയുണ്ട്,0,0,1,1
19677,മെല്ലിയെക്കുറിച്ച്,0,0,1,1
19678,environnementaux.,0,0,1,1
19679,funciona,0,0,1,1
19680,текстом,0,0,1,1
19681,genaamd.,0,0,1,1
19683,يسير؟,0,0,1,1
19684,disharmoni,0,0,1,1
19687,exceptions,0,0,1,1
19674,borta,0,0,1,1
19688,выдать,0,0,1,1
19690,ഉണ്ടായേക്കാവുന്ന,0,0,1,1
19693,masculine,0,0,1,1
19694,सम्पूर्ण,0,0,1,1
19695,λεπτό,0,0,1,1
19696,φτιαγμένο,0,0,1,1
19697,goud.,0,0,1,1
19675,ತೆಗೆದುಕೊಂಡರೆ,0,0,1,1
19673,sacolejou,0,0,1,1
19702,maldonado​,0,0,1,1
19658,बहन,0,0,1,1
19650,atribuições,0,0,1,1
19651,generating,0,0,1,1
19652,behalve,0,0,1,1
19653,анонсирована,0,0,1,1
19654,fühle,0,0,1,1
19656,ನೋಡುತ್ತಿದ್ದಾಗ,0,0,1,1
19657,snabbare,0,0,1,1
19659,മെച്ചപ്പെടുത്തുന്നുണ്ട്.,0,0,1,1
19672,aplicadas,0,0,1,1
19662,நேரமில்லை,0,0,1,1
19664,engaging,0,0,1,1
19666,aprendan.,0,0,1,1
19667,udviklet.,0,0,1,1
19669,ഓർഗനൈസേഷൻ,0,0,1,1
19670,nuire,0,0,1,1
19671,извинения.,0,0,1,1
19701,nds •,0,0,1,1
19704,religion,0,0,1,1
19756,uygunluğu,0,0,1,1
19746,réalisable,0,0,1,1
19736,uddannede,0,0,1,1
19737,നല്ലവനാണോ,0,0,1,1
19740,istersiniz.,0,0,1,1
19741,protegidos.,0,0,1,1
19743,गैर-विकिपीडिया,0,0,1,1
19744,цене,0,0,1,1
19745,столом,0,0,1,1
19748,произносится,0,0,1,1
19733,luchó,0,0,1,1
19749,formuler,0,0,1,1
19750,неоднократно,0,0,1,1
19751,ಕಾಯಲು,0,0,1,1
19752,udc,0,0,1,1
19753,excuse,0,0,1,1
19754,التنبيهات,0,0,1,1
19755,sluggish.,0,0,1,1
19734,dotées,0,0,1,1
19732,விற்றீர்கள்.,0,0,1,1
19705,नशा,0,0,1,1
19718,المزايا,0,0,1,1
19706,подчинённых,0,0,1,1
19707,नीतियां,0,0,1,1
19708,çalışmasının,0,0,1,1
19710,unternehmen,0,0,1,1
19711,stewards.,0,0,1,1
19713,பெறும்போது,0,0,1,1
19714,ಪಚ್ಚೆಗಳ,0,0,1,1
19720,المصروفات,0,0,1,1
19730,επαγγελματική,0,0,1,1
19721,ur •,0,0,1,1
19722,சுவாரஸ்யமான,0,0,1,1
19723,tt •,0,0,1,1
19726,ocasionalmente,0,0,1,1
19727,distribuida,0,0,1,1
19728,парламентский,0,0,1,1
19729,us[aj],0,0,1,1
19880,aufschreiben,0,0,1,1
19881,посвящён,0,0,1,1
19882,प्रयास।,0,0,1,1
20055,fikir.,0,0,1,1
20047,medication,0,0,1,1
20048,ഇംഗ്ലീഷിലാണ്,0,0,1,1
20050,தேவையற்ற,0,0,1,1
20051,ağlıyorsun,0,0,1,1
20052,τρως.,0,0,1,1
20053,biográficos.,0,0,1,1
20054,புரிந்துகொள்வதில்,0,0,1,1
20058,politiques ,0,0,1,1
20045,εκτεθούν,0,0,1,1
20059,leven.,0,0,1,1
20060,förutsättningar,0,0,1,1
20061,सा,0,0,1,1
20062,участия,0,0,1,1
20063,неявную,0,0,1,1
20064,babosa,0,0,1,1
20066,நாளும்,0,0,1,1
20046,l'erika.,0,0,1,1
20043,leitores.,0,0,1,1
20069,ægteskab,0,0,1,1
20026,berømte,0,0,1,1
20017,προσφορές.,0,0,1,1
20018,സുന്ദരിയും,0,0,1,1
20019,أتساءل,0,0,1,1
20020,ತಮಾಷೆಯಾಗಿದೆ,0,0,1,1
20022,കുഴഞ്ഞുമറിഞ്ഞ,0,0,1,1
20024,esboço,0,0,1,1
20025,മികച്ചതാക്കുക.,0,0,1,1
20027,\}\rightarrow,0,0,1,1
20039,«abrió,0,0,1,1
20028,विकिपीडीयन्स,0,0,1,1
20030,ചെയ്തിരിക്കുന്ന,0,0,1,1
20031,ಇದೀಗ.,0,0,1,1
20034,продвижение,0,0,1,1
20035,வலைதளத்துக்கு,0,0,1,1
20036,måtte,0,0,1,1
20037,идет,0,0,1,1
20067,langage,0,0,1,1
20070,مسافة,0,0,1,1
20015,presidenciais,0,0,1,1
20124,ಚಲಿಸುವ,0,0,1,1
20112,parçasıdır,0,0,1,1
20113,välmenade.,0,0,1,1
20116,live,0,0,1,1
20118,mencionarse,0,0,1,1
20119,أخبرتك,0,0,1,1
20121,مثلا،,0,0,1,1
20123,новой,0,0,1,1
20125,gevraagd.,0,0,1,1
20110,подвергавшихся,0,0,1,1
20126,№ ,0,0,1,1
20127,الثانية.,0,0,1,1
20128,ಯಾವಾಗ,0,0,1,1
20129,profuse.,0,0,1,1
20133,forstå,0,0,1,1
20135,കേൾക്കുമ്പോൾ,0,0,1,1
20136,ومقاومته,0,0,1,1
20111,présentée.,0,0,1,1
20109,basisconcept,0,0,1,1
20071,discurso,0,0,1,1
20089,ഒപ്റ്റിമൈസേഷൻ,0,0,1,1
20072,അഭിനന്ദിക്കുന്നതിനുള്ള,0,0,1,1
20074,biologiques,0,0,1,1
20077,τρελό.,0,0,1,1
20081,उठाया,0,0,1,1
20082,översättningen,0,0,1,1
20086,vec •,0,0,1,1
20087,fullaste,0,0,1,1
20092,возможного,0,0,1,1
20107,отмечены,0,0,1,1
20093,dussintal,0,0,1,1
20094,മലയാളത്തിനു,0,0,1,1
20095,financés,0,0,1,1
20099,प्रविष्टियाँ,0,0,1,1
20101,мнений,0,0,1,1
20102,компьютерным,0,0,1,1
20105,ideological,0,0,1,1
20016,देश,0,0,1,1
20014,importantlyit,0,0,1,1
19883,ಶಾಸ್ತ್ರೀಯ,0,0,1,1
19929,கருத்தை,0,0,1,1
19915,heltäckande,0,0,1,1
19917,ശൈലി,0,0,1,1
19918,freakade,0,0,1,1
19919,realizou,0,0,1,1
19921,substitutions,0,0,1,1
19923,closer,0,0,1,1
19925,ungenießbar,0,0,1,1
19930,bøger,0,0,1,1
19909,pouca,0,0,1,1
19931,الشديد,0,0,1,1
19932,здравоохранении.,0,0,1,1
19933,بكم,0,0,1,1
19936,τερενς,0,0,1,1
19939,lèvres,0,0,1,1
19940,enfiar,0,0,1,1
19942,detect.,0,0,1,1
19910,небольшую,0,0,1,1
19907,региональных,0,0,1,1
19945,afviste,0,0,1,1
19891,structurées,0,0,1,1
19884,öğreneceğiz,0,0,1,1
19885,സമസ്ത,0,0,1,1
19886,चिन्हित,0,0,1,1
19887,holder,0,0,1,1
19888,कार्यक्षमता,0,0,1,1
19889,recente,0,0,1,1
19890,hield,0,0,1,1
19892,ಬಹಳಷ್ಟು,0,0,1,1
19906,അതോ,0,0,1,1
19894,الويكيبيديون,0,0,1,1
19896,സ്ത്രീകൾക്ക്,0,0,1,1
19897,ബാധകമായ,0,0,1,1
19898,قبولًا,0,0,1,1
19900,принимаю,0,0,1,1
19903,trovärdiga,0,0,1,1
19904,لنبدأ.,0,0,1,1
19944,d'étonnant,0,0,1,1
19948,spitzen,0,0,1,1
20011,गुजर,0,0,1,1
19994,majeur ,0,0,1,1
19984,الماضية,0,0,1,1
19985,grupper,0,0,1,1
19986,visualiseringsverktyg,0,0,1,1
19987,plaisir,0,0,1,1
19989,университет,0,0,1,1
19992,празднует,0,0,1,1
19993,şirket,0,0,1,1
19995,inferred,0,0,1,1
19982,संसदीय,0,0,1,1
20000,ραντεβού.,0,0,1,1
20001,compraría,0,0,1,1
20003,php-викидвижке,0,0,1,1
20004,ægteskab.,0,0,1,1
20007,korsar,0,0,1,1
20009,والعربية,0,0,1,1
20010,adopte,0,0,1,1
19983,ശ്രമം,0,0,1,1
19981,أطلقت,0,0,1,1
19951,усердной,0,0,1,1
19968,தேடுகிறீர்கள்,0,0,1,1
19954,salutations,0,0,1,1
19955,oftare,0,0,1,1
19957,пользователь,0,0,1,1
19959,ಉದಾಹರಣೆಗಳು,0,0,1,1
19961,missnöje,0,0,1,1
19963,sweetheart,0,0,1,1
19965,pointant,0,0,1,1
19970,κρυφά,0,0,1,1
19980,constantly,0,0,1,1
19971,atributos,0,0,1,1
19973,принцип,0,0,1,1
19974,شخصا.,0,0,1,1
19975,ರೀತಿಗೆ,0,0,1,1
19977,undersökningsgruppen,0,0,1,1
19978,ventes,0,0,1,1
19979,şarkı,0,0,1,1
19649,toppositie,0,0,1,1
19646,опираться,0,0,1,1
19158,продолжайте.,0,0,1,1
19645,സൈന്യം,0,0,1,1
19319,оперативно,0,0,1,1
19320,ಕುಳಿತಳು.,0,0,1,1
19321,मोडल,0,0,1,1
19324,anmodninger.,0,0,1,1
19325,göz,0,0,1,1
19326,πρόταση,0,0,1,1
19327,افعل,0,0,1,1
19328,وسيول.,0,0,1,1
19331,maître,0,0,1,1
19332,developed.,0,0,1,1
19335,вышел,0,0,1,1
19336,திருமண,0,0,1,1
19337,волнует,0,0,1,1
19338,arkiverade,0,0,1,1
19339,பிரதிபலிப்பில்,0,0,1,1
19341,وبدون,0,0,1,1
19345,erholt.,0,0,1,1
19318,ಎಂದರ್ಥ.,0,0,1,1
19317,ഇടാൻ,0,0,1,1
19311,franche-comté,0,0,1,1
19300,offrir,0,0,1,1
19288,вежливым,0,0,1,1
19289,blandad,0,0,1,1
19290,باستنتاج,0,0,1,1
19293,தொலைபேசியில்,0,0,1,1
19294,yaparsınız,0,0,1,1
19296,इनक्यूबेटर,0,0,1,1
19297,atualização.,0,0,1,1
19301,« valeur »,0,0,1,1
19310,vardag.,0,0,1,1
19302,бесплатного,0,0,1,1
19303,pensez,0,0,1,1
19304,unutulmamalıdır,0,0,1,1
19306,externas,0,0,1,1
19307,ampliaría,0,0,1,1
19308,ressources,0,0,1,1
19309,croissant,0,0,1,1
19347,സ്വാഭാവികമായും,0,0,1,1
19348,pertenecen,0,0,1,1
19349,erfolgreich,0,0,1,1
19391,permission.,0,0,1,1
19381,expanding,0,0,1,1
19382,irlandais,0,0,1,1
19383,değildir.,0,0,1,1
19384,ficava,0,0,1,1
19386,anónimos,0,0,1,1
19387,consertar,0,0,1,1
19390,óbvio,0,0,1,1
19392,ميلًا,0,0,1,1
19379,i»,0,0,1,1
19393,riktat,0,0,1,1
19394,இல்,0,0,1,1
19396,रहने,0,0,1,1
19397,hjärtskadad,0,0,1,1
19399,fracción,0,0,1,1
19400,colaboran,0,0,1,1
19402,ഒരാളുടെ,0,0,1,1
19380,não.,0,0,1,1
19378,منع,0,0,1,1
19350,अन्य-भाषाओं,0,0,1,1
19362,privado,0,0,1,1
19351,sophisticated.,0,0,1,1
19352,l'indonésie.,0,0,1,1
19354,främställs,0,0,1,1
19355,verden.,0,0,1,1
19359,namorada,0,0,1,1
19360,определенно,0,0,1,1
19361,causou,0,0,1,1
19363,واراي.,0,0,1,1
19375,usuário.,0,0,1,1
19365,hakkı,0,0,1,1
19366,common.,0,0,1,1
19367,företeelsen.,0,0,1,1
19369,διεύθυνση,0,0,1,1
19371,τονίσετε,0,0,1,1
19372,benutzt,0,0,1,1
19374,अशिष्टता,0,0,1,1
19287,enregistrés,0,0,1,1
19286,ஃபேஸ்புக்,0,0,1,1
19283,tricky,0,0,1,1
19206,zorgelijke,0,0,1,1
19193,удаление,0,0,1,1
19195,похожи,0,0,1,1
19196,toestemming.,0,0,1,1
19197,perçoit,0,0,1,1
19200,[citation,0,0,1,1
19204,تقطع,0,0,1,1
19205,യന്ത്രപഠനത്തെ,0,0,1,1
19207,استندت,0,0,1,1
19189,yanılıyorsun,0,0,1,1
19210,അർത്ഥമാക്കുന്നു,0,0,1,1
19213,tilfældig,0,0,1,1
19215,farväl,0,0,1,1
19216,jet,0,0,1,1
19218,devant,0,0,1,1
19219,ornamentation,0,0,1,1
19221,ക്രോസ്സ്,0,0,1,1
19191,reverting/reverted,0,0,1,1
19187,disais,0,0,1,1
19223,intentional,0,0,1,1
19172,expose,0,0,1,1
19159,biliyor,0,0,1,1
19160,intentado,0,0,1,1
19161,terms.,0,0,1,1
19163,plays,0,0,1,1
19164,पर्यटन,0,0,1,1
19168,إشارة,0,0,1,1
19170,विभाजन,0,0,1,1
19173,ατρόμητο,0,0,1,1
19186,spil.,0,0,1,1
19174,borç,0,0,1,1
19175,plötsligt,0,0,1,1
19179,ek,0,0,1,1
19180,تقييم,0,0,1,1
19182,desfazer,0,0,1,1
19184,búsqueda.,0,0,1,1
19185,revidera,0,0,1,1
19222,προωθήθηκα,0,0,1,1
19224,geometría,0,0,1,1
19282,söylediğinde,0,0,1,1
19270,eles.,0,0,1,1
19255,lugna,0,0,1,1
19258,بالضبط.,0,0,1,1
19259,lusófona.,0,0,1,1
19261,ಆಟವನ್ನು,0,0,1,1
19266,செப்டம்பர்,0,0,1,1
19267,αγώνας,0,0,1,1
19269,широкому,0,0,1,1
19271,l'obscurantisme.,0,0,1,1
19253,अंक,0,0,1,1
19272,shell,0,0,1,1
19275,d'informatique,0,0,1,1
19276,salud​,0,0,1,1
19277,поживаешь.,0,0,1,1
19278,وجدوا,0,0,1,1
19279,ಶಬ್ದವನ್ನು,0,0,1,1
19281,tillåta,0,0,1,1
19254,cultivée,0,0,1,1
19252,estabelecidos,0,0,1,1
19226,one-half,0,0,1,1
19236,handlung,0,0,1,1
19227,വിഷയങ്ങളിലുള്ള,0,0,1,1
19228,പോവുന്നത്,0,0,1,1
19230,brillantes.,0,0,1,1
19231,сформулировало,0,0,1,1
19232,лицензию.,0,0,1,1
19233,bıraktıysanız,0,0,1,1
19235,അവസ്ഥയിലായിരിക്കുക,0,0,1,1
19238,ustedes,0,0,1,1
19250,डार्टमाउथ,0,0,1,1
19239,παντρευτεί,0,0,1,1
19240,فتى,0,0,1,1
19241,പരീക്ഷണം,0,0,1,1
19243,patrón,0,0,1,1
19245,நிலைமை,0,0,1,1
19248,പഠനത്തിന്,0,0,1,1
19249,മത്സരം,0,0,1,1
19403,المضي,0,0,1,1
19404,ചെറുതുള്ളികൾ,0,0,1,1
19405,hansson,0,0,1,1
19565,souris,0,0,1,1
19557,அறிக்கையையும்,0,0,1,1
19559,paysagères,0,0,1,1
19560,liedjes,0,0,1,1
19561,afgewezen,0,0,1,1
19562,systémique,0,0,1,1
19563,directivos.,0,0,1,1
19564,कानूनों,0,0,1,1
19566,acıktım,0,0,1,1
19553,değişti.,0,0,1,1
19568,பாரம்பரியக்,0,0,1,1
19569,gesprek.,0,0,1,1
19572,fundamentais.,0,0,1,1
19574,welcome.,0,0,1,1
19577,വാൻഡലിസംവരുന്നത്,0,0,1,1
19578,كافحت,0,0,1,1
19580,schlägt,0,0,1,1
19556,تسمية,0,0,1,1
19548,ضغطت,0,0,1,1
19586,воспроизведение,0,0,1,1
19536,væk,0,0,1,1
19526,yapıldığı,0,0,1,1
19527,risken,0,0,1,1
19528,génèrent,0,0,1,1
19530,comida.,0,0,1,1
19531,l'éducation,0,0,1,1
19533,uppslukad,0,0,1,1
19534,signos,0,0,1,1
19537,founding,0,0,1,1
19547,идти.,0,0,1,1
19538,மீளப்பெறவோ,0,0,1,1
19540,സ്വപ്ന,0,0,1,1
19541,affecting,0,0,1,1
19542,wegener,0,0,1,1
19543,представления,0,0,1,1
19545,hasn't,0,0,1,1
19546,controverse,0,0,1,1
19581,programs.,0,0,1,1
19587,مقالات،,0,0,1,1
19523,استضافة,0,0,1,1
19631,όντα,0,0,1,1
19622,στατιστικές,0,0,1,1
19623,لجميع,0,0,1,1
19625,everyday,0,0,1,1
19627,guerras,0,0,1,1
19628,الحكم,0,0,1,1
19629,ನುಡಿಗಟ್ಟುಗಳ,0,0,1,1
19630,förändras.,0,0,1,1
19633,kutsche,0,0,1,1
19620,തിരുത്തുകൾ,0,0,1,1
19635,استئناف,0,0,1,1
19639,téléphonique,0,0,1,1
19640,я',0,0,1,1
19641,بي،,0,0,1,1
19642,magique,0,0,1,1
19643,интересно,0,0,1,1
19644,peer-review,0,0,1,1
19621,πηγαίνει,0,0,1,1
19619,pauvres,0,0,1,1
19589,schmecken,0,0,1,1
19605,inappropriée.,0,0,1,1
19590,பேச்சாளர்கள்,0,0,1,1
19591,rato».,0,0,1,1
19594,serverklustren,0,0,1,1
19595,ಯಾರೋ,0,0,1,1
19596,घुस,0,0,1,1
19597,schnellen,0,0,1,1
19598,причинам.,0,0,1,1
19606,fpr,0,0,1,1
19617,многоуровневую,0,0,1,1
19607,использовали,0,0,1,1
19608,dadian,0,0,1,1
19610,числе,0,0,1,1
19611,nankín,0,0,1,1
19612,betegner,0,0,1,1
19615,législatives ».,0,0,1,1
19616,परिष्कृत।,0,0,1,1
19525,फ्लुमॉक्स,0,0,1,1
19522,rostros.,0,0,1,1
19407,barajando,0,0,1,1
19453,utilidad.,0,0,1,1
19440,سياسة,0,0,1,1
19441,cultivé,0,0,1,1
19442,kültürlü,0,0,1,1
19444,preguntaba,0,0,1,1
19445,reject,0,0,1,1
19446,متعدد,0,0,1,1
19451,høfligt.,0,0,1,1
19455,ஸ்லக்,0,0,1,1
19438,bios,0,0,1,1
19456,ഉപയോഗിച്ചിരുന്നു.,0,0,1,1
19457,universitaire.,0,0,1,1
19458,принципах,0,0,1,1
19459,ഘട്ടമാണിത്.,0,0,1,1
19460,rappeler,0,0,1,1
19461,stylistic,0,0,1,1
19462,gratitude,0,0,1,1
19439,i̇ngilizcede,0,0,1,1
19437,negativa,0,0,1,1
19466,iyiyim,0,0,1,1
19419,opened,0,0,1,1
19408,учителем,0,0,1,1
19410,എഴുതിവെക്കുന്നതും,0,0,1,1
19411,degrés.,0,0,1,1
19413,bry,0,0,1,1
19414,dirigée,0,0,1,1
19416,hi •,0,0,1,1
19417,id •,0,0,1,1
19420,വജ്രങ്ങളിലും,0,0,1,1
19436,propiciado,0,0,1,1
19423,μαζικής,0,0,1,1
19424,yaşadığı,0,0,1,1
19426,opérateurs,0,0,1,1
19429,linguistics,0,0,1,1
19430,nätcommunities,0,0,1,1
19431,inletts,0,0,1,1
19432,തെറ്റെഴുതിയാൽ,0,0,1,1
19463,обычный.,0,0,1,1
19467,βανδαλισμός,0,0,1,1
19519,udøver,0,0,1,1
19504,greatly,0,0,1,1
19495,göklerin,0,0,1,1
19496,مفيدة,0,0,1,1
19498,transmit,0,0,1,1
19499,intensives,0,0,1,1
19500,συνειδητοποιήσετε,0,0,1,1
19501,källkritik,0,0,1,1
19503,lika,0,0,1,1
19506,ύπνο,0,0,1,1
19491,متباينة،,0,0,1,1
19512,laid,0,0,1,1
19513,என்பதைப்,0,0,1,1
19514,ಬಯಸಿದ್ದರು,0,0,1,1
19515,ಜೀವಿಗಳು,0,0,1,1
19516,vänsterpolitisk,0,0,1,1
19517,militent,0,0,1,1
19518,شائعة,0,0,1,1
19493,croyait-il,0,0,1,1
19490,yapmasına,0,0,1,1
19468,tommelfingre,0,0,1,1
19478,tamamlanmayacağı,0,0,1,1
19469,المعرفية،,0,0,1,1
19470,collision,0,0,1,1
19471,klassiska,0,0,1,1
19473,слез.,0,0,1,1
19474,உடைந்துவிட்டது,0,0,1,1
19475,acrescentando,0,0,1,1
19476,perplexed,0,0,1,1
19479,mandarei,0,0,1,1
19489,tilbud.,0,0,1,1
19480,rechazada.,0,0,1,1
19481,contest,0,0,1,1
19482,προσπαθήστε,0,0,1,1
19485,te •,0,0,1,1
19486,violates,0,0,1,1
19487,естественно-научной,0,0,1,1
19488,üzülme,0,0,1,1
18193,अकार्डिंग,0,0,1,1
18187,പരിശോധനാ,0,0,1,1
20140,bakgrund,0,0,1,1
16742,பயன்படுத்தித்,0,0,1,1
16890,soluciones,0,0,1,1
16893,-ഫെബ്രുവരിയിൽ‍,0,0,1,1
16896,tightening,0,0,1,1
16897,கருத்துக்,0,0,1,1
16898,z.,0,0,1,1
16903,«anónima»,0,0,1,1
16904,μυαλό.,0,0,1,1
16905,законах,0,0,1,1
16907,informationskällor,0,0,1,1
16911,المائة,0,0,1,1
16913,απολυτο,0,0,1,1
16914,целиком,0,0,1,1
16916,лучше.,0,0,1,1
16920,புகழ்பெற்றதுமாகும்.,0,0,1,1
16921,pudiste,0,0,1,1
16923,producen,0,0,1,1
16925,desafortunadamente,0,0,1,1
16889,socio,0,0,1,1
16887,يسمى.,0,0,1,1
16885,tellurique,0,0,1,1
16872,аспирантом,0,0,1,1
16865,милые,0,0,1,1
16866,الغالب,0,0,1,1
16867,disponível,0,0,1,1
16868,पूछता,0,0,1,1
16869,encantado,0,0,1,1
16870,കഴിക്കൂ.,0,0,1,1
16871,merveilleux,0,0,1,1
16873,umursayamazdım,0,0,1,1
16884,произносите,0,0,1,1
16874,تحتل,0,0,1,1
16877,fordi.,0,0,1,1
16878,πάρει,0,0,1,1
16879,salataları,0,0,1,1
16880,guided,0,0,1,1
16881,solicitada,0,0,1,1
16882,историю,0,0,1,1
16926,أقدر,0,0,1,1
16927,ಸ್ಥಗಿತಗೊಳಿಸಿ.,0,0,1,1
16929,hovedet.,0,0,1,1
16970,globala,0,0,1,1
16961,δώρο,0,0,1,1
16962,concordamos.,0,0,1,1
16963,தண்ணீர்,0,0,1,1
16964,telugu,0,0,1,1
16966,pájaro,0,0,1,1
16967,attesté,0,0,1,1
16969,julien,0,0,1,1
16971,klottraren,0,0,1,1
16959,ഇല്ലെങ്കിൽ,0,0,1,1
16972,या।,0,0,1,1
16973,nämn,0,0,1,1
16974,estructura,0,0,1,1
16975,പ്രശ്‌നമില്ല.,0,0,1,1
16976,valorize,0,0,1,1
16977,culturels,0,0,1,1
16978,معًا,0,0,1,1
16960,بطيئة.,0,0,1,1
16958,положительной,0,0,1,1
16930,എന്തെങ്കിലുമൊക്കെ,0,0,1,1
16939,செயலை,0,0,1,1
16931,للإعجاب,0,0,1,1
16933,публикацию,0,0,1,1
16934,rentrant,0,0,1,1
16935,سلبية,0,0,1,1
16936,ಅರ್ಥಮಾಡಿಕೊಳ್ಳಲು,0,0,1,1
16937,തിരുത്തുന്നതിനും,0,0,1,1
16938,nahezu,0,0,1,1
16941,κάθεστε,0,0,1,1
16957,diderot,0,0,1,1
16943,sınava,0,0,1,1
16944,ips,0,0,1,1
16945,tituló,0,0,1,1
16948,ifadeyi,0,0,1,1
16950,'less,0,0,1,1
16953,வழங்குகின்றன.,0,0,1,1
16955,tenu,0,0,1,1
16864,adicionam,0,0,1,1
16863,കാഴ്ച്ചപ്പാട്,0,0,1,1
16862,സ്പീക്കറിൽ,0,0,1,1
16779,datas,0,0,1,1
16770,διέσχισαν.,0,0,1,1
16771,स्वाभाविक,0,0,1,1
16772,«votaciones».,0,0,1,1
16773,dönük,0,0,1,1
16775,busy.,0,0,1,1
16776,bekende,0,0,1,1
16778,تحسينات,0,0,1,1
16780,surveillants,0,0,1,1
16767,förstör,0,0,1,1
16781,alejandro,0,0,1,1
16782,magasiner,0,0,1,1
16783,പ്രവൃത്തിയാണെന്ന്,0,0,1,1
16784,редактором,0,0,1,1
16786,distribuer,0,0,1,1
16788,memnun,0,0,1,1
16789,debate.,0,0,1,1
16769,verborreica,0,0,1,1
16763,chanserna.,0,0,1,1
16791,മന്ദഗതിയിലായിരുന്നു,0,0,1,1
16753,άχρηστο,0,0,1,1
16744,wendt,0,0,1,1
16746,urbaine,0,0,1,1
16747,சொல்கிறார்கள்,0,0,1,1
16748,«читать,0,0,1,1
16749,silberbrot,0,0,1,1
16750,ಅಭಿಪ್ರಾಯಗಳು,0,0,1,1
16752,transformations,0,0,1,1
16754,ಬಯಸುತ್ತಾಳೆ,0,0,1,1
16762,расскажет,0,0,1,1
16755,ചെയ്യുന്നതെന്ന്,0,0,1,1
16756,salater,0,0,1,1
16757,السيدات,0,0,1,1
16758,رؤية.,0,0,1,1
16759,atingiu,0,0,1,1
16760,mejora.,0,0,1,1
16761,ಕೇಳಿ.,0,0,1,1
16790,wikiprocedurerne,0,0,1,1
16793,idéologies.,0,0,1,1
16861,multidões,0,0,1,1
16842,africâner,0,0,1,1
16834,hjælpe.,0,0,1,1
16835,وقانون,0,0,1,1
16836,bahçelerinde,0,0,1,1
16837,gevonden,0,0,1,1
16838,hastily,0,0,1,1
16839,succèdent,0,0,1,1
16841,другого,0,0,1,1
16844,ηχείου,0,0,1,1
16831,വിലമതിക്കാനാവാത്തത്,0,0,1,1
16846,recevant,0,0,1,1
16850,приступим,0,0,1,1
16852,abordé,0,0,1,1
16853,പരിശീലിപ്പിക്കുകയും,0,0,1,1
16854,சமயங்களில்,0,0,1,1
16857,отправлении,0,0,1,1
16859,ondernemer,0,0,1,1
16833,πλημμύρα,0,0,1,1
16828,செல்போனைப்,0,0,1,1
16794,πόλεμο.,0,0,1,1
16811,ಸೈರ್,0,0,1,1
16795,pm,0,0,1,1
16796,opdagelse.,0,0,1,1
16797,самим,0,0,1,1
16799,порядке.,0,0,1,1
16803,gevoel,0,0,1,1
16805,samfundsvidenskab,0,0,1,1
16810,enciende,0,0,1,1
16813,ತಬ್ಬಿಕೊಳ್ಳಲು,0,0,1,1
16826,ಇಲ್ಲಿಯೇ,0,0,1,1
16814,lykke.,0,0,1,1
16815,jobbet.,0,0,1,1
16817,ಚಿನ್ನವನ್ನು,0,0,1,1
16819,fängelser,0,0,1,1
16821,castillo,0,0,1,1
16823,stannar,0,0,1,1
16825,obtain,0,0,1,1
16981,recuerde.,0,0,1,1
16983,بمقابلتك.,0,0,1,1
16984,ಟ್,0,0,1,1
17160,resource,0,0,1,1
17152,mk •,0,0,1,1
17153,officiële,0,0,1,1
17154,ex-editor,0,0,1,1
17155,prohibieron,0,0,1,1
17157,treated.,0,0,1,1
17158, €,0,0,1,1
17159,والاختلاف.,0,0,1,1
17161,voluntarios.,0,0,1,1
17149,एजेंसियों,0,0,1,1
17162,inmediato,0,0,1,1
17163,prioridad,0,0,1,1
17164,بوضوح,0,0,1,1
17165,முயற்சிக்கவும்.,0,0,1,1
17166,тематическому,0,0,1,1
17168,trabalhando,0,0,1,1
17170,физической,0,0,1,1
17150,ஏற்றுக்கொள்கிறேன்.,0,0,1,1
17148,raros,0,0,1,1
17173,δώσουμε,0,0,1,1
17133,сетевая,0,0,1,1
17124,निर्माणात्मक,0,0,1,1
17126,goleiro,0,0,1,1
17127,удивительной,0,0,1,1
17128,exército,0,0,1,1
17130,chamar,0,0,1,1
17131,n'ayant,0,0,1,1
17132,prazo,0,0,1,1
17137,achevé,0,0,1,1
17147,தன்,0,0,1,1
17138,sustantivo,0,0,1,1
17139,opmuntring,0,0,1,1
17141,بكتابة,0,0,1,1
17142,ಅಸಭ್ಯವಾಗಿ,0,0,1,1
17143,ജോലി.,0,0,1,1
17144,немецких,0,0,1,1
17146,living.,0,0,1,1
17172,veranderde,0,0,1,1
17174,الاختبار,0,0,1,1
17118,للإجماع,0,0,1,1
17219,साल,0,0,1,1
17208,γυρίζει,0,0,1,1
17210,ಹೆಚ್ಚಿಸಿ.,0,0,1,1
17211,geométricos,0,0,1,1
17212,salladerna,0,0,1,1
17215,தொகுக்கப்படும்,0,0,1,1
17216,tidens,0,0,1,1
17217,поисковыми,0,0,1,1
17220,cultlike,0,0,1,1
17204,encyclopédie.,0,0,1,1
17222,manager,0,0,1,1
17223,ചേരാത്തതുമായ,0,0,1,1
17224,marques,0,0,1,1
17225,വിക്കിഎഴുതുന്നതെല്ലാം,0,0,1,1
17226,സംസാരിക്കുന്നു,0,0,1,1
17228,foto's,0,0,1,1
17229,бесчисленное,0,0,1,1
17207,تعلم.,0,0,1,1
17203,फुल्का,0,0,1,1
17175,அனுப்பி,0,0,1,1
17191,نارسيسا,0,0,1,1
17176,previa,0,0,1,1
17177,تحاول,0,0,1,1
17179,изложение,0,0,1,1
17182,anti-dühring ,0,0,1,1
17184,högskolebibliotekarien,0,0,1,1
17185,ಸುಂದರರು,0,0,1,1
17188,syltetøj,0,0,1,1
17192,ಚಂದಾದಾರರಾಗಲು,0,0,1,1
17202,arıyoruz,0,0,1,1
17193,narzissen,0,0,1,1
17194,തെളിവുകൾ,0,0,1,1
17195,hrw,0,0,1,1
17196,ഒന്നു,0,0,1,1
17197,siger.,0,0,1,1
17199,requérant,0,0,1,1
17200,clay,0,0,1,1
17121,merdé,0,0,1,1
17117,yüce,0,0,1,1
16985,കൂട്ടിച്ചേർത്തോളും,0,0,1,1
17042,ആശയക്കുഴപ്പമുണ്ടായാൽ,0,0,1,1
17030,работах.,0,0,1,1
17035,gestart.,0,0,1,1
17036,форматах,0,0,1,1
17037,невероятно,0,0,1,1
17039,cargo,0,0,1,1
17040,nachricht,0,0,1,1
17041,convergent,0,0,1,1
17043,inkl.,0,0,1,1
17026,kennedy.,0,0,1,1
17044,gevolg,0,0,1,1
17046,மெர்ரி,0,0,1,1
17047,ساعات.,0,0,1,1
17048,enseignements,0,0,1,1
17049,ذهبوا,0,0,1,1
17051,знай,0,0,1,1
17053,திரும்பப்,0,0,1,1
17029,astronomers,0,0,1,1
17024,ബംഗാളി,0,0,1,1
17059,плохо,0,0,1,1
17000,سيول.,0,0,1,1
16986,കാര്യമോ,0,0,1,1
16987,μη,0,0,1,1
16990,دخل,0,0,1,1
16994,activity.,0,0,1,1
16995,«введите,0,0,1,1
16996,evaluates,0,0,1,1
16999,memex.,0,0,1,1
17002,fonctionner,0,0,1,1
17016,bien-fondé,0,0,1,1
17003,namnrymder,0,0,1,1
17005,nyskapade,0,0,1,1
17006,мировым,0,0,1,1
17008,célèbre,0,0,1,1
17011,передаётся,0,0,1,1
17013,ചിയേഴ്സ്,0,0,1,1
17014,நேர்மறை,0,0,1,1
17054,अभिनेता,0,0,1,1
17064,virtually,0,0,1,1
17116,تغيير,0,0,1,1
17101,dioxide,0,0,1,1
17091,வந்தன.,0,0,1,1
17094,choisis,0,0,1,1
17095,incorrectes,0,0,1,1
17096,بعدد,0,0,1,1
17097,redevenue,0,0,1,1
17099,hsts,0,0,1,1
17100,характерной,0,0,1,1
17102,cabeça.,0,0,1,1
17089,août,0,0,1,1
17104,ಒಪ್ಪುತ್ತೇನೆ.,0,0,1,1
17107,सच्चाई,0,0,1,1
17108,expresado,0,0,1,1
17109,felen.,0,0,1,1
17111,ഉപയോഗത്തിനും,0,0,1,1
17112,susceptibility,0,0,1,1
17113,всему,0,0,1,1
17090,ಹೋಗಬೇಕಾಗಿದೆ.,0,0,1,1
17088,law ·ഭൗതികശാസ്ത്രം ·pollution,0,0,1,1
17065,ആഴ്ച,0,0,1,1
17076,vinkede,0,0,1,1
17066,விட்டுவிட்டால்,0,0,1,1
17067,+k,0,0,1,1
17068,söylüyorsunuz.,0,0,1,1
17070,bewegt,0,0,1,1
17071,encombrants,0,0,1,1
17072,explanation.,0,0,1,1
17075,rothenburg,0,0,1,1
17077,സാവധാനത്തിൽ,0,0,1,1
17087,ನೋಡಿ,0,0,1,1
17078,வைத்தீர்கள்,0,0,1,1
17080,حان,0,0,1,1
17081,stadt.,0,0,1,1
17082,chacune.,0,0,1,1
17084,ದೂರ,0,0,1,1
17085,ansågs,0,0,1,1
17086,والذي,0,0,1,1
16743,everybodywiki,0,0,1,1
16741,dados.,0,0,1,1
17231,hazards,0,0,1,1
16738,ordet.,0,0,1,1
16423,guide.,0,0,1,1
16424,çalış.,0,0,1,1
16425,fund,0,0,1,1
16426,حلم,0,0,1,1
16431,kompakt,0,0,1,1
16432,المجانية,0,0,1,1
16433,retirada,0,0,1,1
16434,εγώ',0,0,1,1
16435,வீடியோவைப்,0,0,1,1
16436,voorzichtig,0,0,1,1
16437,bevarade,0,0,1,1
16438,കണക്കാക്കപ്പെടുന്നു.വിക്കിസോഫ്‌റ്റ്‌വെയർ,0,0,1,1
16439,fördel,0,0,1,1
16440,mehlmädchen,0,0,1,1
16441,upptäckts,0,0,1,1
16443,ಒಳ್ಳೆಯವನು,0,0,1,1
16444,émoussé,0,0,1,1
16421,പ്രശ്‌നമായിരുന്നു.,0,0,1,1
16420,yorumlar,0,0,1,1
16419,meninger.,0,0,1,1
16408,കൂടിക്കാഴ്ചയ്ക്ക്,0,0,1,1
16398,bretonne,0,0,1,1
16399,பார்த்ததில்லை,0,0,1,1
16401,மாற்றங்களைப்,0,0,1,1
16402,gösterenlerin,0,0,1,1
16404,cobrindo,0,0,1,1
16405,ಟೆಲಿಗ್ರಾಮ್,0,0,1,1
16406,offline.,0,0,1,1
16409,nuttig,0,0,1,1
16418,ligações,0,0,1,1
16410,источниках.,0,0,1,1
16411,интернет-справочником,0,0,1,1
16413,kontakt.,0,0,1,1
16414,opportunity,0,0,1,1
16415,lækre,0,0,1,1
16416,uzbekistan,0,0,1,1
16417,pancarte,0,0,1,1
16445,ചെയ്തിട്ടില്ല.,0,0,1,1
16446,capture,0,0,1,1
16447,المسؤولين,0,0,1,1
16489,εσυ,0,0,1,1
16480,بالتشعب,0,0,1,1
16482,checo,0,0,1,1
16483,αναστατωθείς,0,0,1,1
16485,വിരലുകളിൽ,0,0,1,1
16486,rythme,0,0,1,1
16487,памятник,0,0,1,1
16488,d'habitude,0,0,1,1
16492,इंटरविकी,0,0,1,1
16477,англоязычного,0,0,1,1
16495,النموذج,0,0,1,1
16496,saborosas.,0,0,1,1
16499,സാധിച്ചു.,0,0,1,1
16501,വിഷമമുണ്ടെന്ന്,0,0,1,1
16502,titeln,0,0,1,1
16504,çalışmıyorsa,0,0,1,1
16505,mediafiler,0,0,1,1
16478,പോലും,0,0,1,1
16476,сообществом,0,0,1,1
16451,felter,0,0,1,1
16460,redaktionell,0,0,1,1
16452,logiquement,0,0,1,1
16453,извлечением,0,0,1,1
16454,обозначен,0,0,1,1
16455,специального,0,0,1,1
16457,wikipediaartikel.,0,0,1,1
16458,разговора,0,0,1,1
16459,gustaban,0,0,1,1
16461,സമയങ്ങളിൽ,0,0,1,1
16475,abusive,0,0,1,1
16463,παιδί.,0,0,1,1
16464,seriøst,0,0,1,1
16466,യന്ത്രപഠനത്തിൽ,0,0,1,1
16467,aprendiendo,0,0,1,1
16469,ಮುಳುಗಬಹುದು,0,0,1,1
16471,iteration,0,0,1,1
16472,ആൾ,0,0,1,1
16396,нужным,0,0,1,1
16394,melpiger,0,0,1,1
16393,स्तब्ध,0,0,1,1
16308,iniciar,0,0,1,1
16297,региональные,0,0,1,1
16300,d'information,0,0,1,1
16301,réussir,0,0,1,1
16302,времени.,0,0,1,1
16304,تجاهل,0,0,1,1
16306,påminna,0,0,1,1
16307,dozens,0,0,1,1
16309,infiniment,0,0,1,1
16295,marié,0,0,1,1
16310,« aujourd'hui,0,0,1,1
16311,meningen.,0,0,1,1
16312,новости,0,0,1,1
16314,mariage,0,0,1,1
16319,तुलनात्मक,0,0,1,1
16320,enviar,0,0,1,1
16322,sexuada,0,0,1,1
16296,elite,0,0,1,1
16294,மாதங்கள்,0,0,1,1
16326,atravesó,0,0,1,1
16279,dagen,0,0,1,1
16270,ഇരുവർക്കും,0,0,1,1
16271,يعد,0,0,1,1
16272,rit,0,0,1,1
16275,certifique-se,0,0,1,1
16276,caracteres,0,0,1,1
16277,contrôle.,0,0,1,1
16278,geçiyor,0,0,1,1
16281,johansson [sv],0,0,1,1
16291,मिले,0,0,1,1
16283,sub-national,0,0,1,1
16285,km.,0,0,1,1
16286,умным,0,0,1,1
16287,ലേഖനമെഴുതാനുദ്ദേശിക്കുന്ന,0,0,1,1
16288,conserving,0,0,1,1
16289,മലയാളത്തിലാണ്.,0,0,1,1
16290,gathered,0,0,1,1
16325,சாங்கரால்,0,0,1,1
16327,autoclavagem,0,0,1,1
16392,comparaisons,0,0,1,1
16373,yapıyorsun,0,0,1,1
16363,vues,0,0,1,1
16364,lider,0,0,1,1
16366,introduite,0,0,1,1
16368,vide.,0,0,1,1
16369,تقل,0,0,1,1
16371,crystallize,0,0,1,1
16372,करेगी,0,0,1,1
16375,ഇതിനായി,0,0,1,1
16361,زعم,0,0,1,1
16377,køre,0,0,1,1
16380,याचना,0,0,1,1
16381,ευχαριστήσω,0,0,1,1
16382,python,0,0,1,1
16386,ಬೇರೇನಾದರೂ,0,0,1,1
16387,சந்திப்பைப்,0,0,1,1
16389,¿debería,0,0,1,1
16362,ಪಿಜ್ಜಾ,0,0,1,1
16359,спала,0,0,1,1
16329,underartiklar,0,0,1,1
16344,piloté,0,0,1,1
16331,palavras.,0,0,1,1
16333,решались,0,0,1,1
16337,иллинойс,0,0,1,1
16338,tidningen,0,0,1,1
16339,agradables.,0,0,1,1
16340,istemeyeceğini,0,0,1,1
16342,examensrapporter,0,0,1,1
16345,лицо.,0,0,1,1
16357,तस्वीरें,0,0,1,1
16347,dukker,0,0,1,1
16348,diles,0,0,1,1
16349,الثروات,0,0,1,1
16350,responding,0,0,1,1
16352,बधाई,0,0,1,1
16353,எல்லாக்,0,0,1,1
16354,vackra,0,0,1,1
16506,seriös,0,0,1,1
16509,forstår,0,0,1,1
16510,ut.,0,0,1,1
16667,بالمقارنة،,0,0,1,1
16657,wikipedia-specific,0,0,1,1
16658,placeret,0,0,1,1
16659,warnings.,0,0,1,1
16660,विकिमिडिया,0,0,1,1
16661,gällande,0,0,1,1
16662,ಹಾಸ್ಯವನ್ನು,0,0,1,1
16664,trails,0,0,1,1
16668,rádio,0,0,1,1
16654,scolastique ,0,0,1,1
16669,жаловался,0,0,1,1
16670,araştırmayı,0,0,1,1
16673,quinlan,0,0,1,1
16677,രാജ്യത്തേക്ക്,0,0,1,1
16680,ജർമൻ,0,0,1,1
16681,भूलें।,0,0,1,1
16682,подобного,0,0,1,1
16656,представлять,0,0,1,1
16652,kısmının,0,0,1,1
16684,masanın,0,0,1,1
16637,serieuze,0,0,1,1
16626,ведущих,0,0,1,1
16627,virtuellement,0,0,1,1
16629,connotation,0,0,1,1
16630,profunda,0,0,1,1
16632,попрощавшись,0,0,1,1
16633,réciproquement.,0,0,1,1
16635,pounds,0,0,1,1
16638,alexnet,0,0,1,1
16651,ஸ்டால்மன்,0,0,1,1
16639,المهمة,0,0,1,1
16640,കുട്ടികൾ,0,0,1,1
16642,forbi,0,0,1,1
16646,ಪ್ರಾರಂಭಿಸಲು,0,0,1,1
16647,conhecidos,0,0,1,1
16648,പഠിക്കും,0,0,1,1
16650,eligió,0,0,1,1
16683,fallacieuse,0,0,1,1
16685,зарегистрированный,0,0,1,1
16624,préconisent,0,0,1,1
16724,ഭൂമി.,0,0,1,1
16716,प्रारूप,0,0,1,1
16718,hakkını,0,0,1,1
16719,percentage,0,0,1,1
16720,τυχερό,0,0,1,1
16721,المعادي,0,0,1,1
16722,zustimmen,0,0,1,1
16723,collègues,0,0,1,1
16725,மக்களுக்கு,0,0,1,1
16713,والكتالونية,0,0,1,1
16726,ತಿನ್ನಲಾಗದ,0,0,1,1
16727,கூறுகிறார்.,0,0,1,1
16728,¿sabrías,0,0,1,1
16732,pointed,0,0,1,1
16733,விக்கிப்பீடியா.காம்,0,0,1,1
16734,опыт,0,0,1,1
16735,мамой,0,0,1,1
16714,ತಯಾರಿಸಲಾಗುತ್ತದೆ.,0,0,1,1
16712,hörnet,0,0,1,1
16686,தொழில்நுட்பத்தை,0,0,1,1
16700,eylem,0,0,1,1
16689,crescente,0,0,1,1
16691,dejó,0,0,1,1
16692,conhecida,0,0,1,1
16693,cinematch,0,0,1,1
16694,digg.,0,0,1,1
16695,قريب,0,0,1,1
16697,സന്തോഷകരമായ,0,0,1,1
16701,sammanfogats.,0,0,1,1
16711,கேள்விக்குறியுடன்,0,0,1,1
16702,schwester,0,0,1,1
16704,കഴിയാത്ത,0,0,1,1
16706,pricing,0,0,1,1
16707,υπευθυνότητας,0,0,1,1
16708,interested.,0,0,1,1
16709,نسخة,0,0,1,1
16710,متكررة,0,0,1,1
16625,ta-tien,0,0,1,1
16623,أداة,0,0,1,1
16511,supprimer,0,0,1,1
16560,ആക്റ്റിവിസത്തിന്റെ,0,0,1,1
16550,leren.,0,0,1,1
16551,fiesta,0,0,1,1
16552,welcome.',0,0,1,1
16553,sıkıcı.,0,0,1,1
16555,росту,0,0,1,1
16556,الفكرة,0,0,1,1
16557,rapides,0,0,1,1
16561,defendam,0,0,1,1
16547,ಅಕ್ಷರಶಃ,0,0,1,1
16562,idiot,0,0,1,1
16563,скрыты,0,0,1,1
16565,работников,0,0,1,1
16566,पूर्वाग्रहों,0,0,1,1
16567,negativas,0,0,1,1
16568,जोड़ें],0,0,1,1
16569,alfred,0,0,1,1
16549,ലേഖനങ്ങളുടേയും,0,0,1,1
16546,tidskrift.,0,0,1,1
16571,минут.,0,0,1,1
16529,muttersprachler,0,0,1,1
16513,görmemişsinizdir,0,0,1,1
16514,फैंसी,0,0,1,1
16516,επισκευή,0,0,1,1
16519,sachez,0,0,1,1
16524,سن,0,0,1,1
16527,wikiexperts.us,0,0,1,1
16528,lejos,0,0,1,1
16532,ಅಭಿನಂದಿಸುವ,0,0,1,1
16544,desarrollamos,0,0,1,1
16533,அடுத்ததாக,0,0,1,1
16534,освободить,0,0,1,1
16538,لثلاثة,0,0,1,1
16539,ചോദിക്കുന്നുണ്ടെങ്കിൽ,0,0,1,1
16540,ചെയ്യുന്നതായി,0,0,1,1
16542,வடிவியல்,0,0,1,1
16543,basco,0,0,1,1
16570,efectuada,0,0,1,1
16572,libre[nota,0,0,1,1
16622,усилия,0,0,1,1
16611,വേരുകൾ,0,0,1,1
16602,soy,0,0,1,1
16605,contributes,0,0,1,1
16606,why.,0,0,1,1
16607,ранней,0,0,1,1
16608,confeccionar,0,0,1,1
16609,ಅಳುತ್ತಿರುವ,0,0,1,1
16610,próximo.,0,0,1,1
16612,கண்டுபிடிப்பின்படி,0,0,1,1
16600,إداريو,0,0,1,1
16613,respecta,0,0,1,1
16614,καλούντα,0,0,1,1
16615,स्वचालित,0,0,1,1
16616,hunnit,0,0,1,1
16618,सार्डिनियाई,0,0,1,1
16619,https-kryptering,0,0,1,1
16621,quebrou,0,0,1,1
16601,استقرارا.,0,0,1,1
16599,польского,0,0,1,1
16573,buggy.,0,0,1,1
16585,depende,0,0,1,1
16574,vanlig,0,0,1,1
16577,इंटरेक्टिव,0,0,1,1
16578,uger,0,0,1,1
16579,udbrød,0,0,1,1
16581,impressa,0,0,1,1
16582,действительные,0,0,1,1
16583,المقالة,0,0,1,1
16586,മുങ്ങുന്നു.,0,0,1,1
16598,ഭൗതികപ്രപഞ്ചത്തെ,0,0,1,1
16587,succesvol,0,0,1,1
16590,amusing,0,0,1,1
16591,എട്ട്,0,0,1,1
16592,эгоистичный,0,0,1,1
16594,fragmented,0,0,1,1
16595,bedecken,0,0,1,1
16597,newly,0,0,1,1
17230,ತಿಳಿದಿರುವುದರಿಂದ,0,0,1,1
17232,melekle,0,0,1,1
18186,pensées,0,0,1,1
17700,крест,0,0,1,1
17849,eventuella,0,0,1,1
17850,أليكسا،,0,0,1,1
17851,manteau,0,0,1,1
17852,eten.,0,0,1,1
17853,оптических,0,0,1,1
17854,navigateur,0,0,1,1
17857,الإذن.,0,0,1,1
17859,σύγκριση,0,0,1,1
17861,விருத்தி,0,0,1,1
17862,ഉപയോക്താവിന്,0,0,1,1
17864,references.,0,0,1,1
17867,मानते,0,0,1,1
17868,hundirse,0,0,1,1
17869,koyuyorum.,0,0,1,1
17870,مجهول,0,0,1,1
17871,ചാനലിലേക്ക്,0,0,1,1
17872,uneven,0,0,1,1
17847,garanderen.,0,0,1,1
17845,d'humanisme,0,0,1,1
17843,intervention,0,0,1,1
17821,глагол,0,0,1,1
17813,γυμνοσάλιαγκας,0,0,1,1
17814,ointelligent.,0,0,1,1
17815,efe,0,0,1,1
17816,существовало,0,0,1,1
17817,ಬಿಟ್ಟಿದ್ದರೆ,0,0,1,1
17818,orkanen,0,0,1,1
17820,расскажи,0,0,1,1
17825,checheno,0,0,1,1
17842,ошибок,0,0,1,1
17826,representación,0,0,1,1
17830,petits,0,0,1,1
17832,مدخلات,0,0,1,1
17833,يسجلون,0,0,1,1
17834,പിന്നിലുണ്ടെങ്കിലേ,0,0,1,1
17836,cérebro,0,0,1,1
17838,interpretada,0,0,1,1
17873,அழைக்க,0,0,1,1
17876,magasin.,0,0,1,1
17880,घबराए,0,0,1,1
17920,жёстких,0,0,1,1
17911,αποφθεγμάτων,0,0,1,1
17912,bloggers,0,0,1,1
17914,ഇഷ്ടപ്പെടുന്നു.,0,0,1,1
17916,step.,0,0,1,1
17917,применялись,0,0,1,1
17918,fontes.,0,0,1,1
17919,مسيئة،,0,0,1,1
17921,évaluer,0,0,1,1
17908,libre[i],0,0,1,1
17922,sponges,0,0,1,1
17926,relationer,0,0,1,1
17929,minimize,0,0,1,1
17930,പണ്ഡിതനും,0,0,1,1
17931,عنها,0,0,1,1
17932,أية,0,0,1,1
17933,ಪಡೆಯಲಿಲ್ಲ.,0,0,1,1
17909,استهدفت,0,0,1,1
17907,большинстве,0,0,1,1
17882,sentiment,0,0,1,1
17891,anlam,0,0,1,1
17883,выпущено,0,0,1,1
17884,نهاية.,0,0,1,1
17885,ನಡವಳಿಕೆ,0,0,1,1
17886,அளவுத்திட்டத்துக்கு,0,0,1,1
17887,wikimedia-projekten,0,0,1,1
17888,tosh,0,0,1,1
17889,дайте-ка,0,0,1,1
17892,находилась,0,0,1,1
17906,അടുത്തത്.,0,0,1,1
17896,ತ್ವರಿತ,0,0,1,1
17897,تسحب,0,0,1,1
17899,hiérarchique,0,0,1,1
17900,slepend,0,0,1,1
17901,ഗുണാങ്കങ്ങൾ,0,0,1,1
17902,verschilt,0,0,1,1
17903,коллектив,0,0,1,1
17812,செயன்முறையின்,0,0,1,1
17810,купить,0,0,1,1
17807,leuke,0,0,1,1
17739,поиске,0,0,1,1
17729,விளம்பர,0,0,1,1
17730,paradoxalement,0,0,1,1
17731,açıdır.,0,0,1,1
17732,etmelerini,0,0,1,1
17735,δανείσετε,0,0,1,1
17736,സവിശേഷതയാണ്,0,0,1,1
17737,esprit,0,0,1,1
17740,proclamé,0,0,1,1
17726,publiek.,0,0,1,1
17743,acompanha,0,0,1,1
17745,बेकार,0,0,1,1
17746,rike,0,0,1,1
17747,konfliktlösning.,0,0,1,1
17748,hablar.,0,0,1,1
17749,الخاصة.,0,0,1,1
17751,постепенно,0,0,1,1
17727,ones.,0,0,1,1
17725,apareció,0,0,1,1
17753,inducción,0,0,1,1
17711,संगठित,0,0,1,1
17702,quisieras,0,0,1,1
17704,പരിഹരിക്കുന്നു.,0,0,1,1
17705,الشريحة,0,0,1,1
17706,سأستخدمه,0,0,1,1
17707,drivs,0,0,1,1
17709,аналитически,0,0,1,1
17710,easiest,0,0,1,1
17712,делают,0,0,1,1
17724,indexing.,0,0,1,1
17713,அனைவருக்கும்,0,0,1,1
17714,καλλιέργεια,0,0,1,1
17715,διάσημο,0,0,1,1
17716,китая,0,0,1,1
17719,ஆரம்பிக்கப்பட்டது.,0,0,1,1
17720,rojo,0,0,1,1
17721,resistência,0,0,1,1
17752,यो,0,0,1,1
17754,relatado,0,0,1,1
17806,zweifel,0,0,1,1
17794,பெறுவீர்கள்,0,0,1,1
17785,φοβερού,0,0,1,1
17786,propostas,0,0,1,1
17787,tendríamos,0,0,1,1
17788,gestern,0,0,1,1
17791,أحدًا,0,0,1,1
17792,hingekommen,0,0,1,1
17793,കൊണ്ടിരിക്കുന്നു.,0,0,1,1
17795,وcebuano،,0,0,1,1
17782,முயற்சிகள்,0,0,1,1
17796,ب,0,0,1,1
17798,uitgehongerd,0,0,1,1
17800,ejercen,0,0,1,1
17801,позволяло,0,0,1,1
17802,amsterdã,0,0,1,1
17803,अपमान,0,0,1,1
17804,попал,0,0,1,1
17783,salarié.,0,0,1,1
17781,prospectivement,0,0,1,1
17758,habido,0,0,1,1
17770,ക്ലിക്കുചെയ്യുന്നത്,0,0,1,1
17759,gedag,0,0,1,1
17760,недостоверной,0,0,1,1
17762,administrativa,0,0,1,1
17763,போராடிய,0,0,1,1
17764,எழுதப்பட்ட,0,0,1,1
17765,ищем,0,0,1,1
17766,излагались,0,0,1,1
17771,हंगेरियाई,0,0,1,1
17779,ಮಾರ್ಗ.,0,0,1,1
17772,estamos,0,0,1,1
17773,produzida,0,0,1,1
17774,«антиэлитарность».,0,0,1,1
17775,secretively,0,0,1,1
17776,threshold.,0,0,1,1
17777,வழியாக,0,0,1,1
17778,wi-fi,0,0,1,1
17934,snabba,0,0,1,1
17935,intrinsic,0,0,1,1
17936,ആരംഭിക്കാം.,0,0,1,1
18118,vergelijkend,0,0,1,1
18108,telefonat,0,0,1,1
18110,பயனர்களின்,0,0,1,1
18111,விக்கித்,0,0,1,1
18113,милю.,0,0,1,1
18115,önceki,0,0,1,1
18116,saint,0,0,1,1
18117,സംഭാഷണവും,0,0,1,1
18120,ഇതര,0,0,1,1
18100,models.,0,0,1,1
18121,möten,0,0,1,1
18123,moda,0,0,1,1
18124,cruza,0,0,1,1
18125,totalité,0,0,1,1
18126,данной,0,0,1,1
18128,propone,0,0,1,1
18129,كريم؟,0,0,1,1
18107,الأوائل,0,0,1,1
18099,volvió,0,0,1,1
18133,verdere,0,0,1,1
18081,τραπεζιού,0,0,1,1
18070,nauwelijks,0,0,1,1
18071,ആഗ്രഹിക്കുന്നത്.,0,0,1,1
18072,aanzet,0,0,1,1
18073,गुड़िया,0,0,1,1
18076,drogs,0,0,1,1
18078,anzurufen,0,0,1,1
18079,விக்கிப்பீடியாவும்,0,0,1,1
18082,admiten,0,0,1,1
18098,işim,0,0,1,1
18084,лицензирования,0,0,1,1
18090,oopsla,0,0,1,1
18091,коннотацией,0,0,1,1
18092,d'accès,0,0,1,1
18094,νομίζω.,0,0,1,1
18095,загрузки,0,0,1,1
18097,unexpected,0,0,1,1
18132,الوحيدة,0,0,1,1
18134,artikelämnen,0,0,1,1
18068,உங்களுடைய,0,0,1,1
18174,выпустил,0,0,1,1
18167,одиночный,0,0,1,1
18168,konuşuyordu,0,0,1,1
18169,ملاك,0,0,1,1
18170,combinées,0,0,1,1
18171,qualities,0,0,1,1
18172,påpekar,0,0,1,1
18173,applying,0,0,1,1
18175,varanda,0,0,1,1
18163,ಪರಿಸ್ಥಿತಿಯಲ್ಲಿರುವುದು,0,0,1,1
18176,compliquée,0,0,1,1
18177,slightly,0,0,1,1
18178,अतिरंजित,0,0,1,1
18179,ilginç,0,0,1,1
18181,hemispheres,0,0,1,1
18182,indecisa,0,0,1,1
18185,كثير,0,0,1,1
18165,இடம்பெற,0,0,1,1
18162,voelt,0,0,1,1
18140,கனவைப்,0,0,1,1
18150,j'accepte,0,0,1,1
18141,condemned,0,0,1,1
18143,dee,0,0,1,1
18144,βοηθήσεις,0,0,1,1
18145,revision.,0,0,1,1
18146,ذكيًا,0,0,1,1
18147,άνθρωπος,0,0,1,1
18148,установлено,0,0,1,1
18152,citaträtten,0,0,1,1
18161,attirée,0,0,1,1
18153,autopromocionales,0,0,1,1
18155,aspecto,0,0,1,1
18156,pisar,0,0,1,1
18157,appuyez,0,0,1,1
18158,ಮಾಡಬಲ್ಲೆ,0,0,1,1
18159,ederim.,0,0,1,1
18160,transgenre,0,0,1,1
18069,formateras,0,0,1,1
18067,sul.,0,0,1,1
17937,தொகுக்கக்கூடியவாறு,0,0,1,1
17985,steigern,0,0,1,1
17972,ζώο,0,0,1,1
17974,autoridades.,0,0,1,1
17975,பக்கம்,0,0,1,1
17976,uninformed,0,0,1,1
17979,normalden,0,0,1,1
17982,പ്രശ്നമല്ല,0,0,1,1
17983,ದೂರದವರೆಗೆ,0,0,1,1
17986,പ്രാവീണ്യമുള്ളവരാകാനുള്ള,0,0,1,1
17970,முடிவுகளில்,0,0,1,1
17987,описал,0,0,1,1
17989,ಟ್ರಿಕಿ,0,0,1,1
17990,handhållna,0,0,1,1
17992,parcs,0,0,1,1
17993,hypertext,0,0,1,1
17994,bogstaveligt,0,0,1,1
17995,​​kolayca,0,0,1,1
17971,recrutar,0,0,1,1
17969,особенных,0,0,1,1
17997,officielles,0,0,1,1
17948,கிடைக்கவேண்டும்”,0,0,1,1
17939,الرابع,0,0,1,1
17940,ಬುದ್ಧಿವಂತಿಕೆಯು,0,0,1,1
17941,ಕಲಿಯಲಿದ್ದೇವೆ,0,0,1,1
17942,confie,0,0,1,1
17943,ഗൂണാങ്കങ്ങളിൽ,0,0,1,1
17946,എന്നിങ്ങനെയുള്ള,0,0,1,1
17947,ചേരുന്നതും,0,0,1,1
17950,d’aller,0,0,1,1
17967,tenían,0,0,1,1
17956,culminate.,0,0,1,1
17958,വൃത്തികെട്ടതും,0,0,1,1
17959,üzereyseniz.,0,0,1,1
17962,lus,0,0,1,1
17963,anarchy,0,0,1,1
17964,இயங்கத்,0,0,1,1
17965,düşünmeye,0,0,1,1
17996,pojken,0,0,1,1
18000,ആശയക്കുഴപ്പത്തിലാക്കി,0,0,1,1
18063,испанская ,0,0,1,1
18046,fann,0,0,1,1
18036,disant,0,0,1,1
18037,ഇന്റലിജൻസ്,0,0,1,1
18038,μέσων,0,0,1,1
18042,الكلمة؟,0,0,1,1
18043,ನೋಡುತ್ತಿದ್ದರು,0,0,1,1
18044,avoiding,0,0,1,1
18045,referenciados,0,0,1,1
18048,aimant,0,0,1,1
18032,«площадкой»,0,0,1,1
18050,liberar,0,0,1,1
18051,выдал,0,0,1,1
18053,тадичем,0,0,1,1
18054,ഡ്രൈവ്വേയിൽ,0,0,1,1
18057,medya,0,0,1,1
18060,дочери,0,0,1,1
18062,физиком,0,0,1,1
18035,gekleed,0,0,1,1
18029,كومنز.,0,0,1,1
18001,ısırık,0,0,1,1
18017,المخربون,0,0,1,1
18002,सुनना,0,0,1,1
18003,asunto,0,0,1,1
18006,പ്രത്യേകിച്ച്,0,0,1,1
18009,кластерах,0,0,1,1
18014,ayudarlo,0,0,1,1
18015,самая,0,0,1,1
18016,recordarte,0,0,1,1
18018,divulgación,0,0,1,1
18028,parlamentosu,0,0,1,1
18020,konferensartikeln,0,0,1,1
18021,girdi,0,0,1,1
18022,internetföretag,0,0,1,1
18024,affiliates.,0,0,1,1
18025,favorisant,0,0,1,1
18026,l'accord,0,0,1,1
18027,вошло,0,0,1,1
17701,congé,0,0,1,1
17699,basan,0,0,1,1
17233,ശ്വസിക്കാൻ,0,0,1,1
17698,lærer,0,0,1,1
17380,conflicto,0,0,1,1
17381,επομένως,0,0,1,1
17382,குளிர்,0,0,1,1
17384,sıfatlar,0,0,1,1
17386,filósofo,0,0,1,1
17387,أساسي.,0,0,1,1
17388,confronter,0,0,1,1
17389,jeg.,0,0,1,1
17390,olayları,0,0,1,1
17391,trophic,0,0,1,1
17392,adı,0,0,1,1
17395,complete,0,0,1,1
17396,corpora,0,0,1,1
17397,época.,0,0,1,1
17398,momentos,0,0,1,1
17399,мнения.,0,0,1,1
17401,இலாப,0,0,1,1
17377,போரின்போது,0,0,1,1
17375,kafasını,0,0,1,1
17374,impulsando,0,0,1,1
17361,l'encontre,0,0,1,1
17353,heartbroken,0,0,1,1
17354,പ്രശ്നമുള്ള,0,0,1,1
17355,hap,0,0,1,1
17356,كلي,0,0,1,1
17357,सहायक,0,0,1,1
17358,للتطوير,0,0,1,1
17359,processing‏,0,0,1,1
17362,томах,0,0,1,1
17373,retención,0,0,1,1
17363,விடைபெறாமல்,0,0,1,1
17364,l'apprécie,0,0,1,1
17365,sahipse,0,0,1,1
17366,ನೋಡಿದಾಗ,0,0,1,1
17367,fantastic,0,0,1,1
17368,आमेरिकेन,0,0,1,1
17371,hayan,0,0,1,1
17402,lacking,0,0,1,1
17403,pasan,0,0,1,1
17404,d'actualités,0,0,1,1
17443,നൽകി,0,0,1,1
17433,doigt,0,0,1,1
17434,condensing,0,0,1,1
17435,unbalanced,0,0,1,1
17438,वू,0,0,1,1
17439,accommodation,0,0,1,1
17441,الحمد,0,0,1,1
17442,« immanente » ,0,0,1,1
17447,ficam,0,0,1,1
17429,سجل,0,0,1,1
17449,للمحتوى,0,0,1,1
17450,सकें,0,0,1,1
17453,analysis.,0,0,1,1
17454,nord[pertinence,0,0,1,1
17455,വശങ്ങളും,0,0,1,1
17457,दूर-दूर,0,0,1,1
17458,transclusion,0,0,1,1
17431,hagas,0,0,1,1
17428,اعتذر,0,0,1,1
17405,कोवेन,0,0,1,1
17417,டைம்,0,0,1,1
17408,beweegt,0,0,1,1
17409,использовалось,0,0,1,1
17410,“controlada”,0,0,1,1
17412,மூழ்கடிப்பது,0,0,1,1
17414,സ്വതന്ത്രമായി,0,0,1,1
17415,ದಿನದಿಂದ,0,0,1,1
17416,ഹീബ്രു,0,0,1,1
17418,maomé,0,0,1,1
17427,ಬಯಸುವಿರಾ,0,0,1,1
17419,കാണാത്തപ്പോൾ‌,0,0,1,1
17420,aturdido,0,0,1,1
17421,ارتكب,0,0,1,1
17422,técnicas.,0,0,1,1
17423,repeated,0,0,1,1
17424,ദർശനം,0,0,1,1
17425,veteraner,0,0,1,1
17352,kazandı,0,0,1,1
17349,sahibi,0,0,1,1
17348,« on,0,0,1,1
17280,especificar,0,0,1,1
17268,asistentes,0,0,1,1
17269,വസ്തുക്കളുടെ,0,0,1,1
17271,aussi ,0,0,1,1
17273,piracy,0,0,1,1
17276,légitimes,0,0,1,1
17278,цифрового,0,0,1,1
17279,ईडो,0,0,1,1
17281,eder.,0,0,1,1
17264,universidades,0,0,1,1
17282,eliminação,0,0,1,1
17284,ഫിക്സ്,0,0,1,1
17286,مقابلة,0,0,1,1
17287,डगलस,0,0,1,1
17288,« six,0,0,1,1
17289,británica»,0,0,1,1
17290,mat.,0,0,1,1
17265,ಬಾಲ್ಕನಿಯಲ್ಲಿ,0,0,1,1
17263,chiffré,0,0,1,1
17292,levande.,0,0,1,1
17247,воды,0,0,1,1
17236,остановились,0,0,1,1
17237,görünüyordu,0,0,1,1
17238,alimentar,0,0,1,1
17239,ಕಾಣಬಹುದು,0,0,1,1
17241,forbløffet,0,0,1,1
17243,dépendent,0,0,1,1
17244,sacaste,0,0,1,1
17249,telefoongesprek,0,0,1,1
17260,ಮಾಡುತ್ತೇನೆ,0,0,1,1
17250,введена,0,0,1,1
17251,अन्यथा,0,0,1,1
17252,மகளின்,0,0,1,1
17253,créateur ,0,0,1,1
17254,εργασίας,0,0,1,1
17255,являясь,0,0,1,1
17259,kasparov,0,0,1,1
17291,вялой,0,0,1,1
17294,réutilisations,0,0,1,1
17347,reportedly,0,0,1,1
17335,വർദ്ധിക്കുമ്പോൾ,0,0,1,1
17326,الحيوية,0,0,1,1
17327,μεγαλύτερη,0,0,1,1
17329,öğretmen,0,0,1,1
17330,डिजीटल,0,0,1,1
17331,شهورًا,0,0,1,1
17332,७८,0,0,1,1
17334,días.,0,0,1,1
17336,исследованиях,0,0,1,1
17321,märka,0,0,1,1
17337,chevalier.,0,0,1,1
17338,s'améliorer,0,0,1,1
17340,zamanın,0,0,1,1
17342,сделана,0,0,1,1
17344,момент[когда],0,0,1,1
17345,طفلي,0,0,1,1
17346,afortunada,0,0,1,1
17322,relativas,0,0,1,1
17320,അനുകൂല,0,0,1,1
17295,hayret,0,0,1,1
17308,promoção,0,0,1,1
17296,lutou,0,0,1,1
17298,упрекать,0,0,1,1
17300,samtalen,0,0,1,1
17301,iii»,0,0,1,1
17302,ಆಯ್ಕೆಗಳ,0,0,1,1
17304,وتعتمد,0,0,1,1
17307,നോട്ടത്തിൽ,0,0,1,1
17309,mediawikiservern,0,0,1,1
17319,смущенной,0,0,1,1
17310,المجتمع ...,0,0,1,1
17311,intelligentie,0,0,1,1
17313,लिंगला,0,0,1,1
17314,flavio,0,0,1,1
17316,suitors,0,0,1,1
17317,सर्चिंग,0,0,1,1
17318,.we,0,0,1,1
17459,مراجعات,0,0,1,1
17460,sakinleşin,0,0,1,1
17462,തിരഞ്ഞെടുക്കുന്നതാണ്.,0,0,1,1
17624,texts,0,0,1,1
17616,attribué,0,0,1,1
17617,количеству,0,0,1,1
17618,संदर्भ,0,0,1,1
17619,ähm.,0,0,1,1
17621,ഹെല്ലർ,0,0,1,1
17622,മേശപ്പുറത്ത്,0,0,1,1
17623,lu,0,0,1,1
17626,l'auteur,0,0,1,1
17613,άνθρωποι,0,0,1,1
17628,conmovido,0,0,1,1
17630,énervé.,0,0,1,1
17632,derrière,0,0,1,1
17633,.todos,0,0,1,1
17634,प्रौद्योगिकी,0,0,1,1
17635,hosts,0,0,1,1
17636,പിറക്കുന്നു.,0,0,1,1
17615,methoden,0,0,1,1
17612,أقلل,0,0,1,1
17638,quirguiz,0,0,1,1
17596,titel,0,0,1,1
17584,svåra,0,0,1,1
17585,ajuda,0,0,1,1
17588,باراك,0,0,1,1
17590,deceased,0,0,1,1
17591,cogna,0,0,1,1
17592,उद्धृत,0,0,1,1
17593,منخفضة.,0,0,1,1
17597,‘மென்பொருட்கள்’,0,0,1,1
17611,സംരക്ഷിക്കുക,0,0,1,1
17598,strikta,0,0,1,1
17599,ولديك,0,0,1,1
17602,doy,0,0,1,1
17603,ಶಾಂತಗೊಳಿಸಿ.,0,0,1,1
17607,schneckenbeispiel.,0,0,1,1
17608,ordered,0,0,1,1
17609,ലേഖനങ്ങളാണ്,0,0,1,1
17637,anlamsızca,0,0,1,1
17639,échecs,0,0,1,1
17582,وكلمة,0,0,1,1
17683,أزمة,0,0,1,1
17673,संवेदनशील,0,0,1,1
17674,ओमेगाविकि,0,0,1,1
17676,hemlighetsfullt,0,0,1,1
17678,item,0,0,1,1
17679,தருகிறேன்,0,0,1,1
17681,spicules,0,0,1,1
17682,dell,0,0,1,1
17684,schrecklichen,0,0,1,1
17671,जड़ें,0,0,1,1
17685,démagogie,0,0,1,1
17687,масштабах,0,0,1,1
17689,ಐದು,0,0,1,1
17690,нарцисса.,0,0,1,1
17692,கூட்டாக,0,0,1,1
17694,spin,0,0,1,1
17695,fondant,0,0,1,1
17672,ಡೆಲ್ಹಿಯಲ್ಲಿ,0,0,1,1
17670,​​te,0,0,1,1
17640,yüksek,0,0,1,1
17652,appalling,0,0,1,1
17641,starrten,0,0,1,1
17642,wikipédien,0,0,1,1
17646,autre.,0,0,1,1
17648,നടപ്പിലാക്കാമെന്ന,0,0,1,1
17649,ഉപയോഗിക്കരുത്.,0,0,1,1
17650,løgne,0,0,1,1
17651,soruyor.,0,0,1,1
17658,restaurangen,0,0,1,1
17669,отчасти,0,0,1,1
17661,assistant,0,0,1,1
17662,augustus,0,0,1,1
17663,നിയോഗിച്ചിരിക്കുന്നു.,0,0,1,1
17664,நேர்மையாக,0,0,1,1
17665,المربى,0,0,1,1
17666,wochenende.,0,0,1,1
17667,roc,0,0,1,1
17583,wahrscheinlich,0,0,1,1
17579,характера,0,0,1,1
17463,valet.,0,0,1,1
17510,تسجيل,0,0,1,1
17499,ağlıyorsa,0,0,1,1
17500,annotera,0,0,1,1
17502,raakt,0,0,1,1
17503,geradeaus.,0,0,1,1
17506,« vandalismes »,0,0,1,1
17507,ouvrir,0,0,1,1
17509,responsibility.”,0,0,1,1
17511,gebeurd,0,0,1,1
17491,ബെൽഗാം,0,0,1,1
17513,стволовых,0,0,1,1
17514,തുടങ്ങുവാനോ,0,0,1,1
17517,ചതുപ്പുനിലമായിട്ടുണ്ട്,0,0,1,1
17518,confundi,0,0,1,1
17519,ellos.,0,0,1,1
17520,blackbody,0,0,1,1
17521,revelam,0,0,1,1
17493,pobre.,0,0,1,1
17487,l'érudition,0,0,1,1
17524,şans,0,0,1,1
17476,നേറ്റീവ്,0,0,1,1
17465,bekijken.,0,0,1,1
17466,colonies,0,0,1,1
17467,quest,0,0,1,1
17471,photography,0,0,1,1
17472,analistas,0,0,1,1
17473,आलेमैनिक,0,0,1,1
17474,അതിലെ,0,0,1,1
17478,överanvändt,0,0,1,1
17486,தெரிவிக்க,0,0,1,1
17479,mutsuz,0,0,1,1
17480,clef,0,0,1,1
17481,jacopo,0,0,1,1
17482, kilotonne,0,0,1,1
17483,φόρεμα,0,0,1,1
17484,parties.,0,0,1,1
17485,magiska,0,0,1,1
17523,വരാനുള്ള,0,0,1,1
17526,கலிஃபோர்னியாவில்,0,0,1,1
17578,என்பதற்கு,0,0,1,1
17567,وديسمبر,0,0,1,1
17560,ஏற்படுத்தவில்லை,0,0,1,1
17561,publicação.,0,0,1,1
17562,pretende,0,0,1,1
17563,wachsen,0,0,1,1
17564,congressthe,0,0,1,1
17565,еженедельник,0,0,1,1
17566,που.,0,0,1,1
17568,μιλήσετε.,0,0,1,1
17556,ഡാറ്റയാണ്,0,0,1,1
17570,stormy,0,0,1,1
17571,anadili,0,0,1,1
17572,വിറ്റതായി,0,0,1,1
17574,predictivo.,0,0,1,1
17575,skills,0,0,1,1
17576,regardez.,0,0,1,1
17577,ഔദ്യോഗിക,0,0,1,1
17557,yenilerinin,0,0,1,1
17555,എന്നാലും,0,0,1,1
17527,விக்கிப்பீடியா.கொம்,0,0,1,1
17537,பயன்படுத்தப்பட்டது,0,0,1,1
17530,difíceis,0,0,1,1
17531,significativos.,0,0,1,1
17532,fresco,0,0,1,1
17533,aardappelen,0,0,1,1
17534,düşünüyorsun,0,0,1,1
17535,ووسيم,0,0,1,1
17536,collégiale.,0,0,1,1
17539,d'entrainement,0,0,1,1
17550,bg •,0,0,1,1
17540,oradan,0,0,1,1
17541,mitigation,0,0,1,1
17543,fausses,0,0,1,1
17544,forskere,0,0,1,1
17545,estrategias,0,0,1,1
17547,excitante,0,0,1,1
17549,détection,0,0,1,1
20139,git,0,0,1,1
20141,puede.,0,0,1,1
24040,winkten,0,0,1,1
22564,ആദ്യവർഷത്തിൽ,0,0,1,1
22734,väl,0,0,1,1
22736,beneficie,0,0,1,1
22737,варианта,0,0,1,1
22738,atualizam,0,0,1,1
22739,balans,0,0,1,1
22740,مؤتمر,0,0,1,1
22741,ഉപയോക്താക്കളുടെ,0,0,1,1
22742,biriyle,0,0,1,1
22745,kuralları,0,0,1,1
22746,dummer,0,0,1,1
22748,ஒப்புக்கொள்கிறேன்,0,0,1,1
22749,ευγενικός,0,0,1,1
22752,cablegate.,0,0,1,1
22754,समझाते,0,0,1,1
22756,servidas,0,0,1,1
22760,wikipub.,0,0,1,1
22763,указан,0,0,1,1
22733,ഒരുക്കിയ,0,0,1,1
22728,undrade,0,0,1,1
22727,программные,0,0,1,1
22705,karin,0,0,1,1
22694,totais,0,0,1,1
22697,ζώνης,0,0,1,1
22698,balansgång,0,0,1,1
22699,உணர்ந்தால்,0,0,1,1
22700,l’esprit,0,0,1,1
22702,hispana,0,0,1,1
22703,cofundador.,0,0,1,1
22707,caller,0,0,1,1
22726,विकिज़नानी,0,0,1,1
22708,высшая,0,0,1,1
22709,mnist,0,0,1,1
22713,haiti,0,0,1,1
22715,«cerrar,0,0,1,1
22719,പ്രശ്നത്തിന്റേയും,0,0,1,1
22722,perdí,0,0,1,1
22725,principper,0,0,1,1
22764,sítio,0,0,1,1
22765,ಹುಚ್ಚನಾಗಿದ್ದೇನೆ.,0,0,1,1
22766,inactivity.,0,0,1,1
22813,डायरेक्टर,0,0,1,1
22805,आधिकारिक,0,0,1,1
22806,conteúdos,0,0,1,1
22807,clean,0,0,1,1
22808,सेवा,0,0,1,1
22809,negou,0,0,1,1
22811,présents,0,0,1,1
22812,mécènes,0,0,1,1
22814,الأَشغال,0,0,1,1
22800,голосованиях,0,0,1,1
22817,വീഡിയോയിലെ,0,0,1,1
22818,ewigkeiten,0,0,1,1
22820,معالجة,0,0,1,1
22821,இணையக்,0,0,1,1
22822,സ്വതന്ത്രമല്ലാത്ത,0,0,1,1
22823,അഭ്യർത്ഥനകൾ,0,0,1,1
22824,идею,0,0,1,1
22802,sonar,0,0,1,1
22799,خطأك,0,0,1,1
22771,disagreements,0,0,1,1
22786,répercussions,0,0,1,1
22775,добровольцами,0,0,1,1
22776,saldırıya,0,0,1,1
22777,teceu,0,0,1,1
22778,تعاملت,0,0,1,1
22781,abandonaban,0,0,1,1
22782,നടക്കുന്നത്.,0,0,1,1
22784,സ്റ്റഫ്,0,0,1,1
22789,ಒಳ್ಳೆಯವನಾಗಿದ್ದೆ,0,0,1,1
22798,annoncée,0,0,1,1
22790,imieliński,0,0,1,1
22791,reflektion,0,0,1,1
22792,enfades,0,0,1,1
22793,знания,0,0,1,1
22794,one's,0,0,1,1
22795,μήπως,0,0,1,1
22797,glace,0,0,1,1
22689,बैठी,0,0,1,1
22687,lissés,0,0,1,1
22686,zurückkommen.,0,0,1,1
22608,resultando,0,0,1,1
22599,تسلسلات,0,0,1,1
22601,çıkmasına,0,0,1,1
22602,reliées,0,0,1,1
22603,مطلوبة,0,0,1,1
22605,حديقتهم,0,0,1,1
22606,muhammad.,0,0,1,1
22607,disallowed,0,0,1,1
22611,ಹೊಂದಿದ್ದರು.,0,0,1,1
22596,aktiviteten,0,0,1,1
22612,ingeniero,0,0,1,1
22613,അക്ഷരങ്ങളെയും,0,0,1,1
22615,φτιαγμένες,0,0,1,1
22616,bce.,0,0,1,1
22617,अर्थव्यवस्था,0,0,1,1
22618,unintelligen.t,0,0,1,1
22620,hiermee,0,0,1,1
22598,solide,0,0,1,1
22594,ವಿವರಿಸುತ್ತಾರೆ,0,0,1,1
22622,dieta,0,0,1,1
22579,antissociais.,0,0,1,1
22567,العلوم,0,0,1,1
22568,serbie,0,0,1,1
22569,ускоряющийся,0,0,1,1
22570,βικιθήκη,0,0,1,1
22573,ίση,0,0,1,1
22577,dinlemiyordum,0,0,1,1
22578,cs •,0,0,1,1
22580,основатели,0,0,1,1
22591,gefangene,0,0,1,1
22581,udtaler,0,0,1,1
22583,kıyafet,0,0,1,1
22584,olursun,0,0,1,1
22586,дисках.,0,0,1,1
22587,ஏற்றுக்கொள்ள,0,0,1,1
22589,adicionados,0,0,1,1
22590,يعتبر,0,0,1,1
22621,takipsizliği,0,0,1,1
22623,jungs,0,0,1,1
22685,cc-by-sa-.-nl,0,0,1,1
22670,வாழ்வாள்,0,0,1,1
22658,مناسبًا,0,0,1,1
22662,bord.,0,0,1,1
22663,programmoduler,0,0,1,1
22664,zeneca,0,0,1,1
22665,καρφί,0,0,1,1
22667,país.,0,0,1,1
22668,раскритиковано,0,0,1,1
22671,ontvoering.,0,0,1,1
22655,descentralizada,0,0,1,1
22673,баллотироваться,0,0,1,1
22676,landlocked,0,0,1,1
22677,opportunités,0,0,1,1
22678,controvertidos,0,0,1,1
22680,ഗുണാങ്ക,0,0,1,1
22681,планах.,0,0,1,1
22682,الدراسة.,0,0,1,1
22657,وذهب,0,0,1,1
22654,πρόσωπο,0,0,1,1
22627,ഓർമയോ,0,0,1,1
22638,léthargiques,0,0,1,1
22628,dérivée,0,0,1,1
22630,подумайте,0,0,1,1
22631,सिटीजेंडियम,0,0,1,1
22633,ಆಲೂಗಡ್ಡೆಗಳನ್ನು,0,0,1,1
22634,verstanden.,0,0,1,1
22635,تبحث,0,0,1,1
22637,красоты.,0,0,1,1
22640,الذاتية,0,0,1,1
22652,attacker,0,0,1,1
22641,അതിനുമുമ്പും,0,0,1,1
22642,यूनानी,0,0,1,1
22643,отца,0,0,1,1
22644,ವಸ್ತುಗಳು,0,0,1,1
22646,yolculuktan,0,0,1,1
22647,simplifier,0,0,1,1
22648,ذكي.,0,0,1,1
22827,normal.,0,0,1,1
22829,falantes,0,0,1,1
22830,نافياً,0,0,1,1
22990,indicates,0,0,1,1
22981,تغطية,0,0,1,1
22983,refrendados,0,0,1,1
22984,βοηθήσει,0,0,1,1
22985,ediyorum.,0,0,1,1
22986,sınıfta,0,0,1,1
22988,attributable,0,0,1,1
22989,[update].,0,0,1,1
22992,izleyebilirler.,0,0,1,1
22978,dinge.,0,0,1,1
22996,άντρας.,0,0,1,1
22997,politiken.dk,0,0,1,1
22998,مشاهدي,0,0,1,1
23000,patrol,0,0,1,1
23001,desanimadoras,0,0,1,1
23002,ലോക,0,0,1,1
23003,musées,0,0,1,1
22980,encima.,0,0,1,1
22977,unglück.,0,0,1,1
23007,randevunuz,0,0,1,1
22966,duydunuz,0,0,1,1
22954,beskrivningsrutan,0,0,1,1
22955,редактирование,0,0,1,1
22957,ervoor,0,0,1,1
22959,interessiert,0,0,1,1
22962, تم,0,0,1,1
22964,içerdiğini,0,0,1,1
22965,ಗಂಟೆ.,0,0,1,1
22967,baseadas,0,0,1,1
22976,yanlışlar,0,0,1,1
22968,lente.,0,0,1,1
22969,traurig,0,0,1,1
22970,°′″n,0,0,1,1
22971,destaca,0,0,1,1
22972,διότι,0,0,1,1
22974,today.,0,0,1,1
22975,ಕರೆದೊಯ್ಯುತ್ತೇನೆ,0,0,1,1
23005,zeiden,0,0,1,1
23008,сказано,0,0,1,1
22952,accepterer,0,0,1,1
23060,macaque.,0,0,1,1
23048,раза.,0,0,1,1
23050,metal,0,0,1,1
23052,tonu,0,0,1,1
23054,ofrecerme.,0,0,1,1
23056,சகோதரத்,0,0,1,1
23058,zevkti.,0,0,1,1
23059,slutgiltig,0,0,1,1
23062,rencontrez,0,0,1,1
23045,kapot,0,0,1,1
23063,пользоваться,0,0,1,1
23064,yanar,0,0,1,1
23067,llama,0,0,1,1
23069,അപ്പോൾ,0,0,1,1
23070,científica.,0,0,1,1
23072,ενημέρωσης,0,0,1,1
23073,trubbigt,0,0,1,1
23047,halvautomatiserade,0,0,1,1
23044,بدون,0,0,1,1
23012,gardens,0,0,1,1
23024,ξεχνούν,0,0,1,1
23013,responsável,0,0,1,1
23014,ganhando,0,0,1,1
23015,frança,0,0,1,1
23019,dualisme.,0,0,1,1
23020,gepolijst,0,0,1,1
23022,खुली,0,0,1,1
23023,വാരാന്ത്യ,0,0,1,1
23025,child.,0,0,1,1
23041,llegar,0,0,1,1
23028,перейти,0,0,1,1
23030,partisanes ».,0,0,1,1
23031,decírselo,0,0,1,1
23032,xanadu,0,0,1,1
23034,able.,0,0,1,1
23035,отражении,0,0,1,1
23038,verfijnd,0,0,1,1
22953,entendez,0,0,1,1
22951,d'auteur.,0,0,1,1
22831,некоторая,0,0,1,1
22873,ಒಂದಕ್ಕಿಂತ,0,0,1,1
22859,presides,0,0,1,1
22860,underwater,0,0,1,1
22862,‘மைக்கேல்,0,0,1,1
22864,latijn,0,0,1,1
22869,ബ്യൂറോക്രാറ്റുകളേയും,0,0,1,1
22870,kvinde,0,0,1,1
22872,bett,0,0,1,1
22874,légèrement,0,0,1,1
22856,baidu.,0,0,1,1
22875,grundprincipen,0,0,1,1
22876,банку,0,0,1,1
22877,വിലയില്ല.,0,0,1,1
22879,resmi,0,0,1,1
22880,descubiertos,0,0,1,1
22882,variáveis,0,0,1,1
22886,الاقتباسات،,0,0,1,1
22857,goods,0,0,1,1
22855,رسمية,0,0,1,1
22890,बोल,0,0,1,1
22844,പ്രദേശത്ത്,0,0,1,1
22833,herum,0,0,1,1
22836,apariencias,0,0,1,1
22837,music,0,0,1,1
22839,أجرى,0,0,1,1
22841,मैं',0,0,1,1
22842,authorities,0,0,1,1
22843,compraron,0,0,1,1
22845,भली,0,0,1,1
22854,glatt,0,0,1,1
22846,dispensem,0,0,1,1
22847,rester,0,0,1,1
22848,ಅವನಿಗೆ,0,0,1,1
22849,ഇപ്പോൾ.,0,0,1,1
22851,знаку,0,0,1,1
22852,ജോർജ്ജ്.,0,0,1,1
22853,gegaan,0,0,1,1
22889,تقريبًا.,0,0,1,1
22891,accord.,0,0,1,1
22949,вопросах,0,0,1,1
22934,rohde,0,0,1,1
22924,ஆண்களை,0,0,1,1
22925,ζωντανό.,0,0,1,1
22926,trait,0,0,1,1
22927,മെച്ചപ്പെടുത്തുവാനും,0,0,1,1
22929,gerealiseerd,0,0,1,1
22930,பொதுவாக,0,0,1,1
22931,sökverktyg,0,0,1,1
22936,خارجية,0,0,1,1
22922,подвергаться,0,0,1,1
22937,d'illustrations,0,0,1,1
22938,systeem,0,0,1,1
22939,использующие,0,0,1,1
22940,панорамы.,0,0,1,1
22942,automatiquement,0,0,1,1
22943,milliarder,0,0,1,1
22947,l'abonnement,0,0,1,1
22923,beeton,0,0,1,1
22921,áfrica.,0,0,1,1
22892,нидерландов,0,0,1,1
22906,appropriée,0,0,1,1
22896,–principalmente,0,0,1,1
22898,afspiegeling,0,0,1,1
22899,يقترح,0,0,1,1
22900,нужна,0,0,1,1
22902,compañía,0,0,1,1
22904,de-noising.,0,0,1,1
22905,പോർച്ചുഗീസ്,0,0,1,1
22907,düzeltilmesini,0,0,1,1
22919,ಹಹ್,0,0,1,1
22908,ثالث,0,0,1,1
22909,dons.,0,0,1,1
22910,ಮಾಡುವುದು.,0,0,1,1
22911,ثابتة,0,0,1,1
22912,вирджиния,0,0,1,1
22915,تقارير,0,0,1,1
22917,sonríe,0,0,1,1
22566,l'humain,0,0,1,1
22562,تواصل.,0,0,1,1
23079,திருத்தங்களைப்,0,0,1,1
22561,grammaire,0,0,1,1
22227,muestran,0,0,1,1
22228,mote,0,0,1,1
22230,artikelredigeringar,0,0,1,1
22232,« éducation ».,0,0,1,1
22234,மற்றவர்,0,0,1,1
22236,товарного,0,0,1,1
22237,brittiska,0,0,1,1
22238,اتخذتها,0,0,1,1
22239,ഉപയോഗിക്കാവുന്ന,0,0,1,1
22241,hâlen,0,0,1,1
22242,अमीर,0,0,1,1
22243,добровольного,0,0,1,1
22244,сбалансированные,0,0,1,1
22245,ಪ್ರಾಮಾಣಿಕವಾಗಿ,0,0,1,1
22246,variadas,0,0,1,1
22248,الاتجاه.,0,0,1,1
22251,gas,0,0,1,1
22226,meant,0,0,1,1
22224,influencia,0,0,1,1
22223,memcached,0,0,1,1
22210,قيمة,0,0,1,1
22202,vezes.,0,0,1,1
22204,bevisar,0,0,1,1
22205,убита,0,0,1,1
22206,springe,0,0,1,1
22207,ತಾಯಿಯಲ್ಲ.,0,0,1,1
22208,tegenstrijdige,0,0,1,1
22209,şifresini,0,0,1,1
22212,wiki-reto,0,0,1,1
22222,الخاطئة,0,0,1,1
22213,bulunabilir.,0,0,1,1
22214,recently,0,0,1,1
22215,புவியியல்,0,0,1,1
22218,ഇറ്റാലിയൻ,0,0,1,1
22219,bokkapitlet,0,0,1,1
22220,stumt,0,0,1,1
22221,yapmamıştım,0,0,1,1
22252,ಯೋಜಿಸುತ್ತಿದ್ದೇನೆ,0,0,1,1
22253,skapades,0,0,1,1
22254,предпочел,0,0,1,1
22299,ಅಮೆರಿಕಾದಲ್ಲಿ,0,0,1,1
22289,rigtige,0,0,1,1
22291,atrás,0,0,1,1
22292,അതിനുപുറമേ,0,0,1,1
22293,разницы,0,0,1,1
22295,manually,0,0,1,1
22296,klinken,0,0,1,1
22298,multi-agent,0,0,1,1
22300,αφοσιωμένη,0,0,1,1
22285,चाहे,0,0,1,1
22302,studenters,0,0,1,1
22304,അത്.,0,0,1,1
22305,apertura,0,0,1,1
22306,напугала,0,0,1,1
22307,காலாண்டில்,0,0,1,1
22308,богат,0,0,1,1
22311,போதுமானதாக,0,0,1,1
22288,ಸಂದಿಗ್ಧತೆ,0,0,1,1
22284,spridning,0,0,1,1
22255,aradan,0,0,1,1
22267,männen,0,0,1,1
22257,criativa,0,0,1,1
22259,versucht,0,0,1,1
22260,reescrevem,0,0,1,1
22262,exeditor,0,0,1,1
22263,vikisözlük,0,0,1,1
22264,animó,0,0,1,1
22266,eliminaria,0,0,1,1
22270,regardons,0,0,1,1
22283,mass.,0,0,1,1
22272,ನಿಧಾನವಾಗಿದ್ದೇನೆ.,0,0,1,1
22274,industrielles,0,0,1,1
22276,anlayabileceği,0,0,1,1
22277,எதிர்மறை,0,0,1,1
22278,بجانبها,0,0,1,1
22281,fehlverhalten,0,0,1,1
22282,ചെയ്താണ്,0,0,1,1
22201,പോകുന്നുവെന്നത്,0,0,1,1
22199,sive,0,0,1,1
22197,அழகையும்,0,0,1,1
22124,vernuftig,0,0,1,1
22114,оскорблением,0,0,1,1
22117,മാസത്തെ,0,0,1,1
22118,connotaciones,0,0,1,1
22119,известны,0,0,1,1
22120,gangen,0,0,1,1
22122,språkversioner.,0,0,1,1
22123,выше,0,0,1,1
22125,ചെയ്യും.,0,0,1,1
22111,sortit,0,0,1,1
22126,menge,0,0,1,1
22127,تضر,0,0,1,1
22131,kinesisk,0,0,1,1
22132,else.,0,0,1,1
22133,vastzit,0,0,1,1
22135,مرت,0,0,1,1
22136,race,0,0,1,1
22113,ofensivas,0,0,1,1
22110,lebender.,0,0,1,1
22138,ловушки-,0,0,1,1
22096,ajout,0,0,1,1
22087,gewijzigde,0,0,1,1
22089,evner.,0,0,1,1
22090,merken,0,0,1,1
22091,وتعترف,0,0,1,1
22092,εθνικοτήτων,0,0,1,1
22093,silber,0,0,1,1
22095,மென்மையாகவும்,0,0,1,1
22098,അഭിപ്രായമിടാൻ,0,0,1,1
22109,mejores,0,0,1,1
22100,«вики».,0,0,1,1
22101,സമയമില്ല,0,0,1,1
22102,إنك,0,0,1,1
22103,சொல்.,0,0,1,1
22104,planerat,0,0,1,1
22106,கொண்டுவரலாம்.,0,0,1,1
22108,அனைத்தும்,0,0,1,1
22137,allait,0,0,1,1
22139,rien.,0,0,1,1
22196,opérateurs.,0,0,1,1
22185,pur,0,0,1,1
22169,இப்பக்கத்தைப்,0,0,1,1
22173,வழங்கப்பட்டது.,0,0,1,1
22179,സംരക്ഷിക്കേണ്ട,0,0,1,1
22180,गिगल्स,0,0,1,1
22181,بوت,0,0,1,1
22182,منظر,0,0,1,1
22184,ലഭിക്കില്ല,0,0,1,1
22186,защиты,0,0,1,1
22167,أذهب.,0,0,1,1
22187,lyt,0,0,1,1
22189,princípio,0,0,1,1
22191,falsamente,0,0,1,1
22192,cancerous,0,0,1,1
22193,vanliga.,0,0,1,1
22194,ഉണ്ടെന്നും,0,0,1,1
22195,அப்பட்டமானதைக்,0,0,1,1
22168,иными,0,0,1,1
22166,function.,0,0,1,1
22140,atualização,0,0,1,1
22152,नरसी,0,0,1,1
22141,tivéssemos,0,0,1,1
22142,matsalen,0,0,1,1
22144,ein.,0,0,1,1
22145,used.,0,0,1,1
22146,കരയുന്ന,0,0,1,1
22147,сотрудничестве,0,0,1,1
22151,ಕ್ರಿಯೆ,0,0,1,1
22153,groups.,0,0,1,1
22165,ಎಲ್ಲಿಂದ,0,0,1,1
22154,fuente.,0,0,1,1
22156,பொத்தானைக்,0,0,1,1
22157,parvenant,0,0,1,1
22160,έβγαλα,0,0,1,1
22161,ரகசியமான,0,0,1,1
22162,zuerst,0,0,1,1
22164,toenemen.,0,0,1,1
22312,valuing,0,0,1,1
22313,intrude,0,0,1,1
22314,l'ajoutant,0,0,1,1
22475,söyle,0,0,1,1
22467,apreço.,0,0,1,1
22468,вкусно,0,0,1,1
22470,சிறைச்சாலைகளில்,0,0,1,1
22471,kanıtlamazsanız,0,0,1,1
22472,boring.,0,0,1,1
22473,chico,0,0,1,1
22474,उज़्बैक,0,0,1,1
22477,tsurko,0,0,1,1
22465,mucha,0,0,1,1
22478,feasibility,0,0,1,1
22481,ചാനലായ,0,0,1,1
22482,üçü,0,0,1,1
22483,sourced.,0,0,1,1
22485,ordu,0,0,1,1
22487,ability.,0,0,1,1
22488,solle,0,0,1,1
22466,salz,0,0,1,1
22463,viel.,0,0,1,1
22490,repairing,0,0,1,1
22451,общество,0,0,1,1
22443,совместного,0,0,1,1
22444,ഉടൻ,0,0,1,1
22445,اعمده,0,0,1,1
22446,fondée,0,0,1,1
22448,bereikt,0,0,1,1
22449,interprétés,0,0,1,1
22450,وتبدو,0,0,1,1
22452,undersöker,0,0,1,1
22462,l'essence,0,0,1,1
22453,dévie,0,0,1,1
22454,évolutions,0,0,1,1
22456,valde,0,0,1,1
22457,समझा,0,0,1,1
22458,eliminadores,0,0,1,1
22459,система,0,0,1,1
22461,voyager,0,0,1,1
22489,«подобное,0,0,1,1
22491,çamaşır,0,0,1,1
22440,ಸ್ಥಳವಿಲ್ಲ,0,0,1,1
22549,duymuşsanız,0,0,1,1
22534,فظيع,0,0,1,1
22538,தாயைக்,0,0,1,1
22539,illustration,0,0,1,1
22542,ശ്രദ്ധിക്കൂ,0,0,1,1
22543,வாக்கிய,0,0,1,1
22544,absurdos,0,0,1,1
22545,تقليدًا,0,0,1,1
22552,polonês/polaco,0,0,1,1
22531,تكميلي,0,0,1,1
22553,d'interventions,0,0,1,1
22554,d'alexa,0,0,1,1
22555,title,0,0,1,1
22557,पकड़ा।,0,0,1,1
22558,स्थिर,0,0,1,1
22559,verbazingwekkends,0,0,1,1
22560,вызванной,0,0,1,1
22533,dediğinizde,0,0,1,1
22530,daneben,0,0,1,1
22494,१५०,0,0,1,1
22512,parodiler,0,0,1,1
22495,ಹೋಗುತ್ತದೆ,0,0,1,1
22499,προστεθούν,0,0,1,1
22502,വാങ്ങില്ല,0,0,1,1
22504,लिखता,0,0,1,1
22507,நேரத்திலும்.,0,0,1,1
22509,regelmæssigt.,0,0,1,1
22511,mejorar,0,0,1,1
22513,بأس,0,0,1,1
22529,വലുതുമായ,0,0,1,1
22516,ställe,0,0,1,1
22517,ouça,0,0,1,1
22518,بنحو,0,0,1,1
22519,korean,0,0,1,1
22520,விக்கிப்பீடியாவினுள்,0,0,1,1
22523,voyageaient,0,0,1,1
22525,எங்கள்,0,0,1,1
22442,ξαναδώ.,0,0,1,1
22439,originalforskning,0,0,1,1
22316,kırmızı,0,0,1,1
22361,εξυπηρετούν,0,0,1,1
22351,sentez,0,0,1,1
22352,εμπειρία.,0,0,1,1
22353,vivas.,0,0,1,1
22354,camel,0,0,1,1
22355,yönleriyle,0,0,1,1
22356,ويتم,0,0,1,1
22358,ru •,0,0,1,1
22365,ತಪ್ಪು.,0,0,1,1
22347,consultores,0,0,1,1
22368,vigilant,0,0,1,1
22369,الانتظار.,0,0,1,1
22371,musée,0,0,1,1
22372,बिग,0,0,1,1
22373,indiquait,0,0,1,1
22374,zorundasın,0,0,1,1
22375,تستطع,0,0,1,1
22349,surprend,0,0,1,1
22346,d'augmenter,0,0,1,1
22378,commit,0,0,1,1
22327,ಗಂಭೀರವಾಗಿ,0,0,1,1
22318,जोड़ें]-विकिपीडिया,0,0,1,1
22319,sitta,0,0,1,1
22320,el.,0,0,1,1
22321,தேவதூதருடன்,0,0,1,1
22323,polysémie.,0,0,1,1
22325,யோசனை,0,0,1,1
22326,θέλει.,0,0,1,1
22332,പഠന,0,0,1,1
22345,முன்னேறியது.,0,0,1,1
22336,adressen,0,0,1,1
22337,redirection.,0,0,1,1
22338,meldden,0,0,1,1
22340,chemical,0,0,1,1
22342,vardagligt,0,0,1,1
22343,تحياتي,0,0,1,1
22344,gusto,0,0,1,1
22377,തടസ്സപ്പെടുത്തിയതിൽ,0,0,1,1
22380,بقراءة,0,0,1,1
22438,drôle,0,0,1,1
22422,بذلك؟.,0,0,1,1
22413,आधुनिक,0,0,1,1
22414,وعمل,0,0,1,1
22416,cümle.,0,0,1,1
22417,lyfta,0,0,1,1
22418,verder.,0,0,1,1
22420,monde ».,0,0,1,1
22421,نسوا,0,0,1,1
22424,-ю,0,0,1,1
22410,पानी,0,0,1,1
22425,пора,0,0,1,1
22427,créatures,0,0,1,1
22428,ഇൻപുട്ടിൽ,0,0,1,1
22429,அவனுடைய,0,0,1,1
22431,دارتموث,0,0,1,1
22436,открытым,0,0,1,1
22437,aleatória,0,0,1,1
22411,affärer,0,0,1,1
22409,குறிப்பிடத்தக்க,0,0,1,1
22381,معروفًا,0,0,1,1
22395,ഷെല്ലിന്റെ,0,0,1,1
22383,woman.,0,0,1,1
22384,ജയിലുകളിൽ,0,0,1,1
22386,igennem,0,0,1,1
22389,españolas,0,0,1,1
22392,لأقول,0,0,1,1
22393,søvnen,0,0,1,1
22394,συνηθισμένο.,0,0,1,1
22397,comediante,0,0,1,1
22408,പതാകവാഹക‍.,0,0,1,1
22398,операционные,0,0,1,1
22401,सुवे,0,0,1,1
22402,الحرب,0,0,1,1
22404,forked,0,0,1,1
22405,spaarnestad,0,0,1,1
22406,nail,0,0,1,1
22407,الذكاء,0,0,1,1
23077,enverrai,0,0,1,1
23080,«ссылки,0,0,1,1
22083,भड़काने,0,0,1,1
23543,ഇബ്സൻ,0,0,1,1
23700,dudosos,0,0,1,1
23701,relatados,0,0,1,1
23702,റഫറൻസ്,0,0,1,1
23705,citizendium.,0,0,1,1
23708, k,0,0,1,1
23709,gelenekleriyle,0,0,1,1
23713,ajudaria,0,0,1,1
23714,अवार्ड,0,0,1,1
23715,утверждения,0,0,1,1
23716,binnenstapte,0,0,1,1
23717,finden,0,0,1,1
23718,അലസമോ,0,0,1,1
23720,मुख्यधारा,0,0,1,1
23723,каким-то,0,0,1,1
23724,advance.,0,0,1,1
23725,раньше.,0,0,1,1
23728,karşısında,0,0,1,1
23698,webbversionen,0,0,1,1
23697,பார்வையிட,0,0,1,1
23695,يتزوجني,0,0,1,1
23681,كلهم,0,0,1,1
23666,bbc.,0,0,1,1
23670,அங்குள்ள,0,0,1,1
23671,red.,0,0,1,1
23674,നല്കുന്ന,0,0,1,1
23675,الطب.,0,0,1,1
23677,n'êtes,0,0,1,1
23678,porção,0,0,1,1
23683,ಗೊತ್ತು,0,0,1,1
23694,knipogen,0,0,1,1
23684,« portail ».[réf.,0,0,1,1
23685,ಮಾಡಬಾರದು,0,0,1,1
23686,bazıları,0,0,1,1
23688,कोटेशन्स,0,0,1,1
23689,функций.,0,0,1,1
23691,смог,0,0,1,1
23693,wells,0,0,1,1
23729,universitários,0,0,1,1
23731,biliyorsanız,0,0,1,1
23732,convenues,0,0,1,1
23782,aback,0,0,1,1
23767,svenskt,0,0,1,1
23768,nessa,0,0,1,1
23770,trading,0,0,1,1
23776,ചെയ്യപ്പെടുന്നു,0,0,1,1
23777,ladda,0,0,1,1
23778,കണ്ടതുമുതൽ,0,0,1,1
23779,முறையை,0,0,1,1
23783,കുറിക്കാൻ,0,0,1,1
23765,أسباب,0,0,1,1
23784,लेखे-जोखे,0,0,1,1
23785,foresee,0,0,1,1
23786,onderverdeeld,0,0,1,1
23787,μαθαίνετε,0,0,1,1
23788,ಯು,0,0,1,1
23789,maldonado ,0,0,1,1
23791,collegiale,0,0,1,1
23766,construite,0,0,1,1
23762,automatiserade,0,0,1,1
23733,tarif,0,0,1,1
23743,downward,0,0,1,1
23734,ناطقة,0,0,1,1
23735,d'âge,0,0,1,1
23736,webbvyn,0,0,1,1
23737,उर्फ,0,0,1,1
23738,amérindiennes.,0,0,1,1
23739,açlıktan,0,0,1,1
23742,wikipediaanvändare.,0,0,1,1
23744,ನಮ್ಮೊಂದಿಗೆ,0,0,1,1
23760,finest,0,0,1,1
23748,taxas,0,0,1,1
23750,அவர்களில்,0,0,1,1
23751,глагольная,0,0,1,1
23752,geliebt,0,0,1,1
23754,d'inscription,0,0,1,1
23755,tú.,0,0,1,1
23759,yttrandefrihet,0,0,1,1
23665,abuso,0,0,1,1
23664,detenerte,0,0,1,1
23663,ಆಡುಮಾತಿನಂತಿದೆ,0,0,1,1
23590,vus,0,0,1,1
23580,சூழலில்,0,0,1,1
23581,приходите,0,0,1,1
23584,പിടിച്ചുനിൽക്കാമോ,0,0,1,1
23585,ಬ್ರೆಡ್ನಿಂದ,0,0,1,1
23586,wie',0,0,1,1
23587,halve,0,0,1,1
23588,جاءت,0,0,1,1
23592,дышать,0,0,1,1
23577,userinterface,0,0,1,1
23593,yann,0,0,1,1
23594,somado,0,0,1,1
23595,öğrenin,0,0,1,1
23596,oi,0,0,1,1
23597,ужасный.,0,0,1,1
23598,vagonun,0,0,1,1
23599,ರೀತಿಯ,0,0,1,1
23578,opslagcapaciteit,0,0,1,1
23576,skrevs,0,0,1,1
23601,கொடுமை,0,0,1,1
23562,«написание,0,0,1,1
23545,homogeneizando,0,0,1,1
23548,αχνό,0,0,1,1
23551,falar.,0,0,1,1
23552,yakışıklıydı,0,0,1,1
23554,பிரஞ்சு,0,0,1,1
23555,commons',0,0,1,1
23558,non-commercial.,0,0,1,1
23564,തൽപരരായ,0,0,1,1
23575,l’occident,0,0,1,1
23565,விரல்களில்,0,0,1,1
23567,लगाना,0,0,1,1
23570,quitaría,0,0,1,1
23571,tjek,0,0,1,1
23572,salle,0,0,1,1
23573,frokosten,0,0,1,1
23574,αριθμού,0,0,1,1
23600,பிரச்சினைகள்,0,0,1,1
23602,экспоненциально,0,0,1,1
23662,incubator,0,0,1,1
23651,சுவைக்கும்.,0,0,1,1
23638,genel,0,0,1,1
23639,passwort,0,0,1,1
23640,ರೀತಿಯದ್ದಾಗಿದೆ.,0,0,1,1
23643,jederzeit.,0,0,1,1
23646,zus,0,0,1,1
23648,देंगे।,0,0,1,1
23649,நாய்,0,0,1,1
23652,sange,0,0,1,1
23633,iğrenç.,0,0,1,1
23653,ieder,0,0,1,1
23654,وكيف,0,0,1,1
23655,sorvete,0,0,1,1
23656,författares,0,0,1,1
23657,അങ്ങനെയായിരിക്കും.,0,0,1,1
23658,ಅಸಮಾಧಾನಗೊಳ್ಳಬೇಡಿ.,0,0,1,1
23660,«научно-образовательный,0,0,1,1
23635,πρότασή,0,0,1,1
23632,ஆக்கங்கள்,0,0,1,1
23603,oposto,0,0,1,1
23615,vazgeçmektedir.,0,0,1,1
23605,ಸಂಪತ್ತಿಗೆ,0,0,1,1
23606,teaching,0,0,1,1
23607,podrias,0,0,1,1
23608,kafasına,0,0,1,1
23611,العلاجات,0,0,1,1
23613,linking,0,0,1,1
23614,situaban,0,0,1,1
23618,ouverte.,0,0,1,1
23631,olanak,0,0,1,1
23619,إم,0,0,1,1
23621,spite,0,0,1,1
23622,vriendinnen,0,0,1,1
23627,व्यस्तता,0,0,1,1
23628,scale,0,0,1,1
23629,சொல்லவும்,0,0,1,1
23630,mannelijk.,0,0,1,1
23792,утро,0,0,1,1
23793,beyler,0,0,1,1
23795,divulgada,0,0,1,1
23971,ಫಿಕ್ಸ್‌ನಲ್ಲಿದ್ದೀರಿ,0,0,1,1
23963,കേൾക്കാതെ,0,0,1,1
23964,நாளைக்கு,0,0,1,1
23965,reeditado,0,0,1,1
23966,блюд,0,0,1,1
23967,rejeitando,0,0,1,1
23968,kingdom,0,0,1,1
23969,الطلبات.,0,0,1,1
23974,ചേർക്കാവുന്നതാണ്.,0,0,1,1
23954,δικιο.,0,0,1,1
23975,தொடங்க,0,0,1,1
23977,готовы,0,0,1,1
23978,बताओ,0,0,1,1
23979,apresentados,0,0,1,1
23983,മാറ്റുക,0,0,1,1
23985,barely,0,0,1,1
23986,possíveis,0,0,1,1
23955,ലേഖകരും,0,0,1,1
23953,понятия,0,0,1,1
23988,conséquent,0,0,1,1
23940,καταλάβω,0,0,1,1
23929,arbetssättet,0,0,1,1
23932,confère ».,0,0,1,1
23933,வழிமுறைகளைப்,0,0,1,1
23935,şatodan,0,0,1,1
23936,uitgeroepen,0,0,1,1
23937,വിചാരിച്ചു,0,0,1,1
23939,مصدري,0,0,1,1
23941,बाढ़,0,0,1,1
23952,liever,0,0,1,1
23943,قضمة,0,0,1,1
23944,behandlede,0,0,1,1
23945,wedding,0,0,1,1
23947,geduld,0,0,1,1
23949,enregistrées,0,0,1,1
23950,анализа,0,0,1,1
23951,اختلاف,0,0,1,1
23987,aclamados,0,0,1,1
23991,semelhanças,0,0,1,1
23927,погружение,0,0,1,1
24031,rubinen,0,0,1,1
24024,वीलेन,0,0,1,1
24025,предсказывать,0,0,1,1
24026,touristique,0,0,1,1
24027,undskyldning.,0,0,1,1
24028,कोरिया,0,0,1,1
24029,augmentation,0,0,1,1
24030,يستخدمون,0,0,1,1
24032,donzelas,0,0,1,1
24022,hızlandı.,0,0,1,1
24033,மாற்றங்களுக்கான,0,0,1,1
24034,recourir,0,0,1,1
24035,статистическим,0,0,1,1
24036,intrude.,0,0,1,1
24037,ഇപയോഗിക്കുന്നത്.,0,0,1,1
24038,ongewild,0,0,1,1
24039,فامنحه,0,0,1,1
24023,поставив,0,0,1,1
24020,ciencias,0,0,1,1
23992,«истина,0,0,1,1
24007,posicionó,0,0,1,1
23993,оказаться,0,0,1,1
23995,ಹಿಸಿದರೂ,0,0,1,1
23998,நபர்,0,0,1,1
24000,стран,0,0,1,1
24001,banned,0,0,1,1
24004,recusado,0,0,1,1
24006,broadcast,0,0,1,1
24009,നീക്കം,0,0,1,1
24019,أخيرًا،,0,0,1,1
24010,sevimlisin,0,0,1,1
24011,párrafo,0,0,1,1
24012,egyptian,0,0,1,1
24013,meddelelse,0,0,1,1
24014,ah,0,0,1,1
24015,المضحك,0,0,1,1
24016,“பல்நிலை,0,0,1,1
23928,gulfs,0,0,1,1
23926,vente.,0,0,1,1
23796,നൈട്രജൻ,0,0,1,1
23843,descartan,0,0,1,1
23831,ಕೇಳುತ್ತಿದೆ.,0,0,1,1
23832,инициировал,0,0,1,1
23835,suède,0,0,1,1
23837,واراي,0,0,1,1
23838,ശ്രദ്ധിക്കുന്നില്ല.,0,0,1,1
23840,വിക്കിവിരുദ്ധരെ,0,0,1,1
23842,intensive,0,0,1,1
23844,voel,0,0,1,1
23828,huil,0,0,1,1
23846,வந்திருந்தார்,0,0,1,1
23848,break,0,0,1,1
23849,conjuntos,0,0,1,1
23850,ಬದಲಾಗಿದ್ದಾಳೆ.,0,0,1,1
23851,.we're,0,0,1,1
23852,vittighed,0,0,1,1
23853,gøre.,0,0,1,1
23830,الإنجليزية.,0,0,1,1
23826,εκθέτει,0,0,1,1
23856,desconcertado.,0,0,1,1
23811,compris.,0,0,1,1
23800,played,0,0,1,1
23802,büyütmek,0,0,1,1
23805,récit,0,0,1,1
23806,للمنزل؟,0,0,1,1
23808,perfection,0,0,1,1
23809,idiot.,0,0,1,1
23810,المجهولين,0,0,1,1
23812,تثار,0,0,1,1
23825,d'esprit,0,0,1,1
23813,சேர்ந்த,0,0,1,1
23814,തീരുമാനിച്ച്,0,0,1,1
23815,следующее,0,0,1,1
23818,alberto,0,0,1,1
23822,konsensussökande,0,0,1,1
23823,സ്കൂളിനെ,0,0,1,1
23824,உரிமத்திற்கு,0,0,1,1
23855,выполнять,0,0,1,1
23857,newsletters,0,0,1,1
23925,erkennen,0,0,1,1
23906,പരസ്പരബന്ധമില്ലാത്ത,0,0,1,1
23891,petition,0,0,1,1
23893,d’enseignement ,0,0,1,1
23894,manuals.,0,0,1,1
23895,celebrates,0,0,1,1
23896,pés,0,0,1,1
23898,infinie,0,0,1,1
23899,sollte.,0,0,1,1
23911,அனைவரையும்,0,0,1,1
23888,skarpaste,0,0,1,1
23912,réunis,0,0,1,1
23913,nieste,0,0,1,1
23916,لاستخدام,0,0,1,1
23918,मैली,0,0,1,1
23919,uppfarten.,0,0,1,1
23923,വ്യത്യസ്തമാവും.,0,0,1,1
23924,живая.,0,0,1,1
23890,farinha,0,0,1,1
23887,utility,0,0,1,1
23859,cavalgando,0,0,1,1
23872,obtienen,0,0,1,1
23861,gain,0,0,1,1
23866,вобрал,0,0,1,1
23867,запросы.,0,0,1,1
23868,trasfondo,0,0,1,1
23869,relatada,0,0,1,1
23870,progressive,0,0,1,1
23871,markant,0,0,1,1
23873,потрясающий.,0,0,1,1
23886,/dvd,0,0,1,1
23876,замене,0,0,1,1
23877,konuşabilir,0,0,1,1
23878,книгах,0,0,1,1
23880,opinião.,0,0,1,1
23882,يستطع,0,0,1,1
23883,மாற்றம்,0,0,1,1
23885,qualité.,0,0,1,1
23544,இடத்தை,0,0,1,1
23542,öyle,0,0,1,1
23081,protists.,0,0,1,1
23540,förbryllade,0,0,1,1
23229,பாடல்களில்,0,0,1,1
23233,ಬಳಸುತ್ತಿತ್ತು,0,0,1,1
23237,एकार्ट,0,0,1,1
23238,இருக்கிறாள்,0,0,1,1
23239,விரும்புகின்றனர்.,0,0,1,1
23242,repair.,0,0,1,1
23243,குறிப்பிடவில்லை,0,0,1,1
23244,يبتسم,0,0,1,1
23245,läste,0,0,1,1
23247,mera,0,0,1,1
23249,passede,0,0,1,1
23251,acalme-se,0,0,1,1
23252,скучно.,0,0,1,1
23253,ошибаетесь.,0,0,1,1
23255,தாயும்,0,0,1,1
23258,minnettarım.,0,0,1,1
23260,lanceret,0,0,1,1
23228,जाये।,0,0,1,1
23227,discontinued,0,0,1,1
23226,má,0,0,1,1
23212,colores,0,0,1,1
23200,erweitern,0,0,1,1
23202,concordo.,0,0,1,1
23203,μαρμελάδες.,0,0,1,1
23205,μπορείτε.,0,0,1,1
23208,fonge,0,0,1,1
23209,samentrekking,0,0,1,1
23210,ए,0,0,1,1
23213,أخطاء,0,0,1,1
23225,internetanvändarna,0,0,1,1
23214,செல்லலாம்,0,0,1,1
23215,veuillez,0,0,1,1
23216,മികച്ചതാണ്,0,0,1,1
23217,заимствовано,0,0,1,1
23218,महाकाव्य,0,0,1,1
23220,commentators,0,0,1,1
23221,हक्का,0,0,1,1
23261,συμμετέχοντες,0,0,1,1
23262,permise,0,0,1,1
23264,singular,0,0,1,1
23302,வெளியிடப்பட்டு,0,0,1,1
23295,αισθάνεστε,0,0,1,1
23296,principen,0,0,1,1
23297,nöje,0,0,1,1
23298,ويكيبيديين,0,0,1,1
23299,நிபுணர்களால்,0,0,1,1
23300,natuurlijk.,0,0,1,1
23301,способствовало,0,0,1,1
23303,νωθρός,0,0,1,1
23292,accounts,0,0,1,1
23305,пополнит,0,0,1,1
23306,आंकडा,0,0,1,1
23307,rönt,0,0,1,1
23308,geçmeniz,0,0,1,1
23309,voormalig,0,0,1,1
23311,കളയുന്നു.,0,0,1,1
23312,മനുഷ്യർക്കിടയിൽ,0,0,1,1
23294,slogan ,0,0,1,1
23291,eventually,0,0,1,1
23265,lida,0,0,1,1
23278,ifadenin,0,0,1,1
23266,stigmergic,0,0,1,1
23267,ie,0,0,1,1
23268,hög-,0,0,1,1
23269,навестить,0,0,1,1
23271,എല്ലാവരികൾക്കും,0,0,1,1
23275,onaylamadıkları,0,0,1,1
23276,yakalayamadım.,0,0,1,1
23280,lois.,0,0,1,1
23290,ناه.,0,0,1,1
23282,ചോദ്യത്തിന്,0,0,1,1
23283,nudity,0,0,1,1
23284,നടത്തുന്നതിൽ,0,0,1,1
23286,december [update],0,0,1,1
23287,അർത്ഥമില്ലാത്ത,0,0,1,1
23288,toepassing,0,0,1,1
23289,கட்டமைப்பும்,0,0,1,1
23199,​​beetje,0,0,1,1
23198,spawned,0,0,1,1
23197,urging,0,0,1,1
23129,клетками,0,0,1,1
23118,'elefante',0,0,1,1
23120,télévisée,0,0,1,1
23121,اختصار,0,0,1,1
23125,владимир,0,0,1,1
23126,بلغ,0,0,1,1
23127,admites,0,0,1,1
23128,போவது,0,0,1,1
23132,индексации,0,0,1,1
23116,milhares,0,0,1,1
23133,കൊണ്ടുവന്നിട്ടുണ്ട്,0,0,1,1
23134,tartışmanın,0,0,1,1
23136,parodiadas,0,0,1,1
23137,मैनर्स,0,0,1,1
23138,klingen,0,0,1,1
23139,bulunabilmesi,0,0,1,1
23141,uppmärksammat.,0,0,1,1
23117,salida,0,0,1,1
23115,நண்பனைப்,0,0,1,1
23143,ಟಾಪ್,0,0,1,1
23100,interesan.,0,0,1,1
23083,принес,0,0,1,1
23085,администрированию,0,0,1,1
23090,l'illustration,0,0,1,1
23091,कामों,0,0,1,1
23092,inclui,0,0,1,1
23094,رفض,0,0,1,1
23098,വളർച്ച,0,0,1,1
23101,fluid,0,0,1,1
23114,brilhantes,0,0,1,1
23103,பயன்படுத்தக்கூடாது,0,0,1,1
23104,സുന്ദരിയായിരുന്നതിനാൽ,0,0,1,1
23106,​​​​,0,0,1,1
23109,tendrás,0,0,1,1
23110,challenge,0,0,1,1
23111,നേരത്തെ,0,0,1,1
23112,approfondie,0,0,1,1
23142,пожалуйста.,0,0,1,1
23144,​​dette,0,0,1,1
23196,seng,0,0,1,1
23184,« créées,0,0,1,1
23175,توداي,0,0,1,1
23176,uitspreekt.,0,0,1,1
23177,reproduce.,0,0,1,1
23179,сбывается,0,0,1,1
23180,implement,0,0,1,1
23181,экзамене,0,0,1,1
23182,iyisi,0,0,1,1
23185,symbian-telefoner,0,0,1,1
23171,dites-leur,0,0,1,1
23187,tradução,0,0,1,1
23188,intentionnalité.,0,0,1,1
23189,ilimitado,0,0,1,1
23190,péréa,0,0,1,1
23191,anime-se.,0,0,1,1
23192,yazılmakta,0,0,1,1
23195,motivation,0,0,1,1
23174,stavet,0,0,1,1
23170,ജീവിതരേഖ,0,0,1,1
23145,upptäcktes,0,0,1,1
23156,ಹುಡುಗರನ್ನು,0,0,1,1
23146,പുഞ്ചിരിക്കാനും,0,0,1,1
23147,stoor.,0,0,1,1
23148,heterotrophic,0,0,1,1
23150,മിനുസമുള്ളതുമാണ്,0,0,1,1
23151,മാജിക്,0,0,1,1
23153,μεγάλο,0,0,1,1
23154,högtalarikon,0,0,1,1
23158,പ്രണേതാവായ,0,0,1,1
23168,vagonla,0,0,1,1
23159,bhasa,0,0,1,1
23160,الشروع,0,0,1,1
23163,russa,0,0,1,1
23164,жестокий,0,0,1,1
23165,തിരുത്തലുകൾക്കൊടുവിൽ,0,0,1,1
23166,energiedrank,0,0,1,1
23167,αντίο.,0,0,1,1
23313,spanska,0,0,1,1
23314,προβλήματα.,0,0,1,1
23316,प्रश्नों,0,0,1,1
23473,başkalarına,0,0,1,1
23465,sorrisos,0,0,1,1
23466,parliamentary,0,0,1,1
23467,இணையத்தளங்களின்,0,0,1,1
23468,goldman,0,0,1,1
23469,square,0,0,1,1
23470,rigtighed,0,0,1,1
23472,വിശ്വാസയോഗ്യമായ,0,0,1,1
23474,dürüst,0,0,1,1
23463,siffror,0,0,1,1
23477,fotoğrafları,0,0,1,1
23478,ومتوازنًا,0,0,1,1
23479,शुभकामना,0,0,1,1
23480,википедисты.,0,0,1,1
23481,yenmez,0,0,1,1
23482,الواردة,0,0,1,1
23483,सांख्यिकीय,0,0,1,1
23464,истинность»,0,0,1,1
23461,zoekmachines.,0,0,1,1
23486,σύνθημα,0,0,1,1
23446,vs,0,0,1,1
23439,первое,0,0,1,1
23440,дорогой,0,0,1,1
23441,وتحاول,0,0,1,1
23442,gratulieren,0,0,1,1
23443,akademisk,0,0,1,1
23444,d'océans,0,0,1,1
23445,некоммерческим,0,0,1,1
23447,egendom”.,0,0,1,1
23459,വിക്കിപീഡിയരിൽ,0,0,1,1
23448,энциклопедией.,0,0,1,1
23449,storbritannien,0,0,1,1
23450,मुस्कुरा,0,0,1,1
23455,ಖಾತ್ರಿಯಿಲ್ಲ.,0,0,1,1
23456,बुल्गारियाई,0,0,1,1
23457,wikipedia],0,0,1,1
23458,verrait,0,0,1,1
23485,egípcio,0,0,1,1
23487,sitter,0,0,1,1
23436,chimiste,0,0,1,1
23527,same-sex,0,0,1,1
23516,nämligen,0,0,1,1
23518,золотом,0,0,1,1
23519,вторичный,0,0,1,1
23521,langsommere,0,0,1,1
23522,штата,0,0,1,1
23523,знаешь.,0,0,1,1
23525,للبرنامج,0,0,1,1
23531,single-celled,0,0,1,1
23514,താല്പര്യമുള്ള,0,0,1,1
23532,അനുവദിക്കുക,0,0,1,1
23533,உடன்படுகிறேன்.,0,0,1,1
23534,libertine.,0,0,1,1
23535,édition,0,0,1,1
23536,customs,0,0,1,1
23537,quer.,0,0,1,1
23538,फर्स्ट,0,0,1,1
23515,endemic,0,0,1,1
23512,cosa.,0,0,1,1
23488,derhen,0,0,1,1
23499,आर्टिकल,0,0,1,1
23489,ഞങ്ങളുമായി,0,0,1,1
23491,காரணம்,0,0,1,1
23492,μοναδική,0,0,1,1
23494,கவனிக்க,0,0,1,1
23495,gedrukt,0,0,1,1
23496,airspace,0,0,1,1
23498,tanışın,0,0,1,1
23501,sustenance,0,0,1,1
23511,réparation,0,0,1,1
23502,dreng,0,0,1,1
23503,रिपोजिटरी,0,0,1,1
23504,मीटिंग,0,0,1,1
23505,गहराई,0,0,1,1
23506,நிறுவனத்தால்,0,0,1,1
23507,ಸಾಲವಾಗಿ,0,0,1,1
23510,nähe,0,0,1,1
23437,valg,0,0,1,1
23435,d'améliorer,0,0,1,1
23317,αργός.,0,0,1,1
23364,झटके,0,0,1,1
23349,spirit,0,0,1,1
23352,libertine,0,0,1,1
23353,license-നാൽ,0,0,1,1
23359,implementatie,0,0,1,1
23361,quantrill.,0,0,1,1
23362,кофе,0,0,1,1
23363,klickt.,0,0,1,1
23365,sencillez,0,0,1,1
23347,ряда,0,0,1,1
23368,paciência,0,0,1,1
23369,pourrez,0,0,1,1
23371,uncorrected,0,0,1,1
23372,ആളുകളുടെ,0,0,1,1
23373,süß,0,0,1,1
23374,grootst.,0,0,1,1
23375,வகையானது.,0,0,1,1
23348,разумность,0,0,1,1
23345,german-language,0,0,1,1
23377,المرآة,0,0,1,1
23332,kwam.,0,0,1,1
23319,«central»,0,0,1,1
23320,welkom.,0,0,1,1
23321,ವಾಸಿಸುತ್ತಿದ್ದಳು.,0,0,1,1
23322,sparqlen,0,0,1,1
23323,χίλια,0,0,1,1
23324,некоторыми,0,0,1,1
23326,argumenta,0,0,1,1
23333,kokulu,0,0,1,1
23344,interromper,0,0,1,1
23334,रही।,0,0,1,1
23335,grundtanken,0,0,1,1
23336,تقاس,0,0,1,1
23337,cent,0,0,1,1
23339,ಅದ್ಭುತವಾಗಿದ್ದೀರಿ.,0,0,1,1
23341,घंटी,0,0,1,1
23343,sofistikerad,0,0,1,1
23376,pasas,0,0,1,1
23380,probabilities,0,0,1,1
23434,وكنت,0,0,1,1
23423,definirse,0,0,1,1
23409,обозначает,0,0,1,1
23414,وجه,0,0,1,1
23415,പരാതിപ്പെടാൻ,0,0,1,1
23416,jezelf.,0,0,1,1
23418,rapazes.,0,0,1,1
23419,problematic,0,0,1,1
23420,“illegal,0,0,1,1
23425,استمع,0,0,1,1
23405,plazo,0,0,1,1
23427,χαμογελούν,0,0,1,1
23428,aplicado,0,0,1,1
23429,வலைப்பக்க,0,0,1,1
23430,المتضاربين،,0,0,1,1
23431,starka,0,0,1,1
23432,ಕರೆ,0,0,1,1
23433,ഉപയോഗിക്കാം,0,0,1,1
23407,hospedagem,0,0,1,1
23404,മുങ്ങാം,0,0,1,1
23382,indrømmer,0,0,1,1
23392,escuchar,0,0,1,1
23383,بل,0,0,1,1
23386,confuse,0,0,1,1
23387,успеха,0,0,1,1
23388,ಮಾತನಾಡುವ,0,0,1,1
23389,amper,0,0,1,1
23390,بنظام,0,0,1,1
23391,πολύ.,0,0,1,1
23393,لأن.,0,0,1,1
23403,weiteren,0,0,1,1
23394,registados,0,0,1,1
23396,destinados,0,0,1,1
23397,decidir,0,0,1,1
23398,grise,0,0,1,1
23400,ക്ഷീണം,0,0,1,1
23401,scientist,0,0,1,1
23402,έναρξη.,0,0,1,1
22085,നൽകുന്നു.,0,0,1,1
22082,erkläre,0,0,1,1
20142,neus,0,0,1,1
20651,ശ്രദ്ധിക്കുന്നവർ,0,0,1,1
20817,கட்டுரைகளைப்,0,0,1,1
20818,lokala,0,0,1,1
20820,फ़िजी,0,0,1,1
20822,n'as,0,0,1,1
20823,അവൾക്കറിയാമോ,0,0,1,1
20825,l'intitulé,0,0,1,1
20826,قريبًا,0,0,1,1
20828,mineral,0,0,1,1
20830,தடுக்கப்படுவதோடு,0,0,1,1
20832,ലേഖനങ്ങളായി.,0,0,1,1
20834,clusters.,0,0,1,1
20835,onvoldoende,0,0,1,1
20837,kritiseret,0,0,1,1
20838,frågor.,0,0,1,1
20839,управлялась,0,0,1,1
20840,paylaşılmaktadır.,0,0,1,1
20841,apprentissage.,0,0,1,1
20816,الخصوص،,0,0,1,1
20814,eigenen,0,0,1,1
20812,ഡബ്ല്യു.,0,0,1,1
20801,geroepen.,0,0,1,1
20788,hadn't,0,0,1,1
20790,encyclo.nl.,0,0,1,1
20791,പാകിസ്താൻ,0,0,1,1
20792,وسلبيًا,0,0,1,1
20798,دليل,0,0,1,1
20799,glauben,0,0,1,1
20800,differing,0,0,1,1
20802,begränsades,0,0,1,1
20811,moverse,0,0,1,1
20804,nica en,0,0,1,1
20805,ألذ,0,0,1,1
20806,högskolekurser,0,0,1,1
20807,termes ,0,0,1,1
20808,uge,0,0,1,1
20809,λίγες,0,0,1,1
20810,способов,0,0,1,1
20843,consideram-se,0,0,1,1
20845,வாங்கிய,0,0,1,1
20846,habitants,0,0,1,1
20892,dehşet,0,0,1,1
20881,έσπασαν,0,0,1,1
20884,pesos,0,0,1,1
20886,புரிந்துகொண்டிருந்தால்,0,0,1,1
20887,காதலன்,0,0,1,1
20888,grouping,0,0,1,1
20889,tutuklular,0,0,1,1
20891,இணையானது.,0,0,1,1
20895,വെളിപ്പെടുത്തുന്നു,0,0,1,1
20879,tonfalls.,0,0,1,1
20896,rundgång,0,0,1,1
20899,mammals.,0,0,1,1
20900,مقابل,0,0,1,1
20901,प्रोटेस्टर,0,0,1,1
20902,comum,0,0,1,1
20904,usaría,0,0,1,1
20905,filled,0,0,1,1
20880,ಮಾಡಬೇಕು.,0,0,1,1
20878,scruté,0,0,1,1
20848,valt.,0,0,1,1
20861,çaba,0,0,1,1
20849,dr.,0,0,1,1
20850,imagina».,0,0,1,1
20851,d'objets,0,0,1,1
20852,därigenom,0,0,1,1
20853,கொண்டிருந்தால்,0,0,1,1
20857,discrètes,0,0,1,1
20860,ppt.,0,0,1,1
20863,مشروعا,0,0,1,1
20876,alegam,0,0,1,1
20865,kanalıma,0,0,1,1
20868,gosta.,0,0,1,1
20869,надёжным,0,0,1,1
20870,நுபீடியாவும்,0,0,1,1
20871,закрыть,0,0,1,1
20874,пределы,0,0,1,1
20875,emphase,0,0,1,1
20786,قابلة,0,0,1,1
20784,അനുസരിച്ച്,0,0,1,1
20783,program.,0,0,1,1
20696,uspiselig,0,0,1,1
20683,sentar,0,0,1,1
20684,listou,0,0,1,1
20685,ರುಚಿಯ,0,0,1,1
20686,présentation,0,0,1,1
20690,прямую,0,0,1,1
20692,ಸಂಭಾಷಣೆಯನ್ನು,0,0,1,1
20694,confiera,0,0,1,1
20697,l'analyse.,0,0,1,1
20681,студентов,0,0,1,1
20699,conectados,0,0,1,1
20701,நிறுத்தினோம்,0,0,1,1
20702,நாட்டிற்கு,0,0,1,1
20703,ausgeglichen,0,0,1,1
20704,foi.,0,0,1,1
20705,força,0,0,1,1
20709,speakers,0,0,1,1
20682,biz,0,0,1,1
20680,bloquaient,0,0,1,1
20711,wikimed.,0,0,1,1
20664,fehlern,0,0,1,1
20653,sauvegardes,0,0,1,1
20654,объектом,0,0,1,1
20659,μπορούσαν,0,0,1,1
20660,[ˌwɪkiˈpiːdiə] ,0,0,1,1
20661,jehová,0,0,1,1
20662,эпизодах,0,0,1,1
20663,narret,0,0,1,1
20665,olmadığı,0,0,1,1
20674,традиционным,0,0,1,1
20666,முறையே,0,0,1,1
20667,eb.,0,0,1,1
20668,ناحية,0,0,1,1
20669,testimde,0,0,1,1
20670,குழப்பிவிட்டேன்,0,0,1,1
20671,sommeil,0,0,1,1
20673,والمحللون,0,0,1,1
20710,ഭാ‍ഷകളിലെ,0,0,1,1
20714,trustees.,0,0,1,1
20782,d'internet »,0,0,1,1
20768,site's,0,0,1,1
20754,modèles,0,0,1,1
20755,включения,0,0,1,1
20757,yapılmaktadır.,0,0,1,1
20760,ವೇಗದಲ್ಲಿರಲು.,0,0,1,1
20761,ljudet,0,0,1,1
20762,κάνετε.,0,0,1,1
20764,വിഷയത്തിൽ,0,0,1,1
20769,comportementaux,0,0,1,1
20752,θέματος.,0,0,1,1
20770,erróneos,0,0,1,1
20771,കാമ്പ്,0,0,1,1
20772,exceptionnellement,0,0,1,1
20773,meinungen.,0,0,1,1
20776,känsliga,0,0,1,1
20778,മൊത്തത്തിൽ,0,0,1,1
20779,'alterações,0,0,1,1
20753,deductief.,0,0,1,1
20751,marionetter.,0,0,1,1
20716,छोटा,0,0,1,1
20731,लिखने,0,0,1,1
20718,வந்து,0,0,1,1
20719,foulée,0,0,1,1
20722,ba,0,0,1,1
20724,gibiler,0,0,1,1
20727,trafic »,0,0,1,1
20728,yeah,0,0,1,1
20729,определённое,0,0,1,1
20733,культурных,0,0,1,1
20750,tijdlang,0,0,1,1
20735,बेस्ट,0,0,1,1
20737,hoe',0,0,1,1
20738,visite,0,0,1,1
20743,признана.,0,0,1,1
20744,none,0,0,1,1
20745,ചെയ്യുന്നതിലൂടെയാണ്,0,0,1,1
20746,منفرجًا,0,0,1,1
20906,agents,0,0,1,1
20907,хеллером,0,0,1,1
20910,விருந்தில்,0,0,1,1
21066,perfekte,0,0,1,1
21059,പ്രവർത്തിക്കുന്നില്ലെങ്കിൽ,0,0,1,1
21060,gekümmert,0,0,1,1
21061,بالأحجار,0,0,1,1
21062,शैक्षणिक,0,0,1,1
21063,ಒತ್ತಿ,0,0,1,1
21064,vermeld,0,0,1,1
21065,implementación,0,0,1,1
21067,മാറ്റിനിർത്തി,0,0,1,1
21056,ædelstene,0,0,1,1
21068,fusion,0,0,1,1
21069,ಎಲ್ಲರೂ,0,0,1,1
21070,birbirinden,0,0,1,1
21071,இரு.,0,0,1,1
21073,шекманом,0,0,1,1
21074,prinsen,0,0,1,1
21075,batholiths,0,0,1,1
21058,وأطلقت,0,0,1,1
21055,التلاعب,0,0,1,1
21078,وضعك,0,0,1,1
21043,tekrarı,0,0,1,1
21035,ദേഷ്യപ്പെടുന്നുവെന്നത്,0,0,1,1
21036,aufgewacht,0,0,1,1
21037,tarihin,0,0,1,1
21038,forhåbentlig,0,0,1,1
21039,ಬಳಸುತ್ತೀರಿ.,0,0,1,1
21040,കൊണ്ടുവരട്ടെ.,0,0,1,1
21042,рассказала,0,0,1,1
21044,forståelige,0,0,1,1
21053,engelskspråkig,0,0,1,1
21045,gidiyor.,0,0,1,1
21046,rill,0,0,1,1
21047,postagens,0,0,1,1
21048,fortunes,0,0,1,1
21049,डाला,0,0,1,1
21050,esclarecido,0,0,1,1
21051,beobachtete,0,0,1,1
21076,'we,0,0,1,1
21079,упоминающимся,0,0,1,1
21032,डॉलर,0,0,1,1
21129,ನೀಡುತ್ತಿದೆ.,0,0,1,1
21121,suivis,0,0,1,1
21122,seawater,0,0,1,1
21123,papers,0,0,1,1
21124,excelente,0,0,1,1
21126,ഉപ്പ്,0,0,1,1
21127,उठाया।,0,0,1,1
21128,l'armée,0,0,1,1
21130,полагается,0,0,1,1
21119,μαριόν.,0,0,1,1
21131,fokuseret,0,0,1,1
21132,« jouer »,0,0,1,1
21135,அலெக்சா,0,0,1,1
21136,goals,0,0,1,1
21137,success.,0,0,1,1
21138,pourront,0,0,1,1
21139,വിലയിരുത്തപ്പെട്ട,0,0,1,1
21120,سجلت,0,0,1,1
21110,einschließlich,0,0,1,1
21080,duydum,0,0,1,1
21096,répartissent,0,0,1,1
21087,inondation,0,0,1,1
21088,objeto,0,0,1,1
21089,вики-проектами.,0,0,1,1
21090,yaşardı.,0,0,1,1
21091,βαρετό.,0,0,1,1
21094,областях,0,0,1,1
21095,मॉम,0,0,1,1
21097,التعليم,0,0,1,1
21109,fejl.,0,0,1,1
21100,συμφωνώ.,0,0,1,1
21103,തിരഞ്ഞെടുത്ത്,0,0,1,1
21104,« chaque,0,0,1,1
21105,upprörda,0,0,1,1
21106,ಗೊಂದಲಕ್ಕೊಳಗಾದವು,0,0,1,1
21107,därefter,0,0,1,1
21108,ನಯವಾಗಿ,0,0,1,1
21033,ξεκινήσουμε.,0,0,1,1
21030,अनुमति।,0,0,1,1
20912,πόλη.,0,0,1,1
20951,minuter,0,0,1,1
20941,hayal,0,0,1,1
20942,ciddiye,0,0,1,1
20944,والدينية.,0,0,1,1
20945,ferais-je,0,0,1,1
20946,έσπασε,0,0,1,1
20947,അനുഭവപ്പെട്ടേക്കാം,0,0,1,1
20950,huvudstad,0,0,1,1
20953,jesucristo,0,0,1,1
20939,ходим,0,0,1,1
20954,assunto.,0,0,1,1
20955,വിക്കിപീഡിയക്ക്,0,0,1,1
20956,ಡಿಗ್ರಿಗಿಂತ,0,0,1,1
20960,approprié,0,0,1,1
20962,reverrais,0,0,1,1
20965,crude,0,0,1,1
20967,ورمز,0,0,1,1
20940,जोनाथन,0,0,1,1
20938,лидер,0,0,1,1
20969,cuyo,0,0,1,1
20924,पुस्तकालय,0,0,1,1
20913,tomber,0,0,1,1
20916,abrazar,0,0,1,1
20918,कज़ाख़,0,0,1,1
20919,syntaxe,0,0,1,1
20921,heimlich,0,0,1,1
20922,متاحًا,0,0,1,1
20923,extend,0,0,1,1
20925,أدناه,0,0,1,1
20937,gegenteil.,0,0,1,1
20927,d'algorithmes,0,0,1,1
20928,tillåts,0,0,1,1
20932,divin,0,0,1,1
20933,عطس,0,0,1,1
20934,anunciou,0,0,1,1
20935,نشأتها,0,0,1,1
20936,bloodthirsty,0,0,1,1
20968,présentées,0,0,1,1
20970,пародируются,0,0,1,1
21029,تحسَن,0,0,1,1
21015,liking,0,0,1,1
21005,popularisés,0,0,1,1
21006,browser,0,0,1,1
21007,സ്വരം,0,0,1,1
21011,ഗെയിം,0,0,1,1
21012,столько,0,0,1,1
21013,செயற்பாடு’,0,0,1,1
21014,യു,0,0,1,1
21016,konservativa,0,0,1,1
21003,بمثل,0,0,1,1
21017,lustigen,0,0,1,1
21018,betecknar,0,0,1,1
21019,lassen.,0,0,1,1
21020,αυτού,0,0,1,1
21021,databases,0,0,1,1
21026,серверные,0,0,1,1
21027,çoğunluğu,0,0,1,1
21004,compactamiento,0,0,1,1
21001,weitergab.,0,0,1,1
20973,മാലാഖയാണ്,0,0,1,1
20984,triplicado.,0,0,1,1
20974,chartier,0,0,1,1
20976,जीटरेन,0,0,1,1
20977,المعتاد,0,0,1,1
20978,തിരുത്താൻ,0,0,1,1
20979,fournies,0,0,1,1
20982,ederken,0,0,1,1
20983,explicitement,0,0,1,1
20987,ಬಯಸಿದ,0,0,1,1
21000,കണ്ടെത്തിയ,0,0,1,1
20989,bulundurur,0,0,1,1
20990,വൈകുന്നേരം.,0,0,1,1
20991,добавлять,0,0,1,1
20993,trouxe,0,0,1,1
20995,hp,0,0,1,1
20997,ഭാഗ്യം,0,0,1,1
20999,directmedia,0,0,1,1
20652,tendrá,0,0,1,1
20650,ونحتاج,0,0,1,1
21141,admiración,0,0,1,1
20649,objectsthe,0,0,1,1
20296,पकड़ते,0,0,1,1
20299,минимизировать,0,0,1,1
20301,என்பவர்,0,0,1,1
20302,إخبارهم,0,0,1,1
20305,forskaren,0,0,1,1
20314,üretilen,0,0,1,1
20315,«кто,0,0,1,1
20316,leider,0,0,1,1
20319,பயனுள்ள,0,0,1,1
20320,saknas.,0,0,1,1
20322,conclusion,0,0,1,1
20325,κατάλληλο,0,0,1,1
20326,обнять,0,0,1,1
20328,nouvel,0,0,1,1
20329,mediantid,0,0,1,1
20330,أعرفها,0,0,1,1
20331,behövs,0,0,1,1
20295,τέλος.,0,0,1,1
20292,मास्टर,0,0,1,1
20289,fastest,0,0,1,1
20275,செய்து.,0,0,1,1
20265,авторского,0,0,1,1
20266,δάχτυλά,0,0,1,1
20267,grubudur,0,0,1,1
20270,aristotélicienne,0,0,1,1
20271,faktamässigt,0,0,1,1
20272,كتابه,0,0,1,1
20274,വഷളായി.,0,0,1,1
20277,സ്തംഭിച്ചുപോകുന്നത്,0,0,1,1
20288,ಪ್ರಾರಂಭಿಸಿದಳು.,0,0,1,1
20279,دانيال,0,0,1,1
20280,pouviez,0,0,1,1
20281,كذباً,0,0,1,1
20282,أحببت,0,0,1,1
20284,mødested,0,0,1,1
20285,zitten,0,0,1,1
20287,колонке,0,0,1,1
20332,κυρίες,0,0,1,1
20333,അതിനടുത്തുള്ള,0,0,1,1
20334,قانونين,0,0,1,1
20383,propriétaire.,0,0,1,1
20374,ശബ്ദമാണ്.,0,0,1,1
20375,hur.,0,0,1,1
20376,spejlet,0,0,1,1
20377,tamam,0,0,1,1
20379,зол,0,0,1,1
20380,skrevet,0,0,1,1
20382,காட்டவும்,0,0,1,1
20384,बिन्दु,0,0,1,1
20369,conseguirás,0,0,1,1
20386,anticlaudianus,0,0,1,1
20387,bildbank,0,0,1,1
20388,σκληρός,0,0,1,1
20389,മുന്നിൽ,0,0,1,1
20390,einzige,0,0,1,1
20392,lättare,0,0,1,1
20393,inblick,0,0,1,1
20371,hänga,0,0,1,1
20368,носители,0,0,1,1
20336,നിങ്ങൾക്കാവശ്യമുള്ളതെന്തും,0,0,1,1
20348,wii.,0,0,1,1
20338,स्कॉट्स,0,0,1,1
20339,peso,0,0,1,1
20342,collège,0,0,1,1
20343,मालागासे,0,0,1,1
20344,மேலதிகமாக,0,0,1,1
20345,ولاحقًا,0,0,1,1
20347,இதனைப்,0,0,1,1
20349,озаглавленная,0,0,1,1
20367,нарцисе,0,0,1,1
20353,ciencia,0,0,1,1
20355,wikipediametadata,0,0,1,1
20358,olduğuydu,0,0,1,1
20359,بدت,0,0,1,1
20361,ലഭിക്കാത്ത,0,0,1,1
20363,desconcertaron.,0,0,1,1
20366,लक्ष्य,0,0,1,1
20264,challenging,0,0,1,1
20263,vinklad,0,0,1,1
20262,टोंगीयाई,0,0,1,1
20186,kopiëren,0,0,1,1
20174,valenciana,0,0,1,1
20175,hieronder.,0,0,1,1
20177,teria,0,0,1,1
20178,‎/ˌwɪkiˈpidi.ə/‏,0,0,1,1
20181,« conservation,0,0,1,1
20182,بقليل,0,0,1,1
20183,güvenilebilirliği,0,0,1,1
20187,пропустить,0,0,1,1
20170,சலவை,0,0,1,1
20188,ehrlich,0,0,1,1
20189,sömnen,0,0,1,1
20190,subversivos,0,0,1,1
20192,терминами,0,0,1,1
20193,alemanha,0,0,1,1
20194,wegwerken,0,0,1,1
20196,yazın,0,0,1,1
20172,συλλογή,0,0,1,1
20168,slarvar,0,0,1,1
20199,спрашивал,0,0,1,1
20154,version.,0,0,1,1
20143,förhindrat,0,0,1,1
20144,waray-waray,0,0,1,1
20146,foucault,0,0,1,1
20148,σχολιάζοντας,0,0,1,1
20149,നല്ലവനാണ്,0,0,1,1
20150,rules”,0,0,1,1
20151,അതിനർ‌ത്ഥം,0,0,1,1
20155,subdomínio,0,0,1,1
20167,لتخريب,0,0,1,1
20157,நெரிசல்கள்,0,0,1,1
20158,bidra.,0,0,1,1
20159,wअज़रबैजानी,0,0,1,1
20160,bruger.,0,0,1,1
20164,chartes,0,0,1,1
20165,commençait,0,0,1,1
20166,accomplish,0,0,1,1
20198,விரும்புகிறாள்,0,0,1,1
20200,تهدئة,0,0,1,1
20261,βάλτου,0,0,1,1
20244,себя.,0,0,1,1
20230,sucedido,0,0,1,1
20233,vergissen.,0,0,1,1
20234,работ,0,0,1,1
20236,aumentando,0,0,1,1
20237,vertrekken,0,0,1,1
20240,pouvez.,0,0,1,1
20241,favoriser,0,0,1,1
20248,ಬೇಡವೆಂದು,0,0,1,1
20227,échappé,0,0,1,1
20249,retrata,0,0,1,1
20250,privilégios,0,0,1,1
20253,предложено,0,0,1,1
20254,dame,0,0,1,1
20258,базы,0,0,1,1
20259,തണുത്തവരായിരിക്കാൻ,0,0,1,1
20260,specifiek,0,0,1,1
20228,പദ്ധതിയിടുന്നു,0,0,1,1
20226,lacked,0,0,1,1
20201,ambas,0,0,1,1
20210,.º.,0,0,1,1
20203,वापस,0,0,1,1
20204,ಚಾನಲ್,0,0,1,1
20205,будущая,0,0,1,1
20206,புத்தகத்தைப்,0,0,1,1
20207,arwid,0,0,1,1
20208,പരിശീലനം,0,0,1,1
20209,رخصة,0,0,1,1
20211,affirmé,0,0,1,1
20224,interessiert.,0,0,1,1
20213,πρόβλημα.,0,0,1,1
20215,replicadas,0,0,1,1
20216,بالخارج,0,0,1,1
20217,planlıyorum,0,0,1,1
20221,uppslagsverket.,0,0,1,1
20222,escuchando.,0,0,1,1
20223,ακόμα,0,0,1,1
20395,wütend.,0,0,1,1
20396,ποιότητας,0,0,1,1
20399,ഒരോ,0,0,1,1
20569,personuppgifter,0,0,1,1
20561,ഭക്ഷണങ്ങൾ,0,0,1,1
20562,ತಿಳಿದಿರುವ,0,0,1,1
20564,imaginez,0,0,1,1
20565,मिनटों,0,0,1,1
20566,обобщением,0,0,1,1
20567,prego,0,0,1,1
20568,телефонного,0,0,1,1
20571,ചുട്ടെടുക്കാൻ,0,0,1,1
20559,запущенная,0,0,1,1
20572,его.,0,0,1,1
20575,subtiele,0,0,1,1
20578,ദിവസമാണെന്ന്,0,0,1,1
20579,ágil,0,0,1,1
20580,göreceksiniz.,0,0,1,1
20583,نتعلم,0,0,1,1
20584,catalane,0,0,1,1
20560,கொள்கைக்கு,0,0,1,1
20558,manche,0,0,1,1
20589,रेटिंग्स,0,0,1,1
20545,பார்க்கிறேன்,0,0,1,1
20530,അനുവദിക്കുന്നുണ്ട്.,0,0,1,1
20532,इंतजार,0,0,1,1
20537,dim-witted,0,0,1,1
20538,ενθαρρύνεις,0,0,1,1
20541,représentant,0,0,1,1
20542,perfectionnement,0,0,1,1
20544,признана,0,0,1,1
20546,मधुर,0,0,1,1
20556,بأمان,0,0,1,1
20547,beweringen.,0,0,1,1
20548,புன்னகைக்கிறாள்,0,0,1,1
20549,स्वीडिश,0,0,1,1
20550,nossas,0,0,1,1
20551,üyelik,0,0,1,1
20552,sujet[b].,0,0,1,1
20555,പദങ്ങൾ‌,0,0,1,1
20587,personalizar,0,0,1,1
20590,karıştırmak,0,0,1,1
20527,ठहराते,0,0,1,1
20636,محل,0,0,1,1
20627,ajustes,0,0,1,1
20628,заморожен.,0,0,1,1
20629,egoist,0,0,1,1
20630,partition,0,0,1,1
20632,frågetecken.,0,0,1,1
20634,vinkling,0,0,1,1
20635,secretos'.,0,0,1,1
20638,имея,0,0,1,1
20623,consist,0,0,1,1
20640,مصطلح,0,0,1,1
20641,تميل,0,0,1,1
20642,использовался,0,0,1,1
20644,ಮಾಡಿಲ್ಲ.,0,0,1,1
20645,διακόπτει,0,0,1,1
20647,hæng,0,0,1,1
20648,диска.,0,0,1,1
20624,लॉ,0,0,1,1
20622,птицы,0,0,1,1
20591,immuables ,0,0,1,1
20605,എന്നൊക്കെ,0,0,1,1
20593,klädkänsla,0,0,1,1
20596,moderering,0,0,1,1
20597,cotidiana.,0,0,1,1
20599,coolt.,0,0,1,1
20601,السرعة،,0,0,1,1
20602,taber,0,0,1,1
20604,appeared,0,0,1,1
20606,augen.,0,0,1,1
20619,newer,0,0,1,1
20607,குறிக்க,0,0,1,1
20610,ಸಹಾಯಕ್ಕಾಗಿ,0,0,1,1
20611,participar.,0,0,1,1
20612,görünecek,0,0,1,1
20614,wachten.,0,0,1,1
20615,الزمرد,0,0,1,1
20616,நுட்பக்,0,0,1,1
20529,утром,0,0,1,1
20526,exceptionsmost,0,0,1,1
20400,बताओ।,0,0,1,1
20442,കൊണ്ടാണ്,0,0,1,1
20433,occupé.,0,0,1,1
20434,கனவு.,0,0,1,1
20436,внимания,0,0,1,1
20437,день».,0,0,1,1
20438,عدت,0,0,1,1
20439,historiadores,0,0,1,1
20440,മധുരമുള്ളതുമായ,0,0,1,1
20445,जाकर,0,0,1,1
20431,estoniano,0,0,1,1
20446,hoge,0,0,1,1
20447,என்னுடன்,0,0,1,1
20449,supermarkets.,0,0,1,1
20450,journalistes,0,0,1,1
20456,lcs,0,0,1,1
20457,لمشروع,0,0,1,1
20459,utilisait,0,0,1,1
20432,non-probabilistic,0,0,1,1
20429,ചെറുതും,0,0,1,1
20463,ಪರಿಣಾಮವನ್ನು,0,0,1,1
20414,приложений[источник,0,0,1,1
20406,k-fold-cross-validation,0,0,1,1
20407,വൃദ്ധനായ,0,0,1,1
20408,विशेषाधिकृत,0,0,1,1
20409,собака,0,0,1,1
20410,skeçler,0,0,1,1
20411,masiva».,0,0,1,1
20412,кэша,0,0,1,1
20416,launched.,0,0,1,1
20427,how.,0,0,1,1
20417,ಬರಲಿದೆ,0,0,1,1
20418,முயற்சிக்கவும்,0,0,1,1
20419,kendileri,0,0,1,1
20421,paraît,0,0,1,1
20423,weerlegging,0,0,1,1
20424,செல்லத்,0,0,1,1
20425,recurre,0,0,1,1
20460,vrijwel,0,0,1,1
20466,begejstrede,0,0,1,1
20525,enenciclopedia,0,0,1,1
20512,науке,0,0,1,1
20501,vergisst,0,0,1,1
20502,сославшись,0,0,1,1
20504,كونغرس,0,0,1,1
20505,schwierigkeiten,0,0,1,1
20507,والسلوك,0,0,1,1
20510,circulando,0,0,1,1
20511,poses,0,0,1,1
20514,والأفضل,0,0,1,1
20499,sket,0,0,1,1
20515,നല്ലവരായിരിക്കുക,0,0,1,1
20516,ठोक,0,0,1,1
20517,mueves,0,0,1,1
20518,लेखन,0,0,1,1
20522,pegue,0,0,1,1
20523,mest.,0,0,1,1
20524,мы',0,0,1,1
20500,haphazard,0,0,1,1
20498,administrativos,0,0,1,1
20467,പോകുന്നു.,0,0,1,1
20479,запросу,0,0,1,1
20469,implicações,0,0,1,1
20470,typique,0,0,1,1
20471,minuscule,0,0,1,1
20472,zoet,0,0,1,1
20473,''dare,0,0,1,1
20477,identifies,0,0,1,1
20478,bred,0,0,1,1
20480,çarpıcı,0,0,1,1
20496,zenginliği,0,0,1,1
20485,enfade,0,0,1,1
20487,социологическое,0,0,1,1
20489,lyngfelt,0,0,1,1
20490,المستقلة,0,0,1,1
20491,saladas,0,0,1,1
20493,i̇yiyim,0,0,1,1
20495,സ്രോതസ്സുകളെയും,0,0,1,1
21140,l'appelle,0,0,1,1
21142,بثبات,0,0,1,1
22081,विकिस्केनर,0,0,1,1
21602,участника,0,0,1,1
21755,traeré,0,0,1,1
21756,crenças,0,0,1,1
21757,പലപ്പൊഴും,0,0,1,1
21759,half-truth,0,0,1,1
21761,மொழிக்,0,0,1,1
21762,எல்லி,0,0,1,1
21763,أعارض.,0,0,1,1
21764,ಲಿಂಕ್,0,0,1,1
21765,എഴുതപ്പെടുന്നത്.,0,0,1,1
21766,ഒരാൾക്ക്,0,0,1,1
21767,locura».,0,0,1,1
21769,suriname,0,0,1,1
21770,престижны,0,0,1,1
21771,вышло,0,0,1,1
21772,minimizing,0,0,1,1
21774,χρησιμοποιηθούν,0,0,1,1
21776,υποθέστε,0,0,1,1
21754,agente,0,0,1,1
21751,obscur,0,0,1,1
21749,जोसेफ,0,0,1,1
21734,højttalerikon,0,0,1,1
21722,рубиновое,0,0,1,1
21723,البريد,0,0,1,1
21726,französische,0,0,1,1
21727,исходят,0,0,1,1
21729,يظنون,0,0,1,1
21730,ministère,0,0,1,1
21732,கிடைத்தால்,0,0,1,1
21737,expliquez,0,0,1,1
21747,enriquecedor,0,0,1,1
21739,welcome,0,0,1,1
21740,complaint,0,0,1,1
21741,лет.,0,0,1,1
21742,предыдущее,0,0,1,1
21744,точный,0,0,1,1
21745,языке».,0,0,1,1
21746,mei,0,0,1,1
21777,forskningsartiklar.,0,0,1,1
21780,bidragsgivarna,0,0,1,1
21781,الاحتفاظ,0,0,1,1
21826,специалистами,0,0,1,1
21818,nummer.,0,0,1,1
21819,bulunmaktadır.,0,0,1,1
21821,d'adn ,0,0,1,1
21822,plug,0,0,1,1
21823,dispyter,0,0,1,1
21824,ரொட்டியில்,0,0,1,1
21825,कर।,0,0,1,1
21827,sürükleyebilir,0,0,1,1
21816,feitas.,0,0,1,1
21828,cömert,0,0,1,1
21829,alleviate,0,0,1,1
21830,копии,0,0,1,1
21831,removing,0,0,1,1
21832,ഓർമ്മിപ്പിക്കാൻ,0,0,1,1
21833,anoche,0,0,1,1
21834,पकड़,0,0,1,1
21817,décrivant,0,0,1,1
21815,zh •,0,0,1,1
21787,ಸ್ನೇಹಿತನನ್ನು,0,0,1,1
21798,kunst.,0,0,1,1
21788,مركبة,0,0,1,1
21789,effrayé,0,0,1,1
21790,grob,0,0,1,1
21794,सर्विस,0,0,1,1
21795,we've,0,0,1,1
21796,« vigilance,0,0,1,1
21797,rappelle,0,0,1,1
21801,ಬಂದ,0,0,1,1
21814,നടത്തുന്നത്.,0,0,1,1
21802,privilegiadas.,0,0,1,1
21803,groeien,0,0,1,1
21805,discourages,0,0,1,1
21806,ಮಹಾಯುದ್ಧದ,0,0,1,1
21808,biophysique,0,0,1,1
21809,посмотрел,0,0,1,1
21812,oğlum,0,0,1,1
21721,النظام،,0,0,1,1
21720,மனச்சார்பு,0,0,1,1
21718,iniciada,0,0,1,1
21641,próprias,0,0,1,1
21628,hatten,0,0,1,1
21630,specialevenemang,0,0,1,1
21632,olman,0,0,1,1
21635,கடனைப்,0,0,1,1
21636,तमिल,0,0,1,1
21639,dénuées,0,0,1,1
21640,«очень,0,0,1,1
21642,λατινική,0,0,1,1
21626,வாழ்க்கையைப்,0,0,1,1
21643,نرسيسا,0,0,1,1
21645,vieil,0,0,1,1
21648,biotechnologies,0,0,1,1
21649,dolarımı,0,0,1,1
21650,основными,0,0,1,1
21653,முடிவு,0,0,1,1
21654,ಕೃತ್ಯವನ್ನು,0,0,1,1
21627,подготовился,0,0,1,1
21624,പ്രവർത്തിച്ചാണ്,0,0,1,1
21656,tratamiento,0,0,1,1
21614,betrouwbaar,0,0,1,1
21605,ذاهب,0,0,1,1
21606,താക്കീതു,0,0,1,1
21607,impact.,0,0,1,1
21608,हैं।अमेरिकी,0,0,1,1
21609,товарный,0,0,1,1
21611,preserving,0,0,1,1
21613,skönheten.,0,0,1,1
21615,narsisizm,0,0,1,1
21623,transação,0,0,1,1
21616,sabrosas,0,0,1,1
21617,ekleyerek,0,0,1,1
21618,competitor,0,0,1,1
21619,exceptions.,0,0,1,1
21620,inräknade,0,0,1,1
21621,af •,0,0,1,1
21622,apologies.,0,0,1,1
21655,வழங்கியதற்கு,0,0,1,1
21659,natuurwetenschap,0,0,1,1
21715,soto ,0,0,1,1
21702,கண்கள்,0,0,1,1
21692,detecting,0,0,1,1
21693,δούμε,0,0,1,1
21694,مجهود,0,0,1,1
21695,organise,0,0,1,1
21696,сэнгеру,0,0,1,1
21697,запрещённых,0,0,1,1
21698,si.,0,0,1,1
21703,design,0,0,1,1
21687,جزيلاً,0,0,1,1
21706,нашу,0,0,1,1
21707,microscopic,0,0,1,1
21708,വശമാണ്.,0,0,1,1
21709,yapıyorum,0,0,1,1
21710,общественном,0,0,1,1
21712,fantaisistes.,0,0,1,1
21714,الشرفة,0,0,1,1
21691,издателями,0,0,1,1
21686,ജീവനുള്ളവളായിരുന്നുവെന്ന്,0,0,1,1
21660,остальная,0,0,1,1
21671,trouwen.,0,0,1,1
21661,nécessitent,0,0,1,1
21662,लायब्रेरी,0,0,1,1
21663,nanotechnologies,0,0,1,1
21665,χαίρομαι,0,0,1,1
21666,shapes,0,0,1,1
21668,telaffuz,0,0,1,1
21669,प्राथमिकता,0,0,1,1
21674,അതിനു,0,0,1,1
21684,ακόμη,0,0,1,1
21675,malı,0,0,1,1
21676,medir,0,0,1,1
21677,beskrive,0,0,1,1
21678,κέρδισε,0,0,1,1
21680,yazdıklarını,0,0,1,1
21682,bekendste,0,0,1,1
21683,representam,0,0,1,1
21836,सकारात्मक,0,0,1,1
21838,cuja,0,0,1,1
21839,ಕೂಡ.,0,0,1,1
22008,تُعرف,0,0,1,1
21996,appreciate,0,0,1,1
21998,writing[clarification,0,0,1,1
22000,культуре,0,0,1,1
22002,«циркуляре,0,0,1,1
22005,interesa.,0,0,1,1
22006,présidentielle,0,0,1,1
22007,paso,0,0,1,1
22009,тонет,0,0,1,1
21993,школы,0,0,1,1
22012,колледжа,0,0,1,1
22013,später.,0,0,1,1
22015,വാങ്ങിയ,0,0,1,1
22018,ಆಸಕ್ತಿಯಿಲ್ಲ.,0,0,1,1
22023,പ്രാധാന്യം,0,0,1,1
22024,положительных,0,0,1,1
22025,humide,0,0,1,1
21995,рассказывалось,0,0,1,1
21991,exciting,0,0,1,1
22029,नवीन,0,0,1,1
21978,oluşur.,0,0,1,1
21966,l'ouvrage,0,0,1,1
21967,स्लोवेनियाई,0,0,1,1
21969,ниже.,0,0,1,1
21971,enfrenta,0,0,1,1
21972,дворце,0,0,1,1
21973,bröllopsklänning,0,0,1,1
21977,നല്ലത്.,0,0,1,1
21979,erwähnt,0,0,1,1
21990,item's,0,0,1,1
21980,विकिसूक्ति,0,0,1,1
21982,plasma,0,0,1,1
21984,censorship,0,0,1,1
21985,βρώσιμο,0,0,1,1
21986,кругу,0,0,1,1
21987,besançon,0,0,1,1
21988,dijera,0,0,1,1
22028,составляла,0,0,1,1
22030,журналом,0,0,1,1
21964,ipucunu,0,0,1,1
22069,begrijpen.,0,0,1,1
22061,സംരക്ഷിക്കാൻ,0,0,1,1
22062,ಮಾಡುತ್ತೀರಾ,0,0,1,1
22063,പരിശീലിപ്പിക്കാൻ,0,0,1,1
22064,σκοπός,0,0,1,1
22065,сообщества ,0,0,1,1
22066,gleiche,0,0,1,1
22067,ಭಾಗವೆಂದರೆ,0,0,1,1
22070,entiendo,0,0,1,1
22059,intervention ,0,0,1,1
22071,твоя,0,0,1,1
22072,сердца,0,0,1,1
22074,पूर्वी,0,0,1,1
22075,അമ്മേ,0,0,1,1
22076,marknadsundersökningsföretag,0,0,1,1
22077,ljusa,0,0,1,1
22078,ويكيمانيا,0,0,1,1
22060,pruebas,0,0,1,1
22058,νοιάζεσαι,0,0,1,1
22031,intentan,0,0,1,1
22043,kafayı,0,0,1,1
22032,सटीकता,0,0,1,1
22033,ஆய்வாளரின்,0,0,1,1
22034,neutre,0,0,1,1
22039,ilan,0,0,1,1
22040,देन,0,0,1,1
22041,немецкая ,0,0,1,1
22042,публикация,0,0,1,1
22046,βγήκε,0,0,1,1
22057,techné.« l'homme,0,0,1,1
22048,atteignait,0,0,1,1
22050,tradicional,0,0,1,1
22051,fakta,0,0,1,1
22052,beviste,0,0,1,1
22053,lijkt,0,0,1,1
22055,нынешнюю,0,0,1,1
22056,الكريهة,0,0,1,1
21965,dağarcığınızı,0,0,1,1
21963,tevoorschijn,0,0,1,1
21840,fortsæt.,0,0,1,1
21877,censurera,0,0,1,1
21868,otomatik,0,0,1,1
21869,αυξήθηκε,0,0,1,1
21870,γαλλία,0,0,1,1
21872,nun,0,0,1,1
21873,dessin,0,0,1,1
21875,ухожу,0,0,1,1
21876,सैटरलैण्ड,0,0,1,1
21880,அனுபவம்,0,0,1,1
21866,പറയുന്നതുപോലെ,0,0,1,1
21881,d'utiliser,0,0,1,1
21882,skikke,0,0,1,1
21891,teman,0,0,1,1
21892,உதாரணத்திற்கு.,0,0,1,1
21895,उतना,0,0,1,1
21896,delicioso,0,0,1,1
21898,ovanför,0,0,1,1
21867,parodique,0,0,1,1
21864,cellular,0,0,1,1
21901,assumption,0,0,1,1
21851,navegador,0,0,1,1
21841,vorbei,0,0,1,1
21844,δοκιμή,0,0,1,1
21845,ಎಳೆಯಬಹುದು,0,0,1,1
21846,утверждение,0,0,1,1
21847,olycklig.,0,0,1,1
21848,vardığında,0,0,1,1
21850,trouwen,0,0,1,1
21852,desactualización,0,0,1,1
21863,évidente.,0,0,1,1
21853,напоминает,0,0,1,1
21854,конце.,0,0,1,1
21855,incríveis,0,0,1,1
21856,असत्यापित,0,0,1,1
21859,kalkylprogram,0,0,1,1
21860,friare,0,0,1,1
21861,اثني,0,0,1,1
21899,صرحت,0,0,1,1
21904,கட்டுப்பாடுகளைக்,0,0,1,1
21962,பாதுகாக்கப்பட்டுள்ளன.,0,0,1,1
21949,சாப்பிடும்,0,0,1,1
21938,maar.,0,0,1,1
21939,divulgar,0,0,1,1
21941,rodríguez,0,0,1,1
21942,सोरानी,0,0,1,1
21944,сообщества,0,0,1,1
21946,internetleverantörer.,0,0,1,1
21947,गुस्से,0,0,1,1
21951,идей,0,0,1,1
21930,रायटर्स,0,0,1,1
21952,εγωιστική,0,0,1,1
21953,écosystémiques ,0,0,1,1
21955,хороший,0,0,1,1
21956,شهر.,0,0,1,1
21957,omdat.,0,0,1,1
21958,منسوبة,0,0,1,1
21959,likheter,0,0,1,1
21931,« même,0,0,1,1
21929,derhâl,0,0,1,1
21906,connaissant,0,0,1,1
21917,غمرني,0,0,1,1
21907,официально,0,0,1,1
21908,allez-vous.,0,0,1,1
21909,es •,0,0,1,1
21910,lethargic,0,0,1,1
21911,bursts,0,0,1,1
21912,riskerar,0,0,1,1
21916,disque,0,0,1,1
21918,τηλεφωνική,0,0,1,1
21927,sueco.,0,0,1,1
21920,schoonheid.,0,0,1,1
21921,pressure,0,0,1,1
21922,hızlandırın,0,0,1,1
21923,strategies,0,0,1,1
21924,japonés,0,0,1,1
21925,'ye,0,0,1,1
21926,subspace,0,0,1,1
21603,لمعرفة,0,0,1,1
21601,keen,0,0,1,1
21143,ಮೂಲೆಯಲ್ಲಿಯೇ,0,0,1,1
21600,комментируя,0,0,1,1
21300,gebaseerd,0,0,1,1
21301,heyecan,0,0,1,1
21303,at&t,0,0,1,1
21304,ಮಾಡದ,0,0,1,1
21305,draaiende,0,0,1,1
21306,bult-in,0,0,1,1
21307,affirmait,0,0,1,1
21308,уроков,0,0,1,1
21309,censar,0,0,1,1
21312,participer,0,0,1,1
21313,bristerna,0,0,1,1
21314,تخبر,0,0,1,1
21316,मुख,0,0,1,1
21317,группе,0,0,1,1
21318,positief,0,0,1,1
21319,kesmek.,0,0,1,1
21320,അവയെല്ലാം,0,0,1,1
21299,l'extrême,0,0,1,1
21295,anual,0,0,1,1
21293,doet,0,0,1,1
21281,ervaring,0,0,1,1
21274,galet.,0,0,1,1
21275,objectif,0,0,1,1
21276,kaydını,0,0,1,1
21277,séparent,0,0,1,1
21278,επικό.,0,0,1,1
21279,obscurs,0,0,1,1
21280,произносить,0,0,1,1
21282,έδωσε,0,0,1,1
21292,انتحال,0,0,1,1
21284,universités,0,0,1,1
21285,author,0,0,1,1
21286,horreur,0,0,1,1
21287,fouilles,0,0,1,1
21288,global.,0,0,1,1
21289,говорят.,0,0,1,1
21291,disculparse.,0,0,1,1
21321,видела,0,0,1,1
21322,χρησιμότητα,0,0,1,1
21323,parabenizar,0,0,1,1
21359,fließender,0,0,1,1
21347,കെട്ടുറപ്പുള്ള,0,0,1,1
21348,குறிக்கிறீர்கள்,0,0,1,1
21349,മാർഗമാണിത്.,0,0,1,1
21351,« machine,0,0,1,1
21352,sofa.,0,0,1,1
21355,üzerindeki,0,0,1,1
21357,دراسات,0,0,1,1
21362,விடுங்கள்,0,0,1,1
21344,acquire,0,0,1,1
21363,activités.,0,0,1,1
21364,bedrijven.,0,0,1,1
21366,hatırlayın.,0,0,1,1
21367,متطورًا,0,0,1,1
21368,forfremmet,0,0,1,1
21370,मीडियाविकी,0,0,1,1
21372,മനസ്സിലാക്കേണ്ടതെല്ലാം,0,0,1,1
21345,législatives.,0,0,1,1
21343,tanrım,0,0,1,1
21324,maatschappij.,0,0,1,1
21332,பயன்படுத்தப்படலாம்,0,0,1,1
21325,killar.,0,0,1,1
21326,höjde,0,0,1,1
21327,πρώτο.,0,0,1,1
21328,wiki-concept,0,0,1,1
21329,kong,0,0,1,1
21330,перемещён,0,0,1,1
21331,insanlara,0,0,1,1
21333,progresser,0,0,1,1
21342,японская ,0,0,1,1
21335,sœur,0,0,1,1
21336,அனுபவங்களைத்,0,0,1,1
21337,благонамеренных,0,0,1,1
21338,ехали,0,0,1,1
21339,أطلب,0,0,1,1
21340,tactics,0,0,1,1
21341,bijdraagt,0,0,1,1
21273,ställning.,0,0,1,1
21271,touristen,0,0,1,1
21270,ആയിരുന്നെങ്കിൽ,0,0,1,1
21183,यिद्दी,0,0,1,1
21175,நண்பர்களிடம்,0,0,1,1
21176,hilf,0,0,1,1
21177,வேர்,0,0,1,1
21179,याकूत,0,0,1,1
21180,latines.,0,0,1,1
21181,இருந்ததுடன்,0,0,1,1
21182,logístico,0,0,1,1
21184,pollueur,0,0,1,1
21172,exercise,0,0,1,1
21185,fará,0,0,1,1
21187,läxor,0,0,1,1
21189,yaptığınızı,0,0,1,1
21190,ದೌರ್ಜನ್ಯವನ್ನು,0,0,1,1
21192,consciemment,0,0,1,1
21193,منطقة,0,0,1,1
21195,t.,0,0,1,1
21174,vogels,0,0,1,1
21171,vandalizmle,0,0,1,1
21197,siguieron,0,0,1,1
21155,взаимодействию,0,0,1,1
21144,bilgileri,0,0,1,1
21146,importarme,0,0,1,1
21147,hasn,0,0,1,1
21149,αγαπημένο,0,0,1,1
21151,slaap,0,0,1,1
21152,सिविल,0,0,1,1
21153,hurtig,0,0,1,1
21156,pålitlighet,0,0,1,1
21169,ವಿನಂತಿಗಳನ್ನು,0,0,1,1
21158,financial,0,0,1,1
21159,destacan,0,0,1,1
21160,реакций.,0,0,1,1
21162,veriyorum,0,0,1,1
21164,cine,0,0,1,1
21167,especie,0,0,1,1
21168,sensíveis,0,0,1,1
21196,уравновешенным,0,0,1,1
21199,സഞ്ചരിക്കുന്ന,0,0,1,1
21268,χρησιμοποιούσατε,0,0,1,1
21252,ದೂರವಾಣಿ,0,0,1,1
21238,unmögliche,0,0,1,1
21244,bengali,0,0,1,1
21246,utilidade,0,0,1,1
21247,d'água,0,0,1,1
21248,создала,0,0,1,1
21249,प्रगति,0,0,1,1
21250,لتصنيف,0,0,1,1
21255,daughter.,0,0,1,1
21235,derecede,0,0,1,1
21256,amené,0,0,1,1
21257,kommentarfeltet,0,0,1,1
21258,четвёртым,0,0,1,1
21260,удивлена,0,0,1,1
21261,fdl,0,0,1,1
21266,ελαφρώς,0,0,1,1
21267,развитие.,0,0,1,1
21236,ವಹಿಸಲಿಲ್ಲ,0,0,1,1
21234,കുറവുമുള്ളതായി,0,0,1,1
21200,wapediatjänsten,0,0,1,1
21217,ಭೇಟಿಯಾಗುತ್ತೀರಿ,0,0,1,1
21201,скажешь,0,0,1,1
21203,அந்தக்,0,0,1,1
21210,волновалась,0,0,1,1
21211,mediawiki ,0,0,1,1
21213,दुर्भाग्य,0,0,1,1
21214,சூடாக,0,0,1,1
21215,mermeladas,0,0,1,1
21218,twice.,0,0,1,1
21233,counterpart,0,0,1,1
21222,mining‏,0,0,1,1
21223,finish.,0,0,1,1
21224,destes,0,0,1,1
21225,actuaciones,0,0,1,1
21226,disposez,0,0,1,1
21230,ചിലരെ,0,0,1,1
21231,സഹിഷ്ണുക്കൾ,0,0,1,1
21373,नवम्बर,0,0,1,1
21374,puestos,0,0,1,1
21375,நிறுவனத்திற்குச்,0,0,1,1
21536,möjliggjorde,0,0,1,1
21527,яркие,0,0,1,1
21529,même.,0,0,1,1
21530,ibmer,0,0,1,1
21531,placozoansanimals,0,0,1,1
21533,άρα,0,0,1,1
21534,فماذا,0,0,1,1
21535,enoje.,0,0,1,1
21537,direta,0,0,1,1
21525,co-évolue,0,0,1,1
21538,ем,0,0,1,1
21539,تنظر,0,0,1,1
21540,просьбу,0,0,1,1
21541,vermeniz,0,0,1,1
21542,rejser,0,0,1,1
21544,improvement,0,0,1,1
21545,dumb,0,0,1,1
21526,antwoorden,0,0,1,1
21523,verkocht.,0,0,1,1
21547,இக்கொள்கைகளிலும்,0,0,1,1
21507,bölümü,0,0,1,1
21499,nära,0,0,1,1
21501,initié,0,0,1,1
21502,nysede,0,0,1,1
21503,холодным,0,0,1,1
21504,திகைத்துப்,0,0,1,1
21505,واسترجاعها،,0,0,1,1
21506,payant,0,0,1,1
21508,അമേരിക്കക്കാരനായ,0,0,1,1
21522,αντέξτε,0,0,1,1
21509,contributos,0,0,1,1
21510,pouvoirs,0,0,1,1
21512,kennst,0,0,1,1
21517,пар,0,0,1,1
21518,gradual,0,0,1,1
21520,logique ,0,0,1,1
21521,misstag.,0,0,1,1
21546,asturiëprijs,0,0,1,1
21548,organismes,0,0,1,1
21496,alemana,0,0,1,1
21586,forneçam,0,0,1,1
21574,romantique,0,0,1,1
21575,exemples ,0,0,1,1
21577,accepteret,0,0,1,1
21580,onderwerpen,0,0,1,1
21581,évidentes,0,0,1,1
21582,استمر,0,0,1,1
21584,congrès,0,0,1,1
21587,ansætte,0,0,1,1
21572,execute,0,0,1,1
21588,intihal,0,0,1,1
21589,ദ്രുത,0,0,1,1
21590,elmaslarla,0,0,1,1
21594,onwards.,0,0,1,1
21595,quartal,0,0,1,1
21596,ಕುತೂಹಲಕಾರಿ,0,0,1,1
21599,m'épouser,0,0,1,1
21573,hayranlık,0,0,1,1
21571,anciennes.,0,0,1,1
21550,விற்றதை,0,0,1,1
21561,principer,0,0,1,1
21552,réalisait,0,0,1,1
21553,l'exagérer.,0,0,1,1
21554,verzamelen,0,0,1,1
21555,gepatenteerde,0,0,1,1
21557,goût,0,0,1,1
21558,deixar,0,0,1,1
21559,inform,0,0,1,1
21562,patient,0,0,1,1
21570,несколькими,0,0,1,1
21563,flickvän,0,0,1,1
21564,température,0,0,1,1
21565,парламента,0,0,1,1
21566,contribué,0,0,1,1
21567,விக்கிப்பீடியாவிற்கு,0,0,1,1
21568,hyperlink,0,0,1,1
21569,बैंड,0,0,1,1
21497,iluminado,0,0,1,1
21495,ogen.,0,0,1,1
21376,compromis,0,0,1,1
21416,научному,0,0,1,1
21407,стилистических,0,0,1,1
21408,γίνεται.,0,0,1,1
21409,أصاب,0,0,1,1
21410,προχωρήσεις,0,0,1,1
21412,склонны,0,0,1,1
21413,bevisa,0,0,1,1
21414,riguroso,0,0,1,1
21417,comunitario,0,0,1,1
21404,स्कॉट,0,0,1,1
21419,அண்மையில்,0,0,1,1
21420,проступках,0,0,1,1
21421,systematisk,0,0,1,1
21423,llorar.,0,0,1,1
21424,censurerar,0,0,1,1
21428,constitué,0,0,1,1
21433,ಸ್ಥಳೀಯ,0,0,1,1
21406,overdrijven.,0,0,1,1
21400,umkreisen,0,0,1,1
21436,உணர்வு,0,0,1,1
21388,सके,0,0,1,1
21377,باللغات,0,0,1,1
21378,paquetes,0,0,1,1
21381,കുഴപ്പമില്ല.,0,0,1,1
21383,koninkrijk,0,0,1,1
21384,लोड-बेलेंसिंग,0,0,1,1
21385,директор,0,0,1,1
21386,ಒಳ್ಳೆಯವರಾಗಿರಿ,0,0,1,1
21390,തിരുത്തൽ,0,0,1,1
21399,« préjudice,0,0,1,1
21391,противоположностью,0,0,1,1
21392,ഉച്ചഭക്ഷണം,0,0,1,1
21393,iniciado.,0,0,1,1
21394,brotbrot,0,0,1,1
21395,alacağım.,0,0,1,1
21396,peaking,0,0,1,1
21398,licorne,0,0,1,1
21435,ചോദിക്കാം.,0,0,1,1
21437,neigen,0,0,1,1
21493,представляют,0,0,1,1
21480,ντυμένος,0,0,1,1
21470,وأكثر,0,0,1,1
21471,കടന്നുപോകാം.,0,0,1,1
21473,проверке,0,0,1,1
21475,ಕೋನ,0,0,1,1
21477,للسؤال,0,0,1,1
21478,использует,0,0,1,1
21479,« d'apprentissage »,0,0,1,1
21481,kaynaklı,0,0,1,1
21467,سعيدا,0,0,1,1
21484,não-usuários,0,0,1,1
21485,atribuído,0,0,1,1
21486,تبكي,0,0,1,1
21487,многослойный,0,0,1,1
21489,εμπειρία,0,0,1,1
21490,நிமிடத்தில்,0,0,1,1
21492,ലേഖനങ്ങളിലും,0,0,1,1
21468,subgrupos,0,0,1,1
21466,അഭിനയിച്ചതിൽ,0,0,1,1
21438,fungera.,0,0,1,1
21451,wikipedia-related,0,0,1,1
21440,infobox,0,0,1,1
21442,tabelldatafil,0,0,1,1
21443,ಅನ್ವಯವಾಗುವ,0,0,1,1
21444,ಒಪ್ಪುತ್ತೇನೆ,0,0,1,1
21445,nonsensical,0,0,1,1
21446,classé,0,0,1,1
21447,λογισμικού.,0,0,1,1
21452,betjänar,0,0,1,1
21464,ഉപയോഗപ്രദവുമായ,0,0,1,1
21453,يحرره،,0,0,1,1
21454,concebida,0,0,1,1
21455,தொலைபேசி,0,0,1,1
21456,lese,0,0,1,1
21457,தேர்ந்தெடுக்கப்பட்ட,0,0,1,1
21458,kopieren,0,0,1,1
21462,divinité,0,0,1,1
52235,aconsejando,0,0,1,1
