,Word,where,Count_ita,Count_other,Total_count
33655,de,0,0,3493,3493
0,,2,135,2678,2813
6547,a,2,604,1685,2289
5287,di,1,2210,0,2210
8772,la,2,780,1216,1996
4517,in,2,741,946,1687
1097,the,2,8,1608,1616
1729,e,2,1165,410,1575
18617,en,0,0,1534,1534
5787,un,2,772,596,1368
27493,que,0,0,1294,1294
7644,wikipedia,2,436,792,1228
5094,of,2,6,1126,1132
6600,che,1,1035,0,1035
8304,i,2,362,637,999
192,le,2,413,472,885
2971,and,2,3,846,849
23838,du,0,0,814,814
3989,il,2,679,112,791
6579,o,2,284,502,786
8911,to,2,1,754,755
3173,è,1,748,0,748
2754,da,2,342,316,658
5762,per,2,605,15,620
7776,una,2,427,187,614
3,se,2,194,410,604
25477,et,0,0,587,587
11949,के,0,0,563,563
3068,is,2,1,552,553
11198,je,0,0,507,507
33,non,2,476,25,501
24673,à,0,0,481,481
12617,att,0,0,438,438
30772,l,0,0,438,438
28010,y,0,0,429,429
1510,wikipédia,2,1,422,423
48478,det,0,0,423,423
13639,por,0,0,408,408
46380,that,0,0,408,408
14146,des,0,0,406,406
7109,del,2,286,114,400
23934,में,0,0,396,396
41321,les,0,0,389,389
49270,och,0,0,387,387
35295,в,0,0,386,386
26559,el,0,0,386,386
32181,d,0,0,383,383
2305,sono,2,380,1,381
8487,con,2,255,125,380
6655,come,2,366,14,380
4149,si,2,200,172,372
44,no,2,23,346,369
9047,you,2,3,363,366
4817,ha,2,315,49,364
38359,as,0,0,356,356
3215,for,2,1,353,354
29467,है,0,0,344,344
16697,para,0,0,337,337
39989,est,0,0,330,330
39174,som,0,0,329,329
29797,em,0,0,313,313
27095,और,0,0,313,313
32091,at,0,0,308,308
16329,kan,0,0,303,303
13575,في,0,0,301,301
16445,une,0,0,299,299
42135,и,0,0,298,298
3995,della,1,295,0,295
14711,er,0,0,295,295
37989,να,0,0,292,292
34941,es,0,0,290,290
38316,är,0,0,285,285
24438,het,0,0,282,282
2137,su,2,177,104,281
20989,vous,0,0,271,271
4262,s,2,1,265,266
21791,på,0,0,265,265
35730,um,0,0,263,263
30115,एक,0,0,262,262
28031,was,0,0,260,260
19389,من,0,0,259,259
46623,om,0,0,258,258
405,on,2,1,256,257
22770,como,0,0,253,253
32413,você,0,0,252,252
19715,को,0,0,251,251
30058,ou,0,0,247,247
40925,،,0,0,247,247
21146,dans,0,0,246,246
49959,har,0,0,245,245
38042,कि,0,0,244,244
34833,een,0,0,244,244
49440,sie,0,0,240,240
13412,से,0,0,233,233
15911,हैं,0,0,228,228
3326,nature,2,10,218,228
16174,los,0,0,223,223
3912,più,1,222,0,222
4878,te,2,36,183,219
2658,lo,2,108,110,218
47794,par,0,0,217,217
15035,van,0,0,212,212
44464,ನೀವು,0,0,211,211
28100,bir,0,0,210,210
51465,are,0,0,209,209
32989,ve,0,0,209,209
22999,it,0,0,205,205
27688,av,0,0,204,204
23297,jag,0,0,203,203
3753,qui,2,25,174,199
46674,ik,0,0,198,198
4141,do,2,2,196,198
36067,og,0,0,197,197
10780,आप,0,0,197,197
17816,jeg,0,0,197,197
10082,και,0,0,196,196
32240,or,0,0,196,196
17115,den,0,0,195,195
29883,uma,0,0,195,195
3807,learning,2,12,181,193
28664,by,0,0,193,193
25867,ich,0,0,192,192
13842,dat,0,0,192,192
32531,med,0,0,191,191
9434,não,0,0,190,190
3860,w,2,2,188,190
34568,की,0,0,188,188
7698,gli,1,188,0,188
2575,me,2,17,169,186
44206,நீங்கள்,0,0,183,183
21820, ·,0,0,182,182
4193,wikimedia,2,41,141,182
36382,है।,0,0,179,179
5705,ne,2,41,137,178
50271,что,0,0,176,176
1303,nel,1,175,0,175
50882,लिए,0,0,173,173
2873,an,2,2,169,171
31895,το,0,0,171,171
50242,with,0,0,171,171
37748,pas,0,0,170,170
368,al,2,142,28,170
23381,أن,0,0,169,169
26046,pour,0,0,167,167
50477,не,0,0,167,167
34173,för,0,0,166,166
21718,can,0,0,165,165
43164,विकिपीडिया,0,0,165,165
3079,dei,1,164,0,164
13352,ನಾನು,0,0,162,162
35211,é,0,0,162,162
36046,dig,0,0,161,161
2041,essere,1,160,0,160
49218,का,0,0,157,157
12228,я,0,0,156,156
38272,على,0,0,155,155
10524,så,0,0,155,155
52675,вы,0,0,153,153
7235,delle,1,152,0,152
5780,narcisa,2,23,129,152
52205,var,0,0,151,151
22500,நான்,0,0,150,150
28743,यह,0,0,150,150
23028,from,0,0,150,150
13071,नहीं,0,0,149,149
30750,на,0,0,149,149
22689,und,0,0,149,149
35247,be,0,0,149,149
15295,articles,0,0,148,148
18511,inte,0,0,148,148
49233,ಮತ್ತು,0,0,147,147
33160,sur,0,0,146,146
33068,have,0,0,145,145
11910,die,0,0,144,144
4897,parte,2,93,50,143
9009,questo,1,143,0,143
32976,las,0,0,142,142
52569,mais,0,0,141,141
22257,ഒരു,0,0,138,138
7876,oh,2,30,108,138
3619,ce,2,2,135,137
37079,com,0,0,137,137
15020,ويكيبيديا,0,0,136,136
1947,this,2,1,133,134
329,era,2,86,48,134
45496,das,0,0,132,132
48633,eller,0,0,131,131
7023,data,2,26,105,131
3637,anche,1,131,0,131
21950,это,0,0,131,131
33586,​,0,0,130,130
6092,puoi,1,130,0,130
49262,os,0,0,130,130
90,web,2,41,88,129
36302,till,0,0,127,127
5478,dire,2,73,54,127
39876,son,0,0,127,127
44271,bu,0,0,127,127
6104,ma,2,116,10,126
21,so,2,8,118,126
24240,είναι,0,0,125,125
15161,als,0,0,125,125
1331,alla,2,103,22,125
29941,ஒரு,0,0,123,123
8729,ad,2,118,4,122
31201,which,0,0,121,121
36544,നിങ്ങൾ,0,0,121,121
33286,पर,0,0,121,121
47982,मैं,0,0,120,120
4319,significa,2,61,59,120
5567,sua,2,64,56,120
48131,που,0,0,119,119
39658,ikke,0,0,118,118
44264,plus,0,0,117,117
18468,niet,0,0,117,117
26724,ഞാൻ,0,0,116,116
18867,sobre,0,0,116,116
2138,t,2,4,110,114
7881,quando,2,83,30,113
31846,eu,0,0,112,112
34354,na,0,0,112,112
6546,machine,2,10,102,112
254,automatico,1,111,0,111
44471,not,0,0,110,110
29446,has,0,0,110,110
8466,nella,1,107,0,107
4775,ai,2,46,61,107
22311,op,0,0,107,107
28183,για,0,0,107,107
32265,ist,0,0,106,106
767,cui,1,104,0,104
1813,wales,2,18,86,104
5082,wiki,2,29,74,103
18121,der,0,0,103,103
569,stato,1,102,0,102
35343,comme,0,0,102,102
38852,está,0,0,102,102
7056,ti,2,92,10,102
47052,ಎಂದು,0,0,102,102
16947,как,0,0,101,101
693,tu,2,34,67,101
17417,с,0,0,101,101
49724,au,0,0,100,100
29686,δεν,0,0,100,100
21905,zu,0,0,100,100
15017,ser,0,0,99,99
37118,ما,0,0,96,96
25681,किया,0,0,96,96
5242,tra,1,96,0,96
49432,nicht,0,0,96,96
41823,कर,0,0,95,95
16654,என்று,0,0,95,95
7095,dati,1,94,0,94
43790,हैं।,0,0,93,93
4453, ,2,9,84,93
34119,ότι,0,0,92,92
27112,mig,0,0,91,91
39419,sont,0,0,91,91
5608,apprendimento,1,90,0,90
29530,over,0,0,90,90
2477,modo,2,78,11,89
12885,википедии,0,0,89,89
16155,നിങ്ങൾക്ക്,0,0,88,88
16077,also,0,0,88,88
6848,mi,2,62,26,88
30043,ett,0,0,88,88
804,hanno,1,87,0,87
24698,لا,0,0,86,86
21443,सकते,0,0,85,85
4751,n,2,1,83,84
3475,articoli,1,84,0,84
51047,been,0,0,84,84
50995,article,0,0,83,83
39054,σε,0,0,83,83
5147,internet,2,7,75,82
51019,إلى,0,0,82,82
3732,molto,1,81,0,81
34497,dass,0,0,81,81
3768,foundation,2,7,74,81
44104,met,0,0,81,81
1390,video,2,17,64,81
28633,men,0,0,80,80
45584,catch,0,0,80,80
45679,avec,0,0,80,80
7689,uno,2,63,17,80
12434,pode,0,0,80,80
3744,degli,1,80,0,80
28555,entre,0,0,79,79
44210,til,0,0,79,79
13489,أو,0,0,79,79
11098,ord,0,0,78,78
6849,così,1,78,0,78
23139,σας,0,0,78,78
6146,loro,1,78,0,78
49757,هذا,0,0,78,78
7817,quindi,1,77,0,77
4518,solo,2,55,22,77
26714,más,0,0,77,77
13126,или,0,0,77,77
32890,artículos,0,0,77,77
44514,artigos,0,0,77,77
44614,some,0,0,77,77
14661,if,0,0,77,77
32379,other,0,0,76,76
50418,such,0,0,76,76
12756,são,0,0,75,75
4378,terry,2,14,61,75
35844,zijn,0,0,75,75
5500,l'apprendimento,1,75,0,75
7236,sanger,2,20,55,75
41033,από,0,0,75,75
34454,its,0,0,74,74
50252,af,0,0,74,74
2904,m,2,1,72,73
13252,cette,0,0,73,73
42397,μια,0,0,73,73
39943,या,0,0,73,73
45257,θα,0,0,73,73
10352,मुझे,0,0,73,73
40691,bien,0,0,72,72
41272,जो,0,0,72,72
8997,sulla,1,72,0,72
43772,all,0,0,72,72
523,one,2,1,71,72
36375,dit,0,0,72,72
3811,ho,2,70,1,71
23369,भी,0,0,71,71
126,parola,1,71,0,71
31581,but,0,0,71,71
27157,dos,0,0,71,71
41975,με,0,0,71,71
35550,करने,0,0,70,70
7502,esempio,1,70,0,70
47609,कुछ,0,0,70,70
32198,αυτό,0,0,69,69
1570,dalla,1,69,0,69
24652,este,0,0,68,68
43766,η,0,0,68,68
41457,c,0,0,68,68
7278,software,2,21,47,68
1259,qualcuno,1,68,0,68
52073,about,0,0,67,67
18619,foi,0,0,67,67
10197,more,0,0,67,67
8029,numero,1,67,0,67
2389,può,1,67,0,67
10947,для,0,0,67,67
4935,use,2,3,64,67
8074,nupedia,2,13,54,67
8081,sei,2,57,9,66
4189,rendezvous,2,14,52,66
3539,due,2,54,12,66
444,voci,1,66,0,66
23936,ने,0,0,66,66
39452,han,0,0,66,66
2497,sia,1,66,0,66
9550,ты,0,0,65,65
664,altri,1,65,0,65
3100,dal,1,65,0,65
3236,hai,1,65,0,65
12131,qu,0,0,65,65
7350,enciclopedia,2,18,47,65
25861,wat,0,0,64,64
5995,possono,1,64,0,64
30270,wenn,0,0,64,64
1937,frase,2,32,32,64
1796,life,2,2,62,64
1884,stata,1,64,0,64
50984,गया,0,0,64,64
14835,يمكنك,0,0,63,63
40902,esta,0,0,63,63
6892,.,1,62,0,62
1861,tempo,2,46,16,62
19265,आपको,0,0,62,62
19686,her,0,0,62,62
14414,года,0,0,62,62
45643,çok,0,0,61,61
5890,alcuni,1,61,0,61
50049,were,0,0,61,61
3991,alle,2,40,21,61
27214,elle,0,0,61,61
8901,google,2,10,50,60
6538,jimmy,2,8,52,60
23174,için,0,0,60,60
50697,site,0,0,60,60
26064,बहुत,0,0,60,60
4386,sul,2,58,1,59
16410,voor,0,0,59,59
3850,base,2,39,20,59
6576,algoritmi,1,59,0,59
16797,उपयोग,0,0,59,59
39605,ഈ,0,0,59,59
49857,എനിക്ക്,0,0,59,59
28060,être,0,0,59,59
7247,sin,2,2,56,58
14929,they,0,0,58,58
15620,had,0,0,58,58
14156,aux,0,0,58,58
23427,vikipedi,0,0,58,58
51117,mot,0,0,57,57
1974,set,2,18,39,57
12874,muito,0,0,57,57
24483,если,0,0,56,56
20360,andere,0,0,56,56
39656,editors,0,0,56,56
8984,perché,1,56,0,56
39351,hvis,0,0,56,56
39056,அல்லது,0,0,56,56
18840,isso,0,0,56,56
43543,ya,0,0,56,56
9835,été,0,0,56,56
9792,रूप,0,0,56,56
36031,he,0,0,56,56
19373,μου,0,0,55,55
7102,ben,2,11,44,55
6555,vita,1,55,0,55
13678,fait,0,0,55,55
7391,natura,2,50,5,55
13371,ನಿಮಗೆ,0,0,55,55
13801,по,0,0,55,55
32064,pouvez,0,0,55,55
38224,betyder,0,0,55,55
13415,their,0,0,55,55
1772,inglese,1,55,0,55
24983,साथ,0,0,55,55
16943,ze,0,0,55,55
10828,التي,0,0,55,55
39015,μπορείτε,0,0,55,55
5488,suave,2,1,53,54
2069,time,2,2,52,54
10412,о,0,0,54,54
19487,तो,0,0,54,54
3132,tutto,1,54,0,54
15763,из,0,0,54,54
8627,cosa,2,52,2,54
28184,like,0,0,54,54
16705,sagen,0,0,54,54
20430,αν,0,0,54,54
50115,ഇത്,0,0,54,54
384,nei,1,54,0,54
32384,इस,0,0,54,54
51164,மிகவும்,0,0,53,53
26536,क्या,0,0,53,53
12369,πολύ,0,0,53,53
24037,था,0,0,53,53
30175,ein,0,0,53,53
8171,what,2,2,51,53
43675,ή,0,0,53,53
35734,say,0,0,53,53
34256,sus,0,0,53,53
45431,these,0,0,52,52
28051,there,0,0,52,52
6934,suo,1,52,0,52
2417,fatto,1,52,0,52
46549,under,0,0,52,52
3653,new,2,3,49,52
8673,sistema,2,38,14,52
16449,रहा,0,0,52,52
1264,mit,2,4,48,52
18322,إذا,0,0,52,52
14263,википедия,0,0,51,51
24904,लेख,0,0,51,51
4636,training,2,3,48,51
32436,किसी,0,0,51,51
1229,online,2,20,31,51
5099,libre,2,3,48,51
36397,word,0,0,50,50
21271,algo,0,0,50,50
3895,fare,1,50,0,50
28303,we,0,0,50,50
20565,used,0,0,50,50
2919,forma,2,14,36,50
6746,ricerca,1,50,0,50
40529,example,0,0,49,49
19738,так,0,0,49,49
50406,της,0,0,49,49
29522,may,0,0,49,49
44766,kunt,0,0,49,49
31118,ses,0,0,49,49
43996,كان,0,0,49,49
3474,war,2,2,47,49
7181,britannica,2,11,38,49
50502,ces,0,0,48,48
15526,можете,0,0,48,48
8732,qualcosa,1,48,0,48
13000,ένα,0,0,48,48
42846,wie,0,0,48,48
37500,ήταν,0,0,48,48
7930,questa,1,48,0,48
37060,j,0,0,48,48
12389,nu,0,0,48,48
21257,ಅಥವಾ,0,0,48,48
29680,वह,0,0,48,48
46801,शब्द,0,0,48,48
50625,மற்றும்,0,0,47,47
47454,അത്,0,0,47,47
4510,man,2,3,44,47
52456,than,0,0,47,47
37313,här,0,0,47,47
23018,when,0,0,47,47
40873,puedes,0,0,47,47
15554,द्वारा,0,0,47,47
30359,vara,0,0,47,47
44239,hvad,0,0,47,47
478,vista,2,27,20,47
7188,information,2,1,46,47
2119,grande,2,26,21,47
39261,vez,0,0,47,47
16573,aussi,0,0,46,46
16189,zo,0,0,46,46
3138,encyclopedia,2,1,45,46
6871,stati,1,46,0,46
20900,oder,0,0,46,46
4225,spesso,1,46,0,46
36421,algorithms,0,0,46,46
22707,säga,0,0,46,46
1655,mellie,2,8,38,46
27863,nummer,0,0,45,45
28495,mas,0,0,45,45
81,altre,1,45,0,45
29559,zeggen,0,0,45,45
34280,हो,0,0,45,45
38620,number,0,0,45,45
48454,eine,0,0,45,45
42324,tem,0,0,45,45
30967,était,0,0,45,45
23191,part,0,0,45,45
40532,número,0,0,45,45
2146,commons,2,7,38,45
25792,können,0,0,45,45
3537,tutti,1,45,0,45
7466,wikipedia.,1,44,0,44
18551,todo,0,0,44,44
43854,earth,0,0,44,44
40997,artiklar,0,0,44,44
3316,parole,2,43,1,44
27960,dizer,0,0,44,44
337,secondo,1,44,0,44
39689,dem,0,0,44,44
46093,இது,0,0,44,44
21680,sige,0,0,43,43
47954,ही,0,0,43,43
17989,iyi,0,0,43,43
42443,vad,0,0,43,43
25530,τη,0,0,43,43
48076,page,0,0,43,43
4837,modello,1,43,0,43
2528,editor,2,16,27,43
38655,ಅದು,0,0,43,43
25049,från,0,0,43,43
27837,इसे,0,0,43,43
1781,ed,1,43,0,43
28115,ನಿಮ್ಮ,0,0,43,43
51645,encyclopédie,0,0,43,43
2100,molti,1,43,0,43
12714,min,0,0,43,43
40124,någon,0,0,43,43
18593,к,0,0,43,43
5328,dai,1,43,0,43
5431,erano,1,43,0,43
6701,utenti,1,42,0,42
33168,content,0,0,42,42
19700,autres,0,0,42,42
24338,version,0,0,42,42
37689,também,0,0,42,42
47450,heb,0,0,42,42
30536,wikipedias,0,0,42,42
3290,insieme,1,42,0,42
5742,quello,1,42,0,42
40862,tout,0,0,41,41
2202,marian,2,5,36,41
11408,noget,0,0,41,41
31418,τον,0,0,41,41
50350,ela,0,0,41,41
2949,anni,1,41,0,41
40652,usar,0,0,41,41
5669,problema,2,25,16,41
43125,она,0,0,41,41
16544,english,0,0,41,41
7455,persona,2,20,21,41
43816,هذه,0,0,41,41
5792,senza,1,41,0,41
17754,vil,0,0,41,41
12185,situation,0,0,41,41
39262,сказать,0,0,41,41
1854,quanto,2,31,10,41
44695,दिया,0,0,40,40
5942,uso,2,12,28,40
8562,flummox,2,6,34,40
3739,dopo,1,40,0,40
44212,only,0,0,40,40
22889,many,0,0,40,40
7309,mentre,1,40,0,40
41403,στο,0,0,40,40
9793,aprendizaje,0,0,40,40
2660,mobile,2,14,26,40
45785,"
",0,0,40,40
31744,ನನ್ನ,0,0,40,40
31682,ಈ,0,0,40,40
8876,nelle,1,40,0,40
4077,test,2,15,25,40
12799,ذلك,0,0,40,40
40582,ont,0,0,40,40
16733,culture,0,0,40,40
48225,а,0,0,40,40
22882,വളരെ,0,0,39,39
7036,larry,2,6,33,39
48897,smart,0,0,39,39
36601,mijn,0,0,39,39
20531,seu,0,0,39,39
20571,мне,0,0,39,39
28779,maar,0,0,39,39
387,mediawiki,2,7,32,39
36959,my,0,0,39,39
13699,most,0,0,39,39
15690,would,0,0,39,39
4246,lavoro,1,39,0,39
4035,informazioni,1,39,0,39
25163,τα,0,0,39,39
25933,andra,0,0,39,39
26044,عن,0,0,39,39
23877,habe,0,0,39,39
42775,re,0,0,39,39
46869,editores,0,0,39,39
29734,कह,0,0,38,38
44584,എന്റെ,0,0,38,38
25869,было,0,0,38,38
14172,meget,0,0,38,38
31143,был,0,0,38,38
8103,vi,2,6,32,38
21225,autre,0,0,38,38
6048,bene,1,38,0,38
47864,up,0,0,38,38
522,dell'apprendimento,1,38,0,38
11403,την,0,0,38,38
16115,any,0,0,38,38
37611,உங்களுக்கு,0,0,38,38
9776,sites,0,0,38,38
22412,kom,0,0,38,38
5681,sempre,2,29,9,38
23025,ele,0,0,38,38
31127,இந்த,0,0,38,38
6011,regole,1,38,0,38
16391,அது,0,0,38,38
44043,कोई,0,0,38,38
4364,sa,2,3,34,37
7291,alcune,1,37,0,37
49902,എന്ന്,0,0,37,37
395,articolo,1,37,0,37
30156,mich,0,0,37,37
38553,alors,0,0,37,37
5749,terrence,2,6,31,37
14604,nogen,0,0,37,37
3158,posso,2,23,14,37
8248,ci,1,37,0,37
25102,hun,0,0,37,37
36367,cada,0,0,37,37
8396,campo,2,32,5,37
2614,metodi,1,37,0,37
534,progetto,1,37,0,37
31615,была,0,0,37,37
43512,door,0,0,37,37
5947,contenuto,1,37,0,37
3578,quel,2,28,8,36
41527,также,0,0,36,36
43966,रहे,0,0,36,36
45786,iemand,0,0,36,36
34658,así,0,0,36,36
34132,water,0,0,36,36
10216,तरह,0,0,36,36
18360,något,0,0,36,36
19284,quelqu,0,0,36,36
41693,alguien,0,0,36,36
7321,durante,2,23,13,36
15448,जैसे,0,0,36,36
5120,madre,2,24,12,36
7662,davvero,1,36,0,36
15308,exemplo,0,0,36,36
23111,leur,0,0,36,36
23119,todos,0,0,36,36
39133,വിക്കിപീഡിയ,0,0,36,36
26890,του,0,0,36,36
30411,cuando,0,0,36,36
25889,deze,0,0,36,36
17617,très,0,0,36,36
34836,alguém,0,0,36,36
14220,olika,0,0,36,36
51310,ejemplo,0,0,36,36
35098,pero,0,0,36,36
40679,human,0,0,36,36
8555,edizioni,1,35,0,35
41011,même,0,0,35,35
48365,conteúdo,0,0,35,35
40580,language,0,0,35,35
32573,palabra,0,0,35,35
2164,queste,1,35,0,35
13595,person,0,0,35,35
19013,كنت,0,0,35,35
27989,woord,0,0,35,35
39625,então,0,0,35,35
11058,sig,0,0,35,35
1072,tipo,2,16,19,35
11722,شخص,0,0,35,35
25342,palavra,0,0,35,35
1580,conoscenza,1,35,0,35
6080,questi,1,35,0,35
38530,project,0,0,35,35
42006,अपने,0,0,35,35
33420,también,0,0,35,35
17386,decir,0,0,35,35
33567,don,0,0,35,35
52524,ತುಂಬಾ,0,0,35,35
9580,model,0,0,35,35
25938,usuarios,0,0,35,35
5908,momento,2,15,19,34
14408,edições,0,0,34,34
12560,ça,0,0,34,34
10795,vill,0,0,34,34
5269,suoi,1,34,0,34
46350,your,0,0,34,34
41170,goed,0,0,34,34
39016,donc,0,0,34,34
12013,into,0,0,34,34
31234,selon,0,0,34,34
3313,input,2,19,15,34
14542,von,0,0,34,34
38660,ved,0,0,34,34
28213,homme,0,0,34,34
10600,ನನಗೆ,0,0,34,34
25974,usuários,0,0,34,34
27602,sido,0,0,34,34
20122,dan,0,0,34,34
40081,все,0,0,34,34
42728,suis,0,0,34,34
47761,how,0,0,34,34
15633,ಇದು,0,0,34,34
5978,science,2,4,30,34
2729,nome,2,25,9,34
2326,tre,2,21,13,34
36276,sens,0,0,34,34
5049,work,2,1,33,34
43548,two,0,0,33,33
50189,ao,0,0,33,33
17728,очень,0,0,33,33
5394,fix,2,2,31,33
51408,phrase,0,0,33,33
43994,mir,0,0,33,33
3532,comunità,1,33,0,33
3257,vengono,1,33,0,33
17905,nombre,0,0,33,33
42413,ook,0,0,33,33
15811,lugar,0,0,33,33
28602,även,0,0,33,33
39918,dir,0,0,33,33
42073,apprentissage,0,0,33,33
2154,prima,1,33,0,33
13084,porque,0,0,33,33
42156,between,0,0,33,33
44545,когда,0,0,33,33
20689,när,0,0,33,33
32787,aan,0,0,33,33
37085,അല്ലെങ്കിൽ,0,0,33,33
50812,artigo,0,0,33,33
39473,सकता,0,0,33,33
35401,mycket,0,0,33,33
6343,detta,2,1,32,33
37785,naar,0,0,33,33
25148,deux,0,0,33,33
43754,например,0,0,33,33
21570,इसके,0,0,32,32
48584,करते,0,0,32,32
6475,studio,1,32,0,32
22765,бы,0,0,32,32
26093,अगर,0,0,32,32
2331,vuoi,1,32,0,32
10659,means,0,0,32,32
33785,जा,0,0,32,32
5359,lingua,1,32,0,32
3590,modifiche,1,32,0,32
17448,أنا,0,0,32,32
10560,hon,0,0,32,32
19962,går,0,0,32,32
46660,peut,0,0,32,32
7386,editori,1,32,0,32
44771,faire,0,0,32,32
4928,forme,2,16,16,32
6204,general,2,1,31,32
44716,somebody,0,0,32,32
31937,كانت,0,0,32,32
3559,processo,2,27,5,32
7418,casa,2,13,19,32
5175,mio,2,31,1,32
11724,bin,0,0,32,32
14127,auf,0,0,32,32
33387,natural,0,0,32,32
12418,avez,0,0,32,32
33085,muy,0,0,32,32
46487,données,0,0,32,32
40792,another,0,0,32,32
18691,signifie,0,0,32,32
2455,voce,1,32,0,32
48173,projeto,0,0,31,31
47826,chose,0,0,31,31
28005,waren,0,0,31,31
8604,media,2,18,13,31
23962,hebt,0,0,31,31
35904,genom,0,0,31,31
44089,ο,0,0,31,31
22421,will,0,0,31,31
25442,hur,0,0,31,31
1973,lui,2,5,26,31
7308,negli,1,31,0,31
10656,നിങ്ങളുടെ,0,0,31,31
14484,சில,0,0,31,31
52667,вам,0,0,31,31
46668,exemple,0,0,31,31
30593,well,0,0,31,31
2289,realmente,2,1,30,31
38079,skulle,0,0,31,31
46761,dus,0,0,31,31
6410,tua,1,31,0,31
32938,einen,0,0,31,31
8810,qualsiasi,1,31,0,31
40022,bra,0,0,31,31
8004,dette,2,1,30,31
40560,πείτε,0,0,31,31
23333,عام,0,0,31,31
5399,research,2,1,30,31
3804,punto,2,24,7,31
25050,often,0,0,31,31
6519,tanto,2,14,17,31
40701,qualquer,0,0,31,31
21628,etwas,0,0,31,31
2133,va,2,17,14,31
40814,статьи,0,0,31,31
46912,artículo,0,0,30,30
27775,ಅದನ್ನು,0,0,30,30
21226,لقد,0,0,30,30
5430,state,2,25,5,30
194,circa,2,29,1,30
7463,usare,1,30,0,30
1778,free,2,1,29,30
19999,páginas,0,0,30,30
31431,هل,0,0,30,30
12065,partir,0,0,30,30
39286,статей,0,0,30,30
8351,caso,2,13,17,30
5138,milioni,1,30,0,30
5015,addestramento,1,30,0,30
23167,но,0,0,30,30
40824,बारे,0,0,30,30
4980,ora,1,30,0,30
11681,want,0,0,30,30
45169,അതിനാൽ,0,0,30,30
17992,called,0,0,30,30
28617,fue,0,0,30,30
30256,være,0,0,30,30
36753,ordet,0,0,30,30
15140,bem,0,0,30,30
1555,computer,2,14,16,30
29625,λέξη,0,0,30,30
45464,she,0,0,30,30
34268,puede,0,0,29,29
35034,sorry,0,0,29,29
50018,fazer,0,0,29,29
6636,youtube,2,2,27,29
2395,volta,1,29,0,29
39548,study,0,0,29,29
49421,estou,0,0,29,29
21862,exempel,0,0,29,29
27982,contenu,0,0,29,29
47415,هي,0,0,29,29
20857,who,0,0,29,29
42481,monde,0,0,29,29
51544,он,0,0,29,29
361,problemi,1,29,0,29
4091,esempi,1,29,0,29
42013,आपके,0,0,29,29
18681,där,0,0,29,29
35341,لم,0,0,29,29
50462,чтобы,0,0,29,29
3030,grazie,1,29,0,29
34832,जाता,0,0,29,29
46085,system,0,0,29,29
36752,know,0,0,29,29
51829,अधिक,0,0,29,29
37062,लेकिन,0,0,29,29
7469,altro,1,29,0,29
41683,dich,0,0,29,29
17828,gibi,0,0,29,29
24125,ediciones,0,0,29,29
25758,good,0,0,29,29
41957,तक,0,0,29,29
35954,उस,0,0,29,29
1637,oltre,1,29,0,29
52633,artificial,0,0,29,29
1013,sebbene,1,29,0,29
37189,several,0,0,28,28
6517,mining,2,16,12,28
1378,knowledge,2,1,27,28
26300,them,0,0,28,28
40848,ಹೇಳಬಹುದು,0,0,28,28
13230,которые,0,0,28,28
1620,progetti,1,28,0,28
46038,haben,0,0,28,28
7084,potrebbe,1,28,0,28
3566,primo,1,28,0,28
43940,because,0,0,28,28
9969,वे,0,0,28,28
26689,din,0,0,28,28
5967,encyclopædia,2,1,27,28
49605,σημαίνει,0,0,28,28
5162,stesso,1,28,0,28
3587,terra,2,26,2,28
25865,ಆದ್ದರಿಂದ,0,0,28,28
52469,أخرى,0,0,28,28
14778,مثل,0,0,28,28
18939,images,0,0,28,28
32054,உங்கள்,0,0,28,28
7570,get,2,1,27,28
32214,हूं,0,0,28,28
493,sito,1,28,0,28
47408,then,0,0,28,28
26,maggior,1,28,0,28
40385,hier,0,0,28,28
909,ciò,1,28,0,28
15142,tan,0,0,28,28
21253,ainsi,0,0,28,28
36944,apenas,0,0,28,28
21119,அதை,0,0,27,27
22436,estoy,0,0,27,27
4222,gfdl,2,8,19,27
44671,question,0,0,27,27
20220,betekent,0,0,27,27
2737,contenuti,1,27,0,27
44501,പറയാൻ,0,0,27,27
2084,agli,1,27,0,27
25853,place,0,0,27,27
2685,intelligente,2,22,5,27
4960,vandalismo,2,12,15,27
20113,هو,0,0,27,27
7874,viene,1,27,0,27
8161,sta,1,27,0,27
49412,dont,0,0,27,27
16907,revista,0,0,27,27
49272,الذي,0,0,27,27
34944,ಒಂದು,0,0,27,27
22598,zou,0,0,27,27
7191,pagina,2,25,2,27
8992,atroce,2,18,9,27
15221,вас,0,0,27,27
41791,eso,0,0,27,27
26299,sich,0,0,27,27
6577,via,2,7,20,27
31652,sind,0,0,27,27
25473,while,0,0,27,27
28172,يمكن,0,0,27,27
36069,στην,0,0,27,27
45381,за,0,0,27,27
30464,меня,0,0,27,27
49751,τι,0,0,27,27
21066,anglais,0,0,27,27
28041,gå,0,0,27,27
20923,otros,0,0,27,27
31607,åh,0,0,27,27
5955,all'interno,1,27,0,27
50811,surface,0,0,26,26
30740,very,0,0,26,26
15236,أنه,0,0,26,26
8132,artificiale,1,26,0,26
14266,aber,0,0,26,26
27450,än,0,0,26,26
8018,ogni,1,26,0,26
5904,times,2,4,22,26
3238,hey,2,5,21,26
15404,daha,0,0,26,26
40128,eles,0,0,26,26
16013,τόσο,0,0,26,26
11083,known,0,0,26,26
15326, million,0,0,26,26
14886,inglés,0,0,26,26
41166,είμαι,0,0,26,26
24459,ಆದರೆ,0,0,26,26
17139,αλλά,0,0,26,26
7063,diversi,1,26,0,26
42442,كل,0,0,26,26
28222,seus,0,0,26,26
5350,mamma,2,14,12,26
25964,amigos,0,0,26,26
35841,τους,0,0,26,26
5863,mondo,1,26,0,26
13293,быть,0,0,26,26
19243,अच्छा,0,0,26,26
26287,இல்லை,0,0,26,26
30198,mundo,0,0,26,26
47707,जब,0,0,26,26
52403,تم,0,0,26,26
20788,μην,0,0,26,26
51872,έχετε,0,0,26,26
48529,olduğunu,0,0,26,26
27905,problem,0,0,26,26
46023,für,0,0,26,26
29461,करता,0,0,26,26
5777,algoritmo,2,18,8,26
2786,argomenti,1,25,0,25
27266,after,0,0,25,25
21439,sehr,0,0,25,25
10386,información,0,0,25,25
29269,contenido,0,0,25,25
365,pane,1,25,0,25
3111,importante,2,12,13,25
21857,அவள்,0,0,25,25
21090,sätt,0,0,25,25
9612,made,0,0,25,25
18045,بعض,0,0,25,25
4924,ama,2,1,24,25
9389,எனவே,0,0,25,25
42444,annat,0,0,25,25
7983,diverse,2,22,3,25
42009,कई,0,0,25,25
41451,gut,0,0,25,25
40592,الإنجليزية,0,0,25,25
13818,bedeutet,0,0,25,25
18720,dessa,0,0,25,25
51579,could,0,0,25,25
9033,rock,2,3,22,25
8109,include,2,3,22,25
34452,слово,0,0,25,25
4064,c'è,1,25,0,25
12046,ஆனால்,0,0,25,25
33212,quelque,0,0,25,25
35741,enciclopédia,0,0,25,25
28342,tous,0,0,25,25
29574,something,0,0,25,25
41131,കഴിയും,0,0,25,25
12203,uit,0,0,25,25
50347,nous,0,0,25,25
8143,dici,1,25,0,25
1160,world,2,2,23,25
3642,creative,2,6,19,25
7467,aveva,1,25,0,25
43237,iets,0,0,25,25
30105,بشكل,0,0,25,25
46881,both,0,0,25,25
10677,werd,0,0,25,25
52750,κάτι,0,0,25,25
5855,sistemi,2,24,1,25
26696,wort,0,0,25,25
16038,था।,0,0,25,25
50832,ofta,0,0,25,25
7962,university,2,3,21,24
46879,प्राप्त,0,0,24,24
26933,estar,0,0,24,24
37007,этого,0,0,24,24
24766,doen,0,0,24,24
25064,у,0,0,24,24
18976,अंग्रेजी,0,0,24,24
2375,disse,2,2,22,24
37806,found,0,0,24,24
8312,visto,2,13,11,24
11394,notamment,0,0,24,24
9034,pages,2,1,23,24
41654,لك,0,0,24,24
4024,generalmente,2,23,1,24
24219,esto,0,0,24,24
4542,ottuso,1,24,0,24
8736,importa,2,9,15,24
42807,years,0,0,24,24
8654,fine,2,20,4,24
50536,diferentes,0,0,24,24
4391,volte,1,24,0,24
23737,få,0,0,24,24
8581,completamente,2,17,7,24
37723,outra,0,0,24,24
15421,उदाहरण,0,0,24,24
17429,अन्य,0,0,24,24
1644,pregiudizi,1,24,0,24
41060,artikelen,0,0,24,24
94,meno,1,24,0,24
23453,bland,0,0,24,24
47867,dag,0,0,24,24
50821,alguns,0,0,24,24
46409,pela,0,0,24,24
22942,estaba,0,0,24,24
4828,gnu,2,2,22,24
49603,process,0,0,24,24
17981,efter,0,0,24,24
44652,desde,0,0,24,24
20298,kommer,0,0,24,24
40726,sous,0,0,24,24
13742,automatique,0,0,24,24
16750,செய்ய,0,0,24,24
50021,hem,0,0,24,24
13424,users,0,0,24,24
13618,where,0,0,24,24
6400,fondazione,1,24,0,24
42027,within,0,0,24,24
11843,using,0,0,24,24
7864,quale,1,24,0,24
5183,journal,2,2,21,23
49188,meer,0,0,23,23
20431,first,0,0,23,23
39389,हूँ,0,0,23,23
43809,ಅವರು,0,0,23,23
14856,sans,0,0,23,23
1956,tale,2,19,4,23
185,sue,2,20,3,23
750,particolare,1,23,0,23
3900,editing,2,3,20,23
32133,words,0,0,23,23
19624,votre,0,0,23,23
14057,വിക്കിപീഡിയയിൽ,0,0,23,23
595,amici,1,23,0,23
16841,through,0,0,23,23
3712,modelli,1,23,0,23
1514,lento,2,4,19,23
27906,each,0,0,23,23
50582,هناك,0,0,23,23
4471,invece,1,23,0,23
29136,geen,0,0,23,23
39639,tão,0,0,23,23
21592,veya,0,0,23,23
43341,out,0,0,23,23
4743,spazio,1,23,0,23
49583,way,0,0,23,23
9974,much,0,0,23,23
20817,κάποιος,0,0,23,23
36064,kann,0,0,23,23
12546,nos,0,0,23,23
6882,quasi,1,23,0,23
37727,later,0,0,23,23
45207,nej,0,0,23,23
4852,fonte,2,17,6,23
20948,godt,0,0,23,23
25390,были,0,0,23,23
51271,including,0,0,23,23
6522,poi,1,23,0,23
4282,gennaio,1,23,0,23
51942,podem,0,0,23,23
35655,hoe,0,0,23,23
6232,deve,2,8,15,23
34193,ville,0,0,23,23
30872,ಯಾರಾದರೂ,0,0,23,23
25699,أي,0,0,23,23
2435,sulle,1,23,0,23
7945,affermato,1,23,0,23
43538,really,0,0,23,23
44346,också,0,0,23,23
8720,bias,2,3,20,23
32082,even,0,0,23,23
19701,sem,0,0,23,23
10625,gebruiken,0,0,23,23
46472,comment,0,0,23,23
5107,tuo,1,23,0,23
5442,persone,1,23,0,23
39871,tiene,0,0,23,23
31494,methods,0,0,22,22
14751,थे,0,0,22,22
42986,मेरे,0,0,22,22
31208,kannst,0,0,22,22
1686,intelligence,2,3,19,22
14402,विश्वकोश,0,0,22,22
24358,bara,0,0,22,22
31469,fantastisk,0,0,22,22
13359,​​,0,0,22,22
9246,hade,0,0,22,22
47407,outros,0,0,22,22
24331,just,0,0,22,22
287,see,2,1,21,22
39835,kadar,0,0,22,22
20549,utiliser,0,0,22,22
28035,विकिमीडिया,0,0,22,22
28415,то,0,0,22,22
5866,grado,2,21,1,22
19768,inteligente,0,0,22,22
47230,काम,0,0,22,22
10235,году,0,0,22,22
51561,başka,0,0,22,22
44056,edição,0,0,22,22
40754,denne,0,0,22,22
37371,करना,0,0,22,22
44121,ska,0,0,22,22
38487,alles,0,0,22,22
885,attraverso,1,22,0,22
35678,hij,0,0,22,22
1942,d'oro,1,22,0,22
41336,his,0,0,22,22
6042,enciclopedie,1,22,0,22
38738,வேண்டும்,0,0,22,22
49917,people,0,0,22,22
29314,என்ன,0,0,22,22
42594,användare,0,0,22,22
50097,является,0,0,22,22
14300,travail,0,0,22,22
46112,haar,0,0,22,22
16120,ಬಗ್ಗೆ,0,0,22,22
42920,otra,0,0,22,22
20123,от,0,0,22,22
41477,शुरू,0,0,22,22
38911,estava,0,0,22,22
5092,sotto,1,22,0,22
11334,المقالات,0,0,22,22
32526,использовать,0,0,22,22
43705,según,0,0,22,22
50390,menos,0,0,22,22
26770,projet,0,0,22,22
35008,moment,0,0,22,22
9338,proyecto,0,0,22,22
11421,text,0,0,22,22
15634,versions,0,0,22,22
50104,अपनी,0,0,21,21
43444,хорошо,0,0,21,21
10698,wirklich,0,0,21,21
49927,otras,0,0,21,21
26076,sources,0,0,21,21
34883,utan,0,0,21,21
4911,reti,1,21,0,21
40243,vraiment,0,0,21,21
33774,έχω,0,0,21,21
21472,hast,0,0,21,21
23235,reported,0,0,21,21
291,classificazione,1,21,0,21
2505,narcis,2,4,17,21
47489,depuis,0,0,21,21
42123,blev,0,0,21,21
8588,poco,2,9,12,21
3972,dello,1,21,0,21
37086,hat,0,0,21,21
22900,quand,0,0,21,21
11978,anlamına,0,0,21,21
29369,olarak,0,0,21,21
47248,sein,0,0,21,21
3576,posto,1,21,0,21
14767,göra,0,0,21,21
17101,ver,0,0,21,21
51088,peuvent,0,0,21,21
14771,விக்கிப்பீடியா,0,0,21,21
6247,lei,2,16,5,21
35214,അവൾ,0,0,21,21
6477,un'altra,1,21,0,21
3996,causa,2,20,1,21
32128,ನಿಜವಾಗಿಯೂ,0,0,21,21
51804,qué,0,0,21,21
40275,yüzden,0,0,21,21
46554,என்,0,0,21,21
50117,എന്ന,0,0,21,21
36443,kelime,0,0,21,21
39339,inglês,0,0,21,21
877,narciso,2,8,13,21
28160,том,0,0,21,21
41500,şey,0,0,21,21
50923,ese,0,0,21,21
1932,caratteristiche,1,21,0,21
23444,എന്നെ,0,0,21,21
29652,heeft,0,0,21,21
28135,generally,0,0,21,21
9274,foram,0,0,21,21
50465,οι,0,0,21,21
32717,ಅವಳು,0,0,21,21
27981,verwenden,0,0,21,21
20401,gerçekten,0,0,21,21
29097,classification,0,0,21,21
27969,mer,0,0,21,21
27670,നിങ്ങളെ,0,0,21,21
20380,go,0,0,21,21
32546,परियोजना,0,0,21,21
1504,tuttavia,1,21,0,21
32936,palabras,0,0,21,21
41143,até,0,0,21,21
22706,أكثر,0,0,21,21
51778,trabalho,0,0,21,21
35371,kun,0,0,21,21
12425,environment,0,0,21,21
26828,being,0,0,21,21
30703,എന്തെങ്കിലും,0,0,21,21
9474,använda,0,0,21,21
5829,alto,2,12,9,21
52175,finns,0,0,21,21
18414,mesmo,0,0,21,21
31486,related,0,0,21,21
20337,تقول,0,0,21,21
46367,atroz,0,0,21,21
7417,fosse,2,19,2,21
1770,examples,2,1,20,21
24309,field,0,0,21,21
15224,gøre,0,0,21,21
35570,είσαι,0,0,20,20
6180,sms,2,2,18,20
36709,changes,0,0,20,20
38353,algunas,0,0,20,20
41385,عندما,0,0,20,20
35481,यदि,0,0,20,20
5128,bbc,2,4,16,20
17907,ആ,0,0,20,20
47374,थी,0,0,20,20
23256,êtes,0,0,20,20
7845,tramite,1,20,0,20
17873,estás,0,0,20,20
3064,libro,2,15,5,20
45474,features,0,0,20,20
2846,public,2,1,19,20
21696,भाषा,0,0,20,20
23039,മറ്റൊരു,0,0,20,20
6677,supervisionato,1,20,0,20
24284,får,0,0,20,20
5690,flora,2,10,10,20
2758,systems,2,1,19,20
48645,mots,0,0,20,20
39661,tudo,0,0,20,20
8087,sarebbe,1,20,0,20
51854,rules,0,0,20,20
27554,व्यक्ति,0,0,20,20
2833,marion,2,2,18,20
8250,nota,2,6,14,20
16522,algorithm,0,0,20,20
5670,rivista,1,20,0,20
6023,già,1,20,0,20
3498,melissa,2,4,16,20
36058,projets,0,0,20,20
47505,automático,0,0,20,20
1355,frasi,1,20,0,20
8452,york,2,2,18,20
48539,يا,0,0,20,20
30333,vezes,0,0,20,20
41108,στη,0,0,20,20
12416,également,0,0,20,20
35438,certaines,0,0,20,20
20049,weet,0,0,20,20
1134,poiché,1,20,0,20
20504,suas,0,0,20,20
3057,dato,2,17,3,20
1602,source,2,2,18,20
50222,skal,0,0,20,20
44062,going,0,0,20,20
23994,क्योंकि,0,0,20,20
16237,manera,0,0,20,20
6258,licenza,1,20,0,20
48428,jemand,0,0,20,20
7532,tutte,1,20,0,20
24594,palavras,0,0,20,20
34163,tal,0,0,20,20
36731,estado,0,0,20,20
1262,cultura,2,15,5,20
9354,ils,0,0,19,19
19274,meu,0,0,19,19
35385,её,0,0,19,19
19353,wir,0,0,19,19
3344,includono,1,19,0,19
24928,website,0,0,19,19
19421,artikel,0,0,19,19
21644,गया।,0,0,19,19
1490,nuovi,1,19,0,19
37780,certain,0,0,19,19
40255,நன்றி,0,0,19,19
35471,संस्करण,0,0,19,19
39665,شيء,0,0,19,19
50191,ligne,0,0,19,19
25997,nin,0,0,19,19
35045,comunidade,0,0,19,19
133,piuttosto,1,19,0,19
4405,edit,2,1,18,19
29732,peu,0,0,19,19
3951,statistica,1,19,0,19
39627,obtuse,0,0,19,19
26761,personas,0,0,19,19
51627,based,0,0,19,19
26270,எப்படி,0,0,19,19
11454,mor,0,0,19,19
27974,particular,0,0,19,19
16027,engelskspråkiga,0,0,19,19
17830,cela,0,0,19,19
46029,community,0,0,19,19
42103,moet,0,0,19,19
12426,nogle,0,0,19,19
20096,hay,0,0,19,19
44666,जिसका,0,0,19,19
1880,qualità,1,19,0,19
14960,anden,0,0,19,19
32877,similar,0,0,19,19
39368,percent,0,0,19,19
41893,give,0,0,19,19
23421,fundación,0,0,19,19
12279,gör,0,0,19,19
6988,allora,1,19,0,19
36541,others,0,0,19,19
2980,contributori,1,19,0,19
26809,—,0,0,19,19
2704,casi,2,11,8,19
52070,different,0,0,19,19
23110,tiempo,0,0,19,19
13311,مع,0,0,19,19
8785,–,2,3,16,19
29637,время,0,0,19,19
8770,proprio,1,19,0,19
22293,पास,0,0,19,19
35660,этом,0,0,19,19
43041,όταν,0,0,19,19
29534,säger,0,0,19,19
46319,означает,0,0,19,19
49349,naturel,0,0,19,19
2677,essa,2,6,13,19
28327,vie,0,0,19,19
8702,american,2,1,18,19
28351,பற்றி,0,0,19,19
25874,वास्तव,0,0,19,19
39268,bent,0,0,18,18
13796,façon,0,0,18,18
34510,now,0,0,18,18
50800,original,0,0,18,18
45256,σαν,0,0,18,18
34111,millions,0,0,18,18
46710,ಆ,0,0,18,18
9916,fois,0,0,18,18
45179,جدًا,0,0,18,18
1841,quali,1,18,0,18
1814,testo,1,18,0,18
2167,chiedere,1,18,0,18
39226,എല്ലാ,0,0,18,18
40717,embora,0,0,18,18
40356,pays,0,0,18,18
38963,large,0,0,18,18
12338,ктото,0,0,18,18
10275,आपने,0,0,18,18
31453,அந்த,0,0,18,18
24404,могу,0,0,18,18
1554,partire,1,18,0,18
24328,उन,0,0,18,18
24323,arbejde,0,0,18,18
21665,im,0,0,18,18
21886,take,0,0,18,18
21888,dois,0,0,18,18
24470,através,0,0,18,18
50933,gaat,0,0,18,18
51932,antes,0,0,18,18
45743,español,0,0,18,18
20434,pelo,0,0,18,18
44700,mon,0,0,18,18
10928,चाहते,0,0,18,18
38740,said,0,0,18,18
50873,ihnen,0,0,18,18
15323,algunos,0,0,18,18
11088,wordt,0,0,18,18
21008,يعني,0,0,18,18
159,pagine,1,18,0,18
1701,mysql,2,2,16,18
19622,गए,0,0,18,18
22718,livre,0,0,18,18
44334,поэтому,0,0,18,18
37801,sitio,0,0,18,18
8367,license,2,1,17,18
43228,mismo,0,0,18,18
29496,bruge,0,0,18,18
19151,let,0,0,18,18
1080,metodo,1,18,0,18
52700,يجب,0,0,18,18
48429,einer,0,0,18,18
48795,нет,0,0,18,18
34345,without,0,0,18,18
6459,giorno,1,18,0,18
4397,mai,2,15,3,18
8940,generale,1,18,0,18
17804,trabajo,0,0,18,18
3095,quella,1,18,0,18
18105,since,0,0,18,18
8583,fonti,1,18,0,18
25658,contributors,0,0,18,18
18894,सभी,0,0,18,18
48203,form,0,0,18,18
49501,although,0,0,18,18
26620,vilket,0,0,18,18
8549,l'enciclopedia,1,18,0,18
2657,principalmente,2,11,7,18
942,vai,2,9,9,18
26505,où,0,0,18,18
25908,पता,0,0,18,18
4263,center,2,2,16,18
33300,ensemble,0,0,18,18
7449,cita,2,3,15,18
43778,они,0,0,18,18
18979,его,0,0,18,18
7522,server,2,12,6,18
16586,могут,0,0,18,18
16464,size,0,0,18,18
1016,quelle,2,12,6,18
16462,art,0,0,18,18
8306,situazione,1,18,0,18
27796,editions,0,0,18,18
48889,u,0,0,18,18
37649,حقًا,0,0,18,18
18215,år,0,0,18,18
7749,rispetto,1,18,0,18
25862,ಸ್ಮಾರ್ಟ್,0,0,18,18
1290,immagini,1,18,0,18
18863,manier,0,0,18,18
33662,existe,0,0,17,17
5178,rete,1,17,0,17
21692,kunne,0,0,17,17
17822,tid,0,0,17,17
44659,hej,0,0,17,17
34465,सबसे,0,0,17,17
21197,mucho,0,0,17,17
40098,न,0,0,17,17
34794,அவர்,0,0,17,17
35042,ಎಂದರೆ,0,0,17,17
10443,lad,0,0,17,17
12989,cualquier,0,0,17,17
39710,biraz,0,0,17,17
37481,vet,0,0,17,17
1958,create,2,3,14,17
15523,några,0,0,17,17
17601,ஸ்மார்ட்,0,0,17,17
14160,however,0,0,17,17
3145,mia,1,17,0,17
40459,मैंने,0,0,17,17
8426,d'acqua,1,17,0,17
26101,इसका,0,0,17,17
16765,bunu,0,0,17,17
5975,redattori,1,17,0,17
49244,κάνει,0,0,17,17
45956,sedan,0,0,17,17
16028,τώρα,0,0,17,17
20278,plusieurs,0,0,17,17
7237,riferimento,1,17,0,17
49115,என்பது,0,0,17,17
7884,nuovo,1,17,0,17
6429,siti,1,17,0,17
27038,स्मार्ट,0,0,17,17
11871,बाद,0,0,17,17
2595,ricercatori,1,17,0,17
21608,flera,0,0,17,17
31981,those,0,0,17,17
6221,principe,2,5,12,17
13700,idiomas,0,0,17,17
5410,utilizzato,1,17,0,17
52527,million,0,0,17,17
36189,igen,0,0,17,17
43477,только,0,0,17,17
16518,já,0,0,17,17
42132,كلمة,0,0,17,17
22848,väldigt,0,0,17,17
1099,sviluppo,1,17,0,17
18761,eram,0,0,17,17
23591,över,0,0,17,17
8211,molte,1,17,0,17
11156,políticas,0,0,17,17
50479,différentes,0,0,17,17
15287,models,0,0,17,17
45134,worden,0,0,17,17
35181,woorden,0,0,17,17
12677,mãe,0,0,17,17
16156,pessoa,0,0,17,17
51752,இருக்கிறேன்,0,0,17,17
51426,vandalism,0,0,17,17
48709,comunidad,0,0,17,17
6671,bomis,2,4,13,17
17321,നന്ദി,0,0,17,17
49658,लेखों,0,0,17,17
39018,same,0,0,17,17
16200,agora,0,0,17,17
6467,struttura,1,17,0,17
11612,cool,0,0,17,17
22615,during,0,0,17,17
4027,meglio,1,17,0,17
27664,ನಿಮ್ಮನ್ನು,0,0,17,17
14733,λέξεις,0,0,17,17
13272,estão,0,0,17,17
40595,akıllı,0,0,17,17
45656,lors,0,0,17,17
47472,எனக்கு,0,0,17,17
31467,சொல்,0,0,17,17
38000,يتم,0,0,17,17
25084,datos,0,0,17,17
24605,ja,0,0,17,17
5867,un'enciclopedia,1,17,0,17
38256,among,0,0,17,17
47673,ευχαριστώ,0,0,17,17
6858,vale,2,9,8,17
32449,vida,0,0,17,17
24433,material,0,0,17,17
10064,echt,0,0,17,17
19312,various,0,0,17,17
17592,சொல்லலாம்,0,0,17,17
47776,job,0,0,17,17
13127,vers,0,0,17,17
38293,ocean,0,0,17,17
6722,termini,1,17,0,17
29945,många,0,0,17,17
33890,tak,0,0,17,17
29696,इसलिए,0,0,17,17
28733,flummoxed,0,0,17,17
30938,есть,0,0,17,17
38828,ici,0,0,16,16
139,detto,1,16,0,16
35498,erg,0,0,16,16
671,premio,2,14,2,16
44368,há,0,0,16,16
37812,certains,0,0,16,16
757,fase,2,11,5,16
41602,wil,0,0,16,16
3511,alexa,2,1,15,16
40762,όχι,0,0,16,16
34522,système,0,0,16,16
20060,ऐसा,0,0,16,16
28618,मुफ्त,0,0,16,16
37204,वाले,0,0,16,16
5113,termine,1,16,0,16
661,stai,1,16,0,16
21944,obtuso,0,0,16,16
11073,fick,0,0,16,16
20947,making,0,0,16,16
17270,puis,0,0,16,16
50405,além,0,0,16,16
36864,ഇപ്പോൾ,0,0,16,16
49178,låt,0,0,16,16
22403,otro,0,0,16,16
8346,sui,1,16,0,16
6965,ga,2,1,15,16
6824,stupendo,1,16,0,16
32720,முடியும்,0,0,16,16
1411,chiamato,1,16,0,16
1146,dove,1,16,0,16
50635,mellan,0,0,16,16
7957,cluster,2,10,6,16
14411,partie,0,0,16,16
51336,ഇംഗ്ലീഷ്,0,0,16,16
36956,μπορώ,0,0,16,16
26856,eftersom,0,0,16,16
23223,может,0,0,16,16
21385,έχει,0,0,16,16
43589,right,0,0,16,16
934,livello,1,16,0,16
25124,zin,0,0,16,16
46531,species,0,0,16,16
48707,их,0,0,16,16
20519,ഏറ്റവും,0,0,16,16
6107,ancora,1,16,0,16
15776,ആരെങ്കിലും,0,0,16,16
2866,tali,1,16,0,16
46826,πρέπει,0,0,16,16
2937,dalle,1,16,0,16
19642,stupendous,0,0,16,16
7307,cose,1,16,0,16
41080,समय,0,0,16,16
2105,open,2,2,14,16
44229,آسف,0,0,16,16
2446,deep,2,6,10,16
29401,değil,0,0,16,16
30578,बार,0,0,16,16
32614,शामिल,0,0,16,16
35737,contributeurs,0,0,16,16
2123,dia,2,2,14,16
25140,पहले,0,0,16,16
23399,end,0,0,16,16
4628,avere,1,16,0,16
46972,january,0,0,16,16
15948,uns,0,0,16,16
51773,antal,0,0,16,16
2672,grandi,1,16,0,16
38582,artikeln,0,0,16,16
30509,நன்றாக,0,0,16,16
1553,ml,2,8,8,16
51277,പക്ഷേ,0,0,16,16
21133,bij,0,0,16,16
1605,seconda,1,16,0,16
15940,غير,0,0,16,16
14547,οπότε,0,0,16,16
9466,heel,0,0,16,16
18552,tack,0,0,16,16
4316,news,2,1,15,16
37419,wäre,0,0,16,16
25941,अब,0,0,16,16
20473,ಹೇಗೆ,0,0,16,16
10705,होता,0,0,16,16
16949,العمل,0,0,16,16
24084,மீண்டும்,0,0,16,16
24092,όπως,0,0,16,16
3108,sogno,1,16,0,16
24114,еще,0,0,16,16
2082,libero,1,16,0,16
14963,då,0,0,16,16
24252,ನಾವು,0,0,16,16
15686,hvordan,0,0,16,16
36343,space,0,0,16,16
727,programmazione,1,16,0,16
991,dati.,1,16,0,16
8724,compiti,1,16,0,16
47369,ut,0,0,16,16
30554,bijvoorbeeld,0,0,16,16
50605,chaque,0,0,16,16
37602,വിക്കിപീഡിയർ,0,0,16,16
9490,conception,0,0,16,16
34307,mest,0,0,16,16
3296,basato,1,16,0,16
626,fa,1,16,0,16
35041,σου,0,0,16,16
24380,என்னை,0,0,16,16
3307,social,2,5,11,16
2408,fornisce,1,16,0,16
23846,того,0,0,16,16
2321,successo,1,16,0,16
8582,cerca,2,5,11,16
7025,sommerso,1,16,0,16
23911,എങ്ങനെ,0,0,16,16
4300,versione,1,16,0,16
10243,γιατί,0,0,16,16
32765,according,0,0,16,16
5976,lista,2,1,15,16
35945,nach,0,0,16,16
14147,texto,0,0,16,16
21793,god,0,0,16,16
17049,ചില,0,0,16,16
51110,ir,0,0,16,16
14252,себя,0,0,16,16
13502,got,0,0,16,16
42432,ahora,0,0,16,16
32888,statistical,0,0,15,15
4171,io,1,15,0,15
15670,كما,0,0,15,15
50595,phrases,0,0,15,15
30865,start,0,0,15,15
7795,next,2,1,14,15
50591,ಅದ್ಭುತ,0,0,15,15
43494,हम,0,0,15,15
12207,википедию,0,0,15,15
7700,portato,1,15,0,15
11735,måste,0,0,15,15
52410,désolé,0,0,15,15
36355,कैसे,0,0,15,15
13301,hvor,0,0,15,15
15696,omdat,0,0,15,15
32044,tasks,0,0,15,15
11670,frases,0,0,15,15
6383,lingue,1,15,0,15
22879,einem,0,0,15,15
16450,considered,0,0,15,15
1847,creare,1,15,0,15
48832,ಏನು,0,0,15,15
6302,chiunque,1,15,0,15
29224,μπορείς,0,0,15,15
156,linguistiche,1,15,0,15
44435,जिसे,0,0,15,15
27878,वाक्यांश,0,0,15,15
3743,vari,1,15,0,15
16651,hacer,0,0,15,15
2338,classe,2,12,3,15
32369,artikler,0,0,15,15
20273,networks,0,0,15,15
78,enorme,2,7,8,15
12404,केवल,0,0,15,15
9757,learn,0,0,15,15
6679,review,2,1,14,15
7861,fin,2,1,14,15
7793,risultati,1,15,0,15
40178,keine,0,0,15,15
7781,facebook,2,3,12,15
22700,موسوعة,0,0,15,15
48983,üzgünüm,0,0,15,15
27372,portal,0,0,15,15
43445,इसकी,0,0,15,15
30244,होती,0,0,15,15
19559,அவர்கள்,0,0,15,15
51808,favor,0,0,15,15
12686,ലേഖനങ്ങൾ,0,0,15,15
2026,funzione,1,15,0,15
45395,supervised,0,0,15,15
37705,procent,0,0,15,15
44897,bana,0,0,15,15
39680,माँ,0,0,15,15
10278,सब,0,0,15,15
37302,använder,0,0,15,15
43136,modifications,0,0,15,15
37261,peux,0,0,15,15
4416,siano,1,15,0,15
8593,farlo,1,15,0,15
26201,janeiro,0,0,15,15
38716,слова,0,0,15,15
13630,mars,0,0,15,15
5984,gran,2,9,6,15
10984,before,0,0,15,15
37796,januari,0,0,15,15
38777,estados,0,0,15,15
8946,usando,2,7,8,15
4393,qualche,1,15,0,15
24503,ella,0,0,15,15
34686,todas,0,0,15,15
25670,gracias,0,0,15,15
5937,neurali,1,15,0,15
3375,l'uso,1,15,0,15
22248,avoir,0,0,15,15
31258,ter,0,0,15,15
45689,mindre,0,0,15,15
19241,இப்போது,0,0,15,15
5556,corso,2,14,1,15
33250,zoals,0,0,15,15
28825,había,0,0,15,15
37467,morgen,0,0,15,15
30353,ಧನ್ಯವಾದಗಳು,0,0,15,15
608,specie,1,15,0,15
8881,intelligenti,1,15,0,15
32464,الآن,0,0,15,15
35567,ένας,0,0,15,15
4752,teoria,1,15,0,15
17091,forms,0,0,15,15
41052,tell,0,0,15,15
2702,serie,2,8,7,15
16679,wilt,0,0,15,15
45128,administradores,0,0,15,15
25301,pouco,0,0,15,15
51521,qualité,0,0,15,15
34543,maintenant,0,0,15,15
27979,vamos,0,0,15,15
6809,libera,1,15,0,15
29280,política,0,0,15,15
32020,ನನ್ನನ್ನು,0,0,15,15
6507,allo,1,15,0,15
37910,»,0,0,15,15
46743,العديد,0,0,15,15
13250,αυτή,0,0,15,15
30814,conditions,0,0,15,15
2239,usato,1,15,0,15
7211,fuori,1,15,0,15
13794,अर्थ,0,0,15,15
10204,utilisé,0,0,15,15
45067,ಮಾಡಲು,0,0,15,15
8444,weekend,2,2,13,15
4227,colbert,2,2,13,15
50856,andre,0,0,15,15
40579,sometimes,0,0,15,15
16193,रही,0,0,15,15
2378,varie,2,14,1,15
20394,siento,0,0,14,14
3614,dvd,2,3,11,14
45412,tenho,0,0,14,14
4836,extra,2,2,12,14
22771,make,0,0,14,14
2258,bot,2,7,7,14
18249,देते,0,0,14,14
3618,seguito,1,14,0,14
13261,किये,0,0,14,14
35927,muitas,0,0,14,14
16561,न्यूपीडिया,0,0,14,14
22284,pesquisa,0,0,14,14
39529,ಕ್ಷಮಿಸಿ,0,0,14,14
32766,же,0,0,14,14
4694,arrabbiato,1,14,0,14
7187,oggi,1,14,0,14
7216,webby,2,4,10,14
39506,edits,0,0,14,14
21697,sí,0,0,14,14
7117,modifica,1,14,0,14
40038,feature,0,0,14,14
44488,ಸಾಧ್ಯವಿಲ್ಲ,0,0,14,14
61,performance,2,4,10,14
759,rna,2,3,11,14
33919,تكون,0,0,14,14
49134,geweldig,0,0,14,14
32698,undskyld,0,0,14,14
40063,popular,0,0,14,14
6537,tecniche,1,14,0,14
31330,யாராவது,0,0,14,14
3697,guida,1,14,0,14
20367,continue,0,0,14,14
17157,لذا,0,0,14,14
40892,stated,0,0,14,14
20658,estupendo,0,0,14,14
35934,ഓ,0,0,14,14
7319,utilizzati,1,14,0,14
12089,air,0,0,14,14
2392,pronuncia,2,13,1,14
10953,annan,0,0,14,14
44094,رقم,0,0,14,14
10750,encyclopedias,0,0,14,14
23932,oss,0,0,14,14
9299,शब्दों,0,0,14,14
47544,मतलब,0,0,14,14
23885,ihre,0,0,14,14
17714,point,0,0,14,14
38235,χρησιμοποιήσετε,0,0,14,14
48460,pueden,0,0,14,14
8528,gmat,2,2,12,14
38708,संस्थान,0,0,14,14
37237,hakkında,0,0,14,14
51041,total,0,0,14,14
26349,estudo,0,0,14,14
15653,мы,0,0,14,14
34428,type,0,0,14,14
29468,global,0,0,14,14
11057,ingen,0,0,14,14
9980,विकी,0,0,14,14
8504,carrozza,1,14,0,14
5097,esse,2,4,10,14
40391,satz,0,0,14,14
23698,zit,0,0,14,14
17346,sonra,0,0,14,14
1687,migliorare,1,14,0,14
49699,jetzt,0,0,14,14
48412,மற்றொரு,0,0,14,14
25846,onde,0,0,14,14
10570,θέλετε,0,0,14,14
43926,daar,0,0,14,14
40563,كيف,0,0,14,14
17506,possible,0,0,14,14
20992,página,0,0,14,14
47380,zaman,0,0,14,14
15817,¿qué,0,0,14,14
29746,editorial,0,0,14,14
52046,types,0,0,14,14
30936,puedo,0,0,14,14
29726,objet,0,0,14,14
29721,قد,0,0,14,14
124,september,2,1,13,14
24282,statistics,0,0,14,14
10174,animals,0,0,14,14
24262,devam,0,0,14,14
31787,hecho,0,0,14,14
3134,né,2,13,1,14
15840,narcissus,0,0,14,14
15851,embargo,0,0,14,14
19408,ओह,0,0,14,14
10470,மன்னிக்கவும்,0,0,14,14
29660,small,0,0,14,14
41553,après,0,0,14,14
10507,hvilket,0,0,14,14
31437,أنني,0,0,14,14
44687,أنك,0,0,14,14
38836,अच्छी,0,0,14,14
17327,biases,0,0,14,14
34850,last,0,0,14,14
30323,ಈಗ,0,0,14,14
44347,algumas,0,0,14,14
21423,help,0,0,14,14
2101,ottenuto,1,14,0,14
33012,veel,0,0,14,14
27197,более,0,0,14,14
46322,outras,0,0,14,14
18596,here,0,0,14,14
20708,linguistiques,0,0,14,14
16459,ويكيبيديا،,0,0,14,14
36453,dar,0,0,14,14
50614,ماذا,0,0,14,14
32190,κάποιον,0,0,14,14
27444,common,0,0,14,14
12159,grandes,0,0,14,14
1836,donne,2,7,7,14
7517,whatsapp,2,2,12,14
9645,después,0,0,14,14
6311,sciences,2,1,13,14
13665,εδώ,0,0,14,14
20324,முடியாது,0,0,14,14
388,output,2,6,8,14
6325,joseph,2,2,12,14
5088,semplicemente,1,14,0,14
12215,bist,0,0,14,14
2212,prestazioni,1,14,0,14
4594,difficile,2,8,6,14
41624,என்ற,0,0,14,14
36669,немного,0,0,14,14
40309,sujet,0,0,14,14
4460,naturale,1,14,0,14
40367,diesem,0,0,14,14
5479,mancanza,1,14,0,14
45146,δουλειά,0,0,14,14
16139,ta,0,0,14,14
15244,gelir,0,0,14,14
48606,analysis,0,0,14,14
26566,allt,0,0,14,14
5605,forse,1,14,0,14
33519,toda,0,0,14,14
26622,måde,0,0,14,14
41028,projetos,0,0,14,14
5129,animali,1,14,0,14
33541,അവർ,0,0,14,14
50629,helt,0,0,14,14
16283,temas,0,0,14,14
82,usa,2,3,11,14
39072,essen,0,0,14,14
7980,tipi,1,14,0,14
31678,problems,0,0,14,14
35290,når,0,0,14,14
32345,fra,0,0,14,14
43526,notion,0,0,14,14
49434,എന്താണ്,0,0,13,13
5352,comportamento,2,12,1,13
42639,इन,0,0,13,13
34882,über,0,0,13,13
34880,próxima,0,0,13,13
784,macchine,1,13,0,13
14495,auch,0,0,13,13
5087,soave,1,13,0,13
14712,brood,0,0,13,13
29804,обучения,0,0,13,13
30734,upp,0,0,13,13
29059,vídeo,0,0,13,13
51279,संख्या,0,0,13,13
17935,venner,0,0,13,13
45242,τις,0,0,13,13
29160,informations,0,0,13,13
6287,michael,2,3,10,13
6243,umana,1,13,0,13
6230,andare,1,13,0,13
21384,يناير,0,0,13,13
13945,mère,0,0,13,13
40104,matter,0,0,13,13
20783,servidores,0,0,13,13
2049,php,2,2,11,13
34950,unsupervised,0,0,13,13
29537,लाइसेंस,0,0,13,13
17808,amis,0,0,13,13
5698,tutta,1,13,0,13
14597,agudo,0,0,13,13
52444,estas,0,0,13,13
14255,informatie,0,0,13,13
14281,comida,0,0,13,13
2176,fu,1,13,0,13
3535,riconoscimento,1,13,0,13
29717,номер,0,0,13,13
42835,pão,0,0,13,13
2190,scusa,1,13,0,13
6668,riviste,1,13,0,13
24942,സ്മാർട്ട്,0,0,13,13
17113,terme,0,0,13,13
43720,care,0,0,13,13
31517,inteligentes,0,0,13,13
46882,licence,0,0,13,13
23652,sana,0,0,13,13
52139,παράδειγμα,0,0,13,13
8462,sto,1,13,0,13
32481,exempelvis,0,0,13,13
26243,quieres,0,0,13,13
23760,tellement,0,0,13,13
50496,pan,0,0,13,13
8513,fantastico,1,13,0,13
26208,lite,0,0,13,13
34144,major,0,0,13,13
8520,status,2,5,8,13
47062,فقط,0,0,13,13
10847,personne,0,0,13,13
10823,numéro,0,0,13,13
47090,eğer,0,0,13,13
8354,sai,2,12,1,13
26514,ಅನ್ನು,0,0,13,13
46395,food,0,0,13,13
4479,false,2,5,8,13
4582,revisione,1,13,0,13
1073,stop,2,1,12,13
36698,vidéo,0,0,13,13
2587,toefl,2,2,11,13
8050,piante,1,13,0,13
46641,friends,0,0,13,13
11479,july,0,0,13,13
31109,última,0,0,13,13
18774,எனக்குத்,0,0,13,13
51192,sendo,0,0,13,13
35657,svenskspråkiga,0,0,13,13
31888,vários,0,0,13,13
41040,gold,0,0,13,13
37006,maneira,0,0,13,13
37016,sætning,0,0,13,13
23465,därför,0,0,13,13
11243,tarafından,0,0,13,13
15967,versión,0,0,13,13
30899,preocupe,0,0,13,13
8584,mangiare,1,13,0,13
25991,biri,0,0,13,13
8960,consenso,2,3,10,13
41642,ли,0,0,13,13
4062,po,1,13,0,13
32421,tarde,0,0,13,13
48196,द,0,0,13,13
43915,όλα,0,0,13,13
9112,merci,0,0,13,13
24613,diğer,0,0,13,13
30224,riktigt,0,0,13,13
25092,active,0,0,13,13
24692,ಸ್ವಲ್ಪ,0,0,13,13
9941,حول,0,0,13,13
24750,unidos,0,0,13,13
1428,importanti,1,13,0,13
33297,less,0,0,13,13
37975,registrados,0,0,13,13
47820,decision,0,0,13,13
24427,nasıl,0,0,13,13
348,everything,2,1,12,13
30212,disso,0,0,13,13
25726,информации,0,0,13,13
15472,están,0,0,13,13
31732,rather,0,0,13,13
436,possa,2,9,4,13
10527,källor,0,0,13,13
43876,alt,0,0,13,13
37516,bunun,0,0,13,13
8713,utilizza,1,13,0,13
366,voglio,1,13,0,13
24351,important,0,0,13,13
15534,access,0,0,13,13
19255,modelo,0,0,13,13
10370,method,0,0,13,13
8806,narcisse,2,1,12,13
47371,think,0,0,13,13
8833,qual,2,6,7,13
37656,بين,0,0,13,13
50417,bread,0,0,13,13
20866,حتى,0,0,13,13
27147,varios,0,0,13,13
43185,vänner,0,0,13,13
49128,بالإنجليزية,0,0,13,13
27917,कार्य,0,0,13,13
22618,எனது,0,0,13,13
39463,الكلمة,0,0,13,13
1895,watch,2,1,12,13
49252,wird,0,0,13,13
2642,controllo,1,13,0,13
43076,हूं।,0,0,13,13
4805,proprietà,1,13,0,13
6930,cibo,1,13,0,13
27757,чем,0,0,13,13
28423,misin,0,0,13,13
16992,gaan,0,0,13,13
27749,olan,0,0,13,13
18250,ledsen,0,0,13,13
39215,techniques,0,0,13,13
45976,moeder,0,0,13,13
12565,redigeringar,0,0,13,13
925,email,2,3,10,13
22323,eten,0,0,13,13
36080,bom,0,0,13,13
12867,نيوبيديا,0,0,13,13
58,fair,2,5,8,13
4735,sapere,2,12,1,13
30847,voulez,0,0,13,13
4777,network,2,2,11,13
28044,day,0,0,13,13
50119,given,0,0,13,13
31649,også,0,0,13,13
3651,materiale,2,12,1,13
36012,об,0,0,13,13
2635,dispiace,1,13,0,13
14962,مقالة,0,0,13,13
7132,fino,2,12,1,13
43481,dizendo,0,0,13,13
22967,dieses,0,0,13,13
44398,ψωμί,0,0,13,13
12086,ചെയ്യാൻ,0,0,13,13
4660,scritto,1,13,0,13
49404,ihr,0,0,13,13
16423,parce,0,0,13,13
12187,melhor,0,0,13,13
174,automatico.,1,13,0,13
6688,troppo,1,13,0,13
12189,tüm,0,0,13,13
48995,dock,0,0,13,13
39896,december,0,0,13,13
22035,दो,0,0,13,13
14990,άλλο,0,0,13,13
30102,который,0,0,13,13
12307,bazı,0,0,13,13
1992,prix,2,2,11,13
13294,largest,0,0,13,13
7696,facendo,1,13,0,13
1868,superficie,1,13,0,13
5628,magazine,2,1,12,13
16566,siger,0,0,13,13
15027,comer,0,0,13,13
20629,proyectos,0,0,12,12
2457,miei,1,12,0,12
41482,manière,0,0,12,12
17119,varit,0,0,12,12
3279,gentile,1,12,0,12
20626,fragen,0,0,12,12
5233,microsoft,2,3,9,12
3097,versioni,1,12,0,12
17741,veces,0,0,12,12
51569,കഴിയുന്ന,0,0,12,12
3342,aver,1,12,0,12
17147,long,0,0,12,12
50081,energy,0,0,12,12
17406,جيدًا,0,0,12,12
15553,потому,0,0,12,12
14598,red,0,0,12,12
14872,നിങ്ങളോട്,0,0,12,12
17991,haciendo,0,0,12,12
18461,أفضل,0,0,12,12
17959,obtus,0,0,12,12
2542,andrew,2,4,8,12
41100,real,0,0,12,12
43408,gjort,0,0,12,12
42965,വിക്കിപീഡിയയിലെ,0,0,12,12
34506,മികച്ച,0,0,12,12
16166,теперь,0,0,12,12
18843,toutes,0,0,12,12
2735,report,2,1,11,12
31551,dictionary,0,0,12,12
3306,maggiore,1,12,0,12
16322,vinkel,0,0,12,12
15053,طريقة,0,0,12,12
18661,mother,0,0,12,12
41811,edición,0,0,12,12
51332,விரும்பினால்,0,0,12,12
16576,स्रोत,0,0,12,12
15965,created,0,0,12,12
50092,cas,0,0,12,12
43839,έτσι,0,0,12,12
41332,ಓಹ್,0,0,12,12
2753,programma,2,10,2,12
42865,resultado,0,0,12,12
19112,concept,0,0,12,12
15397,βίντεο,0,0,12,12
19083,सॉफ्टवेयर,0,0,12,12
15336,nom,0,0,12,12
16612,lakes,0,0,12,12
14723,étaient,0,0,12,12
51276,समुदाय,0,0,12,12
42186,ठीक,0,0,12,12
33916,enquanto,0,0,12,12
2568,rilevamento,1,12,0,12
34820,ll,0,0,12,12
6236,international,2,1,11,12
8294,funzionalità,1,12,0,12
11387,उन्हें,0,0,12,12
52176,accuracy,0,0,12,12
29439,നിന്ന്,0,0,12,12
36985,aquí,0,0,12,12
51856,उपयोगकर्ताओं,0,0,12,12
49695,though,0,0,12,12
30739,atrocious,0,0,12,12
38955,modèle,0,0,12,12
48614,वीडियो,0,0,12,12
46825,ile,0,0,12,12
11166,കഴിയില്ല,0,0,12,12
30797,dies,0,0,12,12
4470,quantità,1,12,0,12
8315,crescita,1,12,0,12
23643,फिर,0,0,12,12
37089,другие,0,0,12,12
38804,सर्वर,0,0,12,12
37122,saying,0,0,12,12
23745,उपलब्ध,0,0,12,12
26383,mal,0,0,12,12
37186,français,0,0,12,12
28698,règles,0,0,12,12
665,attività,1,12,0,12
26614,muazzam,0,0,12,12
46056,hayır,0,0,12,12
36799,sehen,0,0,12,12
12413,مما,0,0,12,12
22764,should,0,0,12,12
12278,score,0,0,12,12
5624,scientifiche,1,12,0,12
3724,pena,2,4,8,12
380,ricerche,1,12,0,12
35790,angle,0,0,12,12
29596,development,0,0,12,12
7943,heller,2,1,11,12
22924,عبارة,0,0,12,12
7959,cache,2,4,8,12
39080,fut,0,0,12,12
7968,policy,2,1,11,12
35786,شيئًا,0,0,12,12
8005,lavori,1,12,0,12
26777,avait,0,0,12,12
23081,mejor,0,0,12,12
32527,जाने,0,0,12,12
8140,bene.,1,12,0,12
36961,muchas,0,0,12,12
46462,informações,0,0,12,12
23252,nada,0,0,12,12
5154,tuoi,1,12,0,12
50489,milhões,0,0,12,12
3964,nello,1,12,0,12
4176,migliori,1,12,0,12
25450,poderia,0,0,12,12
24680,أيضًا,0,0,12,12
52669,beaucoup,0,0,12,12
5499,esiste,1,12,0,12
9756,documentation,0,0,12,12
35392,mayor,0,0,12,12
9703,पृष्ठ,0,0,12,12
49570,prendre,0,0,12,12
49568,harika,0,0,12,12
4296,melli,2,2,10,12
38022,güzel,0,0,12,12
26286,الكلمات,0,0,12,12
9453,plants,0,0,12,12
5505,seigenthaler,2,5,7,12
9443,தெரியும்,0,0,12,12
4893,principale,1,12,0,12
48197,généralement,0,0,12,12
37799,growth,0,0,12,12
35430,twee,0,0,12,12
9268,होने,0,0,12,12
6532,medio,2,4,8,12
48138,ραντεβού,0,0,12,12
30760,eksempel,0,0,12,12
25652,berätta,0,0,12,12
24586,aus,0,0,12,12
10152,നമ്പർ,0,0,12,12
23879,под,0,0,12,12
10782,havde,0,0,12,12
47117,مقال,0,0,12,12
10761,देने,0,0,12,12
6217,abbia,1,12,0,12
23945,bidrag,0,0,12,12
1607,chiamati,1,12,0,12
38591,final,0,0,12,12
8613,acqua,1,12,0,12
24062,issues,0,0,12,12
30921,zum,0,0,12,12
10429,تعني,0,0,12,12
781,prossima,1,12,0,12
34172,virkelig,0,0,12,12
10382,zorgen,0,0,12,12
24355,phase,0,0,12,12
35285,algoritmos,0,0,12,12
24469,climate,0,0,12,12
5496,lucene,2,4,8,12
24478,history,0,0,12,12
47495,ചെയ്യുന്നു,0,0,12,12
36679,спасибо,0,0,12,12
30313,afin,0,0,12,12
3692,capito,1,12,0,12
7492,errori,1,12,0,12
13447,pain,0,0,12,12
13443,видео,0,0,12,12
34561,thank,0,0,12,12
21686,moi,0,0,12,12
3529,harvard,2,3,9,12
4687,palo,2,3,9,12
30056,kind,0,0,12,12
34430,links,0,0,12,12
13386,जाते,0,0,12,12
36274,ನಂತರ,0,0,12,12
29822,хотите,0,0,12,12
27525,demander,0,0,12,12
31335,structure,0,0,12,12
36393,vrienden,0,0,12,12
50161,مقالات,0,0,12,12
22002,تريد,0,0,12,12
22055,tidigare,0,0,12,12
29792,vais,0,0,12,12
33489,stor,0,0,12,12
45354,trop,0,0,12,12
5832,facile,2,10,2,12
5659,aree,1,12,0,12
35930,lado,0,0,12,12
20998,great,0,0,12,12
874,angolo,1,12,0,12
30448,souvent,0,0,12,12
14225,gang,0,0,12,12
30059,എന്നാൽ,0,0,12,12
34826,للغاية,0,0,12,12
7113,categoria,2,10,2,12
13967,tip,0,0,12,12
2081,relativamente,2,10,2,12
30426,leurs,0,0,12,12
5648,acuto,1,12,0,12
27787,nem,0,0,12,12
4806,globale,2,10,2,12
27750,sob,0,0,12,12
40237,grand,0,0,12,12
32048,dieser,0,0,12,12
32605,discussão,0,0,12,12
13180,normal,0,0,12,12
48081,name,0,0,12,12
36498,encontro,0,0,12,12
7685,france,2,1,11,12
34595,dollars,0,0,12,12
31211,действительно,0,0,12,12
45688,contributions,0,0,12,12
1975,laghi,1,12,0,12
12856,इंटरनेट,0,0,12,12
27332,grymt,0,0,12,12
36487,gehen,0,0,12,12
27140,tun,0,0,12,12
602,principali,1,12,0,12
1944,utilizzando,1,12,0,12
7847,lungo,1,12,0,12
48894,hommes,0,0,12,12
7622,technology,2,1,11,12
35799,أنت,0,0,12,12
37490,wikipediaorg,0,0,11,11
25541,കൂടുതൽ,0,0,11,11
6580,copyright,2,5,6,11
25643,परेशान,0,0,11,11
7270,',1,11,0,11
4715,dizionario,1,11,0,11
4713,economist,2,1,10,11
49093,mes,0,0,11,11
52097,tot,0,0,11,11
28373,tror,0,0,11,11
8749,eseguire,1,11,0,11
8680,artificiali,1,11,0,11
30199,projects,0,0,11,11
37533,críticas,0,0,11,11
6860,applicazioni,1,11,0,11
7320,trovare,1,11,0,11
6590,basati,1,11,0,11
4560,john,2,5,6,11
31556,processus,0,0,11,11
1345,dicendo,1,11,0,11
26593,medan,0,0,11,11
36103,además,0,0,11,11
43275,φράση,0,0,11,11
16829,internal,0,0,11,11
32414,minutes,0,0,11,11
52044,थे।,0,0,11,11
27088,häpnadsväckande,0,0,11,11
9110,april,0,0,11,11
35938,intelligent,0,0,11,11
870,alta,2,6,5,11
49475,application,0,0,11,11
2667,punti,1,11,0,11
35792,viel,0,0,11,11
28142,часто,0,0,11,11
25417,grupo,0,0,11,11
27236,did,0,0,11,11
532,interesse,2,6,5,11
33753,communauté,0,0,11,11
7766,domanda,1,11,0,11
4772,fai,1,11,0,11
8981,inoltre,1,11,0,11
16846,cuenta,0,0,11,11
15812,semana,0,0,11,11
6959,li,2,9,2,11
6861,concetto,1,11,0,11
18372,best,0,0,11,11
18602,travers,0,0,11,11
6842,stessa,1,11,0,11
37447,सामग्री,0,0,11,11
28724,வேண்டாம்,0,0,11,11
48980,sen,0,0,11,11
4872,award,2,1,10,11
35643,ni,0,0,11,11
26362,représentation,0,0,11,11
42081,written,0,0,11,11
27521,perform,0,0,11,11
28436,instead,0,0,11,11
37080,him,0,0,11,11
30888,கொள்ளுங்கள்,0,0,11,11
43723,حيث,0,0,11,11
43722,three,0,0,11,11
26606,тебе,0,0,11,11
5121,dell'intelligenza,1,11,0,11
5694,list,2,3,8,11
407,dispositivi,1,11,0,11
28653,través,0,0,11,11
43036,conversation,0,0,11,11
37026,approach,0,0,11,11
2618,standard,2,6,5,11
8276,national,2,1,10,11
26546,mij,0,0,11,11
16472,interaction,0,0,11,11
27442,देता,0,0,11,11
30535,هنا,0,0,11,11
8196,politiche,1,11,0,11
49313,us,0,0,11,11
6531,post,2,4,7,11
41698,மூலம்,0,0,11,11
26095,şeyi,0,0,11,11
4691,gruppo,1,11,0,11
1015,volontari,1,11,0,11
50514,உங்களை,0,0,11,11
8616,citato,1,11,0,11
84,umano,1,11,0,11
8101,esseri,1,11,0,11
34244,πώς,0,0,11,11
18217,burada,0,0,11,11
15955,langues,0,0,11,11
5585,wikidata,2,1,10,11
15961,toen,0,0,11,11
26151,யாரோ,0,0,11,11
17132,researchers,0,0,11,11
30854,quality,0,0,11,11
48943,слов,0,0,11,11
30531,रोटी,0,0,11,11
50494,videon,0,0,11,11
33722,permet,0,0,11,11
26674,ஓ,0,0,11,11
15997,reference,0,0,11,11
50493,μαζί,0,0,11,11
43087,why,0,0,11,11
7590,preso,2,9,2,11
1214,business,2,3,8,11
7375,act,2,2,9,11
30940,feito,0,0,11,11
32918,είστε,0,0,11,11
3205,mezzo,1,11,0,11
32982,hele,0,0,11,11
2314,previsioni,1,11,0,11
5036,amministratori,1,11,0,11
14899,ശരിക്കും,0,0,11,11
5101,definizione,1,11,0,11
12703,class,0,0,11,11
44476,afschuwelijk,0,0,11,11
1928,support,2,1,10,11
22465,altın,0,0,11,11
12735,querida,0,0,11,11
5882,basata,1,11,0,11
600,caratteristica,1,11,0,11
44491,nombreux,0,0,11,11
45755,view,0,0,11,11
308,ellie,2,2,9,11
39737,sabe,0,0,11,11
49801,stump,0,0,11,11
35022,जानकारी,0,0,11,11
33918,ഞങ്ങൾ,0,0,11,11
3709,l'articolo,1,11,0,11
48068,zal,0,0,11,11
5446,pizza,2,2,9,11
11666,detection,0,0,11,11
11777,cependant,0,0,11,11
330,noto,1,11,0,11
23094,became,0,0,11,11
32226,πεις,0,0,11,11
6009,consiglio,1,11,0,11
46314,कहा,0,0,11,11
40954,siempre,0,0,11,11
29557,dieu,0,0,11,11
12031,καλά,0,0,11,11
46284,aqui,0,0,11,11
39285,πραγματικά,0,0,11,11
22925,βικιπαίδεια,0,0,11,11
1860,macchina,1,11,0,11
29602,entanto,0,0,11,11
39754,ago,0,0,11,11
39800,لكن,0,0,11,11
42815,würde,0,0,11,11
14046,വാക്കുകൾ,0,0,11,11
14639,descartes,0,0,11,11
20764,samma,0,0,11,11
45159,सुस्त,0,0,11,11
20768,nee,0,0,11,11
45051,layer,0,0,11,11
51596,استخدام,0,0,11,11
32880,tres,0,0,11,11
51630,around,0,0,11,11
13760,जानते,0,0,11,11
3385,approccio,1,11,0,11
21043,diese,0,0,11,11
3331,machines,2,1,10,11
40535,ಬಯಸಿದರೆ,0,0,11,11
21001,vragen,0,0,11,11
14370,laten,0,0,11,11
32014,ആണ്,0,0,11,11
45191,ask,0,0,11,11
21394,zich,0,0,11,11
22075,данных,0,0,11,11
31344,várias,0,0,11,11
31266,toujours,0,0,11,11
20510,परियोजनाओं,0,0,11,11
13260,şimdi,0,0,11,11
40847,சொல்ல,0,0,11,11
39931,principal,0,0,11,11
3562,disponibili,1,11,0,11
17739,fueron,0,0,11,11
40052,فإن,0,0,11,11
13727,innehåll,0,0,11,11
40095,ನಾರ್ಸಿಸಾ,0,0,11,11
30405,உங்களிடம்,0,0,11,11
45382,critiques,0,0,11,11
29836,कम,0,0,11,11
40203,incrível,0,0,11,11
52673,ditt,0,0,11,11
50180,depois,0,0,11,11
11419,संस्करणों,0,0,11,11
11928,année,0,0,11,11
11366,estudio,0,0,11,11
47103,regression,0,0,11,11
15528,எண்,0,0,11,11
47340,один,0,0,11,11
47277,மேலும்,0,0,11,11
19705,día,0,0,11,11
42531,இங்கே,0,0,11,11
41356,ويلز,0,0,11,11
24057,dados,0,0,11,11
15524,ഉപയോഗിക്കാൻ,0,0,11,11
1600,seria,2,2,9,11
30628,पूरी,0,0,11,11
38999,création,0,0,11,11
32290,यहाँ,0,0,11,11
3986,today,2,1,10,11
10717,having,0,0,11,11
502,temo,2,6,5,11
23900,देख,0,0,11,11
17882,soit,0,0,11,11
19684,bonne,0,0,11,11
51341,அதாவது,0,0,11,11
706,senso,2,10,1,11
50610,realizado,0,0,11,11
28906,few,0,0,11,11
28982,ccbysa,0,0,11,11
6401,legge,1,11,0,11
52020,métodos,0,0,11,11
43012,nein,0,0,11,11
5524,lentamente,2,9,2,11
41489,available,0,0,11,11
47753,must,0,0,11,11
42930,results,0,0,11,11
9845,enligt,0,0,11,11
3113,banco,2,3,8,11
10022,websites,0,0,11,11
33333,nombreuses,0,0,11,11
24618,modifier,0,0,11,11
47541,werk,0,0,11,11
4953,contributi,1,11,0,11
41211,questions,0,0,11,11
24006,order,0,0,11,11
41194,pedir,0,0,11,11
4989,approcci,1,11,0,11
4977,hg,2,2,9,11
20071,avant,0,0,11,11
42544,ಜೌಗು,0,0,11,11
23578,usually,0,0,11,11
29331,beispiel,0,0,11,11
42548,mutter,0,0,11,11
38889,atmosphere,0,0,11,11
11113,obrigado,0,0,11,11
38907,wikipediaartiklar,0,0,11,11
50749,करें,0,0,11,11
29354,मदद,0,0,11,11
1719,Wikipedia,1,11,0,11
11340,वेल्स,0,0,11,11
1733,lavorare,1,11,0,11
23656,एवं,0,0,11,11
6140,pattern,2,6,5,11
47010,ولكن,0,0,11,11
15335,reste,0,0,11,11
23675,wörter,0,0,11,11
1649,lettori,1,11,0,11
46916,سبيل,0,0,11,11
38763,países,0,0,11,11
47038,idea,0,0,11,11
10958,contenidos,0,0,11,11
38723,plaats,0,0,11,11
47006,predictions,0,0,11,11
49263,represented,0,0,10,10
6758,certo,2,9,1,10
6376,solito,1,10,0,10
32747,verkligen,0,0,10,10
5111,ip,2,1,9,10
6611,chi,1,10,0,10
5720,obama,2,1,9,10
5885,inglese.,1,10,0,10
2784,buon,2,9,1,10
32775,outro,0,0,10,10
5861,buona,1,10,0,10
4915,varietà,1,10,0,10
5076,luglio,1,10,0,10
49748,ഉദാഹരണത്തിന്,0,0,10,10
42755,neural,0,0,10,10
4970,gratuita,2,5,5,10
16920,fonctionnement,0,0,10,10
42792,fortælle,0,0,10,10
51266,etc,0,0,10,10
49755,inputs,0,0,10,10
43224,«нупедии»,0,0,10,10
43161,लगभग,0,0,10,10
5701,nell'apprendimento,1,10,0,10
17348,μητέρα,0,0,10,10
5957,"wikipedia,",1,10,0,10
49826,trouve,0,0,10,10
6186,regressione,1,10,0,10
2850,verso,1,10,0,10
6770,propria,1,10,0,10
49813,मुख्य,0,0,10,10
6969,fornire,1,10,0,10
44751,både,0,0,10,10
50314,learned,0,0,10,10
11188,licença,0,0,10,10
12172,வேலை,0,0,10,10
44384,مرة,0,0,10,10
15044,parfois,0,0,10,10
15047,قبل,0,0,10,10
3775,link,2,3,7,10
15057,diz,0,0,10,10
15154,ναρκίσσα,0,0,10,10
50759,gemaakt,0,0,10,10
11309,subject,0,0,10,10
15272,பின்னர்,0,0,10,10
46792,law,0,0,10,10
15305,maioria,0,0,10,10
11167,janvier,0,0,10,10
32641,tienes,0,0,10,10
3910,settembre,1,10,0,10
11143,участники,0,0,10,10
11124,свою,0,0,10,10
3936,decisioni,1,10,0,10
15442,tinha,0,0,10,10
47116,liv,0,0,10,10
10711,izin,0,0,10,10
33352,sure,0,0,10,10
47445,vision,0,0,10,10
5311,parti,2,7,3,10
10225,disputas,0,0,10,10
10186,têm,0,0,10,10
50831,topics,0,0,10,10
3725,primi,1,10,0,10
12446,konsensus,0,0,10,10
44458,geven,0,0,10,10
44830,الذكية,0,0,10,10
44919,internautes,0,0,10,10
44936,خلال,0,0,10,10
45028,público,0,0,10,10
3422,controversie,1,10,0,10
13926,theory,0,0,10,10
13735,onder,0,0,10,10
13697,istället,0,0,10,10
13493,الأخرى,0,0,10,10
3536,cinque,1,10,0,10
3284,bella,1,10,0,10
13364,ويكي,0,0,10,10
45472,association,0,0,10,10
13222,निर्माण,0,0,10,10
3588,aperta,1,10,0,10
50897,होगा,0,0,10,10
33556,ಇಲ್ಲ,0,0,10,10
44504,स्थिति,0,0,10,10
3630,scoperta,1,10,0,10
51058,dream,0,0,10,10
12739,engelska,0,0,10,10
12730,दिन,0,0,10,10
3679,apprendimento.,1,10,0,10
12508,search,0,0,10,10
3688,linea,1,10,0,10
51137,ಬ್ರೆಡ್,0,0,10,10
10154,nécessaire,0,0,10,10
4095,zone,2,5,5,10
16117,svenska,0,0,10,10
8150,raccolta,1,10,0,10
43599,nur,0,0,10,10
50438,enero,0,0,10,10
8000,lenta,2,3,7,10
31679,premier,0,0,10,10
7994,lih,2,4,6,10
2992,facilmente,2,8,2,10
48767,അടുത്ത,0,0,10,10
7899,dell'enciclopedia,1,10,0,10
7856,barack,2,1,9,10
4604,logica,1,10,0,10
48955,बात,0,0,10,10
31658,serait,0,0,10,10
48956,too,0,0,10,10
48973,υπάρχει,0,0,10,10
72,sé,2,3,7,10
7438,pubblicazioni,1,10,0,10
7384,cara,2,9,1,10
7373,esperti,1,10,0,10
7316,risposta,1,10,0,10
16590,outer,0,0,10,10
4730,contro,1,10,0,10
4742,considera,2,5,5,10
7178,bello,1,10,0,10
62,imparare,1,10,0,10
8166,messaggio,1,10,0,10
33224,waar,0,0,10,10
9966,मिला,0,0,10,10
5604,stavi,1,10,0,10
43992,développement,0,0,10,10
9680,dank,0,0,10,10
47817,certeza,0,0,10,10
9494,laws,0,0,10,10
3099,potrebbero,1,10,0,10
9372,communautés,0,0,10,10
47994,guld,0,0,10,10
9358,okay,0,0,10,10
15753,можешь,0,0,10,10
43930,ക്ഷമിക്കണം,0,0,10,10
48107,раз,0,0,10,10
9122,सम्बंधित,0,0,10,10
15792,traag,0,0,10,10
15794,الفيديو,0,0,10,10
50559,wrote,0,0,10,10
5529,sconcertato,1,10,0,10
4322,clima,1,10,0,10
8691,database,2,6,4,10
8651,quelli,1,10,0,10
8640,figlia,1,10,0,10
8624,es.,1,10,0,10
8459,chiedendo,1,10,0,10
31711,يكون,0,0,10,10
8402,notizie,1,10,0,10
48548,πιο,0,0,10,10
11064,deras,0,0,10,10
52544,enkele,0,0,10,10
37523,almost,0,0,10,10
40541,philosophie,0,0,10,10
26691,अंत,0,0,10,10
40570,உங்களுக்குத்,0,0,10,10
31593,تحرير,0,0,10,10
36662,mim,0,0,10,10
20265,நல்லது,0,0,10,10
38778,tengo,0,0,10,10
1297,simili,1,10,0,10
20280,जिन्हें,0,0,10,10
51769,вместо,0,0,10,10
27059,temps,0,0,10,10
22239,തന്നെ,0,0,10,10
38825,things,0,0,10,10
34592,bort,0,0,10,10
36228,accord,0,0,10,10
20852,ಕೆಲವು,0,0,10,10
27054,разделов,0,0,10,10
34261,teşekkür,0,0,10,10
1965,male,2,3,7,10
378,dispiace.,1,10,0,10
19201,υπέροχο,0,0,10,10
41670,чтото,0,0,10,10
37383,चिंता,0,0,10,10
42306,بدلاً,0,0,10,10
36243,некоторые,0,0,10,10
2686,scientifica,1,10,0,10
52089,imagens,0,0,10,10
30480,fras,0,0,10,10
21160,algorithmes,0,0,10,10
39900,mis,0,0,10,10
30457,erreurs,0,0,10,10
18190,பயன்படுத்தக்கூடிய,0,0,10,10
52040,toute,0,0,10,10
52295,bedankt,0,0,10,10
21113,جميع,0,0,10,10
1659,confuso,2,4,6,10
23274,വിക്കിപീഡിയയുടെ,0,0,10,10
920,oxford,2,2,8,10
41026,வேறு,0,0,10,10
1875,programming,2,1,9,10
37147,didn,0,0,10,10
18234,vue,0,0,10,10
1666,pigro,1,10,0,10
27009,во,0,0,10,10
40641,ancak,0,0,10,10
51527,usage,0,0,10,10
33856,versões,0,0,10,10
25094,मूल,0,0,10,10
18667,тебя,0,0,10,10
36354,ki,0,0,10,10
20389,l’idée,0,0,10,10
39502,അങ്ങനെ,0,0,10,10
18673,англ,0,0,10,10
34687,covered,0,0,10,10
2570,scopo,1,10,0,10
719,far,2,3,7,10
26786,millones,0,0,10,10
36868,முடியுமா,0,0,10,10
25089,ob,0,0,10,10
585,deutschland,2,3,7,10
20461,encore,0,0,10,10
2306,autori,1,10,0,10
40880,bon,0,0,10,10
41966,varför,0,0,10,10
39519,humaine,0,0,10,10
40895,langue,0,0,10,10
1901,poche,1,10,0,10
28103,voir,0,0,10,10
41800,منذ,0,0,10,10
18610,χρυσό,0,0,10,10
2223,acceso,2,5,5,10
1957,motivo,2,5,5,10
1271,prodotto,1,10,0,10
28706,denk,0,0,10,10
38881,november,0,0,10,10
28319,которую,0,0,10,10
19688,cansado,0,0,10,10
42148,möte,0,0,10,10
35816,body,0,0,10,10
30327,mein,0,0,10,10
31557,بعد,0,0,10,10
40966,rigtig,0,0,10,10
18545,acesso,0,0,10,10
40953,negative,0,0,10,10
30186,living,0,0,10,10
29162,program,0,0,10,10
18951,അവൻ,0,0,10,10
36786,leven,0,0,10,10
34047,applications,0,0,10,10
25249,examen,0,0,10,10
51982,møde,0,0,10,10
19330,mere,0,0,10,10
28959,तुम,0,0,10,10
27263,utilisation,0,0,10,10
34485,ऑनलाइन,0,0,10,10
29456,inglesa,0,0,10,10
558,italiano,2,5,5,10
21344,ಪದವನ್ನು,0,0,10,10
40070,fontes,0,0,10,10
1370,po',1,10,0,10
257,presenti,1,10,0,10
1457,dicembre,1,10,0,10
17887,casos,0,0,10,10
38628,चाहता,0,0,10,10
29317,ellos,0,0,10,10
30081,gebruikt,0,0,10,10
20040,wide,0,0,10,10
21797,sætninger,0,0,10,10
39334,έξυπνη,0,0,10,10
25600,இருக்கும்,0,0,10,10
25613,topic,0,0,10,10
21746,أستطيع,0,0,10,10
34309,published,0,0,10,10
21737,pendant,0,0,10,10
17760,seen,0,0,10,10
25419,bots,0,0,10,10
2430,genere,2,7,3,10
34170,organisms,0,0,10,10
21506,stedet,0,0,10,10
39247,можно,0,0,10,10
41348,own,0,0,10,10
21477,nas,0,0,10,10
1468,riferito,1,10,0,10
17690,fondation,0,0,10,10
2413,propose,2,1,9,10
34795,function,0,0,10,10
1033,biografia,2,8,2,10
1163,golden,2,1,9,10
24790,étude,0,0,10,10
28998,bidragsgivare,0,0,10,10
41320,ibland,0,0,10,10
1591,pensare,1,10,0,10
17880,നന്നായി,0,0,10,10
39313,areas,0,0,10,10
34490,tog,0,0,10,10
23921,raison,0,0,10,10
34492,came,0,0,10,10
25343,lack,0,0,10,10
28661,signal,0,0,10,10
29558,दी,0,0,10,10
39140,problemas,0,0,10,10
688,dell'università,1,10,0,10
650,comuni,1,10,0,10
1780,linee,1,10,0,10
42489,sina,0,0,10,10
38682,मेरी,0,0,10,10
41079,nouvelle,0,0,10,10
26372,ಅದರ,0,0,10,10
25346,تفعل,0,0,10,10
751,guardian,2,3,7,10
21913,ಬಳಸಬಹುದಾದ,0,0,10,10
1327,segnale,1,10,0,10
41114,استخدامها,0,0,10,10
39341,medical,0,0,10,10
40384,ud,0,0,10,10
52304,nouveaux,0,0,10,10
22680,дела,0,0,9,9
20135,şekilde,0,0,9,9
24826,klotter,0,0,9,9
22666,started,0,0,9,9
6412,l'ultima,1,9,0,9
39505,universe,0,0,9,9
14936,λίγο,0,0,9,9
7044,parlare,1,9,0,9
44283,ಇಲ್ಲಿ,0,0,9,9
8423, milioni,1,9,0,9
51549,muchos,0,0,9,9
45316,മലയാളം,0,0,9,9
51099,которое,0,0,9,9
7057,ultimi,1,9,0,9
15175,تعديل,0,0,9,9
6433,quattro,1,9,0,9
31434,comprendre,0,0,9,9
41333,sueño,0,0,9,9
33400,forskare,0,0,9,9
47858,quelques,0,0,9,9
15260,எந்த,0,0,9,9
49854,moins,0,0,9,9
3770,estremamente,1,9,0,9
34078,fazla,0,0,9,9
15250,versiones,0,0,9,9
3771,cercando,1,9,0,9
33642,aos,0,0,9,9
20423,нарцисса,0,0,9,9
45983,அற்புதமான,0,0,9,9
19691,jour,0,0,9,9
31893,logiciel,0,0,9,9
6409,origine,2,2,7,9
33645,क्यों,0,0,9,9
15002,kunde,0,0,9,9
36186,smarta,0,0,9,9
32516,رائع,0,0,9,9
34303,άτομο,0,0,9,9
8401,logo,2,1,8,9
2334,sicuro,1,9,0,9
44185,held,0,0,9,9
22909,करें।,0,0,9,9
24961,image,0,0,9,9
15038,تمامًا,0,0,9,9
31900,droom,0,0,9,9
9485,लगता,0,0,9,9
37184,gentil,0,0,9,9
27742,falta,0,0,9,9
3746,factor,2,3,6,9
50166,stort,0,0,9,9
48574,able,0,0,9,9
4933,resto,2,3,6,9
29042,næste,0,0,9,9
4707,naturali,1,9,0,9
20287,home,0,0,9,9
19853,still,0,0,9,9
40991,estupenda,0,0,9,9
20333,و,0,0,9,9
31205,waarom,0,0,9,9
6358,complessità,1,9,0,9
34391,geben,0,0,9,9
26260,நல்ல,0,0,9,9
9480,inhoud,0,0,9,9
52684,bajo,0,0,9,9
32878,manger,0,0,9,9
10416,الرغم,0,0,9,9
40663,μετά,0,0,9,9
37962,error,0,0,9,9
8832,alcun,1,9,0,9
21268,third,0,0,9,9
13899,quer,0,0,9,9
50208,personen,0,0,9,9
2033,group,2,1,8,9
13394,anne,0,0,9,9
28046,sabes,0,0,9,9
3436,team,2,5,4,9
33949,anyone,0,0,9,9
32090,ತಿಳಿದಿದೆ,0,0,9,9
8776,l'analisi,1,9,0,9
13340,cuya,0,0,9,9
48181,hasta,0,0,9,9
39995,своей,0,0,9,9
33994,yerine,0,0,9,9
1319,ricevuto,1,9,0,9
44983,interview,0,0,9,9
44975,echter,0,0,9,9
25333,где,0,0,9,9
13286,hvorfor,0,0,9,9
32016,aunque,0,0,9,9
32458,ओर,0,0,9,9
13271,cümle,0,0,9,9
40429,section,0,0,9,9
14169,river,0,0,9,9
4257,iniziò,1,9,0,9
39887,επίσης,0,0,9,9
49640,sea,0,0,9,9
8821,condizioni,1,9,0,9
37631,yo,0,0,9,9
25077,étatsunis,0,0,9,9
31348,veux,0,0,9,9
49688,ದೌರ್ಜನ್ಯ,0,0,9,9
13609,states,0,0,9,9
33957,influence,0,0,9,9
8986,novembre,2,6,3,9
45263,بها,0,0,9,9
45260,look,0,0,9,9
8993,abbastanza,1,9,0,9
48272,decline,0,0,9,9
21491,mathematical,0,0,9,9
21469,этих,0,0,9,9
45237,நாங்கள்,0,0,9,9
4291,palude,1,9,0,9
3513,studenti,1,9,0,9
35219,zegt,0,0,9,9
33280,اليوم,0,0,9,9
52705,författarna,0,0,9,9
40129,bueno,0,0,9,9
6052,punteggio,1,9,0,9
2058,street,2,2,7,9
4286,comune,1,9,0,9
13425,average,0,0,9,9
34358,दोस्तों,0,0,9,9
13782,stumpf,0,0,9,9
40306,assim,0,0,9,9
2116,programmi,1,9,0,9
178,clic,2,6,3,9
3531,tretikov,2,3,6,9
29286,cases,0,0,9,9
13145,fordi,0,0,9,9
5928,computing,2,7,2,9
9212,mine,0,0,9,9
3634,dice,2,7,2,9
48437,humans,0,0,9,9
29205,eat,0,0,9,9
6264,tasso,1,9,0,9
50588,dess,0,0,9,9
25116,gemacht,0,0,9,9
51590,improve,0,0,9,9
20745,esa,0,0,9,9
45848,politique,0,0,9,9
590,avuto,1,9,0,9
37947,situação,0,0,9,9
44596,போல,0,0,9,9
44595,am,0,0,9,9
45868,beauty,0,0,9,9
5064,rappresentazione,1,9,0,9
14725,analyse,0,0,9,9
49591,rêve,0,0,9,9
5839,tom,2,4,5,9
12678,تعرف,0,0,9,9
4406,continuare,1,9,0,9
44560,lieu,0,0,9,9
40808,им,0,0,9,9
37303,vetenskapliga,0,0,9,9
25090,feliz,0,0,9,9
26156,addition,0,0,9,9
12591,ಇನ್ನೊಂದು,0,0,9,9
3268,stava,1,9,0,9
702,collaborative,2,2,7,9
1954,cambiamenti,1,9,0,9
52107,थी।,0,0,9,9
22194,ഉള്ള,0,0,9,9
21082,united,0,0,9,9
21075,vertellen,0,0,9,9
22116,των,0,0,9,9
49770,estos,0,0,9,9
44824,ഇവിടെ,0,0,9,9
4729,generalizzazione,1,9,0,9
14374,fråga,0,0,9,9
29266,നാർസിസ,0,0,9,9
49624,debido,0,0,9,9
25203,ge,0,0,9,9
8661,tema,2,1,8,9
6220,prove,2,7,2,9
5903,cento,2,8,1,9
14584,elles,0,0,9,9
29263,κάνω,0,0,9,9
25201,sicher,0,0,9,9
4374,bellezza,1,9,0,9
14458,described,0,0,9,9
31262,slim,0,0,9,9
25169,когото,0,0,9,9
25866,fler,0,0,9,9
3615,month,2,1,8,9
37391,weil,0,0,9,9
8615,apprendere,1,9,0,9
12939,этот,0,0,9,9
30754,человека,0,0,9,9
44074,μερικές,0,0,9,9
25421,serveurs,0,0,9,9
11980,çünkü,0,0,9,9
23344,plant,0,0,9,9
10756,என்றால்,0,0,9,9
28455,disponible,0,0,9,9
27567,alterações,0,0,9,9
1634,wikimédia,2,1,8,9
41997,maior,0,0,9,9
7568,"esempio,",1,9,0,9
3870,mano,2,7,2,9
5518,tedesca,1,9,0,9
18008,designed,0,0,9,9
5323,metà,1,9,0,9
42438,créer,0,0,9,9
42435,आवश्यकता,0,0,9,9
52374,страниц,0,0,9,9
38304,eran,0,0,9,9
18677,persoon,0,0,9,9
28454,birçok,0,0,9,9
1728,show,2,2,7,9
7985,associazione,1,9,0,9
38982,अवयवों,0,0,9,9
2689,rosenzweig,2,1,8,9
4554,utilizzare,1,9,0,9
6845,area,2,1,8,9
39035,cet,0,0,9,9
24724,leren,0,0,9,9
7475,separate,2,2,7,9
51287,principales,0,0,9,9
46652,languages,0,0,9,9
34699,ஏதாவது,0,0,9,9
9910,policies,0,0,9,9
48694,alemán,0,0,9,9
28473,जाना,0,0,9,9
17325,τρόπος,0,0,9,9
9912,sitt,0,0,9,9
33381,anstelle,0,0,9,9
8072,apprende,1,9,0,9
10257,имеет,0,0,9,9
35603,revisão,0,0,9,9
142,contesto,1,9,0,9
23938,creación,0,0,9,9
2550,capacità,1,9,0,9
18916,jemanden,0,0,9,9
3980,usemodwiki,2,1,8,9
18860,seni,0,0,9,9
18852,linux,0,0,9,9
5560,raggiunto,1,9,0,9
18834,तरीका,0,0,9,9
46780,arbete,0,0,9,9
23474,mina,0,0,9,9
50278,ಯಾರನ್ನಾದರೂ,0,0,9,9
2608,cd,2,1,8,9
16618,nästa,0,0,9,9
52643,لديك,0,0,9,9
52210,physical,0,0,9,9
28437,σπίτι,0,0,9,9
18403,référence,0,0,9,9
7824,totale,1,9,0,9
10091,været,0,0,9,9
53,oro,2,1,8,9
46900,warum,0,0,9,9
16680,pourquoi,0,0,9,9
16689,إن,0,0,9,9
16692,अद्भुत,0,0,9,9
11089,لأي,0,0,9,9
38754,со,0,0,9,9
4583,categorie,2,8,1,9
4868,storia,1,9,0,9
16877,land,0,0,9,9
7848,richiede,1,9,0,9
18280,ಏಕೆಂದರೆ,0,0,9,9
11041,ಚಿನ್ನದ,0,0,9,9
1064,decisione,1,9,0,9
28679,الكثير,0,0,9,9
4099,professor,2,1,8,9
30883,latin,0,0,9,9
26521,importe,0,0,9,9
46807,sluggish,0,0,9,9
42394,overspoeld,0,0,9,9
50141,situación,0,0,9,9
4877,possibile,1,9,0,9
30996,devices,0,0,9,9
23497,கட்டுரைகள்,0,0,9,9
2616,utilizzate,1,9,0,9
27489,sûr,0,0,9,9
38897,लोग,0,0,9,9
2962,valori,1,9,0,9
31634,variables,0,0,9,9
28449,ouro,0,0,9,9
7921,segreto,1,9,0,9
48833,ponto,0,0,9,9
47559,organização,0,0,9,9
7902,considerato,1,9,0,9
43397,typically,0,0,9,9
11182,olmak,0,0,9,9
28705,способ,0,0,9,9
16970,لذلك,0,0,9,9
24723,approximately,0,0,9,9
18936,usado,0,0,9,9
4,d'accordo.,1,9,0,9
32237,havia,0,0,9,9
52235,моя,0,0,9,9
17520,ಹೇಳಲು,0,0,9,9
46415,seguro,0,0,9,9
2772,maggio,1,9,0,9
1566,infatti,1,9,0,9
4497,aumento,2,6,3,9
24294,grausam,0,0,9,9
33175,i̇ngilizce,0,0,9,9
47728,தங்க,0,0,9,9
41547,goal,0,0,9,9
43933,фраза,0,0,9,9
35916,honom,0,0,9,9
11792,permite,0,0,9,9
23969,sonho,0,0,9,9
2479,super,2,2,7,9
4627,usano,1,9,0,9
42630,werken,0,0,9,9
15773,وهذا,0,0,9,9
38561,கனவு,0,0,9,9
27645,better,0,0,9,9
10555,sitios,0,0,9,9
38153,gebruik,0,0,9,9
24176,erstaunlich,0,0,9,9
41502,ஆம்,0,0,9,9
47747,publicados,0,0,9,9
19670,المحتوى,0,0,9,9
1807,automaticamente,2,6,3,9
41398,ω,0,0,9,9
47783,ഇല്ല,0,0,9,9
15598,vu,0,0,9,9
27672,ked,0,0,9,9
23065,policyer,0,0,9,9
7613,pubblicata,1,9,0,9
47354,date,0,0,9,9
34259,conocimiento,0,0,9,9
4493,amo,2,6,3,9
11888,bruger,0,0,9,9
8244,accesso,1,9,0,9
24181,dices,0,0,9,9
15684,хлеб,0,0,9,9
35746,june,0,0,9,9
437,target,2,2,7,9
24253,weather,0,0,9,9
8223,miliardi,1,9,0,9
4634,misura,1,9,0,9
33879,lidt,0,0,9,9
34548,beste,0,0,9,9
39085,interest,0,0,9,9
3829,centro,2,5,4,9
9806,இருக்கிறது,0,0,9,9
24076,språk,0,0,9,9
47397,vraagt,0,0,9,9
1481,terrestre,2,8,1,9
27627,traditional,0,0,9,9
9840,जाती,0,0,9,9
32330,இருக்க,0,0,9,9
7706,top,2,1,8,9
49908,tag,0,0,9,9
28862,ஏன்,0,0,9,9
15816,meses,0,0,9,9
49387,juste,0,0,9,9
27256,ಯಾವುದೇ,0,0,9,9
17399,vou,0,0,9,9
10362,ليس,0,0,9,9
11616,वेब,0,0,9,9
17368,pessoas,0,0,9,9
34486,especially,0,0,9,9
11756,kanal,0,0,9,9
42825,passe,0,0,9,9
11526,become,0,0,9,9
10670,hand,0,0,9,9
3937,sparse,2,1,7,8
32851,rate,0,0,8,8
3585,strato,1,8,0,8
38344,regions,0,0,8,8
3994,logic,2,1,7,8
24567,всех,0,0,8,8
1578,wikipediani,1,8,0,8
33353,وأنت,0,0,8,8
9051,certa,2,4,4,8
10686,defined,0,0,8,8
4083,citata,1,8,0,8
45598,zien,0,0,8,8
170,guerra,2,3,5,8
9050,sugli,1,8,0,8
37781,δύο,0,0,8,8
8982,domande,1,8,0,8
49149,cadre,0,0,8,8
50900,ekmek,0,0,8,8
38495,contribuições,0,0,8,8
33470,bei,0,0,8,8
23770,källa,0,0,8,8
7175,distribuzione,1,8,0,8
33099,universidade,0,0,8,8
6835,adams,2,2,6,8
7114,eh,2,6,2,8
52350,പദം,0,0,8,8
45605,என்னால்,0,0,8,8
64,neutrale,1,8,0,8
13223,liberté,0,0,8,8
45407,θέλω,0,0,8,8
10547,ayant,0,0,8,8
34175,noch,0,0,8,8
21645,ताकि,0,0,8,8
25286,año,0,0,8,8
351,là,2,4,4,8
36040,செய்து,0,0,8,8
38700,സ്വയം,0,0,8,8
37770,делать,0,0,8,8
28439,gång,0,0,8,8
51687,recherche,0,0,8,8
24324,nobrainer,0,0,8,8
31350,hui,0,0,8,8
48177,ഉപയോഗിക്കുന്നു,0,0,8,8
47473,εάν,0,0,8,8
30782,stora,0,0,8,8
1520,statistiche,1,8,0,8
10545,эти,0,0,8,8
49369,mitt,0,0,8,8
47382,بواسطة,0,0,8,8
51676,mientras,0,0,8,8
10719,daily,0,0,8,8
2011,passaggio,1,8,0,8
10183,hennes,0,0,8,8
10918,ಕೆಲಸ,0,0,8,8
29316,പുതിയ,0,0,8,8
35250,καλή,0,0,8,8
6657,originariamente,1,8,0,8
10736,denna,0,0,8,8
24450,क्षमा,0,0,8,8
51897,represent,0,0,8,8
38297,ரொட்டி,0,0,8,8
21979,universidad,0,0,8,8
38298,benim,0,0,8,8
13346,μπορεί,0,0,8,8
24310,συγνώμη,0,0,8,8
45487,coverage,0,0,8,8
35326,fik,0,0,8,8
28424,plans,0,0,8,8
39437,peutêtre,0,0,8,8
12249,contrôle,0,0,8,8
1862,perdita,1,8,0,8
24760,التحرير,0,0,8,8
24743,mad,0,0,8,8
38046,meine,0,0,8,8
9578,aberta,0,0,8,8
23206,laquelle,0,0,8,8
51834,हालाँकि,0,0,8,8
28900,boa,0,0,8,8
39364,minha,0,0,8,8
46108,புதிய,0,0,8,8
6960,ragazzo,1,8,0,8
32341,incluindo,0,0,8,8
35552,ज्यादा,0,0,8,8
11635,мать,0,0,8,8
35553,ರೆಂಡೆಜ್ವಸ್,0,0,8,8
11565,term,0,0,8,8
9854,möchten,0,0,8,8
9508,kanske,0,0,8,8
52558,brot,0,0,8,8
32634,book,0,0,8,8
33051,கேட்க,0,0,8,8
39401,örneğin,0,0,8,8
28127,neurons,0,0,8,8
9900,conjunto,0,0,8,8
46655,dann,0,0,8,8
3698,video.,1,8,0,8
32754,lost,0,0,8,8
46676,будто,0,0,8,8
23181,etmek,0,0,8,8
29039,arbeit,0,0,8,8
39353,change,0,0,8,8
46232,nah,0,0,8,8
35943,mange,0,0,8,8
47763,أريد,0,0,8,8
9729,kullanabileceğiniz,0,0,8,8
6419,leggi,1,8,0,8
47748,хочу,0,0,8,8
9774,दूसरे,0,0,8,8
46301,εκεί,0,0,8,8
22982,verschillende,0,0,8,8
22975,लोगों,0,0,8,8
4921,giro,2,7,1,8
28977,அதைப்,0,0,8,8
46276,பதிலாக,0,0,8,8
6991,scoperto,1,8,0,8
46229,सामान्य,0,0,8,8
11778,возможность,0,0,8,8
23134,él,0,0,8,8
3745,ciao,1,8,0,8
38094,basis,0,0,8,8
46195,विशेष,0,0,8,8
39168,smarte,0,0,8,8
11819,behavior,0,0,8,8
7002,creati,1,8,0,8
35425,voluntários,0,0,8,8
749,materiali,1,8,0,8
157,percentuale,1,8,0,8
12205,bazen,0,0,8,8
22834,slimme,0,0,8,8
9618,nuevo,0,0,8,8
12424,early,0,0,8,8
22694,ತಾಯಿ,0,0,8,8
51887,relatively,0,0,8,8
3857,andiamo,1,8,0,8
35335,två,0,0,8,8
35330,bekommen,0,0,8,8
25127,विकास,0,0,8,8
11223,geht,0,0,8,8
32164,hög,0,0,8,8
9317,modelos,0,0,8,8
38882,luego,0,0,8,8
163,York,1,8,0,8
6238,futuro,2,4,4,8
843,normalmente,2,2,6,8
697,incluso,2,2,6,8
28693,true,0,0,8,8
11155,गाड़ी,0,0,8,8
45728,naam,0,0,8,8
23616,amazing,0,0,8,8
12964,شكرا,0,0,8,8
24604,работы,0,0,8,8
37907,smaller,0,0,8,8
49296,بما,0,0,8,8
32258,которая,0,0,8,8
13002,verstanden,0,0,8,8
24582,reports,0,0,8,8
13032,κάνεις,0,0,8,8
38795,ಪದ,0,0,8,8
50732,الذين,0,0,8,8
45628,car,0,0,8,8
45626,नाम,0,0,8,8
3929,umani,1,8,0,8
11065,nya,0,0,8,8
38914,muitos,0,0,8,8
38928,நர்சிசா,0,0,8,8
12734,vid,0,0,8,8
31102,ഉപയോക്താക്കൾ,0,0,8,8
9935,coisa,0,0,8,8
29064,septembre,0,0,8,8
32245,choses,0,0,8,8
12513,അവളുടെ,0,0,8,8
34185,existen,0,0,8,8
33084,जनवरी,0,0,8,8
28746,ಅವನು,0,0,8,8
30995,ello,0,0,8,8
25078,ее,0,0,8,8
51852,gedaan,0,0,8,8
9419,സ്വർണ്ണ,0,0,8,8
39549,parmi,0,0,8,8
12600,birisi,0,0,8,8
722,analisi,1,8,0,8
23491,sammen,0,0,8,8
29122,disponibles,0,0,8,8
46721,importance,0,0,8,8
11355,buena,0,0,8,8
12641,edition,0,0,8,8
1735,tendenza,1,8,0,8
32338,down,0,0,8,8
23415,പോലെ,0,0,8,8
22527,constante,0,0,8,8
4219,formato,2,4,4,8
49453,घर,0,0,8,8
39588,अनुसार,0,0,8,8
38968,ജോലി,0,0,8,8
39591,सच,0,0,8,8
9687,sadece,0,0,8,8
17380,société,0,0,8,8
4477,darò,1,8,0,8
20044,просто,0,0,8,8
42251,loss,0,0,8,8
43279,στιγμή,0,0,8,8
32903,لدي,0,0,8,8
16767,प्रकार,0,0,8,8
16795,already,0,0,8,8
5722,creazione,1,8,0,8
20034,देखा,0,0,8,8
31812,fri,0,0,8,8
26438,തിരുത്തലുകൾ,0,0,8,8
52485,വാക്ക്,0,0,8,8
32894,première,0,0,8,8
33643,maddeleri,0,0,8,8
26390,энциклопедии,0,0,8,8
3184,pubblico,1,8,0,8
49074,enlaces,0,0,8,8
8364,campi,1,8,0,8
49075,numaralı,0,0,8,8
16811,engelstalige,0,0,8,8
41208,hatte,0,0,8,8
8329,ragazzi,1,8,0,8
37068,changed,0,0,8,8
48587,citizendium,0,0,8,8
51503,onlara,0,0,8,8
37033,objetivo,0,0,8,8
51227,सवाल,0,0,8,8
25437,λάθος,0,0,8,8
36678,وقت,0,0,8,8
50467,mil,0,0,8,8
34596,सोने,0,0,8,8
4472,pochi,1,8,0,8
51231,कहने,0,0,8,8
15464,στον,0,0,8,8
5403,potresti,1,8,0,8
52159,таких,0,0,8,8
44124,amerika,0,0,8,8
31651,leid,0,0,8,8
7852,giugno,1,8,0,8
44126,vissa,0,0,8,8
16713,വലിയ,0,0,8,8
20161,animal,0,0,8,8
41057,العبارة,0,0,8,8
41362,traum,0,0,8,8
14888,ويكيميديا,0,0,8,8
14951,स्थापना,0,0,8,8
14940,gave,0,0,8,8
20372,voiture,0,0,8,8
3250,relative,2,7,1,8
48827,quiser,0,0,8,8
14925,quero,0,0,8,8
30700,developed,0,0,8,8
27096,readers,0,0,8,8
30497,control,0,0,8,8
8394,alan,2,2,6,8
5803,visione,1,8,0,8
5329,realtà,1,8,0,8
48488,novos,0,0,8,8
14868,tradition,0,0,8,8
26217,ഇന്ന്,0,0,8,8
258,beck,2,4,4,8
34263,ऑफ़,0,0,8,8
44503,nog,0,0,8,8
48825,عدد,0,0,8,8
2318,registrati,1,8,0,8
40948,academic,0,0,8,8
43165,lequel,0,0,8,8
5741,piccola,1,8,0,8
29943,κάνετε,0,0,8,8
15167,swamped,0,0,8,8
20203,genetic,0,0,8,8
1202,forte,2,7,1,8
2665,fatti,1,8,0,8
7829,linguaggio,1,8,0,8
41025,scientific,0,0,8,8
16889,أكبر,0,0,8,8
26322,ಸಂಖ್ಯೆ,0,0,8,8
5757,momento.,1,8,0,8
51539,നു,0,0,8,8
26307,больше,0,0,8,8
27461,limited,0,0,8,8
31899,योगदानकर्ता,0,0,8,8
42331,pensar,0,0,8,8
52664,bli,0,0,8,8
19756,trög,0,0,8,8
19694,प्रयोग,0,0,8,8
52241,auteur,0,0,8,8
30142,tais,0,0,8,8
1102,discipline,2,4,4,8
50380,ಮೇಲೆ,0,0,8,8
26837,organización,0,0,8,8
15972,update,0,0,8,8
26713,много,0,0,8,8
7499,compito,1,8,0,8
7465,scholarpedia,2,1,7,8
5130,originale,1,8,0,8
41735,تقلق,0,0,8,8
41653,klar,0,0,8,8
19128,along,0,0,8,8
34723,lass,0,0,8,8
15930,grâce,0,0,8,8
30299,demande,0,0,8,8
5443,privacy,2,4,4,8
19246,fuente,0,0,8,8
19253,всего,0,0,8,8
8111,boris,2,2,6,8
51436,صفحة,0,0,8,8
18981,situatie,0,0,8,8
34642,dites,0,0,8,8
8062,scienza,1,8,0,8
16357,أنها,0,0,8,8
52195,variations,0,0,8,8
2991,massa,2,5,3,8
41981,धन्यवाद।,0,0,8,8
32912,हमेशा,0,0,8,8
43598,basic,0,0,8,8
5531,pulsante,1,8,0,8
26791,ice,0,0,8,8
16252,programa,0,0,8,8
49947,प्रवृति,0,0,8,8
33747,oceans,0,0,8,8
32954,android,0,0,8,8
36871,servers,0,0,8,8
26780,¿cómo,0,0,8,8
52191,άλλη,0,0,8,8
4665,neuroni,1,8,0,8
18973,المثال,0,0,8,8
5124,riportava,1,8,0,8
8121,devono,1,8,0,8
19693,estce,0,0,8,8
36722,здесь,0,0,8,8
2470,preoccuparti,1,8,0,8
2638,sentito,1,8,0,8
544,daniel,2,2,6,8
26578,വാചകം,0,0,8,8
2461,osservazioni,1,8,0,8
2946,school,2,1,7,8
1164,comunque,1,8,0,8
4571,argomento,1,8,0,8
26556,لو,0,0,8,8
34610,asking,0,0,8,8
15635,neutral,0,0,8,8
5414,piccoli,1,8,0,8
5413,oceani,1,8,0,8
36706,hause,0,0,8,8
30655,trained,0,0,8,8
19651,trois,0,0,8,8
15577,المحررين,0,0,8,8
41384,إنه,0,0,8,8
36303,சொற்கள்,0,0,8,8
43959,الشخص,0,0,8,8
49898,criticada,0,0,8,8
50373,crear,0,0,8,8
33868,अक्सर,0,0,8,8
3071,successivamente,1,8,0,8
5438,diventare,1,8,0,8
27633,εντάξει,0,0,8,8
30125,उसे,0,0,8,8
30336,central,0,0,8,8
36410,sais,0,0,8,8
8153,materia,2,7,1,8
15784,सन्दर्भ,0,0,8,8
48662,accès,0,0,8,8
27649,lige,0,0,8,8
7413,bang,2,1,7,8
8175,politica,1,8,0,8
48649,avril,0,0,8,8
42185,done,0,0,8,8
18429,étant,0,0,8,8
43939,past,0,0,8,8
8519,strumenti,1,8,0,8
468,robot,2,3,5,8
14241,legal,0,0,8,8
50082,washington,0,0,8,8
48377,dedos,0,0,8,8
624,virgin,2,2,6,8
7203,accurate,2,3,5,8
3399,probabilità,1,8,0,8
40424,самых,0,0,8,8
191,opera,2,5,3,8
34284,kunnen,0,0,8,8
40422,maddelerin,0,0,8,8
49341,desculpe,0,0,8,8
37553,första,0,0,8,8
35072,present,0,0,8,8
49742,ಒಳ್ಳೆಯದು,0,0,8,8
17423,specific,0,0,8,8
7682,james,2,2,6,8
36059,increasing,0,0,8,8
45029,saber,0,0,8,8
40401,quiero,0,0,8,8
17412,trafic,0,0,8,8
4354,comscore,2,1,7,8
48379,لغة,0,0,8,8
44867,ಮೂಲಕ,0,0,8,8
44825,lent,0,0,8,8
42867,cosas,0,0,8,8
21013,eens,0,0,8,8
49768,federal,0,0,8,8
44863,current,0,0,8,8
25806,ಎಂಬ,0,0,8,8
5200,svm,2,5,3,8
27251,ലേഖനം,0,0,8,8
1041,radio,2,2,6,8
3379,ampiamente,1,8,0,8
44890,zeit,0,0,8,8
8698,pranzo,1,8,0,8
21144,utilisateurs,0,0,8,8
18094,अध्ययन,0,0,8,8
17781,செல்ல,0,0,8,8
21147,области,0,0,8,8
25649,сделать,0,0,8,8
27269,എന്നതാണ്,0,0,8,8
8804,collegamenti,1,8,0,8
8931,tradizionali,1,8,0,8
21435,गयी,0,0,8,8
48288,கொடூரமான,0,0,8,8
21440,ஆங்கில,0,0,8,8
31358,несколько,0,0,8,8
1347,regioni,1,8,0,8
40244,worry,0,0,8,8
21503,erros,0,0,8,8
40220,diyebilirsin,0,0,8,8
2791,New,1,8,0,8
2079,commerciale,2,7,1,8
8936,discussione,1,8,0,8
37677,höflich,0,0,8,8
21517,आया,0,0,8,8
50549,викимедиа,0,0,8,8
2787,stanco,1,8,0,8
21526,äta,0,0,8,8
42741,языковых,0,0,8,8
668,appuntamento,1,8,0,8
17455,ας,0,0,8,8
29457,നിങ്ങൾ‌ക്ക്,0,0,8,8
13927,inundado,0,0,8,8
2131,mente,2,5,3,8
4646,dentro,2,2,6,8
5993,sociale,2,4,4,8
51320,будет,0,0,8,8
45103,análisis,0,0,8,8
35130,ಏನನ್ನಾದರೂ,0,0,8,8
37650,case,0,0,8,8
45201,அடுத்த,0,0,8,8
25567,explica,0,0,8,8
45177,ordinateur,0,0,8,8
48947,आज,0,0,8,8
37663,always,0,0,8,8
50105,arbeta,0,0,8,8
48295,unique,0,0,8,8
4317,devi,1,8,0,8
14375,  ,0,0,8,8
51205,ξέρετε,0,0,8,8
40748,misschien,0,0,8,8
34246,primeira,0,0,8,8
14731,säker,0,0,8,8
40653,المنزل,0,0,8,8
14573,usuário,0,0,8,8
44678,planer,0,0,8,8
33533,launched,0,0,8,8
5191,nuove,1,8,0,8
33162,без,0,0,8,8
8567,contiene,1,8,0,8
40662,zeker,0,0,8,8
27206,hans,0,0,8,8
20675,« nature »,0,0,8,8
48960,às,0,0,8,8
31616,últimos,0,0,8,8
2855,c'era,1,8,0,8
7741,fortunato,1,8,0,8
20784,हुए,0,0,8,8
17186,pourrait,0,0,8,8
14407,introduced,0,0,8,8
52110,tut,0,0,8,8
591,dimensione,1,8,0,8
7751,turing,2,3,5,8
25993,senare,0,0,8,8
5058,dita,1,8,0,8
18051,മറ്റ്,0,0,8,8
51038,धन्यवाद,0,0,8,8
2715,rende,2,7,1,8
14622,tijd,0,0,8,8
52286,lang,0,0,8,8
17222,déjà,0,0,8,8
17185,lunch,0,0,8,8
2222,agosto,2,3,5,8
44780,computers,0,0,8,8
20891,extinction,0,0,8,8
20638,biography,0,0,8,8
42579,происходит,0,0,8,8
42884,secret,0,0,8,8
4407,supporto,1,8,0,8
26126,oversvømmet,0,0,8,8
51611,volgende,0,0,8,8
40615,simple,0,0,8,8
2283,consiste,2,4,4,8
18069,ക്യാച്ച്,0,0,8,8
20938,ecosystem,0,0,8,8
37259,against,0,0,8,8
20471,referência,0,0,8,8
4367,liste,2,1,7,8
40774,eg,0,0,8,8
2842,dagli,1,8,0,8
4650,favore,1,8,0,8
14513,cofundador,0,0,8,8
17944,التعلم,0,0,8,8
3289,positive,2,1,7,8
7734,web.,1,8,0,8
17922,ging,0,0,8,8
27412,सहयोग,0,0,8,8
1010,perso,1,7,0,7
48986,mostly,0,0,7,7
50662,thus,0,0,7,7
7527,user,2,1,6,7
36781,contain,0,0,7,7
36606,beter,0,0,7,7
7601,l'obiettivo,1,7,0,7
36511,therefore,0,0,7,7
47476,visar,0,0,7,7
26824,task,0,0,7,7
4037,elementi,1,7,0,7
27536,zwei,0,0,7,7
28338,teşekkürler,0,0,7,7
1108,stessi,1,7,0,7
47590,хотя,0,0,7,7
9984,every,0,0,7,7
48913,என்பதை,0,0,7,7
32575,liquid,0,0,7,7
27328,experience,0,0,7,7
36837,أعتقد,0,0,7,7
1512,lincoln,2,1,6,7
24424,carruagem,0,0,7,7
7666,portare,1,7,0,7
10379,mannen,0,0,7,7
32561,tant,0,0,7,7
10066,sagde,0,0,7,7
33105,சிறந்த,0,0,7,7
38328,знаю,0,0,7,7
10076,terms,0,0,7,7
7688,figure,2,2,5,7
24632,موعد,0,0,7,7
10342,alltid,0,0,7,7
24363,carruaje,0,0,7,7
27369,approaches,0,0,7,7
36538,overall,0,0,7,7
50298,inom,0,0,7,7
38254,tar,0,0,7,7
28477,बना,0,0,7,7
7860,writing,2,1,6,7
47433,pergunta,0,0,7,7
36674,escrito,0,0,7,7
36559,vos,0,0,7,7
4090,continua,1,7,0,7
38388,cruel,0,0,7,7
28420,mom,0,0,7,7
48888,sejam,0,0,7,7
10102,zei,0,0,7,7
27501,sorgen,0,0,7,7
28429,ಕ್ಯಾಚ್,0,0,7,7
7827,gioco,1,7,0,7
7828,stupenda,1,7,0,7
28389,مجموعة,0,0,7,7
26922,tree,0,0,7,7
27279,processes,0,0,7,7
52206,maak,0,0,7,7
48777,três,0,0,7,7
36759,aprender,0,0,7,7
49320,heute,0,0,7,7
4624,l'idea,1,7,0,7
24360,mode,0,0,7,7
1038,vero,1,7,0,7
10357,ತಿಳಿದಿಲ್ಲ,0,0,7,7
27482,ऐसी,0,0,7,7
38320,المعلومات,0,0,7,7
4074,corpo,1,7,0,7
8961,furono,1,7,0,7
8003,notte,1,7,0,7
25910,innehållet,0,0,7,7
25138,complex,0,0,7,7
48042,presque,0,0,7,7
25977,при,0,0,7,7
1273,propri,1,7,0,7
36018,बजाय,0,0,7,7
7105,ambiente,2,6,1,7
8621,probabilmente,1,7,0,7
9266,laat,0,0,7,7
8608,simonite,2,3,4,7
52713,autor,0,0,7,7
34229,yolu,0,0,7,7
25852,وهو,0,0,7,7
4369,idee,2,3,4,7
33156,टिप्पणी,0,0,7,7
28077,يمكنني,0,0,7,7
932,oggetti,1,7,0,7
48037,कहते,0,0,7,7
25988,andet,0,0,7,7
26803,submergé,0,0,7,7
52312,ನುಡಿಗಟ್ಟು,0,0,7,7
26190,संचालित,0,0,7,7
27895,votación,0,0,7,7
941,mellon,2,2,5,7
37272,значит,0,0,7,7
4718,mese,1,7,0,7
8572,film,2,4,3,7
37939,فظيعة,0,0,7,7
37343,போன்ற,0,0,7,7
52109,января,0,0,7,7
48001,ദൈനംദിന,0,0,7,7
7245,wiktionary,2,2,5,7
37359,smuk,0,0,7,7
1415,tipicamente,1,7,0,7
37925,sistemas,0,0,7,7
7100,iphone,2,1,6,7
37924,जिमी,0,0,7,7
1300,dieci,1,7,0,7
37865,collection,0,0,7,7
4247,Web,1,7,0,7
33264,consulter,0,0,7,7
1374,ovvero,1,7,0,7
48332,качестве,0,0,7,7
897,lunga,1,7,0,7
25371,forfærdeligt,0,0,7,7
25381,tekrar,0,0,7,7
48317,étudiants,0,0,7,7
8878,delhi,2,1,6,7
37664,പറഞ്ഞു,0,0,7,7
37860,ihrer,0,0,7,7
28048,நடக்கிறது,0,0,7,7
48291,makes,0,0,7,7
899,specifici,1,7,0,7
52710,años,0,0,7,7
25389,हुआ,0,0,7,7
1362,fammi,1,7,0,7
898,strumento,1,7,0,7
8807,sbagliato,1,7,0,7
49158,produce,0,0,7,7
50537,contre,0,0,7,7
34288,idée,0,0,7,7
27961,importantes,0,0,7,7
48106,έξυπνες,0,0,7,7
9196,fall,0,0,7,7
9191,भाषाओँ,0,0,7,7
396,crescente,2,5,2,7
8716,dio,2,3,4,7
49176,minutos,0,0,7,7
9155,لـ,0,0,7,7
1392,differenze,1,7,0,7
48364,gün,0,0,7,7
37568,brugere,0,0,7,7
7195,conseguenza,1,7,0,7
4269,unità,1,7,0,7
99,pronto,2,2,5,7
48189,involves,0,0,7,7
47976,γωνία,0,0,7,7
888,statistici,1,7,0,7
26215,عمل,0,0,7,7
26595,संपादन,0,0,7,7
28314,engels,0,0,7,7
38164,environ,0,0,7,7
28299,सपना,0,0,7,7
4143,diritto,1,7,0,7
27638,wel,0,0,7,7
26635,willen,0,0,7,7
36962,year,0,0,7,7
49038,pris,0,0,7,7
8289,computazionale,1,7,0,7
6974,oggetto,1,7,0,7
4495,atti,1,7,0,7
48627,commercial,0,0,7,7
51995,again,0,0,7,7
27668,المقالات،,0,0,7,7
4793,presenta,2,4,3,7
1469,significativa,2,5,2,7
9827,fundação,0,0,7,7
4138,negativo,2,3,4,7
36336,donner,0,0,7,7
9836,drøm,0,0,7,7
48733,യന്ത്രപഠന,0,0,7,7
34190,mening,0,0,7,7
32651,ως,0,0,7,7
9927,distribution,0,0,7,7
49260,materials,0,0,7,7
26742,sätze,0,0,7,7
26727,result,0,0,7,7
4529,gpl,2,1,6,7
52256,students,0,0,7,7
9886,இடத்தில்,0,0,7,7
9878,നല്ല,0,0,7,7
47679,ولا,0,0,7,7
4522,controversia,2,2,5,7
26710,cual,0,0,7,7
4519,sostenuto,1,7,0,7
26542,spørger,0,0,7,7
28236,intelligents,0,0,7,7
26222,altijd,0,0,7,7
38013,medida,0,0,7,7
32393,सेंगर,0,0,7,7
24957,दोस्त,0,0,7,7
26326,работу,0,0,7,7
47908,bodies,0,0,7,7
47909,πάντα,0,0,7,7
4439,insider,2,3,4,7
8429,felice,1,7,0,7
27840,мама,0,0,7,7
49246,imágenes,0,0,7,7
26289,الويكي,0,0,7,7
25033,первоначально,0,0,7,7
8465,specchio,1,7,0,7
7288,george,2,2,5,7
7082,rinforzo,1,7,0,7
26227,setembro,0,0,7,7
25044,उसने,0,0,7,7
35993,escritos,0,0,7,7
33146,diskussioner,0,0,7,7
47835,به,0,0,7,7
966,katherine,2,3,4,7
48593,doesn,0,0,7,7
47789,second,0,0,7,7
8297,differenza,1,7,0,7
36279,effort,0,0,7,7
7370,killer,2,2,5,7
9672,språkversioner,0,0,7,7
26475,maison,0,0,7,7
38102,ye,0,0,7,7
47812,moyens,0,0,7,7
48589,properties,0,0,7,7
36253,reinforcement,0,0,7,7
24848,série,0,0,7,7
38071,difícil,0,0,7,7
56,funzioni,1,7,0,7
7362,niente,1,7,0,7
49137,doing,0,0,7,7
39383,publications,0,0,7,7
33348,voire,0,0,7,7
44636,publicado,0,0,7,7
14810,अमेरिकी,0,0,7,7
14786,zinnen,0,0,7,7
20485,spise,0,0,7,7
3280,critici,2,6,1,7
40837,began,0,0,7,7
14766,അതിനർത്ഥം,0,0,7,7
40791,കാര്യങ്ങൾ,0,0,7,7
44570,почему,0,0,7,7
20652,comparison,0,0,7,7
34379,tatlı,0,0,7,7
33543,gør,0,0,7,7
49800,vær,0,0,7,7
31997,தெரியாது,0,0,7,7
31395,mise,0,0,7,7
20458,êtres,0,0,7,7
44651,lit,0,0,7,7
2237,cervello,1,7,0,7
29751,début,0,0,7,7
20793,led,0,0,7,7
5872,avanti,1,7,0,7
14594,जीवन,0,0,7,7
40654,مشروع,0,0,7,7
14574,hoek,0,0,7,7
44691,principes,0,0,7,7
49790,användas,0,0,7,7
2219,black,2,2,5,7
34969,முடியவில்லை,0,0,7,7
29729,ಕನಸು,0,0,7,7
14833,david,0,0,7,7
20452,junho,0,0,7,7
20898,estivesse,0,0,7,7
15245,estilo,0,0,7,7
15460,programs,0,0,7,7
33665,fez,0,0,7,7
19785,upon,0,0,7,7
51113,håller,0,0,7,7
19917,systemic,0,0,7,7
34823,αντί,0,0,7,7
44199,criticized,0,0,7,7
19965,rédacteurs,0,0,7,7
41126,टेरी,0,0,7,7
41090,collaboration,0,0,7,7
32978,समीक्षा,0,0,7,7
3186,vector,2,1,6,7
51524,rätt,0,0,7,7
3196,rappresentare,1,7,0,7
29851,left,0,0,7,7
20178,exist,0,0,7,7
31421,pregunta,0,0,7,7
30687,aller,0,0,7,7
44340,parece,0,0,7,7
49847,années,0,0,7,7
32979,conhecimento,0,0,7,7
3227,inizialmente,1,7,0,7
15034,seja,0,0,7,7
34840,geliyor,0,0,7,7
5077,strettamente,1,7,0,7
14998,εαυτό,0,0,7,7
14928,increasingly,0,0,7,7
20421,ربما,0,0,7,7
29719,الخاصة,0,0,7,7
611,possibilità,1,7,0,7
44120,drie,0,0,7,7
51661,καθώς,0,0,7,7
32986,l’apprentissage,0,0,7,7
52432,frågar,0,0,7,7
21327,começou,0,0,7,7
21342,pense,0,0,7,7
51652,naturels,0,0,7,7
45192,sexual,0,0,7,7
45193,verbete,0,0,7,7
6044,dilemma,2,2,5,7
13759,neste,0,0,7,7
51655,نهاية,0,0,7,7
6051,parlando,1,7,0,7
45226,programas,0,0,7,7
50958,boos,0,0,7,7
3476,capire,1,7,0,7
13920,particulier,0,0,7,7
21502,использования,0,0,7,7
45274,sker,0,0,7,7
6065,quegli,1,7,0,7
4999,corpi,1,7,0,7
13557,denken,0,0,7,7
45335,möchte,0,0,7,7
45340,शादी,0,0,7,7
51671,сегодня,0,0,7,7
3505,possano,1,7,0,7
32860,wikipedians,0,0,7,7
35195,которой,0,0,7,7
29353,brød,0,0,7,7
3516,induttiva,1,7,0,7
3438,canale,1,7,0,7
40374,aardig,0,0,7,7
29710,mediante,0,0,7,7
30712,fantastiskt,0,0,7,7
44768,verärgert,0,0,7,7
20926,dezembro,0,0,7,7
44773,വളരെയധികം,0,0,7,7
2195,modi,1,7,0,7
44809,alguma,0,0,7,7
44820,oficial,0,0,7,7
5916,serio,2,3,4,7
5921,wall,2,1,6,7
14269,table,0,0,7,7
619,prevedere,1,7,0,7
14223,أمي,0,0,7,7
14221,συγγνώμη,0,0,7,7
40447,meus,0,0,7,7
14161,dine,0,0,7,7
35124,одна,0,0,7,7
21189,following,0,0,7,7
35064,donde,0,0,7,7
3406,marzo,2,5,2,7
29583,mind,0,0,7,7
35103,började,0,0,7,7
21215,عليها,0,0,7,7
21227,parler,0,0,7,7
35105,dina,0,0,7,7
3423,La,1,7,0,7
49737,meinen,0,0,7,7
38482,diffusion,0,0,7,7
40392,studie,0,0,7,7
33947,particulière,0,0,7,7
15465,مليون,0,0,7,7
15490,bank,0,0,7,7
13444,once,0,0,7,7
51232,representation,0,0,7,7
42391,ಹೆಚ್ಚು,0,0,7,7
17021,ಪದಗಳು,0,0,7,7
250,sarà,1,7,0,7
43156,textos,0,0,7,7
18230,quoi,0,0,7,7
51370,engel,0,0,7,7
33775,find,0,0,7,7
18231,പറയുന്നു,0,0,7,7
2661,caa,2,3,4,7
18311,associated,0,0,7,7
42250,reino,0,0,7,7
30384,científicos,0,0,7,7
42237,до,0,0,7,7
43331,búsqueda,0,0,7,7
17100,எப்போதும்,0,0,7,7
43344,ocasiones,0,0,7,7
18380,nieuwe,0,0,7,7
2644,moderne,2,1,6,7
16621,yok,0,0,7,7
42194,ಅವರಿಗೆ,0,0,7,7
5424,filosofia,2,5,2,7
43399,விரும்புகிறேன்,0,0,7,7
18479,allowing,0,0,7,7
51384,acadêmicos,0,0,7,7
51387,अत्याचारी,0,0,7,7
16486,φίλους,0,0,7,7
18559,utilisée,0,0,7,7
32943,तब,0,0,7,7
17061,сша,0,0,7,7
42430,ذات,0,0,7,7
34624,amount,0,0,7,7
34481,disputes,0,0,7,7
42723,across,0,0,7,7
42707,vilken,0,0,7,7
5231,raggiungere,1,7,0,7
5236,inductive,2,1,6,7
17562,helemaal,0,0,7,7
5238,portale,1,7,0,7
17504,idag,0,0,7,7
42788,தனது,0,0,7,7
32946,investigación,0,0,7,7
17742,такие,0,0,7,7
2807,concentra,1,7,0,7
17745,país,0,0,7,7
50094,cause,0,0,7,7
42617,comunicación,0,0,7,7
18003,kvinnor,0,0,7,7
42844,وفقًا,0,0,7,7
17766,posibilidad,0,0,7,7
42608,обучение,0,0,7,7
17400,नहीं।,0,0,7,7
5283,elemento,2,2,5,7
5199,l'hai,1,7,0,7
17810,obtusa,0,0,7,7
2836,note,2,3,4,7
5291,anno,2,6,1,7
50067,gode,0,0,7,7
17948,compte,0,0,7,7
17194,दुनिया,0,0,7,7
17974,gånger,0,0,7,7
42082,marca,0,0,7,7
16428,currents,0,0,7,7
2412,artificiale.,1,7,0,7
33692,together,0,0,7,7
19276,likely,0,0,7,7
15805,february,0,0,7,7
19315,detect,0,0,7,7
51461,uses,0,0,7,7
43919,händer,0,0,7,7
51158,ഇത്തരം,0,0,7,7
15780,tenía,0,0,7,7
19430,mobila,0,0,7,7
3088,principi,1,7,0,7
34424,джимми,0,0,7,7
30082,उसकी,0,0,7,7
2474,prosa,2,3,4,7
43956,wikiscanner,0,0,7,7
43976,snabbt,0,0,7,7
33713,يوم,0,0,7,7
3105,visitatori,1,7,0,7
34766,உன்னை,0,0,7,7
41458,forbløffende,0,0,7,7
34772,fortsätt,0,0,7,7
51476,numérique,0,0,7,7
5678,rappresentano,1,7,0,7
30047,neden,0,0,7,7
15648,स्थान,0,0,7,7
19619,കാരണം,0,0,7,7
551,nell'ambito,1,7,0,7
19671,repetir,0,0,7,7
15516,weiß,0,0,7,7
224,peter,2,2,5,7
3070,maher,2,3,4,7
19256,werden,0,0,7,7
30278,einige,0,0,7,7
32964,danke,0,0,7,7
43500,lavet,0,0,7,7
30259,அழகாக,0,0,7,7
2985,vedi,1,7,0,7
2590,[...],1,7,0,7
16368,முறை,0,0,7,7
2585,tecnologia,2,6,1,7
30227,calidad,0,0,7,7
16331,colaboradores,0,0,7,7
30218,ಚಿಂತಿಸಬೇಡಿ,0,0,7,7
5545,copertura,1,7,0,7
16230,aujourd,0,0,7,7
16221,καλό,0,0,7,7
41954,статья,0,0,7,7
30195,العالم,0,0,7,7
30127,¿por,0,0,7,7
18961,நிச்சயமாக,0,0,7,7
30181,qualidade,0,0,7,7
16074,devient,0,0,7,7
2545,presso,1,7,0,7
18987,alsof,0,0,7,7
19018,service,0,0,7,7
2531,corsi,1,7,0,7
43785,espèces,0,0,7,7
15987,cited,0,0,7,7
19086,два,0,0,7,7
19097,changement,0,0,7,7
2520,opere,1,7,0,7
19177,linguistique,0,0,7,7
6112,radice,1,7,0,7
13996,imagen,0,0,7,7
36509,भोजन,0,0,7,7
23672,mensagem,0,0,7,7
6656,clustering,2,3,4,7
38717,आपकी,0,0,7,7
46144,rien,0,0,7,7
10965,siden,0,0,7,7
38747,சொல்லுங்கள்,0,0,7,7
6379,correnti,1,7,0,7
11045,आगे,0,0,7,7
31144,جيدة,0,0,7,7
22831,знаете,0,0,7,7
23703,കഴിക്കാൻ,0,0,7,7
22869,liens,0,0,7,7
38714,επόμενη,0,0,7,7
6649,ars,2,2,5,7
46883,øjeblik,0,0,7,7
23645,всегда,0,0,7,7
38838,kelimeyi,0,0,7,7
22876,nett,0,0,7,7
29023,تعلم,0,0,7,7
22920,effect,0,0,7,7
22931,منها,0,0,7,7
1831,comunemente,1,7,0,7
22951,अच्छे,0,0,7,7
22819,seulement,0,0,7,7
23830,llamada,0,0,7,7
23590,potential,0,0,7,7
23330,ಟೆರ್ರಿ,0,0,7,7
39512,libres,0,0,7,7
6674,assunto,2,1,6,7
12526,إنشاء,0,0,7,7
12482,droits,0,0,7,7
315,stream,2,1,6,7
3957,paradigmi,1,7,0,7
6363,conservapedia,2,1,6,7
39420,मीडिया,0,0,7,7
3700,processi,1,7,0,7
31185,podría,0,0,7,7
46067,используется,0,0,7,7
22817,estiver,0,0,7,7
12391,hela,0,0,7,7
39397,suficiente,0,0,7,7
1881,conto,1,7,0,7
35644,meeting,0,0,7,7
12364,الخبز,0,0,7,7
4642,lucro,2,3,4,7
4934,fondo,2,5,2,7
1652,sembrare,1,7,0,7
22798,segundo,0,0,7,7
29060,μαμά,0,0,7,7
31066,умное,0,0,7,7
3762,carnegie,2,2,5,7
29067,ಉದಾಹರಣೆಗೆ,0,0,7,7
23283,dessutom,0,0,7,7
46747,keer,0,0,7,7
4881,inglesi,1,7,0,7
30767,लाख,0,0,7,7
11729,उनके,0,0,7,7
755,beni,2,1,6,7
11685,freunden,0,0,7,7
39100,niveau,0,0,7,7
23250,performing,0,0,7,7
49464,organization,0,0,7,7
28832,revisión,0,0,7,7
11629,جيد,0,0,7,7
34138,терри,0,0,7,7
51841, billion,0,0,7,7
35,sera,2,1,6,7
145,chiamate,1,7,0,7
35559,nature »,0,0,7,7
11420,rapidement,0,0,7,7
46650,riktlinjer,0,0,7,7
28777,permettent,0,0,7,7
1746,matematica,1,7,0,7
11423,जिसमें,0,0,7,7
11446,roll,0,0,7,7
146,venduto,1,7,0,7
23186,ζωή,0,0,7,7
46311,library,0,0,7,7
1798,attivi,1,7,0,7
28985,virtual,0,0,7,7
13433,fonds,0,0,7,7
38876,лучше,0,0,7,7
50814,geral,0,0,7,7
11168,ആരെയെങ്കിലും,0,0,7,7
23029,विषय,0,0,7,7
11962,sería,0,0,7,7
46852,सुंदर,0,0,7,7
39223,maddeler,0,0,7,7
11183,upset,0,0,7,7
31126,ಪದಗಳನ್ನು,0,0,7,7
11815,uppslagsverket,0,0,7,7
140,offre,2,3,4,7
1791,formale,1,7,0,7
3893,servizio,1,7,0,7
11905,ಮುಂದಿನ,0,0,7,7
11891,bare,0,0,7,7
1790,ok,2,3,4,7
46398,ανησυχείτε,0,0,7,7
31122,científica,0,0,7,7
11856,avezvous,0,0,7,7
28953,développé,0,0,7,7
38693,society,0,0,7,7
10857,fácil,0,0,7,7
45972,следующий,0,0,7,7
39935,آخر,0,0,7,7
28581,ihm,0,0,7,7
22012,carriage,0,0,7,7
24015,unido,0,0,7,7
39893,observations,0,0,7,7
22049,tiden,0,0,7,7
13212,jeu,0,0,7,7
24011,मुक्त,0,0,7,7
45538,другой,0,0,7,7
45561,gewoon,0,0,7,7
6706,istanze,1,7,0,7
6207,wikiquote,2,2,5,7
22111,जिस,0,0,7,7
30751,verwirrt,0,0,7,7
47176,encyclopedie,0,0,7,7
13119,которых,0,0,7,7
22156,tels,0,0,7,7
32119,sound,0,0,7,7
13049,acordo,0,0,7,7
22234,hendes,0,0,7,7
23980,चाहिए,0,0,7,7
45684,دائمًا,0,0,7,7
10647,résultat,0,0,7,7
51708,पहला,0,0,7,7
22292,ensuite,0,0,7,7
24054,رائعة,0,0,7,7
4833,l'uomo,1,7,0,7
10477,വേഡ്,0,0,7,7
50927,проекты,0,0,7,7
24148,weißt,0,0,7,7
50225,ber,0,0,7,7
2038,modificare,1,7,0,7
177,cebuano,2,2,5,7
40033,жизни,0,0,7,7
13375,meio,0,0,7,7
4017,confronto,1,7,0,7
32088,случае,0,0,7,7
51698,further,0,0,7,7
1586,disciplina,2,6,1,7
28539,ವ್ಯಕ್ತಿಯನ್ನು,0,0,7,7
45451,अगली,0,0,7,7
35724,சதுப்பு,0,0,7,7
49359,biological,0,0,7,7
13318,jusqu,0,0,7,7
6772,cielo,2,5,2,7
13289,absence,0,0,7,7
3563,Internet,1,7,0,7
39735,बता,0,0,7,7
39822,لي,0,0,7,7
6242,società,1,7,0,7
39651,avaient,0,0,7,7
23883,numbers,0,0,7,7
3638,avrebbe,1,7,0,7
29152,अधिकांश,0,0,7,7
51910,rapport,0,0,7,7
47118,administrators,0,0,7,7
10751,फाउंडेशन,0,0,7,7
12644,opinión,0,0,7,7
35305,provide,0,0,7,7
23940,originally,0,0,7,7
31237,leder,0,0,7,7
22485,proceso,0,0,7,7
6223,rispondere,1,7,0,7
39601,anderen,0,0,7,7
23946,estàdire,0,0,7,7
35652,contributeur,0,0,7,7
22543,விக்கிப்பீடியாவின்,0,0,7,7
33362,tener,0,0,7,7
45739,decirle,0,0,7,7
32167,german,0,0,7,7
22564,talk,0,0,7,7
12925,stating,0,0,7,7
32144,யாரையாவது,0,0,7,7
22374,பிறகு,0,0,7,7
28665,squid,0,0,6,6
30472,diskussionssidor,0,0,6,6
30552,probabilistic,0,0,6,6
5581,sezione,1,6,0,6
5385,bayesiana,2,3,3,6
27494,؛,0,0,6,6
6681,cc,2,2,4,6
28332,debe,0,0,6,6
30176,línea,0,0,6,6
30453,obras,0,0,6,6
30570,savez,0,0,6,6
6950,habitat,2,2,4,6
5594,festival,2,2,4,6
28482,viendo,0,0,6,6
5386,fornito,1,6,0,6
30556,участников,0,0,6,6
28749,этим,0,0,6,6
34552,fiabilité,0,0,6,6
6798,positivi,1,6,0,6
28722,editar,0,0,6,6
32668,enkelt,0,0,6,6
35646,الموسوعة,0,0,6,6
28616,üzerine,0,0,6,6
28578,kära,0,0,6,6
49447,market,0,0,6,6
6868,spiega,1,6,0,6
6653,presto,1,6,0,6
30290,alguna,0,0,6,6
34600,യന്ത്രപഠനം,0,0,6,6
30282,personnes,0,0,6,6
5288,esperienza,1,6,0,6
5490,americana,2,4,2,6
49401,n’est,0,0,6,6
36488,undersökning,0,0,6,6
49274,ret,0,0,6,6
33091,ponds,0,0,6,6
34541,deki,0,0,6,6
28692,εκ,0,0,6,6
28582,científicas,0,0,6,6
50009,شخصًا,0,0,6,6
7514,chiamata,1,6,0,6
28545,пожалуйста,0,0,6,6
6718,proprie,1,6,0,6
34667,тем,0,0,6,6
5279,iniziato,1,6,0,6
50062,iki,0,0,6,6
5412,trova,1,6,0,6
32691,continents,0,0,6,6
6866,feedback,2,3,3,6
30219,musst,0,0,6,6
35693,added,0,0,6,6
6744,preoccupazione,1,6,0,6
28605,selv,0,0,6,6
30540,soms,0,0,6,6
50099,методы,0,0,6,6
6696,organizzazioni,1,6,0,6
27595,कभी,0,0,6,6
7169,encarta,2,2,4,6
30151,привет,0,0,6,6
27929,enciclopédias,0,0,6,6
30716,anses,0,0,6,6
35019,deixeme,0,0,6,6
35000,culturelle,0,0,6,6
5935,collaboratori,1,6,0,6
35300,problèmes,0,0,6,6
27966,आपसे,0,0,6,6
29226,fille,0,0,6,6
36107,please,0,0,6,6
29700,ദയവായി,0,0,6,6
34989,такой,0,0,6,6
29165,rule,0,0,6,6
7222,giapponese,1,6,0,6
6277,nessun,1,6,0,6
5972,Times,1,6,0,6
6289,stavo,1,6,0,6
29727,dochter,0,0,6,6
49789,conoce,0,0,6,6
6320,provenienti,1,6,0,6
30840,decisiones,0,0,6,6
35377,formed,0,0,6,6
7229,campione,1,6,0,6
32620,looked,0,0,6,6
27907,cannot,0,0,6,6
29754,इस्तेमाल,0,0,6,6
49201,actions,0,0,6,6
29773,frères,0,0,6,6
34289,œuvre,0,0,6,6
29503,little,0,0,6,6
6573,studi,1,6,0,6
7141,wikibooks,2,2,4,6
7161,dunque,1,6,0,6
7153,potrei,1,6,0,6
6123,inferiore,1,6,0,6
6082,obiettivo,1,6,0,6
29412,आपका,0,0,6,6
32847,leitores,0,0,6,6
49689,horrible,0,0,6,6
6074,risorse,1,6,0,6
49143,variety,0,0,6,6
29431,ordnung,0,0,6,6
29435,ನಡೆಯುತ್ತಿದೆ,0,0,6,6
49649,referred,0,0,6,6
49645,eerste,0,0,6,6
7115,sopa,2,1,5,6
29303,ham,0,0,6,6
7133,cellule,1,6,0,6
6183,nata,1,6,0,6
7120,rispettivamente,1,6,0,6
35248,prata,0,0,6,6
30737,φορά,0,0,6,6
6187,mondiale,2,3,3,6
6013,addestramento.,1,6,0,6
6004,ann,2,3,3,6
5987,pae,2,2,4,6
5985,qualcuno.,1,6,0,6
6195,piacere,1,6,0,6
6366,intitolato,1,6,0,6
27896,sett,0,0,6,6
33019,ಏನಾದರೂ,0,0,6,6
35495,ನಿಧಾನಗತಿಯ,0,0,6,6
7340,ilp,2,4,2,6
27726,kommentar,0,0,6,6
7365,tron,2,2,4,6
5702,suite,2,1,5,6
29971,vanliga,0,0,6,6
28979,πάω,0,0,6,6
49530,træg,0,0,6,6
34808,multimedia,0,0,6,6
6453,wired,2,2,4,6
34779,successful,0,0,6,6
30638,increase,0,0,6,6
30060,labeled,0,0,6,6
6497,indicare,1,6,0,6
34938,ചിലർ,0,0,6,6
27661,lide,0,0,6,6
5662,rendering,2,3,3,6
30071,projecten,0,0,6,6
35542,experiencia,0,0,6,6
34732,ಹೇಳಿ,0,0,6,6
7419,stanford,2,2,4,6
5637,accademici,1,6,0,6
28795,artificielle,0,0,6,6
28784,experter,0,0,6,6
49471,contrast,0,0,6,6
32904,ಸಹಾಯ,0,0,6,6
6563,economic,2,1,5,6
34830,بالفعل,0,0,6,6
6405,normale,1,6,0,6
7330,computational,2,1,5,6
35436,huh,0,0,6,6
27875,études,0,0,6,6
29807,poäng,0,0,6,6
5815,ritiene,1,6,0,6
35983,compris,0,0,6,6
36151,അവിടെ,0,0,6,6
7280,cura,1,6,0,6
27864,amerikaner,0,0,6,6
29895,hitta,0,0,6,6
36173,уверен,0,0,6,6
5786,esistono,1,6,0,6
34867,منك,0,0,6,6
7297,movimento,1,6,0,6
28150,संग्रह,0,0,6,6
36183,okej,0,0,6,6
34300,இரண்டு,0,0,6,6
34839,помочь,0,0,6,6
5765,Wales,1,6,0,6
7024,biblioteca,2,3,3,6
34838,содержания,0,0,6,6
27764,englishlanguage,0,0,6,6
7004,wikireader,2,4,2,6
34387,noite,0,0,6,6
5747,me.,1,6,0,6
49549,criação,0,0,6,6
29033,методов,0,0,6,6
35950,vivant,0,0,6,6
42713,https,0,0,6,6
27323,characteristic,0,0,6,6
44985,മന്ദഗതിയിലുള്ള,0,0,6,6
14022,icke,0,0,6,6
40403,تحصل,0,0,6,6
14049,língua,0,0,6,6
14058,இல்,0,0,6,6
44999,leuk,0,0,6,6
14093,emin,0,0,6,6
44982,d’un,0,0,6,6
13997,matière,0,0,6,6
14119,kære,0,0,6,6
14129,vergeet,0,0,6,6
14152,dahaki,0,0,6,6
21171,تغييرات,0,0,6,6
21158,segunda,0,0,6,6
31392,egen,0,0,6,6
45035,bitte,0,0,6,6
45069,рандеву,0,0,6,6
44895,कोण,0,0,6,6
33522,projektet,0,0,6,6
21392,machen,0,0,6,6
21388,பிழைத்திருத்தத்தில்,0,0,6,6
13773,countries,0,0,6,6
45180,deres,0,0,6,6
40318,ξέρω,0,0,6,6
21292,ऐसे,0,0,6,6
40358,سيكون,0,0,6,6
13952,visitors,0,0,6,6
45135,lorsque,0,0,6,6
21278,चाहिए।,0,0,6,6
13887,views,0,0,6,6
13903,flesta,0,0,6,6
45100,artiklarna,0,0,6,6
13930,τότε,0,0,6,6
40456,pensée,0,0,6,6
21104,url,0,0,6,6
40278,ortaklaşa,0,0,6,6
20634,factors,0,0,6,6
14653,largement,0,0,6,6
14670,brain,0,0,6,6
40698,sefere,0,0,6,6
20678,விரும்பவில்லை,0,0,6,6
44593,kendini,0,0,6,6
20653,four,0,0,6,6
20495,droit,0,0,6,6
20775,level,0,0,6,6
44541,rivers,0,0,6,6
20451,നിമിഷം,0,0,6,6
40890,labels,0,0,6,6
31401,कवर,0,0,6,6
20424,வீட்டிற்கு,0,0,6,6
20405,वर्णन,0,0,6,6
20774,quase,0,0,6,6
44660,éditions,0,0,6,6
21050,günlük,0,0,6,6
14446,tenha,0,0,6,6
40521,upprörd,0,0,6,6
14340,yourself,0,0,6,6
14352,créée,0,0,6,6
40555,déjame,0,0,6,6
14410,stomp,0,0,6,6
44788,discussion,0,0,6,6
40600,؟,0,0,6,6
20803,montre,0,0,6,6
20844,recent,0,0,6,6
14504,ಸಮಯದಲ್ಲಿ,0,0,6,6
14519,mettre,0,0,6,6
20843,entries,0,0,6,6
14528,mí,0,0,6,6
40636,начала,0,0,6,6
40279,yanı,0,0,6,6
13611,നാർസിസസ്,0,0,6,6
14944,kelimeler,0,0,6,6
34026,ಕೇಳಲು,0,0,6,6
12779,ಬಾರಿ,0,0,6,6
45818,ordre,0,0,6,6
12820,deste,0,0,6,6
12840,dagelijks,0,0,6,6
22394,créé,0,0,6,6
12847,remember,0,0,6,6
45782,voy,0,0,6,6
22428,gouden,0,0,6,6
22355,plan,0,0,6,6
45761,വീണ്ടും,0,0,6,6
33435,canal,0,0,6,6
32151,local,0,0,6,6
39684,ಕ್ಷಣ,0,0,6,6
12899,hija,0,0,6,6
34044,neutralité,0,0,6,6
22470,veut,0,0,6,6
13027,uw,0,0,6,6
22611,ângulo,0,0,6,6
22810,résultats,0,0,6,6
22796,vandalisme,0,0,6,6
12394,grader,0,0,6,6
22746,connaissances,0,0,6,6
39431,ஒருவர்,0,0,6,6
22657,crying,0,0,6,6
22594,yani,0,0,6,6
12687,specifically,0,0,6,6
12589,environnement,0,0,6,6
12602,ларри,0,0,6,6
12610,rapports,0,0,6,6
33427,difficult,0,0,6,6
12662,fields,0,0,6,6
22510,pass,0,0,6,6
22302,existence,0,0,6,6
22159,حصلت,0,0,6,6
13606,cobertura,0,0,6,6
45369,allons,0,0,6,6
13403,جيمي,0,0,6,6
13455,kişiyi,0,0,6,6
40136,нарциса,0,0,6,6
13463,процессе,0,0,6,6
40163,درجة,0,0,6,6
13476,fortæller,0,0,6,6
13485,particularmente,0,0,6,6
40046,obtenir,0,0,6,6
40165,alemão,0,0,6,6
40176,humains,0,0,6,6
21567,أقول,0,0,6,6
13567,да,0,0,6,6
13574,solar,0,0,6,6
13584,wikipedistas,0,0,6,6
21760,aynı,0,0,6,6
13376,друзьями,0,0,6,6
13091,celui,0,0,6,6
33474,blevet,0,0,6,6
45608,net,0,0,6,6
39831,whole,0,0,6,6
39848,пока,0,0,6,6
13157,frage,0,0,6,6
39858,portanto,0,0,6,6
39862,características,0,0,6,6
39913,demasiado,0,0,6,6
21808,amigo,0,0,6,6
45486,savoir,0,0,6,6
31285,खुश,0,0,6,6
21933,lassen,0,0,6,6
39987,certaine,0,0,6,6
21841,simplement,0,0,6,6
31342,maman,0,0,6,6
33580,എന്നാണ്,0,0,6,6
40950,около,0,0,6,6
12285,nødt,0,0,6,6
16668,plats,0,0,6,6
33817,അവരുടെ,0,0,6,6
43389,wo,0,0,6,6
16605,upprepa,0,0,6,6
18408,sábado,0,0,6,6
43353,стороны,0,0,6,6
42223,begon,0,0,6,6
18362,पाठ,0,0,6,6
43407,καθημερινή,0,0,6,6
42246,willst,0,0,6,6
43270,रिपोर्ट,0,0,6,6
42295,разных,0,0,6,6
43188,fortsæt,0,0,6,6
16916,esprit,0,0,6,6
42337,गलत,0,0,6,6
18480,noche,0,0,6,6
16549,algorithme,0,0,6,6
43134,¿te,0,0,6,6
18624,werde,0,0,6,6
18704,επιδιόρθωση,0,0,6,6
18703,argued,0,0,6,6
43508,"है।
",0,0,6,6
16401,vraag,0,0,6,6
43505,жаль,0,0,6,6
18625,gentage,0,0,6,6
18613,editoriais,0,0,6,6
33826,krijgt,0,0,6,6
31663,danske,0,0,6,6
5227,nuova,1,6,0,6
18592,sagst,0,0,6,6
18581,hace,0,0,6,6
42087,могли,0,0,6,6
16491,gesagt,0,0,6,6
42347,clusters,0,0,6,6
18172,permettant,0,0,6,6
18751,الأمر,0,0,6,6
42791,instance,0,0,6,6
17407,له,0,0,6,6
42837,allemaal,0,0,6,6
42836,máquinas,0,0,6,6
17759,hjælpe,0,0,6,6
17442,harder,0,0,6,6
42806,decisions,0,0,6,6
17524,doğru,0,0,6,6
31610,acuerdo,0,0,6,6
42662,وفي,0,0,6,6
17560,கேட்ச்,0,0,6,6
17570,indo,0,0,6,6
17660,större,0,0,6,6
17652,ಉತ್ತಮ,0,0,6,6
17626,άλλες,0,0,6,6
17385,ಜೀವನದಲ್ಲಿ,0,0,6,6
42863,yine,0,0,6,6
42358,दो।,0,0,6,6
17971,entry,0,0,6,6
43091,λέτε,0,0,6,6
17030,formas,0,0,6,6
18143,snart,0,0,6,6
18083,иногда,0,0,6,6
18040,goede,0,0,6,6
42486,είχε,0,0,6,6
42523,diciendo,0,0,6,6
17803,угол,0,0,6,6
17291,istiyorsanız,0,0,6,6
17308,prodigieux,0,0,6,6
42575,vestido,0,0,6,6
42580,शायद,0,0,6,6
17819,बेहतर,0,0,6,6
17359,formal,0,0,6,6
16352,buna,0,0,6,6
31545,altid,0,0,6,6
14981,olur,0,0,6,6
15437,समाचार,0,0,6,6
20033,வரை,0,0,6,6
19996,range,0,0,6,6
15346,വിഷമിക്കേണ്ട,0,0,6,6
19939,comenzó,0,0,6,6
44140,mach,0,0,6,6
44138,träge,0,0,6,6
41235,jij,0,0,6,6
44228,herhangi,0,0,6,6
44114,jezelf,0,0,6,6
15501,между,0,0,6,6
15518,datum,0,0,6,6
31772,latest,0,0,6,6
19625,comigo,0,0,6,6
19614,freunde,0,0,6,6
20114,pobre,0,0,6,6
44265,उपयोगकर्ता,0,0,6,6
19581,completely,0,0,6,6
15076,modern,0,0,6,6
31909,context,0,0,6,6
20317,içinde,0,0,6,6
15031,νούμερο,0,0,6,6
20304,hjælp,0,0,6,6
40979,مؤسسة,0,0,6,6
20274,författare,0,0,6,6
15094,jam,0,0,6,6
31876,இன்று,0,0,6,6
20251,category,0,0,6,6
20242,increíble,0,0,6,6
44317,turn,0,0,6,6
20201,emploi,0,0,6,6
44305,différents,0,0,6,6
15207,telefon,0,0,6,6
19606,продолжайте,0,0,6,6
19541,வார்த்தையை,0,0,6,6
18762,gjorde,0,0,6,6
18952,plutôt,0,0,6,6
41758,അതിൽ,0,0,6,6
41770,μόνο,0,0,6,6
33726,contar,0,0,6,6
19007,مكان,0,0,6,6
33736,dear,0,0,6,6
18965,критики,0,0,6,6
18911,खेद,0,0,6,6
19117,затем,0,0,6,6
18853,cuanto,0,0,6,6
31535,அவளுடைய,0,0,6,6
16213,realizada,0,0,6,6
16235,عبر,0,0,6,6
43605,cours,0,0,6,6
41970,videnskabelige,0,0,6,6
43805,wagen,0,0,6,6
41719,coisas,0,0,6,6
15680,agit,0,0,6,6
15762,conducted,0,0,6,6
19510,regras,0,0,6,6
41499,beauté,0,0,6,6
19494,realidad,0,0,6,6
19462,tus,0,0,6,6
19460,gik,0,0,6,6
19444,until,0,0,6,6
33699,dispositivos,0,0,6,6
19196,yavaş,0,0,6,6
31476,auteurs,0,0,6,6
43905,науки,0,0,6,6
41627,ise,0,0,6,6
15819,hör,0,0,6,6
15838,بطيئة,0,0,6,6
41663,हूँ।,0,0,6,6
12318,quais,0,0,6,6
12261,ಮನೆಗೆ,0,0,6,6
48906,இருந்தால்,0,0,6,6
8812,carr,2,1,5,6
25722,hjem,0,0,6,6
8734,catch-,1,6,0,6
8752,selezione,1,6,0,6
25651,प्रयास,0,0,6,6
8774,aprile,1,6,0,6
8794,digitale,2,3,3,6
8890,zona,2,5,1,6
37526,nourriture,0,0,6,6
8894,dovrebbe,1,6,0,6
8941,noi,1,6,0,6
37679,शानदार,0,0,6,6
48251,rédaction,0,0,6,6
25403,معلومات,0,0,6,6
9018,prenderlo,1,6,0,6
37549,beskriver,0,0,6,6
8696,appropriate,2,1,5,6
48214,amsterdam,0,0,6,6
37375,эта,0,0,6,6
37304,ни,0,0,6,6
26084,terrible,0,0,6,6
26019,daran,0,0,6,6
37368,need,0,0,6,6
8597,donna,2,5,1,6
8603,fortemente,2,4,2,6
8612,ricordati,1,6,0,6
37505,ever,0,0,6,6
37461,frente,0,0,6,6
8648,bisogno,1,6,0,6
8666,migliore,1,6,0,6
8670,ei,2,3,3,6
30931,populaire,0,0,6,6
8684,organismi,1,6,0,6
48218,gezien,0,0,6,6
9027,rappresentazioni,1,6,0,6
26170,måske,0,0,6,6
24944,ദിവസം,0,0,6,6
9456,umm,0,0,6,6
47931,знаешь,0,0,6,6
25034,hallo,0,0,6,6
38014,step,0,0,6,6
47907,തിരഞ്ഞെടുത്ത,0,0,6,6
47895,partes,0,0,6,6
9572,sikker,0,0,6,6
25088,respectively,0,0,6,6
47860,onu,0,0,6,6
24939,nearly,0,0,6,6
30986,issue,0,0,6,6
38054,críticos,0,0,6,6
47831,contribuintes,0,0,6,6
9627,units,0,0,6,6
25086,الطعام,0,0,6,6
9364,abril,0,0,6,6
25365,leben,0,0,6,6
9172,plupart,0,0,6,6
37792,discovery,0,0,6,6
48185,tradicionais,0,0,6,6
9104,administratorer,0,0,6,6
37808,говорите,0,0,6,6
37809,ángulo,0,0,6,6
33294,filha,0,0,6,6
9211,φράσεις,0,0,6,6
9344,ejemplos,0,0,6,6
25241,titled,0,0,6,6
37877,पसंद,0,0,6,6
9255,attention,0,0,6,6
9262,ederim,0,0,6,6
48046,jemandem,0,0,6,6
9291,supervisado,0,0,6,6
37258,regler,0,0,6,6
26171,вашей,0,0,6,6
47825,ഗണിത,0,0,6,6
8042,mie,1,6,0,6
30884,είπε,0,0,6,6
36818,hjälpa,0,0,6,6
7984,nell'edizione,1,6,0,6
26818,needed,0,0,6,6
48734,φίλοι,0,0,6,6
8030,azioni,1,6,0,6
8084,modifiche.,1,6,0,6
36773,impacts,0,0,6,6
48692,volunteer,0,0,6,6
8102,miglioramento,1,6,0,6
48683,κάτω,0,0,6,6
26690,capacité,0,0,6,6
8122,applicato,1,6,0,6
36931,utilizada,0,0,6,6
7951,decisionale,1,6,0,6
26927,машинного,0,0,6,6
26626,конечно,0,0,6,6
36596,இருக்கிறீர்கள்,0,0,6,6
48899,initially,0,0,6,6
7665,sembrava,1,6,0,6
27216,skarp,0,0,6,6
7714,bravo,2,4,2,6
48873,humaines,0,0,6,6
7731,ottieni,1,6,0,6
32551,differences,0,0,6,6
48786,ذكية,0,0,6,6
27173,aantal,0,0,6,6
36622,generalization,0,0,6,6
32547,aider,0,0,6,6
27085,ಹಾಗೆ,0,0,6,6
36660,ger,0,0,6,6
36739,அம்மா,0,0,6,6
26684,बिना,0,0,6,6
26623,vandalismos,0,0,6,6
8489,esso,1,6,0,6
8447,triste,2,2,4,6
26369,incroyable,0,0,6,6
37139,children,0,0,6,6
8398,mantenere,1,6,0,6
8416,siamo,1,6,0,6
8433,citando,2,2,4,6
8442,settimana,1,6,0,6
37185,terre,0,0,6,6
1,dispute,2,2,4,6
8453,impact,2,1,5,6
26292,അനേകം,0,0,6,6
32493,resultados,0,0,6,6
37209,använde,0,0,6,6
48500,sun,0,0,6,6
37213,endişelenme,0,0,6,6
32506,instances,0,0,6,6
8343,indicato,1,6,0,6
26607,describe,0,0,6,6
48608,redigera,0,0,6,6
36983,мире,0,0,6,6
26586,позже,0,0,6,6
8200,bancario,2,4,2,6
48636,தொகுப்புக்கள்,0,0,6,6
32523,escreveu,0,0,6,6
36995,needs,0,0,6,6
26534,freaked,0,0,6,6
26440,wilderness,0,0,6,6
26497,six,0,0,6,6
37053,страницы,0,0,6,6
37066,واحد,0,0,6,6
37073,utilise,0,0,6,6
8334,pregiudizio,1,6,0,6
8336,rappresentato,1,6,0,6
24909,weinen,0,0,6,6
24890,optimization,0,0,6,6
12245,നിന്നും,0,0,6,6
46693,modification,0,0,6,6
46752,tur,0,0,6,6
11346,αμβλεία,0,0,6,6
46734,linear,0,0,6,6
31105,सही,0,0,6,6
23359,याद,0,0,6,6
39023,redigeras,0,0,6,6
11414,relacionados,0,0,6,6
38933,учтивый,0,0,6,6
23326,endast,0,0,6,6
46661,gick,0,0,6,6
39046,wikis,0,0,6,6
11465,organizations,0,0,6,6
46653,ocupado,0,0,6,6
23304,yardım,0,0,6,6
46797,chamado,0,0,6,6
46824,αυτά,0,0,6,6
11494,बीच,0,0,6,6
38761,outside,0,0,6,6
47058,glad,0,0,6,6
32278,الوقت,0,0,6,6
10874,apache,0,0,6,6
23843,belki,0,0,6,6
33373,educado,0,0,6,6
46938,после,0,0,6,6
23738,ಯಾವಾಗಲೂ,0,0,6,6
46854,definition,0,0,6,6
23653,action,0,0,6,6
23623,själv,0,0,6,6
23622,values,0,0,6,6
38853,quatre,0,0,6,6
46863,protection,0,0,6,6
38866,illustrations,0,0,6,6
31111,κατάσταση,0,0,6,6
46630,artiklarnas,0,0,6,6
10849,vagnen,0,0,6,6
12069,obtenu,0,0,6,6
39233,individual,0,0,6,6
23005,φορές,0,0,6,6
12011,दोनों,0,0,6,6
31132,லாரி,0,0,6,6
34102,haven,0,0,6,6
22992,أفعل,0,0,6,6
22943,करती,0,0,6,6
39200,experts,0,0,6,6
39292,ίσως,0,0,6,6
22908,femmes,0,0,6,6
22904,biology,0,0,6,6
12179,sim,0,0,6,6
39327,sidan,0,0,6,6
22858,meilleur,0,0,6,6
23072,tekst,0,0,6,6
11872,verwendet,0,0,6,6
11515,opposition,0,0,6,6
11675,должны,0,0,6,6
46616,corriger,0,0,6,6
11537,думаю,0,0,6,6
34112,vem,0,0,6,6
11648,சாங்கர்,0,0,6,6
11663,excuses,0,0,6,6
11665,tinham,0,0,6,6
46506,बेटी,0,0,6,6
46422,message,0,0,6,6
23229,obter,0,0,6,6
23218,moyen,0,0,6,6
46473,bliver,0,0,6,6
23173,ಮತ್ತೊಂದು,0,0,6,6
11779,visade,0,0,6,6
11834,genial,0,0,6,6
47059,सैक्सन,0,0,6,6
10832,única,0,0,6,6
32380,αργή,0,0,6,6
47532,غارق,0,0,6,6
10051,previously,0,0,6,6
24633,acho,0,0,6,6
47554,snel,0,0,6,6
10088,predict,0,0,6,6
38253,geld,0,0,6,6
10095,sorte,0,0,6,6
47529,communication,0,0,6,6
47606,जून,0,0,6,6
10138,tochter,0,0,6,6
10148,five,0,0,6,6
34181,länge,0,0,6,6
34180,bilder,0,0,6,6
38280,ಅವಳ,0,0,6,6
24525,статье,0,0,6,6
10037,efforts,0,0,6,6
24654,göre,0,0,6,6
24480,colaboración,0,0,6,6
32347,mehr,0,0,6,6
9690,πω,0,0,6,6
38114,beautiful,0,0,6,6
24818,kritik,0,0,6,6
38125,trend,0,0,6,6
9743,comes,0,0,6,6
24763,поскольку,0,0,6,6
24741,regarding,0,0,6,6
9952,usan,0,0,6,6
47704,ചെയ്യുന്നത്,0,0,6,6
38170,mesa,0,0,6,6
9911,slowly,0,0,6,6
38188,future,0,0,6,6
47637,ಚೆನ್ನಾಗಿ,0,0,6,6
9944,randevu,0,0,6,6
24512,octobre,0,0,6,6
38321,ಏಕೆ,0,0,6,6
23861,തവണ,0,0,6,6
10682,εσάς,0,0,6,6
10631,ನಾರ್ಸಿಸಸ್,0,0,6,6
17623,λες,0,0,6,6
10654,αγγλικά,0,0,6,6
24036,store,0,0,6,6
23991,lütfen,0,0,6,6
32286,sample,0,0,6,6
31053,terwijl,0,0,6,6
38568,daughter,0,0,6,6
23907,विध्वंस,0,0,6,6
23895,ಕೆಲವೊಮ್ಮೆ,0,0,6,6
23893,används,0,0,6,6
10787,कल,0,0,6,6
38685,europe,0,0,6,6
38689,varias,0,0,6,6
47218,извините,0,0,6,6
10578,milhão,0,0,6,6
24463,اللغات,0,0,6,6
38468,ದಯವಿಟ್ಟು,0,0,6,6
47451,mañana,0,0,6,6
24447,informatique,0,0,6,6
10259,часть,0,0,6,6
31014,ജനുവരി,0,0,6,6
24395,vier,0,0,6,6
47364,उसके,0,0,6,6
24225,groups,0,0,6,6
32300,longtemps,0,0,6,6
10450,train,0,0,6,6
10464,однако,0,0,6,6
24138,técnicas,0,0,6,6
10536,contra,0,0,6,6
10553,nice,0,0,6,6
24089,ಇತರ,0,0,6,6
47199,helst,0,0,6,6
16471,gesehen,0,0,6,6
50159,meaning,0,0,6,6
4773,netflix,2,3,3,6
52257,criar,0,0,6,6
431,l'edizione,1,6,0,6
4684,eckart,2,1,5,6
2264,scritte,1,6,0,6
3285,l'intera,1,6,0,6
51925,samt,0,0,6,6
51761,ability,0,0,6,6
2186,vuole,1,6,0,6
4544,albero,1,6,0,6
54,capo,1,6,0,6
304,piaciuto,1,6,0,6
51189,génial,0,0,6,6
2169,domesday,2,2,4,6
51566,secreto,0,0,6,6
134,produrre,1,6,0,6
3687,fiumi,1,6,0,6
51340,män,0,0,6,6
50194,majority,0,0,6,6
508,Il,1,6,0,6
50376,ಮರಿಯನ್,0,0,6,6
1499,l'output,1,6,0,6
51455,entrada,0,0,6,6
1128,terzo,1,6,0,6
4800,conversazione,1,6,0,6
4313,determinate,1,6,0,6
3281,terreno,1,6,0,6
50929,சாப்பிட,0,0,6,6
679,viventi,1,6,0,6
50529,required,0,0,6,6
3950,e.,1,6,0,6
52134,രസകരമായ,0,0,6,6
3467,ripeterlo,1,6,0,6
3216,mobili,1,6,0,6
2541,questo.,1,6,0,6
4941,ceo,2,2,4,6
4408,valutazione,1,6,0,6
2959,venuto,1,6,0,6
1829,ibm,2,1,5,6
1702,problema.,1,6,0,6
2303,domani,1,6,0,6
51236,mamá,0,0,6,6
2325,risolvere,1,6,0,6
3719,big,2,2,4,6
4208,atlantic,2,1,5,6
3414,mio.,1,6,0,6
546,attivo,1,6,0,6
51734,ಅಂದರೆ,0,0,6,6
555,servizi,1,6,0,6
50548,grupos,0,0,6,6
2524,beh,1,6,0,6
3190,occhi,1,6,0,6
4536,italiana,2,5,1,6
3047,frequentemente,2,2,4,6
3982,gruppi,1,6,0,6
4361,suoni,1,6,0,6
2066,affermando,1,6,0,6
179,fluente,2,3,3,6
4093,kernel,2,3,3,6
4979,febbraio,1,6,0,6
527,definita,1,6,0,6
3191,dovrei,1,6,0,6
4229,multilingue,2,3,3,6
51672,بطريقة,0,0,6,6
2376,natura.,1,6,0,6
649,questione,1,6,0,6
621,avanti.,1,6,0,6
1899,tedesco,1,6,0,6
4984,archaea,2,3,3,6
5093,classificare,1,6,0,6
4310,complessa,1,6,0,6
171,energia,2,5,1,6
1111,correlato,1,6,0,6
1960,esterno,1,6,0,6
52387,valeur,0,0,6,6
3415,posizione,1,6,0,6
52118,française,0,0,6,6
2350,latina,2,4,2,6
3541,ultime,2,5,1,6
4392,florida,2,1,5,6
3606,un'ampia,1,6,0,6
4444,francese,1,6,0,6
5051,unici,1,6,0,6
51659,produit,0,0,6,6
50611,القول,0,0,6,6
51568,δείτε,0,0,6,6
2163,rilevare,1,6,0,6
4832,l'acqua,1,6,0,6
4689,chiesto,1,6,0,6
4342,l'oceano,1,6,0,6
2976,incontro,1,6,0,6
1674,k,2,2,4,6
5123,considerata,1,6,0,6
51397,só,0,0,6,6
50948,ரெண்டெஸ்வஸ்,0,0,6,6
3045,basa,2,4,2,6
50593,grad,0,0,6,6
2269,variabili,1,6,0,6
286,fortuna,2,4,2,6
2579,vanno,1,6,0,6
3283,progettati,1,6,0,6
52518,dröm,0,0,6,6
3230,toc,2,3,3,6
4372,probabilistico,1,6,0,6
3806,messenger,2,2,4,6
2158,wikimedia.,1,6,0,6
2462,accademica,1,6,0,6
50144,στα,0,0,6,6
3752,luogo,1,6,0,6
5119,prestito,1,6,0,6
50961,stallman,0,0,6,6
1635,trovano,1,6,0,6
4487,lì,1,6,0,6
3644,mantiene,2,3,3,6
3853,contrario,2,4,2,6
1333,photos,2,1,5,6
51293,ligesom,0,0,6,6
1537,rimane,1,6,0,6
2393,baidu,2,1,5,6
1209,richard,2,1,5,6
3660,l'accesso,1,6,0,6
4936,devo,2,5,1,6
2057,succedendo,1,6,0,6
50664,ελεύθερης,0,0,6,6
2669,premi,1,6,0,6
2431,scritti,1,6,0,6
50340,évolution,0,0,6,6
4657,parola.,1,6,0,6
51394,définition,0,0,6,6
3761,p,2,4,2,6
4557,stephen,2,1,5,6
4433,sviluppato,1,6,0,6
50675,eve,0,0,6,6
4966,matrimonio,2,4,2,6
2526,testi,1,6,0,6
2738,presentare,1,6,0,6
52260,домой,0,0,6,6
51284,förlåt,0,0,6,6
52702,മറ്റു,0,0,6,6
4421,oceano,1,6,0,6
50860,controversial,0,0,6,6
1801,quotidiana,1,6,0,6
1972,college,2,2,4,6
50209,desarrollo,0,0,6,6
2472,l'ambiente,1,6,0,6
2663,Stati,1,6,0,6
3844,lineare,1,6,0,6
2091,geografia,2,4,2,6
4556,cyberarts,2,2,4,6
5008,etichette,1,6,0,6
2083,componenti,1,6,0,6
3320,file,2,4,2,6
1873,membri,1,6,0,6
2418,disponibile,1,6,0,6
30444,vocês,0,0,5,5
13772,either,0,0,5,5
44938,tillsammans,0,0,5,5
48585,حوالي,0,0,5,5
38356,innebär,0,0,5,5
22430,siguiente,0,0,5,5
44846,täglichen,0,0,5,5
22476,niets,0,0,5,5
28717,terrain,0,0,5,5
20353,नए,0,0,5,5
39621,falar,0,0,5,5
39602,ubuntu,0,0,5,5
33829,autonome,0,0,5,5
3127,ten,2,1,4,5
9846,objects,0,0,5,5
35628,evidence,0,0,5,5
17821,gained,0,0,5,5
27400,müde,0,0,5,5
4950,jaffe,2,2,3,5
17339,our,0,0,5,5
42584,ಸಂಪೂರ್ಣವಾಗಿ,0,0,5,5
1541,pianeta,1,5,0,5
48580,நண்பர்களுடன்,0,0,5,5
6280,collaborazione,1,5,0,5
46173,enorm,0,0,5,5
26628,varje,0,0,5,5
31550,വീഡിയോ,0,0,5,5
12225,ಮಾಡಿದ್ದೇನೆ,0,0,5,5
33849,نيويورك,0,0,5,5
12784,उपयोगी,0,0,5,5
12783,spørge,0,0,5,5
45828,korkunç,0,0,5,5
48582,பெரிய,0,0,5,5
7762,l'attività,1,5,0,5
43558,patrimoine,0,0,5,5
4461,effetti,1,5,0,5
8316,tavolo,1,5,0,5
44851,wurde,0,0,5,5
24378,responsabilité,0,0,5,5
1295,richiedono,1,5,0,5
26661,neutro,0,0,5,5
28772,night,0,0,5,5
36948,dirigido,0,0,5,5
27371,continuer,0,0,5,5
27375,സാധാരണ,0,0,5,5
20366,ದೈನಂದಿನ,0,0,5,5
38399,université,0,0,5,5
46161,उसी,0,0,5,5
14188,गूगल,0,0,5,5
30469,lagras,0,0,5,5
23213,अपना,0,0,5,5
3654,comitato,1,5,0,5
6352,traffico,1,5,0,5
50797,streams,0,0,5,5
38667,crescimento,0,0,5,5
6349,significativo,2,4,1,5
24336,darwin,0,0,5,5
42858,കാണാൻ,0,0,5,5
20523,donné,0,0,5,5
26664,стоит,0,0,5,5
22568,gyllene,0,0,5,5
31412,πραγματικότητα,0,0,5,5
12712,episode,0,0,5,5
462,economia,2,2,3,5
3973,geologia,1,5,0,5
22557,bange,0,0,5,5
35575,conocida,0,0,5,5
21047,associations,0,0,5,5
19331,besser,0,0,5,5
11452,zie,0,0,5,5
1086,walsh,2,1,4,5
40840,cinco,0,0,5,5
4779,dell'articolo.,1,5,0,5
50836,zag,0,0,5,5
14189,wanneer,0,0,5,5
33914,उनकी,0,0,5,5
8281,utenti.,1,5,0,5
28760,πήρε,0,0,5,5
13775,chine,0,0,5,5
6309,singola,1,5,0,5
656,alcuna,1,5,0,5
38375,correct,0,0,5,5
12760,chez,0,0,5,5
51906,yorgun,0,0,5,5
12762,சந்திப்பு,0,0,5,5
28721,polar,0,0,5,5
14184,share,0,0,5,5
24377,intended,0,0,5,5
16314,റെൻഡെജൂസ്,0,0,5,5
47377,aí,0,0,5,5
9837,അവന്റെ,0,0,5,5
42874,desconcertado,0,0,5,5
25258,दे,0,0,5,5
4946,slashdot,2,1,4,5
12768,लायक,0,0,5,5
7072,descrivono,1,5,0,5
48591,novembro,0,0,5,5
38377,colaborar,0,0,5,5
28758,arbeiten,0,0,5,5
1292,fame,1,5,0,5
20809,fim,0,0,5,5
22530,lot,0,0,5,5
28755,संपादित,0,0,5,5
40938,ಮತ್ತೆ,0,0,5,5
7778,cioè,1,5,0,5
8290,vedere.,1,5,0,5
27381,tendance,0,0,5,5
51135,αυτός,0,0,5,5
31571,seninle,0,0,5,5
31477,भयानक,0,0,5,5
15188,geralmente,0,0,5,5
31480,φαγητό,0,0,5,5
15758,फॉर,0,0,5,5
45845,جملة,0,0,5,5
12755,components,0,0,5,5
38382,interfaz,0,0,5,5
50711,γι,0,0,5,5
23626,محرري,0,0,5,5
48856,construction,0,0,5,5
39058,priori,0,0,5,5
31774,principaux,0,0,5,5
48074,maintain,0,0,5,5
9243,preocupes,0,0,5,5
13723,हर,0,0,5,5
9065,progetto.,1,5,0,5
33680,bijna,0,0,5,5
41169,göbl,0,0,5,5
9440,disponíveis,0,0,5,5
46751,easy,0,0,5,5
645,cima,2,2,3,5
6095,miglior,1,5,0,5
222,usarlo,2,3,2,5
6089,disposizione,1,5,0,5
51209,beschikbaar,0,0,5,5
49159,stykke,0,0,5,5
28541,ögonblick,0,0,5,5
24528,identité,0,0,5,5
6081,networking,2,1,4,5
30360,αυτές,0,0,5,5
21121,പലപ്പോഴും,0,0,5,5
20309,ομορφιά,0,0,5,5
33693,escrita,0,0,5,5
25925,kon,0,0,5,5
6135,mettere,1,5,0,5
25929,debes,0,0,5,5
813,somiglianza,1,5,0,5
2428,latine,2,2,3,5
35697,nergis,0,0,5,5
4438,dolce,1,5,0,5
18575,geheime,0,0,5,5
26558,वाली,0,0,5,5
31751,uppge,0,0,5,5
6121,possibili,1,5,0,5
22291,καλύτερα,0,0,5,5
20552,hold,0,0,5,5
8435,quota,1,5,0,5
17253,revistas,0,0,5,5
17251,mcpherson,0,0,5,5
15998,dotter,0,0,5,5
29566,தொகுப்பாளர்கள்,0,0,5,5
9898,manchmal,0,0,5,5
25423,भाग,0,0,5,5
3999,dna,2,1,4,5
16414,referencia,0,0,5,5
44815,puntos,0,0,5,5
45719,nın,0,0,5,5
39781,representations,0,0,5,5
6041,usi,1,5,0,5
51095,shown,0,0,5,5
16113,blir,0,0,5,5
8491,editore,1,5,0,5
22195,juin,0,0,5,5
38270,ഇന്ത്യൻ,0,0,5,5
9906,şeyler,0,0,5,5
12953,nouveau,0,0,5,5
9588,aristote,0,0,5,5
31883,किया।,0,0,5,5
33613,pares,0,0,5,5
42063,versie,0,0,5,5
2739,disturbo,1,5,0,5
18605,δώσω,0,0,5,5
10318,studied,0,0,5,5
49690,معينة,0,0,5,5
23331,तीन,0,0,5,5
15515,ihrem,0,0,5,5
19388,maakt,0,0,5,5
39750,immer,0,0,5,5
3965,line,2,1,4,5
30337,beder,0,0,5,5
14368,hafta,0,0,5,5
20776,ευγενικό,0,0,5,5
25597,requests,0,0,5,5
52659,ifade,0,0,5,5
6057,l'atmosfera,1,5,0,5
2270,overfitting,2,2,3,5
2162,russo,2,3,2,5
33638,γεια,0,0,5,5
35744,σήμερα,0,0,5,5
15507,requires,0,0,5,5
1748,forniti,1,5,0,5
49152,söylemek,0,0,5,5
29538,എല്ലാം,0,0,5,5
44087,ej,0,0,5,5
7752,pop,2,1,4,5
41804,പല,0,0,5,5
22381,لأن,0,0,5,5
24443,personal,0,0,5,5
24445,initial,0,0,5,5
33784,wouldn,0,0,5,5
6211,grazie.,1,5,0,5
7743,ciffolilli,2,2,3,5
7789,ascoltando,1,5,0,5
50713,lucky,0,0,5,5
49630,http,0,0,5,5
50486,menar,0,0,5,5
16011,onderzoek,0,0,5,5
14341,بطيئًا,0,0,5,5
12209,presence,0,0,5,5
800,penso,2,4,1,5
39084,released,0,0,5,5
31648,fraser,0,0,5,5
16359,hombres,0,0,5,5
22362,francés,0,0,5,5
38335,measure,0,0,5,5
17835,least,0,0,5,5
33793,announced,0,0,5,5
474,citate,1,5,0,5
48567,खाना,0,0,5,5
51386,eerder,0,0,5,5
28674,yeni,0,0,5,5
14332,являются,0,0,5,5
260,solitamente,1,5,0,5
22416,succès,0,0,5,5
13758,agree,0,0,5,5
31586,hjälp,0,0,5,5
4606,milione,1,5,0,5
26621,kiwix,0,0,5,5
30419,wieder,0,0,5,5
23874,gars,0,0,5,5
23261,personer,0,0,5,5
1144,ciascuno,1,5,0,5
45204,المرة,0,0,5,5
12211,évidence,0,0,5,5
44432,lévistrauss,0,0,5,5
21106,address,0,0,5,5
16009,позволяет,0,0,5,5
3730,attualmente,1,5,0,5
48541,गैर,0,0,5,5
37755,ziet,0,0,5,5
22333,easily,0,0,5,5
11344,منه,0,0,5,5
22326,माध्यम,0,0,5,5
40672,services,0,0,5,5
3424,robert,2,2,3,5
25608,ändå,0,0,5,5
45767,sida,0,0,5,5
7732,wikivoyage,2,1,4,5
49172,china,0,0,5,5
42934,connection,0,0,5,5
16003,عليك,0,0,5,5
22318,health,0,0,5,5
15529,पूछा,0,0,5,5
36996,assez,0,0,5,5
30370,другими,0,0,5,5
811,mchenry,2,1,4,5
11349,points,0,0,5,5
24474,maybe,0,0,5,5
7110,clifford,2,1,4,5
31690,traits,0,0,5,5
18542,söyleyebilirsiniz,0,0,5,5
4607,negativi,1,5,0,5
802,ciascun,1,5,0,5
46724,britannicas,0,0,5,5
9250,yer,0,0,5,5
20331,கவலைப்பட,0,0,5,5
49641,അതിശയകരമായ,0,0,5,5
33756,apart,0,0,5,5
26594,मामले,0,0,5,5
3636,tassi,1,5,0,5
45053,errors,0,0,5,5
19991,paid,0,0,5,5
24467,informação,0,0,5,5
36990,focus,0,0,5,5
48072,normas,0,0,5,5
6175,passare,1,5,0,5
6174,quadriga,2,1,4,5
8376,interne,2,3,2,5
27350,سأكون,0,0,5,5
8249,ragionamento,1,5,0,5
11633,உங்களுடன்,0,0,5,5
36790,taille,0,0,5,5
11615,நாள்,0,0,5,5
433,entrambi,1,5,0,5
1094,background,2,2,3,5
46511,bloquear,0,0,5,5
22897,rates,0,0,5,5
9704,feitas,0,0,5,5
4573,aperto,1,5,0,5
39314,prins,0,0,5,5
362,direttamente,1,5,0,5
4849,paul,2,1,4,5
6702,piccole,1,5,0,5
4539,medici,1,5,0,5
46561,للمحررين,0,0,5,5
42729,delar,0,0,5,5
9356,necesidad,0,0,5,5
52546,mama,0,0,5,5
27273,деле,0,0,5,5
15656,refers,0,0,5,5
29126,surveillance,0,0,5,5
16164,component,0,0,5,5
34227,love,0,0,5,5
12454,patterns,0,0,5,5
51800,मेरा,0,0,5,5
49376,autores,0,0,5,5
717,critica,1,5,0,5
25374,guys,0,0,5,5
2208,confini,1,5,0,5
20846,πράγμα,0,0,5,5
4224,william,2,1,4,5
11622,inicialmente,0,0,5,5
10447,ഭാഷകളിൽ,0,0,5,5
42231,भर,0,0,5,5
49385,difficulté,0,0,5,5
42648,संपादकों,0,0,5,5
30904,bruges,0,0,5,5
39194,claro,0,0,5,5
7886,bloccato,1,5,0,5
1103,talvolta,1,5,0,5
51609,hora,0,0,5,5
6910,segue,1,5,0,5
27221,remains,0,0,5,5
12481,built,0,0,5,5
29098,propre,0,0,5,5
45992,bilgi,0,0,5,5
35411,ficar,0,0,5,5
29052,പോകാൻ,0,0,5,5
31004,उपयुक्त,0,0,5,5
35417,response,0,0,5,5
18393,ontzagwekkend,0,0,5,5
29333,अतिरिक्त,0,0,5,5
22836,ajudar,0,0,5,5
41761,लिखा,0,0,5,5
9723,leute,0,0,5,5
6661,budget,2,1,4,5
16190,இருந்தது,0,0,5,5
24143,marriage,0,0,5,5
3981,apprese,1,5,0,5
37525,ये,0,0,5,5
38520,tillförlitlighet,0,0,5,5
34447,المستخدمين,0,0,5,5
47759,നിങ്ങൾ‌,0,0,5,5
11570,बातचीत,0,0,5,5
353,deriva,1,5,0,5
49422,quem,0,0,5,5
48716,deus,0,0,5,5
18375,अलावा,0,0,5,5
19257,meet,0,0,5,5
11605,പോയി,0,0,5,5
50443,invés,0,0,5,5
43664,वाक्य,0,0,5,5
42222,نفسك,0,0,5,5
37532,juillet,0,0,5,5
46507,почти,0,0,5,5
6678,ios,2,2,3,5
22861,словами,0,0,5,5
17735,الآلي,0,0,5,5
23105,conversación,0,0,5,5
49276,questões,0,0,5,5
51916,birinin,0,0,5,5
8053,pubblica,1,5,0,5
15139,ಮಾಡುತ್ತಿದ್ದೀರಿ,0,0,5,5
23960,οποία,0,0,5,5
19085,manner,0,0,5,5
15724,tales,0,0,5,5
40604,após,0,0,5,5
15713,systèmes,0,0,5,5
20955,huilen,0,0,5,5
390,difficoltà,1,5,0,5
40626,الثاني,0,0,5,5
43701,vê,0,0,5,5
3825,futura,2,3,2,5
6876,apportate,1,5,0,5
29219,universal,0,0,5,5
1044,estinzione,1,5,0,5
29214,chateado,0,0,5,5
43698,جاء,0,0,5,5
34347,minute,0,0,5,5
2776,scritta,1,5,0,5
13919,पाया,0,0,5,5
12392,nächsten,0,0,5,5
17653,geography,0,0,5,5
6812,educato,1,5,0,5
38598,diesen,0,0,5,5
3439,spagnolo,1,5,0,5
46092,reliable,0,0,5,5
18304,όνειρο,0,0,5,5
6806,perplesso,1,5,0,5
12382,lieber,0,0,5,5
50790,commonly,0,0,5,5
20882,olması,0,0,5,5
40857,substance,0,0,5,5
34376,olmadığını,0,0,5,5
17679,handling,0,0,5,5
30711,écriture,0,0,5,5
44318,لن,0,0,5,5
34370,lead,0,0,5,5
1045,smartphone,2,3,2,5
18295,orden,0,0,5,5
7932,un'organizzazione,1,5,0,5
29243,inloggade,0,0,5,5
30741,многие,0,0,5,5
23050,sverige,0,0,5,5
3708,addestrare,1,5,0,5
700,listen,2,2,3,5
29276,versionen,0,0,5,5
30683,rädd,0,0,5,5
44601,அதன்,0,0,5,5
18292,känner,0,0,5,5
16118,random,0,0,5,5
12395,εγώ,0,0,5,5
24032,significant,0,0,5,5
37565,programme,0,0,5,5
35337,कार्यक्रम,0,0,5,5
18276,kaynak,0,0,5,5
23079,thought,0,0,5,5
2209,pornografia,2,2,3,5
9685,aigu,0,0,5,5
37547,информация,0,0,5,5
38589,ಕೇಳಿದಾಗ,0,0,5,5
11637,historical,0,0,5,5
42256,thanks,0,0,5,5
30839,contains,0,0,5,5
35259,മാറ്റങ്ങൾ,0,0,5,5
398,Jimmy,1,5,0,5
24050,வழி,0,0,5,5
29161,вопрос,0,0,5,5
7993,ragione,1,5,0,5
27268,lembrese,0,0,5,5
4165,dire.,1,5,0,5
7995,terrestri,1,5,0,5
43684,тупым,0,0,5,5
11692,طلب,0,0,5,5
29178,doit,0,0,5,5
29207,رقيق,0,0,5,5
30659,talvez,0,0,5,5
51149,पल,0,0,5,5
36815,vielen,0,0,5,5
15023,ذلك،,0,0,5,5
49350,engelse,0,0,5,5
12407,ήρθε,0,0,5,5
47292,nästan,0,0,5,5
3101,esplicitamente,1,5,0,5
6884,includere,1,5,0,5
22977,emellertid,0,0,5,5
25715,entradas,0,0,5,5
35261,सम्पादकीय,0,0,5,5
1821,supervisionato.,1,5,0,5
7971,fiume,1,5,0,5
47807,contigo,0,0,5,5
13909,tråkigt,0,0,5,5
37779,καλύτερο,0,0,5,5
6780,casa.,1,5,0,5
23989,затруднительном,0,0,5,5
12531,require,0,0,5,5
30591,époque,0,0,5,5
14587,nouvelles,0,0,5,5
17772,பல,0,0,5,5
7810,fare.,1,5,0,5
14280,telif,0,0,5,5
6473,riceve,1,5,0,5
2668,evitando,2,2,3,5
36499,मिलियन,0,0,5,5
45907,soin,0,0,5,5
14982,πρόσβασης,0,0,5,5
49225,vielleicht,0,0,5,5
46637,πού,0,0,5,5
25656,histoire,0,0,5,5
26700,moe,0,0,5,5
29432,controle,0,0,5,5
31306,तर्क,0,0,5,5
44875,mayoría,0,0,5,5
22645,λήμματα,0,0,5,5
8207,numerose,1,5,0,5
7017,dell'informatica,1,5,0,5
1628,almeno,1,5,0,5
33985,serviço,0,0,5,5
25289,named,0,0,5,5
3224,höfling,2,1,4,5
24255,रात,0,0,5,5
4181,mission,2,1,4,5
24226,wees,0,0,5,5
45154,cuál,0,0,5,5
20408,ಹೇಗಾದರೂ,0,0,5,5
29419,القيام,0,0,5,5
44881,siendo,0,0,5,5
18445,cover,0,0,5,5
17776,fem,0,0,5,5
44301,endroit,0,0,5,5
15742,vide,0,0,5,5
13824,répéter,0,0,5,5
43617,millón,0,0,5,5
31249,μέρα,0,0,5,5
4148,corpus,2,2,3,5
9782,ಅವನ,0,0,5,5
34484,डेटाबेस,0,0,5,5
25293,ano,0,0,5,5
39453,jämfört,0,0,5,5
10671,simplemente,0,0,5,5
45900,såsom,0,0,5,5
11745,develop,0,0,5,5
31312,bayesian,0,0,5,5
31398,τρόπο,0,0,5,5
48622,egna,0,0,5,5
21031,claimed,0,0,5,5
9804,went,0,0,5,5
14295,applied,0,0,5,5
43595,terrestrial,0,0,5,5
3975,proposta,2,4,1,5
34504,மந்தமான,0,0,5,5
39132,उद्देश्य,0,0,5,5
4923,bellezza.,1,5,0,5
30491,dacht,0,0,5,5
3094,lanciato,1,5,0,5
40929,خوادم,0,0,5,5
36942,travailler,0,0,5,5
770,sapere.,1,5,0,5
39126,hiçbir,0,0,5,5
25272,ligga,0,0,5,5
49550,сентября,0,0,5,5
35571,ξανά,0,0,5,5
4184,multimediali,1,5,0,5
19969,souhaitée,0,0,5,5
39488,founded,0,0,5,5
50709,responder,0,0,5,5
39492,divided,0,0,5,5
50624,نفس,0,0,5,5
8214,mangiarlo,1,5,0,5
7021,werkstatt,2,1,4,5
39503,occurred,0,0,5,5
23179,similarity,0,0,5,5
7799,speciale,2,3,2,5
25835,أذهب,0,0,5,5
31336,contrairement,0,0,5,5
28833,لها,0,0,5,5
4782,riguarda,1,5,0,5
9907,director,0,0,5,5
25836,अकादमिक,0,0,5,5
12259,mejora,0,0,5,5
31359,abrumado,0,0,5,5
40841,сейчас,0,0,5,5
42596,ihren,0,0,5,5
31366,chamada,0,0,5,5
8168,utilizzata,1,5,0,5
36592,പറയാം,0,0,5,5
22801,ಎರಡು,0,0,5,5
30542,aften,0,0,5,5
4882,condotto,1,5,0,5
745,utile,2,4,1,5
19292,description,0,0,5,5
43731,सकता।,0,0,5,5
28972,verbazingwekkend,0,0,5,5
8117,dì,1,5,0,5
51459,pasar,0,0,5,5
9330,belleza,0,0,5,5
31117,зрения,0,0,5,5
13851,depending,0,0,5,5
4885,lanciata,1,5,0,5
4887,afferma,1,5,0,5
27308,concerning,0,0,5,5
12574,call,0,0,5,5
47744,apuros,0,0,5,5
51555,innan,0,0,5,5
20429,ಸ್ನೇಹಿತರೊಂದಿಗೆ,0,0,5,5
2637,rappresenta,1,5,0,5
42622,allemand,0,0,5,5
37511,पार,0,0,5,5
18418,حماية,0,0,5,5
19288,أحيانًا,0,0,5,5
18252,معك,0,0,5,5
52543,works,0,0,5,5
2643,fsf,2,1,4,5
18409,tillräckligt,0,0,5,5
39374,misma,0,0,5,5
47329,mevcuttur,0,0,5,5
37521,voluntarios,0,0,5,5
23951,recognition,0,0,5,5
31059,verir,0,0,5,5
2640,andrea,2,2,3,5
442,falso,2,4,1,5
52588,gehört,0,0,5,5
25324,learns,0,0,5,5
26766,critics,0,0,5,5
52423,activities,0,0,5,5
22780,wiederholen,0,0,5,5
29367,вами,0,0,5,5
6601,nonostante,1,5,0,5
4798,popolazione,1,5,0,5
20513,claim,0,0,5,5
34104,даже,0,0,5,5
2799,electronica,2,1,4,5
41772,julho,0,0,5,5
31178,ayrıca,0,0,5,5
40644,ഉപയോഗിക്കുന്ന,0,0,5,5
4791,comunità.,1,5,0,5
4591,consulta,2,2,3,5
52541,leading,0,0,5,5
25804,ميلي,0,0,5,5
40900,comuns,0,0,5,5
6525,carlos,2,1,4,5
6523,articoli.,1,5,0,5
19960,nye,0,0,5,5
50586,होकर,0,0,5,5
15041,изображений,0,0,5,5
20982,länder,0,0,5,5
49242,هم,0,0,5,5
1891,rapporto,1,5,0,5
4904,superando,2,3,2,5
42619,resources,0,0,5,5
35487,continuar,0,0,5,5
35479,classified,0,0,5,5
6976,awards,2,1,4,5
31141,oroa,0,0,5,5
31153,கட்டுரைகளின்,0,0,5,5
50452,താളുകളിൽ,0,0,5,5
36909,ट्रेडमार्क,0,0,5,5
14992,particulièrement,0,0,5,5
35469,lake,0,0,5,5
45953,βικιπαίδειας,0,0,5,5
22742,algorithmic,0,0,5,5
37502,कहाँ,0,0,5,5
34462,சொல்வது,0,0,5,5
6551,l'altra,1,5,0,5
9324,yemek,0,0,5,5
8137,matematico,1,5,0,5
2400,criticata,1,5,0,5
40846,വ്യക്തിയെ,0,0,5,5
4896,solare,1,5,0,5
22733,polynomial,0,0,5,5
31165,சொற்றொடர்,0,0,5,5
17497,jamais,0,0,5,5
14196,كانوا,0,0,5,5
22185,tools,0,0,5,5
15984,свои,0,0,5,5
30088,существует,0,0,5,5
13579,ie,0,0,5,5
13267,ജീവിതത്തിൽ,0,0,5,5
18804,native,0,0,5,5
48154,amable,0,0,5,5
41845,olurdu,0,0,5,5
4324,presenza,1,5,0,5
11051,maio,0,0,5,5
2391,l'accuratezza,1,5,0,5
40074,soir,0,0,5,5
40077,ander,0,0,5,5
48153,exact,0,0,5,5
52300,språket,0,0,5,5
43176,mantenimiento,0,0,5,5
37720,ihåg,0,0,5,5
20630,şimdiden,0,0,5,5
21334,konflikter,0,0,5,5
15254,डर,0,0,5,5
47051,türkiye,0,0,5,5
3407,vita.,1,5,0,5
8836,rapidamente,1,5,0,5
52305,பயன்படுத்தும்,0,0,5,5
20621,herhalen,0,0,5,5
2895,Uniti,1,5,0,5
43375,hiç,0,0,5,5
49935,virginia,0,0,5,5
44532,opinions,0,0,5,5
16610,onion,0,0,5,5
1462,prendere,1,5,0,5
12058,blive,0,0,5,5
41068,selection,0,0,5,5
41428,trött,0,0,5,5
18115,quien,0,0,5,5
13580,milieu,0,0,5,5
4328,quinto,2,3,2,5
44364,ஆண்டு,0,0,5,5
10582,træt,0,0,5,5
14062,நினைவில்,0,0,5,5
44349,वर्णित,0,0,5,5
2941,numerosi,1,5,0,5
2548,Mi,1,5,0,5
23699,comercial,0,0,5,5
1207,diventata,1,5,0,5
48310,содержит,0,0,5,5
28016,μένα,0,0,5,5
929,foto,2,3,2,5
32611,dele,0,0,5,5
41934,conversa,0,0,5,5
11032,सूची,0,0,5,5
5470,succede,1,5,0,5
12032,directly,0,0,5,5
49991,gange,0,0,5,5
5465,coniato,1,5,0,5
2390,riguardo,1,5,0,5
42488,इसने,0,0,5,5
13295,philosophy,0,0,5,5
13559,kennis,0,0,5,5
27955,rüya,0,0,5,5
3500,cattura-,1,5,0,5
51350,présentée,0,0,5,5
27951,livro,0,0,5,5
38047,dorado,0,0,5,5
45001,ರಾತ್ರಿ,0,0,5,5
38815,இருப்பேன்,0,0,5,5
8877,contengono,1,5,0,5
49983,weiter,0,0,5,5
2902,teorici,1,5,0,5
70,libri,1,5,0,5
14806,ಕಾಳಜಿ,0,0,5,5
52297,ideia,0,0,5,5
42495,colère,0,0,5,5
15910,clear,0,0,5,5
46298,príncipe,0,0,5,5
50143,precisão,0,0,5,5
10067,female,0,0,5,5
45478,fatigué,0,0,5,5
15359,βάλτο,0,0,5,5
33178,положении,0,0,5,5
5155,pew,2,1,4,5
918,wikiproject,2,1,4,5
20695,ему,0,0,5,5
15356,bekend,0,0,5,5
4069,sì,1,5,0,5
37915,domaine,0,0,5,5
46937,encuentran,0,0,5,5
33240,salt,0,0,5,5
3758,umano.,1,5,0,5
4311,verifica,1,5,0,5
35994,കുറച്ച്,0,0,5,5
52032,ಬಳಸಬಹುದು,0,0,5,5
20168,கூறலாம்,0,0,5,5
117,calo,1,5,0,5
10248,правок,0,0,5,5
45020,metawiki,0,0,5,5
11114,unknown,0,0,5,5
28140,krijgen,0,0,5,5
20163,изменения,0,0,5,5
18131,الصفحات,0,0,5,5
23721,ಅತ್ಯಂತ,0,0,5,5
32388,lecteurs,0,0,5,5
35995,повезло,0,0,5,5
40362,rijtuig,0,0,5,5
43391,χρησιμοποιώ,0,0,5,5
27551,possível,0,0,5,5
19630,utilisant,0,0,5,5
23449,practice,0,0,5,5
40011,वेबसाईट,0,0,5,5
29720,الإصلاح,0,0,5,5
50358,daarom,0,0,5,5
11081,principalement,0,0,5,5
5671,query,2,2,3,5
7618,lago,1,5,0,5
17035,ಫ್ಲಮ್ಮಾಕ್ಸ್,0,0,5,5
40375,ആയിരുന്നു,0,0,5,5
19652,inc,0,0,5,5
27032,القادمة,0,0,5,5
11875,அன்றாட,0,0,5,5
11123,elkaar,0,0,5,5
32343,değişiklikler,0,0,5,5
41261,entschuldigung,0,0,5,5
33320,beetje,0,0,5,5
7611,mailing,2,3,2,5
29711,കാര്യങ്ങളും,0,0,5,5
49083,prince,0,0,5,5
20179,sidevisninger,0,0,5,5
29714,mı,0,0,5,5
2473,genetici,1,5,0,5
43097,ಮೆಲ್ಲಿ,0,0,5,5
21859,helfen,0,0,5,5
43132,कमी,0,0,5,5
37329,rulebased,0,0,5,5
41065,root,0,0,5,5
13236,நண்பர்கள்,0,0,5,5
38797,schon,0,0,5,5
8795,myspace,2,1,4,5
16598,खुद,0,0,5,5
40039,pouvezvous,0,0,5,5
16599,എനിക്കറിയാം,0,0,5,5
16600,потрясающий,0,0,5,5
49069,anthropologies,0,0,5,5
3922,indica,2,2,3,5
40713,सूचना,0,0,5,5
15934,வாழ்க்கையில்,0,0,5,5
52714,usuario,0,0,5,5
28081,этому,0,0,5,5
7335,fondamentale,1,5,0,5
7589,avevano,1,5,0,5
49928,tú,0,0,5,5
18970,मत,0,0,5,5
51696,birini,0,0,5,5
32477,vá,0,0,5,5
16958,chance,0,0,5,5
16959,¿puedes,0,0,5,5
48142,samen,0,0,5,5
2027,brown,2,2,3,5
48136,presse,0,0,5,5
20159,estrutura,0,0,5,5
28114,solve,0,0,5,5
47581,emot,0,0,5,5
40021,தவறு,0,0,5,5
51480,tired,0,0,5,5
31902,تقديم,0,0,5,5
10233,серверов,0,0,5,5
14045,yapmak,0,0,5,5
3417,soluzione,1,5,0,5
15074,veta,0,0,5,5
13224,चल,0,0,5,5
32427,anomaly,0,0,5,5
5603,caratteri,1,5,0,5
43823,الأخيرة,0,0,5,5
28105,رسالة,0,0,5,5
36009,allí,0,0,5,5
37292,इतना,0,0,5,5
11924,हों,0,0,5,5
9161,pesquisas,0,0,5,5
1434,eventi,1,5,0,5
41714,restaurant,0,0,5,5
18035,वाला,0,0,5,5
46359,التخريب,0,0,5,5
29918,vardı,0,0,5,5
41881,layers,0,0,5,5
9081,franco,2,1,4,5
11985,understood,0,0,5,5
25047,bus,0,0,5,5
44240,दलदल,0,0,5,5
13517,spørgsmål,0,0,5,5
43866,months,0,0,5,5
26214,الأساسية,0,0,5,5
3310,comporta,1,5,0,5
2555,paideia,2,2,3,5
37969,meilleure,0,0,5,5
7459,america,2,3,2,5
50083,ثم,0,0,5,5
37234,office,0,0,5,5
51585,små,0,0,5,5
36225,perguntar,0,0,5,5
48240,décembre,0,0,5,5
10957,anderes,0,0,5,5
44991,arquivos,0,0,5,5
15309,गयी।,0,0,5,5
23569,adopted,0,0,5,5
23571,अनुसंधान,0,0,5,5
44215,bedste,0,0,5,5
36310,रखें,0,0,5,5
16800,composed,0,0,5,5
38873,वर्तमान,0,0,5,5
4270,mass,2,1,4,5
18944,alligevel,0,0,5,5
13426,rare,0,0,5,5
10171,sélection,0,0,5,5
10602,такими,0,0,5,5
33005,സ്വന്തം,0,0,5,5
23585,सहमत,0,0,5,5
7446,chiamare,1,5,0,5
34917,കാണുന്നു,0,0,5,5
36218,ಓ,0,0,5,5
52475,कारण,0,0,5,5
41242,francesa,0,0,5,5
23637,λέει,0,0,5,5
47023,كلمات,0,0,5,5
32920,istiyorum,0,0,5,5
48200,celle,0,0,5,5
13501,ಇದರರ್ಥ,0,0,5,5
14532,нужно,0,0,5,5
13482,distribución,0,0,5,5
5214,senti,1,5,0,5
8,minuto,2,3,2,5
18059,vanaf,0,0,5,5
43284,espace,0,0,5,5
19,scoprire,1,5,0,5
26181,wissen,0,0,5,5
3777,usati,1,5,0,5
19538,لست,0,0,5,5
1697,valore,1,5,0,5
10902,بدأت,0,0,5,5
48994,gesprek,0,0,5,5
15856,naquele,0,0,5,5
5221,-,1,5,0,5
36271,الإنترنت,0,0,5,5
36266,exists,0,0,5,5
34877,மேலே,0,0,5,5
5246,stasera,1,5,0,5
23596,சொற்றொடரை,0,0,5,5
2099,temperature,2,1,4,5
16771,parts,0,0,5,5
43272,mean,0,0,5,5
37965,bysa,0,0,5,5
46338,cuales,0,0,5,5
50560,days,0,0,5,5
15089,ചെയ്യുക,0,0,5,5
14097,мой,0,0,5,5
36293,før,0,0,5,5
26198,δω,0,0,5,5
21489,attrition,0,0,5,5
5253,variazioni,1,5,0,5
20059,вандализма,0,0,5,5
40263,गुणवत्ता,0,0,5,5
49000,सर्च,0,0,5,5
20043,categories,0,0,5,5
16802,huis,0,0,5,5
36179,schönheit,0,0,5,5
2934,persone.,1,5,0,5
8937,uomini,1,5,0,5
19575,« wikipédia »,0,0,5,5
41244,спросить,0,0,5,5
25470,ಸರಿ,0,0,5,5
2905,contribuito,1,5,0,5
7542,risoluzione,1,5,0,5
4092,partecipazione,1,5,0,5
10989,verder,0,0,5,5
36323,பொருள்,0,0,5,5
32736,bästa,0,0,5,5
20690,فيها,0,0,5,5
7538,anomalie,1,5,0,5
5391,svolgere,1,5,0,5
8943,colto,1,5,0,5
983,mitchell,2,4,1,5
47538,wikipedianer,0,0,5,5
15085,seul,0,0,5,5
40166,научных,0,0,5,5
7536,alberi,1,5,0,5
40146,truth,0,0,5,5
16850,repeat,0,0,5,5
7436,superato,1,5,0,5
27922,lange,0,0,5,5
37688,prêmio,0,0,5,5
38043,μας,0,0,5,5
43846,novo,0,0,5,5
33130,основном,0,0,5,5
50005,إنني,0,0,5,5
30000,opinion,0,0,5,5
16664,moeten,0,0,5,5
15337,الموقع,0,0,5,5
51351,ತಾಯಿಗೆ,0,0,5,5
23667,complexity,0,0,5,5
29996,geluk,0,0,5,5
51866,beleza,0,0,5,5
29989,الجيد,0,0,5,5
29988,autorais,0,0,5,5
41089,forskarna,0,0,5,5
24943,mieux,0,0,5,5
2374,nica,2,2,3,5
50015,produced,0,0,5,5
13382,siguientes,0,0,5,5
40170,mois,0,0,5,5
9517,remaining,0,0,5,5
23650,grupp,0,0,5,5
44499,രീതിയിൽ,0,0,5,5
7528,usata,1,5,0,5
4655,san,2,1,4,5
2074,aumenta,2,4,1,5
18872,ഉപയോഗിച്ച്,0,0,5,5
43318,hacerlo,0,0,5,5
21568,لويكيبيديا,0,0,5,5
2075,naturale.,1,5,0,5
51244,essas,0,0,5,5
43853,receives,0,0,5,5
19883,pueda,0,0,5,5
5341,centinaia,1,5,0,5
32797,работой,0,0,5,5
42424,diskussionssidorna,0,0,5,5
40183,nível,0,0,5,5
41902,extremes,0,0,5,5
16703,rédacteur,0,0,5,5
41901,connaissance,0,0,5,5
50044,забудьте,0,0,5,5
7429,carne,2,3,2,5
2379,americani,1,5,0,5
15319,utilizar,0,0,5,5
48175,fake,0,0,5,5
41104,καταπληκτική,0,0,5,5
10103,تلك,0,0,5,5
50031,बताया,0,0,5,5
10973,नीचे,0,0,5,5
52125,പറയുക,0,0,5,5
27067,сайт,0,0,5,5
16823,ಪದದ,0,0,5,5
11935,atolado,0,0,5,5
43884,തങ്ങളുടെ,0,0,5,5
8958,caching,2,1,4,5
14855,might,0,0,5,5
42422,enough,0,0,5,5
50038,main,0,0,5,5
40175,weg,0,0,5,5
18013,дорогая,0,0,5,5
1353,minuti.,1,5,0,5
8731,dopo.,1,5,0,5
20867,χωρίς,0,0,5,5
10550,unos,0,0,5,5
49814,complètement,0,0,5,5
32142,ακούγεται,0,0,5,5
25207,iş,0,0,5,5
5825,neurale,1,5,0,5
4412,volte.,1,5,0,5
166,largo,2,3,2,5
35891,завален,0,0,5,5
44684,παραδείγματα,0,0,5,5
35814,तहत,0,0,5,5
20584,раздел,0,0,5,5
42015,थीं,0,0,5,5
38200,travaille,0,0,5,5
12143,प्रस्तुत,0,0,5,5
7243,acque,1,5,0,5
14916,работе,0,0,5,5
17121,send,0,0,5,5
7240,episodi,1,5,0,5
7234,americano,1,5,0,5
4721,livelli,1,5,0,5
20224,environments,0,0,5,5
17174,समर्थन,0,0,5,5
36399,eres,0,0,5,5
22039,sinto,0,0,5,5
31985,പോകുന്നു,0,0,5,5
12140,oubliez,0,0,5,5
32129,lernen,0,0,5,5
5034,fattori,1,5,0,5
1734,heilman,2,2,3,5
18695,உதாரணமாக,0,0,5,5
47085,पूछ,0,0,5,5
36420,möglichkeit,0,0,5,5
39882,skønhed,0,0,5,5
1739,pubblicato,1,5,0,5
2868,paesi,1,5,0,5
8546,l'altro,1,5,0,5
2586,vieni,1,5,0,5
30266,geniş,0,0,5,5
15231,jobb,0,0,5,5
49112,ನಿಮ್ಮೊಂದಿಗೆ,0,0,5,5
3963,attenzione,1,5,0,5
14424,goud,0,0,5,5
34641,visual,0,0,5,5
38750,sah,0,0,5,5
43478,hebben,0,0,5,5
34644,dizem,0,0,5,5
8658,redattore,1,5,0,5
46796,lois,0,0,5,5
2156,frequenti,1,5,0,5
45235,technique,0,0,5,5
11826,ämnen,0,0,5,5
45027,золотого,0,0,5,5
30177,passou,0,0,5,5
8537,giorni.,1,5,0,5
26452,أين,0,0,5,5
31968,исследований,0,0,5,5
5962,riportato,1,5,0,5
42993,uniquement,0,0,5,5
842,singole,1,5,0,5
22009,connue,0,0,5,5
21164,അവരോട്,0,0,5,5
22013,popularidad,0,0,5,5
46847,الذهبي,0,0,5,5
19899,resulting,0,0,5,5
27462,நேரம்,0,0,5,5
28278,desenvolvimento,0,0,5,5
18705,core,0,0,5,5
11186,concerns,0,0,5,5
9217,كثيرًا,0,0,5,5
52503,बस,0,0,5,5
11202,zonder,0,0,5,5
29659,μία,0,0,5,5
18665,geology,0,0,5,5
47080,ξέρεις,0,0,5,5
19416,должна,0,0,5,5
21179,അതിനെക്കുറിച്ച്,0,0,5,5
21193,kwam,0,0,5,5
52447,största,0,0,5,5
48108,billion,0,0,5,5
47420,وأنا,0,0,5,5
42351,biosphere,0,0,5,5
5874,sabato,1,5,0,5
1986,imparato,1,5,0,5
18652,എണ്ണം,0,0,5,5
2969,prova,2,4,1,5
13050,должен,0,0,5,5
21195,ചിലപ്പോൾ,0,0,5,5
47936,तरीके,0,0,5,5
48445,snälla,0,0,5,5
14840,premiers,0,0,5,5
28344,bouton,0,0,5,5
45663,modos,0,0,5,5
511,positivo,2,2,3,5
24621,eines,0,0,5,5
14923,explain,0,0,5,5
27001,sueco,0,0,5,5
24629,cómo,0,0,5,5
46827,свой,0,0,5,5
3896,richiesta,1,5,0,5
28362,повседневной,0,0,5,5
9940,उन्होंने,0,0,5,5
22090,tard,0,0,5,5
8580,aggiunto,1,5,0,5
22100,träffar,0,0,5,5
40428,peur,0,0,5,5
30215,områden,0,0,5,5
52108,reached,0,0,5,5
3046,gradi,1,5,0,5
5936,responsabile,1,5,0,5
28307,мелли,0,0,5,5
51217,कोमन्स,0,0,5,5
41826,ಸಾಮಾನ್ಯ,0,0,5,5
20231,आश्चर्यजनक,0,0,5,5
48456,بينما,0,0,5,5
1991,soprattutto,1,5,0,5
51085,хочет,0,0,5,5
181,education,2,1,4,5
40416,dólares,0,0,5,5
37644,ಕೆಲಸವನ್ನು,0,0,5,5
44130,മരിയൻ,0,0,5,5
52207,someone,0,0,5,5
46839,hors,0,0,5,5
5843,sforzi,1,5,0,5
32096,проекта,0,0,5,5
39014,जबकि,0,0,5,5
24599,entendi,0,0,5,5
44457,എന്നീ,0,0,5,5
11247,уэйлс,0,0,5,5
20011,എന്നത്,0,0,5,5
27497,matrix,0,0,5,5
49796,funciones,0,0,5,5
39866,όλη,0,0,5,5
32086,encyclopedieën,0,0,5,5
11828,sugerem,0,0,5,5
24643,الآخر,0,0,5,5
43026,canım,0,0,5,5
46833,schön,0,0,5,5
50351,engine,0,0,5,5
3249,motori,1,5,0,5
17168,explique,0,0,5,5
17102,events,0,0,5,5
20590,ainda,0,0,5,5
38236,menudo,0,0,5,5
33599,does,0,0,5,5
7256,creato,1,5,0,5
12973,mismos,0,0,5,5
8693,edwin,2,2,3,5
21895,இதன்,0,0,5,5
8514,terra.,1,5,0,5
2341,correlati,1,5,0,5
38166,തീർച്ചയായും,0,0,5,5
24573,cells,0,0,5,5
8690,mondiale.,1,5,0,5
41237,datter,0,0,5,5
21934,पुस्तक,0,0,5,5
33377,കഴിയുമോ,0,0,5,5
35964,useful,0,0,5,5
23763,يستخدم,0,0,5,5
18731,américains,0,0,5,5
24575,naast,0,0,5,5
34722,direitos,0,0,5,5
2599,ward,2,3,2,5
15946,प्रस्ताव,0,0,5,5
38171,sério,0,0,5,5
3956,interna,2,4,1,5
25189,effet,0,0,5,5
16533,empresa,0,0,5,5
13623,πάνω,0,0,5,5
46216,получите,0,0,5,5
51081,prochaine,0,0,5,5
32301,നല്ലതാണ്,0,0,5,5
875,protect,2,1,4,5
17062,versão,0,0,5,5
41041,اليومية,0,0,5,5
21907,بالنسبة,0,0,5,5
46254,القواعد,0,0,5,5
6008,€,2,1,4,5
45575,الأولى,0,0,5,5
25174,வெவ்வேறு,0,0,5,5
18141,ധാരാളം,0,0,5,5
3958,sarò,1,5,0,5
34632,analysera,0,0,5,5
8709,stagni,1,5,0,5
21249,المساهمين,0,0,5,5
31919,correctif,0,0,5,5
6003,adesso,1,5,0,5
8704,intende,1,5,0,5
6002,offline,2,2,3,5
36376,ಹೇಳಿದರೆ,0,0,5,5
49727,υπέροχη,0,0,5,5
37107,معظم,0,0,5,5
41572,ಪದಗುಚ್,0,0,5,5
12971,شكرًا,0,0,5,5
32279,asked,0,0,5,5
27021,сон,0,0,5,5
16542,إنها,0,0,5,5
15238,meinem,0,0,5,5
25963,anonymous,0,0,5,5
52240,aldım,0,0,5,5
16558,recursos,0,0,5,5
41996,حال,0,0,5,5
49106,widely,0,0,5,5
14426,forskellige,0,0,5,5
40993,руки,0,0,5,5
25564,heldig,0,0,5,5
2143,introdotto,1,5,0,5
21956,всю,0,0,5,5
26433,ganze,0,0,5,5
3164,rappresentati,1,5,0,5
50402,വിവിധ,0,0,5,5
17088,تبدو,0,0,5,5
13647,licencias,0,0,5,5
13648,fangede,0,0,5,5
4258,sostengono,1,5,0,5
20208,സ്വപ്നം,0,0,5,5
41549,участниками,0,0,5,5
35017,πως,0,0,5,5
32317,تمت,0,0,5,5
48402,வார்த்தையின்,0,0,5,5
31946,издание,0,0,5,5
5692,adam,2,1,4,5
836,direttore,1,5,0,5
21152,explicitly,0,0,5,5
14912,entirely,0,0,5,5
17191,bewerkers,0,0,5,5
33406,முற்றிலும்,0,0,5,5
26011,forvirret,0,0,5,5
43075,possuem,0,0,5,5
18743,ongoing,0,0,5,5
26432,άλλος,0,0,5,5
51123,الشيء,0,0,5,5
47076,എല്ലായ്പ്പോഴും,0,0,5,5
19213,liten,0,0,5,5
21966,html,0,0,5,5
27117,genre,0,0,5,5
3050,necessariamente,2,4,1,5
39979,ತಪ್ಪು,0,0,5,5
32313,problemet,0,0,5,5
17075,whether,0,0,5,5
23358,increased,0,0,5,5
5081,ipotesi,1,5,0,5
4635,francisco,2,1,4,5
9164,anglophone,0,0,5,5
30163,narcissa,0,0,5,5
27447,dado,0,0,5,5
31935,arbetet,0,0,5,5
7261,hard,2,3,2,5
5083,dominante,2,2,3,5
5768,perl,2,1,4,5
23802,इतिहास,0,0,4,4
14159,domains,0,0,4,4
46363,digo,0,0,4,4
35268,réponse,0,0,4,4
23627,jonathan,0,0,4,4
29868,ಮಾಡುವ,0,0,4,4
27135,दैनिक,0,0,4,4
47186,effects,0,0,4,4
48882,الحصول,0,0,4,4
9385,birlikte,0,0,4,4
38727,αστείο,0,0,4,4
11677,wochenende,0,0,4,4
7678,generali,1,4,0,4
29589,المرتبة,0,0,4,4
10655,hermosa,0,0,4,4
20568,ಹೆದರುತ್ತೇನೆ,0,0,4,4
46449,diverses,0,0,4,4
1685,secoli,1,4,0,4
20497,ಬಳಸುವ,0,0,4,4
46524,раздела,0,0,4,4
25414,பயப்படுகிறேன்,0,0,4,4
19137,sıra,0,0,4,4
35066,happy,0,0,4,4
35246,الأشياء,0,0,4,4
34908,enciclopedias,0,0,4,4
38617,plannen,0,0,4,4
29824,correspondant,0,0,4,4
29849,actually,0,0,4,4
52057,evet,0,0,4,4
1361,personaggio,1,4,0,4
7506,tradizione,1,4,0,4
3080,pubblicate,1,4,0,4
15711,næsten,0,0,4,4
18060,naziksiniz,0,0,4,4
29564,lovely,0,0,4,4
4620,lasciato,1,4,0,4
44981,правильно,0,0,4,4
2284,soldi,1,4,0,4
38707,vacker,0,0,4,4
7519,preoccupata,1,4,0,4
15719,yet,0,0,4,4
638,addestrati,1,4,0,4
10648,initiative,0,0,4,4
27142,outputs,0,0,4,4
51894,interactive,0,0,4,4
7515,superficie.,1,4,0,4
23990,തുടങ്ങിയ,0,0,4,4
4658,breiman,2,2,2,4
29593,az,0,0,4,4
14167,freund,0,0,4,4
7716,varma,2,2,2,4
48984,τελευταία,0,0,4,4
11820,benimle,0,0,4,4
44320,toi,0,0,4,4
7497,carico,1,4,0,4
11816,simply,0,0,4,4
47937,tage,0,0,4,4
11795,गलती,0,0,4,4
18180,einmal,0,0,4,4
7887,l'addestramento,1,4,0,4
23996,ലഭിച്ചു,0,0,4,4
44337,barn,0,0,4,4
23822,الأسبوع,0,0,4,4
18070,expérience,0,0,4,4
25415,mistake,0,0,4,4
40812,ven,0,0,4,4
27230,அன்பே,0,0,4,4
7690,dirmi,1,4,0,4
25416,dernier,0,0,4,4
27229,தருகிறேன்,0,0,4,4
7889,svedese,1,4,0,4
2662,impiegano,1,4,0,4
14102,विश्वसनीयता,0,0,4,4
38629,propio,0,0,4,4
34894,சென்று,0,0,4,4
44357,primera,0,0,4,4
29850,peine,0,0,4,4
29556,één,0,0,4,4
46400,mostrou,0,0,4,4
41738,signification,0,0,4,4
596,avesse,1,4,0,4
48822,вклад,0,0,4,4
47921,تمانع,0,0,4,4
599,errore,1,4,0,4
15744,position,0,0,4,4
29745,sprogversioner,0,0,4,4
38657,encontrados,0,0,4,4
7806,"che,",1,4,0,4
23889,mantener,0,0,4,4
7641,ambienti,1,4,0,4
51909,lawrence,0,0,4,4
29744,répondre,0,0,4,4
11859,vermasselt,0,0,4,4
29433,graag,0,0,4,4
51368,allowed,0,0,4,4
27106,half,0,0,4,4
18126,trabalhe,0,0,4,4
35013,vendeu,0,0,4,4
18149,plates,0,0,4,4
18236,просмотра,0,0,4,4
25379,begyndte,0,0,4,4
15740,perdido,0,0,4,4
27176,books,0,0,4,4
10674,மகள்,0,0,4,4
29769,equinix,0,0,4,4
52453,mann,0,0,4,4
7575,costantemente,1,4,0,4
27101,frei,0,0,4,4
25455,исследование,0,0,4,4
41744,thing,0,0,4,4
40825,bilgiler,0,0,4,4
19918,சரி,0,0,4,4
29403,ninguna,0,0,4,4
7758,dimenticare,1,4,0,4
23927,соответствии,0,0,4,4
11902,multiples,0,0,4,4
27119,வருத்தப்பட,0,0,4,4
1625,arthur,2,2,2,4
20624,women,0,0,4,4
51890,usam,0,0,4,4
669,scoperte,1,4,0,4
7635,input.,1,4,0,4
3067,ruscello,1,4,0,4
18132,processos,0,0,4,4
51907,erreur,0,0,4,4
29472,moral,0,0,4,4
18223,ஜனவரி,0,0,4,4
48933,fantastisch,0,0,4,4
34997,kelimenin,0,0,4,4
20609,لأنني,0,0,4,4
47958,zelf,0,0,4,4
46397,அவரது,0,0,4,4
43901,любой,0,0,4,4
1673,samuel,2,2,2,4
34995,considéré,0,0,4,4
47959,डाल,0,0,4,4
7616,affermava,1,4,0,4
29459,¿puedo,0,0,4,4
36650,letterlijk,0,0,4,4
3791,algoritmico,2,3,1,4
29476,ways,0,0,4,4
35134,tonto,0,0,4,4
50700,översvämmad,0,0,4,4
35002,कैसा,0,0,4,4
36651,méthodes,0,0,4,4
29438,dépend,0,0,4,4
29676,fluent,0,0,4,4
1668,zero,2,1,3,4
2683,scott,2,1,3,4
38662,αύριο,0,0,4,4
38663,independent,0,0,4,4
3786,terabyte,2,2,2,4
36598,keinen,0,0,4,4
20615,δωρεάν,0,0,4,4
3091,orlowski,2,1,3,4
29449,ακούσει,0,0,4,4
27108,hear,0,0,4,4
40785,venlig,0,0,4,4
14142,código,0,0,4,4
48922,neem,0,0,4,4
9408,άμαξα,0,0,4,4
40789,മുതൽ,0,0,4,4
14641,योगदान,0,0,4,4
2260,documentazione,1,4,0,4
35032,bedre,0,0,4,4
10620,crítica,0,0,4,4
7866,descritto,1,4,0,4
29793,சூழ்நிலையில்,0,0,4,4
35229,sentences,0,0,4,4
51570,боюсь,0,0,4,4
23670,appel,0,0,4,4
20505,correction,0,0,4,4
35228,eau,0,0,4,4
50421,أظهرت,0,0,4,4
25380,വാക്കിന്റെ,0,0,4,4
20506,одним,0,0,4,4
29340,محتوى,0,0,4,4
29342,adelante,0,0,4,4
50419,ಮಾರಿದ್ದೀರಿ,0,0,4,4
7550,nazionali,1,4,0,4
29639,citing,0,0,4,4
47184,defining,0,0,4,4
4629,baike,2,1,3,4
48858,कॉपीराइट,0,0,4,4
23663,welke,0,0,4,4
4202,valutare,1,4,0,4
18168,værd,0,0,4,4
11705,विश्व,0,0,4,4
15791,läser,0,0,4,4
15769,लगा,0,0,4,4
4576,consente,1,4,0,4
29802,തുടങ്ങി,0,0,4,4
18207,fingers,0,0,4,4
47950,peer,0,0,4,4
23795,conseil,0,0,4,4
35238,الجد,0,0,4,4
29800,tipos,0,0,4,4
15841,அதற்கு,0,0,4,4
35040,rocks,0,0,4,4
14114,neerlandés,0,0,4,4
46504,ongeveer,0,0,4,4
1681,julie,2,2,2,4
4581,coprirmi,1,4,0,4
4590,sai.,1,4,0,4
680,juan,2,1,3,4
25385,éxito,0,0,4,4
20547,सर्वरों,0,0,4,4
23781,broke,0,0,4,4
37719,العربة,0,0,4,4
18247,σημασία,0,0,4,4
29513,хочешь,0,0,4,4
15829,mensaje,0,0,4,4
2691,piace,1,4,0,4
27205,réalisée,0,0,4,4
23875,espere,0,0,4,4
7566,divertente,1,4,0,4
20633,goda,0,0,4,4
51575,ದಿನ,0,0,4,4
47917,yanlış,0,0,4,4
51903,لهم,0,0,4,4
35183,stable,0,0,4,4
35118,क्रिएटिव,0,0,4,4
7838,l'ipotesi,1,4,0,4
36607,nonprofit,0,0,4,4
18103,planet,0,0,4,4
7556,l'ex,1,4,0,4
4652,basano,1,4,0,4
43952,αριθμός,0,0,4,4
35209,vred,0,0,4,4
29641,überfüllt,0,0,4,4
47183,quoted,0,0,4,4
29368,आधारित,0,0,4,4
10639,fish,0,0,4,4
14646,നല്ലത്,0,0,4,4
23679,komt,0,0,4,4
14623,pedidos,0,0,4,4
25468,дам,0,0,4,4
3795,cellulari,1,4,0,4
42404,правила,0,0,4,4
7560,ordine,1,4,0,4
46495,البرنامج,0,0,4,4
48813,पारंपरिक,0,0,4,4
47938,risk,0,0,4,4
26188,परेशानी,0,0,4,4
24002,लिए।,0,0,4,4
8708,dovuto,1,4,0,4
28202,sinds,0,0,4,4
51433,reunión,0,0,4,4
24745,sense,0,0,4,4
35953,ciertas,0,0,4,4
28194,ब्रिटेन,0,0,4,4
35955,തോന്നുന്നു,0,0,4,4
8706,forza,1,4,0,4
51022,этой,0,0,4,4
1479,arte,2,2,2,4
25171,büyük,0,0,4,4
28181,имя,0,0,4,4
27541,статьях,0,0,4,4
38156,deu,0,0,4,4
24761,badstof,0,0,4,4
4350,madrid,2,1,3,4
11132,preguntar,0,0,4,4
41994,originais,0,0,4,4
867,prima.,1,4,0,4
24701,vaya,0,0,4,4
11162,कभीकभी,0,0,4,4
15425,puissance,0,0,4,4
41999,अप्रैल,0,0,4,4
20210,isto,0,0,4,4
51532,kvar,0,0,4,4
35928,التعديلات,0,0,4,4
38176,hola,0,0,4,4
8672,probabile,1,4,0,4
18726,code,0,0,4,4
41149,ടെറിയും,0,0,4,4
35933,لطف,0,0,4,4
8677,famoso,2,2,2,4
14559,प्रक्रिया,0,0,4,4
24725,guapo,0,0,4,4
50524,буду,0,0,4,4
10835,pântano,0,0,4,4
14558,الغرق,0,0,4,4
41984,κείμενο,0,0,4,4
48132,ellas,0,0,4,4
44261,travaux,0,0,4,4
41968,сэнгер,0,0,4,4
44258,flydende,0,0,4,4
51526,samme,0,0,4,4
11108,ஒவ்வொரு,0,0,4,4
15389,بأن,0,0,4,4
41971,özgür,0,0,4,4
28122,vendiste,0,0,4,4
3920,persino,1,4,0,4
44171,passieren,0,0,4,4
14449,värt,0,0,4,4
36003,diriezvous,0,0,4,4
48137,akıcı,0,0,4,4
2546,periodo,1,4,0,4
44699,बटन,0,0,4,4
51027,أقل,0,0,4,4
24808,إضافة,0,0,4,4
8786,dipende,1,4,0,4
24792,съесть,0,0,4,4
24791,журналах,0,0,4,4
35982,entendu,0,0,4,4
10853,باللغة,0,0,4,4
35973,பெற,0,0,4,4
4346,piangendo,1,4,0,4
18748,antar,0,0,4,4
24776,nova,0,0,4,4
38145,algemeen,0,0,4,4
28156,الزاوية,0,0,4,4
48366,ಭಾವಿಸುತ್ತೇನೆ,0,0,4,4
8743,l'affidabilità,1,4,0,4
35976,inga,0,0,4,4
8745,suffisso,1,4,0,4
24778,यकीन,0,0,4,4
8748,definite,1,4,0,4
4343,distribuito,1,4,0,4
28151,ಮಗಳು,0,0,4,4
41979,φρικτό,0,0,4,4
18721,internacional,0,0,4,4
18712,تذكر,0,0,4,4
24816,чего,0,0,4,4
11251,« le,0,0,4,4
25217,dakika,0,0,4,4
18639,wrong,0,0,4,4
8547,l'universo,1,4,0,4
8552,sole,1,4,0,4
20259,éventuellement,0,0,4,4
41158,outlier,0,0,4,4
36415,editada,0,0,4,4
19000,japonais,0,0,4,4
840,dall'altra,1,4,0,4
27480,χρησιμοποιείται,0,0,4,4
24608,миллионов,0,0,4,4
1498,applicazione,1,4,0,4
47082,பிற,0,0,4,4
44688,phusis,0,0,4,4
42042,dumps,0,0,4,4
24619,vrij,0,0,4,4
2537,letteralmente,1,4,0,4
35803,gingen,0,0,4,4
28257,ನೀಡಲು,0,0,4,4
46785,rejse,0,0,4,4
27445,excepción,0,0,4,4
44103,¿no,0,0,4,4
51018,committee,0,0,4,4
828,criticato,1,4,0,4
46781,notably,0,0,4,4
28457,crianças,0,0,4,4
10802,nuevas,0,0,4,4
2343,cuore.,1,4,0,4
15483,πράγματα,0,0,4,4
38258,stället,0,0,4,4
18636,akademiska,0,0,4,4
48476,verkauft,0,0,4,4
8525,implicitamente,2,3,1,4
35795,scientifique,0,0,4,4
2346,traduzione,1,4,0,4
52342,chaîne,0,0,4,4
15468,بسبب,0,0,4,4
15466,அன்று,0,0,4,4
3151,citazioni,1,4,0,4
14561,niveaux,0,0,4,4
11200,ಎಲ್ಲವೂ,0,0,4,4
20225,debate,0,0,4,4
38209,projekt,0,0,4,4
38206,части,0,0,4,4
20222,நினைக்கிறேன்,0,0,4,4
38202,fungi,0,0,4,4
18988,मिनट,0,0,4,4
8638,avrei,1,4,0,4
46821,материалы,0,0,4,4
35899,channel,0,0,4,4
2352,faccia,1,4,0,4
10830,fått,0,0,4,4
15433,تسمح,0,0,4,4
20215,பகுதி,0,0,4,4
24696,कहता,0,0,4,4
35910,denke,0,0,4,4
11201,रोक,0,0,4,4
10827,റൊട്ടി,0,0,4,4
27506,बौद्धिक,0,0,4,4
36403,dedicado,0,0,4,4
28357,чрезвычайно,0,0,4,4
38238,प्रत्येक,0,0,4,4
8587,preferita,1,4,0,4
4252,dover,1,4,0,4
11224,ಇದನ್ನು,0,0,4,4
28339,स्रोतों,0,0,4,4
51401,κλαίει,0,0,4,4
8599,stesso.,1,4,0,4
36408,knap,0,0,4,4
52332,места,0,0,4,4
35863,समर्पित,0,0,4,4
41013,δεδομένων,0,0,4,4
35869,στις,0,0,4,4
855,dell'ia,1,4,0,4
10826,പറയുകയും,0,0,4,4
41067,فأنت,0,0,4,4
1465,tecnica,1,4,0,4
7922,sogni,1,4,0,4
27640,однажды,0,0,4,4
27841,såg,0,0,4,4
41109,sofisticado,0,0,4,4
41903,estudantes,0,0,4,4
27830,erhalten,0,0,4,4
41852,تقوله,0,0,4,4
18877,दस,0,0,4,4
27821,നഷ്ടം,0,0,4,4
37996,couldn,0,0,4,4
41904,europa,0,0,4,4
36199,மட்டுமே,0,0,4,4
37994,ужасное,0,0,4,4
25020,sålde,0,0,4,4
18889,насчет,0,0,4,4
44245,mudança,0,0,4,4
36216,notre,0,0,4,4
48231,contributed,0,0,4,4
949,presidente,2,2,2,4
52010,citou,0,0,4,4
20106,разными,0,0,4,4
945,ragioni,1,4,0,4
18844,redes,0,0,4,4
27885,texte,0,0,4,4
36145,برنامج,0,0,4,4
9100,económico,0,0,4,4
20100,fantastiska,0,0,4,4
3940,visualizzazioni,1,4,0,4
27628,demain,0,0,4,4
15261,bekymre,0,0,4,4
41139,आदमी,0,0,4,4
8956,probabilità.,1,4,0,4
38005,tamamen,0,0,4,4
36158,विश्वसनीय,0,0,4,4
36316,सुना,0,0,4,4
27859,multiple,0,0,4,4
27856,​​​,0,0,4,4
36164,supuesto,0,0,4,4
10950,fazendo,0,0,4,4
25023,ouverte,0,0,4,4
14520,ജോലിയിൽ,0,0,4,4
27674,zones,0,0,4,4
18923,editable,0,0,4,4
9039,miglio,1,4,0,4
25114,french,0,0,4,4
44230,entender,0,0,4,4
27710,försökt,0,0,4,4
10913,ouvir,0,0,4,4
4277,episodio,2,3,1,4
27676,d’autres,0,0,4,4
10889,خبراء,0,0,4,4
1420,gratuiti,1,4,0,4
25097,includes,0,0,4,4
52268,редакторов,0,0,4,4
25103,hypothesis,0,0,4,4
44235,diye,0,0,4,4
25110,होना,0,0,4,4
37941,énergie,0,0,4,4
9074,chris,2,1,3,4
10893,ecological,0,0,4,4
10892,långsamt,0,0,4,4
50720,जिसके,0,0,4,4
10941,غالبًا,0,0,4,4
36232,internationale,0,0,4,4
27658,främst,0,0,4,4
27751,sollte,0,0,4,4
25053,flytande,0,0,4,4
10934,सहयोगी,0,0,4,4
25057,creó,0,0,4,4
9077,dell'apprendimento.,1,4,0,4
2554,dell'universo,1,4,0,4
15290,prize,0,0,4,4
41121,lentement,0,0,4,4
25060,identified,0,0,4,4
9028,modificano,1,4,0,4
36244,errores,0,0,4,4
25063,método,0,0,4,4
27891,συνομιλία,0,0,4,4
10993,όσο,0,0,4,4
36022,connected,0,0,4,4
36060,تأخذ,0,0,4,4
36044,açı,0,0,4,4
44748,plaît,0,0,4,4
41948,vendu,0,0,4,4
52031,polaco,0,0,4,4
20142,лет,0,0,4,4
52299,أصدقائي,0,0,4,4
911,npov,2,1,3,4
27592,पृष्ठों,0,0,4,4
46921,إصلاح,0,0,4,4
48313,gespräch,0,0,4,4
48312,fast,0,0,4,4
20134,dafür,0,0,4,4
14479,consists,0,0,4,4
38065,atualmente,0,0,4,4
15361,வருந்துகிறேன்,0,0,4,4
28004,ಪದವು,0,0,4,4
52000,золотой,0,0,4,4
38083,planos,0,0,4,4
20109,ребята,0,0,4,4
28069,lenguas,0,0,4,4
28082,اعتبارًا,0,0,4,4
36362,பயன்படுத்தலாம்,0,0,4,4
24839,soimême,0,0,4,4
27565,quickly,0,0,4,4
24840,zowel,0,0,4,4
20153,highly,0,0,4,4
18969,diversas,0,0,4,4
24847,जांच,0,0,4,4
20149,pelos,0,0,4,4
11077,फिक्स,0,0,4,4
11075,கூடுதல்,0,0,4,4
25155,भाग्यशाली,0,0,4,4
24855,writers,0,0,4,4
14468,பார்க்க,0,0,4,4
48331,sum,0,0,4,4
46918,responsible,0,0,4,4
47050,диск,0,0,4,4
28000,laissezmoi,0,0,4,4
41935,الاتصال,0,0,4,4
14489,títulos,0,0,4,4
20035,μερικά,0,0,4,4
50570,अमेरिका,0,0,4,4
9109,nenhum,0,0,4,4
8912,wireless,2,1,3,4
38039,английская,0,0,4,4
11008,сми,0,0,4,4
27912,острый,0,0,4,4
8917,paura,1,4,0,4
41081,tam,0,0,4,4
27911,creation,0,0,4,4
47043,annually,0,0,4,4
936,classificati,1,4,0,4
27616,மெதுவாக,0,0,4,4
24950,ತಿನ್ನಲು,0,0,4,4
38035,würden,0,0,4,4
48270,fredag,0,0,4,4
18833,descobriu,0,0,4,4
36121,développée,0,0,4,4
44249,பல்வேறு,0,0,4,4
36116,ആഗ്രഹിക്കുന്നുവെങ്കിൽ,0,0,4,4
27985,σελίδα,0,0,4,4
38058,умных,0,0,4,4
50726,motores,0,0,4,4
4323,ospitare,1,4,0,4
11033,ആഗ്രഹിക്കുന്നു,0,0,4,4
27597,रखने,0,0,4,4
36338,yapabilirsin,0,0,4,4
2369,dataset,2,2,2,4
38051,хорошая,0,0,4,4
38048,handsome,0,0,4,4
27952,duas,0,0,4,4
11019,محرر,0,0,4,4
48168,vriend,0,0,4,4
9114,بالتأكيد,0,0,4,4
1409,siete,2,3,1,4
42061,skapa,0,0,4,4
8499,aggiornamento],1,4,0,4
25236,englisch,0,0,4,4
18423,digital,0,0,4,4
28983,мог,0,0,4,4
8108,sarebbero,1,4,0,4
4520,utili,1,4,0,4
4516,veri,1,4,0,4
28974,момент,0,0,4,4
1577,ragazzi.,1,4,0,4
50451,usada,0,0,4,4
3206,vapore,1,4,0,4
36532,natürlich,0,0,4,4
28956,médias,0,0,4,4
28954,udgivet,0,0,4,4
748,lezioni,1,4,0,4
20428,vandalismes,0,0,4,4
752,centrale,2,3,1,4
20425,fram,0,0,4,4
42184,உதவ,0,0,4,4
8105,dico,1,4,0,4
38507,கட்டற்ற,0,0,4,4
8075,repository,2,3,1,4
24151,चरण,0,0,4,4
15162,consejo,0,0,4,4
52396,चलो,0,0,4,4
14251,ಸಾಕಷ್ಟು,0,0,4,4
11568,ഹേയ്,0,0,4,4
15639,rond,0,0,4,4
8085,mille,2,3,1,4
11566,वेबसाइट,0,0,4,4
11563,sted,0,0,4,4
24163,ಬಳಸಲಾಗುತ್ತದೆ,0,0,4,4
10720,файлов,0,0,4,4
35434,αναστατωμένος,0,0,4,4
18410,हुई,0,0,4,4
29005,reglas,0,0,4,4
25327,பார்க்கிறேன்,0,0,4,4
11559,indicated,0,0,4,4
35440,बताने,0,0,4,4
52232,συνάντηση,0,0,4,4
28943,initiatives,0,0,4,4
1030,svms,2,2,2,4
24256,existing,0,0,4,4
28915,முதலில்,0,0,4,4
24236,identify,0,0,4,4
38461,vrije,0,0,4,4
38460,பொதுவான,0,0,4,4
28895,أوه,0,0,4,4
36503,sommes,0,0,4,4
44299,ρίζες,0,0,4,4
47134,possibly,0,0,4,4
38480,вандализм,0,0,4,4
8194,survey,2,1,3,4
48642,يوجد,0,0,4,4
8197,radiazione,1,4,0,4
19055,nonenglish,0,0,4,4
24266,zeer,0,0,4,4
2634,wap,2,1,3,4
11492,नशीली,0,0,4,4
4503,serve,2,3,1,4
41775,بخير,0,0,4,4
8172,matrice,1,4,0,4
20409,البيانات,0,0,4,4
20422,septiembre,0,0,4,4
18435,tomorrow,0,0,4,4
8152,parlamento,2,3,1,4
20419,græde,0,0,4,4
47139,अनुमति,0,0,4,4
8158,dicono,1,4,0,4
28927,enojado,0,0,4,4
8160,belle,2,1,3,4
4507,visualeditor,2,1,3,4
28925,begrepp,0,0,4,4
10739,praten,0,0,4,4
8165,ampio,1,4,0,4
11521,skribenter,0,0,4,4
40904,ofte,0,0,4,4
40906,ερώτηση,0,0,4,4
29027,incident,0,0,4,4
11574,angry,0,0,4,4
18614,style,0,0,4,4
35324,verbe,0,0,4,4
10699,flórida,0,0,4,4
29199,answer,0,0,4,4
24035,എന്നു,0,0,4,4
36554,side,0,0,4,4
27258,الرئيسية,0,0,4,4
37789,chacun,0,0,4,4
29188,skriva,0,0,4,4
24040,جامعة,0,0,4,4
3390,vandalismo.,1,4,0,4
38593,энциклопедией,0,0,4,4
11643,വർഷം,0,0,4,4
14615,dicha,0,0,4,4
18321,faites,0,0,4,4
29172,اللغة,0,0,4,4
18323,intervju,0,0,4,4
7986,verbo,2,2,2,4
43975,देखते,0,0,4,4
35311,वैसे,0,0,4,4
44898,ವೀಡಿಯೊವನ್ನು,0,0,4,4
35289,altına,0,0,4,4
35271,natuurlijk,0,0,4,4
20491,العلمية,0,0,4,4
36566,kijken,0,0,4,4
11669,örnek,0,0,4,4
36561,देना,0,0,4,4
698,rimettiti,1,4,0,4
7933,stile,1,4,0,4
48768,जिनमें,0,0,4,4
11659,içindeyim,0,0,4,4
35296,fürchte,0,0,4,4
35297,amanhã,0,0,4,4
48764,بالمائة,0,0,4,4
29230,இரவு,0,0,4,4
47990,told,0,0,4,4
24016,ничего,0,0,4,4
44915,afable,0,0,4,4
18333,अलगअलग,0,0,4,4
29158,industrial,0,0,4,4
7997,£,2,1,3,4
40875,employ,0,0,4,4
11607,قواعد,0,0,4,4
51926,japanese,0,0,4,4
46565,ಅದ್ಭುತವಾಗಿದೆ,0,0,4,4
40874,толку,0,0,4,4
19087,إجراء,0,0,4,4
29079,fel,0,0,4,4
48004,bleek,0,0,4,4
35399,imagem,0,0,4,4
14614,avance,0,0,4,4
24112,январе,0,0,4,4
41203,kez,0,0,4,4
1383,annunciato,1,4,0,4
14238,τρία,0,0,4,4
27282,namnet,0,0,4,4
38533,livres,0,0,4,4
40886,aumentar,0,0,4,4
29101,फर्क,0,0,4,4
1592,wikinfo,2,1,3,4
29113,gud,0,0,4,4
35368,dix,0,0,4,4
1598,sviluppare,1,4,0,4
44912,länkar,0,0,4,4
4546,distinguono,1,4,0,4
38575,servir,0,0,4,4
11626,font,0,0,4,4
2651,commento,1,4,0,4
11619,ಸ್ಥಳದಲ್ಲಿ,0,0,4,4
18353,celles,0,0,4,4
29133,tuvo,0,0,4,4
24083,എന്തായാലും,0,0,4,4
35365,appelée,0,0,4,4
45360,citation,0,0,4,4
24085,ಭಯಾನಕ,0,0,4,4
50785,comparando,0,0,4,4
35367,ഭക്ഷണം,0,0,4,4
18462,يبدو,0,0,4,4
24272,konnte,0,0,4,4
48634,minuten,0,0,4,4
35688,dynamique,0,0,4,4
24481,côté,0,0,4,4
24488,reviews,0,0,4,4
42089,pesar,0,0,4,4
18569,allmänhet,0,0,4,4
51013,tijdens,0,0,4,4
35681,முறையில்,0,0,4,4
18570,pasa,0,0,4,4
44823,mayores,0,0,4,4
2329,merito,1,4,0,4
15203,vilka,0,0,4,4
28591,derechos,0,0,4,4
24495,neler,0,0,4,4
38308,direito,0,0,4,4
28584,പകരം,0,0,4,4
44822,statut,0,0,4,4
9245,visitas,0,0,4,4
40961,publié,0,0,4,4
20325,εντελώς,0,0,4,4
15595,olumsuz,0,0,4,4
47104,gjordes,0,0,4,4
38337,потрясающе,0,0,4,4
41803,точки,0,0,4,4
797,hegel,2,3,1,4
51958,ಯೋಗ್ಯವಾಗಿಲ್ಲ,0,0,4,4
47106,parle,0,0,4,4
37852,بعتني,0,0,4,4
8375,sarei,1,4,0,4
24457,ली,0,0,4,4
8399,passive,2,1,3,4
28645,substantially,0,0,4,4
46723,materiais,0,0,4,4
48549,позвольте,0,0,4,4
8386,selvagge,1,4,0,4
801,sconosciuta,1,4,0,4
8389,niente.,1,4,0,4
28627,கவலையும்,0,0,4,4
35699,redigering,0,0,4,4
28574,levar,0,0,4,4
8436,utente,1,4,0,4
15505,ವೀಡಿಯೊದಲ್ಲಿ,0,0,4,4
52351,beginnen,0,0,4,4
28517,கணம்,0,0,4,4
24537,w ·,0,0,4,4
36439,ஜிம்மி,0,0,4,4
14369,ana,0,0,4,4
44284,आम,0,0,4,4
46764,clasificar,0,0,4,4
38276,orientação,0,0,4,4
18577,θυμηθείτε,0,0,4,4
4425,guide,2,1,3,4
8488,chiedi,1,4,0,4
35754,spijt,0,0,4,4
8490,farlo.,1,4,0,4
20290,भाषाओं,0,0,4,4
46774,ensayo,0,0,4,4
2339,composto,1,4,0,4
47099,relacionado,0,0,4,4
24531,ഇതുവരെ,0,0,4,4
2610,mostrato,1,4,0,4
46756,तुम्हें,0,0,4,4
48521,indicate,0,0,4,4
8440,preservare,1,4,0,4
24509,அவை,0,0,4,4
27428,licencia,0,0,4,4
3880,atroci,1,4,0,4
8446,vettori,1,4,0,4
27434,planes,0,0,4,4
44680,creada,0,0,4,4
38290,aprendizagem,0,0,4,4
14365,course,0,0,4,4
35716,nombres,0,0,4,4
51128,нескольких,0,0,4,4
52353,moon,0,0,4,4
51543,tópico,0,0,4,4
819,regione,1,4,0,4
48064,zeg,0,0,4,4
18521,solución,0,0,4,4
27407,கோபமாக,0,0,4,4
41788,kennen,0,0,4,4
37836,இனிமையான,0,0,4,4
8245,chiedere.,1,4,0,4
25268,وتريد,0,0,4,4
47120,perçue,0,0,4,4
24330,над,0,0,4,4
28792,कैच,0,0,4,4
28790,ciertos,0,0,4,4
24333,sonu,0,0,4,4
2627,particolarmente,1,4,0,4
1022,britannica.,1,4,0,4
35587,klein,0,0,4,4
8267,intenzione,1,4,0,4
8268,edizione,1,4,0,4
40933,वितरित,0,0,4,4
35592,game,0,0,4,4
27376,παιδιά,0,0,4,4
46656,focused,0,0,4,4
48618,سانجر,0,0,4,4
4235,fattore,1,4,0,4
769,conosciuta,1,4,0,4
4494,shapiro,2,2,2,4
8212,emozioni,1,4,0,4
52385,videre,0,0,4,4
24292,impacto,0,0,4,4
44039,तैयार,0,0,4,4
44871,paar,0,0,4,4
44041,higher,0,0,4,4
42157,όλοι,0,0,4,4
28851,использование,0,0,4,4
11473,frequently,0,0,4,4
19050,παρακαλώ,0,0,4,4
35546,venligt,0,0,4,4
11471,நாம்,0,0,4,4
764,linguistica,1,4,0,4
50775,screwed,0,0,4,4
50813,நர்சிஸஸ்,0,0,4,4
27380,fundada,0,0,4,4
47107,प्रभाव,0,0,4,4
38352,அவர்களிடம்,0,0,4,4
10777,ध्वनि,0,0,4,4
10778,لماذا,0,0,4,4
35624,behöver,0,0,4,4
44847,disagreement,0,0,4,4
790,percento,1,4,0,4
8338,records,2,1,3,4
38354,வார,0,0,4,4
24411,conocidos,0,0,4,4
35597,amplamente,0,0,4,4
8344,medico,1,4,0,4
44064,रखता,0,0,4,4
2323,riferisce,1,4,0,4
14331,कौन,0,0,4,4
28672,ஆண்டின்,0,0,4,4
8357,modificate,1,4,0,4
38342,मान्यता,0,0,4,4
47109,ಬಟನ್,0,0,4,4
15562,prijs,0,0,4,4
25250,skrivandet,0,0,4,4
2532,generano,1,4,0,4
18502,разделе,0,0,4,4
44855,båda,0,0,4,4
776,alias,2,1,3,4
8293,andare.,1,4,0,4
27382,работает,0,0,4,4
14315,quotidienne,0,0,4,4
38389,fout,0,0,4,4
25261,ναι,0,0,4,4
24366,bonito,0,0,4,4
8301,lascia,1,4,0,4
28726,seven,0,0,4,4
785,yasseri,2,2,2,4
8310,pari,1,4,0,4
8313,l'angelo,1,4,0,4
50471,άρχισε,0,0,4,4
24347,incluyendo,0,0,4,4
20780,creo,0,0,4,4
38848,realidade,0,0,4,4
31864,создания,0,0,4,4
33618,ചിലർക്ക്,0,0,4,4
39782,pedindo,0,0,4,4
49707,anos,0,0,4,4
42972,vereceğim,0,0,4,4
6040,cinese,1,4,0,4
31868,bons,0,0,4,4
6046,rumore,1,4,0,4
39778,conseguiu,0,0,4,4
31858,deben,0,0,4,4
33616,brödet,0,0,4,4
13710,incluem,0,0,4,4
39761,ചോദിക്കുന്നു,0,0,4,4
5002,trimestre,2,1,3,4
39756,άρεσε,0,0,4,4
49698,naturelles,0,0,4,4
16407,audience,0,0,4,4
13713,cofounder,0,0,4,4
22231,публикации,0,0,4,4
16417,வண்டியில்,0,0,4,4
6030,copyleft,2,2,2,4
4126,rey,2,1,3,4
43491,wants,0,0,4,4
12974,mío,0,0,4,4
33589,shows,0,0,4,4
49730,wikipediaartikel,0,0,4,4
22174,verlegenheit,0,0,4,4
3282,descriveva,1,4,0,4
22177,मिलने,0,0,4,4
42980,absoluto,0,0,4,4
50212,mesaj,0,0,4,4
12966,preocupada,0,0,4,4
49715,kluges,0,0,4,4
40448,reçu,0,0,4,4
31905,nothing,0,0,4,4
37023,meningar,0,0,4,4
22189,verstaan,0,0,4,4
22192,aparecer,0,0,4,4
45713,предложение,0,0,4,4
45714,favorit,0,0,4,4
17215,expertos,0,0,4,4
6067,d'accordo,1,4,0,4
31827,ಬಯಸುವುದಿಲ್ಲ,0,0,4,4
33584,algae,0,0,4,4
43521,namn,0,0,4,4
31768,بشأن,0,0,4,4
45748,manmade,0,0,4,4
31762,mam,0,0,4,4
22290,humanité,0,0,4,4
1165,ottimo,1,4,0,4
22295,vertel,0,0,4,4
6126,elenco,1,4,0,4
42941,बेहद,0,0,4,4
19384,ήμουν,0,0,4,4
43514,problemática,0,0,4,4
45214,regional,0,0,4,4
26563,cabo,0,0,4,4
1161,watson,2,1,3,4
19380,zusammen,0,0,4,4
33717,bit,0,0,4,4
21117,आसान,0,0,4,4
3631,ulteriori,1,4,0,4
49661,haber,0,0,4,4
22276,छोटे,0,0,4,4
4990,ricevere,1,4,0,4
31826,фонд,0,0,4,4
31815,tycker,0,0,4,4
39743,key,0,0,4,4
13717,estimated,0,0,4,4
4996,modificato,1,4,0,4
50219,ൽ,0,0,4,4
45736,exatamente,0,0,4,4
39741,vrouwen,0,0,4,4
31818,telegram,0,0,4,4
25953,ataques,0,0,4,4
19387,estraguei,0,0,4,4
13726,determine,0,0,4,4
2165,erasmus,2,1,3,4
31807,botón,0,0,4,4
2168,interessante,2,2,2,4
42956,मिल,0,0,4,4
17241,protocole,0,0,4,4
49677,damit,0,0,4,4
22268,centaines,0,0,4,4
13724,مجتمع,0,0,4,4
49732,sägs,0,0,4,4
31932,pratique,0,0,4,4
16376,británica,0,0,4,4
189,Street,1,4,0,4
5894,successivo,1,4,0,4
49780,المنفرجة,0,0,4,4
49779,ange,0,0,4,4
37047,статью,0,0,4,4
33517,வேடிக்கையான,0,0,4,4
1268,che.,1,4,0,4
10301,ആവശ്യമാണ്,0,0,4,4
19407,verkocht,0,0,4,4
32027,focuses,0,0,4,4
13677,faz,0,0,4,4
32023,ಬಯಸುತ್ತೇನೆ,0,0,4,4
26501,berkman,0,0,4,4
19405,ονομάζεται,0,0,4,4
43461,seconde,0,0,4,4
13016,إزالة,0,0,4,4
10303,emprego,0,0,4,4
13013,pläne,0,0,4,4
37038,eux,0,0,4,4
22094,सकती,0,0,4,4
50641,rapid,0,0,4,4
21177,estabas,0,0,4,4
52111,बुरा,0,0,4,4
5847,sette,1,4,0,4
3481,crudele,1,4,0,4
22057,hålla,0,0,4,4
26478,प्रारंभ,0,0,4,4
39867,difference,0,0,4,4
45253,underlättar,0,0,4,4
5864,esistenti,1,4,0,4
13053,áreas,0,0,4,4
33491,إجراؤها,0,0,4,4
13675,поддерживает,0,0,4,4
17137,ordinateurs,0,0,4,4
43025,सहकर्मी,0,0,4,4
1989,voci.,1,4,0,4
26483,അമ്മ,0,0,4,4
16479,औपचारिक,0,0,4,4
5879,discutere,1,4,0,4
43455,كبيرة,0,0,4,4
47418,wikipédias,0,0,4,4
32004,distinction,0,0,4,4
198,impedire,1,4,0,4
21156,cancer,0,0,4,4
22146,desculpas,0,0,4,4
5958,nulla,1,4,0,4
2856,recenti,1,4,0,4
33562,automática,0,0,4,4
33563,studies,0,0,4,4
9914,गई,0,0,4,4
2975,reinvestimento,1,4,0,4
49743,журнала,0,0,4,4
5970,terribile,1,4,0,4
43480,ಸ್ನೇಹಿತರು,0,0,4,4
22141,spanish,0,0,4,4
50203,बैठक,0,0,4,4
31944,människor,0,0,4,4
22160,σχεδόν,0,0,4,4
39802,mat,0,0,4,4
43484,подумать,0,0,4,4
25965,делает,0,0,4,4
5986,opinioni,1,4,0,4
5018,piangere,1,4,0,4
1275,breve,2,2,2,4
51492,activos,0,0,4,4
199,reagle,2,2,2,4
17173,βρίσκεστε,0,0,4,4
17170,ಹೇಳುತ್ತೀರಿ,0,0,4,4
33544,مواقع,0,0,4,4
47641,şaşırtıcı,0,0,4,4
26515,trabajar,0,0,4,4
43003,हाल,0,0,4,4
5934,radici,1,4,0,4
50196,küçük,0,0,4,4
22124,technologie,0,0,4,4
47643,فيه,0,0,4,4
202,citizen,2,1,3,4
5943,apportare,1,4,0,4
43001,empresas,0,0,4,4
47410,gråta,0,0,4,4
26525,baan,0,0,4,4
21168,ней,0,0,4,4
49753,waarin,0,0,4,4
22136,inquiétez,0,0,4,4
9917,leitor,0,0,4,4
31726,understand,0,0,4,4
31723,ಹೇ,0,0,4,4
33469,caractéristiques,0,0,4,4
16291,pantano,0,0,4,4
31444,αξίζει,0,0,4,4
1918,operativa,1,4,0,4
16296,lío,0,0,4,4
31435,ശേഷം,0,0,4,4
49563,gehoord,0,0,4,4
33910,wikipediacom,0,0,4,4
39545,primeros,0,0,4,4
22552,recognized,0,0,4,4
6378,immagino,1,4,0,4
36949,akşam,0,0,4,4
31423,योजना,0,0,4,4
52621,democrática,0,0,4,4
6381,stanno,1,4,0,4
31417,extremamente,0,0,4,4
36946,schoonheid,0,0,4,4
1298,libera.,1,4,0,4
33920,सितंबर,0,0,4,4
22570,exemplos,0,0,4,4
45183,flere,0,0,4,4
45856,ഞാൻ‌,0,0,4,4
33925,декабре,0,0,4,4
4039,costante,1,4,0,4
43576,distinguished,0,0,4,4
6328,muove,1,4,0,4
6330,wikinews,2,1,3,4
33885,функционирование,0,0,4,4
43578,завтра,0,0,4,4
22509,redan,0,0,4,4
31468,permitir,0,0,4,4
40510,hellre,0,0,4,4
44425,там,0,0,4,4
18052,detectar,0,0,4,4
6344,pratici,1,4,0,4
12737,самом,0,0,4,4
43582,falando,0,0,4,4
49574,resolution,0,0,4,4
26652,guess,0,0,4,4
17381,ആരംഭിച്ചു,0,0,4,4
37458,près,0,0,4,4
6354,coinvolge,1,4,0,4
26670,historial,0,0,4,4
47710,sister,0,0,4,4
17374,programmed,0,0,4,4
39476,primero,0,0,4,4
47720,buluşma,0,0,4,4
4145,sviluppati,1,4,0,4
45893,champ,0,0,4,4
16264,محمل,0,0,4,4
19742,room,0,0,4,4
4913,interno,2,3,1,4
3664,lavoro.,1,4,0,4
39482,kwamen,0,0,4,4
47353,trovärdighet,0,0,4,4
31328,başladı,0,0,4,4
51760,boundaries,0,0,4,4
3240,orribile,1,4,0,4
49513,ಮಾಡಿದ,0,0,4,4
31290,toch,0,0,4,4
13822,تايمز,0,0,4,4
47727,«википедии»,0,0,4,4
3665,motore,1,4,0,4
4909,ii,2,2,2,4
41349,hein,0,0,4,4
2815,occupa,2,3,1,4
31402,பிடிக்கவில்லை,0,0,4,4
1912,vestito,1,4,0,4
4926,mille.,1,4,0,4
25837,έναν,0,0,4,4
33928,cambio,0,0,4,4
50971,июня,0,0,4,4
36938,razón,0,0,4,4
45176,särskilt,0,0,4,4
22591,kelimesinin,0,0,4,4
40520,للحصول,0,0,4,4
49540,rendre,0,0,4,4
12679,സ്വതന്ത്ര,0,0,4,4
21024,συμβαίνει,0,0,4,4
36936,текст,0,0,4,4
36935,vognen,0,0,4,4
22604,kullanıcılar,0,0,4,4
26683,single,0,0,4,4
6430,sostanzialmente,1,4,0,4
17422,जर्मन,0,0,4,4
12680,killar,0,0,4,4
12751,d’apprentissage,0,0,4,4
4944,veloce,1,4,0,4
1156,addestrato,1,4,0,4
6213,modello.,1,4,0,4
45788,speech,0,0,4,4
26602,ಮಾಡಬಹುದು,0,0,4,4
31644,chinese,0,0,4,4
45790,чегото,0,0,4,4
39668,bother,0,0,4,4
39667,problemen,0,0,4,4
249,sola,2,2,2,4
52177,சொற்களை,0,0,4,4
9862,دراسة,0,0,4,4
6191,tratti,1,4,0,4
40481,langsam,0,0,4,4
12833,ராக்,0,0,4,4
33789,uppslagsverk,0,0,4,4
12832,korkarım,0,0,4,4
47681,ಯಾಕೆ,0,0,4,4
31614,attempt,0,0,4,4
1283,Journal,1,4,0,4
6229,determinare,1,4,0,4
31660,heat,0,0,4,4
31668,получил,0,0,4,4
17314,dort,0,0,4,4
13740,enlightenment,0,0,4,4
22322,processing,0,0,4,4
45768,μπορούσες,0,0,4,4
22324,vanligt,0,0,4,4
26581,ami,0,0,4,4
33731,équivalent,0,0,4,4
41583,செய்யப்பட்ட,0,0,4,4
13737,sharp,0,0,4,4
39692,ஏனென்றால்,0,0,4,4
47671,überflutet,0,0,4,4
40472,écologie,0,0,4,4
39685,κουμπί,0,0,4,4
6170,conosci,1,4,0,4
31691,homem,0,0,4,4
236,attuale,1,4,0,4
31683,sucede,0,0,4,4
13741,komme,0,0,4,4
33751,unutmayın,0,0,4,4
3635,fondata,1,4,0,4
2998,intrinsecamente,1,4,0,4
51743,sociala,0,0,4,4
40502,einfach,0,0,4,4
6294,sesto,1,4,0,4
22458,héberge,0,0,4,4
4044,fauna,2,3,1,4
12785,மொழிகளில்,0,0,4,4
3462,fossi,1,4,0,4
6288,domanda.,1,4,0,4
26636,julio,0,0,4,4
40497,المزيد,0,0,4,4
47693,ल्युसेन,0,0,4,4
19341,radiation,0,0,4,4
12791,πάει,0,0,4,4
12772,januar,0,0,4,4
25880,ahead,0,0,4,4
13776,"
विकिपीडिया",0,0,4,4
6304,yongle,2,2,2,4
52629,elas,0,0,4,4
12763,करे,0,0,4,4
6315,un'area,1,4,0,4
22489,essentiellement,0,0,4,4
21079,visas,0,0,4,4
45824,карета,0,0,4,4
19352,πριν,0,0,4,4
39630,wütend,0,0,4,4
36968,resolução,0,0,4,4
4959,magnus,2,1,3,4
47686,button,0,0,4,4
19720,लिखे,0,0,4,4
51744,जगह,0,0,4,4
50243,sommige,0,0,4,4
6248,egli,1,4,0,4
42900,outubro,0,0,4,4
13764,يهم,0,0,4,4
42889,apportées,0,0,4,4
13766,skicka,0,0,4,4
6257,idea.,1,4,0,4
39622,propia,0,0,4,4
6260,dale,2,1,3,4
50875,них,0,0,4,4
31560,relève,0,0,4,4
16335,waard,0,0,4,4
10353,нравится,0,0,4,4
13067,وجهة,0,0,4,4
52160,എന്നോട്,0,0,4,4
39457,ಇಂಗ್ಲಿಷ್,0,0,4,4
1220,turista,2,2,2,4
32686,dynamic,0,0,4,4
19511,madde,0,0,4,4
32684,devenue,0,0,4,4
40137,effective,0,0,4,4
40134,вместе,0,0,4,4
33116,facts,0,0,4,4
44523,détectés,0,0,4,4
13549,probleem,0,0,4,4
10083,divine,0,0,4,4
32688,أفهم,0,0,4,4
1219,oceaniche,1,4,0,4
32657,wwwwikipediacom,0,0,4,4
10081,ελεύθερου,0,0,4,4
43343,दृष्टिकोण,0,0,4,4
32646,riquezas,0,0,4,4
5160,questioni,1,4,0,4
33141,modificaciones,0,0,4,4
5449,dovresti,1,4,0,4
21635,doe,0,0,4,4
33111,ответ,0,0,4,4
45456,titre,0,0,4,4
10096,viele,0,0,4,4
5380,subito,1,4,0,4
21591,всё,0,0,4,4
45435,sak,0,0,4,4
3543,pollice,1,4,0,4
26149,obvious,0,0,4,4
2068,tendenze,1,4,0,4
2456,regno,1,4,0,4
26144,مشكلة,0,0,4,4
33081,geweldige,0,0,4,4
13350,ansiklopedisi,0,0,4,4
21602,रखते,0,0,4,4
5177,prendi,1,4,0,4
51233,contexte,0,0,4,4
32723,arg,0,0,4,4
33087,терренс,0,0,4,4
40297,सम्बन्धी,0,0,4,4
5409,ottobre,1,4,0,4
21631,colaboração,0,0,4,4
4100,denota,2,1,3,4
26115,mu,0,0,4,4
10184,genoeg,0,0,4,4
5509,"inglese,",1,4,0,4
16899,प्रविष्टियों,0,0,4,4
32591,hoje,0,0,4,4
1212,scrittura,1,4,0,4
21705,изза,0,0,4,4
51057,ಕೆಲಸದಲ್ಲಿ,0,0,4,4
21712,ആംഗിൾ,0,0,4,4
1244,riflettere,1,4,0,4
40092,nedan,0,0,4,4
21719,heureux,0,0,4,4
21699,continuous,0,0,4,4
21349,publicidad,0,0,4,4
4104,so.,1,4,0,4
3496,array,2,1,3,4
43361,يقرب,0,0,4,4
26103,версия,0,0,4,4
13577,glück,0,0,4,4
51473,തന്റെ,0,0,4,4
21739,alright,0,0,4,4
40100,τυχερός,0,0,4,4
51684,среди,0,0,4,4
21660,tipp,0,0,4,4
26114,облажался,0,0,4,4
21661,favorita,0,0,4,4
33149,coming,0,0,4,4
43196,popularity,0,0,4,4
45462,बदल,0,0,4,4
2938,continenti,1,4,0,4
66,tadić,2,1,3,4
40312,совет,0,0,4,4
14869,stilig,0,0,4,4
43195,médio,0,0,4,4
32598,charge,0,0,4,4
21359,एनसाइक्लोपीडिया,0,0,4,4
13319,tâche,0,0,4,4
52138,நேரங்களில்,0,0,4,4
40105,brandchannelcom,0,0,4,4
13314,εκπληκτικό,0,0,4,4
40314,advance,0,0,4,4
21355,pontos,0,0,4,4
5483,reso,1,4,0,4
32748,тупой,0,0,4,4
4089,routine,2,2,2,4
5527,ufficiale,1,4,0,4
32886,المشروع,0,0,4,4
45380,diferente,0,0,4,4
32971,أعلم,0,0,4,4
5264,aiutarti,1,4,0,4
10158,قاموس,0,0,4,4
21495,обычно,0,0,4,4
5267,telefono,1,4,0,4
32893,worth,0,0,4,4
5273,vediamo,1,4,0,4
40227,σχέδια,0,0,4,4
32901,movement,0,0,4,4
45350,wasn,0,0,4,4
40265,заявил,0,0,4,4
2085,sequence,2,1,3,4
40223,لدى,0,0,4,4
24,formare,1,4,0,4
45389,സമയം,0,0,4,4
32871,entrou,0,0,4,4
32988,constituye,0,0,4,4
21494,இருந்தார்கள்,0,0,4,4
50095,degrees,0,0,4,4
10167,igång,0,0,4,4
32952,പ്രധാന,0,0,4,4
19537,oluyor,0,0,4,4
45363,sucesso,0,0,4,4
32947,θέση,0,0,4,4
21453,أخشى,0,0,4,4
32935,tussen,0,0,4,4
51663,junto,0,0,4,4
2463,l'errore,1,4,0,4
32930,شركة,0,0,4,4
50938,trabaja,0,0,4,4
21480,γίνεται,0,0,4,4
32923,sorun,0,0,4,4
10141,glas,0,0,4,4
5243,mercato,1,4,0,4
13503,ألا,0,0,4,4
9,notato,1,4,0,4
43280,volontaires,0,0,4,4
5248,kdd,2,2,2,4
14836,തെറ്റുകൾ,0,0,4,4
50079,lugares,0,0,4,4
5295,california,2,1,3,4
40171,സ്വാഗതം,0,0,4,4
16812,டெர்ரி,0,0,4,4
21402,पुरस्कार,0,0,4,4
21401,fluide,0,0,4,4
21563,исправлении,0,0,4,4
10113,phone,0,0,4,4
43243,espacio,0,0,4,4
21566,ferramenta,0,0,4,4
34,separato,1,4,0,4
32783,progrès,0,0,4,4
37,arrivò,1,4,0,4
13529,gonna,0,0,4,4
14852,först,0,0,4,4
32771,básicas,0,0,4,4
21583,recentes,0,0,4,4
5365,domini,1,4,0,4
50036,ഗുരുതരമായ,0,0,4,4
26244,translation,0,0,4,4
32761,slow,0,0,4,4
5372,scorpions,2,1,3,4
10177,passed,0,0,4,4
50128,наиболее,0,0,4,4
32858,രാത്രി,0,0,4,4
21421,अक्टूबर,0,0,4,4
50931,advocacy,0,0,4,4
32857,toe,0,0,4,4
45394,nunca,0,0,4,4
40212,åka,0,0,4,4
50074,aime,0,0,4,4
5304,manning,2,1,3,4
5306,riferimenti,1,4,0,4
13435,café,0,0,4,4
10122,kullanılır,0,0,4,4
43312,incluir,0,0,4,4
21542,unless,0,0,4,4
21543,album,0,0,4,4
2464,logoramento,1,4,0,4
13523,बाहर,0,0,4,4
5322,messo,1,4,0,4
10173,التغييرات,0,0,4,4
45406,présente,0,0,4,4
21410,الثانية,0,0,4,4
51472,bättre,0,0,4,4
40073,ತನ್ನ,0,0,4,4
43031,ним,0,0,4,4
9992,inanılmaz,0,0,4,4
21917,sold,0,0,4,4
45582,espero,0,0,4,4
39961,obra,0,0,4,4
33364,λυπάμαι,0,0,4,4
5731,grillini,2,1,3,4
2877,contenuti.,1,4,0,4
49858,परिवर्तन,0,0,4,4
47604,ನೋಡುತ್ತೀರಿ,0,0,4,4
37098,vaak,0,0,4,4
39966,فقد,0,0,4,4
13636,जारी,0,0,4,4
17066,själva,0,0,4,4
37097,octubre,0,0,4,4
21936,olabilir,0,0,4,4
21938,nächste,0,0,4,4
32249,organizações,0,0,4,4
3486,maggiori,1,4,0,4
5084,dell'articolo,1,4,0,4
19438,permettre,0,0,4,4
43409,criterios,0,0,4,4
21960,cruzados,0,0,4,4
14900,novas,0,0,4,4
16560,investigation,0,0,4,4
5686,pubblicazione,1,4,0,4
49880,الصفحة,0,0,4,4
26028,προτάσεις,0,0,4,4
2134,umana.,1,4,0,4
32316,logical,0,0,4,4
39981,raised,0,0,4,4
5696,potenziali,1,4,0,4
17047,event,0,0,4,4
32294,diga,0,0,4,4
44470,files,0,0,4,4
10260,حياتك,0,0,4,4
32302,back,0,0,4,4
10000,मूर्खतापूर्ण,0,0,4,4
16553,allez,0,0,4,4
49871,mentioned,0,0,4,4
13631,citations,0,0,4,4
21906,comments,0,0,4,4
33382,ceci,0,0,4,4
50898,solid,0,0,4,4
5682,portata,1,4,0,4
10280,botão,0,0,4,4
158,luna,1,4,0,4
33423,enstaka,0,0,4,4
160,generale.,1,4,0,4
16505,gabriel,0,0,4,4
13092,يبكي,0,0,4,4
5810,fondatore,1,4,0,4
2481,sforzo,1,4,0,4
17114,guidelines,0,0,4,4
33436,നിങ്ങൾക്കറിയാം,0,0,4,4
19426,concerned,0,0,4,4
19667,tegen,0,0,4,4
39889,agrupamiento,0,0,4,4
47620,संगठन,0,0,4,4
16497,"
पश्चिमी",0,0,4,4
17122,licensed,0,0,4,4
47623,вики,0,0,4,4
37067,susningnu,0,0,4,4
47428,específicas,0,0,4,4
52683,وإذا,0,0,4,4
19663,aparecen,0,0,4,4
13124,الأكثر,0,0,4,4
44547,neredeyse,0,0,4,4
41548,времени,0,0,4,4
3595,basso,1,4,0,4
37094,réalise,0,0,4,4
5771,supervisione,1,4,0,4
39925,formes,0,0,4,4
19657,présence,0,0,4,4
32211,gott,0,0,4,4
49835,aspect,0,0,4,4
21981,हिस्सा,0,0,4,4
43038,court,0,0,4,4
10274,நுபீடியா,0,0,4,4
37082,كانون,0,0,4,4
26446,mudanças,0,0,4,4
5793,modellazione,1,4,0,4
22004,particularly,0,0,4,4
43040,നമുക്ക്,0,0,4,4
32189,tend,0,0,4,4
21217,extension,0,0,4,4
13174,kallas,0,0,4,4
21874,working,0,0,4,4
16623,members,0,0,4,4
45521,historique,0,0,4,4
33238,frågor,0,0,4,4
26348,ലേഖനങ്ങളുടെ,0,0,4,4
26079,weten,0,0,4,4
16607,nacht,0,0,4,4
95,hardware,2,2,2,4
10038,institute,0,0,4,4
37320,samarbete,0,0,4,4
21305,अलग,0,0,4,4
5580,intraprendere,1,4,0,4
47569,studien,0,0,4,4
32465,spel,0,0,4,4
5583,«wikipedia,2,1,3,4
33262,lesquels,0,0,4,4
26075,situations,0,0,4,4
2030,limiti,1,4,0,4
5592,precedentemente,1,4,0,4
13232,universelle,0,0,4,4
10035,hope,0,0,4,4
43374,dicho,0,0,4,4
40337,genoemd,0,0,4,4
32438,algum,0,0,4,4
40067,المقال,0,0,4,4
33214,dur,0,0,4,4
5144,canto,2,3,1,4
26309,tio,0,0,4,4
10052,respeito,0,0,4,4
26310,xixe siècle,0,0,4,4
5536,aumentare,1,4,0,4
32530,funcionar,0,0,4,4
33218,region,0,0,4,4
21756,других,0,0,4,4
51252,gekommen,0,0,4,4
37170,förvirrade,0,0,4,4
49948,theoretical,0,0,4,4
40336,wikileaks,0,0,4,4
21772,pm,0,0,4,4
89,suggerito,1,4,0,4
45506,took,0,0,4,4
5551,risultato,1,4,0,4
32513,رائعًا,0,0,4,4
41423,ಹೋಗಬೇಕು,0,0,4,4
32437,traffic,0,0,4,4
13178,doctor,0,0,4,4
2020,inclusa,1,4,0,4
26040,filosofía,0,0,4,4
32365,ഭയപ്പെടുന്നു,0,0,4,4
1194,tendono,1,4,0,4
32362,एकमात्र,0,0,4,4
32361,प्यार,0,0,4,4
37120,مصادر,0,0,4,4
49892,പ്രവർത്തിക്കുന്ന,0,0,4,4
21270,senaste,0,0,4,4
26039,ans,0,0,4,4
33306,finalidad,0,0,4,4
16569,உள்ளது,0,0,4,4
1192,all'apprendimento,1,4,0,4
37340,argent,0,0,4,4
21266,sentido,0,0,4,4
121,marmellata,1,4,0,4
32340,исследования,0,0,4,4
5676,l'evoluzione,1,4,0,4
43400,института,0,0,4,4
32368,όμορφη,0,0,4,4
115,derakhshan,2,2,2,4
37142,promover,0,0,4,4
32401,ലേഖനങ്ങളെ,0,0,4,4
33281,comité,0,0,4,4
26070,وغير,0,0,4,4
33288,watching,0,0,4,4
10234,hørt,0,0,4,4
45528,spelar,0,0,4,4
51259,staat,0,0,4,4
32409,متعبًا,0,0,4,4
2122,record,2,1,3,4
5125,profondo,1,4,0,4
10242,fantastiske,0,0,4,4
114,l'intelligenza,1,4,0,4
5629,wikispecies,2,2,2,4
13206,misstag,0,0,4,4
32389,engelsk,0,0,4,4
13608,अनुरोध,0,0,4,4
40004,imod,0,0,4,4
45540,hemen,0,0,4,4
5640,guai,1,4,0,4
45912,devem,0,0,4,4
6355,narcisismo,2,2,2,4
30566,σίγουρα,0,0,4,4
23219,поводу,0,0,4,4
34525,huge,0,0,4,4
12234,complexe,0,0,4,4
12233,അതെ,0,0,4,4
39104,propios,0,0,4,4
1765,candidato,2,1,3,4
7068,vedere,1,4,0,4
13985,statistik,0,0,4,4
15049,जिससे,0,0,4,4
1332,cell,2,1,3,4
51329,каждый,0,0,4,4
42585,nehmen,0,0,4,4
49194,अ,0,0,4,4
46175,activamente,0,0,4,4
41283,istemek,0,0,4,4
4770,professore,1,4,0,4
34538,vapor,0,0,4,4
20805,பெற்றேன்,0,0,4,4
41296,aide,0,0,4,4
45061,κόρη,0,0,4,4
30427,away,0,0,4,4
49209,வீடியோவில்,0,0,4,4
23172,américaine,0,0,4,4
12271,tyska,0,0,4,4
9617,настолько,0,0,4,4
50606,greater,0,0,4,4
12263,போமிஸ்,0,0,4,4
23185,classifier,0,0,4,4
43752,navn,0,0,4,4
46153,другом,0,0,4,4
7034,lsjbot,2,1,3,4
12255,gibisin,0,0,4,4
39130,дочь,0,0,4,4
49215,élevé,0,0,4,4
1328,affermazioni,1,4,0,4
10511,plads,0,0,4,4
13978,gidiyor,0,0,4,4
7048,atto,1,4,0,4
1771,considerano,1,4,0,4
7089,mettendo,1,4,0,4
1763,camelcase,2,1,3,4
34487,உணவு,0,0,4,4
34583,получаете,0,0,4,4
12194,gender,0,0,4,4
14000,повторить,0,0,4,4
12192,sådan,0,0,4,4
10532,univers,0,0,4,4
23294,செய்த,0,0,4,4
30354,discovering,0,0,4,4
485,esattamente,1,4,0,4
15995,delen,0,0,4,4
45046,പദ്ധതികൾ,0,0,4,4
7146,seguire,1,4,0,4
34591,solgte,0,0,4,4
7149,fisico,1,4,0,4
30344,biliyorsun,0,0,4,4
14006,partido,0,0,4,4
1751,continuo,1,4,0,4
487,dispiacerebbe,1,4,0,4
1750,calcolo,1,4,0,4
43777,википедии —,0,0,4,4
7130,crea,2,3,1,4
16017,उनसे,0,0,4,4
34582,получила,0,0,4,4
40661,மில்லியன்,0,0,4,4
30422,nemen,0,0,4,4
51600,oktober,0,0,4,4
50327,फ्लोरिडा,0,0,4,4
17832,heard,0,0,4,4
23262,беспокойтесь,0,0,4,4
34553,interprétation,0,0,4,4
34555,looking,0,0,4,4
34558,winkel,0,0,4,4
4761,preoccuparti.,1,4,0,4
23266,inget,0,0,4,4
3733,buone,1,4,0,4
36745,വാൻഡലിസം,0,0,4,4
2232,mentalmente,2,2,2,4
34576,धाराप्रवाह,0,0,4,4
34578,haut,0,0,4,4
51597,പോകണം,0,0,4,4
39146,योगदानकर्ताओं,0,0,4,4
16050,уже,0,0,4,4
43706,employed,0,0,4,4
17706,некоторых,0,0,4,4
3715,pensavo,1,4,0,4
30635,परिणाम,0,0,4,4
17717,besoin,0,0,4,4
23099,списке,0,0,4,4
6915,classifica,1,4,0,4
30626,typ,0,0,4,4
30624,horas,0,0,4,4
6920,plantae,2,2,2,4
12320,poor,0,0,4,4
25685,hablar,0,0,4,4
25684,liebe,0,0,4,4
23106,visiteurs,0,0,4,4
4810,publishing,2,1,3,4
17731,അത്ഭുതകരമായ,0,0,4,4
30611,gente,0,0,4,4
10491,கடந்து,0,0,4,4
23113,عزيزي,0,0,4,4
30642,générale,0,0,4,4
36795,ಕಡಿಮೆ,0,0,4,4
30604,πολλά,0,0,4,4
30646,fyre,0,0,4,4
34385,analyses,0,0,4,4
23045,culturels,0,0,4,4
30692,concern,0,0,4,4
427,credo,1,4,0,4
23048,selflearning,0,0,4,4
23049,ചെറിയ,0,0,4,4
17684,treffen,0,0,4,4
6872,difesa,1,4,0,4
30680,grec,0,0,4,4
9660,दिल,0,0,4,4
25695,propos,0,0,4,4
47805,vardır,0,0,4,4
17695,وظيفة,0,0,4,4
40635,videoyu,0,0,4,4
34415,entschuldigen,0,0,4,4
47808,diversos,0,0,4,4
42653,économie,0,0,4,4
50307,самым,0,0,4,4
34443,téléphone,0,0,4,4
23163,ആഗ്രഹിക്കുന്നുണ്ടോ,0,0,4,4
9631,child,0,0,4,4
34461,förklarar,0,0,4,4
49250,perguntas,0,0,4,4
4794,conversazione.,1,4,0,4
30562,enciclopédica,0,0,4,4
26928,शांत,0,0,4,4
30557,labor,0,0,4,4
2762,logico,1,4,0,4
2761,fica,2,1,3,4
26935,давай,0,0,4,4
19227,läsare,0,0,4,4
34475,copy,0,0,4,4
12284,प्रारंभिक,0,0,4,4
452,semi,1,4,0,4
453,ovviamente,1,4,0,4
4786,buona.,1,4,0,4
46143,falsas,0,0,4,4
17780,الذهب,0,0,4,4
31273,l’anthropologie,0,0,4,4
25665,anterior,0,0,4,4
34445,usadas,0,0,4,4
16065,പൂർണ്ണമായും,0,0,4,4
39184,measured,0,0,4,4
16076,altından,0,0,4,4
23116,faible,0,0,4,4
1789,mirror,2,3,1,4
37579,dons,0,0,4,4
12306,ورائعة,0,0,4,4
30586,वाणिज्यिक,0,0,4,4
19802,भिन्न,0,0,4,4
6951,mesi,1,4,0,4
2765,funghi,1,4,0,4
49261,egal,0,0,4,4
51824,lära,0,0,4,4
46128,இதை,0,0,4,4
17753,occurs,0,0,4,4
23131,sikkert,0,0,4,4
10496,पाठ्य,0,0,4,4
4797,app,2,1,3,4
9590,larger,0,0,4,4
15986,noticias,0,0,4,4
23334,arkadaşlarımla,0,0,4,4
7364,giù,1,4,0,4
34775,publica,0,0,4,4
47888,product,0,0,4,4
23513,espèce,0,0,4,4
19877,possibles,0,0,4,4
49048,உள்ளன,0,0,4,4
46303,الأحيان,0,0,4,4
14067,coined,0,0,4,4
38915,мило,0,0,4,4
46307,ಇಂದು,0,0,4,4
25515,verb,0,0,4,4
14072,primeiro,0,0,4,4
14073,котором,0,0,4,4
12022,المقالة,0,0,4,4
4682,abstract,2,2,2,4
7402,fantastico.,1,4,0,4
7403,voi,1,4,0,4
20692,сказал,0,0,4,4
52492,multimédia,0,0,4,4
38920,vooral,0,0,4,4
17993,ό,0,0,4,4
549,costruzione,1,4,0,4
23467,scientifiques,0,0,4,4
7336,appena,1,4,0,4
37674,νομίζω,0,0,4,4
23476,mujeres,0,0,4,4
7339,ricorda,1,4,0,4
51587,согласно,0,0,4,4
42502,especificamente,0,0,4,4
36685,civil,0,0,4,4
38930,anderer,0,0,4,4
30061,aberto,0,0,4,4
52494,tittade,0,0,4,4
17956,corrigés,0,0,4,4
44627,anders,0,0,4,4
17957,instant,0,0,4,4
12048,afraid,0,0,4,4
23500,खा,0,0,4,4
38924,yapılan,0,0,4,4
34809,—como,0,0,4,4
38904,ಅಲ್ಲಿ,0,0,4,4
47851,significantly,0,0,4,4
49004,avis,0,0,4,4
23592,எதையாவது,0,0,4,4
2705,popolari,1,4,0,4
29902,dessas,0,0,4,4
14095,mår,0,0,4,4
46337,populares,0,0,4,4
575,sistemici,1,4,0,4
34874,medios,0,0,4,4
42439,различные,0,0,4,4
7474,specificamente,1,4,0,4
20665,daglige,0,0,4,4
23610,लग,0,0,4,4
29886,sidorna,0,0,4,4
576,vinto,1,4,0,4
48997,fins,0,0,4,4
46342,πήρα,0,0,4,4
40744,croyance,0,0,4,4
15090,زر,0,0,4,4
7461,raccogliere,1,4,0,4
47906,perto,0,0,4,4
29978,cdrom,0,0,4,4
20676,neutralitet,0,0,4,4
4681,migliora,1,4,0,4
29974,نعم,0,0,4,4
38893,realize,0,0,4,4
3059,disaccordo,1,4,0,4
20683,कहना,0,0,4,4
4004,cambiato,1,4,0,4
34831,lyser,0,0,4,4
25506,continued,0,0,4,4
9513,políticos,0,0,4,4
14084,predictive,0,0,4,4
47899,проект,0,0,4,4
42463,போகிறீர்கள்,0,0,4,4
23567,laatste,0,0,4,4
38870,verpest,0,0,4,4
25501,بي,0,0,4,4
15087,इंजन,0,0,4,4
37702,τίποτα,0,0,4,4
40707,سياسات,0,0,4,4
49071,emotions,0,0,4,4
42509,activités,0,0,4,4
7218,dirlo.,1,4,0,4
7221,jay,2,1,3,4
30221,പരിഹാരത്തിലാണ്,0,0,4,4
513,l'economista,1,4,0,4
30217,follow,0,0,4,4
49124,fail,0,0,4,4
39004,сообщество,0,0,4,4
27003,correspond,0,0,4,4
17906,diciembre,0,0,4,4
19848,aquela,0,0,4,4
30201,sprechen,0,0,4,4
30192,stomverbaasd,0,0,4,4
37648,источника,0,0,4,4
4720,semplice,1,4,0,4
521,diamo,1,4,0,4
10554,herzen,0,0,4,4
7246,vandalismi,1,4,0,4
524,polinomiale.,1,4,0,4
49127,inklusive,0,0,4,4
9569,schwierigen,0,0,4,4
23456,himlen,0,0,4,4
34670,новые,0,0,4,4
34615,nerede,0,0,4,4
25584,arts,0,0,4,4
19215,clara,0,0,4,4
20757,vloeiend,0,0,4,4
26975,connu,0,0,4,4
49142,चुके,0,0,4,4
12155,imagine,0,0,4,4
9579,gute,0,0,4,4
42543,языке,0,0,4,4
10544,senden,0,0,4,4
4014,ascolta,1,4,0,4
25581,menor,0,0,4,4
25578,senin,0,0,4,4
507,entro,1,4,0,4
20752,пользователей,0,0,4,4
23378,tribunal,0,0,4,4
40689,ambos,0,0,4,4
7250,nostro,1,4,0,4
4010,bassa,1,4,0,4
2513,passato,1,4,0,4
23401,குறிப்பிட்ட,0,0,4,4
30128,unten,0,0,4,4
531,dump,2,2,2,4
533,abbastanza.,1,4,0,4
7298,jordan,2,3,1,4
34729,വേണം,0,0,4,4
42515,numerous,0,0,4,4
2515,derivati,1,4,0,4
45021,helpen,0,0,4,4
46261,steeds,0,0,4,4
47880,reinvestment,0,0,4,4
4704,precisa,2,1,3,4
30111,الإنجليزية،,0,0,4,4
20731,значения,0,0,4,4
23440,bis,0,0,4,4
25544,mee,0,0,4,4
47883,genau,0,0,4,4
38954,मुलाकात,0,0,4,4
7292,l'ottimizzazione,1,4,0,4
46256,ranked,0,0,4,4
7290,corretta,1,4,0,4
7272,popolarità,1,4,0,4
2245,tenuto,1,4,0,4
7263,cuore,1,4,0,4
30164,functions,0,0,4,4
34708,होते,0,0,4,4
30160,trata,0,0,4,4
4716,piattaforma,1,4,0,4
23411,mesure,0,0,4,4
25559,enig,0,0,4,4
15945,pardon,0,0,4,4
1727,continuato,1,4,0,4
7275,creata,1,4,0,4
9554,بذلك,0,0,4,4
46252,llegó,0,0,4,4
30141,имеют,0,0,4,4
7284,percettroni,1,4,0,4
7285,componente,1,4,0,4
1320,dartmouth,2,1,3,4
36282,diyebilirsiniz,0,0,4,4
16236,nonlinear,0,0,4,4
17501,друзья,0,0,4,4
51786,आमतौर,0,0,4,4
47313,वाक्यांशों,0,0,4,4
12445,özellikle,0,0,4,4
13870,références,0,0,4,4
17486,ting,0,0,4,4
50615,прежде,0,0,4,4
386,indipendentemente,1,4,0,4
36835,hoy,0,0,4,4
39349,раньше,0,0,4,4
25737,ടെക്സ്റ്റ്,0,0,4,4
4030,chiede,1,4,0,4
6540,suggeriscono,1,4,0,4
47316,ಸಾಧ್ಯವಾಗಲಿಲ್ಲ,0,0,4,4
25743,तीव्र,0,0,4,4
41325,όμορφος,0,0,4,4
13860,говоря,0,0,4,4
3443,dollari,1,4,0,4
31101,تحتوي,0,0,4,4
39302,தொந்தரவு,0,0,4,4
41623,inmiddels,0,0,4,4
43677,hetzelfde,0,0,4,4
6728,peso,2,3,1,4
26717,şu,0,0,4,4
12457,lektioner,0,0,4,4
4864,roc,2,2,2,4
19268,dios,0,0,4,4
34277,happen,0,0,4,4
25795,farklı,0,0,4,4
31188,nós,0,0,4,4
10405,deseja,0,0,4,4
34297,término,0,0,4,4
6766,permanente,2,1,3,4
49365,σαββατοκύριακο,0,0,4,4
9770,chorando,0,0,4,4
10437,sabor,0,0,4,4
16147,يحدث,0,0,4,4
30837,magnifique,0,0,4,4
31091,വാക്യം,0,0,4,4
37491,ссылок,0,0,4,4
6760,φύσις,2,2,2,4
34071,bakış,0,0,4,4
19750,désigner,0,0,4,4
9767,drei,0,0,4,4
31183,ranking,0,0,4,4
39390,ait,0,0,4,4
51505,worries,0,0,4,4
39391,présenter,0,0,4,4
19291,слишком,0,0,4,4
397,insulto,2,2,2,4
20906,catégories,0,0,4,4
392,chiave,1,4,0,4
17554,μπορούσα,0,0,4,4
45944,esfuerzo,0,0,4,4
42784,colaborativa,0,0,4,4
19305,apparition,0,0,4,4
3441,filtraggio,1,4,0,4
22912,heures,0,0,4,4
25756,développer,0,0,4,4
30958,nederlands,0,0,4,4
1308,spero,1,4,0,4
1846,richieste,1,4,0,4
31001,estadounidenses,0,0,4,4
42734,move,0,0,4,4
6571,Wall,1,4,0,4
9718,bureau,0,0,4,4
49420,temel,0,0,4,4
17518,உண்மையில்,0,0,4,4
22845,ಮೊದಲು,0,0,4,4
10419,diaria,0,0,4,4
13852,durum,0,0,4,4
34187,previous,0,0,4,4
39342,fundador,0,0,4,4
43665,சரளமாக,0,0,4,4
19261,anyway,0,0,4,4
12489,aldrig,0,0,4,4
17579,chicos,0,0,4,4
46003,ind,0,0,4,4
12492,português,0,0,4,4
45144,dica,0,0,4,4
22863,первой,0,0,4,4
39402,وتيري,0,0,4,4
52578,yarın,0,0,4,4
44397,flest,0,0,4,4
4026,bambini,1,4,0,4
51793,بأي,0,0,4,4
46026,letzte,0,0,4,4
4154,considerate,1,4,0,4
4846,ciclo,2,2,2,4
26831,clasificación,0,0,4,4
42725,devoirs,0,0,4,4
41625,महत्वपूर्ण,0,0,4,4
47741,ceux,0,0,4,4
40559,नार्सीसा,0,0,4,4
25745,stompe,0,0,4,4
12464,estaré,0,0,4,4
4161,condotta,1,4,0,4
31142,انخفاض,0,0,4,4
2205,prenditi,1,4,0,4
17589,கிட்டத்தட்ட,0,0,4,4
1840,possiamo,1,4,0,4
31131,  articles,0,0,4,4
12472,مركز,0,0,4,4
6567,presupposto,1,4,0,4
6568,problematica,1,4,0,4
41338,skönhet,0,0,4,4
22890,soort,0,0,4,4
30944,period,0,0,4,4
2789,terza,1,4,0,4
44407,fact,0,0,4,4
4853,quotidiano,1,4,0,4
16146,مستخدمي,0,0,4,4
6581,principio,2,3,1,4
34060,αυτήν,0,0,4,4
9775,проблема,0,0,4,4
15024,worldwide,0,0,4,4
17661,той,0,0,4,4
13829,haft,0,0,4,4
26785,ديسمبر,0,0,4,4
26868,фонда,0,0,4,4
51811,ಪ್ರಾರಂಭಿಸಿದಳು,0,0,4,4
6846,paritaria,1,4,0,4
25810,fiabilidad,0,0,4,4
13931,واحدة,0,0,4,4
6811,identifica,2,3,1,4
408,dimostrato,1,4,0,4
30729,estimation,0,0,4,4
39380,कानून,0,0,4,4
4824,definito,1,4,0,4
45985,رؤية,0,0,4,4
46068,طويل,0,0,4,4
39439,مستخدم,0,0,4,4
49348,olacağım,0,0,4,4
9674,acontecendo,0,0,4,4
20889,creado,0,0,4,4
12403,बनाने,0,0,4,4
17649,latter,0,0,4,4
17474,всем,0,0,4,4
23008,actual,0,0,4,4
30721,fit,0,0,4,4
47752,വഴി,0,0,4,4
36811,വന്നു,0,0,4,4
6617,journalism,2,1,3,4
47756,версии,0,0,4,4
6498,floricic,2,1,3,4
34150,проблем,0,0,4,4
43648,ಹೌದು,0,0,4,4
50297,совершенно,0,0,4,4
22687,jaar,0,0,4,4
13929,legais,0,0,4,4
31047,चीज,0,0,4,4
49336,أعرف,0,0,4,4
23019,dagliga,0,0,4,4
39242,beyond,0,0,4,4
6627,incredibile,1,4,0,4
39243,வேல்ஸ்,0,0,4,4
22785,closely,0,0,4,4
6494,hacker,2,1,3,4
30726,विचार,0,0,4,4
34366,уловка,0,0,4,4
39371,प्रविष्टि,0,0,4,4
45155,dónde,0,0,4,4
1119,ringraziare,1,4,0,4
4823,gas,2,3,1,4
49493,كبير,0,0,4,4
50857,former,0,0,4,4
45139,reality,0,0,4,4
49358,recommendation,0,0,4,4
6516,altamente,1,4,0,4
3449,dipendenti,1,4,0,4
6852,regionali,1,4,0,4
22822,multicellular,0,0,4,4
20895,välja,0,0,4,4
31080,streek,0,0,4,4
422,licenze,1,4,0,4
30816,पॉलिश,0,0,4,4
34167,snällt,0,0,4,4
4903,qualcosa.,1,4,0,4
22968,entendí,0,0,4,4
52084,одно,0,0,4,4
9683,impossible,0,0,4,4
43653,kwaliteit,0,0,4,4
12520,vaut,0,0,4,4
16208,dollar,0,0,4,4
45916,reasons,0,0,4,4
17534,фразы,0,0,4,4
34010,lisans,0,0,4,4
6514,pubblicità,1,4,0,4
47734,φοβάμαι,0,0,4,4
17633,quatro,0,0,4,4
34055,ರಾಕ್,0,0,4,4
31036,início,0,0,4,4
6794,unica,1,4,0,4
16248,función,0,0,4,4
6508,mostra,1,4,0,4
36918,इसमें,0,0,4,4
6510,soft,1,4,0,4
31252,tool,0,0,4,4
15022,publicerar,0,0,4,4
26787,उचित,0,0,4,4
1112,ecc.,1,4,0,4
45937,രണ്ട്,0,0,4,4
40610,വീട്ടിലേക്ക്,0,0,4,4
43690,حد,0,0,4,4
42701,предложений,0,0,4,4
49325,स्वतंत्र,0,0,4,4
3678,modificando,2,3,1,4
39265,bush,0,0,4,4
51765,कितना,0,0,4,4
12525,classique,0,0,4,4
47730,passer,0,0,4,4
52030,konu,0,0,3,3
10730,klingen,0,0,3,3
10632,അർത്ഥമാക്കുന്നത്,0,0,3,3
14666,dulce,0,0,3,3
37735,chino,0,0,3,3
37653,pesquisadores,0,0,3,3
47379,color,0,0,3,3
44702,beings,0,0,3,3
47148,равно,0,0,3,3
14643,verbaasd,0,0,3,3
25553,security,0,0,3,3
19855,кто,0,0,3,3
44622,alternative,0,0,3,3
10873,oorspronkelijke,0,0,3,3
1289,migliorano,1,3,0,3
50682,asturias,0,0,3,3
19594,älskar,0,0,3,3
14746,mouvement,0,0,3,3
47238,marais,0,0,3,3
1388,rank,2,1,2,3
37298,канал,0,0,3,3
19729,περιεχομένου,0,0,3,3
19726,nou,0,0,3,3
26122,പദമാണ്,0,0,3,3
10566,notability,0,0,3,3
19763,sweet,0,0,3,3
19587,نظام,0,0,3,3
50684,advertisements,0,0,3,3
10571,இறுதியில்,0,0,3,3
41352,buscar,0,0,3,3
37810,தவறுகள்,0,0,3,3
44527,face,0,0,3,3
10729,கேட்கவில்லை,0,0,3,3
25969,graphic,0,0,3,3
10179,never,0,0,3,3
37844,भ्रमित,0,0,3,3
47219,تعديلات,0,0,3,3
47500,supplémentaire,0,0,3,3
25809,entrées,0,0,3,3
25502,άντρας,0,0,3,3
44672,решений,0,0,3,3
10163,فهي,0,0,3,3
19552,கேட்கும்போது,0,0,3,3
41137,participation,0,0,3,3
26164,reprenant,0,0,3,3
52026,klingt,0,0,3,3
37697,élèves,0,0,3,3
10617,ഉള്ളടക്കം,0,0,3,3
25119,वृत्तचित्र,0,0,3,3
47220,làbas,0,0,3,3
47360,seres,0,0,3,3
41468,posible,0,0,3,3
47035,getan,0,0,3,3
37691,أكن,0,0,3,3
47125,perplexo,0,0,3,3
47358,fréquemment,0,0,3,3
47501,ആരോടെങ്കിലും,0,0,3,3
47361,αρκετά,0,0,3,3
25811,جدية,0,0,3,3
25487,издания,0,0,3,3
25486,சற்று,0,0,3,3
25296,karar,0,0,3,3
19746,செய்யும்,0,0,3,3
25825,فوق,0,0,3,3
25485,വെബ്,0,0,3,3
37489,eliminación,0,0,3,3
14595,अभ्यास,0,0,3,3
41191,appear,0,0,3,3
25474,komen,0,0,3,3
41479,chaos,0,0,3,3
25479,cumplen,0,0,3,3
10895,mallar,0,0,3,3
26174,dingen,0,0,3,3
25283,dada,0,0,3,3
10894,pequeña,0,0,3,3
2460,sesso,1,3,0,3
1351,ispirati,1,3,0,3
51474,लिया,0,0,3,3
3273,fenomeno,1,3,0,3
19861,privacidade,0,0,3,3
19952,बन,0,0,3,3
10767,ಅದೇ,0,0,3,3
44588,feet,0,0,3,3
19758,секретный,0,0,3,3
10628,saisi,0,0,3,3
10580,piada,0,0,3,3
1412,incontrarmi,1,3,0,3
25857,liefste,0,0,3,3
25533,indépendamment,0,0,3,3
14541,relativement,0,0,3,3
25125,வந்தது,0,0,3,3
10629,नरसीसा,0,0,3,3
10189,swedish,0,0,3,3
37280,paniqué,0,0,3,3
37282,हमारे,0,0,3,3
10879,retrieval,0,0,3,3
10195,ചെയ്യും,0,0,3,3
51475,м,0,0,3,3
2453,statistico.,1,3,0,3
37462,inútil,0,0,3,3
25848,knew,0,0,3,3
4033,addetti,1,3,0,3
19753,liberdade,0,0,3,3
14738,गति,0,0,3,3
50658,jan,0,0,3,3
10590,décontenancé,0,0,3,3
41138,विकसित,0,0,3,3
4079,oppure,1,3,0,3
41466,الأول,0,0,3,3
41245,birine,0,0,3,3
4036,l'una,1,3,0,3
10587,fonctions,0,0,3,3
37270,باسم,0,0,3,3
3321,josé,2,1,2,3
25265,druk,0,0,3,3
25264,கடினமாக,0,0,3,3
47203,принимайте,0,0,3,3
37266,gizli,0,0,3,3
3949,caballero,2,1,2,3
1239,scrittori,1,3,0,3
41249,σίγουρος,0,0,3,3
47244,contents,0,0,3,3
44568,investigadores,0,0,3,3
25568,തമ്മിൽ,0,0,3,3
14698,sets,0,0,3,3
2404,complesso,1,3,0,3
37590,dinge,0,0,3,3
25238,தெரியவில்லை,0,0,3,3
1377,importanza,1,3,0,3
19919,bisschen,0,0,3,3
10276,granskning,0,0,3,3
26008,oui,0,0,3,3
10829,durumda,0,0,3,3
4053,foresta,1,3,0,3
44598,മാത്രം,0,0,3,3
10282,hårdare,0,0,3,3
1379,fiume.,1,3,0,3
41218,ideas,0,0,3,3
51488,emner,0,0,3,3
47302,extremely,0,0,3,3
26000,നിലവിൽ,0,0,3,3
41205,المثيرة,0,0,3,3
10287,διόρθωση,0,0,3,3
10497,whatever,0,0,3,3
41387,twitter,0,0,3,3
47175,सवार,0,0,3,3
10321,understanding,0,0,3,3
10501,unas,0,0,3,3
10502,masse,0,0,3,3
50716,vond,0,0,3,3
47308,söyleyebileceğin,0,0,3,3
25395,говоришь,0,0,3,3
51509,بحاجة,0,0,3,3
37540,suene,0,0,3,3
41396,überhaupt,0,0,3,3
26021,قام,0,0,3,3
1256,vietnamita,2,1,2,3
25650,inaccuracies,0,0,3,3
52079,ποια,0,0,3,3
37543,redigeringskrig,0,0,3,3
10268,frecuentemente,0,0,3,3
19808,интернете,0,0,3,3
47438,மெல்லி,0,0,3,3
37545,ലേഖനങ്ങളെഴുതുക,0,0,3,3
41301,propuesta,0,0,3,3
10669,principles,0,0,3,3
25659,λένε,0,0,3,3
19658,fundadores,0,0,3,3
50706,प्रकल्प,0,0,3,3
1280,osservare,1,3,0,3
25935,केन्द्रित,0,0,3,3
41374,plaindre,0,0,3,3
47423,verbluffend,0,0,3,3
25666,وقد,0,0,3,3
1261,efficacemente,1,3,0,3
25689,usados,0,0,3,3
37376,buy,0,0,3,3
25234,निर्मित,0,0,3,3
19925,gece,0,0,3,3
25706,nå,0,0,3,3
19797,engineering,0,0,3,3
52054,माइकल,0,0,3,3
37560,hende,0,0,3,3
47291,contribuer,0,0,3,3
37567,ήρθατε,0,0,3,3
10690,tidskriften,0,0,3,3
1272,universalmente,2,2,1,3
25694,ojos,0,0,3,3
14569,faktisk,0,0,3,3
14703,surtei,0,0,3,3
10695,automatically,0,0,3,3
10809,எடுத்துக்,0,0,3,3
19995,عامة,0,0,3,3
47166,извиниться,0,0,3,3
14705,सोचना,0,0,3,3
41164,சிறிது,0,0,3,3
25367,للجدل,0,0,3,3
50687,உரையாடலில்,0,0,3,3
41217,contribution,0,0,3,3
25714,ಹೆಚ್ಚುವರಿ,0,0,3,3
37882,basin,0,0,3,3
10681,deuxième,0,0,3,3
25237,direkt,0,0,3,3
20012,kategorier,0,0,3,3
1369,'più,1,3,0,3
37885,три,0,0,3,3
25713,американцы,0,0,3,3
14700,vingers,0,0,3,3
1277,Alexa,1,3,0,3
25960,ஒன்றாக,0,0,3,3
1266,x,2,1,2,3
47097,صحيفة,0,0,3,3
25711,evaluation,0,0,3,3
44689,चीजें,0,0,3,3
47417,பிரமாதமானது,0,0,3,3
25683,production,0,0,3,3
25356,வாக்கியங்கள்,0,0,3,3
10696,പോകുന്നു,0,0,3,3
37572,ελεύθερη,0,0,3,3
47171,décrire,0,0,3,3
25986,தோழர்களே,0,0,3,3
19789,ನಿಧಾನವಾಗಿ,0,0,3,3
25742,ನಾಳೆ,0,0,3,3
25179,இருந்தபோது,0,0,3,3
19604,vanavond,0,0,3,3
37745,observed,0,0,3,3
26091,கொண்டுள்ளது,0,0,3,3
19990,tienen,0,0,3,3
41274,φρικτή,0,0,3,3
3286,light,2,1,2,3
26090,другое,0,0,3,3
41275,объектами,0,0,3,3
10223,केचे,0,0,3,3
47253,utilizadas,0,0,3,3
10540,klinken,0,0,3,3
25588,निर्माता,0,0,3,3
52059,jongens,0,0,3,3
10264,perdón,0,0,3,3
14548,traditionele,0,0,3,3
41313,textes,0,0,3,3
10783,october,0,0,3,3
47152,നിന്നാണ്,0,0,3,3
47326,dra,0,0,3,3
14680,βρίσκεται,0,0,3,3
19833,خبرة,0,0,3,3
47057,subscribe,0,0,3,3
10858,الأم,0,0,3,3
50719,laisse,0,0,3,3
1284,cronologia,1,3,0,3
47108,والتي,0,0,3,3
19944,venus,0,0,3,3
2407,ai.,1,3,0,3
10721,erro,0,0,3,3
3325,riduzione,1,3,0,3
41430,allezy,0,0,3,3
2397,casuale.,1,3,0,3
10425,razões,0,0,3,3
1245,casuale,1,3,0,3
44639,gramática,0,0,3,3
37742,व्यापक,0,0,3,3
44677,opposite,0,0,3,3
44662,وكان,0,0,3,3
41359,sexuellt,0,0,3,3
37443,gråter,0,0,3,3
41231,chefredaktör,0,0,3,3
19770,forget,0,0,3,3
47054,लेने,0,0,3,3
37439,ängeln,0,0,3,3
41429,ആർക്കും,0,0,3,3
47249,infantil,0,0,3,3
47055,bununla,0,0,3,3
3335,mesi.,1,3,0,3
14804,அல்ல,0,0,3,3
10434,l’aa,0,0,3,3
26067,besökare,0,0,3,3
51479,الحظ,0,0,3,3
44643,समूह,0,0,3,3
37617,दिया।,0,0,3,3
25923,bunların,0,0,3,3
26027,άσε,0,0,3,3
41284,встретиться,0,0,3,3
25404,klage,0,0,3,3
14787,حالة,0,0,3,3
25166,começar,0,0,3,3
37855,эй,0,0,3,3
25341,longterm,0,0,3,3
44644,sine,0,0,3,3
37609,ecology,0,0,3,3
25628,angel,0,0,3,3
47444,नीतियों,0,0,3,3
37413,ജിമ്മി,0,0,3,3
37896,थीं।,0,0,3,3
19910,waarop,0,0,3,3
19814,आई,0,0,3,3
47443,пальцы,0,0,3,3
37595,الويكي،,0,0,3,3
19940,концу,0,0,3,3
3276,articolo.,1,3,0,3
25165,pornographic,0,0,3,3
14713,vän,0,0,3,3
37531,aman,0,0,3,3
10337,saker,0,0,3,3
47457,offers,0,0,3,3
37422,asturian,0,0,3,3
41322,zacht,0,0,3,3
51481,characteristics,0,0,3,3
3998,Marte,1,3,0,3
10440,предложения,0,0,3,3
25911,mayo,0,0,3,3
10344,rockst,0,0,3,3
26053,beschweren,0,0,3,3
41361,ವಿಭಿನ್ನ,0,0,3,3
26048,हिस्से,0,0,3,3
26045,provient,0,0,3,3
51483,शीर्ष,0,0,3,3
41230,geef,0,0,3,3
41282,sista,0,0,3,3
44566,wist,0,0,3,3
25749,encuentro,0,0,3,3
25921,afspraak,0,0,3,3
10789,давайте,0,0,3,3
19710,όσα,0,0,3,3
47319,ваше,0,0,3,3
37478,sagt,0,0,3,3
9357,posteriormente,0,0,3,3
14535,планы,0,0,3,3
39494,opinião,0,0,3,3
39448,welcome,0,0,3,3
45925,lijst,0,0,3,3
39449,encontrar,0,0,3,3
39450,வீட்டில்,0,0,3,3
1898,ritmo,2,2,1,3
3666,Galles,1,3,0,3
39458,verden,0,0,3,3
2185,sembra,1,3,0,3
21002,moeras,0,0,3,3
12655,substantiv,0,0,3,3
12656,pollution,0,0,3,3
21003,hört,0,0,3,3
12663,dernières,0,0,3,3
22632,débat,0,0,3,3
2181,laggiù,1,3,0,3
13833,शिकायत,0,0,3,3
2180,descrivere,1,3,0,3
1907,perfetto,1,3,0,3
22608,возьми,0,0,3,3
50867,renderização,0,0,3,3
22606,propias,0,0,3,3
39510,följande,0,0,3,3
21017,abierta,0,0,3,3
40528,திருகினேன்,0,0,3,3
12693,consecuencia,0,0,3,3
39520,अनुभव,0,0,3,3
12697,auktoritativa,0,0,3,3
39521,samstag,0,0,3,3
21032,onze,0,0,3,3
39528,ಮಾತ್ರ,0,0,3,3
12625,entendeu,0,0,3,3
22696,won,0,0,3,3
45874,pairs,0,0,3,3
3447,selvaggia,1,3,0,3
39394,சொந்த,0,0,3,3
51772,complexes,0,0,3,3
45142,seis,0,0,3,3
39396,appuie,0,0,3,3
45963,प्रयुक्त,0,0,3,3
22759,soon,0,0,3,3
22751,móvel,0,0,3,3
39405,खराब,0,0,3,3
3673,trovi,1,3,0,3
12578,மட்டும்,0,0,3,3
12579,enmwikipediaorg,0,0,3,3
22747,databases,0,0,3,3
1886,tremendamente,2,2,1,3
12586,criteria,0,0,3,3
40557,miriam,0,0,3,3
39438,அதிக,0,0,3,3
39414,juntos,0,0,3,3
12594,सुंदरता,0,0,3,3
22731,cuidar,0,0,3,3
39416,ಬಯಸುತ್ತೀರಿ,0,0,3,3
39417,июле,0,0,3,3
45150,latitude,0,0,3,3
20978,കുറഞ്ഞ,0,0,3,3
50863,ಇರುವ,0,0,3,3
39424,ವನ್ನು,0,0,3,3
13840,tillgång,0,0,3,3
39426,density,0,0,3,3
39429,список,0,0,3,3
50864,lille,0,0,3,3
45936,விக்கிப்பீடியாவில்,0,0,3,3
1915,scorre,1,3,0,3
21034,यात्रा,0,0,3,3
46165,ίδρυμα,0,0,3,3
39653,نارسيس,0,0,3,3
22448,herramienta,0,0,3,3
39618,изображения,0,0,3,3
22441,вялый,0,0,3,3
12801,കാണും,0,0,3,3
22425,currently,0,0,3,3
21086,puisje,0,0,3,3
50963,condición,0,0,3,3
21089,intervention,0,0,3,3
12818,κοίταξε,0,0,3,3
21091,essayez,0,0,3,3
45804,पंजीकृत,0,0,3,3
45803,gorillas,0,0,3,3
39649,«вики»,0,0,3,3
22392,εκπληκτική,0,0,3,3
45205,semble,0,0,3,3
39610,geometri,0,0,3,3
40479,härter,0,0,3,3
13747,ஏய்,0,0,3,3
40477,yakışıklı,0,0,3,3
12842,फोन,0,0,3,3
39671,கேட்கிறது,0,0,3,3
13744,skett,0,0,3,3
22354,название,0,0,3,3
22353,exemples,0,0,3,3
3639,costo,1,3,0,3
12853,classement,0,0,3,3
12855,ದೇವರೇ,0,0,3,3
22344,हमें,0,0,3,3
22340,remis,0,0,3,3
22337,annesi,0,0,3,3
45822,легко,0,0,3,3
22461,mensen,0,0,3,3
22571,protected,0,0,3,3
22521,πάρα,0,0,3,3
21039,explains,0,0,3,3
39539,écoutais,0,0,3,3
22559,duro,0,0,3,3
12717,mondial,0,0,3,3
21049,branches,0,0,3,3
22547,جديدة,0,0,3,3
12724,spiel,0,0,3,3
22544,نمو,0,0,3,3
12726,stockholm,0,0,3,3
1920,shopping,2,1,2,3
45184,தானியங்கிகள்,0,0,3,3
13788,steadily,0,0,3,3
3652,veicoli,1,3,0,3
45855,identification,0,0,3,3
39562,awesome,0,0,3,3
50874,ante,0,0,3,3
21056,fyra,0,0,3,3
1922,vegetali,1,3,0,3
39571,potencialmente,0,0,3,3
1923,"vita,",1,3,0,3
12750,aucune,0,0,3,3
39586,contrarié,0,0,3,3
45840,lång,0,0,3,3
12764,مصنوع,0,0,3,3
3459,saggio,1,3,0,3
21068,verbetes,0,0,3,3
45836,ner,0,0,3,3
22477,souligne,0,0,3,3
12773,возможно,0,0,3,3
22473,സ്വതന്ത്രവും,0,0,3,3
50858,सुन,0,0,3,3
20960,écologique,0,0,3,3
1874,tratta,1,3,0,3
39214,moves,0,0,3,3
45081,സുഹൃത്തുക്കളുമായി,0,0,3,3
46114,editados,0,0,3,3
2217,mare,1,3,0,3
20845,lärare,0,0,3,3
39196,πειράζει,0,0,3,3
13947,kullandığım,0,0,3,3
23082,скажите,0,0,3,3
12336,ಉದಾಹರಣೆ,0,0,3,3
51820,ιδέα,0,0,3,3
46102,selvfølgelig,0,0,3,3
12340,detección,0,0,3,3
40633,anında,0,0,3,3
1799,Android,1,3,0,3
2215,differenti,1,3,0,3
45092,organisations,0,0,3,3
23103,kullanılmaktadır,0,0,3,3
12352,ficou,0,0,3,3
13937,speaker,0,0,3,3
12356,близко,0,0,3,3
45095,ഒക്കെ,0,0,3,3
40623,நாளை,0,0,3,3
20871,അധിക,0,0,3,3
12370,ganhou,0,0,3,3
46081,speciellt,0,0,3,3
12373,individuele,0,0,3,3
3434,temperate,2,1,2,3
1809,storico,1,3,0,3
46073,confundir,0,0,3,3
20885,licenças,0,0,3,3
50843,überrascht,0,0,3,3
23102,glaciers,0,0,3,3
51823,mantém,0,0,3,3
22776,selvom,0,0,3,3
20827,போகிறேன்,0,0,3,3
39123,raise,0,0,3,3
12250,ohne,0,0,3,3
12252,மரியன்,0,0,3,3
51831,historically,0,0,3,3
40651,ಯೋಜನೆಗಳನ್ನು,0,0,3,3
45066,ಮಾಡುವುದು,0,0,3,3
12267,neurales,0,0,3,3
12268,ಪರೀಕ್ಷೆಯಲ್ಲಿ,0,0,3,3
20820,क्षेत्र,0,0,3,3
12274,låter,0,0,3,3
12275,forhånd,0,0,3,3
3429,"fa,",1,3,0,3
3720,sondaggio,1,3,0,3
45071,cargos,0,0,3,3
46140,superior,0,0,3,3
23112,nam,0,0,3,3
46139,millioner,0,0,3,3
46138,manske,0,0,3,3
23149,cientistas,0,0,3,3
20828,græder,0,0,3,3
20831,понял,0,0,3,3
23142,utilisent,0,0,3,3
1785,pagamento,1,3,0,3
40642,hårdere,0,0,3,3
13960,ஒருவரை,0,0,3,3
12299,aparte,0,0,3,3
12302,ánimo,0,0,3,3
13957,αλλιώς,0,0,3,3
23122,atual,0,0,3,3
39180,sousjacente,0,0,3,3
39251,referendo,0,0,3,3
22996,അവൾക്ക്,0,0,3,3
3703,letture,1,3,0,3
51784,مشاريع,0,0,3,3
13879,subjects,0,0,3,3
22866,convencional,0,0,3,3
46010,lançado,0,0,3,3
1850,co-fondatore,1,3,0,3
12496,intéresse,0,0,3,3
22855,вечером,0,0,3,3
22852,ಹೋಗೋಣ,0,0,3,3
22843,jou,0,0,3,3
20941,значение,0,0,3,3
50853,ದೊಡ್ಡ,0,0,3,3
22840,feitos,0,0,3,3
39348,adicional,0,0,3,3
22837,रख,0,0,3,3
45133,sanki,0,0,3,3
1859,utilizzo,1,3,0,3
20893,saturday,0,0,3,3
39360,conflict,0,0,3,3
39361,climat,0,0,3,3
12527,external,0,0,3,3
20951,dress,0,0,3,3
12529,горит,0,0,3,3
22804,belangrijk,0,0,3,3
45138,internetleverantörer,0,0,3,3
39377,appareil,0,0,3,3
13861,narcisses,0,0,3,3
39378,structural,0,0,3,3
39379,അവരെ,0,0,3,3
3677,identificare,1,3,0,3
13859,biais,0,0,3,3
45973,κουρασμένοι,0,0,3,3
22874,पैदा,0,0,3,3
22880,النظر,0,0,3,3
13881,التخريب،,0,0,3,3
46020,ومن,0,0,3,3
12408,formuleringar,0,0,3,3
51809,صغيرة,0,0,3,3
51806,ക്ഷമിക്കൂ,0,0,3,3
51805,обучающей,0,0,3,3
13907,campaña,0,0,3,3
40609,servere,0,0,3,3
22962,умные,0,0,3,3
46050,majeure,0,0,3,3
20902,recupera,0,0,3,3
39278,sidste,0,0,3,3
12432,английском,0,0,3,3
13897,сделали,0,0,3,3
40606,notions,0,0,3,3
39282,fifth,0,0,3,3
46039, مليون,0,0,3,3
1832,tropicale,2,2,1,3
3689,incontrare,1,3,0,3
22930,liked,0,0,3,3
40601,tráfego,0,0,3,3
22921,nivel,0,0,3,3
12451,beschreiben,0,0,3,3
13888,yes,0,0,3,3
12455,sequences,0,0,3,3
51797,नंबर,0,0,3,3
20920,ينزعج,0,0,3,3
12463,संशोधन,0,0,3,3
22905,gruwelijke,0,0,3,3
22896,രജിസ്റ്റർ,0,0,3,3
39318,δει,0,0,3,3
22328,authors,0,0,3,3
39694,primary,0,0,3,3
45769,américa,0,0,3,3
40093,करो,0,0,3,3
21324,फिल्मों,0,0,3,3
45502,puan,0,0,3,3
40068,bugün,0,0,3,3
21751,μυαλό,0,0,3,3
21747,gens,0,0,3,3
45497,blocage,0,0,3,3
21333,vandaag,0,0,3,3
45493,högst,0,0,3,3
13572,எனினும்,0,0,3,3
21716,sammanhang,0,0,3,3
21714,εξαιρετικά,0,0,3,3
13290,நுபீடியாவிற்கு,0,0,3,3
45484,सामने,0,0,3,3
3560,nonché,1,3,0,3
21708,comportements,0,0,3,3
45507,ситуацию,0,0,3,3
45481,wetenschappelijke,0,0,3,3
45480,reviewed,0,0,3,3
2048,l'ho,1,3,0,3
40099,dez,0,0,3,3
45473,لحظة,0,0,3,3
3555,"terra,",1,3,0,3
13315,tager,0,0,3,3
21689,உதாரணம்,0,0,3,3
13321,говорить,0,0,3,3
21361,special,0,0,3,3
13333,förekommer,0,0,3,3
40127,drawn,0,0,3,3
21654,gostaria,0,0,3,3
51650,incluye,0,0,3,3
40056,кнопку,0,0,3,3
21775,kein,0,0,3,3
21854,minuter,0,0,3,3
13220,establecidas,0,0,3,3
13613,koets,0,0,3,3
13193,readership,0,0,3,3
21276,уловил,0,0,3,3
40003,പേര്,0,0,3,3
45542,símbolos,0,0,3,3
13198,മനോഹരമായ,0,0,3,3
40365,counterproductive,0,0,3,3
21287,दोपहर,0,0,3,3
40012,komma,0,0,3,3
2125,herring,2,2,1,3
40014,negotiation,0,0,3,3
13600,ಬದಲು,0,0,3,3
51699,سيجنثالر,0,0,3,3
21817,दौरान,0,0,3,3
40353,seinen,0,0,3,3
13587,gaf,0,0,3,3
40029,erstaunliche,0,0,3,3
21810,baixos,0,0,3,3
13225,أليس,0,0,3,3
45296,seção,0,0,3,3
13231,ஒலிக்க,0,0,3,3
2031,sistema.,1,3,0,3
21309,gardner,0,0,3,3
21794,amounts,0,0,3,3
45300,ρωτήσετε,0,0,3,3
21311,område,0,0,3,3
40343,ലേഖകർ,0,0,3,3
45512,وبالتالي,0,0,3,3
13247,valt,0,0,3,3
40049,वहाँ,0,0,3,3
45323,изменений,0,0,3,3
21650,удивительно,0,0,3,3
40305,operations,0,0,3,3
21509,सफलता,0,0,3,3
13417,cultural,0,0,3,3
21550,ниже,0,0,3,3
45343,φάω,0,0,3,3
13423,perspektiv,0,0,3,3
2076,casi.,1,3,0,3
21532,inden,0,0,3,3
13431,கற்றுக்,0,0,3,3
40274,тоже,0,0,3,3
45398,sådana,0,0,3,3
21524,fejl,0,0,3,3
3520,immediatamente,1,3,0,3
21427,örnekleri,0,0,3,3
50932,prêt,0,0,3,3
13513,ഔട്പുട്ട്,0,0,3,3
13456,ನೀಡಲಿದ್ದೇನೆ,0,0,3,3
13551,prevent,0,0,3,3
21434,scherp,0,0,3,3
21496,modeling,0,0,3,3
3512,fronte,1,3,0,3
13464,administratörerna,0,0,3,3
13467,данные,0,0,3,3
21493,يونيو,0,0,3,3
51667,ഇതിനകം,0,0,3,3
21478,polémica,0,0,3,3
3510,cowen,2,1,2,3
21473,harassment,0,0,3,3
45358,சொன்னது,0,0,3,3
21445,بنفسك,0,0,3,3
40253,reach,0,0,3,3
3506,uso.,1,3,0,3
21408,minnesota,0,0,3,3
50942,experiência,0,0,3,3
21565,هؤلاء,0,0,3,3
21571,hyperliens,0,0,3,3
51677,takke,0,0,3,3
21373,hablando,0,0,3,3
40133,afirma,0,0,3,3
13348,हाँ,0,0,3,3
21634,blague,0,0,3,3
50920,ಮಾರ್ಗವೆಂದರೆ,0,0,3,3
45446,प्रेरित,0,0,3,3
45444,zaterdag,0,0,3,3
21627,பெரும்பாலும்,0,0,3,3
40298,estarei,0,0,3,3
40148,النرجسية,0,0,3,3
40154,βλέπω,0,0,3,3
13367,உறுதியாக,0,0,3,3
2113,muoversi,1,3,0,3
2112,obiettivi,1,3,0,3
50921,houdt,0,0,3,3
13374,sætningen,0,0,3,3
3544,identificano,1,3,0,3
3542,tono,2,2,1,3
45430,racine,0,0,3,3
40293,vegetation,0,0,3,3
45336,trees,0,0,3,3
21584,economía,0,0,3,3
45426,automatiskt,0,0,3,3
45425,voice,0,0,3,3
2072,dell'ipotesi,1,3,0,3
21577,свидание,0,0,3,3
21573,nor,0,0,3,3
13533,ನೆನಪಿಡಿ,0,0,3,3
40371,publication,0,0,3,3
21856,aktualitet,0,0,3,3
12880,حسب,0,0,3,3
45674,améliorer,0,0,3,3
22145,referências,0,0,3,3
40443,résoudre,0,0,3,3
39811,ஆகிய,0,0,3,3
3616,economista,2,1,2,3
39817,serem,0,0,3,3
51631,encompasses,0,0,3,3
3612,[nota],1,3,0,3
39819,निश्चित,0,0,3,3
39820,lå,0,0,3,3
22128,justo,0,0,3,3
13004,അമേരിക്കക്കാർ,0,0,3,3
45680,vanligaste,0,0,3,3
3609,potenziale,1,3,0,3
22119,libraries,0,0,3,3
13012,ons,0,0,3,3
2157,brutto,1,3,0,3
1985,autoctona,1,3,0,3
39836,chanserna,0,0,3,3
39837,выходные,0,0,3,3
39841,دخلت,0,0,3,3
45667,nommée,0,0,3,3
45666,dichotomie,0,0,3,3
22095,wikipédiens,0,0,3,3
13028,الرجل,0,0,3,3
13030,tijdschriften,0,0,3,3
13031,brug,0,0,3,3
39845,construção,0,0,3,3
13037,collective,0,0,3,3
45249,mark,0,0,3,3
22085,முடிவில்,0,0,3,3
45234,copiar,0,0,3,3
12972,uppfyllelse,0,0,3,3
21860,conta,0,0,3,3
22260,école,0,0,3,3
3468,database.,1,3,0,3
13734,étonnant,0,0,3,3
22312,عديدة,0,0,3,3
22309,waardoor,0,0,3,3
22304,olá,0,0,3,3
45757,tivesse,0,0,3,3
1962,stupido,1,3,0,3
3627,precisione,1,3,0,3
22297,visit,0,0,3,3
13730,diária,0,0,3,3
45751,mathématiques,0,0,3,3
50883,wikipediasidor,0,0,3,3
22264,voraus,0,0,3,3
22261,προσπάθεια,0,0,3,3
12918,euxmêmes,0,0,3,3
50959,derece,0,0,3,3
12919,நிலத்தில்,0,0,3,3
39738,herramientas,0,0,3,3
12923,όνειρό,0,0,3,3
22240,émissions,0,0,3,3
22235,alvo,0,0,3,3
22232,முன்கூட்டியே,0,0,3,3
12935,bibliothèque,0,0,3,3
13708,ಆಹಾರ,0,0,3,3
22201,जिसने,0,0,3,3
45721,métaphysique,0,0,3,3
21149,luisterde,0,0,3,3
12960,любом,0,0,3,3
12961,الحادة,0,0,3,3
45231,ко,0,0,3,3
45653,firm,0,0,3,3
51720,potentially,0,0,3,3
39861,ήμασταν,0,0,3,3
21924,यूट्यूब,0,0,3,3
45603,réseaux,0,0,3,3
21229,उनका,0,0,3,3
13117,знал,0,0,3,3
21232,march,0,0,3,3
21971,especial,0,0,3,3
2007,culturali,1,3,0,3
2141,contenere,1,3,0,3
51707,संस्थापक,0,0,3,3
13640,grundläggande,0,0,3,3
39954,signals,0,0,3,3
21931,kendine,0,0,3,3
21930,требует,0,0,3,3
21929,amélioration,0,0,3,3
45275,afirmou,0,0,3,3
21919,conmigo,0,0,3,3
22068,advertising,0,0,3,3
21914,reconnaître,0,0,3,3
40389,பேச,0,0,3,3
2139,prevede,1,3,0,3
39973,tillgänglig,0,0,3,3
2136,piano,1,3,0,3
21252,πηγαίνετε,0,0,3,3
51642,suffer,0,0,3,3
13166,communities,0,0,3,3
21882,encourage,0,0,3,3
21879,इससे,0,0,3,3
13176,ഉപയോക്താക്കൾക്ക്,0,0,3,3
21868,எந்தவொரு,0,0,3,3
40372,composition,0,0,3,3
39994,ಕೆಳಗೆ,0,0,3,3
40402,humain,0,0,3,3
45607,redigerats,0,0,3,3
3598,appropriato,1,3,0,3
39921,location,0,0,3,3
22060,संग्रहण,0,0,3,3
13059,ಕೊನೆಯ,0,0,3,3
40417,விஷயம்,0,0,3,3
39869,extremadamente,0,0,3,3
51717,publicatie,0,0,3,3
13069,cambios,0,0,3,3
22048,ഭാഷയിൽ,0,0,3,3
45635,ആളുകൾ,0,0,3,3
40414,अधिकार,0,0,3,3
40413,பொத்தானை,0,0,3,3
13076,മെല്ലിയും,0,0,3,3
39880,ಯಾರಿಗಾದರೂ,0,0,3,3
1997,liberamente,1,3,0,3
22026,मिलता,0,0,3,3
1998,Non,1,3,0,3
45624,publicação,0,0,3,3
45623,mundial,0,0,3,3
40409,bastante,0,0,3,3
2148,giornalista,1,3,0,3
45621,شيوعًا,0,0,3,3
13654,परीक्षा,0,0,3,3
45618,telles,0,0,3,3
45617,éthique,0,0,3,3
39901,العلماء,0,0,3,3
45264,ejercicio,0,0,3,3
45265,tatsächlich,0,0,3,3
21219,replaced,0,0,3,3
21984,محيرة,0,0,3,3
45611,ещё,0,0,3,3
23214,henne,0,0,3,3
20808,الخاص,0,0,3,3
47021,istiyorsan,0,0,3,3
46725,americanos,0,0,3,3
20303,എന്നോട്,0,0,3,3
11319,μυστική,0,0,3,3
44819,l’encontre,0,0,3,3
46749,originalmente,0,0,3,3
14362,طريق,0,0,3,3
24514,setting,0,0,3,3
20308,स्कूल्स,0,0,3,3
11331,जहाँ,0,0,3,3
38307,lieve,0,0,3,3
24494,put,0,0,3,3
11341,tourist,0,0,3,3
20326,samedi,0,0,3,3
46728,argue,0,0,3,3
38327,озадачены,0,0,3,3
3371,transazione,1,3,0,3
50755,इन्टरनेट,0,0,3,3
40955,serious,0,0,3,3
44836,utrymme,0,0,3,3
24439,सप्ताहांत,0,0,3,3
11378,étais,0,0,3,3
11380,seek,0,0,3,3
24435,könntest,0,0,3,3
24431,degree,0,0,3,3
44841,लागू,0,0,3,3
3868,riesco,1,3,0,3
44845,teste,0,0,3,3
11396,dårligt,0,0,3,3
46700,utvalda,0,0,3,3
11406,mobiltelefoner,0,0,3,3
40943,कोलबर्ट,0,0,3,3
46759,commencé,0,0,3,3
24540,desigual,0,0,3,3
11409,sjov,0,0,3,3
24590,sections,0,0,3,3
46816,week,0,0,3,3
38240,meddelande,0,0,3,3
14399,—y,0,0,3,3
1500,blue,2,1,2,3
11245,buen,0,0,3,3
38249,off,0,0,3,3
24598,menées,0,0,3,3
24597,sidor,0,0,3,3
11255,hé,0,0,3,3
11256,अवयव,0,0,3,3
44799,bedanken,0,0,3,3
24593,adaptation,0,0,3,3
11260,золота,0,0,3,3
38251,مني,0,0,3,3
11263,fingre,0,0,3,3
20302,сэнгером,0,0,3,3
14392,ஒருவருக்கு,0,0,3,3
46798,परवाह,0,0,3,3
44802,« la,0,0,3,3
24583,വിവരങ്ങൾ,0,0,3,3
46793,collected,0,0,3,3
24578,круто,0,0,3,3
46783,विश्वविद्यालय,0,0,3,3
38266,estudiantes,0,0,3,3
38267,αμερικανοί,0,0,3,3
46779,мотивации,0,0,3,3
46778,എനിക്കറിയില്ല,0,0,3,3
46777,सम्पादन,0,0,3,3
51541,açıklayan,0,0,3,3
24550,chacune,0,0,3,3
51954,penge,0,0,3,3
24394,marque,0,0,3,3
23228,intonation,0,0,3,3
14268,taget,0,0,3,3
24263,dünya,0,0,3,3
51011,svårt,0,0,3,3
11499,εξηγεί,0,0,3,3
46633,observable,0,0,3,3
38456,नकारात्मक,0,0,3,3
38457,ಹೃದಯಕ್ಕೆ,0,0,3,3
46628,النهاية,0,0,3,3
24244,вопросу,0,0,3,3
20406,precipitation,0,0,3,3
44882,samenwerking,0,0,3,3
24230,samples,0,0,3,3
24217,ವ್ಯಕ್ತಿ,0,0,3,3
50781,ഒബ്ട്യൂസ്,0,0,3,3
24214,लोकप्रिय,0,0,3,3
46610,wahr,0,0,3,3
44872,இத்திட்டம்,0,0,3,3
24203,alemã,0,0,3,3
46609,jogo,0,0,3,3
24202,വചനം,0,0,3,3
46607,две,0,0,3,3
44889,taken,0,0,3,3
11542,संस्कृति,0,0,3,3
38491,особенно,0,0,3,3
46601,ajouts,0,0,3,3
24182,vient,0,0,3,3
40894,powers,0,0,3,3
24178,elde,0,0,3,3
2299,yahoo,2,1,2,3
24173,ekstra,0,0,3,3
11553,« les,0,0,3,3
38435,phuein,0,0,3,3
38422,ചിത്രങ്ങൾ,0,0,3,3
11411,vogn,0,0,3,3
11447,preguntas,0,0,3,3
24384,ಮಾಡುತ್ತೀರಿ,0,0,3,3
14320,locales,0,0,3,3
1544,rivelare,1,3,0,3
3862,accuratezza,1,3,0,3
14317,réduire,0,0,3,3
40941,bitten,0,0,3,3
20358,sentence,0,0,3,3
46679,olhos,0,0,3,3
14310,दावा,0,0,3,3
51547,abierto,0,0,3,3
38395,encyklopedi,0,0,3,3
11442,täcka,0,0,3,3
24339,provides,0,0,3,3
3854,norma,2,2,1,3
20368,natureza,0,0,3,3
14292,fossil,0,0,3,3
20371,ужасно,0,0,3,3
24327,κανάλι,0,0,3,3
38404,إلهي,0,0,3,3
11457,conocimientos,0,0,3,3
20374,ಸಂಭಾಷಣೆಯಲ್ಲಿ,0,0,3,3
44864,første,0,0,3,3
38410,перед,0,0,3,3
44865,जवाब,0,0,3,3
40927,ettiğim,0,0,3,3
51550,порядке,0,0,3,3
11468,kullanmak,0,0,3,3
11470,எல்லா,0,0,3,3
3845,corse,2,2,1,3
38418,لهذا,0,0,3,3
24620,verifiability,0,0,3,3
20246,சொன்னால்,0,0,3,3
38234,refer,0,0,3,3
24929,august,0,0,3,3
44729,согласен,0,0,3,3
44731,express,0,0,3,3
10992,е,0,0,3,3
46959,kızı,0,0,3,3
24948,strength,0,0,3,3
14492,genug,0,0,3,3
41091,общего,0,0,3,3
1451,coloro,1,3,0,3
11011,биологии,0,0,3,3
14488,ಕುರಿತು,0,0,3,3
24932,exibido,0,0,3,3
11015,beschrijven,0,0,3,3
11016,indem,0,0,3,3
11017,pesquisador,0,0,3,3
20119,പൊതുവേ,0,0,3,3
3341,faccio,1,3,0,3
11022,rejeitou,0,0,3,3
46942,cidessous,0,0,3,3
1454,ciascuna,1,3,0,3
11031,சிறிய,0,0,3,3
24905,fluido,0,0,3,3
11038,seule,0,0,3,3
11040,blandt,0,0,3,3
14481,அவற்றின்,0,0,3,3
20138,эту,0,0,3,3
46930,capítulo,0,0,3,3
11048,മാർഗമാണ്,0,0,3,3
11049,gemiddeld,0,0,3,3
24891,محتويات,0,0,3,3
52002,الألمانية,0,0,3,3
20103,ಮುಂದುವರಿಯಿರಿ,0,0,3,3
1443,patate,1,3,0,3
24635,volgens,0,0,3,3
25043,recuerda,0,0,3,3
47019,pengar,0,0,3,3
52017,قل,0,0,3,3
1430,dimensioni,1,3,0,3
37956,forklarer,0,0,3,3
37958,പ്രിയപ്പെട്ട,0,0,3,3
3948,wikipedia.com,1,3,0,3
25073,scherpe,0,0,3,3
2382,bacino,1,3,0,3
10922,बैंक,0,0,3,3
50721,threshold,0,0,3,3
20074,kvalitet,0,0,3,3
1435,universale,1,3,0,3
37971,matematik,0,0,3,3
10942,marcas,0,0,3,3
1439,migliaia,1,3,0,3
2377,inventata,1,3,0,3
37985,vijf,0,0,3,3
3339,ipotetico,1,3,0,3
25021,ocak,0,0,3,3
3943,enciclopedicamente,2,2,1,3
25019,अंतिम,0,0,3,3
20083,âge,0,0,3,3
25010,नया,0,0,3,3
14516,verdad,0,0,3,3
41110,ενός,0,0,3,3
25002,utilización,0,0,3,3
10968,अंग्रेज़ी,0,0,3,3
38004,взаимодействия,0,0,3,3
24994,lektion,0,0,3,3
38009,correspondiente,0,0,3,3
38073,செல்லுங்கள்,0,0,3,3
41074,ಅಪ್ರಸ್ತುತವಾಗುತ್ತದೆ,0,0,3,3
24881,ಸ್ಕೋರ್,0,0,3,3
3902,soggetto,1,3,0,3
11142,driven,0,0,3,3
41042,soru,0,0,3,3
38161,boek,0,0,3,3
14439,متأكد,0,0,3,3
3352,nodi,1,3,0,3
50741,bröd,0,0,3,3
24740,showed,0,0,3,3
20194,मेहनत,0,0,3,3
24734,creating,0,0,3,3
24728,وليس,0,0,3,3
41037,panorama,0,0,3,3
1482,spettatori,1,3,0,3
51987,ശൈലികൾ,0,0,3,3
20206,items,0,0,3,3
46848,uppmärksamhet,0,0,3,3
11060,alstublieft,0,0,3,3
50746,снова,0,0,3,3
24688,écrire,0,0,3,3
11190,voyez,0,0,3,3
1487,considerati,1,3,0,3
11197,tipset,0,0,3,3
24662,verktyg,0,0,3,3
41018,கீழே,0,0,3,3
24657,duitstalige,0,0,3,3
24655,weinberger,0,0,3,3
20234,കുറച്ചുകൂടി,0,0,3,3
3357,sostentamento,1,3,0,3
24639,அடிக்கடி,0,0,3,3
51020,editör,0,0,3,3
14406,എഴുതുന്ന,0,0,3,3
44769,समायोजित,0,0,3,3
24756,мечты,0,0,3,3
20189,kontroversiella,0,0,3,3
3349,specifico,1,3,0,3
46925,suerte,0,0,3,3
3931,comprende,1,3,0,3
24874,hjertet,0,0,3,3
20148,صحيح,0,0,3,3
24852,dilde,0,0,3,3
24844,thématique,0,0,3,3
24841,εγκυκλοπαίδεια,0,0,3,3
11085,asombroso,0,0,3,3
20154,malgré,0,0,3,3
24833,usual,0,0,3,3
46907,ವರ್ಡ್,0,0,3,3
24814,ನೋಡೋಣ,0,0,3,3
24810,anônimos,0,0,3,3
11096,havalı,0,0,3,3
1467,bokmål,2,1,2,3
38127,officiel,0,0,3,3
14461,ಆಗಿದೆ,0,0,3,3
20157,aussehen,0,0,3,3
46902,machst,0,0,3,3
38134,sert,0,0,3,3
46897,അല്ലെങ്കിൽ‌,0,0,3,3
38139,doivent,0,0,3,3
51529,völlig,0,0,3,3
24772,midt,0,0,3,3
46885,escuela,0,0,3,3
24771,«wikipedia»,0,0,3,3
14448,रोने,0,0,3,3
3915,wysiwyg,2,1,2,3
38152,gerçek,0,0,3,3
24168,allerede,0,0,3,3
20438,eyes,0,0,3,3
20439,разделы,0,0,3,3
38905,incapable,0,0,3,3
38867,വിഷമിക്കേണ്ടതില്ല,0,0,3,3
38868,representative,0,0,3,3
40736,κάποιο,0,0,3,3
23565,العشر,0,0,3,3
12001,يؤدي,0,0,3,3
23562,relação,0,0,3,3
12005,ótimo,0,0,3,3
38887,récemment,0,0,3,3
14080,remainder,0,0,3,3
38895,negativt,0,0,3,3
12012,работал,0,0,3,3
20688,ontmoeten,0,0,3,3
44997,sabía,0,0,3,3
46315,requisitos,0,0,3,3
14074,deelnemers,0,0,3,3
14088,arruiné,0,0,3,3
14071,ozone,0,0,3,3
23522,inquiète,0,0,3,3
20694,nuevos,0,0,3,3
14066,نصية,0,0,3,3
50818,അവ,0,0,3,3
12042,obstante,0,0,3,3
23502,उच्चारण,0,0,3,3
12049,प्यारे,0,0,3,3
40721,occupé,0,0,3,3
20710,deliver,0,0,3,3
12055,supervisé,0,0,3,3
14059,يكن,0,0,3,3
14054,offensive,0,0,3,3
3756,tyler,2,1,2,3
46330,naturalisme,0,0,3,3
46332,vão,0,0,3,3
38788,plateforme,0,0,3,3
11929,skaffa,0,0,3,3
11894,paintings,0,0,3,3
11895,espécie,0,0,3,3
11897,φάτε,0,0,3,3
3405,efficace,1,3,0,3
11901,हे,0,0,3,3
11904,reason,0,0,3,3
14125,buenos,0,0,3,3
51884,примеры,0,0,3,3
23691,программного,0,0,3,3
20637,aquele,0,0,3,3
46375,साईट,0,0,3,3
46373,நபரை,0,0,3,3
23677,первый,0,0,3,3
23669,идти,0,0,3,3
38823,représentations,0,0,3,3
14090,sociétés,0,0,3,3
44977,hemmelige,0,0,3,3
14109,போது,0,0,3,3
11942,anderson,0,0,3,3
44980,fortsätta,0,0,3,3
23646,متطوعين,0,0,3,3
23641,analytique,0,0,3,3
3778,java,2,1,2,3
23635,folk,0,0,3,3
11954,miyim,0,0,3,3
46351,álbum,0,0,3,3
23628,biotic,0,0,3,3
51583,origin,0,0,3,3
20667,bede,0,0,3,3
11981,கொள்ள,0,0,3,3
45014,sizin,0,0,3,3
1720,linguistici,1,3,0,3
38960,árboles,0,0,3,3
39038,teve,0,0,3,3
46224,merhaba,0,0,3,3
23367,bidrar,0,0,3,3
23364,προτέρων,0,0,3,3
12147,longer,0,0,3,3
40688,bonjour,0,0,3,3
23361,ഉപയോഗിക്കാം,0,0,3,3
46217,mala,0,0,3,3
46215,dela,0,0,3,3
23355,cabida,0,0,3,3
23350,ಒಟ್ಟಿಗೆ,0,0,3,3
3747,arrabbiato.,1,3,0,3
14018,بوابة,0,0,3,3
12164,शनिवार,0,0,3,3
39036,skrivs,0,0,3,3
14015,reuters,0,0,3,3
20730,എന്നിരുന്നാലും,0,0,3,3
14013,प्रिय,0,0,3,3
40680,lørdag,0,0,3,3
12177,anunció,0,0,3,3
39064,faktiskt,0,0,3,3
12197,கேட்டால்,0,0,3,3
23281,déranger,0,0,3,3
40669,móveis,0,0,3,3
45058,gama,0,0,3,3
12220,roy,0,0,3,3
23243,पूछने,0,0,3,3
23242,casamento,0,0,3,3
23239,förhand,0,0,3,3
12227,चैनल,0,0,3,3
1767,doveva,1,3,0,3
12139,prazer,0,0,3,3
23370,വിക്കിമീഡിയ,0,0,3,3
23376,value,0,0,3,3
3748,controversi,1,3,0,3
38969,lhe,0,0,3,3
14039,únicos,0,0,3,3
1725,esterne,1,3,0,3
12093,instellingen,0,0,3,3
20732,आलोचकों,0,0,3,3
12095,deles,0,0,3,3
23424,anúncios,0,0,3,3
46255,uden,0,0,3,3
20733,primeiros,0,0,3,3
38979,இருக்கிறார்,0,0,3,3
46250,ಮಾರ್ಗವಾಗಿದೆ,0,0,3,3
12104,विकिस्रोत,0,0,3,3
12105,özür,0,0,3,3
1730,rivolge,1,3,0,3
40694,الحقيقة,0,0,3,3
12113,vinieron,0,0,3,3
38992,langzaam,0,0,3,3
14031,unseen,0,0,3,3
20746,விரைவில்,0,0,3,3
38994,तुलना,0,0,3,3
23393,gekomen,0,0,3,3
12121,भेज,0,0,3,3
46236,nimm,0,0,3,3
12125,gemensam,0,0,3,3
23385,ஆங்கிலத்தில்,0,0,3,3
12127,morgon,0,0,3,3
2243,copie,2,1,2,3
46233,submit,0,0,3,3
50824,moyenne,0,0,3,3
46388,citações,0,0,3,3
46392,störa,0,0,3,3
38511,fuentes,0,0,3,3
1611,riportano,1,3,0,3
46539,oración,0,0,3,3
24030,träffa,0,0,3,3
3391,dell'ecosistema,1,3,0,3
38604,participar,0,0,3,3
3823,evento,1,3,0,3
46529,ತಮ್ಮ,0,0,3,3
1608,coperti,1,3,0,3
11671,ur,0,0,3,3
38611,состоянию,0,0,3,3
11673,northern,0,0,3,3
24003,dedicados,0,0,3,3
46525,источниках,0,0,3,3
3819,collegehumor,2,1,2,3
51919,ترى,0,0,3,3
11689,стал,0,0,3,3
1603,ecologico,1,3,0,3
38624,high,0,0,3,3
44921,لديه,0,0,3,3
46515,खुले,0,0,3,3
38630,статус,0,0,3,3
23977,ಕೇಳುತ್ತೀರಿ,0,0,3,3
23975,geweest,0,0,3,3
38631,يستحق,0,0,3,3
23972,rama,0,0,3,3
38633,ಅನೇಕ,0,0,3,3
1616,online.,1,3,0,3
46501,φαγητά,0,0,3,3
40850,fehler,0,0,3,3
40849,annonce,0,0,3,3
23941,टिप,0,0,3,3
1604,rilasciata,1,3,0,3
46541,économiques,0,0,3,3
14134,yakında,0,0,3,3
38547,escribir,0,0,3,3
40888,transaction,0,0,3,3
38516,davon,0,0,3,3
11567,ماريان,0,0,3,3
51931,множество,0,0,3,3
3386,swartz,2,1,2,3
11575,कार्यों,0,0,3,3
20455,заранее,0,0,3,3
14239,aqueles,0,0,3,3
38534,месте,0,0,3,3
24119,graden,0,0,3,3
38539,suggest,0,0,3,3
51929,تأكل,0,0,3,3
24111,δοκιμάστε,0,0,3,3
20466,χρήματα,0,0,3,3
38555,juntamente,0,0,3,3
24038,கடவுளே,0,0,3,3
11608,μέρος,0,0,3,3
20472,experto,0,0,3,3
1593,incorporato,1,3,0,3
3832,tue,2,2,1,3
24081,கொண்ட,0,0,3,3
1595,progetti.,1,3,0,3
38570,bak,0,0,3,3
14226,рядом,0,0,3,3
40866,género,0,0,3,3
14224,vaste,0,0,3,3
3827,intelligente.,1,3,0,3
51002,கொள்க,0,0,3,3
51922,criado,0,0,3,3
38592,uzun,0,0,3,3
23939,exakt,0,0,3,3
1622,stima,1,3,0,3
44930,hen,0,0,3,3
23797,wikiwand,0,0,3,3
46445,അവസാന,0,0,3,3
11803,pessoal,0,0,3,3
23835,mutually,0,0,3,3
14168,εκείνη,0,0,3,3
46440,kovitz,0,0,3,3
40806,место,0,0,3,3
1656,bigipedia,2,1,2,3
23821,busca,0,0,3,3
23819,ഇവരെ,0,0,3,3
1657,lettera,1,3,0,3
38719,വ്യത്യസ്ത,0,0,3,3
11825,sigan,0,0,3,3
46428,நீண்ட,0,0,3,3
11831,nadat,0,0,3,3
46424,المحادثة,0,0,3,3
46492,давно,0,0,3,3
23793,assigned,0,0,3,3
46421,बिल्कुल,0,0,3,3
40798,básicamente,0,0,3,3
23784,பிஸியாக,0,0,3,3
11849,чувствую,0,0,3,3
20586,cobertos,0,0,3,3
23767,servidor,0,0,3,3
23766,लिखते,0,0,3,3
23764,самой,0,0,3,3
50996,فعل,0,0,3,3
20595,semelhante,0,0,3,3
11870,aviso,0,0,3,3
23740,fome,0,0,3,3
44963,eksik,0,0,3,3
11799,matérialistes,0,0,3,3
23848,फ्रेंच,0,0,3,3
2272,implica,2,2,1,3
20550,плакать,0,0,3,3
11730,volumes,0,0,3,3
23928,ಸಿಹಿ,0,0,3,3
46489,acute,0,0,3,3
11733,الموضوع,0,0,3,3
3813,specialmente,1,3,0,3
11736,fais,0,0,3,3
20516,وتقول,0,0,3,3
11739,എന്തിനാണ്,0,0,3,3
38658,traitement,0,0,3,3
14192,sprog,0,0,3,3
14191,afbeeldingen,0,0,3,3
46476,balansen,0,0,3,3
51908,hak,0,0,3,3
50796,arbeitet,0,0,3,3
23896,suggère,0,0,3,3
2276,supera,1,3,0,3
23891,அதிர்ஷ்டசாலி,0,0,3,3
38679,അതിശയകരമാണ്,0,0,3,3
11774,कुल,0,0,3,3
46458,narrow,0,0,3,3
23871,remercier,0,0,3,3
14177,الإطلاق,0,0,3,3
11784,αναμμένο,0,0,3,3
23865,inteligencia,0,0,3,3
20548,ήδη,0,0,3,3
38690,बच्चे,0,0,3,3
51900,autour,0,0,3,3
38691,സംസാരിക്കാൻ,0,0,3,3
38692,despite,0,0,3,3
11827,என்னிடம்,0,0,3,3
13496,دقائق,0,0,3,3
47511,located,0,0,3,3
30150,nasılsın,0,0,3,3
30117,rede,0,0,3,3
17929,लेरी,0,0,3,3
34726,maten,0,0,3,3
17926,gift,0,0,3,3
15947,alleen,0,0,3,3
30140,değişiklik,0,0,3,3
34715,журналов,0,0,3,3
17915,tanrım,0,0,3,3
536,aaron,2,1,2,3
30157,ενοχλεί,0,0,3,3
30168,olduğu,0,0,3,3
34703,οποίο,0,0,3,3
34701,females,0,0,3,3
30173,ailleurs,0,0,3,3
17914,doigts,0,0,3,3
7252,usate,1,3,0,3
7303,sottostante,1,3,0,3
3054,neurone,1,3,0,3
17910,വിവാഹം,0,0,3,3
7325,festa,2,2,1,3
30080,casar,0,0,3,3
7337,costruita,1,3,0,3
7334,interessi,1,3,0,3
7332,artificiali.,1,3,0,3
3055,douglas,2,1,2,3
17942,accept,0,0,3,3
7326,spettacolo,1,3,0,3
34751,μαρία,0,0,3,3
50359,وداعًا,0,0,3,3
17938,devenir,0,0,3,3
7318,incomplete,2,1,2,3
43818,gerne,0,0,3,3
34745,сообщение,0,0,3,3
30099,automatisch,0,0,3,3
34739,asusté,0,0,3,3
30109,lecteur,0,0,3,3
49111,मिडिया,0,0,3,3
52507,buitengewoon,0,0,3,3
15922,officielle,0,0,3,3
42560,वर्ष,0,0,3,3
50342,tidsskriftet,0,0,3,3
30287,keskin,0,0,3,3
4745,regalo,2,2,1,3
34628,maddesi,0,0,3,3
15980,boas,0,0,3,3
34613,uppgifter,0,0,3,3
30316,fears,0,0,3,3
17857,странице,0,0,3,3
15976,أشار,0,0,3,3
7157,cox,2,1,2,3
49155,occidentale,0,0,3,3
4753,malapena,1,3,0,3
7142,eccoti,1,3,0,3
17846,grund,0,0,3,3
3041,uscì,1,3,0,3
7134,hudong,2,1,2,3
30280,donnée,0,0,3,3
17876,لديها,0,0,3,3
30213,ഒബ്‌ട്യൂസ്,0,0,3,3
7205,salto,2,2,1,3
49122,subset,0,0,3,3
34674,م,0,0,3,3
42525,husk,0,0,3,3
509,conferenze,1,3,0,3
30233,பார்த்துக்,0,0,3,3
49131,fevereiro,0,0,3,3
34661,fallen,0,0,3,3
30258,വിലകൾ,0,0,3,3
4740,ruby,2,1,2,3
49135,junio,0,0,3,3
7199,multimediale,1,3,0,3
49136,выглядела,0,0,3,3
30260,couverture,0,0,3,3
34643,implique,0,0,3,3
7189,liberi,1,3,0,3
43796,வீடியோ,0,0,3,3
49067,νέα,0,0,3,3
17954,ваши,0,0,3,3
42571,toutefois,0,0,3,3
29888,allumé,0,0,3,3
29864,ಸುವ್,0,0,3,3
7494,wikiality,2,1,2,3
18053,relationships,0,0,3,3
29875,orolig,0,0,3,3
578,all'editing,1,3,0,3
48993,மிக,0,0,3,3
15862,tarafsız,0,0,3,3
4668,diagnosi,1,3,0,3
34901,distributed,0,0,3,3
18047,travlt,0,0,3,3
34871,contribuinte,0,0,3,3
2701,forum,2,1,2,3
574,eravamo,1,3,0,3
34866,मूर्ख,0,0,3,3
29908,opgericht,0,0,3,3
34860,رفاق,0,0,3,3
34891,जाम,0,0,3,3
34902,ലേഖനങ്ങളിൽ,0,0,3,3
49007,έκανε,0,0,3,3
34935,വിരലുകൾ,0,0,3,3
7554,comuni.,1,3,0,3
43886,உங்களைப்,0,0,3,3
48964,cinq,0,0,3,3
15839,üç,0,0,3,3
18086,names,0,0,3,3
29799,विशेषज्ञ,0,0,3,3
7540,donazioni,1,3,0,3
584,moderno,1,3,0,3
34906,estábamos,0,0,3,3
42417,വാക്കുകളും,0,0,3,3
18073,respecto,0,0,3,3
34931,comparable,0,0,3,3
7526,campioni,1,3,0,3
34914,cœur,0,0,3,3
7516,nessuno,1,3,0,3
7510,riguardanti,1,3,0,3
7453,o.,1,3,0,3
7448,resa,2,1,2,3
34765,دعني,0,0,3,3
30029,şaşkın,0,0,3,3
7405,declino,1,3,0,3
7392,commento.,1,3,0,3
17987,öka,0,0,3,3
30008,söyleyebilir,0,0,3,3
42484,pond,0,0,3,3
51169,estatísticas,0,0,3,3
30027,продали,0,0,3,3
50370,ton,0,0,3,3
7409,identificate,1,3,0,3
552,mac,2,1,2,3
30034,которым,0,0,3,3
4690,comprensiva,2,2,1,3
7360,riguardare,1,3,0,3
42500,semelhantes,0,0,3,3
30054,desk,0,0,3,3
15919,ನಿರರ್ಗಳವಾಗಿ,0,0,3,3
34810,решение,0,0,3,3
43852,сообществе,0,0,3,3
43862,μήνυμα,0,0,3,3
15879,денег,0,0,3,3
34843,bekymringer,0,0,3,3
34841,play,0,0,3,3
18028,يريد,0,0,3,3
7441,pasticcio,1,3,0,3
43859,verdade,0,0,3,3
42457,политики,0,0,3,3
49015,önce,0,0,3,3
567,sparso,1,3,0,3
29968,muestra,0,0,3,3
52483,ia,0,0,3,3
29946,ausgeflippt,0,0,3,3
29948,мои,0,0,3,3
18011,miljoen,0,0,3,3
52487,transform,0,0,3,3
15886,suggested,0,0,3,3
29967,जिम्मी,0,0,3,3
30376,ಪಡೆದಿದ್ದೇನೆ,0,0,3,3
4757,chiaro,1,3,0,3
42406,encyclopédies,0,0,3,3
17656,freedom,0,0,3,3
6827,meta,2,1,2,3
3023,nascosti,1,3,0,3
42679,skillnader,0,0,3,3
6823,dirgli,1,3,0,3
6822,distribuita,1,3,0,3
30755,apple,0,0,3,3
16124,inspired,0,0,3,3
42687,желание,0,0,3,3
30744,universitaire,0,0,3,3
30773,الذكور,0,0,3,3
34334,ampliar,0,0,3,3
17650,зависимость,0,0,3,3
34333,சவாரி,0,0,3,3
52559,прав,0,0,3,3
16132,viewers,0,0,3,3
16133,ihop,0,0,3,3
6828,casino,1,3,0,3
17666,busy,0,0,3,3
6796,dell'edizione,1,3,0,3
16108,καρδιά,0,0,3,3
50304,peki,0,0,3,3
34407,mätte,0,0,3,3
30669,स्वतंत्रता,0,0,3,3
6878,utilizzano,1,3,0,3
16103,πλημμυρίσει,0,0,3,3
16105,apparaît,0,0,3,3
49314,λογισμικού,0,0,3,3
6864,biosfera,1,3,0,3
49333,போல்,0,0,3,3
43707,italian,0,0,3,3
42674,لأنك,0,0,3,3
34368,uk,0,0,3,3
30728,مصدر,0,0,3,3
49329,красив,0,0,3,3
30733,ബട്ടൺ,0,0,3,3
30735,usas,0,0,3,3
30788,strongly,0,0,3,3
30790,critères,0,0,3,3
17703,مارس,0,0,3,3
34247,responsáveis,0,0,3,3
17620,aquellas,0,0,3,3
30868,haga,0,0,3,3
16153,explosion,0,0,3,3
34267,जरुरत,0,0,3,3
6735,annuale,1,3,0,3
374,memoria,2,2,1,3
30896,memory,0,0,3,3
371,mutazione,1,3,0,3
6749,previsioni.,1,3,0,3
42720,одном,0,0,3,3
34230,mutlu,0,0,3,3
51313,garçon,0,0,3,3
30923,estes,0,0,3,3
34225,interesses,0,0,3,3
30930,ಈಗಾಗಲೇ,0,0,3,3
367,crawler,2,1,2,3
6747,newsletter,2,2,1,3
393,mondo.,1,3,0,3
34324,сердцу,0,0,3,3
6775,bel,2,2,1,3
6790,viaggio,1,3,0,3
42700,alma,0,0,3,3
34314,добросовестного,0,0,3,3
34313,hébergement,0,0,3,3
30811,flawed,0,0,3,3
42703,"
उत्तरी",0,0,3,3
2778,piani,1,3,0,3
401,costituiscono,1,3,0,3
30845,gebeurt,0,0,3,3
34306,skriven,0,0,3,3
2779,valutate,1,3,0,3
4840,attraversato,1,3,0,3
6768,tende,2,2,1,3
30842,அம்மாவிடம்,0,0,3,3
50290,estudos,0,0,3,3
34290,некоторым,0,0,3,3
49305,ரகசிய,0,0,3,3
6895,politico,1,3,0,3
43774,raíz,0,0,3,3
49208,रखा,0,0,3,3
7061,ricerca.,1,3,0,3
7060,porterò,1,3,0,3
30459,buscador,0,0,3,3
4776,simile,1,3,0,3
30463,созданию,0,0,3,3
16030,используются,0,0,3,3
30466,capable,0,0,3,3
42588,والدتها,0,0,3,3
34527,composé,0,0,3,3
30474,falsa,0,0,3,3
43756,forskning,0,0,3,3
2751,iii,2,1,2,3
17796,фраз,0,0,3,3
34505,fritt,0,0,3,3
50322,dåligt,0,0,3,3
30493,stören,0,0,3,3
34526,wusste,0,0,3,3
17814,palácio,0,0,3,3
34502,खुला,0,0,3,3
30428,frasen,0,0,3,3
4759,chiaramente,1,3,0,3
34557,suivent,0,0,3,3
30402,किस,0,0,3,3
479,padre,2,2,1,3
30408,dérivé,0,0,3,3
49187,lyde,0,0,3,3
52528,zamandır,0,0,3,3
2744,l'attenzione,1,3,0,3
17815,rejected,0,0,3,3
16020,prensa,0,0,3,3
4771,bibliotecario,2,2,1,3
34532,πουλήσατε,0,0,3,3
7076,distribuire,1,3,0,3
7071,copertina,1,3,0,3
470,incoraggiare,1,3,0,3
30449,revelou,0,0,3,3
49220,hello,0,0,3,3
7026,offensivo,1,3,0,3
30647,أنواع,0,0,3,3
34431,تقريبًا,0,0,3,3
17743,lyder,0,0,3,3
6947,codifica,1,3,0,3
34442,característica,0,0,3,3
17736,lördag,0,0,3,3
3028,animali.,1,3,0,3
6923,coprivano,1,3,0,3
51321,أصدقائك,0,0,3,3
43718,spielt,0,0,3,3
30580,cité,0,0,3,3
49283,திறந்த,0,0,3,3
51319,posição,0,0,3,3
34423,publiées,0,0,3,3
17711,основе,0,0,3,3
34419,trabalhar,0,0,3,3
34418,संपादक,0,0,3,3
49297,ಹೇಳುವ,0,0,3,3
30582,weight,0,0,3,3
30579,rencontrer,0,0,3,3
16043,relation,0,0,3,3
6998,brockhaus,2,2,1,3
30506,revisões,0,0,3,3
17790,deine,0,0,3,3
7016,andarono,1,3,0,3
16046,தங்கத்தால்,0,0,3,3
30513,looks,0,0,3,3
7007,biomassa,1,3,0,3
30523,गुस्सा,0,0,3,3
49235,bunlar,0,0,3,3
6961,piedi,1,3,0,3
30547,намного,0,0,3,3
30548,grados,0,0,3,3
34469,possui,0,0,3,3
16062,utilisés,0,0,3,3
49249,muhammad,0,0,3,3
30569,передать,0,0,3,3
443,distinto,1,3,0,3
18092,தயவு,0,0,3,3
7561,istruzioni,1,3,0,3
28736,consideraba,0,0,3,3
52402,проекте,0,0,3,3
18397,мое,0,0,3,3
42206,zoveel,0,0,3,3
18394,κανόνες,0,0,3,3
29040,présentes,0,0,3,3
35409,كذلك,0,0,3,3
35408,história,0,0,3,3
733,costituito,1,3,0,3
35400,réunion,0,0,3,3
29031,الجديد,0,0,3,3
18386,जापानी,0,0,3,3
18377,confused,0,0,3,3
29084,episódio,0,0,3,3
42225,lockyer,0,0,3,3
724,temperatura,1,3,0,3
35380,പറഞ്ഞാൽ,0,0,3,3
48719,θεέ,0,0,3,3
4533,dieta,2,2,1,3
29029,toll,0,0,3,3
8032,lento.,1,3,0,3
15630,besøgt,0,0,3,3
42192,उद्धरण,0,0,3,3
28970,generate,0,0,3,3
18419,மிக்க,0,0,3,3
28984,അതിന്റെ,0,0,3,3
8104,consentire,1,3,0,3
28990,newspaper,0,0,3,3
28995,tex,0,0,3,3
8098,ottimizzazione,1,3,0,3
2645,presente,2,1,2,3
29012,sino,0,0,3,3
29018,reading,0,0,3,3
4530,DNA,1,3,0,3
8082,crossover,2,2,1,3
4531,canzoni,1,3,0,3
29022,മാത്രമേ,0,0,3,3
48695,diskussion,0,0,3,3
52406,عما,0,0,3,3
18361,ಬಳಿಗೆ,0,0,3,3
42190,globally,0,0,3,3
15693,modellen,0,0,3,3
709,relativo,1,3,0,3
35328,danken,0,0,3,3
29182,mellem,0,0,3,3
48756,pasando,0,0,3,3
18303,betydelse,0,0,3,3
48758,занят,0,0,3,3
35307,goodbye,0,0,3,3
29221,biased,0,0,3,3
710,password,2,2,1,3
43972,επειδή,0,0,3,3
703,l'assegnazione,1,3,0,3
35301,references,0,0,3,3
35284,comentario,0,0,3,3
15699,θυμωμένος,0,0,3,3
35275,दी।,0,0,3,3
7925,anticipo,1,3,0,3
42258,ಎಲ್ಲಿದ್ದೇವೆ,0,0,3,3
4552,superiore,1,3,0,3
48726,व्यस्त,0,0,3,3
8007,incorpora,2,1,2,3
8023,beta,2,1,2,3
18354,literalmente,0,0,3,3
29130,beau,0,0,3,3
718,affiliati,1,3,0,3
48735,चलने,0,0,3,3
8010,visualizzate,1,3,0,3
35355,απλά,0,0,3,3
18347,कड़ी,0,0,3,3
42257,ജാം,0,0,3,3
42241,hombre,0,0,3,3
18344,bilmiyorum,0,0,3,3
29149,الأطعمة,0,0,3,3
18339,representing,0,0,3,3
51376,τραβήξτε,0,0,3,3
7991,campana,2,2,1,3
42255,videoda,0,0,3,3
48678,bas,0,0,3,3
4514,composta,2,2,1,3
29265,klagen,0,0,3,3
42147,baseada,0,0,3,3
28802,स्थानांतरित,0,0,3,3
28803,minder,0,0,3,3
18488,каждого,0,0,3,3
4489,larga,2,2,1,3
44048,løsning,0,0,3,3
8243,inutile,2,2,1,3
8242,nell'arte,1,3,0,3
28816,divertida,0,0,3,3
28793,ಮಾಡಿ,0,0,3,3
35560,anjo,0,0,3,3
28830,universel,0,0,3,3
3124,waray,2,1,2,3
762,crimson,2,1,2,3
28845,contas,0,0,3,3
2633,concesso,1,3,0,3
8219,recente,2,2,1,3
35574,facilement,0,0,3,3
42142,growing,0,0,3,3
8213,austria,2,2,1,3
35594,ലേഖനത്തിനു,0,0,3,3
15570,mag,0,0,3,3
18503,geographic,0,0,3,3
8291,cercare,1,3,0,3
4482,l'effetto,1,3,0,3
28754,bilgilerin,0,0,3,3
8283,dovrebbero,1,3,0,3
8280,markup,2,2,1,3
8277,ridurre,1,3,0,3
35582,consequence,0,0,3,3
8275,ampie,1,3,0,3
44053,employé,0,0,3,3
8273,correio,2,1,2,3
8272,sottoinsieme,1,3,0,3
8271,raro,2,2,1,3
35586,assistindo,0,0,3,3
42138,l’enseignement,0,0,3,3
8216,criteri,1,3,0,3
8206,piccolo,1,3,0,3
8126,prossimo,1,3,0,3
48665,परीक्षण,0,0,3,3
8169,supportare,1,3,0,3
44030,cher,0,0,3,3
4505,prendendo,1,3,0,3
28924,additionally,0,0,3,3
28931,أعمال,0,0,3,3
8155,relazioni,1,3,0,3
8154,ricchezze,1,3,0,3
8148,tradizionale,1,3,0,3
28921,degrés,0,0,3,3
35477,distintas,0,0,3,3
35475,ಹೊಸ,0,0,3,3
48668,fora,0,0,3,3
28947,verklaart,0,0,3,3
48672,الويب,0,0,3,3
8128,intrusioni,1,3,0,3
15621,ಅಸಮಾಧಾನಗೊಳ್ಳಬೇಡಿ,0,0,3,3
8170,genera,2,2,1,3
8173,pur,2,2,1,3
4498,manipolare,1,3,0,3
4501,emigh,2,2,1,3
28872,nedenle,0,0,3,3
28874,discover,0,0,3,3
15600,lançou,0,0,3,3
15601,contained,0,0,3,3
4500,bayesiane,1,3,0,3
15602,receiving,0,0,3,3
48644,utilizado,0,0,3,3
35512,yapamam,0,0,3,3
42177,themselves,0,0,3,3
18458,கொஞ்சம்,0,0,3,3
18457,أحدهم,0,0,3,3
28891,éditions ,0,0,3,3
42169,λέξης,0,0,3,3
28904,keek,0,0,3,3
52388,dersin,0,0,3,3
48654,distingue,0,0,3,3
29259,tek,0,0,3,3
48775,ಫಿಕ್ಸ್‌ನಲ್ಲಿದ್ದೇನೆ,0,0,3,3
42399,aslında,0,0,3,3
7676,schekman,1,3,0,3
18182,ഡാറ്റ,0,0,3,3
7692,programmati,1,3,0,3
35065,planète,0,0,3,3
7687,conoscere,1,3,0,3
29607,हार्वर्ड,0,0,3,3
7679,eliminare,1,3,0,3
29610,tenderar,0,0,3,3
35043,ajouter,0,0,3,3
4616,limitati,1,3,0,3
7670,crossbar,2,1,2,3
7669,impiegato,1,3,0,3
48896,системы,0,0,3,3
4631,divenne,1,3,0,3
7660,sorprendente,2,1,2,3
29645,inspirados,0,0,3,3
4632,densità,1,3,0,3
10144,hören,0,0,3,3
7699,intelligenza,1,3,0,3
35023,será,0,0,3,3
15774,suppose,0,0,3,3
18202,desarrollar,0,0,3,3
51156,dediğini,0,0,3,3
7724,l'unico,1,3,0,3
29549,outil,0,0,3,3
29550,extrêmement,0,0,3,3
35088,kelimesini,0,0,3,3
35086,follows,0,0,3,3
51365,απασχολημένος,0,0,3,3
42342,learner,0,0,3,3
29563,боже,0,0,3,3
29568,सीखने,0,0,3,3
29571,upptagen,0,0,3,3
7708,ruolo,1,3,0,3
29573,necesario,0,0,3,3
35076,actuellement,0,0,3,3
29581,depends,0,0,3,3
7655,spiegare,1,3,0,3
52452,dereceden,0,0,3,3
35097,characters,0,0,3,3
2688,un'opera,1,3,0,3
7599,potenzialmente,1,3,0,3
52464,friend,0,0,3,3
52465,único,0,0,3,3
18117,delas,0,0,3,3
48949,subsets,0,0,3,3
29757,अत्याचार,0,0,3,3
43896,representa,0,0,3,3
48953,kamen,0,0,3,3
7603,l'interazione,1,3,0,3
34956,effekt,0,0,3,3
18108,ഉദാഹരണങ്ങൾ,0,0,3,3
7572,revisioni,1,3,0,3
4649,ideatori,1,3,0,3
7569,editoriali,1,3,0,3
4651,garanzia,1,3,0,3
7567,"contrario,",1,3,0,3
29724,सार्वजनिक,0,0,3,3
7605,vegetazione,1,3,0,3
18158,ಹೇಳುತ್ತೇನೆ,0,0,3,3
15800,vocabulaire,0,0,3,3
29655,enwikipediaorg,0,0,3,3
18156,ona,0,0,3,3
48907,speed,0,0,3,3
48911,meest,0,0,3,3
15797,ببطء,0,0,3,3
29664,vyn,0,0,3,3
48916,possessed,0,0,3,3
29683,topla,0,0,3,3
29716,déplacer,0,0,3,3
43906,पूरे,0,0,3,3
18142,debajo,0,0,3,3
42376,capa,0,0,3,3
7619,edizione.,1,3,0,3
52459,سوف,0,0,3,3
42379,запущенным,0,0,3,3
48928,colaborativos,0,0,3,3
15771,थक,0,0,3,3
51366,düzelme,0,0,3,3
695,proporzione,1,3,0,3
42301,determinados,0,0,3,3
7873,l'intero,1,3,0,3
43957,prática,0,0,3,3
3096,proposto,1,3,0,3
52420,பணிகள்,0,0,3,3
29335,ലഭ്യമായ,0,0,3,3
48806,television,0,0,3,3
29337,viewed,0,0,3,3
18253,puntuación,0,0,3,3
7877,successivi,1,3,0,3
35224,appearing,0,0,3,3
7851,vendita,1,3,0,3
15731,hiérarchie,0,0,3,3
15732,robots,0,0,3,3
7836,statistico,1,3,0,3
29381,ನೀಡುತ್ತೇನೆ,0,0,3,3
15735,élus,0,0,3,3
50423,नीति,0,0,3,3
15720,நான்கு,0,0,3,3
29396,وهم,0,0,3,3
29285,woman,0,0,3,3
50429,goldene,0,0,3,3
15701,оно,0,0,3,3
7915,accadono,1,3,0,3
7909,teorie,1,3,0,3
18282,provenant,0,0,3,3
7907,letto,1,3,0,3
7906,scrivono,1,3,0,3
18278,पकड़ा,0,0,3,3
52419,dourado,0,0,3,3
7901,riescono,1,3,0,3
50426,archives,0,0,3,3
15709,allow,0,0,3,3
42293,पर्याप्त,0,0,3,3
35249,صفحات,0,0,3,3
689,antico,1,3,0,3
29305,affirme,0,0,3,3
29388,provided,0,0,3,3
29399,вот,0,0,3,3
29531,prediction,0,0,3,3
7754,revisione.,1,3,0,3
3092,inserito,1,3,0,3
7767,costruiscono,1,3,0,3
655,aspetto,1,3,0,3
654,passa,2,2,1,3
29498,каждой,0,0,3,3
51367,respect,0,0,3,3
29505,കഴിഞ്ഞില്ല,0,0,3,3
7750,tardi,1,3,0,3
29463,απλώς,0,0,3,3
7748,redazione,1,3,0,3
18210,கருத்து,0,0,3,3
29518,ஒன்றை,0,0,3,3
35104,manual,0,0,3,3
7740,appresa,1,3,0,3
7738,posso.,1,3,0,3
48859,kelimeden,0,0,3,3
42320,बेच,0,0,3,3
7782,amico,1,3,0,3
7826,aggiunta,1,3,0,3
4596,singoli,1,3,0,3
35179,humano,0,0,3,3
48819,logiciels,0,0,3,3
18237,publicar,0,0,3,3
48820,c’estàdire,0,0,3,3
15743,него,0,0,3,3
29429,propósito,0,0,3,3
35161,verte,0,0,3,3
48829,norman,0,0,3,3
660,lee,2,1,2,3
29434,день,0,0,3,3
4597,ragazza,1,3,0,3
50413,catégorie,0,0,3,3
29453,pontuação,0,0,3,3
29455,स्क्वीड,0,0,3,3
15750,hellere,0,0,3,3
7786,hoiberg,2,1,2,3
49396,continuación,0,0,3,3
6711,descritta,1,3,0,3
49397,derfor,0,0,3,3
49873,समकक्ष,0,0,3,3
2958,riflesso,1,3,0,3
32283,vinklat,0,0,3,3
43071,vrouw,0,0,3,3
16550,ഫ്രഞ്ച്,0,0,3,3
130,blodget,2,1,2,3
5712,academy,2,1,2,3
5709,markov,2,2,1,3
32305,diferenças,0,0,3,3
52691,αδελφικά,0,0,3,3
43403,below,0,0,3,3
5700,statistica.,1,3,0,3
33345,innefattar,0,0,3,3
32315,beschäftigt,0,0,3,3
5691,impresa,2,1,2,3
33342,somme,0,0,3,3
32321,successfully,0,0,3,3
43070,ಅತ್ಯುತ್ತಮ,0,0,3,3
16539,статистики,0,0,3,3
51264,anonymt,0,0,3,3
5755,pratica.,1,3,0,3
5770,ottenere,1,3,0,3
17087,بطلاقة,0,0,3,3
33396,உரை,0,0,3,3
149,sorpresa,1,3,0,3
17078,termo,0,0,3,3
148,d'altro,1,3,0,3
147,fanno,1,3,0,3
43063,खोज,0,0,3,3
49853,actúan,0,0,3,3
5750,salata,1,3,0,3
32248,السبت,0,0,3,3
32251,motion,0,0,3,3
17067,போலவே,0,0,3,3
32256,importancia,0,0,3,3
32259,aquellos,0,0,3,3
136,settimanale,1,3,0,3
17044,tells,0,0,3,3
33329,précise,0,0,3,3
49839,ശ്രദ്ധിച്ചില്ല,0,0,3,3
33273,rocker,0,0,3,3
43140,kabul,0,0,3,3
33289,venu,0,0,3,3
5610,riconoscere,1,3,0,3
5609,studente,1,3,0,3
49915,सुनिश्चित,0,0,3,3
32426,مشاكل,0,0,3,3
33277,alls,0,0,3,3
49921,تناول,0,0,3,3
52703,sitting,0,0,3,3
16953,décision,0,0,3,3
32450,أصدقاؤك,0,0,3,3
5589,particolari,1,3,0,3
32470,slate,0,0,3,3
43157,للتخريب,0,0,3,3
32483,பதிவு,0,0,3,3
49936,demandez,0,0,3,3
43387,επιτρέψτε,0,0,3,3
16973,xkcd,0,0,3,3
50162,wollen,0,0,3,3
51223,locais,0,0,3,3
2953,editoriale,1,3,0,3
43094,tvärtom,0,0,3,3
16571,അതൊരു,0,0,3,3
5665,curriculum,2,2,1,3
17008,gefragt,0,0,3,3
32356,trevliga,0,0,3,3
5657,temporale,1,3,0,3
49899,chorar,0,0,3,3
32399,nosotros,0,0,3,3
16579,pegar,0,0,3,3
32382,ஏற்கனவே,0,0,3,3
5643,evoluzione,1,3,0,3
49903,किए,0,0,3,3
5635,portmanteau,2,1,2,3
5630,collegato,1,3,0,3
32396,bacteria,0,0,3,3
16524,actifs,0,0,3,3
32217,biomass,0,0,3,3
5140,manuale,1,3,0,3
43014,ಗಾಡಿಯಲ್ಲಿ,0,0,3,3
5041,provengono,1,3,0,3
32022,работать,0,0,3,3
5045,relativi,1,3,0,3
33515,build,0,0,3,3
5898,eventuali,1,3,0,3
32037,എത്ര,0,0,3,3
33514,expression,0,0,3,3
5891,soluzioni,1,3,0,3
43464,بالإضافة,0,0,3,3
5047,I,1,3,0,3
49782,står,0,0,3,3
33505,മുന്നോട്ട്,0,0,3,3
32052,aceso,0,0,3,3
49786,கொடூரமானது,0,0,3,3
17141,थोड़ी,0,0,3,3
182,impossibile,1,3,0,3
5917,giorno.,1,3,0,3
5920,dicendomi,1,3,0,3
32075,visa,0,0,3,3
49754,episódios,0,0,3,3
31962,αυτόν,0,0,3,3
49750,estadísticas,0,0,3,3
43475,पोशाक,0,0,3,3
5030,möller,2,1,2,3
33557,raderas,0,0,3,3
5953,l'era,1,3,0,3
5952,adottato,1,3,0,3
51278,relevanta,0,0,3,3
32002,oldukça,0,0,3,3
50197,pasado,0,0,3,3
5939,riuscito,1,3,0,3
5037,aumentando,2,2,1,3
5932,semplici,1,3,0,3
16456,ನಿನ್ನನ್ನು,0,0,3,3
43467,nodig,0,0,3,3
43005,लाभ,0,0,3,3
32074,culturais,0,0,3,3
5868,effettivamente,1,3,0,3
32216,والمعلوماتية,0,0,3,3
16511,moteurs,0,0,3,3
52682,வார்த்தையைப்,0,0,3,3
5817,regola,1,3,0,3
32160,senere,0,0,3,3
32161,sumpf,0,0,3,3
33431,αιχμηρή,0,0,3,3
43433,essential,0,0,3,3
33418,إدخال,0,0,3,3
17103,ίδιο,0,0,3,3
32149,llorando,0,0,3,3
2875,alghe,1,3,0,3
5788,voce.,1,3,0,3
17099,भूगोल,0,0,3,3
5783,praticamente,2,1,2,3
17090,मन,0,0,3,3
5078,portali,1,3,0,3
32212,lag,0,0,3,3
51272,ക്രൂരമായ,0,0,3,3
5828,inserite,1,3,0,3
32081,через,0,0,3,3
33471,pull,0,0,3,3
17135,méthode,0,0,3,3
2965,immagine,1,3,0,3
52676,totalmente,0,0,3,3
17130,rubis,0,0,3,3
32099,sırasında,0,0,3,3
32100,numerosas,0,0,3,3
33476,implicitly,0,0,3,3
32107,ಹೋಗಿ,0,0,3,3
33448,claims,0,0,3,3
33460,voorbeelden,0,0,3,3
16495,തുടർന്ന്,0,0,3,3
49807,собственном,0,0,3,3
32122,coolt,0,0,3,3
33459,tänka,0,0,3,3
32127,planeta,0,0,3,3
52680,जुलाई,0,0,3,3
5562,universitari,1,3,0,3
32497,değmez,0,0,3,3
30934,noyau,0,0,3,3
16709,esteja,0,0,3,3
32803,activity,0,0,3,3
2923,provenienza,1,3,0,3
32811,abonnement,0,0,3,3
32817,hemliga,0,0,3,3
16707,சொற்றொடர்கள்,0,0,3,3
5327,insiemi,1,3,0,3
32826,ترخيص,0,0,3,3
16710,கடைசி,0,0,3,3
50051,contradictoires,0,0,3,3
50061,extended,0,0,3,3
5190,grafico,1,3,0,3
32832,فكرة,0,0,3,3
5317,industriale,1,3,0,3
43310,racines,0,0,3,3
32835,acımasız,0,0,3,3
51243,filmer,0,0,3,3
32802,kritiserats,0,0,3,3
32793,agradecer,0,0,3,3
16717,disputed,0,0,3,3
5364,seguito.,1,3,0,3
16685,reveal,0,0,3,3
50133,tendencia,0,0,3,3
50027,apporter,0,0,3,3
5378,venivano,1,3,0,3
5376,ehi,1,3,0,3
16825,люди,0,0,3,3
5374,verità,1,3,0,3
5361,globale.,1,3,0,3
5345,formattazione,1,3,0,3
50039,enseignants,0,0,3,3
16813,anything,0,0,3,3
5358,più.,1,3,0,3
32773,يعمل,0,0,3,3
33048,dames,0,0,3,3
32785,lyttede,0,0,3,3
33039,joke,0,0,3,3
43252,neuron,0,0,3,3
16792,daumen,0,0,3,3
5388,geometria,2,2,1,3
50118,källbeskrivning,0,0,3,3
5259,impatto,1,3,0,3
43274,ಏನೂ,0,0,3,3
43294,результаты,0,0,3,3
11,nell'elaborazione,1,3,0,3
16736,nichts,0,0,3,3
5207,spiegano,1,3,0,3
5211,letteratura,1,3,0,3
50106,रास्ता,0,0,3,3
5261,paradigma,2,2,1,3
16751,видели,0,0,3,3
5230,censura,2,1,2,3
32933,kväll,0,0,3,3
50109,fio,0,0,3,3
32949,بدأ,0,0,3,3
52748,amerikanen,0,0,3,3
5222,vedrai,1,3,0,3
5260,rilevanti,1,3,0,3
5262,ghiaccio,1,3,0,3
16719,films,0,0,3,3
5196,lolicon,2,1,2,3
50072,दिए,0,0,3,3
29,mantengono,1,3,0,3
43254,nok,0,0,3,3
32853,banklån,0,0,3,3
5297,entità,1,3,0,3
32859,мнения,0,0,3,3
16786,شبه,0,0,3,3
5198,"generale,",1,3,0,3
5265,giorni,1,3,0,3
52740,manières,0,0,3,3
5282,probabilistici,1,3,0,3
32881,régression,0,0,3,3
32882,intento,0,0,3,3
43298,പറയാനുള്ള,0,0,3,3
18,analogamente,1,3,0,3
2916,rubini,1,3,0,3
5387,dizionari,1,3,0,3
32740,hambre,0,0,3,3
32515,عرض,0,0,3,3
5506,modellare,1,3,0,3
16909,linda,0,0,3,3
16908,photographic,0,0,3,3
32560,apprend,0,0,3,3
16905,மேல்,0,0,3,3
16635,secreta,0,0,3,3
16636,योग्य,0,0,3,3
33197,meiner,0,0,3,3
32577,مزعج,0,0,3,3
32553,evolved,0,0,3,3
5502,trucco,1,3,0,3
33189,المثال،,0,0,3,3
33187,voz,0,0,3,3
43357,spreken,0,0,3,3
49973,ಕ್ಷಮಿಸು,0,0,3,3
43182,torno,0,0,3,3
33180,ولكني,0,0,3,3
49966,मल्टीमीडिया,0,0,3,3
32552,يسمى,0,0,3,3
71,account,2,2,1,3
33217,ವಾರಾಂತ್ಯದಲ್ಲಿ,0,0,3,3
32520,словам,0,0,3,3
32522,läsarna,0,0,3,3
52718,ilegal,0,0,3,3
16619,biográficos,0,0,3,3
5541,sostiene,1,3,0,3
5540,correggere,1,3,0,3
2898,eugene,2,1,2,3
33216,äußerst,0,0,3,3
43177,απόψεις,0,0,3,3
33215,lição,0,0,3,3
16915,graus,0,0,3,3
43368,candidat,0,0,3,3
50147,penser,0,0,3,3
43367,volcanic,0,0,3,3
43366,बनी,0,0,3,3
32544,güzelliği,0,0,3,3
5156,fa.,1,3,0,3
33172,ഓൺ‌ലൈൻ,0,0,3,3
16684,encyklopædi,0,0,3,3
50,situazioni,1,3,0,3
16853,الإناث,0,0,3,3
32687,άπταιστα,0,0,3,3
52,trasmettere,1,3,0,3
50014,studenter,0,0,3,3
32692,البداية,0,0,3,3
16670,ಎಲ್ಲಾ,0,0,3,3
43337,surtout,0,0,3,3
43334,आ,0,0,3,3
16860,maken,0,0,3,3
5408,libertà,1,3,0,3
16676,toward,0,0,3,3
50135,kunna,0,0,3,3
2928,ricca,1,3,0,3
16843,करके,0,0,3,3
43222,escuchando,0,0,3,3
33077,ज्ञान,0,0,3,3
5426,forti,1,3,0,3
43208,आसानी,0,0,3,3
43190,agriculture,0,0,3,3
5463,rimasta,1,3,0,3
5159,by-sa,1,3,0,3
16888,குழப்பமான,0,0,3,3
32612,بالطبع,0,0,3,3
33164,ذلك؟,0,0,3,3
49988,देखने,0,0,3,3
67,uniti,1,3,0,3
49992,southern,0,0,3,3
5461,significativamente,2,1,2,3
2933,wikisource,2,1,2,3
65,l'identificazione,1,3,0,3
33154,appuyant,0,0,3,3
33153,línguas,0,0,3,3
32633,atroces,0,0,3,3
33143,syfte,0,0,3,3
5161,smetti,1,3,0,3
43202,«фаза,0,0,3,3
16442,vilja,0,0,3,3
5973,leo,2,2,1,3
31950,ಇದೆ,0,0,3,3
17447,libros,0,0,3,3
31259,публикаций,0,0,3,3
6484,simili.,1,3,0,3
31264,författaren,0,0,3,3
31270,obtuve,0,0,3,3
2808,Le,1,3,0,3
31278,вялым,0,0,3,3
33997,என்னவென்றால்,0,0,3,3
49511,laver,0,0,3,3
43618,ஒன்று,0,0,3,3
33990,lastige,0,0,3,3
2812,[richiede,1,3,0,3
6457,discussioni,1,3,0,3
6456,liquida,1,3,0,3
6455,stampate,1,3,0,3
6454,sala,2,2,1,3
16265,atmospheric,0,0,3,3
6488,strategie,1,3,0,3
31228,match,0,0,3,3
16266,अलविदा,0,0,3,3
43624,стала,0,0,3,3
31179,resolver,0,0,3,3
17484,acquisition,0,0,3,3
52601,regulares,0,0,3,3
34067,இருந்தார்,0,0,3,3
17479,fortfarande,0,0,3,3
34061,கவனித்துக்,0,0,3,3
6520,otto,1,3,0,3
34056,μπήκε,0,0,3,3
6500,xx,2,1,2,3
49490,interested,0,0,3,3
31210,tittar,0,0,3,3
43623,ಅಳುವುದು,0,0,3,3
6505,brand,2,1,2,3
6504,rappresentata,1,3,0,3
34049,использую,0,0,3,3
52604,aparece,0,0,3,3
31318,английский,0,0,3,3
6444,collegamento,1,3,0,3
31177,سمعت,0,0,3,3
6390,noti,1,3,0,3
52619,marché,0,0,3,3
4925,precedenti,1,3,0,3
17402,graves,0,0,3,3
17401,المتخصصين,0,0,3,3
2824,certamente,2,2,1,3
31407,daarmee,0,0,3,3
33923,carefully,0,0,3,3
2825,rocciose,1,3,0,3
33940,thème,0,0,3,3
17397,ouvrages,0,0,3,3
17395,συμφωνώ,0,0,3,3
50254,opiniões,0,0,3,3
284,ecco,1,3,0,3
50253,incluant,0,0,3,3
49559,جون,0,0,3,3
17389,kendi,0,0,3,3
33927,catalan,0,0,3,3
16281,şeyin,0,0,3,3
6443,classificato,1,3,0,3
33956,approche,0,0,3,3
17434,criador,0,0,3,3
6441,finché,1,3,0,3
2814,sistemico,1,3,0,3
301,fotografica,1,3,0,3
17426,förvånad,0,0,3,3
16275,querer,0,0,3,3
16276,observaciones,0,0,3,3
42840,தங்கள்,0,0,3,3
31379,poursuit,0,0,3,3
31363,parecia,0,0,3,3
31364,avond,0,0,3,3
33951,voorbaat,0,0,3,3
6418,sostanza,1,3,0,3
33948,φιλικός,0,0,3,3
33944,söylemenin,0,0,3,3
31378,пришли,0,0,3,3
6536,preoccupazioni,1,3,0,3
17488,received,0,0,3,3
42990,σκληρότερα,0,0,3,3
42753,പോലും,0,0,3,3
51308,pleurer,0,0,3,3
34176,माफ,0,0,3,3
31010,يطلب,0,0,3,3
52584,sekund,0,0,3,3
49425,αγαπητέ,0,0,3,3
345,spam,2,1,2,3
49427,വിക്കി,0,0,3,3
49430,développe,0,0,3,3
6658,interni,1,3,0,3
43651,actividades,0,0,3,3
4870,primaria,2,2,1,3
31026,ಹಿಡಿಯಲಿಲ್ಲ,0,0,3,3
31029,foutieve,0,0,3,3
31038,شعبية,0,0,3,3
34157,स्वीकार,0,0,3,3
31041,üben,0,0,3,3
17565,général,0,0,3,3
30999,содержимое,0,0,3,3
16198,версий,0,0,3,3
30970,yorum,0,0,3,3
50285,bör,0,0,3,3
49405,συνηθισμένο,0,0,3,3
49407,covers,0,0,3,3
6691,altri.,1,3,0,3
34209,variable,0,0,3,3
17581,fiche,0,0,3,3
30966,നിങ്ങൾക്കറിയില്ല,0,0,3,3
34201,ഓൺലൈൻ,0,0,3,3
34183,считается,0,0,3,3
50281,tendens,0,0,3,3
4858,dedicato,1,3,0,3
30975,escrever,0,0,3,3
42737,pois,0,0,3,3
49415,zuilen,0,0,3,3
30985,jimbo,0,0,3,3
17572,ಮುಂಚಿತವಾಗಿ,0,0,3,3
49439,dijo,0,0,3,3
3014,farina,2,2,1,3
42790,devenues,0,0,3,3
2801,meteorologiche,1,3,0,3
31119,intérieur,0,0,3,3
31120,откуда,0,0,3,3
31121,onto,0,0,3,3
42774,próximo,0,0,3,3
34105,auktoritet,0,0,3,3
43633,ಒಳ್ಳೆಯ,0,0,3,3
6559,bradley,2,1,2,3
6557,previsione,1,3,0,3
4883,importava,2,2,1,3
31149,σκορ,0,0,3,3
4891,communications,2,1,2,3
34093,veracidad,0,0,3,3
16225,cartoon,0,0,3,3
17502,cofondateur,0,0,3,3
17499,العام,0,0,3,3
52600,доступны,0,0,3,3
52594,elsker,0,0,3,3
31115,robotskapade,0,0,3,3
31058,işe,0,0,3,3
49450,ofensivo,0,0,3,3
49443,advanced,0,0,3,3
31064,passar,0,0,3,3
42759,слушал,0,0,3,3
6612,tentano,1,3,0,3
17536,stationära,0,0,3,3
49449,प्रतिपादन,0,0,3,3
6607,considerando,1,3,0,3
16207,juridique,0,0,3,3
6584,enciclopedia.,1,3,0,3
31082,onunla,0,0,3,3
31095,பயனர்,0,0,3,3
31096,chamados,0,0,3,3
31100,kenmerken,0,0,3,3
17525,modificar,0,0,3,3
49460,ανησυχείς,0,0,3,3
6586,"wikimedia,",1,3,0,3
31438,contraire,0,0,3,3
4938,cibi,1,3,0,3
6359,posto.,1,3,0,3
33704,सहायता,0,0,3,3
31730,ಸೌಂದರ್ಯವನ್ನು,0,0,3,3
17272,capaz,0,0,3,3
2849,supervisionate,1,3,0,3
33715,tras,0,0,3,3
49665,gäller,0,0,3,3
43523,wikikod,0,0,3,3
6125,raggi,1,3,0,3
50224,roughly,0,0,3,3
31727,gelukkig,0,0,3,3
42942,المتحدة,0,0,3,3
42947,biliyorum,0,0,3,3
31771,говорил,0,0,3,3
33686,devons,0,0,3,3
6105,parole.,1,3,0,3
33684,talen,0,0,3,3
49678,пользователи,0,0,3,3
33720,ediyorum,0,0,3,3
6151,induttivo,1,3,0,3
31789,φαίνεται,0,0,3,3
49650,образом,0,0,3,3
50231,большой,0,0,3,3
4978,scienziati,1,3,0,3
49646,konversationen,0,0,3,3
31697,realizan,0,0,3,3
6167,riprodurre,1,3,0,3
52650,obtener,0,0,3,3
31705,اسم,0,0,3,3
17280,statistiques,0,0,3,3
49656,söyle,0,0,3,3
33732,italien,0,0,3,3
6161,aggiuntive,1,3,0,3
17278,dinheiro,0,0,3,3
6158,proposte,1,3,0,3
31712,nphard,0,0,3,3
43533,fournir,0,0,3,3
49655,später,0,0,3,3
2987,commenti,1,3,0,3
33664,समान,0,0,3,3
6357,sottoinsiemi,1,3,0,3
2977,ministro,2,2,1,3
49712,abonnieren,0,0,3,3
6025,connessione,1,3,0,3
42976,hadi,0,0,3,3
31894,നോക്കി,0,0,3,3
17207,letar,0,0,3,3
5009,correzione,1,3,0,3
33600,shift,0,0,3,3
6006,conseguenza.,1,3,0,3
215,vettore,1,3,0,3
49728,hungrig,0,0,3,3
43488,اجتماع,0,0,3,3
5994,interrompendo,2,2,1,3
31925,മുമ്പ്,0,0,3,3
43486,negativ,0,0,3,3
43485,ontwikkeling,0,0,3,3
43483,أحدث,0,0,3,3
6035,«una,2,1,2,3
42969,unit,0,0,3,3
33658,betydligt,0,0,3,3
17235,सुनहरी,0,0,3,3
51210,extent,0,0,3,3
6085,sostituito,1,3,0,3
6083,cercano,1,3,0,3
6077,arrivo,1,3,0,3
31823,позднее,0,0,3,3
33654,autant,0,0,3,3
31825,skrev,0,0,3,3
31831,declaraciones,0,0,3,3
6043,iscrizione,1,3,0,3
5000,pubblicati,1,3,0,3
31833,सहमति,0,0,3,3
6063,pilastri,1,3,0,3
51282,serves,0,0,3,3
33629,capacités,0,0,3,3
42966,விட,0,0,3,3
5005,unicamente,1,3,0,3
42923,либо,0,0,3,3
6193,cambiamento,1,3,0,3
242,reputazione,1,3,0,3
42877,നിർദ്ദേശങ്ങൾ,0,0,3,3
33866,ampla,0,0,3,3
6306,iniziale,1,3,0,3
31506,φυσικά,0,0,3,3
17357,पहुँच,0,0,3,3
31513,θέλατε,0,0,3,3
6298,ieri,1,3,0,3
43566,അധികം,0,0,3,3
42882,lyssnade,0,0,3,3
33869,conçu,0,0,3,3
49597,करेंगे,0,0,3,3
6290,nucleo,1,3,0,3
4948,legato,1,3,0,3
52631,നാളെ,0,0,3,3
2837,micro,2,1,2,3
2838,dominio,2,2,1,3
3000,vocale,2,2,1,3
43570,ಬಹುಶಃ,0,0,3,3
31498,scientists,0,0,3,3
50232,bald,0,0,3,3
6338,Washington,1,3,0,3
31450,تيري,0,0,3,3
279,scrivendo,1,3,0,3
16300,edebilir,0,0,3,3
33893,economics,0,0,3,3
33892,comptes,0,0,3,3
43581,compostura,0,0,3,3
277,classiche,1,3,0,3
6336,passata,1,3,0,3
6314,solamente,2,1,2,3
33886,documents,0,0,3,3
49581,ಪ್ರಿಯ,0,0,3,3
17375,fichier,0,0,3,3
273,stagno,1,3,0,3
16311,पोर्टल,0,0,3,3
43572,portent,0,0,3,3
6316,creando,2,1,2,3
6279,testa,1,3,0,3
6278,pnina,2,1,2,3
31538,இருப்பதாக,0,0,3,3
49626,нее,0,0,3,3
2843,respinto,1,3,0,3
31602,reiß,0,0,3,3
17315,dedicada,0,0,3,3
17309,amateur,0,0,3,3
6226,miglioramenti,1,3,0,3
31625,conduit,0,0,3,3
16353,بأنه,0,0,3,3
43545,brought,0,0,3,3
42886,sagte,0,0,3,3
6210,critiche,1,3,0,3
33782,låta,0,0,3,3
31637,schaltfläche,0,0,3,3
51203,entire,0,0,3,3
247,sembrano,1,3,0,3
17294,underrepresented,0,0,3,3
17293,gek,0,0,3,3
259,dell'arte,1,3,0,3
31585,pidiendo,0,0,3,3
31583,редактирования,0,0,3,3
6241,grammatica,2,2,1,3
6274,inizio,1,3,0,3
31543,sannolikt,0,0,3,3
6271,stime,1,3,0,3
6268,pazienza,1,3,0,3
31552,liées,0,0,3,3
42894,primordial,0,0,3,3
6259,sorprende,2,2,1,3
50244,answers,0,0,3,3
6256,lila,2,1,2,3
33827,savoirs,0,0,3,3
33825,atividades,0,0,3,3
33824,δάχτυλα,0,0,3,3
6252,informazioni.,1,3,0,3
33820,vroeg,0,0,3,3
31580,repetidas,0,0,3,3
28738,sürümü,0,0,3,3
4617,interattiva,1,3,0,3
44057,моем,0,0,3,3
44399,ortega,0,0,3,3
19279,प्रश्न,0,0,3,3
9734,റോന്ദേവൂ,0,0,3,3
19270,ήθελα,0,0,3,3
1114,annegare,1,3,0,3
9726,dinero,0,0,3,3
9721,acquis,0,0,3,3
36205,நீ,0,0,3,3
36207,करो।,0,0,3,3
41649,läuft,0,0,3,3
27794,نص,0,0,3,3
36856,filtros,0,0,3,3
44400,russian,0,0,3,3
2556,cibo.,1,3,0,3
41638,klinkt,0,0,3,3
26813,النرجس,0,0,3,3
9000,nomi,1,3,0,3
27773,градусов,0,0,3,3
36850,woher,0,0,3,3
41656,bibliotecarios,0,0,3,3
36229,kender,0,0,3,3
9006,l'approccio,1,3,0,3
36843,abend,0,0,3,3
27767,rolle,0,0,3,3
9010,l'editing,1,3,0,3
27756,declaró,0,0,3,3
47778,задачи,0,0,3,3
36194,grammatik,0,0,3,3
27828,déclare,0,0,3,3
44414,πρόβλημα,0,0,3,3
27879,verá,0,0,3,3
27897,गणित,0,0,3,3
943,recupero,1,3,0,3
47735,onun,0,0,3,3
47736,источник,0,0,3,3
48266,elke,0,0,3,3
27889,visat,0,0,3,3
9766,revert,0,0,3,3
8939,classificata,1,3,0,3
36146,البعض,0,0,3,3
41919,विकिबुक्स,0,0,3,3
27880,synonyme,0,0,3,3
47737,कॉमन्स,0,0,3,3
47738,decisão,0,0,3,3
8980,Center,1,3,0,3
1124,sequenze,1,3,0,3
47740,απόγευμα,0,0,3,3
27876,insanların,0,0,3,3
52187,таким,0,0,3,3
9753,बनाती,0,0,3,3
48257,bloggar,0,0,3,3
51425,ತೆಗೆದುಕೊಳ್ಳಬೇಡಿ,0,0,3,3
19302,düzeltme,0,0,3,3
26754,açık,0,0,3,3
15318,utiles,0,0,3,3
36166,punktzahl,0,0,3,3
26757,clase,0,0,3,3
27754,επαναλάβετε,0,0,3,3
44224,mener,0,0,3,3
48222,кроме,0,0,3,3
26879,oxygen,0,0,3,3
9056,strategia,1,3,0,3
36812,receio,0,0,3,3
4274,marketing,2,2,1,3
9668,καθόλου,0,0,3,3
969,raccomandazione,1,3,0,3
41864,evaluated,0,0,3,3
47798,еда,0,0,3,3
47800,своих,0,0,3,3
9663,décisions,0,0,3,3
971,basate,1,3,0,3
3231,guinness,1,3,0,3
36806,الصوت,0,0,3,3
9658,наличие,0,0,3,3
26838,estávamos,0,0,3,3
44238,farvel,0,0,3,3
974,simbolici,1,3,0,3
48188,registered,0,0,3,3
9075,cena,2,2,1,3
51100,organisatie,0,0,3,3
48186,træk,0,0,3,3
27657,الحياة,0,0,3,3
15030,όνομα,0,0,3,3
44242,مثير,0,0,3,3
27635,l’algorithme,0,0,3,3
9094,fazladan,0,0,3,3
48176,titan,0,0,3,3
44391,comentário,0,0,3,3
47793,pratiques,0,0,3,3
9677,foiré,0,0,3,3
48199,التقاء,0,0,3,3
26839,मीड़याविकी,0,0,3,3
9021,IP,1,3,0,3
4164,perceptrons,2,1,2,3
48217,पाठक,0,0,3,3
15288,işi,0,0,3,3
27735,tecnología,0,0,3,3
27734,ωραία,0,0,3,3
26842,थोड़ा,0,0,3,3
36834,ಚಿನ್ನದಿಂದ,0,0,3,3
36831,acquérir,0,0,3,3
26847,croate,0,0,3,3
27725,kjole,0,0,3,3
36252,λάβετε,0,0,3,3
27721,sons,0,0,3,3
9040,consentendo,1,3,0,3
41866,vår,0,0,3,3
9684,ഡിഗ്രിയിൽ,0,0,3,3
52200,sump,0,0,3,3
50561,weer,0,0,3,3
44231,conseguir,0,0,3,3
36823,eliminan,0,0,3,3
4168,branca,1,3,0,3
9679,нейросети,0,0,3,3
18926,σύντομα,0,0,3,3
15278,americans,0,0,3,3
44412,большинство,0,0,3,3
8928,apprendono,1,3,0,3
36783,दोहरान,0,0,3,3
36041,rahatsız,0,0,3,3
19354,είχα,0,0,3,3
28063,enklare,0,0,3,3
1142,affidabile,1,3,0,3
8813,popolare,1,3,0,3
9852,organisation,0,0,3,3
28059,συμβουλή,0,0,3,3
8816,bloomberg,2,1,2,3
1141,sporco,1,3,0,3
14961,بكل,0,0,3,3
19349,गए।,0,0,3,3
15369,akzeptiere,0,0,3,3
4327,modo.,1,3,0,3
8823,conoscenze,1,3,0,3
28071,कपड़े,0,0,3,3
28053,propres,0,0,3,3
8825,energetica,1,3,0,3
28052,usarse,0,0,3,3
14968,ಟದ,0,0,3,3
28050,पाठ्यक्रम,0,0,3,3
8831,definire,1,3,0,3
902,vengano,1,3,0,3
36048,annulations,0,0,3,3
8837,creano,1,3,0,3
14969,considerada,0,0,3,3
36049,ഓരോ,0,0,3,3
26643,reverting,0,0,3,3
41956,richtig,0,0,3,3
36030,viki,0,0,3,3
18838,licens,0,0,3,3
19371,utöver,0,0,3,3
37012,sesgo,0,0,3,3
8759,commentato,1,3,0,3
18756,humanos,0,0,3,3
9887,ഒപ്പം,0,0,3,3
18765,membros,0,0,3,3
48354,levou,0,0,3,3
4340,tosh,2,1,2,3
44442,grundades,0,0,3,3
28117,maj,0,0,3,3
36004,individus,0,0,3,3
44172,அதைச்,0,0,3,3
44173,ನುಡಿಗಟ್ಟುಗಳು,0,0,3,3
18783,apparence,0,0,3,3
36027,مرحباً,0,0,3,3
28096,مراجعة,0,0,3,3
36984,ouvert,0,0,3,3
36014,obtenez,0,0,3,3
26598,coordenar,0,0,3,3
52310,prose,0,0,3,3
36019,erklärt,0,0,3,3
28084,فضلك,0,0,3,3
36024,στείλω,0,0,3,3
48339,лучший,0,0,3,3
8802,henry,2,1,2,3
51419,proposal,0,0,3,3
18788,réaliser,0,0,3,3
41944,alternativas,0,0,3,3
28032,നൽകും,0,0,3,3
8846,determinata,1,3,0,3
9787,இருக்கும்போது,0,0,3,3
50626,कवरेज़,0,0,3,3
9803,sujets,0,0,3,3
3168,'60,1,3,0,3
1132,imprecisioni,1,3,0,3
44196,தமிழ்,0,0,3,3
8896,arti,1,3,0,3
15342,söka,0,0,3,3
41928,ursprung,0,0,3,3
27939,نطاق,0,0,3,3
18832,ouvindo,0,0,3,3
36925,sparsely,0,0,3,3
26697,விற்றீர்கள்,0,0,3,3
52288,фразу,0,0,3,3
36063,full,0,0,3,3
48280,mauvais,0,0,3,3
27928,комментариев,0,0,3,3
18835,planets,0,0,3,3
9783,«un,0,0,3,3
8916,etichettati,1,3,0,3
44200,studenterna,0,0,3,3
27908,feita,0,0,3,3
8921,stavano,1,3,0,3
8923,conclusioni,1,3,0,3
8925,luce,1,3,0,3
19317,doet,0,0,3,3
27903,друг,0,0,3,3
44421,нам,0,0,3,3
4318,cinema,2,2,1,3
2490,permette,1,3,0,3
44194,silver,0,0,3,3
912,debba,1,3,0,3
52181,утверждал,0,0,3,3
47695,சொன்னேன்,0,0,3,3
47696,artık,0,0,3,3
48311,träsk,0,0,3,3
28015,cour,0,0,3,3
9831,olmayan,0,0,3,3
26645,escala,0,0,3,3
913,produzione,1,3,0,3
9829,llorar,0,0,3,3
19336,klaga,0,0,3,3
27987,духе,0,0,3,3
36955,dicen,0,0,3,3
27980,πολλές,0,0,3,3
18819,gentils,0,0,3,3
26656,അടുത്തേക്ക്,0,0,3,3
15354,കഠിനാധ്വാനം,0,0,3,3
8875,preprocessing,2,1,2,3
18824,frygtelig,0,0,3,3
26663,desafios,0,0,3,3
9816,üzerinde,0,0,3,3
36096,spécifiques,0,0,3,3
1135,occorrenze,1,3,0,3
47708,stoor,0,0,3,3
927,contenenti,1,3,0,3
19233,vind,0,0,3,3
26909,vinden,0,0,3,3
44164,ángel,0,0,3,3
41767,esperar,0,0,3,3
27304,narcissism,0,0,3,3
9526,estimates,0,0,3,3
15165,മാർഗ്ഗം,0,0,3,3
52212,recientes,0,0,3,3
36531,ess,0,0,3,3
27295,पड़ता,0,0,3,3
27294,ബ്രെഡ്,0,0,3,3
27293,historia,0,0,3,3
41701,huvudsak,0,0,3,3
48014,конце,0,0,3,3
19072,mídia,0,0,3,3
15163,trabalhos,0,0,3,3
41711,வேலையில்,0,0,3,3
36518,almindelige,0,0,3,3
41759,lucrativos,0,0,3,3
19084,remove,0,0,3,3
48005,قائمة,0,0,3,3
47897,रोना,0,0,3,3
4228,"rocce,",1,3,0,3
47898,comunidades,0,0,3,3
27272,يقوم,0,0,3,3
27270,combatir,0,0,3,3
52227,recomponha,0,0,3,3
9363,instalación,0,0,3,3
9365,adequada,0,0,3,3
36549,разговоре,0,0,3,3
27055,included,0,0,3,3
2516,rami,1,3,0,3
9279,ελεύθερος,0,0,3,3
9545,volonté,0,0,3,3
4237,porta,1,3,0,3
27023,ആവശ്യപ്പെടുന്നു,0,0,3,3
44295,ثلاثة,0,0,3,3
1023,assicurati,1,3,0,3
27357,घटनाओं,0,0,3,3
36493,elbette,0,0,3,3
27031,kleine,0,0,3,3
48043,чемнибудь,0,0,3,3
27355,incorporado,0,0,3,3
41689,ശനിയാഴ്ച,0,0,3,3
27354,keep,0,0,3,3
44297,объясняет,0,0,3,3
27348,خبز,0,0,3,3
47887,ஆச்சரியமாக,0,0,3,3
47881,piece,0,0,3,3
27040,highest,0,0,3,3
9304,droeg,0,0,3,3
27343,tornar,0,0,3,3
48035,elegidos,0,0,3,3
19056,geschreven,0,0,3,3
47884,fortalte,0,0,3,3
41777,permission,0,0,3,3
36510,ämnet,0,0,3,3
9321,सहित,0,0,3,3
9322,serai,0,0,3,3
36682,abone,0,0,3,3
9511,विकिसमाचार,0,0,3,3
1040,aspetta,1,3,0,3
36672,passiert,0,0,3,3
41724,ran,0,0,3,3
52222,believed,0,0,3,3
19146,модели,0,0,3,3
4205,secolo,1,3,0,3
36597,categorías,0,0,3,3
47960,प्रसिद्ध,0,0,3,3
27187,similarly,0,0,3,3
47925,linterweb,0,0,3,3
27183,மதிப்பெண்,0,0,3,3
15104,existem,0,0,3,3
41743,получить,0,0,3,3
9465,மதிய,0,0,3,3
51440,आधार,0,0,3,3
19143,melhores,0,0,3,3
47901,rica,0,0,3,3
27167,bloqueios,0,0,3,3
36612,old,0,0,3,3
19142,présent,0,0,3,3
36623,يقدم,0,0,3,3
27149,actes,0,0,3,3
36641,harcèlement,0,0,3,3
44341,entrenamiento,0,0,3,3
9441,ವಿದಾಯ,0,0,3,3
19130,swamp,0,0,3,3
47942,américain,0,0,3,3
9446,globorompecabezas,0,0,3,3
15116,yaygın,0,0,3,3
44329,மனதில்,0,0,3,3
27102,överbelastad,0,0,3,3
19109,unlabeled,0,0,3,3
47970,additional,0,0,3,3
15151,варенье,0,0,3,3
1066,scala,1,3,0,3
47903,செய்கிறீர்கள்,0,0,3,3
47904,tijdschrift,0,0,3,3
27240,digits,0,0,3,3
9500,πόσο,0,0,3,3
9383,आए,0,0,3,3
27081,systematic,0,0,3,3
19096,அமெரிக்கர்கள்,0,0,3,3
52215,publikationer,0,0,3,3
4216,proviene,2,2,1,3
47979,எப்படியும்,0,0,3,3
19160,skriver,0,0,3,3
51084,effets,0,0,3,3
41752,επιπλέον,0,0,3,3
41751,machinaal,0,0,3,3
9493,इतने,0,0,3,3
9397,sorge,0,0,3,3
15096,μοίρες,0,0,3,3
27091,computacional,0,0,3,3
19106,लगाने,0,0,3,3
9403,bekymret,0,0,3,3
4203,prese,1,3,0,3
1048,maniera,1,3,0,3
9484,أيضا,0,0,3,3
27020,സ്നേഹിക്കുന്നു,0,0,3,3
27019,mooi,0,0,3,3
9640,встречи,0,0,3,3
26948,crecimiento,0,0,3,3
27555,gelip,0,0,3,3
994,andasse,1,3,0,3
36368,phénomènes,0,0,3,3
4182,batteri,1,3,0,3
48135,conteúdos,0,0,3,3
36761,الاشتراك,0,0,3,3
48130,entrevista,0,0,3,3
27542,fully,0,0,3,3
41667,dejligt,0,0,3,3
48128,unglaublich,0,0,3,3
995,informatica,2,2,1,3
36757,പോലുള്ള,0,0,3,3
36756,marmelade,0,0,3,3
36366,grote,0,0,3,3
27539,знаний,0,0,3,3
9171,sollten,0,0,3,3
9175,sad,0,0,3,3
1085,suono,1,3,0,3
41834,bygger,0,0,3,3
36381,grundare,0,0,3,3
26953,sabia,0,0,3,3
27530,डिग्री,0,0,3,3
997,numeri,1,3,0,3
26954,leve,0,0,3,3
19223,ट्रेफिक,0,0,3,3
19222,money,0,0,3,3
9619,लिखी,0,0,3,3
18971,لإزعاجك,0,0,3,3
9275,lätt,0,0,3,3
48161,methodes,0,0,3,3
36321,двое,0,0,3,3
27618,മുഴുവൻ,0,0,3,3
26912,estimé,0,0,3,3
19231,endereços,0,0,3,3
27615,ol,0,0,3,3
18949,japonesa,0,0,3,3
27610,akıllıca,0,0,3,3
27607,ಅದ್ಭುತವಾದ,0,0,3,3
3226,commons.,1,3,0,3
36334,مجلة,0,0,3,3
18950,n’a,0,0,3,3
52259,fragt,0,0,3,3
9124,задач,0,0,3,3
15045,തെറ്റ്,0,0,3,3
44383,zelfs,0,0,3,3
48159,engelske,0,0,3,3
1091,diventato,1,3,0,3
27588,rend,0,0,3,3
9133,الولايات,0,0,3,3
4179,categorizzazione,1,3,0,3
26924,användning,0,0,3,3
9624,förstå,0,0,3,3
27582,മിക്കവാറും,0,0,3,3
9623,utilisateur,0,0,3,3
15248,devido,0,0,3,3
3192,lumaca,1,3,0,3
52248,செல்லலாம்,0,0,3,3
27510,média,0,0,3,3
36400,καλός,0,0,3,3
15195,учёными,0,0,3,3
28732,मार्क,0,0,3,3
27421,actualmente,0,0,3,3
48071,animales,0,0,3,3
15202,discussões,0,0,3,3
36456,ஏதேனும்,0,0,3,3
15200,heart,0,0,3,3
41679,permanence,0,0,3,3
4191,perry,2,1,2,3
15198,kocaman,0,0,3,3
50603,dil,0,0,3,3
4194,incidente,2,1,2,3
47868,فقدت,0,0,3,3
36713,வகையில்,0,0,3,3
27500,age,0,0,3,3
9263,istemiyorum,0,0,3,3
9562,board,0,0,3,3
27007,सितम्बर,0,0,3,3
50583,βιβλίο,0,0,3,3
19035,incomodálo,0,0,3,3
44292,hjärtat,0,0,3,3
9270,compute,0,0,3,3
48056,μέση,0,0,3,3
36712,نارسسا,0,0,3,3
36469,trotzdem,0,0,3,3
4238,ritengono,1,3,0,3
44369,lisansı,0,0,3,3
9239,nsa,0,0,3,3
44285,içeriğini,0,0,3,3
36723,أربعة,0,0,3,3
27441,несмотря,0,0,3,3
2539,venerdì,1,3,0,3
41822,attribution,0,0,3,3
41669,ഏത്,0,0,3,3
48104,procesos,0,0,3,3
36746,जर्नल,0,0,3,3
9599,αργά,0,0,3,3
48100,editörlerin,0,0,3,3
15220,νάρκισσος,0,0,3,3
9598,وصلت,0,0,3,3
4251,determinato,1,3,0,3
41816,artisan,0,0,3,3
47847,अमेरिकन,0,0,3,3
9595,beide,0,0,3,3
36744,приятно,0,0,3,3
48094,barnpornografi,0,0,3,3
27455,neuronas,0,0,3,3
36742,अनुरोधों,0,0,3,3
15054,expressions,0,0,3,3
19012,d’une,0,0,3,3
47853,ಅವರ,0,0,3,3
26979,molestarte,0,0,3,3
48086,ஆரம்பித்தாள்,0,0,3,3
41675,ടിപ്പ്,0,0,3,3
48084,لإنشاء,0,0,3,3
41808,schrecklich,0,0,3,3
26552,ಮುಂದೆ,0,0,3,3
15347,फ़्रिसियाई,0,0,3,3
9975,நுபீடியாவின்,0,0,3,3
28341,εμένα,0,0,3,3
51118,திருமணம்,0,0,3,3
8405,settore,1,3,0,3
3131,conflitto,1,3,0,3
18561,ഫ്ലമ്മോക്സ്,0,0,3,3
50509,mitten,0,0,3,3
851,personalmente,2,2,1,3
19435,préalablement,0,0,3,3
26419,º,0,0,3,3
41546,featured,0,0,3,3
35858,कॉल,0,0,3,3
28628,गुप्त,0,0,3,3
28334,envoyer,0,0,3,3
42099,bed,0,0,3,3
4389,dirlo,1,3,0,3
8397,cifre,1,3,0,3
18546,moved,0,0,3,3
9987,ഇതാണ്,0,0,3,3
26248,periódico,0,0,3,3
9985,πάμε,0,0,3,3
35875,considérés,0,0,3,3
26256,पूछते,0,0,3,3
15462,behavioral,0,0,3,3
8406,perché.,1,3,0,3
26257,falsk,0,0,3,3
18571,doğruluğu,0,0,3,3
28594,langsomt,0,0,3,3
28381,soucis,0,0,3,3
28375,eletrônico,0,0,3,3
28374,därmed,0,0,3,3
47543,कृपया,0,0,3,3
18653,أستخدمها,0,0,3,3
35684,orthographe,0,0,3,3
44493,γουέιλς,0,0,3,3
8574,tentativi,1,3,0,3
35679,hayek,0,0,3,3
26398,aplicación,0,0,3,3
19514,hoofdredacteur,0,0,3,3
4400,bad,2,1,2,3
28358,científico,0,0,3,3
10003,host,0,0,3,3
42039,constant,0,0,3,3
28612,வகையானது,0,0,3,3
18658,licentie,0,0,3,3
42034,apoyo,0,0,3,3
4383,prime,1,3,0,3
42008,прямо,0,0,3,3
28647,verblüfft,0,0,3,3
26462,ಅಲ್ಲ,0,0,3,3
18539,innehåller,0,0,3,3
26465,खींचते,0,0,3,3
48421,റോക്ക്,0,0,3,3
3159,fisiche,1,3,0,3
48553,comunes,0,0,3,3
4088,costituisce,1,3,0,3
42016,الويكيبيديا,0,0,3,3
15440,हों।,0,0,3,3
35653,കയറി,0,0,3,3
4110,flore,2,2,1,3
35892,αργότερα,0,0,3,3
28282,considers,0,0,3,3
9956,repetirlo,0,0,3,3
8374,comprese,1,3,0,3
19524,eliminar,0,0,3,3
48415,முன்பு,0,0,3,3
35902,μιας,0,0,3,3
42112,ακριβώς,0,0,3,3
51411,πάρετε,0,0,3,3
50517,ಕೇಳಿದ್ದೀರಿ,0,0,3,3
14854,जनमत,0,0,3,3
19418,abaixo,0,0,3,3
48423,siz,0,0,3,3
50645,environnementaux,0,0,3,3
50515,громадно,0,0,3,3
35664,vidste,0,0,3,3
44497,hvem,0,0,3,3
18543,dinlemiyordum,0,0,3,3
37084,بـ,0,0,3,3
35663,skrivna,0,0,3,3
50644,existencia,0,0,3,3
1186,incarichi,1,3,0,3
35656,automated,0,0,3,3
51467,expert,0,0,3,3
8381,potevo,1,3,0,3
44498,doce,0,0,3,3
50643,запрос,0,0,3,3
8622,assolutamente,1,3,0,3
41491,olma,0,0,3,3
47618,criança,0,0,3,3
50516,बनाना।,0,0,3,3
18689,esos,0,0,3,3
50504,beim,0,0,3,3
28382,ones,0,0,3,3
2475,guadagnato,1,3,0,3
4432,completo,2,1,2,3
10059,chercheurs,0,0,3,3
829,soglia,1,3,0,3
28532,الموسوعة،,0,0,3,3
35729,vor,0,0,3,3
18587,φράσης,0,0,3,3
52346,tacka,0,0,3,3
26365,nio,0,0,3,3
1208,tipico,1,3,0,3
10025,thèmes,0,0,3,3
28452,contenant,0,0,3,3
2465,mese.,1,3,0,3
10062,torna,0,0,3,3
48481,före,0,0,3,3
28451,oraciones,0,0,3,3
42058,trek,0,0,3,3
8451,l'insegnante,1,3,0,3
28445,básicos,0,0,3,3
37132,ಧನ್ಯವಾದ,0,0,3,3
26296,webbläsare,0,0,3,3
19506,другим,0,0,3,3
47560,lycklig,0,0,3,3
42074,wapedia,0,0,3,3
37141,arkadaşlarınız,0,0,3,3
8468,nupedia.,1,3,0,3
19497,сайта,0,0,3,3
8477,verbale,2,2,1,3
18607,вещи,0,0,3,3
18598,ruim,0,0,3,3
4424,rimasto,1,3,0,3
41511,throughout,0,0,3,3
44095,θέλει,0,0,3,3
4106,"luglio,",1,3,0,3
8473,consultazione,1,3,0,3
35759,grands,0,0,3,3
28519,forskningspublikationer,0,0,3,3
2603,mostrano,1,3,0,3
2601,dai.,1,3,0,3
8501,creek,2,1,2,3
42060,participação,0,0,3,3
28471,الجديدة,0,0,3,3
10034,प्रोजेक्ट,0,0,3,3
14875,ഉണ്ട്,0,0,3,3
35784,contient,0,0,3,3
1211,coppie,1,3,0,3
35793,أستمع,0,0,3,3
4107,protette,1,3,0,3
18640,εγχειρήματα,0,0,3,3
51122,мечта,0,0,3,3
4436,shachaf,2,1,2,3
35704,لديهم,0,0,3,3
28569,commun,0,0,3,3
15476,tidsskrift,0,0,3,3
4410,confusione,1,3,0,3
44475,redo,0,0,3,3
48457,استمر,0,0,3,3
44117,प्रणाली,0,0,3,3
19508,организация,0,0,3,3
42048,jantar,0,0,3,3
814,controllati,1,3,0,3
28579,seit,0,0,3,3
1195,determinati,1,3,0,3
14867,प्रशासक,0,0,3,3
28391,ذهبية,0,0,3,3
28390,слышали,0,0,3,3
8564,francia,2,2,1,3
8425,chiunque.,1,3,0,3
28567,उससे,0,0,3,3
8544,strutture,1,3,0,3
52149,try,0,0,3,3
28416,लगाया,0,0,3,3
18637,horizontal,0,0,3,3
26377,vergelijking,0,0,3,3
37187,görs,0,0,3,3
1213,effetto,1,3,0,3
47551,opfyldelse,0,0,3,3
28431,இருப்பது,0,0,3,3
48470,miljoner,0,0,3,3
8532,affrontare,1,3,0,3
48467,بضع,0,0,3,3
15482,αυτούς,0,0,3,3
2613,associato,1,3,0,3
26282,शीर्षक,0,0,3,3
35806,«нупедия»,0,0,3,3
8541,l'aria,1,3,0,3
35709,değilim,0,0,3,3
18638,चार,0,0,3,3
10077,lema,0,0,3,3
26278,yoğun,0,0,3,3
50488,aandacht,0,0,3,3
52157,vikipedilerin,0,0,3,3
19490,darte,0,0,3,3
28224,ethical,0,0,3,3
28710,constituent,0,0,3,3
28712,perguntando,0,0,3,3
19533,devenu,0,0,3,3
28163,assise,0,0,3,3
28680,computadoras,0,0,3,3
48387,sunulmaktadır,0,0,3,3
28164,petite,0,0,3,3
8327,necessario,1,3,0,3
35642,ولم,0,0,3,3
28165,машинное,0,0,3,3
15415,universitaires,0,0,3,3
868,poter,1,3,0,3
35946,visste,0,0,3,3
28205,mathématique,0,0,3,3
786,altra,1,3,0,3
28218,realm,0,0,3,3
9923,maanden,0,0,3,3
26212,gutaussehend,0,0,3,3
10128,ലാറ്റിൻ,0,0,3,3
14930,ലേഖനങ്ങളും,0,0,3,3
9928,probability,0,0,3,3
8738,viventi.,1,3,0,3
48369,ಅಮೆರಿಕನ್ನರು,0,0,3,3
48394,precisión,0,0,3,3
10139,cambió,0,0,3,3
10140,seviyorum,0,0,3,3
8321,roccia,1,3,0,3
28230,cumartesi,0,0,3,3
28231,lohnt,0,0,3,3
3129,collaborativa,1,3,0,3
37040,மேற்பட்ட,0,0,3,3
35974,விரும்புகிறீர்கள்,0,0,3,3
15561,शब्दकोष,0,0,3,3
44152,ويمكن,0,0,3,3
50526,hyperlinks,0,0,3,3
35957,saknas,0,0,3,3
8721,randy,1,3,0,3
8723,stiamo,1,3,0,3
26527,καταπληκτικό,0,0,3,3
15405,используют,0,0,3,3
44063,discusiones,0,0,3,3
28685,antemano,0,0,3,3
4462,thomas,2,1,2,3
35969,listening,0,0,3,3
9913,bile,0,0,3,3
48375,concurso,0,0,3,3
50478,знать,0,0,3,3
18739,eua,0,0,3,3
41989,modified,0,0,3,3
8712,computer.,1,3,0,3
35629,reconnaissance,0,0,3,3
28199,οξεία,0,0,3,3
41990,ನಂಬರ್,0,0,3,3
41566,confiáveis,0,0,3,3
26524,நடுவில்,0,0,3,3
41992,tahmin,0,0,3,3
48570,ontving,0,0,3,3
47647,zustimmen,0,0,3,3
37030,criticou,0,0,3,3
15412,fort,0,0,3,3
37031,attributed,0,0,3,3
28682,espaces,0,0,3,3
19528,ஆமாம்,0,0,3,3
41488,عند,0,0,3,3
37236,φαινόταν,0,0,3,3
28704,studenten,0,0,3,3
8318,Come,1,3,0,3
8340,businessweek,2,2,1,3
44500,самое,0,0,3,3
10125,normalt,0,0,3,3
15565,entered,0,0,3,3
52162,sammenlignet,0,0,3,3
41978,ലോഗിൻ,0,0,3,3
28723,kanaal,0,0,3,3
28729,harte,0,0,3,3
10114,cheer,0,0,3,3
26225,idé,0,0,3,3
8368,affidamento,1,3,0,3
9950,möjligt,0,0,3,3
37230,underlying,0,0,3,3
52368,jullie,0,0,3,3
42122,termos,0,0,3,3
47525,عملية,0,0,3,3
19417,utvecklas,0,0,3,3
35977,lokalt,0,0,3,3
35918,nicholas,0,0,3,3
47528,extérieur,0,0,3,3
35922,ഖേദിക്കുന്നു,0,0,3,3
3267,l'algoritmo,1,3,0,3
9943,middle,0,0,3,3
26232,samtale,0,0,3,3
37229,escreve,0,0,3,3
8754,animale,1,3,0,3
1178,espandere,1,3,0,3
8365,storicamente,1,3,0,3
10126,yi,0,0,3,3
4345,stone,2,1,2,3
792,risultando,1,3,0,3
28719,enviarle,0,0,3,3
37061,ihn,0,0,3,3
26192,gehad,0,0,3,3
28718,challenges,0,0,3,3
28258,geldi,0,0,3,3
42113,बड़े,0,0,3,3
35984,posé,0,0,3,3
26482,материалов,0,0,3,3
9946,ardından,0,0,3,3
3162,minimo,1,3,0,3
44066,व्याख्या,0,0,3,3
26548,üzülmemesini,0,0,3,3
862,uv,2,1,2,3
28234,preserve,0,0,3,3
37020,donations,0,0,3,3
19821,ocorre,0,0,2,2
17284,mythologie,0,0,2,2
17262,produto,0,0,2,2
19211,assist,0,0,2,2
19598,estavam,0,0,2,2
17383,permanecer,0,0,2,2
2827,sotterranee,1,2,0,2
2848,bootstrap,2,1,1,2
42928,يتحقق,0,0,2,2
41292,частности,0,0,2,2
43240,artikelns,0,0,2,2
19815,donaciones,0,0,2,2
19547,форме,0,0,2,2
2847,julius,2,1,1,2
42950,math,0,0,2,2
41239,πολλοί,0,0,2,2
19498,സുഹൃത്ത്,0,0,2,2
19499,செய்தியை,0,0,2,2
16806,vestidos,0,0,2,2
42861,voluntaria,0,0,2,2
42924,ves,0,0,2,2
19148,وتعني,0,0,2,2
40261,celebrated,0,0,2,2
16824,सूत्रों,0,0,2,2
51622,iğrenç,0,0,2,2
43244,semisupervised,0,0,2,2
42946,manipulation,0,0,2,2
42926,relationship,0,0,2,2
2466,successo.,1,2,0,2
21033,οποιαδήποτε,0,0,2,2
19214,obscene,0,0,2,2
17273,smaragden,0,0,2,2
17276,etnologiämnet,0,0,2,2
19831,içeriği,0,0,2,2
17266,questioned,0,0,2,2
17267,disposition,0,0,2,2
21114,acha,0,0,2,2
2519,argento,1,2,0,2
19900,αποτέλεσμα,0,0,2,2
2178,condizione,1,2,0,2
19543,tectonic,0,0,2,2
21397,insertion,0,0,2,2
2107,balcone,1,2,0,2
51654,संरक्षण,0,0,2,2
19826,pública,0,0,2,2
19139,القناة,0,0,2,2
19829,يفعل,0,0,2,2
19897,fondé,0,0,2,2
21041,ancient,0,0,2,2
41484,intresserad,0,0,2,2
41281,الشائعة,0,0,2,2
17277,christian,0,0,2,2
16822,ابنتها,0,0,2,2
43285,protección,0,0,2,2
21112,перестань,0,0,2,2
40260,üzere,0,0,2,2
17391,"
मराठी",0,0,2,2
17393,drömmen,0,0,2,2
19840,presentar,0,0,2,2
19892,geçmiş,0,0,2,2
17263,ومنفرجة,0,0,2,2
17264,صديقي,0,0,2,2
2170,descrisse,1,2,0,2
2910,ristorante,1,2,0,2
19839,responsabilidad,0,0,2,2
21048,dedim,0,0,2,2
21444,süß,0,0,2,2
19531,objeto,0,0,2,2
19217,parmaklar,0,0,2,2
41727,dabei,0,0,2,2
41671,يستخدمها,0,0,2,2
19145,krav,0,0,2,2
19174,تدل,0,0,2,2
42916,advent,0,0,2,2
16752,hayalim,0,0,2,2
43253,ആരുടെയെങ്കിലും,0,0,2,2
43232,नयी,0,0,2,2
19184,illustre,0,0,2,2
2834,dipendenza,1,2,0,2
41252,консенсуса,0,0,2,2
19885,ಧ್ವನಿಸಲು,0,0,2,2
19570,uenig,0,0,2,2
19869,одной,0,0,2,2
21084,syn,0,0,2,2
42873,fini,0,0,2,2
19868,сбудется,0,0,2,2
41713,limites,0,0,2,2
21085,கூறுகிறீர்கள்,0,0,2,2
41250,الجزء,0,0,2,2
41694,accepteer,0,0,2,2
17331,ಇರುತ್ತೇನೆ,0,0,2,2
19520,funktioner,0,0,2,2
40490,significados,0,0,2,2
41470,தயாராக,0,0,2,2
17323,distribuir,0,0,2,2
41260,fraude,0,0,2,2
19519,p ,0,0,2,2
16793,μίλι,0,0,2,2
19516,கையை,0,0,2,2
19572,पत्रकारिता,0,0,2,2
19183,egoísta,0,0,2,2
16764,naturelle,0,0,2,2
2917,quadrati,1,2,0,2
17344,arriver,0,0,2,2
40267,arrangement,0,0,2,2
19168,mermelada,0,0,2,2
2835,siciliano,2,1,1,2
16784,varnish,0,0,2,2
2517,cancellando,1,2,0,2
16781,комунибудь,0,0,2,2
21070,descrevem,0,0,2,2
42885,занимались,0,0,2,2
40268,annoncerede,0,0,2,2
43255,dirigida,0,0,2,2
17353,dum,0,0,2,2
21074,direct,0,0,2,2
21426,ανανέωση,0,0,2,2
43262,потом,0,0,2,2
40496,neutral»,0,0,2,2
16776,ganska,0,0,2,2
2458,detenuto,1,2,0,2
19876,സംഭാഷണത്തിൽ,0,0,2,2
40493,ಶೀಘ್ರದಲ್ಲೇ,0,0,2,2
19875,بيانات,0,0,2,2
41696,சந்திக்க,0,0,2,2
19560,διαγραφεί,0,0,2,2
42890,فارما,0,0,2,2
19884,«я,0,0,2,2
2912,variano,1,2,0,2
17364,تأسيسها,0,0,2,2
16753,الثلاثة,0,0,2,2
51283,استعدت,0,0,2,2
51506,നടത്താൻ,0,0,2,2
17377,yolunda,0,0,2,2
41268,oferecer,0,0,2,2
41684,alcanzar,0,0,2,2
41703,cult,0,0,2,2
43276,"
डच",0,0,2,2
41450,केंद्र,0,0,2,2
2096,elogiata,1,2,0,2
41681,convey,0,0,2,2
21054,комуто,0,0,2,2
42917,ഹലോ,0,0,2,2
19590,മുകളിൽ,0,0,2,2
21057,здорово,0,0,2,2
41240,lessons,0,0,2,2
21409,coordinated,0,0,2,2
19204,fruktansvärt,0,0,2,2
17379,बदला,0,0,2,2
19157,área,0,0,2,2
40285,كتب,0,0,2,2
21051,miedo,0,0,2,2
2828,cancellati,1,2,0,2
41717,موقف,0,0,2,2
51443,indse,0,0,2,2
41676,பயன்படுகிறது,0,0,2,2
41473,afecta,0,0,2,2
19527,suit,0,0,2,2
19193,التعريف,0,0,2,2
21099,genomfördes,0,0,2,2
19515,மேற்கொள்ளப்படும்,0,0,2,2
21416,samman,0,0,2,2
41687,kızım,0,0,2,2
2172,visitati,1,2,0,2
17322,வீடியோவின்,0,0,2,2
21436,nøjagtigt,0,0,2,2
42906,tâches,0,0,2,2
21061,текстов,0,0,2,2
41263,சொற்களைக்,0,0,2,2
40281,fjollet,0,0,2,2
40482,crocker,0,0,2,2
19576,wikislavia,0,0,2,2
40480,വിറ്റു,0,0,2,2
42907,зол,0,0,2,2
19161,divin,0,0,2,2
42911,wii,0,0,2,2
40506,erkänner,0,0,2,2
17305,handlar,0,0,2,2
21058,μέλι,0,0,2,2
42915,vejo,0,0,2,2
51444,centros,0,0,2,2
19887,durch,0,0,2,2
21437,beleefd,0,0,2,2
2829,sorridere,1,2,0,2
2888,capito.,1,2,0,2
17213,முந்தைய,0,0,2,2
21124,ഉദാഹരണത്തിൽ,0,0,2,2
19415,المواضيع,0,0,2,2
43055,ಪರಿಸ್ಥಿತಿಯಲ್ಲಿ,0,0,2,2
40395,préféré,0,0,2,2
2422,pagerank,2,1,1,2
43050,dedica,0,0,2,2
19681,политика,0,0,2,2
19739,ஒன்றைப்,0,0,2,2
19413,repos »,0,0,2,2
19903,معي,0,0,2,2
17096,заслуживаю,0,0,2,2
41608,participate,0,0,2,2
19325,أمثلة,0,0,2,2
19323,மூன்று,0,0,2,2
19320,século,0,0,2,2
2421,vagamente,1,2,0,2
43045,princesa,0,0,2,2
19678,products,0,0,2,2
19735,تلقت,0,0,2,2
51466,combination,0,0,2,2
43058,सेंटर,0,0,2,2
43173,büyülü,0,0,2,2
16928,incorporated,0,0,2,2
43067,بوميس,0,0,2,2
43172,जॉन,0,0,2,2
19730,maturation,0,0,2,2
17065,ഇത്തരത്തിൽ,0,0,2,2
40390,bonitos,0,0,2,2
41604,deposition,0,0,2,2
43065,говорили,0,0,2,2
51641,définitions,0,0,2,2
19402,सदी,0,0,2,2
41606,உடனடியாக,0,0,2,2
19734,ഇതെല്ലാം,0,0,2,2
43062,राजनीतिज्ञ,0,0,2,2
21326,portable,0,0,2,2
2121,manderò,1,2,0,2
19677,глаза,0,0,2,2
43175,benzeri,0,0,2,2
16931,heiraten,0,0,2,2
16903,mantidas,0,0,2,2
41389,daarna,0,0,2,2
17120,நினைத்தேன்,0,0,2,2
21212,entendiste,0,0,2,2
40411,algoritmes,0,0,2,2
41343,книгу,0,0,2,2
41557,verbijsterd,0,0,2,2
19664,предоставляет,0,0,2,2
16902,tekniken,0,0,2,2
19672,engang,0,0,2,2
19755,именно,0,0,2,2
19304,апреле,0,0,2,2
21207,forbindelse,0,0,2,2
17125,gjorda,0,0,2,2
17126,любое,0,0,2,2
21206,analogs,0,0,2,2
19303,repeatedly,0,0,2,2
40410,twelve,0,0,2,2
19313,diseases,0,0,2,2
19747,böylece,0,0,2,2
17116,αξίζω,0,0,2,2
40405,पंजीकरण,0,0,2,2
43178,publiceringen,0,0,2,2
51269,εσείς,0,0,2,2
40326,configuração,0,0,2,2
21338,कृप्या,0,0,2,2
2872,scuse.,1,2,0,2
19744,sugerencias,0,0,2,2
2871,proceedings,2,1,1,2
21346,explicações,0,0,2,2
17110,αρχή,0,0,2,2
19316,создан,0,0,2,2
43035,allows,0,0,2,2
17112,ಪಾಠಗಳನ್ನು,0,0,2,2
2491,gorilla,1,2,0,2
21348,ಮಾರ್ಗಗಳನ್ನು,0,0,2,2
21242,agency,0,0,2,2
41355,സുന്ദരൻ,0,0,2,2
2419,richieste.,1,2,0,2
19713,kaldet,0,0,2,2
19369,സ്ഥലം,0,0,2,2
43110,silly,0,0,2,2
17006,gideceksin,0,0,2,2
19391,galilée,0,0,2,2
17007,ചോദിക്കാനുള്ള,0,0,2,2
19392,പദങ്ങൾ,0,0,2,2
19712,rostro,0,0,2,2
17023,enbart,0,0,2,2
21299,movies,0,0,2,2
19365,indépendante,0,0,2,2
19364,ഇൻപുട്ട്,0,0,2,2
41591,nedenfor,0,0,2,2
19394,مشاهدات,0,0,2,2
2883,schemi,1,2,0,2
16964,σφαίρα,0,0,2,2
21298,स्वभाव,0,0,2,2
19390,തീരുമാനിക്കപ്പെടുന്നു,0,0,2,2
19377,आने,0,0,2,2
43141,decirme,0,0,2,2
41575,pequeños,0,0,2,2
19699,administrativo,0,0,2,2
16967,ermee,0,0,2,2
16979,സഹായിക്കാൻ,0,0,2,2
19385,கட்டுரைகளைக்,0,0,2,2
21289,kullanabileceğin,0,0,2,2
43128,ചെയ്യുന്നതും,0,0,2,2
21284,bataklık,0,0,2,2
19386,"
निम्न",0,0,2,2
16990,ikväll,0,0,2,2
51494,بيديا,0,0,2,2
2885,biblioteche,1,2,0,2
19708,പ്രശ്നങ്ങളിൽ,0,0,2,2
16998,maintained,0,0,2,2
2128,gordon,2,1,1,2
2484,medica,1,2,0,2
43090,джозефом,0,0,2,2
21301,presents,0,0,2,2
17056,fique,0,0,2,2
21247,beskriva,0,0,2,2
17050,feel,0,0,2,2
16934,gav,0,0,2,2
17051,mvs,0,0,2,2
19338,σωστά,0,0,2,2
17052,ukrainien,0,0,2,2
41358,informática,0,0,2,2
40386,erkek,0,0,2,2
17053,illustrer,0,0,2,2
2130,accademiche,1,2,0,2
40341,observar,0,0,2,2
19683,commonalities,0,0,2,2
43073,undo,0,0,2,2
43072,darauf,0,0,2,2
16932,journalist,0,0,2,2
21243,κάθε,0,0,2,2
21315,toegekend,0,0,2,2
19342,المؤسس,0,0,2,2
40344,செய்யவில்லை,0,0,2,2
16939,απαντήσετε,0,0,2,2
41600,indexação,0,0,2,2
41570,anda,0,0,2,2
41594,нем,0,0,2,2
2132,frequente,2,1,1,2
19355,stört,0,0,2,2
41567,købe,0,0,2,2
43089,bottom,0,0,2,2
16948,köpa,0,0,2,2
43155,അതായത്‌,0,0,2,2
51256,editorchefe,0,0,2,2
16941,trodde,0,0,2,2
19350,മികച്ചതായിരിക്കും,0,0,2,2
19689,presentó,0,0,2,2
19721,ഇല്ലാതെ,0,0,2,2
21255,பயன்படுத்தப்படுகிறது,0,0,2,2
19344,answered,0,0,2,2
17128,boğuldum,0,0,2,2
19431,hagas,0,0,2,2
21125,ಪಡೆಯಲಿಲ್ಲ,0,0,2,2
41306,задачах,0,0,2,2
41413,عكس,0,0,2,2
19235,சுவையான,0,0,2,2
19632,forfærdelige,0,0,2,2
17217,ಪುಸ್ತಕವನ್ನು,0,0,2,2
41665,schaffen,0,0,2,2
19467,formar,0,0,2,2
42967,лицо,0,0,2,2
40304,encarga,0,0,2,2
42963,റഫറൻസുകൾ,0,0,2,2
19623,والعمل,0,0,2,2
16848,langzamer,0,0,2,2
51629,marked,0,0,2,2
40451,begynde,0,0,2,2
17227,റൂട്ട്,0,0,2,2
17228,write,0,0,2,2
40303,directed,0,0,2,2
40357,واستمر,0,0,2,2
19236,locations,0,0,2,2
17208,kelimelerin,0,0,2,2
41524,contrôler,0,0,2,2
2854,sapore,1,2,0,2
19465,z,0,0,2,2
16865,hemskt,0,0,2,2
42987,åt,0,0,2,2
42984,बेवकूफ़,0,0,2,2
19639,அப்படி,0,0,2,2
17204,ramène,0,0,2,2
21153,çalışmasını,0,0,2,2
2509,scientifica.,1,2,0,2
16856,propuso,0,0,2,2
43217,chère,0,0,2,2
40449,சோர்வாக,0,0,2,2
17206,astuce,0,0,2,2
19239,hayatınızda,0,0,2,2
21150,surpassing,0,0,2,2
21380,pronunciation,0,0,2,2
19230,நிலைமை,0,0,2,2
19245,noticiário,0,0,2,2
17242,préciser,0,0,2,2
42957,affranchir,0,0,2,2
21134,électroniques,0,0,2,2
19484,« l,0,0,2,2
19226,simbolizando,0,0,2,2
19486,teknolojileri,0,0,2,2
21390,aspectos,0,0,2,2
40462,prens,0,0,2,2
19616,ಫ್ಲಮ್ಮೋಕ್ಸ್,0,0,2,2
40454,appliqué,0,0,2,2
16835,suggestions,0,0,2,2
41297,fifty,0,0,2,2
21128,visitado,0,0,2,2
19489,അടിസ്ഥാനം,0,0,2,2
16833,видела,0,0,2,2
17247,κάνουν,0,0,2,2
16832,följa,0,0,2,2
41299,छवियों,0,0,2,2
19482,finally,0,0,2,2
21387,éditoriale,0,0,2,2
16836,بحلول,0,0,2,2
19470,framstående,0,0,2,2
16847,readily,0,0,2,2
40296,porém,0,0,2,2
21137,κακό,0,0,2,2
19229,ग्रस्त,0,0,2,2
17233,ചോദ്യം,0,0,2,2
19471,armazenadas,0,0,2,2
16844,പിൻബലത്തോടെ,0,0,2,2
19228,valores,0,0,2,2
19478,açısı,0,0,2,2
42959,समस्या,0,0,2,2
19480,register,0,0,2,2
40458,fichiers,0,0,2,2
42958,दुर्लभ,0,0,2,2
17238,ಸ್ಪೀಕರ್,0,0,2,2
43204,ಹೋಗುವುದು,0,0,2,2
21157,सिद्धांत,0,0,2,2
17129,terrível,0,0,2,2
2859,sorrisi,1,2,0,2
17148,couch,0,0,2,2
43018,divisions,0,0,2,2
43015,ഇംഗ്ലീഷിൽ,0,0,2,2
41323,diretamente,0,0,2,2
2410,storici,1,2,0,2
19436,propensos,0,0,2,2
17155,principais,0,0,2,2
21182,builds,0,0,2,2
17164,nachrichten,0,0,2,2
40433,mariage,0,0,2,2
43011,commentaire,0,0,2,2
21358,зарегистрированы,0,0,2,2
19441,முதல்,0,0,2,2
51451,réellement,0,0,2,2
17160,portions,0,0,2,2
17161,eet,0,0,2,2
51453,ಕಣ್ಣುಗಳು,0,0,2,2
2500,operava,2,1,1,2
40427,sade,0,0,2,2
2478,lavorativa.,1,2,0,2
21350,notícias,0,0,2,2
16900,первое,0,0,2,2
51273,reconnu,0,0,2,2
21202,лучшая,0,0,2,2
21352,multilingual,0,0,2,2
2416,manuali,1,2,0,2
43186,बिलकुल,0,0,2,2
21354,വെയിൽ‌സും,0,0,2,2
2864,problematici,1,2,0,2
41324,каждая,0,0,2,2
2901,leggendo,1,2,0,2
16891,savoureux,0,0,2,2
40423,afscheid,0,0,2,2
17142,الحال,0,0,2,2
21188,fuhr,0,0,2,2
43009,artículos—,0,0,2,2
43191,narcissisme,0,0,2,2
19464,ligger,0,0,2,2
21367,creditado,0,0,2,2
19649,പരസ്പരബഹുമാനവും,0,0,2,2
16880,journalistes,0,0,2,2
21166,mention,0,0,2,2
21366,aktiva,0,0,2,2
41317,telefone,0,0,2,2
2507,álvaro,1,2,0,2
41316,svare,0,0,2,2
43198,aquatic,0,0,2,2
43007,vänster,0,0,2,2
16876,verrai,0,0,2,2
43200,الأصابع,0,0,2,2
21162,ಭಯ,0,0,2,2
16874,என,0,0,2,2
42991,alain,0,0,2,2
40446,consulted,0,0,2,2
51484,kim,0,0,2,2
19458,الأيمن,0,0,2,2
17183,langsamer,0,0,2,2
17182,—«wikipedia,0,0,2,2
43000,koordinering,0,0,2,2
19251,wisdom,0,0,2,2
41541,απόφαση,0,0,2,2
40434,μάτια,0,0,2,2
19250,protegidos,0,0,2,2
19249,administratörer,0,0,2,2
43006,lower,0,0,2,2
19248,rodando,0,0,2,2
40435,gitmeliyim,0,0,2,2
40436,molecules,0,0,2,2
41538,daré,0,0,2,2
41533,веб,0,0,2,2
19247,shifted,0,0,2,2
19782,ಚಾನಲ್‌ಗೆ,0,0,2,2
21364,suppe,0,0,2,2
40437,inserção,0,0,2,2
19134,अग्रिम,0,0,2,2
2534,clonazione,1,2,0,2
2822,applicati,1,2,0,2
42382,lente,0,0,2,2
20610,reconocimiento,0,0,2,2
42380,realizar,0,0,2,2
20608,لذلك،,0,0,2,2
18134,discrètes,0,0,2,2
40778,κοινές,0,0,2,2
18747,rico,0,0,2,2
18746,skruvade,0,0,2,2
41046,وتم,0,0,2,2
18136,annual,0,0,2,2
42377,russe,0,0,2,2
20603,donationer,0,0,2,2
20602,ஆரம்ப,0,0,2,2
20599,enlace,0,0,2,2
18741,reis,0,0,2,2
40788,ലഭിക്കുന്നു,0,0,2,2
41044,редакторами,0,0,2,2
18145,financiamento,0,0,2,2
18147,felaktig,0,0,2,2
41987,लेकर,0,0,2,2
20191,ನೋಡುವುದಿಲ್ಲ,0,0,2,2
2267,vialetto.,1,2,0,2
20611,artists,0,0,2,2
20616,rockar,0,0,2,2
18161,während,0,0,2,2
40771,reproduce,0,0,2,2
18773,intéressé,0,0,2,2
42410,ஆரம்பத்தில்,0,0,2,2
42409,batmak,0,0,2,2
2573,beeton,2,1,1,2
41972,viés,0,0,2,2
51577,മുൻ‌കൂട്ടി,0,0,2,2
18763,precisamos,0,0,2,2
41976,сообщила,0,0,2,2
40764,tidig,0,0,2,2
41061,संकलन,0,0,2,2
18106,vorm,0,0,2,2
20627,جذور,0,0,2,2
2265,lava,2,1,1,2
2363,quest'anno,1,2,0,2
2690,l'albero,1,2,0,2
20174,arreglar,0,0,2,2
2687,en.wikipedia.org,1,2,0,2
18123,considerou,0,0,2,2
42385,ελπίζω,0,0,2,2
42384,விக்கிப்பீடியாவிலுள்ள,0,0,2,2
20619,स्कोर,0,0,2,2
41993,haya,0,0,2,2
40796,निरीक्षण,0,0,2,2
17932,अविश्वसनीय,0,0,2,2
2581,partita,1,2,0,2
40810,lateinische,0,0,2,2
40811,ertrinken,0,0,2,2
42336,success,0,0,2,2
41030,autonomes,0,0,2,2
20556,نفسها,0,0,2,2
18709,समझ,0,0,2,2
2353,richiesto,1,2,0,2
42010,eleições,0,0,2,2
18701,veräppeln,0,0,2,2
51534,stand,0,0,2,2
42329,darle,0,0,2,2
20223,inscrição,0,0,2,2
42020,пишут,0,0,2,2
40823,വരാൻ,0,0,2,2
2274,logici,1,2,0,2
42328,existent,0,0,2,2
42325,l’étude,0,0,2,2
18688,percepção,0,0,2,2
2275,universitaria,2,1,1,2
18216,sentindo,0,0,2,2
2673,puzzolente,1,2,0,2
18710,सारे,0,0,2,2
18198,kalifornien,0,0,2,2
20579,الطريقة,0,0,2,2
18723,microorganisms,0,0,2,2
2682,leggibilità,1,2,0,2
40797,огромный,0,0,2,2
40801,macs,0,0,2,2
18173,விளக்குகிறது,0,0,2,2
18730,прецедентам,0,0,2,2
18729,wildlife,0,0,2,2
18177,witz,0,0,2,2
42348,noemen,0,0,2,2
20569,pensé,0,0,2,2
20198,النقر,0,0,2,2
2356,pubblico.,1,2,0,2
20566,rijkdom,0,0,2,2
18183,release,0,0,2,2
20204,ആയി,0,0,2,2
18193,g,0,0,2,2
20205,periodistas,0,0,2,2
18195,приятного,0,0,2,2
2355,soldato,1,2,0,2
40809,numera,0,0,2,2
18196,habitualmente,0,0,2,2
2580,invito,1,2,0,2
18089,daher,0,0,2,2
51418,möta,0,0,2,2
18779,fiz,0,0,2,2
2250,eseguono,1,2,0,2
17958,ಮರೆಯಬೇಡಿ,0,0,2,2
41931,kriterier,0,0,2,2
42497,விடுங்கள்,0,0,2,2
20697,καιρό,0,0,2,2
17965,الذهاب,0,0,2,2
42496,குறிக்கோளை,0,0,2,2
42493,climatiques,0,0,2,2
18820,thumbs,0,0,2,2
51346,ну,0,0,2,2
17972,conduta,0,0,2,2
17975,domaines,0,0,2,2
18816,платье,0,0,2,2
20693,आक्रामक,0,0,2,2
17985,साबित,0,0,2,2
42482,документальный,0,0,2,2
41939,bidra,0,0,2,2
2713,profit,2,1,1,2
2367,judea,2,1,1,2
2712,l'impact,1,2,0,2
2710,apprenderanno,1,2,0,2
18812,четыре,0,0,2,2
20127,έξω,0,0,2,2
20124,दस्तावेज़,0,0,2,2
18781,gratuito,0,0,2,2
17955,അടുത്ത്,0,0,2,2
2566,-pedìa,1,2,0,2
17933,profesionales,0,0,2,2
20728,último,0,0,2,2
20726,welches,0,0,2,2
2723,vado,1,2,0,2
42512,фильм,0,0,2,2
40706,criticism,0,0,2,2
41929,нов,0,0,2,2
40710,منتصف,0,0,2,2
17943,betekenis,0,0,2,2
18827,quantités,0,0,2,2
40712,visitar,0,0,2,2
20715,feeling,0,0,2,2
41088,τραπεζικό,0,0,2,2
2722,finito,1,2,0,2
20713,критикуют,0,0,2,2
2721,famiglie,1,2,0,2
42503,espaço,0,0,2,2
17951,modifiées,0,0,2,2
17952,إليك,0,0,2,2
41930,языковые,0,0,2,2
17994,allonsy,0,0,2,2
18000,الناس,0,0,2,2
2251,solleva,1,2,0,2
18004,ಕಷ್ಟಪಟ್ಟು,0,0,2,2
18791,التالي,0,0,2,2
2699,casualmente,1,2,0,2
41955,ಸುಂದರವಾಗಿ,0,0,2,2
2255,risultante,1,2,0,2
42436,desse,0,0,2,2
42434,criticadas,0,0,2,2
2697,rilasciato,1,2,0,2
51581,oferecido,0,0,2,2
51356,magisk,0,0,2,2
20651,zugehört,0,0,2,2
18063,cia,0,0,2,2
20155,ultraviolet,0,0,2,2
42428,repareren,0,0,2,2
40757,steht,0,0,2,2
42425,σένα,0,0,2,2
20646,மொழிப்,0,0,2,2
18785,arbitration,0,0,2,2
18079,غالباً,0,0,2,2
20644,religión,0,0,2,2
20642,volledige,0,0,2,2
20640,maand,0,0,2,2
2567,elevato,1,2,0,2
2703,colloquiale,1,2,0,2
20151,thinking,0,0,2,2
18797,какое,0,0,2,2
2708,piracy,2,1,1,2
18805,starten,0,0,2,2
20681,constitue,0,0,2,2
42464,l’influence,0,0,2,2
20680,salinity,0,0,2,2
20140,préoccupation,0,0,2,2
18022,χρήση,0,0,2,2
18801,ذكرت,0,0,2,2
41072,сервер,0,0,2,2
41071,soutien,0,0,2,2
40742,redigeringarna,0,0,2,2
42453,soldater,0,0,2,2
42451,собственные,0,0,2,2
18038,மூழ்கி,0,0,2,2
42445,quotes,0,0,2,2
40739,geçti,0,0,2,2
2706,coordinate,2,1,1,2
20672,സ്ഥലത്ത്,0,0,2,2
20669,πλαίσιο,0,0,2,2
18793,glöm,0,0,2,2
41019,shane,0,0,2,2
18219,programmés,0,0,2,2
42323,nariz,0,0,2,2
51557,locuteurs,0,0,2,2
2333,porterà,1,2,0,2
2332,pedia,2,1,1,2
18425,quotations,0,0,2,2
42188,gratuit,0,0,2,2
18558,ತಂಪಾದ,0,0,2,2
2636,vincolate,1,2,0,2
20426,εικονίδιο,0,0,2,2
18432,തുടരാൻ,0,0,2,2
42102,ndeki,0,0,2,2
40960,vital,0,0,2,2
18433,llevando,0,0,2,2
20329,الهندسة,0,0,2,2
42183,parecer,0,0,2,2
18436,publicamente,0,0,2,2
40899,klugen,0,0,2,2
18438,oké,0,0,2,2
40957,latinsk,0,0,2,2
51545,interesting,0,0,2,2
20334,முரண்பாடான,0,0,2,2
40956,diretrizes,0,0,2,2
42178,notable,0,0,2,2
18562,ερωτήσεις,0,0,2,2
40970,anordnas,0,0,2,2
40878,பயன்படுத்தப்படுகின்றன,0,0,2,2
18416,öppet,0,0,2,2
42211,facility,0,0,2,2
42208,floras,0,0,2,2
20460,целях,0,0,2,2
40879,εμφανίζεται,0,0,2,2
2294,dell'energia,1,2,0,2
20306,corrigilos,0,0,2,2
20449,هاه,0,0,2,2
42083,ναρκίσσου,0,0,2,2
20446,siehst,0,0,2,2
20445,bezeichnen,0,0,2,2
20444,sentada,0,0,2,2
42204,ഉണ്ടെങ്കിൽ,0,0,2,2
18580,süredir,0,0,2,2
42085,printed,0,0,2,2
20307,ستة,0,0,2,2
42198,ställning,0,0,2,2
40887,الأشهر,0,0,2,2
42197,wortel,0,0,2,2
42195,dentre,0,0,2,2
18415,degré,0,0,2,2
18573,மாட்டேன்,0,0,2,2
42176,सुबह,0,0,2,2
18446,específicos,0,0,2,2
2309,ricarica,1,2,0,2
2327,gergo,1,2,0,2
2630,un'estensione,1,2,0,2
20347,latines,0,0,2,2
18483,परी,0,0,2,2
2629,rotto,1,2,0,2
40928,അടിസ്ഥാന,0,0,2,2
18515,источникам,0,0,2,2
42126,række,0,0,2,2
20373,छात्रों,0,0,2,2
42143,expected,0,0,2,2
40945,ನಾಲ್ಕು,0,0,2,2
18491,ಸ್ವಾಗತ,0,0,2,2
2319,dichiarato,1,2,0,2
42141,gagne,0,0,2,2
18498,удалить,0,0,2,2
20351,ಮನುಷ್ಯ,0,0,2,2
20352,voordat,0,0,2,2
51385,atualização,0,0,2,2
18508,ruimte,0,0,2,2
42131,простое,0,0,2,2
2626,metodologici,1,2,0,2
40939,सोर्बियाई,0,0,2,2
18478,verward,0,0,2,2
40947,hoewel,0,0,2,2
18516,anlatıyorlar,0,0,2,2
40951,recorded,0,0,2,2
2310,pensava,1,2,0,2
18535,клеток,0,0,2,2
18531,welchem,0,0,2,2
18530,conventions,0,0,2,2
42115,ρήμα,0,0,2,2
2324,swami,2,1,1,2
20400,ഇവരുടെ,0,0,2,2
18460,серверы,0,0,2,2
18522,ergens,0,0,2,2
20397,faktorer,0,0,2,2
2313,corrette.,1,2,0,2
2311,arabo,1,2,0,2
40918,الأخبار,0,0,2,2
2312,aiutare,1,2,0,2
42164,importaria,0,0,2,2
40919,konuda,0,0,2,2
42163,soi,0,0,2,2
40924,энциклопедического,0,0,2,2
20382,igår,0,0,2,2
2632,strati,1,2,0,2
51395,agradeço,0,0,2,2
18388,иметь,0,0,2,2
42321,reducing,0,0,2,2
51371,σελίδων,0,0,2,2
18654,кусок,0,0,2,2
2348,contestata,1,2,0,2
20502,resource,0,0,2,2
20500,ماريون,0,0,2,2
20253,equilibradas,0,0,2,2
42045,വൈകുന്നേരം,0,0,2,2
18259,consensus,0,0,2,2
20255,provedores,0,0,2,2
18261,sept,0,0,2,2
18262,desta,0,0,2,2
18263,σχόλιο,0,0,2,2
42298,सर्वोत्तम,0,0,2,2
20256,citoyens,0,0,2,2
40856,ചേർത്ത്,0,0,2,2
18642,satt,0,0,2,2
18641,classical,0,0,2,2
20260,सुखद,0,0,2,2
18293,desarrollada,0,0,2,2
18294,produktionssätt,0,0,2,2
20493,следовательно,0,0,2,2
20261,spiser,0,0,2,2
2278,andando,1,2,0,2
2666,distruzione,1,2,0,2
18588,egendom”,0,0,2,2
41008,periódicos,0,0,2,2
40839,friday,0,0,2,2
18685,perte,0,0,2,2
42025,vidéos,0,0,2,2
42028,രഥത്തിൽ,0,0,2,2
51404,ganzen,0,0,2,2
18228,أخذت,0,0,2,2
18676,செய்வோம்,0,0,2,2
20237,wortels,0,0,2,2
42315,entonces,0,0,2,2
18233,praktik,0,0,2,2
18668,desacuerdos,0,0,2,2
51402,kæreste,0,0,2,2
18666,familiar,0,0,2,2
2277,sabatier,2,1,1,2
20243,книге,0,0,2,2
41009,mulheres,0,0,2,2
18240,настоящее,0,0,2,2
18241,taking,0,0,2,2
18245,grow,0,0,2,2
18660,donnent,0,0,2,2
18659,pornography,0,0,2,2
20263,देखभाल,0,0,2,2
18296,പെട്ടെന്നുതന്നെ,0,0,2,2
42275,rikedomar,0,0,2,2
40996,महसूस,0,0,2,2
40868,h,0,0,2,2
18612,பார்க்கிறீர்கள்,0,0,2,2
20474,naquela,0,0,2,2
42065,adopté,0,0,2,2
18350,everyone,0,0,2,2
20295,tive,0,0,2,2
40976,ചതുപ്പുനിലമാണ്,0,0,2,2
20299,deveria,0,0,2,2
20301,darüber,0,0,2,2
42234,рекламу,0,0,2,2
42068,automatizado,0,0,2,2
2650,farai.,1,2,0,2
2605,accetto,1,2,0,2
18601,gehe,0,0,2,2
42228,brillants,0,0,2,2
18367,hypothetical,0,0,2,2
2606,collaborativo,1,2,0,2
40872,l’écologie,0,0,2,2
20468,месяцы,0,0,2,2
51379,डोमस्डे,0,0,2,2
42216,trabajando,0,0,2,2
20288,ಹೊರತು,0,0,2,2
18343,വണ്ടിയിൽ,0,0,2,2
18334,انتظر,0,0,2,2
42268,hører,0,0,2,2
42273,சொல்கிறார்கள்,0,0,2,2
40995,പറഞ്ഞത്,0,0,2,2
18301,intermédiaire,0,0,2,2
40863,ответов,0,0,2,2
18631,الليلة,0,0,2,2
40865,மெலிசா,0,0,2,2
42271,esforço,0,0,2,2
20482,எப்படிப்,0,0,2,2
42270,بكثير,0,0,2,2
42267,പ്രതീക്ഷിക്കുന്നു,0,0,2,2
18622,francophones,0,0,2,2
51373,stellen,0,0,2,2
18314,описания,0,0,2,2
42261,möten,0,0,2,2
20279,tomes,0,0,2,2
18318,இருந்ததால்,0,0,2,2
20286,voulait,0,0,2,2
2655,confine,2,1,1,2
20481,متجاوزة,0,0,2,2
51400,begann,0,0,2,2
41925,nenhuma,0,0,2,2
51519,временем,0,0,2,2
17409,मील,0,0,2,2
19041,ಲ್ಯಾಟಿನ್,0,0,2,2
51612,téléchargé,0,0,2,2
17573,betydning,0,0,2,2
41174,idade,0,0,2,2
2200,batte.,1,2,0,2
51610,print,0,0,2,2
2790,Linux,1,2,0,2
41173,восстановить,0,0,2,2
40583,savaşı,0,0,2,2
19036,incoming,0,0,2,2
20934,σίγουροι,0,0,2,2
40588,αμέσως,0,0,2,2
17580,sowohl,0,0,2,2
19031,bonnes,0,0,2,2
2204,rallegrare,1,2,0,2
17586,hawaiiska,0,0,2,2
19027,பரவாயில்லை,0,0,2,2
20925,κατά,0,0,2,2
42732,conséquence,0,0,2,2
2533,sapevo,1,2,0,2
51311,يوفر,0,0,2,2
42727,forkerte,0,0,2,2
2793,castello,1,2,0,2
40578,muita,0,0,2,2
42726,माणिक,0,0,2,2
42745,जड़,0,0,2,2
17544,running,0,0,2,2
17545,essencialmente,0,0,2,2
19964,verdrinken,0,0,2,2
41190,suggesting,0,0,2,2
19968,impose,0,0,2,2
20956,pornográficos,0,0,2,2
19052,शब्दकोश,0,0,2,2
17548,ومنع,0,0,2,2
2194,composizione,1,2,0,2
17550,γνωρίζω,0,0,2,2
19048,ಬೆರಗುಗೊಳಿಸುವ,0,0,2,2
41185,svag,0,0,2,2
20949,siècle,0,0,2,2
17553,wikiprogramvaran,0,0,2,2
19978,मियां,0,0,2,2
2196,otrs,2,1,1,2
17558,arreglo,0,0,2,2
17559,treated,0,0,2,2
41176,rejette,0,0,2,2
19047,daarnaast,0,0,2,2
19045,subsequent,0,0,2,2
17595,faria,0,0,2,2
19022,observou,0,0,2,2
18837,utseende,0,0,2,2
19003,ജനകീയ,0,0,2,2
41159,сердца,0,0,2,2
20899,krydsede,0,0,2,2
17625,செய்வேன்,0,0,2,2
2210,ripristinare,1,2,0,2
40608,established,0,0,2,2
18999,மாற்றங்களை,0,0,2,2
41819,asignaciones,0,0,2,2
17631,ønske,0,0,2,2
17634,leaves,0,0,2,2
41824,массачусетского,0,0,2,2
42693,تعتقد,0,0,2,2
41825,quantité,0,0,2,2
20892,gentille,0,0,2,2
41829,sakıncası,0,0,2,2
2211,fermata,1,2,0,2
40611,ennuyeux,0,0,2,2
20018,levantadas,0,0,2,2
20887,literally,0,0,2,2
18983,neveneffect,0,0,2,2
51434,लिह,0,0,2,2
20886,besked,0,0,2,2
20901,prøv,0,0,2,2
20904,güvenilir,0,0,2,2
2206,un'opinione,1,2,0,2
41814,प्रशासकों,0,0,2,2
17599,brincando,0,0,2,2
41807,نبدأ,0,0,2,2
19016,свидетельствуют,0,0,2,2
42718,format,0,0,2,2
41167,l’homme,0,0,2,2
17609,ήσουν,0,0,2,2
17611,utförd,0,0,2,2
17612,छोड़,0,0,2,2
19014,carga,0,0,2,2
2535,fascia,1,2,0,2
17618,decisões,0,0,2,2
19997,இதற்காக,0,0,2,2
42708,रिचर्ड,0,0,2,2
40603,statuts,0,0,2,2
41165,വിക്കിപീഡിയരുടെ,0,0,2,2
2780,McPherson,1,2,0,2
40605,φωτεινά,0,0,2,2
20907,लिंक,0,0,2,2
41809,интернетпользователей,0,0,2,2
51437,βοηθήσω,0,0,2,2
20004,eksempler,0,0,2,2
17543,click,0,0,2,2
19059,defesa,0,0,2,2
19963,نوفمبر,0,0,2,2
40533,минутку,0,0,2,2
42827,виды,0,0,2,2
41747,pasó,0,0,2,2
2811,incrociate,1,2,0,2
42823,escrituras,0,0,2,2
42821,ശരാശരി,0,0,2,2
20999,iğrençti,0,0,2,2
2810,l'aggiunta,1,2,0,2
40543,kvalitén,0,0,2,2
17449,kullansam,0,0,2,2
19108,zetten,0,0,2,2
17450,procedentes,0,0,2,2
17456,estimer,0,0,2,2
19921,aimé,0,0,2,2
51617,skiftede,0,0,2,2
17462,domain,0,0,2,2
19105,ಅವು,0,0,2,2
19104,útil,0,0,2,2
40544,ತಿಳಿದಿತ್ತು,0,0,2,2
42810,raffiniert,0,0,2,2
2189,all'inizio,1,2,0,2
41754,kapsamlı,0,0,2,2
19111,फ्री,0,0,2,2
41219,esas,0,0,2,2
42760,भरोसा,0,0,2,2
42828,السياسات,0,0,2,2
41730,climates,0,0,2,2
42845,बड़ा,0,0,2,2
19129,pilares,0,0,2,2
21029,തിരക്കിലാണ്,0,0,2,2
21026,gebied,0,0,2,2
17420,platform,0,0,2,2
51442,succes,0,0,2,2
21018,induction,0,0,2,2
41734,påverkade,0,0,2,2
41739,numara,0,0,2,2
51297,şaşkına,0,0,2,2
41740,δάνειο,0,0,2,2
2816,vicino,1,2,0,2
21016,celuici,0,0,2,2
51298,ganó,0,0,2,2
41746,एंड,0,0,2,2
41228,professeur,0,0,2,2
2182,troverai,1,2,0,2
41222,அடிப்படை,0,0,2,2
21010,சரியாகப்,0,0,2,2
42831,tabii,0,0,2,2
40546,verhoog,0,0,2,2
17467,kvaliteten,0,0,2,2
2805,portland,1,2,0,2
17470,myntades,0,0,2,2
19073,വഴികൾ,0,0,2,2
41198,lagen,0,0,2,2
17512,skriv,0,0,2,2
17519,allemande,0,0,2,2
19950,специально,0,0,2,2
19951,നിങ്ങൾക്കറിയാമെന്ന്,0,0,2,2
42772,requer,0,0,2,2
20967,niye,0,0,2,2
41768,annexes,0,0,2,2
2193,diverse.,1,2,0,2
17522,لأول,0,0,2,2
20962,مشغول,0,0,2,2
19954,σχεδίου,0,0,2,2
17528,rigorous,0,0,2,2
42768,confondues,0,0,2,2
42765,banka,0,0,2,2
41769,oefenen,0,0,2,2
2530,testimonianza,1,2,0,2
17533,രൂപത്തിൽ,0,0,2,2
19957,журналы,0,0,2,2
41773,konsensusbeslut,0,0,2,2
19947,pequenos,0,0,2,2
40558,revealed,0,0,2,2
17503,possam,0,0,2,2
19093,verdiene,0,0,2,2
42803,questioning,0,0,2,2
40547,കഴിഞ്ഞ,0,0,2,2
2525,pronunciare,1,2,0,2
20986,الجميلة,0,0,2,2
40548,digite,0,0,2,2
40549,culturel,0,0,2,2
19095,beri,0,0,2,2
19926,udseende,0,0,2,2
17476,ولكنك,0,0,2,2
19927,collision,0,0,2,2
51439,publient,0,0,2,2
19092,मेजबानी,0,0,2,2
40551,almak,0,0,2,2
19090,процесса,0,0,2,2
42798,étudient,0,0,2,2
2403,resistenza,1,2,0,2
41757,skäl,0,0,2,2
40552,ரொட்டியை,0,0,2,2
20976,лицензией,0,0,2,2
20973,comidas,0,0,2,2
41833,uppdrag,0,0,2,2
17655,πεινασμένος,0,0,2,2
20020,خاصة,0,0,2,2
42570,लेखक,0,0,2,2
42569,energética,0,0,2,2
18896,சோர்வடையவில்லை,0,0,2,2
17844,enviaré,0,0,2,2
20782,juego,0,0,2,2
20781,clearly,0,0,2,2
17847,crisis,0,0,2,2
42567,alacağım,0,0,2,2
40673,fanns,0,0,2,2
41890,acuñado,0,0,2,2
42566,ಇಬ್ಬರು,0,0,2,2
20777,şikayet,0,0,2,2
42565,reprennent,0,0,2,2
51594,traces,0,0,2,2
40675,oye,0,0,2,2
18888,போன்றது,0,0,2,2
20772,reizen,0,0,2,2
17852,سعيد,0,0,2,2
17855,uppsatser,0,0,2,2
40681,générées,0,0,2,2
20081,redacteuren,0,0,2,2
42558,கவனிப்புப்,0,0,2,2
2235,tornare,1,2,0,2
41884,ஆடம்பரமான,0,0,2,2
18919,وكيف,0,0,2,2
41113,kommit,0,0,2,2
17813,suena,0,0,2,2
41871,gerek,0,0,2,2
18915,världen,0,0,2,2
2381,lamentarti,1,2,0,2
51331,ഇതിനു,0,0,2,2
18909,role,0,0,2,2
41877,கட்டுரைகளில்,0,0,2,2
42582,feifei,0,0,2,2
41878,undisclosed,0,0,2,2
20798,hou,0,0,2,2
2742,concentrati,1,2,0,2
40664,विकिशब्दकोष,0,0,2,2
42577,систем,0,0,2,2
2741,matematiche,1,2,0,2
17836,talking,0,0,2,2
18903,reverts,0,0,2,2
17837,videnskabsfolk,0,0,2,2
40666,speaking,0,0,2,2
17839,ಪುನರಾವರ್ತಿಸಬಹುದೇ,0,0,2,2
2380,secondo.,1,2,0,2
42572,जल्दी,0,0,2,2
18886,ಮಾತನಾಡಲು,0,0,2,2
17862,ഒന്നും,0,0,2,2
51591,phenomena,0,0,2,2
42550,उम्मीदवार,0,0,2,2
20098,outsiders,0,0,2,2
17904,soyez,0,0,2,2
20747,للسؤال,0,0,2,2
17908,توجد,0,0,2,2
17909,चलाने,0,0,2,2
41096,zilver,0,0,2,2
2725,plasma,2,1,1,2
42522,lidar,0,0,2,2
51421,أنشأ,0,0,2,2
41094,proportion,0,0,2,2
41923,limite,0,0,2,2
40693,prüfung,0,0,2,2
20110,refiriéndose,0,0,2,2
20738,imparcialidade,0,0,2,2
20112,venido,0,0,2,2
17916,evlilikte,0,0,2,2
17917,yollarını,0,0,2,2
42521,parties,0,0,2,2
17919,рассылки,0,0,2,2
17920,menée,0,0,2,2
17924,относительно,0,0,2,2
18851,образ,0,0,2,2
20097,ಯಾವ,0,0,2,2
41913,ಮನಸ್ಸಿಲ್ಲವೇ,0,0,2,2
18868,academics,0,0,2,2
20763,ടീച്ചർ,0,0,2,2
17871,எல்லாம்,0,0,2,2
20762,princípios,0,0,2,2
40682,அதனை,0,0,2,2
41900,interesantes,0,0,2,2
18873,político,0,0,2,2
41905,lært,0,0,2,2
17875,allvar,0,0,2,2
40686,εμπειρία,0,0,2,2
51427,большое,0,0,2,2
17895,önemi,0,0,2,2
18865,موسوعات,0,0,2,2
42542,manipulación,0,0,2,2
20090,ಮೂರು,0,0,2,2
51424,pude,0,0,2,2
20753,manufactured,0,0,2,2
18857,eşit,0,0,2,2
20094,supprimé,0,0,2,2
17890,запросы,0,0,2,2
42534,vermijden,0,0,2,2
20065,ಹೇಳುತ್ತಾರೆ,0,0,2,2
20806,gratis,0,0,2,2
20022,matemáticas,0,0,2,2
20859,وشكك,0,0,2,2
17692,تمييز,0,0,2,2
20853,månaden,0,0,2,2
2216,sognato.,1,2,0,2
42657,cambiar,0,0,2,2
17701,idén,0,0,2,2
42654,extensão,0,0,2,2
17705,προχωρήστε,0,0,2,2
41847,yoktur,0,0,2,2
41849,एंड्रयू,0,0,2,2
20848,edities,0,0,2,2
20847,oraya,0,0,2,2
17719,ζητώντας,0,0,2,2
17724,последний,0,0,2,2
40637,स्पष्ट,0,0,2,2
2388,eccitante,1,2,0,2
20840,homens,0,0,2,2
2769,minsky,1,2,0,2
17729,descending,0,0,2,2
20839,maximize,0,0,2,2
42633,sérieuse,0,0,2,2
20038,еды,0,0,2,2
20858,ഉറപ്പില്ല,0,0,2,2
41844,ποιος,0,0,2,2
20064,செய்ததற்கு,0,0,2,2
17691,வண்டி,0,0,2,2
20023,политику,0,0,2,2
20884,டிகிரிக்கு,0,0,2,2
20027,gérée,0,0,2,2
20883,उंगलियों,0,0,2,2
20028,لما,0,0,2,2
41145,ആഗ്രഹിക്കുന്നില്ല,0,0,2,2
17669,funding,0,0,2,2
20881,visuais,0,0,2,2
51608,verdien,0,0,2,2
40617,incidentes,0,0,2,2
40619,improves,0,0,2,2
17670,ಹೊಂದಿದ್ದೀರಿ,0,0,2,2
41835,ಪಠ್ಯವನ್ನು,0,0,2,2
40620,instruktioner,0,0,2,2
18974,approches,0,0,2,2
42673,gebracht,0,0,2,2
17676,reliability,0,0,2,2
17681,പോകുന്നത്,0,0,2,2
42664,русская,0,0,2,2
20860,kritiken,0,0,2,2
41837,ಅತ್ಯಾಧುನಿಕ,0,0,2,2
17737,warte,0,0,2,2
42632,الأفضل,0,0,2,2
2768,insalate,1,2,0,2
2767,taha,2,1,1,2
20819,πάρω,0,0,2,2
17792,தாய்,0,0,2,2
20818,opener,0,0,2,2
17793,الإعلانات,0,0,2,2
17794,kam,0,0,2,2
18929,¿estás,0,0,2,2
20047,broadest,0,0,2,2
20814,huset,0,0,2,2
18927,பிடித்திருந்தால்,0,0,2,2
20051,vertelde,0,0,2,2
2755,comprato,1,2,0,2
17799,कहना।,0,0,2,2
2226,quei,1,2,0,2
42590,materialet,0,0,2,2
17807,hieronder,0,0,2,2
18925,coordination,0,0,2,2
20811,illegal,0,0,2,2
40655,illustration,0,0,2,2
42587,syftet,0,0,2,2
20063,منظمة,0,0,2,2
41867,फाउनडेशन,0,0,2,2
20045,போதுமான,0,0,2,2
41861,respirar,0,0,2,2
42599,добавления,0,0,2,2
17756,ചേർക്കുന്നു,0,0,2,2
51322,röra,0,0,2,2
42627,becoming,0,0,2,2
41853,habertürk,0,0,2,2
20838,इतालवी,0,0,2,2
18943,konanykhin,0,0,2,2
40639,интересные,0,0,2,2
2763,linus,2,1,1,2
2221,adatta,1,2,0,2
2552,besançon,2,1,1,2
17762,convective,0,0,2,2
42600,creativity,0,0,2,2
17773,effectively,0,0,2,2
42610,latijnse,0,0,2,2
41860,στείλετε,0,0,2,2
40646,αγοράσω,0,0,2,2
2757,cammina,1,2,0,2
42607,constitutes,0,0,2,2
18934,про,0,0,2,2
20823,bobo,0,0,2,2
2756,respirare,1,2,0,2
50114,سأرسل,0,0,2,2
38018,moles,0,0,2,2
21449,sommaren,0,0,2,2
35353,diseño,0,0,2,2
29107,hungry,0,0,2,2
29110,ettim,0,0,2,2
29112,ενοχλητική,0,0,2,2
35366,ಹೆಲ್ಲರ್,0,0,2,2
29119,korrekt,0,0,2,2
29127,jämföra,0,0,2,2
29128,ಪ್ರೀತಿಸುತ್ತೇನೆ,0,0,2,2
35360,esqueça,0,0,2,2
35356,جادل,0,0,2,2
29137,ವೀಡಿಯೊದ,0,0,2,2
35351,ξεχάσετε,0,0,2,2
29170,أعجبك,0,0,2,2
35350,sextafeira,0,0,2,2
35345,dando,0,0,2,2
716,sezioni,1,2,0,2
29156,wortes,0,0,2,2
35339,فلوريدا،,0,0,2,2
35338,ഞങ്ങളുടെ,0,0,2,2
714,perciò,1,2,0,2
29163,हो।,0,0,2,2
712,spirito,1,2,0,2
29166,ഉദാഹരണമാണ്,0,0,2,2
29095,اعتقدت,0,0,2,2
29088,impresionante,0,0,2,2
29087,sætte,0,0,2,2
29083,vrijdag,0,0,2,2
29003,സിസോപ്പുകളേയും,0,0,2,2
29004,askerler,0,0,2,2
29006,continual,0,0,2,2
29007,يتطلب,0,0,2,2
29013,presented,0,0,2,2
29014,symptoms,0,0,2,2
29017,entró,0,0,2,2
739,vocabolario.,1,2,0,2
29021,riparian,0,0,2,2
29024,യഥാർത്ഥത്തിൽ,0,0,2,2
29032,applicants,0,0,2,2
52397,digamos,0,0,2,2
736,costi,1,2,0,2
735,stupro,1,2,0,2
52398,طوال,0,0,2,2
29046,niemand,0,0,2,2
29048,poised,0,0,2,2
35404,साइट,0,0,2,2
29073,borde,0,0,2,2
29075,eukaryotic,0,0,2,2
726,confondere,1,2,0,2
29167,राय,0,0,2,2
35331,политик,0,0,2,2
742,spazi,1,2,0,2
29309,assessment,0,0,2,2
29281,einfache,0,0,2,2
691,Michael,1,2,0,2
29289,prises,0,0,2,2
35257,कला,0,0,2,2
29292,läget,0,0,2,2
35253,birbirlerine,0,0,2,2
29297,dourada,0,0,2,2
687,interpreta,1,2,0,2
29306,викимедиа»,0,0,2,2
29307,sugeriu,0,0,2,2
29311,çalışın,0,0,2,2
29176,மேற்கொள்ளப்பட்ட,0,0,2,2
29312,koordinationsarbete,0,0,2,2
683,susning.nu,1,2,0,2
35241,påverkas,0,0,2,2
35236,goldenen,0,0,2,2
29329,ту,0,0,2,2
35231,ಸಂದೇಶವನ್ನು,0,0,2,2
35227,هائلة,0,0,2,2
29343,comedy,0,0,2,2
29345,ತಿರುಗಿಸಿದೆ,0,0,2,2
29359,verilere,0,0,2,2
692,sedeva,1,2,0,2
29279,katılıyorum,0,0,2,2
29274,ക്രൂരമാണ്,0,0,2,2
29273,சேனலுக்கு,0,0,2,2
29180,unmatched,0,0,2,2
29190,verlicht,0,0,2,2
35321,försökte,0,0,2,2
35319,метавики,0,0,2,2
29197,sektioner,0,0,2,2
29200,сбит,0,0,2,2
29204,comprises,0,0,2,2
29206,« d,0,0,2,2
29208,sandheder,0,0,2,2
29209,beskrev,0,0,2,2
29212,motvalise,0,0,2,2
29217,i̇nternet,0,0,2,2
705,saranno,1,2,0,2
704,alimentare,1,2,0,2
29225,réel,0,0,2,2
701,pre-elaborazione,1,2,0,2
29249,основные,0,0,2,2
35277,επαναλάβει,0,0,2,2
35276,ملاحظة,0,0,2,2
29268,fortæl,0,0,2,2
29270,licenses,0,0,2,2
35439,хлеба,0,0,2,2
52392,مرتبطة,0,0,2,2
36620,الفور,0,0,2,2
28715,leçons,0,0,2,2
28675,personnalités,0,0,2,2
35638,daarvoor,0,0,2,2
28683,оригинальных,0,0,2,2
28686,håber,0,0,2,2
35635,широкий,0,0,2,2
28689,compétence,0,0,2,2
28694,நிமிடங்களில்,0,0,2,2
52372,എവിടെ,0,0,2,2
28711,இருப்பதால்,0,0,2,2
35620,parvient,0,0,2,2
28720,महल,0,0,2,2
28780,കുഴപ്പമില്ല,0,0,2,2
28727,تمرير,0,0,2,2
28728,nahm,0,0,2,2
28734,esfera,0,0,2,2
28737,queria,0,0,2,2
35612,ilustraciones,0,0,2,2
35611,смог,0,0,2,2
28757,ofrecer,0,0,2,2
28766,bestrijden,0,0,2,2
28770,hasn,0,0,2,2
35588,πούμε,0,0,2,2
35641,natuurwetenschappelijke,0,0,2,2
28669,representación,0,0,2,2
28667,परस्पर,0,0,2,2
35645,സ്യൂവ്,0,0,2,2
28593,ಪರಿಸ್ಥಿತಿ,0,0,2,2
35686,investigators,0,0,2,2
52359,attempts,0,0,2,2
28609,αγαπητή,0,0,2,2
35677,نظر,0,0,2,2
52362,contextes,0,0,2,2
35672,regels,0,0,2,2
28621,opiniones,0,0,2,2
28622,يقول,0,0,2,2
28624,befinden,0,0,2,2
35669,carved,0,0,2,2
28634,bewerkt,0,0,2,2
28640,கோணத்திலும்,0,0,2,2
28646,akademik,0,0,2,2
52364,indesejáveis,0,0,2,2
28651,directions,0,0,2,2
28654,templates,0,0,2,2
28655,« apprentissage,0,0,2,2
28657,seguinte,0,0,2,2
28663,الحر,0,0,2,2
795,portano,1,2,0,2
52380,kallade,0,0,2,2
28786,gelden,0,0,2,2
35458,إم,0,0,2,2
35480,تكراره,0,0,2,2
35502,الحرية,0,0,2,2
28907,cultlike,0,0,2,2
28910,filmes,0,0,2,2
28912,наукам,0,0,2,2
35492,निम्न,0,0,2,2
28919,السماح,0,0,2,2
28922,incite,0,0,2,2
52390,utformas,0,0,2,2
28934,доступа,0,0,2,2
28935,paramos,0,0,2,2
28940,പരിചയം,0,0,2,2
772,sketch,2,1,1,2
35474,expressed,0,0,2,2
28946,lágrimas,0,0,2,2
28948,londres,0,0,2,2
28958,ವಾಕ್ಯಗಳು,0,0,2,2
747,pubblicamente,1,2,0,2
35465,заболоченного,0,0,2,2
35464,μέσα,0,0,2,2
35463,yazılımı,0,0,2,2
28964,verificabilidad,0,0,2,2
28965,dışında,0,0,2,2
28889,इतनी,0,0,2,2
28888,junge,0,0,2,2
28882,احتلت,0,0,2,2
28880,εγγραφής,0,0,2,2
28799,другу,0,0,2,2
28804,لفترة,0,0,2,2
771,stagioni,1,2,0,2
28811,capaces,0,0,2,2
28817,produktiva,0,0,2,2
35557,ночью,0,0,2,2
763,vada,1,2,0,2
28834,bize,0,0,2,2
35543,neue,0,0,2,2
35536,verschrikkelijk,0,0,2,2
35534, млн,0,0,2,2
35533,áfrica,0,0,2,2
28854,berättar,0,0,2,2
35530,المتطوعين,0,0,2,2
35526,فضلك؟,0,0,2,2
35522,أشهر,0,0,2,2
28868,κόπο,0,0,2,2
28869,pronunciando,0,0,2,2
35518,telecomunicaciones,0,0,2,2
28877,указания,0,0,2,2
28879,affiliates,0,0,2,2
29371,إلي,0,0,2,2
35201,κι,0,0,2,2
35200,iedereen,0,0,2,2
29912,حلمًا,0,0,2,2
29874,تأكد,0,0,2,2
29876,ಅದಕ್ಕೆ,0,0,2,2
34881,الشخصية,0,0,2,2
34879,παρακάτω,0,0,2,2
29889,webben,0,0,2,2
34872,says,0,0,2,2
29894,ningún,0,0,2,2
29899,നിഷ്പക്ഷത,0,0,2,2
29904,ervan,0,0,2,2
29906,box,0,0,2,2
29913,சிக்கியிருக்கிறேன்,0,0,2,2
34834,الرياضيات,0,0,2,2
29916,آخرون,0,0,2,2
34854,tarea,0,0,2,2
34853,semaine,0,0,2,2
29931,mathématicien,0,0,2,2
29934,dozen,0,0,2,2
29937,कथित,0,0,2,2
572,giugno.,1,2,0,2
52480,साथ।,0,0,2,2
52481,relatou,0,0,2,2
34837,custommade,0,0,2,2
29872,expansión,0,0,2,2
34885,animados,0,0,2,2
34889,paradoks,0,0,2,2
34890,goldbrot,0,0,2,2
29788,hield,0,0,2,2
29789,xviie siècle,0,0,2,2
34939,hjalmarsson,0,0,2,2
587,accanto,1,2,0,2
29794,अपाचे,0,0,2,2
29795,രുചികരമായ,0,0,2,2
29796,सुझाव,0,0,2,2
586,partecipato,1,2,0,2
29805,focal,0,0,2,2
29806,increases,0,0,2,2
52473,പറയുന്നതെന്ന്,0,0,2,2
29808,lire,0,0,2,2
29810,यहां,0,0,2,2
34930,sayfa,0,0,2,2
29823,λεξιλόγιό,0,0,2,2
34916,നിങ്ങളോടൊപ്പമുണ്ടാകും,0,0,2,2
29835,geleden,0,0,2,2
34910,கொடூரமானவை,0,0,2,2
34907,sofistikeret,0,0,2,2
29846,ಅಡಿಯಲ್ಲಿ,0,0,2,2
29863,έφτασε,0,0,2,2
566,sanitaria,1,2,0,2
29951,geometrie,0,0,2,2
35199,понимаешь,0,0,2,2
34762,reverte,0,0,2,2
30037,metapedia,0,0,2,2
30039,மகிழ்ச்சியான,0,0,2,2
30040,eruditos,0,0,2,2
30046,tages,0,0,2,2
30048,accordingly,0,0,2,2
548,gustosi,1,2,0,2
34770,أكون,0,0,2,2
30052,இருப்பினும்,0,0,2,2
545,diteci,1,2,0,2
542,catalano,1,2,0,2
34760,rays,0,0,2,2
29954,miljon,0,0,2,2
30070,исправления,0,0,2,2
52495,series,0,0,2,2
30075,papier,0,0,2,2
34755,نوع,0,0,2,2
30077,görüşürüz,0,0,2,2
34754,ipucu,0,0,2,2
30079,beror,0,0,2,2
540,relazionali,1,2,0,2
539,.che,1,2,0,2
30083,ಮಾಡುವುದನ್ನು,0,0,2,2
30035,etablerade,0,0,2,2
30030,प्यारी,0,0,2,2
30028,anayasa,0,0,2,2
30026,gerade,0,0,2,2
34827,menace,0,0,2,2
29962,djupt,0,0,2,2
52489,medalhas,0,0,2,2
29964,எல்லாவற்றையும்,0,0,2,2
557,proposta.,1,2,0,2
34817,cuentas,0,0,2,2
29977,milliards,0,0,2,2
29979,محتواها,0,0,2,2
34813,مستخدمو,0,0,2,2
29991,använt,0,0,2,2
29997,ولطيف,0,0,2,2
30001,tendencias,0,0,2,2
34798,low,0,0,2,2
30004,വിട,0,0,2,2
554,caro,1,2,0,2
30009,удачи,0,0,2,2
34791,prêmios,0,0,2,2
34787,αρνητικό,0,0,2,2
30018,мэриан,0,0,2,2
30021,besværlig,0,0,2,2
30024,vocabulário,0,0,2,2
29787,sensitivity,0,0,2,2
589,prezzi,1,2,0,2
29784,obscur,0,0,2,2
29528,exige,0,0,2,2
29482,लगते,0,0,2,2
29485,வந்தேன்,0,0,2,2
35127,बढ़ती,0,0,2,2
29493,øjne,0,0,2,2
29495,meerderheid,0,0,2,2
29500,आरोप,0,0,2,2
29504,giver,0,0,2,2
29506,പദമായ,0,0,2,2
29514,surpresa,0,0,2,2
29524,brittisk,0,0,2,2
52436,समावेश,0,0,2,2
29782,producido,0,0,2,2
35101,ಇಲ್ಲಿಗೆ,0,0,2,2
35094,abajo,0,0,2,2
35092,ഘടകങ്ങളാണ്,0,0,2,2
29547,ranging,0,0,2,2
29554,celleci,0,0,2,2
642,generalista,1,2,0,2
29560,ilustrativo,0,0,2,2
35082,sturen,0,0,2,2
35078,glückspilz,0,0,2,2
29577,lære,0,0,2,2
35133,milieux,0,0,2,2
35138,ചുമതലയും,0,0,2,2
657,un'origine,1,2,0,2
658,segni,1,2,0,2
35196,datadump,0,0,2,2
29386,implies,0,0,2,2
29387,extraction,0,0,2,2
35182,منهم،,0,0,2,2
52426,formulée,0,0,2,2
35176,nacimiento,0,0,2,2
35172,merleauponty,0,0,2,2
29415,appropriately,0,0,2,2
29418,مروعًا,0,0,2,2
29422,acéfalo,0,0,2,2
29423,estuviera,0,0,2,2
35166,ಇನ್ನೊಂದನ್ನು,0,0,2,2
670,descrizioni,1,2,0,2
35158,работала,0,0,2,2
52430,hang,0,0,2,2
29451,populære,0,0,2,2
35149,namen,0,0,2,2
662,decisive,2,1,1,2
29460,naturaliste,0,0,2,2
35145,solicitações,0,0,2,2
29466,marry,0,0,2,2
640,scorso,1,2,0,2
639,d'oro.,1,2,0,2
29584,flowing,0,0,2,2
34992,പ്രശ്നമല്ല,0,0,2,2
29705,παιχνίδι,0,0,2,2
29706,geldiğini,0,0,2,2
29712,سحرية,0,0,2,2
609,giornalisti,1,2,0,2
29723,civilisation,0,0,2,2
34980,komm,0,0,2,2
34977,underlätta,0,0,2,2
604,percorsi,1,2,0,2
29733,weeds,0,0,2,2
29740,crossed,0,0,2,2
34970,ನಮ್ಮ,0,0,2,2
34966,качество,0,0,2,2
29752,пора,0,0,2,2
29755,ചോദിച്ചാൽ,0,0,2,2
34962,регистрации,0,0,2,2
34958,enfatizar,0,0,2,2
34957,प्रदर्शन,0,0,2,2
29771,sourire,0,0,2,2
594,loveland,2,1,1,2
29775,libertad,0,0,2,2
34943,أصبح,0,0,2,2
614,rientra,1,2,0,2
52458,நடத்தப்படும்,0,0,2,2
35069,huylu,0,0,2,2
29690,diez,0,0,2,2
29597,violación,0,0,2,2
29604,hoş,0,0,2,2
29605,considerados,0,0,2,2
35055,départ,0,0,2,2
29613,başlamak,0,0,2,2
29619,डोक्युमेंटेशन,0,0,2,2
29622,nätverk,0,0,2,2
52445,وموسوعة,0,0,2,2
35027,ദത്തവിവര,0,0,2,2
35025,bancário,0,0,2,2
29653,அங்கீகரிக்கப்பட்ட,0,0,2,2
35018,desenvolvido,0,0,2,2
623,col,1,2,0,2
35016,repositório,0,0,2,2
29665,نحن,0,0,2,2
29669,holdout,0,0,2,2
35004,balkon,0,0,2,2
29681,வெள்ளி,0,0,2,2
29685,informatiques,0,0,2,2
29687,decreases,0,0,2,2
29688,الاستقرائي,0,0,2,2
35690,ಬಹುತೇಕ,0,0,2,2
35694,projelerinin,0,0,2,2
28586,περιμένατε,0,0,2,2
36331,начал,0,0,2,2
27575,कस्टमनिर्मित,0,0,2,2
27577,boy,0,0,2,2
36351,സിൽവർ,0,0,2,2
27580,النزاعات,0,0,2,2
36347,customer,0,0,2,2
27593,publicou,0,0,2,2
36341,elements,0,0,2,2
27596,knol,0,0,2,2
27605,culturele,0,0,2,2
36333,kopen,0,0,2,2
36328,análises,0,0,2,2
27673,bijdragen,0,0,2,2
27629,accordent,0,0,2,2
36314,especialmente,0,0,2,2
27637,intensifier,0,0,2,2
52263,geschenk,0,0,2,2
52264,sécurité,0,0,2,2
978,vede.,1,2,0,2
36300,تخلق,0,0,2,2
52266,modèles,0,0,2,2
975,controversa,2,1,1,2
27666,clicking,0,0,2,2
27573,mediawikiservern,0,0,2,2
27572,encyclopédiques,0,0,2,2
27569,சிக்கலான,0,0,2,2
36363,cry,0,0,2,2
27484,identique,0,0,2,2
27490,συνεχίσετε,0,0,2,2
1003,calmati,1,2,0,2
27496,missão,0,0,2,2
36404,சிறுவன்,0,0,2,2
36398,beraber,0,0,2,2
1000,otterresti,1,2,0,2
27516,philosophes,0,0,2,2
36391,standards,0,0,2,2
36389,sød,0,0,2,2
52249,eb,0,0,2,2
36384,balança,0,0,2,2
27533,σταματήστε,0,0,2,2
52251,руководства,0,0,2,2
36377,ഇതിൽ,0,0,2,2
27543,banken,0,0,2,2
27547,label,0,0,2,2
27549,sentados,0,0,2,2
36370,फैसला,0,0,2,2
36369,libre»—,0,0,2,2
36365,zfs,0,0,2,2
973,predittiva.,1,2,0,2
27679,ಅಸಮಾಧಾನ,0,0,2,2
27867,run,0,0,2,2
27826,färre,0,0,2,2
958,hopfield,2,1,1,2
27770,diseñado,0,0,2,2
36220,heißt,0,0,2,2
27790,puisse,0,0,2,2
36210,വിശദീകരിച്ചു,0,0,2,2
36209,missing,0,0,2,2
27807,ಆಗಿ,0,0,2,2
36195,жениться,0,0,2,2
954,piatto,1,2,0,2
952,rivulet,2,1,1,2
27832,είχαν,0,0,2,2
27689,portion,0,0,2,2
27833,actualiser,0,0,2,2
27834,garden,0,0,2,2
951,anglia,2,1,1,2
36172,co,0,0,2,2
36171,procédures,0,0,2,2
27848,ideal,0,0,2,2
36165,conduite,0,0,2,2
27853,desconcertada,0,0,2,2
36163,находятся,0,0,2,2
27860,lesquelles,0,0,2,2
36230,முடியாமல்,0,0,2,2
27763,procurando,0,0,2,2
27755,contributor,0,0,2,2
27753,banning,0,0,2,2
27690,consequência,0,0,2,2
970,starò,1,2,0,2
36273,लैरी,0,0,2,2
27698,தரம்,0,0,2,2
27707,born,0,0,2,2
36264,jefferson,0,0,2,2
36263,pergunto,0,0,2,2
27712,न्यूट्रल,0,0,2,2
27713,inherently,0,0,2,2
36256,expand,0,0,2,2
52269,προφορά,0,0,2,2
27730,extensas,0,0,2,2
27731,न्यासी,0,0,2,2
27739,ഇനി,0,0,2,2
27741,scharf,0,0,2,2
963,piacessero,1,2,0,2
27743,موقفًا,0,0,2,2
36242,πήρατε,0,0,2,2
36241,durant,0,0,2,2
962,gemme,1,2,0,2
961,zuppa,1,2,0,2
27483,λικνίζεις,0,0,2,2
1007,cartacee,1,2,0,2
27479,quantrill,0,0,2,2
27280,cooperação,0,0,2,2
36560,dis,0,0,2,2
27249,totalt,0,0,2,2
27252,gennem,0,0,2,2
36550,"
azeri",0,0,2,2
27264,stored,0,0,2,2
27265,رؤيته,0,0,2,2
36546,meinung,0,0,2,2
36545,comenzar,0,0,2,2
52228,pequeño,0,0,2,2
52229,учёные,0,0,2,2
27283,welgemanierd,0,0,2,2
36416,सुनें।,0,0,2,2
27284,aşağıdaki,0,0,2,2
36540,الياقوت,0,0,2,2
52231,considerar,0,0,2,2
36536,ಒಪ್ಪುವುದಿಲ್ಲ,0,0,2,2
36534,lösning,0,0,2,2
27299,редактируют,0,0,2,2
36525,περάσετε,0,0,2,2
27313,आंशिक,0,0,2,2
36516,λέξεων,0,0,2,2
27319,मिलना,0,0,2,2
27234,candidate,0,0,2,2
36572,supercontinent,0,0,2,2
36574,conclusiones,0,0,2,2
27226,ссылался,0,0,2,2
36611,لقول,0,0,2,2
27168,عطلة,0,0,2,2
27170,profesor,0,0,2,2
27171,रहना,0,0,2,2
1052,studiato,1,2,0,2
27181,contou,0,0,2,2
27186,gelişmesi,0,0,2,2
27194,حولها,0,0,2,2
27195,istediğin,0,0,2,2
27198,yeterli,0,0,2,2
27199,ಬೆಳಿಗ್ಗೆ,0,0,2,2
27201,vendredi,0,0,2,2
36585,ziemlich,0,0,2,2
36581,freitag,0,0,2,2
1047,ricco,1,2,0,2
1046,"mobili,",1,2,0,2
27217,manuals,0,0,2,2
27222,paysbas,0,0,2,2
36576,flattening,0,0,2,2
27224,വേണ്ട,0,0,2,2
27225,ndesanjo,0,0,2,2
27326,περισσότερο,0,0,2,2
27329,textuel,0,0,2,2
27330,acht,0,0,2,2
27408,kunst,0,0,2,2
36460,ride,0,0,2,2
27413,обеспечения,0,0,2,2
36458,crowds,0,0,2,2
1019,direzione,1,2,0,2
36451,construir,0,0,2,2
27430,βάσης,0,0,2,2
27435,idioma,0,0,2,2
36442,वहां,0,0,2,2
36441,रिकॉर्ड,0,0,2,2
1017,norme,1,2,0,2
27443,globo,0,0,2,2
1014,commettono,1,2,0,2
27448,ins,0,0,2,2
36435,writes,0,0,2,2
36434,äter,0,0,2,2
27456,birbirlerinin,0,0,2,2
36430,forvaltere,0,0,2,2
27464,suédois,0,0,2,2
27468,gerektiğini,0,0,2,2
27469,നടത്തുന്നു,0,0,2,2
52243,sensitive,0,0,2,2
36461,blij,0,0,2,2
27406,ഇഷ്ടപ്പെടുന്നു,0,0,2,2
1027,conflitti,1,2,0,2
36465,последним,0,0,2,2
27333,figura,0,0,2,2
36506,ಪ್ರಯತ್ನಿಸಿ,0,0,2,2
36501,நம்புகிறேன்,0,0,2,2
27341,क़िताबें,0,0,2,2
1026,tendiamo,1,2,0,2
27347,modify,0,0,2,2
36495,klik,0,0,2,2
36494,μαθήματα,0,0,2,2
27353,conclusão,0,0,2,2
27364,विश्वकोशों,0,0,2,2
36486,deserve,0,0,2,2
27366,मुश्किल,0,0,2,2
27368,incapazes,0,0,2,2
36484,toegang,0,0,2,2
27389,purpose,0,0,2,2
27394,ആൺകുട്ടി,0,0,2,2
27395,verwijderd,0,0,2,2
27396,diagnostic,0,0,2,2
27398,വേണ്ടെന്ന്,0,0,2,2
27401,subdomain,0,0,2,2
36466,demandes,0,0,2,2
36157,généraliste,0,0,2,2
36154,kardeş,0,0,2,2
35700,पूर्वाग्रह,0,0,2,2
35849,fundamentales,0,0,2,2
28308,θέλεις,0,0,2,2
35876,gradually,0,0,2,2
28315,ställe,0,0,2,2
35865,culto,0,0,2,2
854,nove,1,2,0,2
28333,amerikanska,0,0,2,2
28337,resolve,0,0,2,2
28343,hoop,0,0,2,2
35856,fácilmente,0,0,2,2
35852,കഴിയില്ലെന്ന്,0,0,2,2
35848,planalto,0,0,2,2
28399,mereço,0,0,2,2
35846,चला,0,0,2,2
35842,désigne,0,0,2,2
28364,tidskrifter,0,0,2,2
35840,anser,0,0,2,2
28368,കൈ,0,0,2,2
35838,hidden,0,0,2,2
35835,أمر,0,0,2,2
52337,متفرغ,0,0,2,2
35825,probeer,0,0,2,2
28393,τίτλο,0,0,2,2
35879,словом,0,0,2,2
35880,permitan,0,0,2,2
857,&,1,2,0,2
28300,recebendo,0,0,2,2
35912,esplanada,0,0,2,2
28255,oito,0,0,2,2
35911,grappige,0,0,2,2
28260,πρωί,0,0,2,2
28263,klicken,0,0,2,2
35907,prononciation,0,0,2,2
35906,sociaux,0,0,2,2
859,tradizionalmente,1,2,0,2
28269,банковский,0,0,2,2
28279,sju,0,0,2,2
35894,विभिन्न,0,0,2,2
35893,graças,0,0,2,2
28283,ಮಾಂತ್ರಿಕ,0,0,2,2
28285,கேட்டபோது,0,0,2,2
28292,परिभाषित,0,0,2,2
28293,fransa,0,0,2,2
28294,springer,0,0,2,2
35885,wikiwiki,0,0,2,2
35884,विशाल,0,0,2,2
28297,ister,0,0,2,2
28298,consistía,0,0,2,2
28394,اكتشاف,0,0,2,2
28400,bildirin,0,0,2,2
27870,item,0,0,2,2
28525,विकि,0,0,2,2
28503,записи,0,0,2,2
35750,editam,0,0,2,2
28506,രഹസ്യ,0,0,2,2
28507,الجدد,0,0,2,2
823,adattivo,1,2,0,2
35742,katalanska,0,0,2,2
28515,attendez,0,0,2,2
28516,lämpligt,0,0,2,2
35738,ലേഖനങ്ങളെഴുതിയ,0,0,2,2
28523,സംഭാവന,0,0,2,2
820,magnifico,1,2,0,2
28401,examiner,0,0,2,2
35731,மாற,0,0,2,2
35727,ανθρώπους,0,0,2,2
28543,பிரமாதமான,0,0,2,2
28546,карете,0,0,2,2
35719,റൊട്ടിയും,0,0,2,2
35714,لعبتك,0,0,2,2
815,opinione,1,2,0,2
28557,निर्णय,0,0,2,2
28562,geração,0,0,2,2
28572,расстраивайтесь,0,0,2,2
35752,pensais,0,0,2,2
28500,beginning,0,0,2,2
35756,midden,0,0,2,2
824,William,1,2,0,2
28409,jeito,0,0,2,2
35808,ಹೊಂದಿದೆ,0,0,2,2
28414,closest,0,0,2,2
35807,fiil,0,0,2,2
28419,открытый,0,0,2,2
35800,cieux,0,0,2,2
28440,traitant,0,0,2,2
28442,hiring,0,0,2,2
834,accessibile,1,2,0,2
833,pdf,2,1,1,2
832,entrò,1,2,0,2
35785,баз,0,0,2,2
35777,inscription,0,0,2,2
35772,இல்லாமல்,0,0,2,2
28474,allebei,0,0,2,2
28476,வேலையைத்,0,0,2,2
35764,épouser,0,0,2,2
28485,podía,0,0,2,2
28486,contexto,0,0,2,2
35761,ساهم,0,0,2,2
28491,relicense,0,0,2,2
28253,intonationen,0,0,2,2
28250,enfant,0,0,2,2
35915,yiyeceklere,0,0,2,2
52296,acíclico,0,0,2,2
27972,unser,0,0,2,2
52291,perfekt,0,0,2,2
36090,acusada,0,0,2,2
36089,émancipation,0,0,2,2
923,placche,1,2,0,2
27986,особенностью,0,0,2,2
36082,fingrar,0,0,2,2
36081,biliyordum,0,0,2,2
27995,нарцисс,0,0,2,2
28002,economy,0,0,2,2
28018,zavallı,0,0,2,2
35919,ಭವ್ಯವಾದ,0,0,2,2
36051,resultaat,0,0,2,2
28036,fancy,0,0,2,2
28039,poner,0,0,2,2
906,tipo.,1,2,0,2
52302,السرية,0,0,2,2
28049,lives,0,0,2,2
28057,pasaron,0,0,2,2
896,tempestata,1,2,0,2
36039,kentinde,0,0,2,2
36038,star,0,0,2,2
926,infrazioni,1,2,0,2
36098,velkommen,0,0,2,2
928,proposito,1,2,0,2
52290,جذر,0,0,2,2
52281,explanation,0,0,2,2
52282,lançada,0,0,2,2
36148,onderdeel,0,0,2,2
27886,utifrån,0,0,2,2
27892,pauvre,0,0,2,2
36141,പ്രവർത്തിക്കുന്നു,0,0,2,2
27901,രണ്ടു,0,0,2,2
52285,varandra,0,0,2,2
27910,deverá,0,0,2,2
36131,locked,0,0,2,2
27918,hoppas,0,0,2,2
27926,porte,0,0,2,2
27927,kâr,0,0,2,2
36122,आदि,0,0,2,2
27935,mécanisme,0,0,2,2
27941,долю,0,0,2,2
36114,vanderbilt,0,0,2,2
36113,essenciais,0,0,2,2
36112,wikiversity,0,0,2,2
36110,mache,0,0,2,2
27953,ταξίδι,0,0,2,2
36036,independentes,0,0,2,2
36032,internos,0,0,2,2
36025,विपरीत,0,0,2,2
35971,wer,0,0,2,2
28168,centre,0,0,2,2
28169,motor,0,0,2,2
35968,сне,0,0,2,2
35966,nosso,0,0,2,2
28176,yakalama,0,0,2,2
35963,पुर्तगाली,0,0,2,2
28186,februari,0,0,2,2
28190,vigiadas,0,0,2,2
35956,trægt,0,0,2,2
872,evitare,1,2,0,2
28196,الحين,0,0,2,2
871,attimo.,1,2,0,2
28203,destinamse,0,0,2,2
35940,अगस्त,0,0,2,2
28215,எதுவும்,0,0,2,2
52324,usaron,0,0,2,2
28220,существуют,0,0,2,2
52325,பார்த்து,0,0,2,2
28227,рецензирования,0,0,2,2
35923,ब्रिटेनिका,0,0,2,2
35921,பயனர்கள்,0,0,2,2
28167,технологического,0,0,2,2
28159,demand,0,0,2,2
28080,ಯಾವುದು,0,0,2,2
35978,हुह,0,0,2,2
28091,வைத்திருக்கிறேன்,0,0,2,2
36011,presença,0,0,2,2
36008,appears,0,0,2,2
36007,хотел,0,0,2,2
28107,rédigé,0,0,2,2
28108,forces,0,0,2,2
36005,prenumerationsknappen,0,0,2,2
36002,atribución,0,0,2,2
36001,soruyorum,0,0,2,2
36000,extensión,0,0,2,2
28119,tænke,0,0,2,2
35997,varies,0,0,2,2
35996,prédominance,0,0,2,2
28126,déjeuner,0,0,2,2
28128,രാഷ്ട്രീയ,0,0,2,2
28129,microfilm,0,0,2,2
28137,régulièrement,0,0,2,2
28138,flows,0,0,2,2
35986,κλαίνε,0,0,2,2
880,verificabilità,1,2,0,2
879,efficiente,1,2,0,2
30085,धीमे,0,0,2,2
34752,tried,0,0,2,2
30089,inteligência,0,0,2,2
32057,pt,0,0,2,2
32021,rápido,0,0,2,2
32025,bordet,0,0,2,2
33520,ordinary,0,0,2,2
188,deviazioni,1,2,0,2
32034,ஆய்வின்,0,0,2,2
32042,lindo,0,0,2,2
33510,objectifs,0,0,2,2
187,stretti,1,2,0,2
32045,estadunidense,0,0,2,2
186,sì.,1,2,0,2
33499,consigues,0,0,2,2
172,quarto,1,2,0,2
32063,रखती,0,0,2,2
32065,binnen,0,0,2,2
32069,partage,0,0,2,2
33493,usted,0,0,2,2
32084,maurice,0,0,2,2
33483,المسجلين,0,0,2,2
176,bilico,1,2,0,2
52677,homepage,0,0,2,2
33478,شعرت,0,0,2,2
32097,виделись,0,0,2,2
52671,இதற்குக்,0,0,2,2
52670,usarem,0,0,2,2
32013,kullanıcıların,0,0,2,2
32010,имени,0,0,2,2
31958,pédagogique,0,0,2,2
203,canada,2,1,1,2
31969,فلا,0,0,2,2
33560,kullanabilirsiniz,0,0,2,2
33558,сделано,0,0,2,2
33553,ಸರಿಯಾದ,0,0,2,2
33552,semanal,0,0,2,2
31979,fines,0,0,2,2
31980,dejlig,0,0,2,2
201,adattarsi,1,2,0,2
33547,उल्लेख,0,0,2,2
31988,altavoz,0,0,2,2
33546,baseado,0,0,2,2
31990,skarpt,0,0,2,2
200,white,2,1,1,2
31994,ബാങ്ക്,0,0,2,2
33538,tusentals,0,0,2,2
33536,теме,0,0,2,2
33535,ഏതെങ്കിലും,0,0,2,2
33534,சொல்கிறேன்,0,0,2,2
52668,warten,0,0,2,2
32098,störst,0,0,2,2
33465,നിന്നു,0,0,2,2
33363,perplexes,0,0,2,2
33389,esbozos,0,0,2,2
32205,aanstaande,0,0,2,2
32208,acto,0,0,2,2
32210,kaufen,0,0,2,2
151,Sue,1,2,0,2
150,vicino.,1,2,0,2
32219,evitar,0,0,2,2
32221,avhandlingen,0,0,2,2
32224,ocorreu,0,0,2,2
33392,kurallarına,0,0,2,2
32231,श्रेणी,0,0,2,2
32234,بريتانيكا،,0,0,2,2
33462,gostou,0,0,2,2
32242,chosen,0,0,2,2
141,attribuita,1,2,0,2
32246,iedere,0,0,2,2
32250,realiza,0,0,2,2
32252,drücken,0,0,2,2
32257,editorinchief,0,0,2,2
52689,saß,0,0,2,2
33367,முடிவு,0,0,2,2
32272,تكن,0,0,2,2
32273,источники,0,0,2,2
32202,उसका,0,0,2,2
52686,sauvagerie,0,0,2,2
32195,norte,0,0,2,2
33411,própria,0,0,2,2
32117,двигаться,0,0,2,2
32121,evlenmek,0,0,2,2
33455,otherwise,0,0,2,2
32135,സൗജന്യവും,0,0,2,2
33446,என்பதால்,0,0,2,2
33442,officiellement,0,0,2,2
33439,retour,0,0,2,2
32157,uneven,0,0,2,2
32158,ಹೆಸರಿನ,0,0,2,2
32163,تأثير,0,0,2,2
162,inaffidabile.,1,2,0,2
161,introduce,2,1,1,2
32169,weinig,0,0,2,2
33428,വ്യക്തമായ,0,0,2,2
32179,reproduction,0,0,2,2
33417,exame,0,0,2,2
32187,resistance,0,0,2,2
33414,förstod,0,0,2,2
52685,trolls,0,0,2,2
32191,مناسب,0,0,2,2
33412,protocol,0,0,2,2
33569,acceptées,0,0,2,2
31954,ultimately,0,0,2,2
31953,फ़ाइल,0,0,2,2
231,tanta,2,1,1,2
237,infine,1,2,0,2
31695,lanserades,0,0,2,2
31706,växer,0,0,2,2
31710,सप्ताह,0,0,2,2
52651,الأكادميين,0,0,2,2
31716,ಫೋನ್,0,0,2,2
33727,employs,0,0,2,2
31721,المعتاد,0,0,2,2
52653,நிறைய,0,0,2,2
33721,r,0,0,2,2
33716,val,0,0,2,2
33574,ആരോ,0,0,2,2
31736,libre—,0,0,2,2
33714,schleppend,0,0,2,2
230,rilevato,1,2,0,2
31741,relaciones,0,0,2,2
52654,factualmente,0,0,2,2
33706,വേഗത,0,0,2,2
31748,एडम्स,0,0,2,2
33705,klicka,0,0,2,2
31752,concevoir,0,0,2,2
31755,förutom,0,0,2,2
52648,ಹೇಗೆ,0,0,2,2
33754,italie,0,0,2,2
31672,മിനിറ്റിനുള്ളിൽ,0,0,2,2
33760,मेलिंग,0,0,2,2
31596,privatisation,0,0,2,2
33804,unreliable,0,0,2,2
31605,прикрыть,0,0,2,2
33800,известность,0,0,2,2
52640,स्थापित,0,0,2,2
33798,riken,0,0,2,2
255,"strato,",1,2,0,2
33797,الليلة؟,0,0,2,2
31613,रहूँगा,0,0,2,2
33794,interação,0,0,2,2
31623,opgaver,0,0,2,2
31627,क्रिया,0,0,2,2
251,esplorativa,1,2,0,2
31633,ಹೇಳಿದರು,0,0,2,2
31638,reprise,0,0,2,2
31642,laissé,0,0,2,2
52644,programmes,0,0,2,2
245,città.,1,2,0,2
243,previsione.,1,2,0,2
33768,சொற்களஞ்சியத்தை,0,0,2,2
33762,drowning,0,0,2,2
33700,dizaines,0,0,2,2
31760,computador,0,0,2,2
31764,altered,0,0,2,2
31873,analizar,0,0,2,2
31881,понятие,0,0,2,2
214,signpost,2,1,1,2
33610,türkçe,0,0,2,2
33609,അറിയിക്കുക,0,0,2,2
52661,vinner,0,0,2,2
33605,πράξη,0,0,2,2
211,considerazione,1,2,0,2
31908,constituyen,0,0,2,2
52665,openness,0,0,2,2
33598,المستنقع,0,0,2,2
31914,visible,0,0,2,2
31917,intensifique,0,0,2,2
33591,источником,0,0,2,2
33590,νόστιμα,0,0,2,2
31930,حذف,0,0,2,2
31934,ಎಷ್ಟು,0,0,2,2
206,"video,",1,2,0,2
31938,स्कूल,0,0,2,2
205,l'informazione,1,2,0,2
31943,artikelhistoriken,0,0,2,2
31947,وهي,0,0,2,2
31879,örneği,0,0,2,2
31871,anúncio,0,0,2,2
33694,politician,0,0,2,2
31867,ಮನಸ್ಸಿನಲ್ಲಿ,0,0,2,2
226,concorso,1,2,0,2
31775,contribute,0,0,2,2
31783,halsiz,0,0,2,2
225,perspectives,1,2,0,2
33676,connais,0,0,2,2
31801,தேதி,0,0,2,2
221,dimenticano,1,2,0,2
31816,dissesse,0,0,2,2
31817,racist,0,0,2,2
31819,facteurs,0,0,2,2
33656,doorgaan,0,0,2,2
31821,सफल,0,0,2,2
31829,cümleyi,0,0,2,2
31830,portugués,0,0,2,2
31839,स्वयंसेवकों,0,0,2,2
33644,പ്രശ്നമുണ്ടോ,0,0,2,2
217,ore,1,2,0,2
216,latino,1,2,0,2
31854,dominios,0,0,2,2
31861,bekæmpe,0,0,2,2
33625,bäst,0,0,2,2
32274,என்னைப்,0,0,2,2
33361,ध्यान,0,0,2,2
31577,النمو,0,0,2,2
32726,opérations,0,0,2,2
32694,क्रूर,0,0,2,2
33108,höre,0,0,2,2
32701,providers,0,0,2,2
33103,πείραζε,0,0,2,2
33100,சொல்கிறீர்கள்,0,0,2,2
33090,locomotion,0,0,2,2
47,vecchia,1,2,0,2
32718,alabilir,0,0,2,2
32724,huske,0,0,2,2
45,avrà,1,2,0,2
32734,ستحصل,0,0,2,2
52734,contexts,0,0,2,2
33075,ejecuta,0,0,2,2
33074,trendline,0,0,2,2
33073,واسعة,0,0,2,2
33071,hinanden,0,0,2,2
42,informazione,1,2,0,2
52731,φίλο,0,0,2,2
32750,лицензиями,0,0,2,2
33064,experiente,0,0,2,2
32759,വിളിക്കുന്നു,0,0,2,2
33057,iniciado,0,0,2,2
33109,رأيك,0,0,2,2
33112,سخيف,0,0,2,2
33115,ഇപ്പോഴും,0,0,2,2
33118,violation,0,0,2,2
32604,ashburn,0,0,2,2
32606,ஒருவேளை,0,0,2,2
69,particelle,1,2,0,2
68,"e,",1,2,0,2
33163,katılmıyorum,0,0,2,2
63,watchlist,2,1,1,2
33150,recognize,0,0,2,2
32632,discours,0,0,2,2
60,passo,2,1,1,2
59,fermarti,1,2,0,2
32640,hemma,0,0,2,2
33140,ಒಳ್ಳೆಯದನ್ನು,0,0,2,2
32647,fließend,0,0,2,2
32649,ordförråd,0,0,2,2
32653,уэйлсу,0,0,2,2
32656,accessible,0,0,2,2
33133,τύπο,0,0,2,2
32664,ಬ್ಯಾಂಕ್,0,0,2,2
32670,estaban,0,0,2,2
32675,gong,0,0,2,2
32677,weekly,0,0,2,2
52733,തോന്നുന്നതിനുള്ള,0,0,2,2
33055,இதனை,0,0,2,2
32282,формате,0,0,2,2
32972,concernant,0,0,2,2
32990,ಮಾಡಬೇಕೆಂದು,0,0,2,2
52739,petit,0,0,2,2
32985,establecer,0,0,2,2
32873,മാതൃക,0,0,2,2
32879,തുടർച്ചയായി,0,0,2,2
20,diversità,1,2,0,2
32885,manutenção,0,0,2,2
16,documenti,1,2,0,2
32891,भंडार,0,0,2,2
52744,جائع,0,0,2,2
52745,марион,0,0,2,2
32768,power,0,0,2,2
32967,metres,0,0,2,2
32966,sos,0,0,2,2
52747,ஒருவருக்கொருவர்,0,0,2,2
32960,одного,0,0,2,2
32917,verrückt,0,0,2,2
32919,stumpe,0,0,2,2
32922,användbara,0,0,2,2
32953,στους,0,0,2,2
32950,തിരഞ്ഞെടുക്കുന്നു,0,0,2,2
2,bambina,1,2,0,2
32852,nativos,0,0,2,2
32850,அனுப்புவேன்,0,0,2,2
30,parte.,1,2,0,2
32846,måder,0,0,2,2
33052,publics,0,0,2,2
33046,sigue,0,0,2,2
33040,entscheidung,0,0,2,2
33036,próprio,0,0,2,2
33034,статистических,0,0,2,2
32800,rentrer,0,0,2,2
32806,அங்கே,0,0,2,2
32807,доступными,0,0,2,2
33028,betreft,0,0,2,2
52736,habitats,0,0,2,2
33017,ಹೆಸರು,0,0,2,2
32825,precis,0,0,2,2
32827,unesco,0,0,2,2
32829,servicios,0,0,2,2
31,condivisione,1,2,0,2
33010,स्टीफन,0,0,2,2
32838,देखें,0,0,2,2
33006,ليست,0,0,2,2
33004,letters,0,0,2,2
33002,अभी,0,0,2,2
32845,amables,0,0,2,2
32603,capteurs,0,0,2,2
33170,ferais,0,0,2,2
33176,المسؤولون,0,0,2,2
32385,optimal,0,0,2,2
32348,minutter,0,0,2,2
32349,இனிமேல்,0,0,2,2
33324,இயங்கும்,0,0,2,2
33323,opensolaris,0,0,2,2
33321,adjö,0,0,2,2
32364,studera,0,0,2,2
32367,журнале,0,0,2,2
32374,глупый,0,0,2,2
32378,soporte,0,0,2,2
32381,relying,0,0,2,2
32386,caracol,0,0,2,2
33177,pageviews,0,0,2,2
33304,proibir,0,0,2,2
32391,hundred,0,0,2,2
32392,लाईसेन्स,0,0,2,2
33301,diversity,0,0,2,2
113,hughes,2,1,1,2
32403,dudas,0,0,2,2
32405,begrepen,0,0,2,2
33291,kendt,0,0,2,2
32415,ஏனெனில்,0,0,2,2
32416,உண்மையிலேயே,0,0,2,2
119,teorica,1,2,0,2
52696,acciones,0,0,2,2
33327,l’histoire,0,0,2,2
33328,dromen,0,0,2,2
32284,последнее,0,0,2,2
32288,учёных,0,0,2,2
33358,ಹೆಚ್ಚಾಗಿ,0,0,2,2
52693,specialiserade,0,0,2,2
32291,hantera,0,0,2,2
32295,reise,0,0,2,2
33354,மெதுவான,0,0,2,2
32299,मेली,0,0,2,2
129,denuncia,2,1,1,2
128,premendo,1,2,0,2
33351,anonyma,0,0,2,2
33349,limité,0,0,2,2
127,fisica,1,2,0,2
32311,participated,0,0,2,2
32319,sender,0,0,2,2
32329,الآخرين,0,0,2,2
33332,എങ്കിലും,0,0,2,2
32334,waarmee,0,0,2,2
33331,jusqu’à,0,0,2,2
122,scene,2,1,1,2
32339,تذهب,0,0,2,2
32417,சந்தா,0,0,2,2
52706,lutter,0,0,2,2
33272,stakkels,0,0,2,2
52719,बढ़ाने,0,0,2,2
33219,καλύψεις,0,0,2,2
32535,ressaisistoi,0,0,2,2
80,dell'oceano,1,2,0,2
32540,gördüğünü,0,0,2,2
32541,கூர்மையான,0,0,2,2
32542,hacia,0,0,2,2
33209,corps,0,0,2,2
52721,entity,0,0,2,2
76,continuò,1,2,0,2
33205,considerado,0,0,2,2
32556,teléfono,0,0,2,2
33203,magical,0,0,2,2
32559,विस्तार,0,0,2,2
75,teme,1,2,0,2
32562,ट्रुथ,0,0,2,2
32567,reduction,0,0,2,2
74,origini,1,2,0,2
33191,estatuto,0,0,2,2
33186,herkes,0,0,2,2
32586,понимаю,0,0,2,2
33182,kampen,0,0,2,2
85,ferro,1,2,0,2
32521,ಮಧ್ಯದಲ್ಲಿದ್ದರೆ,0,0,2,2
32443,ചോദിക്കാൻ,0,0,2,2
32514,lancer,0,0,2,2
32444,varsa,0,0,2,2
32445,pleasure,0,0,2,2
33266,metabolism,0,0,2,2
32454,ende,0,0,2,2
33265,électorale,0,0,2,2
32457,últimas,0,0,2,2
32463,preserves,0,0,2,2
32466,блокировки,0,0,2,2
33258,والآن,0,0,2,2
33254,ಶನಿವಾರ,0,0,2,2
33251,contribuyentes,0,0,2,2
93,παιδεία,2,1,1,2
32482,bericht,0,0,2,2
33239,classifying,0,0,2,2
52715,adaptan,0,0,2,2
32496,അതായത്,0,0,2,2
33236,similitud,0,0,2,2
33230,работайте,0,0,2,2
32505,vandalizm,0,0,2,2
33228,விவரிக்கிறார்கள்,0,0,2,2
32510,udelukkende,0,0,2,2
33808,hazırlanmaktadır,0,0,2,2
31573,pendentes,0,0,2,2
34750,அவருடன்,0,0,2,2
30588,കാര്യനിർവ്വാഹകർ,0,0,2,2
30558,débattues,0,0,2,2
52542,dillerdeki,0,0,2,2
34460,المساهمات,0,0,2,2
30571,εξαιτίας,0,0,2,2
30574,användargränssnitt,0,0,2,2
30576,سيجنثالر،,0,0,2,2
441,ottieni.,1,2,0,2
30583,arabic,0,0,2,2
30584,wurzel,0,0,2,2
34453,सेकंड,0,0,2,2
30590,plane,0,0,2,2
34432,samtalen,0,0,2,2
30592,മറ്റെന്തെങ്കിലും,0,0,2,2
30594,सवेव,0,0,2,2
30595,denominativo,0,0,2,2
34446,consider,0,0,2,2
34441,remained,0,0,2,2
30610,enseignement,0,0,2,2
30612,circulation,0,0,2,2
30614,tropas,0,0,2,2
30616,διαφορετικά,0,0,2,2
30620,favorite,0,0,2,2
446,mrs,2,1,1,2
448,dispositivo,2,1,1,2
34473,വർഗ്ഗ,0,0,2,2
30543,travel,0,0,2,2
30487,fed,0,0,2,2
461,abiotici,1,2,0,2
30494,biographies,0,0,2,2
30495,vandálicos,0,0,2,2
34501,abuse,0,0,2,2
30501,ക്രോധ,0,0,2,2
52536,सकें,0,0,2,2
30507,pierre,0,0,2,2
30511,gången,0,0,2,2
457,esistenza,1,2,0,2
30517,notícia,0,0,2,2
30519,samarbetet,0,0,2,2
455,originali.,1,2,0,2
454,costruire,1,2,0,2
30524,etmenin,0,0,2,2
30527,landen,0,0,2,2
30528,وتمييز,0,0,2,2
34482,bloque,0,0,2,2
450,rappresentativa,1,2,0,2
34477,انت,0,0,2,2
30538,cobriam,0,0,2,2
30621,تشمل,0,0,2,2
30627,autoridade,0,0,2,2
404,"no,",1,2,0,2
414,infantile,1,2,0,2
30702,amaçlı,0,0,2,2
424,gboard,2,1,1,2
34375,durgun,0,0,2,2
34361,красота,0,0,2,2
420,efficaci,1,2,0,2
417,tante,1,2,0,2
30742,videregive,0,0,2,2
30745,तारीख,0,0,2,2
34356,observe,0,0,2,2
415,"multimediali,",1,2,0,2
30756,minhas,0,0,2,2
434,kurier,2,1,1,2
412,avveri,1,2,0,2
30764,ஆர்வம்,0,0,2,2
34343,يكتب,0,0,2,2
409,combinazione,1,2,0,2
34340,representan,0,0,2,2
34339,graphs,0,0,2,2
30779,gorman,0,0,2,2
34330,ട്യൂമറിന്റെ,0,0,2,2
30786,portail,0,0,2,2
34327,parlementaire,0,0,2,2
426,rivelato,1,2,0,2
30697,oorsprong,0,0,2,2
30696,förtydliga,0,0,2,2
30695,revanche,0,0,2,2
34426,കമ്പ്യൂട്ടർ,0,0,2,2
34425,semiprotegidos,0,0,2,2
30634,bans,0,0,2,2
432,proprietari,1,2,0,2
34422,weglatingen,0,0,2,2
30643,चलता,0,0,2,2
34417,санфранциско,0,0,2,2
30650,journaux,0,0,2,2
30651,ಸ್ಥಳವನ್ನು,0,0,2,2
30652,disciplines,0,0,2,2
34414,αριθμό,0,0,2,2
52547,neşelen,0,0,2,2
30656,convection,0,0,2,2
34408,geliştirmesine,0,0,2,2
34406,കാര്യങ്ങൾക്കോ,0,0,2,2
34401,говорят,0,0,2,2
30673,سهل,0,0,2,2
30679,lezzetli,0,0,2,2
34390,stoppede,0,0,2,2
34389,estabelecido,0,0,2,2
30690,besten,0,0,2,2
30485,inspirado,0,0,2,2
34511,அங்கு,0,0,2,2
52534,army,0,0,2,2
30262,occasion,0,0,2,2
34678,migrating,0,0,2,2
30214,ख्याल,0,0,2,2
30222,बढ़ने,0,0,2,2
30225,காலத்தில்,0,0,2,2
34671,मुझसे,0,0,2,2
510,intervista,1,2,0,2
30241,யார்,0,0,2,2
34654,خاطئة,0,0,2,2
34650,मजाक,0,0,2,2
34645,regel,0,0,2,2
30267,descrita,0,0,2,2
34514,mobiltelefon,0,0,2,2
30268,estadística,0,0,2,2
503,hardcore,2,1,1,2
30271,soutenir,0,0,2,2
30276,எங்களுக்கு,0,0,2,2
30277,fortjener,0,0,2,2
30288,trouver,0,0,2,2
30293,математической,0,0,2,2
30296,الشديد,0,0,2,2
30304,øve,0,0,2,2
30306,шутка,0,0,2,2
30193,publicitários,0,0,2,2
520,ipotizzato,1,2,0,2
30180,какоето,0,0,2,2
52500,доступные,0,0,2,2
30091,atender,0,0,2,2
30093,inappropriées,0,0,2,2
34748,jours,0,0,2,2
30096,أشعر,0,0,2,2
34734,thuis,0,0,2,2
30118,glass,0,0,2,2
30120,английским,0,0,2,2
34727,πρόγραμμα,0,0,2,2
34725,ന്,0,0,2,2
30132,ആവർത്തിക്കാൻ,0,0,2,2
530,tecnico,1,2,0,2
30135,décimo,0,0,2,2
34719,förtjänar,0,0,2,2
34716,executive,0,0,2,2
30147,mutation,0,0,2,2
30149,فبراير,0,0,2,2
528,etichettati.,1,2,0,2
30153,prontitud,0,0,2,2
30154,ноября,0,0,2,2
34704,concluded,0,0,2,2
30174,dirigentes,0,0,2,2
34614,классических,0,0,2,2
496,gradi.,1,2,0,2
34611,إرسال,0,0,2,2
30404,bog,0,0,2,2
475,stargli,1,2,0,2
30412,capazes,0,0,2,2
34547,ഉള്ളത്,0,0,2,2
30416,öğrenmeye,0,0,2,2
30417,крупные,0,0,2,2
30423,uppnått,0,0,2,2
30433,stade,0,0,2,2
34537,ಸಂಜೆ,0,0,2,2
30435,gamla,0,0,2,2
30437,கோணம்,0,0,2,2
30438,നിഷ്പ്രയാസം,0,0,2,2
34533,försöker,0,0,2,2
30443,l’encyclopédie,0,0,2,2
34531,усерднее,0,0,2,2
30450,बताता,0,0,2,2
30451,தொகுப்புக்களை,0,0,2,2
30454,المتعلقة,0,0,2,2
466,ridistribuzione,1,2,0,2
465,stampata.,1,2,0,2
34517,tillämpas,0,0,2,2
30475,kaffe,0,0,2,2
476,un'analisi,1,2,0,2
30403,proposée,0,0,2,2
495,incoraggiato,1,2,0,2
34560,buscas,0,0,2,2
30322,فترة,0,0,2,2
492,stamattina,1,2,0,2
30328,формально,0,0,2,2
30329,ilgili,0,0,2,2
34597,الواقع,0,0,2,2
30342,май,0,0,2,2
30348,தலைமையான,0,0,2,2
30349,längre,0,0,2,2
30350,ನಮಗೆ,0,0,2,2
30356,சொல்வதற்கான,0,0,2,2
30357,primárias,0,0,2,2
30361,ലേഖനത്തിന്റെ,0,0,2,2
30362,सेक्शन,0,0,2,2
30363,koruma,0,0,2,2
30365,kontroversielle,0,0,2,2
30369,anteriormente,0,0,2,2
34577,تعرفه,0,0,2,2
482,automatica,1,2,0,2
34567,kopf,0,0,2,2
30387,vy,0,0,2,2
30394,वेब्बी,0,0,2,2
34321,menciones,0,0,2,2
34320,evolution,0,0,2,2
31572,touch,0,0,2,2
33958,nuestro,0,0,2,2
31317,പഠനം,0,0,2,2
31319,जीवनी,0,0,2,2
31321,архитектуры,0,0,2,2
31322,അറിയപ്പെടുന്ന,0,0,2,2
31327,dreams,0,0,2,2
31332,ಹುಡುಗ,0,0,2,2
31334,машинами,0,0,2,2
31337,ಬಡ,0,0,2,2
33963,opmuntre,0,0,2,2
297,avevi,1,2,0,2
296,minimizzare,1,2,0,2
31414,ಕನಸುಗಳ,0,0,2,2
31361,الأعمال,0,0,2,2
31370,narzissenhand,0,0,2,2
293,prendo.,1,2,0,2
31373,aprenderá,0,0,2,2
31380,டெரன்ஸ்,0,0,2,2
31381,جميعًا,0,0,2,2
33938,göndermek,0,0,2,2
33934,острого,0,0,2,2
33926,प्रतिष्ठा,0,0,2,2
31405,oldu,0,0,2,2
33983,removidas,0,0,2,2
31309,нарцис,0,0,2,2
31307,famosos,0,0,2,2
31303,seasonal,0,0,2,2
34053,lessen,0,0,2,2
31219,меньше,0,0,2,2
31220,تعال,0,0,2,2
34046,grew,0,0,2,2
312,enhanced,1,2,0,2
31224,mágico,0,0,2,2
31241,wünschen,0,0,2,2
34030,siècles,0,0,2,2
34025,موضوع,0,0,2,2
31250,rapidez,0,0,2,2
31267,زائر,0,0,2,2
34008,göndereceğim,0,0,2,2
34007,ταινίες,0,0,2,2
34006,ಮನೆಯಲ್ಲಿ,0,0,2,2
31279,देखना,0,0,2,2
31291,increíblemente,0,0,2,2
303,pedofilia,2,1,1,2
31295,prevalent,0,0,2,2
31299,ontvoering,0,0,2,2
33989,balance,0,0,2,2
33988,formatting,0,0,2,2
31406,rapide,0,0,2,2
31415,τόσα,0,0,2,2
30803,പണം,0,0,2,2
31522,trække,0,0,2,2
31499,resume,0,0,2,2
33867,icon,0,0,2,2
31504,स्त्रोत,0,0,2,2
31505,factually,0,0,2,2
31508,ಎಳೆಯಿರಿ,0,0,2,2
31515,अखबार,0,0,2,2
52630,evening,0,0,2,2
33858,étymologie,0,0,2,2
31519,क्लिक,0,0,2,2
33857,രേഖകൾ,0,0,2,2
31528,आपत्तिजनक,0,0,2,2
288,icona,1,2,0,2
31529,savais,0,0,2,2
31534,eigen,0,0,2,2
33846,इनमें,0,0,2,2
33844, years,0,0,2,2
33841,strong,0,0,2,2
31544,soar,0,0,2,2
33837,декабря,0,0,2,2
52637,exactamente,0,0,2,2
31561,grundlæggende,0,0,2,2
33831,hiervan,0,0,2,2
33870,தோற்றம்,0,0,2,2
31491,nadruk,0,0,2,2
33876,பேசிக்கொண்டிருக்கலாம்,0,0,2,2
31488,trick,0,0,2,2
31424,wikiconcept,0,0,2,2
31426,ಮರೆಯದಿರಿ,0,0,2,2
33913,watercourse,0,0,2,2
33911,relied,0,0,2,2
31432,مثال,0,0,2,2
31439,devenant,0,0,2,2
31440,—literalmente—,0,0,2,2
31443,seguida,0,0,2,2
33903,спрашиваете,0,0,2,2
33898,വാക്യങ്ങൾ‌,0,0,2,2
33896,beteende,0,0,2,2
31461,naissance,0,0,2,2
33891,requiere,0,0,2,2
278,recoba,1,2,0,2
31466,corrigir,0,0,2,2
33888,mijl,0,0,2,2
31472,mão,0,0,2,2
33882,dichas,0,0,2,2
31483,xviie,0,0,2,2
52627,للصفحة,0,0,2,2
33877,professores,0,0,2,2
316,telegramma,1,2,0,2
317,orizzontale,1,2,0,2
31196,சோதனை,0,0,2,2
34208,நேரத்தில்,0,0,2,2
34226,acadêmicas,0,0,2,2
34224,hakkına,0,0,2,2
30935,pertinent,0,0,2,2
30937,ಸಭೆಗೆ,0,0,2,2
30943,pues,0,0,2,2
30945,promotion,0,0,2,2
34217,تقدم,0,0,2,2
30950,constatou,0,0,2,2
34213,oprindeligt,0,0,2,2
30954,falun,0,0,2,2
30961,liée,0,0,2,2
34064,équipe,0,0,2,2
30963,ابتهج,0,0,2,2
30965,encontrarse,0,0,2,2
52577,نيتشر,0,0,2,2
34203,harmful,0,0,2,2
30979,asunto,0,0,2,2
30980,söylüyorsunuz,0,0,2,2
52579,делаешь,0,0,2,2
34191,ಅದೃಷ್ಟವಂತರು,0,0,2,2
355,significato,1,2,0,2
352,maschi,1,2,0,2
369,scelti,1,2,0,2
30924,ಸುಂದರ,0,0,2,2
30922,recebeu,0,0,2,2
34231,conter,0,0,2,2
30806,vise,0,0,2,2
30807,yardımcı,0,0,2,2
34311,سألك,0,0,2,2
30815,suggests,0,0,2,2
30818,निर्धारित,0,0,2,2
30823,öva,0,0,2,2
34302,yaptın,0,0,2,2
30830,judges,0,0,2,2
30836,يوليو,0,0,2,2
30850,ansåg,0,0,2,2
30860,خبزًا,0,0,2,2
30864,പെട്ടെന്നു,0,0,2,2
389,viaggio.,1,2,0,2
30866,family,0,0,2,2
30876,conocerte,0,0,2,2
34265,ഉണ്ടോ,0,0,2,2
52568,philosophique,0,0,2,2
34260,reflection,0,0,2,2
375,macro,2,1,1,2
372,dolce.,1,2,0,2
34232,सामान,0,0,2,2
34178,fundamental,0,0,2,2
31007,большая,0,0,2,2
31012,موثوق,0,0,2,2
31099,ordforråd,0,0,2,2
31107,playstation,0,0,2,2
332,diminuisce,1,2,0,2
31124,لدرجة,0,0,2,2
326,grandioso.,1,2,0,2
34106,ناجحًا,0,0,2,2
31135,वेबसाईटों,0,0,2,2
322,dell'olocene,1,2,0,2
34097,allá,0,0,2,2
31147,imorgon,0,0,2,2
31151,dominated,0,0,2,2
31154,компанией,0,0,2,2
31155,uygun,0,0,2,2
34092,murat,0,0,2,2
34088,ആകാം,0,0,2,2
34085,derivadas,0,0,2,2
34079,allégorique,0,0,2,2
31173,അനുമതി,0,0,2,2
34076,episodes,0,0,2,2
31175,விரும்பினேன்,0,0,2,2
31180,rich,0,0,2,2
31192,rire,0,0,2,2
335,organizzata,1,2,0,2
31098,perteneciente,0,0,2,2
349,diverso,1,2,0,2
31097,neurosciences,0,0,2,2
52585,investigação,0,0,2,2
31019,محظوظ,0,0,2,2
31020,damas,0,0,2,2
34169,lycka,0,0,2,2
31024,nadie,0,0,2,2
34166,जलाया,0,0,2,2
31033,publicités,0,0,2,2
34159,diagram,0,0,2,2
31048,जिन,0,0,2,2
31049,undvika,0,0,2,2
343,[aggiornamento],1,2,0,2
34145,clasificadores,0,0,2,2
52587,دقيقة,0,0,2,2
31062,envolve,0,0,2,2
341,poteva,1,2,0,2
31067,explicit,0,0,2,2
34139,ഒരേ,0,0,2,2
31078,பயன்படுத்த,0,0,2,2
31086,equipe,0,0,2,2
31087,വിക്കിപീഡിയയെ,0,0,2,2
338,privata,2,1,1,2
1054,autorità,1,2,0,2
36627,ಹೇಗಿದ್ದೀರಿ,0,0,2,2
21452,slaat,0,0,2,2
23436,quant,0,0,2,2
23400,biologie,0,0,2,2
38991,θέματος,0,0,2,2
23406,restaurante,0,0,2,2
38988,strategy,0,0,2,2
38987,sormanın,0,0,2,2
51855,فظيعًا,0,0,2,2
38975,groei,0,0,2,2
38972,τέλος,0,0,2,2
23431,сетей,0,0,2,2
1723,"l'atmosfera,",1,2,0,2
23441,കേട്ടിട്ടുണ്ട്,0,0,2,2
38945,γλυκιά,0,0,2,2
51858,அதனால்,0,0,2,2
23445,aprecio,0,0,2,2
38953,الأستاذ,0,0,2,2
23458,языка,0,0,2,2
23461,objectionable,0,0,2,2
23464,professionals,0,0,2,2
1717,cambiata,1,2,0,2
23466,hata,0,0,2,2
23468,मारी,0,0,2,2
23470,”allmän,0,0,2,2
1731,traguardo,1,2,0,2
23398,historian,0,0,2,2
23388,estabelecidos,0,0,2,2
39005,மரியான்,0,0,2,2
23306,grootste,0,0,2,2
39052,viernes,0,0,2,2
23310,natifs,0,0,2,2
23311,føler,0,0,2,2
23316,கருத்துக்கள்,0,0,2,2
23317,enfermedades,0,0,2,2
23322,dispose,0,0,2,2
39043,plainte,0,0,2,2
23325,lowdimensional,0,0,2,2
23327,كتاب,0,0,2,2
51846,efficient,0,0,2,2
39034,സാധിക്കുന്നു,0,0,2,2
23341,luimême,0,0,2,2
39030,pacientemente,0,0,2,2
39029,yanıyor,0,0,2,2
51848,dominate,0,0,2,2
51849,anladım,0,0,2,2
23363,കരുതുന്നു,0,0,2,2
1737,proposti,1,2,0,2
39009,pare,0,0,2,2
39006,эффект,0,0,2,2
38946,അൽപ്പം,0,0,2,2
38943,quantidade,0,0,2,2
23301,സാഹചര്യം,0,0,2,2
38864,verabschieden,0,0,2,2
23560,എളുപ്പത്തിൽ,0,0,2,2
38883,ഇഷ്‌ടപ്പെട്ടെങ്കിൽ,0,0,2,2
51869,vemos,0,0,2,2
23566,когдалибо,0,0,2,2
51870,citerede,0,0,2,2
23587,latinas,0,0,2,2
51873,opnieuw,0,0,2,2
23589,visitados,0,0,2,2
1699,affidabilità,1,2,0,2
51874,publicada,0,0,2,2
38863,trying,0,0,2,2
23480,научиться,0,0,2,2
38859,parfaite,0,0,2,2
23602,échecs,0,0,2,2
23603,interessiert,0,0,2,2
23605,ungefär,0,0,2,2
23607,spil,0,0,2,2
38849,ಗಾಡಿ,0,0,2,2
1695,Dio,1,2,0,2
23619,സ്വർഗ്ഗം,0,0,2,2
23629,الرجال,0,0,2,2
38842,включая,0,0,2,2
23555,bild,0,0,2,2
38891,antielitism,0,0,2,2
38899,سيرة,0,0,2,2
23543,deinen,0,0,2,2
23483,ortográficas,0,0,2,2
38938,gelijk,0,0,2,2
23486,containing,0,0,2,2
23488,الآلة,0,0,2,2
1714,Nature,1,2,0,2
23495,описывают,0,0,2,2
38929,എപ്പോഴും,0,0,2,2
23506,ತಪ್ಪಾಗಿ,0,0,2,2
23515,hiervoor,0,0,2,2
23517,inscrit,0,0,2,2
23518,pais,0,0,2,2
38913,matin,0,0,2,2
23523,obtiendrez,0,0,2,2
23527,தவிர,0,0,2,2
38909,patrones,0,0,2,2
23529,etti,0,0,2,2
23530,dezelfde,0,0,2,2
23532,mercado,0,0,2,2
38906,ಕೋನವು,0,0,2,2
23535,resulted,0,0,2,2
23541,वीं,0,0,2,2
1752,rapida,1,2,0,2
51842,sesgos,0,0,2,2
36628,cuma,0,0,2,2
39218,impactfactor,0,0,2,2
39229,дополнительный,0,0,2,2
39228,seine,0,0,2,2
39227,paths,0,0,2,2
39225,மாற்றப்பட்டது,0,0,2,2
23042,oficiosas,0,0,2,2
51818,llevamos,0,0,2,2
23044,lecciones,0,0,2,2
23052,verilir,0,0,2,2
23053,credenciais,0,0,2,2
23054,ಮಾಡುತ್ತಿದ್ದಳು,0,0,2,2
23062,bewegen,0,0,2,2
39190,исходя,0,0,2,2
39211,entreprises,0,0,2,2
51819,globalement,0,0,2,2
23066,procedimientos,0,0,2,2
23067,ತಾನು,0,0,2,2
23073,besökta,0,0,2,2
39204,ويقولون,0,0,2,2
39199,vir,0,0,2,2
23089,உணவைப்,0,0,2,2
23090,dias,0,0,2,2
23091,تدرك,0,0,2,2
39230,¿quieres,0,0,2,2
1805,abbiano,1,2,0,2
39234,obligé,0,0,2,2
51814,ولاري,0,0,2,2
22961,abonneerknop,0,0,2,2
39271,voyage,0,0,2,2
22966,varying,0,0,2,2
22971,failed,0,0,2,2
39267,padrões,0,0,2,2
39266,പോകാം,0,0,2,2
22980,സമവാക്യത്തിലെ,0,0,2,2
22987,hydrosphere,0,0,2,2
22989,أخرى،,0,0,2,2
39255,डिजाइन,0,0,2,2
1816,bambino,1,2,0,2
22993,singapore,0,0,2,2
39253,kararıyla,0,0,2,2
39252,görünüyordu,0,0,2,2
23001,frequentes,0,0,2,2
23002,switched,0,0,2,2
23006,كتابة,0,0,2,2
23010,ഇല്ലാത്തതിനാൽ,0,0,2,2
23015,പറയുന്നത്,0,0,2,2
23023,intereses,0,0,2,2
23027,تناوله,0,0,2,2
1794,classi,1,2,0,2
39189,determinado,0,0,2,2
23296,bloqueio,0,0,2,2
39086,devoted,0,0,2,2
39121,şaşırdı,0,0,2,2
23210,சொன்னாள்,0,0,2,2
1768,attribuiti,1,2,0,2
39110,veio,0,0,2,2
39108,davantage,0,0,2,2
39101,αργό,0,0,2,2
23244,μαθαίνετε,0,0,2,2
23247,ಹೊಂದಿದ್ದೇನೆ,0,0,2,2
39090,विकिताबें,0,0,2,2
39088,short,0,0,2,2
1760,sento,1,2,0,2
39188,menade,0,0,2,2
39083,trace,0,0,2,2
23268,लैटिन,0,0,2,2
23269,التراجع,0,0,2,2
39077,धीमा,0,0,2,2
1758,raccontare.,1,2,0,2
23277,добро,0,0,2,2
39071,merezco,0,0,2,2
23284,തങ്ങൾ,0,0,2,2
39068,tampa,0,0,2,2
39066,nature ,0,0,2,2
23205,deel,0,0,2,2
23203,correcteur,0,0,2,2
23201,кандидата,0,0,2,2
39135,patients,0,0,2,2
23101,स्थित,0,0,2,2
23109,wp,0,0,2,2
23125,happening,0,0,2,2
23129,hangisinin,0,0,2,2
23132,puedan,0,0,2,2
39172,छवि,0,0,2,2
1787,vederti,1,2,0,2
23137,முழுவதும்,0,0,2,2
23143,muestras,0,0,2,2
23146,λοιπόν,0,0,2,2
39164,suspect,0,0,2,2
39159,orientée,0,0,2,2
39158,ροκ,0,0,2,2
39154,dépendra,0,0,2,2
39150,hallan,0,0,2,2
1784,calotte,1,2,0,2
51827,يخبرك,0,0,2,2
1779,promosso,1,2,0,2
23178,falsos,0,0,2,2
39139,gases,0,0,2,2
23184,clicando,0,0,2,2
38837,августа,0,0,2,2
51879,computed,0,0,2,2
38831,abandonné,0,0,2,2
38524,hadden,0,0,2,2
38548,ಹೇಳುತ್ತಿದ್ದೀರಿ,0,0,2,2
38546,редко,0,0,2,2
24109,février,0,0,2,2
24116,wörtern,0,0,2,2
38536,essentially,0,0,2,2
1585,meridionale,1,2,0,2
38532,പുതുതായി,0,0,2,2
24128,pensei,0,0,2,2
1584,cadere,1,2,0,2
24131,लिये,0,0,2,2
51930,ಭೇಟಿಯಾಗಲು,0,0,2,2
24177,dachte,0,0,2,2
24139,потрясающе»,0,0,2,2
38523,edemem,0,0,2,2
24141,மந்தமாக,0,0,2,2
38521,choisis,0,0,2,2
24145,zenodot,0,0,2,2
24149,effectué,0,0,2,2
38518,கனவுகளின்,0,0,2,2
38513,consacrée,0,0,2,2
24160,தெரியுமா,0,0,2,2
38509,второй,0,0,2,2
38554,comparaison,0,0,2,2
38560,ರಹಸ್ಯ,0,0,2,2
38564,சர்ச்சைக்குரிய,0,0,2,2
38565,improved,0,0,2,2
1613,sappi,1,2,0,2
23982,चट्टान,0,0,2,2
23993,dynamo,0,0,2,2
24000,தரத்தைக்,0,0,2,2
24001,சொற்றொடர்களை,0,0,2,2
38612,وجد,0,0,2,2
24012,википедией,0,0,2,2
24017,categorized,0,0,2,2
38605,gillade,0,0,2,2
24022,nöje,0,0,2,2
38602,bloqueado,0,0,2,2
24026,பயன்படுத்தக்கூடாது,0,0,2,2
38596,olumlu,0,0,2,2
24046,ഭയാനകമായ,0,0,2,2
24047,സൗന്ദര്യം,0,0,2,2
24051,optimisation,0,0,2,2
24055,recogen,0,0,2,2
1596,cinquanta,1,2,0,2
24064,संगठनों,0,0,2,2
38574,rent,0,0,2,2
24071,английских,0,0,2,2
24171,l’utilisation,0,0,2,2
38498,അമ്മയോട്,0,0,2,2
38830,حلمها,0,0,2,2
24304,kişinin,0,0,2,2
38441,dualisme,0,0,2,2
24273,ekstremt,0,0,2,2
38440,édition,0,0,2,2
51944,implicit,0,0,2,2
24290,artificiel,0,0,2,2
1561,descrizione,1,2,0,2
24295,faitesle,0,0,2,2
38420,சரியான,0,0,2,2
24301,visàvis,0,0,2,2
38419,यू,0,0,2,2
38415,conclusions,0,0,2,2
38492,significado,0,0,2,2
24308,പതുക്കെ,0,0,2,2
51946,etmeye,0,0,2,2
24311,أحبك,0,0,2,2
38414,മറക്കരുത്,0,0,2,2
24317,ifadesi,0,0,2,2
24320,உலகளவில்,0,0,2,2
1557,fpr,2,1,1,2
1556,rallegrati.,1,2,0,2
24332,الأصل،,0,0,2,2
38401,deltagarna,0,0,2,2
38442,الحرة,0,0,2,2
38444,escuche,0,0,2,2
24264,participación,0,0,2,2
24261,расстраивался,0,0,2,2
24192,செய்தி,0,0,2,2
51935,പക്ഷെ,0,0,2,2
24197,horrível,0,0,2,2
38483,seiner,0,0,2,2
24199,yerde,0,0,2,2
24204,acomodar,0,0,2,2
24206,property,0,0,2,2
24207,modernes,0,0,2,2
24209,caché,0,0,2,2
24211,வேண்டிய,0,0,2,2
24212,ഏതാണ്,0,0,2,2
38473,விக்கி,0,0,2,2
24224,ingilizce,0,0,2,2
24228,wellmannered,0,0,2,2
1571,filtra,2,1,1,2
24234,அதிர்ஷ்டம்,0,0,2,2
24235,ಒಂದೇ,0,0,2,2
38463,bancaire,0,0,2,2
1569,solida,1,2,0,2
38458,ثمانية,0,0,2,2
38450,رسمية,0,0,2,2
23976,"
बेलारूसी",0,0,2,2
23958,बनाई,0,0,2,2
23957,holde,0,0,2,2
38766,admite,0,0,2,2
38787,لمدة,0,0,2,2
23720,verfijnd,0,0,2,2
1675,ripristina,1,2,0,2
23728,ಚೂಪಾದ,0,0,2,2
38774,आइकन,0,0,2,2
23735,يشجع,0,0,2,2
23739,diamanter,0,0,2,2
23742,occasionally,0,0,2,2
23743,കത്തിക്കാം,0,0,2,2
51886,ويكيبيديا؛,0,0,2,2
51888,raiz,0,0,2,2
23956,novamente,0,0,2,2
23750,navegar,0,0,2,2
38762,दिखती,0,0,2,2
23757,californië,0,0,2,2
23772,klockan,0,0,2,2
38748,sidder,0,0,2,2
1663,digita,1,2,0,2
23775,vandalizme,0,0,2,2
38746,असंख्य,0,0,2,2
38744,naturaleza,0,0,2,2
23779,politikartiklar,0,0,2,2
38789,ελέγξετε,0,0,2,2
38790,редактировать,0,0,2,2
38791,structures,0,0,2,2
1676,trattato,1,2,0,2
1688,legami,1,2,0,2
23654,existentes,0,0,2,2
1683,"inoltre,",1,2,0,2
23657,zouden,0,0,2,2
1682,umane,1,2,0,2
38824,തുടരുക,0,0,2,2
38820,ofertas,0,0,2,2
23673,moquez,0,0,2,2
38812,allerlei,0,0,2,2
38811,nobel,0,0,2,2
23683,potentiel,0,0,2,2
23684,réside,0,0,2,2
38810,sex,0,0,2,2
23692,जनता,0,0,2,2
38803,decided,0,0,2,2
23695,helgen,0,0,2,2
38802,بأس,0,0,2,2
1678,sempre.,1,2,0,2
38800,hvilken,0,0,2,2
38798,இருக்கலாம்,0,0,2,2
1677,regolarità,1,2,0,2
23780,будут,0,0,2,2
23782,political,0,0,2,2
1662,"altri,",1,2,0,2
38678,uppnås,0,0,2,2
23892,işler,0,0,2,2
23894,ಬಂದರು,0,0,2,2
1631,statunitense.,1,2,0,2
23905,hébergeant,0,0,2,2
23908,olmaya,0,0,2,2
38665,omkring,0,0,2,2
1629,genoma,1,2,0,2
23912,märkspråk,0,0,2,2
23913,assis,0,0,2,2
38664,πιάσατε,0,0,2,2
23920,crescido,0,0,2,2
23925,wikilivros,0,0,2,2
23929,sal,0,0,2,2
38654,энциклопедической,0,0,2,2
1624,predizioni,1,2,0,2
23935,kontakt,0,0,2,2
38650,retains,0,0,2,2
23944, modifications,0,0,2,2
38645,مساهمات,0,0,2,2
23952,جدا,0,0,2,2
23953,गोल्डन,0,0,2,2
38676,overrasket,0,0,2,2
23884,assignments,0,0,2,2
23791,dû,0,0,2,2
23880,chamber,0,0,2,2
38726,orbit,0,0,2,2
51893,കളിയാക്കണം,0,0,2,2
23810,informou,0,0,2,2
1658,raramente,2,1,1,2
23818,numa,0,0,2,2
23827,அறிமுகப்படுத்தப்பட்டது,0,0,2,2
23828,இணைய,0,0,2,2
23829,pegou,0,0,2,2
38710,sizi,0,0,2,2
1653,guerre,2,1,1,2
23836,visitantes,0,0,2,2
23839,veelvoorkomende,0,0,2,2
23844,médiatiques,0,0,2,2
23847,كيفية,0,0,2,2
23850,свободно,0,0,2,2
38699,percebe,0,0,2,2
1645,annualmente,1,2,0,2
23864,dünyanın,0,0,2,2
1641,delizioso,1,2,0,2
23873,alleges,0,0,2,2
38681,rod,0,0,2,2
22958,macha,0,0,2,2
22957,اللطيف,0,0,2,2
22956,begonnen,0,0,2,2
21920,antwoord,0,0,2,2
39977,amenaza,0,0,2,2
21891,നടത്തി,0,0,2,2
21892,खाद्य,0,0,2,2
39971,jornalismo,0,0,2,2
21900,νοιάζει,0,0,2,2
21902,sunucuları,0,0,2,2
21904,ícone,0,0,2,2
51704,publicaties,0,0,2,2
21909,قوله,0,0,2,2
21910,функции,0,0,2,2
39956,أثناء,0,0,2,2
2005,climatiche,1,2,0,2
39955,أجمل,0,0,2,2
2013,dirla,1,2,0,2
39950,تخبرني,0,0,2,2
21943,fruto,0,0,2,2
2012,andò,1,2,0,2
39942,ടെറി,0,0,2,2
39927,സംഭവിക്കുന്നതെന്ന്,0,0,2,2
21972,positivt,0,0,2,2
21973,λειτουργία,0,0,2,2
21975,سؤال,0,0,2,2
21889,названием,0,0,2,2
2017,l'anno,1,2,0,2
21880,reflects,0,0,2,2
39984,चित्रों,0,0,2,2
40027,cicéron,0,0,2,2
40018,الربع,0,0,2,2
40017,க்கு,0,0,2,2
40015,sofistike,0,0,2,2
21830,செய்யப்,0,0,2,2
21834,instituto,0,0,2,2
40008,lendemain,0,0,2,2
40007,коммерческой,0,0,2,2
21840,ومدى,0,0,2,2
2023,complementare,1,2,0,2
21844,привело,0,0,2,2
21845,approfondir,0,0,2,2
21848,விரும்பும்,0,0,2,2
40000,தற்போது,0,0,2,2
21851,chaotic,0,0,2,2
39998,ενώ,0,0,2,2
51702,മനസ്സിൽ,0,0,2,2
21866,kullanıcı,0,0,2,2
21870,விரல்களைக்,0,0,2,2
2019,parodia,2,1,1,2
2018,agrawal,2,1,1,2
21978,skolen,0,0,2,2
39923,குறைவாக,0,0,2,2
22169,अगले,0,0,2,2
1982,lcs,2,1,1,2
22087,χρησιμοποιείτε,0,0,2,2
22088,ಸವಾರಿ,0,0,2,2
22089,utilizan,0,0,2,2
39843,begin,0,0,2,2
22099,малых,0,0,2,2
22106,origens,0,0,2,2
39834,ответить,0,0,2,2
39829,tchèque,0,0,2,2
22117,καταλάβατε,0,0,2,2
39828,healthrelated,0,0,2,2
22131,esses,0,0,2,2
39916,القائمة,0,0,2,2
39816,«не,0,0,2,2
39815,reconnues,0,0,2,2
22142,அடிப்படையிலும்,0,0,2,2
22144,решения,0,0,2,2
22149,تتبع,0,0,2,2
22150,idées,0,0,2,2
22153,लिनक्स,0,0,2,2
22157,संदेश,0,0,2,2
51724,eftermiddagen,0,0,2,2
1979,cane,1,2,0,2
1987,gioco.,1,2,0,2
39849,обычных,0,0,2,2
39851,viser,0,0,2,2
39852,νάρκισα,0,0,2,2
39911,unregistered,0,0,2,2
21995,голоден,0,0,2,2
22001,نصف,0,0,2,2
39902,teil,0,0,2,2
39897,«знания»,0,0,2,2
1999,platt,2,1,1,2
22017,руководств,0,0,2,2
22020,காணப்படும்,0,0,2,2
22027,appliquer,0,0,2,2
39883,സ്വയംചലിത,0,0,2,2
22043,parliament,0,0,2,2
39874,« ont,0,0,2,2
22046,побуждает,0,0,2,2
22052,κομμάτια,0,0,2,2
39870,suivant,0,0,2,2
22056,recognition‏,0,0,2,2
22059,പിന്നീട്,0,0,2,2
22061,cold,0,0,2,2
51719,χρησιμοποιώντας,0,0,2,2
22069,സൗകര്യവും,0,0,2,2
22077,സ്വതന്ത്രവിജ്ഞാനകോശത്തിന്റെ,0,0,2,2
40031,يحررها,0,0,2,2
21804,doctors,0,0,2,2
21803,conclusión,0,0,2,2
21572,opérateur,0,0,2,2
40196,teacher,0,0,2,2
40192,jaarlijkse,0,0,2,2
21549,ശരി,0,0,2,2
21551,inference,0,0,2,2
21554,τζίμι,0,0,2,2
40189,biliyorsunuz,0,0,2,2
21557,estará,0,0,2,2
40186,ഉദാഹരണമായി,0,0,2,2
21560,etmektedir,0,0,2,2
40184,participants,0,0,2,2
40179,trabajos,0,0,2,2
40036,efeitos,0,0,2,2
21578,தன்னை,0,0,2,2
2073,appartenente,1,2,0,2
40174,مجال,0,0,2,2
21588,ಪ್ರಶ್ನೆಯನ್ನು,0,0,2,2
40169,ആരാണ്,0,0,2,2
21599,ನೋಡುತ್ತಿದ್ದೇನೆ,0,0,2,2
51673,avsedd,0,0,2,2
40162,இணைப்புக்கள்,0,0,2,2
21612,கேட்கலாம்,0,0,2,2
40151,पुराने,0,0,2,2
21537,soient,0,0,2,2
40202,الاقتصاد,0,0,2,2
40205,издан,0,0,2,2
40206,എഴുതുവാനും,0,0,2,2
40247,எல்லோரும்,0,0,2,2
21464,internettet,0,0,2,2
51664,ready,0,0,2,2
40241,مفرداتك,0,0,2,2
2090,palazzo,1,2,0,2
40239,décrivent,0,0,2,2
40238,बढ़ें।,0,0,2,2
2088,sorella,1,2,0,2
21481,ley,0,0,2,2
21484,turquie,0,0,2,2
21497,जैसा,0,0,2,2
21499,νόμιζα,0,0,2,2
21501,தெரியப்படுத்துங்கள்,0,0,2,2
51668,reçel,0,0,2,2
40222,llevó,0,0,2,2
40221,poèmes,0,0,2,2
21512,préstamo,0,0,2,2
40213,перешла,0,0,2,2
40211,anônimo,0,0,2,2
2077,sale,1,2,0,2
21527,noot,0,0,2,2
21620,skapas,0,0,2,2
21623,книга,0,0,2,2
21626,проектов,0,0,2,2
21730,cross,0,0,2,2
40080,видите,0,0,2,2
21734,व्यक्तिगत,0,0,2,2
21736,humble,0,0,2,2
51690,génère,0,0,2,2
21738,контроля,0,0,2,2
21743,dom,0,0,2,2
21757,насколько,0,0,2,2
21759,deviations,0,0,2,2
21761,gitmeniz,0,0,2,2
21766,audaz,0,0,2,2
40058,kreeg,0,0,2,2
40054,μπορούσε,0,0,2,2
2036,andato,1,2,0,2
40051,motivos,0,0,2,2
21783,état,0,0,2,2
21785,apprendre,0,0,2,2
40045,anunciada,0,0,2,2
21787,sistêmico,0,0,2,2
2034,entrate,1,2,0,2
21795,ali,0,0,2,2
40040,കേൾക്കുമ്പോൾ,0,0,2,2
21731,croissance,0,0,2,2
21727,парень,0,0,2,2
40139,inicial,0,0,2,2
40083,kökeni,0,0,2,2
21642,கவலைப்படுகிறீர்களா,0,0,2,2
21643,чтонибудь,0,0,2,2
2061,dell'IA,1,2,0,2
51678,pertinence,0,0,2,2
21652,медленно,0,0,2,2
21653,diamanten,0,0,2,2
21658,wij,0,0,2,2
21659,gustó,0,0,2,2
21662,créateur,0,0,2,2
21663,interface,0,0,2,2
21667,портал,0,0,2,2
21681,आवश्यक,0,0,2,2
40110,நினைக்கவில்லை,0,0,2,2
2054,comico,1,2,0,2
21687,ಕೇಳಿದರೆ,0,0,2,2
21693,rötter,0,0,2,2
40103,ಸರಿಯಾಗಿ,0,0,2,2
51685,pronúncia,0,0,2,2
21700,പ്രധാനമായും,0,0,2,2
21703,ocho,0,0,2,2
40086,sebep,0,0,2,2
22167,рамках,0,0,2,2
22170,herinde,0,0,2,2
39276,कोष,0,0,2,2
1894,riferiscono,1,2,0,2
22678,pratade,0,0,2,2
22682,مذهل,0,0,2,2
22684,espanhol,0,0,2,2
22685,unidas,0,0,2,2
39447,encontrou,0,0,2,2
1896,informato,1,2,0,2
39442,forkert,0,0,2,2
39441,voorzichtig,0,0,2,2
22698,aparência,0,0,2,2
39440,पूरा,0,0,2,2
22710,intellectuelle,0,0,2,2
22752,கொடுத்தார்,0,0,2,2
1890,puoi.,1,2,0,2
51767,vars,0,0,2,2
22724,prevención,0,0,2,2
1887,\{\mathrm,1,2,0,2
22728,criticado,0,0,2,2
39415,números,0,0,2,2
22734,recibido,0,0,2,2
39413,लगी,0,0,2,2
22738,caused,0,0,2,2
22739,αντικειμενική,0,0,2,2
22677,collectively,0,0,2,2
22674,нарцисой,0,0,2,2
39456,accessibles,0,0,2,2
39460,ميزات,0,0,2,2
22586,மூலமும்,0,0,2,2
1914,"intrusioni,",1,2,0,2
51754,buscando,0,0,2,2
39514,environmental,0,0,2,2
22596,ertesi,0,0,2,2
22599,öğle,0,0,2,2
51755,υπάρχουν,0,0,2,2
22601,personales,0,0,2,2
22603,empréstimo,0,0,2,2
39508,enjoy,0,0,2,2
1906,acquisito,1,2,0,2
22623,ação,0,0,2,2
39491,πιθανούς,0,0,2,2
39489,colour,0,0,2,2
39483,നൂപീഡിയ,0,0,2,2
39477,erzählt,0,0,2,2
39470,coup,0,0,2,2
39469,பயன்படுத்தி,0,0,2,2
39467,ρίζα,0,0,2,2
22658,ställde,0,0,2,2
22661,ನೋಡುತ್ತೇನೆ,0,0,2,2
39407,dog,0,0,2,2
39403,ಒಪ್ಪುತ್ತೇನೆ,0,0,2,2
39795,correctement,0,0,2,2
39299,rights,0,0,2,2
1849,generazione,1,2,0,2
39328,произношение,0,0,2,2
39326,ens,0,0,2,2
39324,scrubs,0,0,2,2
22885,mahkemesi,0,0,2,2
22901,tillbaka,0,0,2,2
39310,рекламы,0,0,2,2
39308,togs,0,0,2,2
51796,banklening,0,0,2,2
39300,flinke,0,0,2,2
1834,amin,2,1,1,2
39399,സാങറും,0,0,2,2
51799,rode,0,0,2,2
22935,σχολείο,0,0,2,2
39287,مساعدتك,0,0,2,2
1828,amiche,1,2,0,2
39284,ولكنها,0,0,2,2
1826,formulati,1,2,0,2
22946,loves,0,0,2,2
39281,pakistan,0,0,2,2
22952,أراك,0,0,2,2
22954,വാക്കുകളിൽ,0,0,2,2
39333,रे,0,0,2,2
22864,grandiosa,0,0,2,2
39337,agi,0,0,2,2
1852,blackberry,2,1,1,2
22760,svara,0,0,2,2
39395,değişikliklerin,0,0,2,2
1879,collettivamente,1,2,0,2
22767,pesado,0,0,2,2
39393,işle,0,0,2,2
39384,группа,0,0,2,2
22782,inspirée,0,0,2,2
22786,καλώς,0,0,2,2
22791,répertoire,0,0,2,2
22800,langsommere,0,0,2,2
22809,littérature,0,0,2,2
51780,grymma,0,0,2,2
22812,useless,0,0,2,2
22816,yıl,0,0,2,2
51783,finds,0,0,2,2
22832,дайте,0,0,2,2
39350,beslutning,0,0,2,2
22835,ekmekten,0,0,2,2
22841,समूहों,0,0,2,2
39347,المعرضة,0,0,2,2
22847,slår,0,0,2,2
39524,kalde,0,0,2,2
39527,considérer,0,0,2,2
39533,vikipedi’ye,0,0,2,2
22319,أعلى,0,0,2,2
22275,assumptions,0,0,2,2
22281,vrijgegeven,0,0,2,2
39715,أحلامه,0,0,2,2
39713,വിശ്വസിക്കുന്നത്,0,0,2,2
1966,cloud,2,1,1,2
22301,مراقبة,0,0,2,2
39704,думаешь,0,0,2,2
22315,voorbeeld,0,0,2,2
22316,болото,0,0,2,2
39697,للطلاب,0,0,2,2
22329,அனைவரும்,0,0,2,2
22572,अध्यक्ष,0,0,2,2
22330,famous,0,0,2,2
22334,ومع,0,0,2,2
39690,देखें।,0,0,2,2
22348,colaborativo,0,0,2,2
22349,пожаловать,0,0,2,2
22350,وأن,0,0,2,2
1952,tesoro,1,2,0,2
22356,تفهم,0,0,2,2
22371,th,0,0,2,2
22372,biz,0,0,2,2
39722,großartige,0,0,2,2
39727,υπέροχα,0,0,2,2
39729,авторитетных,0,0,2,2
39732,private,0,0,2,2
22176,главный,0,0,2,2
39790,forest,0,0,2,2
22180,പ്രകൃതിയുടെ,0,0,2,2
22182,தயவுசெய்து,0,0,2,2
22183,appris,0,0,2,2
22184,revisions,0,0,2,2
51725,കുറിച്ചുള്ള,0,0,2,2
39777,else,0,0,2,2
39776,بهذا,0,0,2,2
22206,faveur,0,0,2,2
39771,juger,0,0,2,2
22214,φίλος,0,0,2,2
22226,sustenta,0,0,2,2
22227,misión,0,0,2,2
39755,സ്കോർ‌,0,0,2,2
51726,flux,0,0,2,2
39742,assurezvous,0,0,2,2
1971,memorizzate,1,2,0,2
22253,ബന്ധപ്പെട്ട,0,0,2,2
1969,vegetale,1,2,0,2
1968,ex,1,2,0,2
22379,базовые,0,0,2,2
39657,semanas,0,0,2,2
22385,ميليسا,0,0,2,2
39593,düşünebilirsiniz,0,0,2,2
1926,tomasz,2,1,1,2
51749,kötü,0,0,2,2
22490,«,0,0,2,2
39584,practical,0,0,2,2
22493,historien,0,0,2,2
39582,interessado,0,0,2,2
39575,burden,0,0,2,2
22512,concerne,0,0,2,2
39567,فظيع,0,0,2,2
22516,தொகுக்க,0,0,2,2
22524,ಡಿಗ್ರಿಗಳಿಗಿಂತ,0,0,2,2
22531,पागल,0,0,2,2
22535,ചോദിക്കാം,0,0,2,2
22540,voitures,0,0,2,2
1919,potuto,1,2,0,2
22550,ഒരിക്കലും,0,0,2,2
22551,étymologiquement,0,0,2,2
22554,സഹായി,0,0,2,2
22558,  images,0,0,2,2
22567,hautparleur,0,0,2,2
22569,திட்டங்களை,0,0,2,2
22480,கணக்குகள்,0,0,2,2
39596,doré,0,0,2,2
22386,பின்,0,0,2,2
39597,привести,0,0,2,2
22393,ഓർക്കുക,0,0,2,2
39647,ജൂൺ,0,0,2,2
39644,publicación,0,0,2,2
1940,consultabili,1,2,0,2
22409,ആയിരിക്കും,0,0,2,2
1939,catturata,1,2,0,2
39634,djur,0,0,2,2
22418,crédit,0,0,2,2
22419,связанных,0,0,2,2
22420,γρήγορη,0,0,2,2
22422,hoffe,0,0,2,2
22426,predicts,0,0,2,2
1936,premium,1,2,0,2
1933,prendessi,1,2,0,2
39623,dining,0,0,2,2
22453,ato,0,0,2,2
39609,துல்லியத்தன்மை,0,0,2,2
22457,оставить,0,0,2,2
1931,lages,2,1,1,2
22462,citar,0,0,2,2
1929,un'immagine,1,2,0,2
24340,confiável,0,0,2,2
38397,poetry,0,0,2,2
24348,"
we",0,0,2,2
37218,ægteskab,0,0,2,2
37246,creencia,0,0,2,2
37242,ouviu,0,0,2,2
52128,politik,0,0,2,2
26202,விஷயங்கள்,0,0,2,2
37240,talt,0,0,2,2
26229,saindo,0,0,2,2
26231,അഭിപ്രായം,0,0,2,2
37222,dominant,0,0,2,2
37221,குறிக்கிறது,0,0,2,2
26237,ages,0,0,2,2
26239,valor,0,0,2,2
37207,eerst,0,0,2,2
37215,denn,0,0,2,2
1224,offerte.,1,2,0,2
26246,rápidas,0,0,2,2
1223,impazzito,1,2,0,2
26252,ഞങ്ങൾ‌,0,0,2,2
26253,научными,0,0,2,2
26254,pelas,0,0,2,2
26255,decisión,0,0,2,2
26258,deposited,0,0,2,2
26261,रह,0,0,2,2
26194,faces,0,0,2,2
26191,പ്രായം,0,0,2,2
1233,dovrai,1,2,0,2
26185,обозначения,0,0,2,2
37279,comprise,0,0,2,2
26141,എന്നിങ്ങനെ,0,0,2,2
37277,hjemme,0,0,2,2
37275,पुस्तकों,0,0,2,2
37271,κουρασμένος,0,0,2,2
37267,الحلم,0,0,2,2
37265,अदालत,0,0,2,2
26159,goals,0,0,2,2
37264,emails,0,0,2,2
26162,fouten,0,0,2,2
37262,næppe,0,0,2,2
26165,محايدة,0,0,2,2
52126,kurumu,0,0,2,2
1237,affermano,1,2,0,2
1235,formano,1,2,0,2
1234,elaborare,1,2,0,2
37253,tropenmuseum,0,0,2,2
26178,फिल्म,0,0,2,2
26179,данный,0,0,2,2
26180,التحكيم,0,0,2,2
26182,conocido,0,0,2,2
26262,courantes,0,0,2,2
37198,इन्हें,0,0,2,2
26459,rockt,0,0,2,2
26410,demais,0,0,2,2
26389,spokesman,0,0,2,2
37119,clarke,0,0,2,2
26392,öppenhet,0,0,2,2
26394,ملايين,0,0,2,2
37117,dicionário,0,0,2,2
26399,звучать,0,0,2,2
26400,encountered,0,0,2,2
37111,تريده,0,0,2,2
37108,stötte,0,0,2,2
26409,aplicaciones,0,0,2,2
37102,दोहराने,0,0,2,2
37195,البريدية,0,0,2,2
26418,långsammare,0,0,2,2
26423,arme,0,0,2,2
26425,privatisé,0,0,2,2
37095,bedöms,0,0,2,2
1189,funzionerà.,1,2,0,2
1188,pearl,2,1,1,2
26443,neemt,0,0,2,2
26449,imitation,0,0,2,2
26455,wurzeln,0,0,2,2
26456,मित्र,0,0,2,2
26381,oceanic,0,0,2,2
37126,εύκολη,0,0,2,2
26379,இணையத்தளத்தில்,0,0,2,2
26378,പ്രസിദ്ധമായ,0,0,2,2
26283,artificiales,0,0,2,2
37190,interés,0,0,2,2
26294,época,0,0,2,2
26295,elliot,0,0,2,2
37181,apprenez,0,0,2,2
26304,akademiske,0,0,2,2
37176,stimuli,0,0,2,2
37165,altitude,0,0,2,2
37164,خطط,0,0,2,2
37161,russie,0,0,2,2
26336,« ce,0,0,2,2
26338,afirmaba,0,0,2,2
26340,उत्पन्न,0,0,2,2
26343,വിവരങ്ങളും,0,0,2,2
37146,продолжить,0,0,2,2
37143,conduire,0,0,2,2
1200,protein,2,1,1,2
26358,median,0,0,2,2
37135,الصور,0,0,2,2
37133,kartor,0,0,2,2
26370,fördröjs,0,0,2,2
26135,дисков,0,0,2,2
37283,неважно,0,0,2,2
37289,banque,0,0,2,2
25894,торговой,0,0,2,2
37456,സബ്‌സ്‌ക്രൈബ്,0,0,2,2
1293,viaggi,1,2,0,2
37454,hareket,0,0,2,2
1288,coordinati,1,2,0,2
25870,σάββατο,0,0,2,2
25875,سأعطيك,0,0,2,2
52103,sereno,0,0,2,2
37444,gobierno,0,0,2,2
25885,"

हालाँकि",0,0,2,2
25893,и т п,0,0,2,2
37431,biodiversité,0,0,2,2
37290,выглядеть,0,0,2,2
37420,lectores,0,0,2,2
25915,semblaient,0,0,2,2
37418,വലിപ്പം,0,0,2,2
37414,band,0,0,2,2
25922,ಬೇರೆ,0,0,2,2
25927,geri,0,0,2,2
25931,encuentre,0,0,2,2
25932,φέρω,0,0,2,2
1279,essendo,1,2,0,2
37406,yaacov,0,0,2,2
1296,evolve,1,2,0,2
25845,മാറ്റി,0,0,2,2
1299,registra,2,1,1,2
25841,توقف,0,0,2,2
1311,"articoli,",1,2,0,2
25762,buraya,0,0,2,2
52091,adição,0,0,2,2
37520,adresse,0,0,2,2
25774,erróneos,0,0,2,2
37509,scolaires,0,0,2,2
25783,твои,0,0,2,2
37504,constants,0,0,2,2
25787,കഴിഞ്ഞാൽ,0,0,2,2
25791,തർക്കങ്ങൾ,0,0,2,2
25793,celular,0,0,2,2
52094,മാറ്റം,0,0,2,2
25798,skål,0,0,2,2
37496,éditeurs,0,0,2,2
52096,الانتظار,0,0,2,2
37486,относить,0,0,2,2
25820,कोशिश,0,0,2,2
25828,സുഹൃത്തുക്കൾ,0,0,2,2
25829,insulte,0,0,2,2
25833,mesma,0,0,2,2
37470,sueños,0,0,2,2
1278,abbiamo,1,2,0,2
25951,gustaría,0,0,2,2
25955,ஜாம்,0,0,2,2
1254,scusi,1,2,0,2
26051,അമ്മയെ,0,0,2,2
26052,امرأة,0,0,2,2
26054,består,0,0,2,2
26055,παίρνετε,0,0,2,2
37330,andel,0,0,2,2
26062,omedelbart,0,0,2,2
26066,ഉയർന്ന,0,0,2,2
37323,اللجنة,0,0,2,2
26081,награда,0,0,2,2
26085,gett,0,0,2,2
26086,प्रोत्साहित,0,0,2,2
37311,दानपुण्य,0,0,2,2
1246,stabile,1,2,0,2
52122,университета,0,0,2,2
37299,கலைக்களஞ்சியத்தின்,0,0,2,2
26110,lá,0,0,2,2
26111,βικιλεξικό,0,0,2,2
37297,قليلاً,0,0,2,2
26116,سوى,0,0,2,2
26123,namens,0,0,2,2
26125,понять,0,0,2,2
52115,tro,0,0,2,2
26042,मुफ़्त,0,0,2,2
37388,holocene,0,0,2,2
26038,magische,0,0,2,2
25970,κορυφή,0,0,2,2
1274,inferenza,1,2,0,2
25981,तुमने,0,0,2,2
25982,nyheden,0,0,2,2
37372,ಚಂದಾದಾರ,0,0,2,2
37369,सॉरी,0,0,2,2
1260,lasciando,1,2,0,2
25996,ಹೋಗಲು,0,0,2,2
37367,фильмов,0,0,2,2
26002,begränsas,0,0,2,2
26003,négative,0,0,2,2
26005,variation,0,0,2,2
37363,nationalencyklopedin,0,0,2,2
37361,जादुई,0,0,2,2
26016,पत्रिका,0,0,2,2
37355,खेल,0,0,2,2
26018,الجامعات,0,0,2,2
37353,دعنا,0,0,2,2
37352,opérateurs,0,0,2,2
37349,bureaucrats,0,0,2,2
37345,wikihpeedeeə,0,0,2,2
1184,filosofi,1,2,0,2
37071,fête,0,0,2,2
25752,decirles,0,0,2,2
1083,villaggio,1,2,0,2
26943,تهتم,0,0,2,2
36760,incompatibles,0,0,2,2
1084,ricchezza,1,2,0,2
36751,totaal,0,0,2,2
26959,bırak,0,0,2,2
36747,resultat,0,0,2,2
26966,следующую,0,0,2,2
26967,விரும்புகிறீர்களா,0,0,2,2
26969,lärande,0,0,2,2
26972,puesto,0,0,2,2
36734,februar,0,0,2,2
27025,biosphère,0,0,2,2
36733,läggas,0,0,2,2
1082,coinvolgere,1,2,0,2
36729,presocratic,0,0,2,2
26992,utgången,0,0,2,2
26993,сидела,0,0,2,2
36718,έπιασα,0,0,2,2
27006,الماضي,0,0,2,2
27008,gegangen,0,0,2,2
1079,wikipediocracy,2,1,1,2
36711,आलोचक,0,0,2,2
26941,början,0,0,2,2
26940,tradicional,0,0,2,2
36765,проектом,0,0,2,2
1088,carino,1,2,0,2
26849,الأنماط,0,0,2,2
26862,lektionen,0,0,2,2
26866,kelimesi,0,0,2,2
36814,വിവരം,0,0,2,2
36813,संभव,0,0,2,2
26872,أغسطس,0,0,2,2
36807,बताते,0,0,2,2
26881,مصداقية,0,0,2,2
26882,aren,0,0,2,2
26883,casos—,0,0,2,2
1095,jet,2,1,1,2
26892,ಉತ್ತಮವಾಗಿ,0,0,2,2
36791,വലിയൊരു,0,0,2,2
26907,heuristic,0,0,2,2
1093,garantire,1,2,0,2
36779,empezar,0,0,2,2
26917,respektive,0,0,2,2
36776,kimmel,0,0,2,2
36775,january update,0,0,2,2
36772,daquela,0,0,2,2
26930,zamanla,0,0,2,2
36710,enof,0,0,2,2
36700,uppfattningar,0,0,2,2
37058,नार्किसा,0,0,2,2
27116,ಜಾಮ್,0,0,2,2
27092,commented,0,0,2,2
27094,parís,0,0,2,2
1059,"clima,",1,2,0,2
27097,ernst,0,0,2,2
27098,considérablement,0,0,2,2
27103,σχετικά,0,0,2,2
36652,публикует,0,0,2,2
27109,minorités,0,0,2,2
36649,kullanım,0,0,2,2
1058,scintillanti.,1,2,0,2
36645,cuidadosamente,0,0,2,2
36695,proposa,0,0,2,2
27122,registrarse,0,0,2,2
36642,व्यू,0,0,2,2
27128,noviembre,0,0,2,2
36637,авторском,0,0,2,2
36635,पेज,0,0,2,2
27134,douce,0,0,2,2
27136,сомнение,0,0,2,2
27137,personajes,0,0,2,2
1057,guidato,1,2,0,2
27143,τραπέζι,0,0,2,2
36657,मूल्यांकन,0,0,2,2
27089,centenas,0,0,2,2
1061,formalmente,2,1,1,2
36658,فهمتك,0,0,2,2
36693,hit,0,0,2,2
1074,arun,2,1,1,2
36688,alegação,0,0,2,2
27044,بشيء,0,0,2,2
36686,skolan,0,0,2,2
27048,brilhantes,0,0,2,2
36680,воспитанный,0,0,2,2
1071,dodici,1,2,0,2
52213,साइटों,0,0,2,2
27058,trubbig,0,0,2,2
1068,kathryn,2,1,1,2
27061,rör,0,0,2,2
36676,nåede,0,0,2,2
27063,выделенных,0,0,2,2
36673,поблагодарить,0,0,2,2
27072,sluta,0,0,2,2
36667,autoridad,0,0,2,2
1065,basti,1,2,0,2
27080,bekymmer,0,0,2,2
36661,grap,0,0,2,2
27084,फाइलें,0,0,2,2
26841,മാസവും,0,0,2,2
26836,ಹುರಿದುಂಬಿಸಲು,0,0,2,2
36836,όλων,0,0,2,2
1149,esempio.,1,2,0,2
1159,necessità,1,2,0,2
26567,sage,0,0,2,2
37001,conscience,0,0,2,2
37000,principer,0,0,2,2
26584,அபத்தமானது,0,0,2,2
1155,respingeva,1,2,0,2
36991,querido,0,0,2,2
1150,ringraziarti,1,2,0,2
36982,kräver,0,0,2,2
26601,विवाह,0,0,2,2
1145,marian.,1,2,0,2
52198,объектах,0,0,2,2
26615,jongen,0,0,2,2
36970,சரியாக,0,0,2,2
52178,लेते,0,0,2,2
36967,executando,0,0,2,2
36966,வழியாகும்,0,0,2,2
26630,அழகான,0,0,2,2
26631,augmentation,0,0,2,2
36964,densité,0,0,2,2
1140,nascita,1,2,0,2
26637,animaux,0,0,2,2
26560,الادعاء,0,0,2,2
1162,cercato,1,2,0,2
26550,comparou,0,0,2,2
1166,pensiero,1,2,0,2
26481,geduldig,0,0,2,2
37055,protists,0,0,2,2
26488,maintains,0,0,2,2
26489,bevatte,0,0,2,2
26493,ಬೆರಳುಗಳನ್ನು,0,0,2,2
26498,houve,0,0,2,2
26499,enviados,0,0,2,2
37042,ಪಡೆಯುತ್ತೀರಿ,0,0,2,2
37041,atributos,0,0,2,2
26512,ಬಳಸಿ,0,0,2,2
1174,conosco,1,2,0,2
26526,„википедию“,0,0,2,2
26529,zat,0,0,2,2
26532,smile,0,0,2,2
1170,notevoli,1,2,0,2
52167,alterar,0,0,2,2
26537,सके,0,0,2,2
37022,integral,0,0,2,2
37021,deluged,0,0,2,2
26540,δουλέψει,0,0,2,2
26541,representar,0,0,2,2
26638,moteur,0,0,2,2
26639,അറിവു,0,0,2,2
26642,peuxtu,0,0,2,2
36904,kidding,0,0,2,2
26737,intervjun,0,0,2,2
26743,üye,0,0,2,2
26748,identities,0,0,2,2
26760,discovered,0,0,2,2
26762,considering,0,0,2,2
26763,krijg,0,0,2,2
26772,tecnológicos,0,0,2,2
26774,tenham,0,0,2,2
26781,publishers,0,0,2,2
36863,historiador,0,0,2,2
36861,wikipediaanvändare,0,0,2,2
26802,பார்த்த,0,0,2,2
1110,diventano,1,2,0,2
26807,geeft,0,0,2,2
26808,object,0,0,2,2
26817,maandenlang,0,0,2,2
1106,wikiworld,2,1,1,2
26819,worried,0,0,2,2
36847,помощью,0,0,2,2
26825,problemer,0,0,2,2
36842,técnicos,0,0,2,2
36901,ثلث,0,0,2,2
26728,livros,0,0,2,2
26647,vilar,0,0,2,2
26725,quejarme,0,0,2,2
26651,يجري,0,0,2,2
36954,coloquial,0,0,2,2
36950,കുറിച്ച്,0,0,2,2
26662,translated,0,0,2,2
1133,nell'esempio,1,2,0,2
26676,ändringar,0,0,2,2
36937,εκκαθάρισης,0,0,2,2
36929,noção,0,0,2,2
1130,mandare,1,2,0,2
1129,lui.,1,2,0,2
36921,исследователей,0,0,2,2
26703,acted,0,0,2,2
36920,खाते,0,0,2,2
26706,hämtar,0,0,2,2
26707,सैनिकों,0,0,2,2
26708,podrían,0,0,2,2
26709,purement,0,0,2,2
1125,credenze,1,2,0,2
36915,trends,0,0,2,2
26719,apresenta,0,0,2,2
36910,तुमसे,0,0,2,2
25754,théoriquement,0,0,2,2
25751,bevor,0,0,2,2
51950,விரைவான,0,0,2,2
1472,termica,1,2,0,2
24742,lusófona,0,0,2,2
24746,ettiği,0,0,2,2
24747,रंग,0,0,2,2
1476,impara,1,2,0,2
24752,заняться,0,0,2,2
38158,ಬುದ್ದಿವಂತನಲ್ಲ,0,0,2,2
24755,delete,0,0,2,2
24757,termed,0,0,2,2
38155,permiso,0,0,2,2
51992,kleiner,0,0,2,2
24767,undervisningen,0,0,2,2
38133,maintenance,0,0,2,2
38147,fondateurs,0,0,2,2
24780,மகிழ்ச்சியாக,0,0,2,2
38143,baseras,0,0,2,2
38141,мариан,0,0,2,2
38136,alcançar,0,0,2,2
24789,agence,0,0,2,2
24793,dedican,0,0,2,2
24794,s’intéressent,0,0,2,2
38135,बढ़ा,0,0,2,2
24797,فأنا,0,0,2,2
24735,hızlı,0,0,2,2
24727, millions,0,0,2,2
24720,പ്രശ്‌നകരമായ,0,0,2,2
38177,ಬಂದಿದ್ದೀರಿ,0,0,2,2
24656,financer,0,0,2,2
38215,επί,0,0,2,2
24664,அனைத்தையும்,0,0,2,2
24665,അതേ,0,0,2,2
38213,tratando,0,0,2,2
51984,médical,0,0,2,2
24675,образуют,0,0,2,2
38198,atención,0,0,2,2
38194,heavy,0,0,2,2
24690,отсутствие,0,0,2,2
24691,redactados,0,0,2,2
38190,noterat,0,0,2,2
24699,clásico,0,0,2,2
1484,biotici,1,2,0,2
38186,وإرشادات,0,0,2,2
24706,bekannt,0,0,2,2
38184,ಬಯಸುತ್ತೀರಾ,0,0,2,2
24709,bénévoles,0,0,2,2
24711,confus,0,0,2,2
38181,citados,0,0,2,2
24715,ചുവടുവപ്പ്,0,0,2,2
24798,जल्द,0,0,2,2
38129,measures,0,0,2,2
24991,caractère,0,0,2,2
24965,مختلفة,0,0,2,2
24934,രണ്ടുപേരും,0,0,2,2
52006,skoja,0,0,2,2
24940,richesses,0,0,2,2
52007,student,0,0,2,2
1448,terrestre.,1,2,0,2
24945,borrowed,0,0,2,2
24946,बोमिस,0,0,2,2
38034,ಅಲ್ಲಿಗೆ,0,0,2,2
1447,giornalistiche,1,2,0,2
24962,മൈൽ,0,0,2,2
24966,dealing,0,0,2,2
38124,vælges,0,0,2,2
24968,ابنتي,0,0,2,2
24970,évidents,0,0,2,2
1445,nient'altro,1,2,0,2
24973,nde,0,0,2,2
24974,sofort,0,0,2,2
24975,παρακαλούμε,0,0,2,2
16745,potatoes,0,0,2,2
24981,ആകർഷണീയമായ,0,0,2,2
1444,opposti,1,2,0,2
38011,turisten,0,0,2,2
1453,contribuisce,1,2,0,2
24923,criada,0,0,2,2
38052,discrete,0,0,2,2
24918,те,0,0,2,2
24828,rødder,0,0,2,2
24835,verscheen,0,0,2,2
24843,resposta,0,0,2,2
24849,välkomna,0,0,2,2
24861,personnel,0,0,2,2
38085,raiva,0,0,2,2
24868,varied,0,0,2,2
24873,அர்த்தம்,0,0,2,2
24875,sormak,0,0,2,2
24878,ലേഖനങ്ങളാവാൻ,0,0,2,2
24880,gusta,0,0,2,2
38077,zittrain,0,0,2,2
38074,تعليقًا,0,0,2,2
24886,ಮರುದಿನ,0,0,2,2
24892,mudou,0,0,2,2
24893,പറ്റിയെഴുതുന്നു,0,0,2,2
24894,അറിയാം,0,0,2,2
24899,higherdimensional,0,0,2,2
24903,إمكانية,0,0,2,2
52003,vergiss,0,0,2,2
24916,instructions,0,0,2,2
38222,étiquette,0,0,2,2
51980,ವಹಿಸಲು,0,0,2,2
24644,മുങ്ങുക,0,0,2,2
24461,narzissenmutter,0,0,2,2
24440,secteur,0,0,2,2
24446,générer,0,0,2,2
1534,leggermente,1,2,0,2
51959,होगी।,0,0,2,2
24451,reciben,0,0,2,2
24452,ಕ್ರೂರ,0,0,2,2
24454,indicar,0,0,2,2
38329,مفيدة,0,0,2,2
51960,referat,0,0,2,2
24458,पसंदीदा,0,0,2,2
24464,शुरुआत,0,0,2,2
24640,patronen,0,0,2,2
1529,valuta,1,2,0,2
1528,meritare,1,2,0,2
24471,olduğunuzu,0,0,2,2
1527,fai.,1,2,0,2
24479,bases,0,0,2,2
1524,frase.,1,2,0,2
24482,دلالات,0,0,2,2
24489,pourraient,0,0,2,2
38312,чемто,0,0,2,2
24493,incroyablement,0,0,2,2
38336,graph,0,0,2,2
51957,sık,0,0,2,2
24430,சிறப்புக்,0,0,2,2
24425,ರ,0,0,2,2
24353,αργός,0,0,2,2
51951,largely,0,0,2,2
24356,priorities,0,0,2,2
24357,navnet,0,0,2,2
51952,fremsætter,0,0,2,2
1546,l'utilizzo,1,2,0,2
1545,dov'eravamo,1,2,0,2
38378,männer,0,0,2,2
24379,περισσότερες,0,0,2,2
38372,drømme,0,0,2,2
38371,kullanmaktadır,0,0,2,2
24386,decirlo,0,0,2,2
24399,sediments,0,0,2,2
24401,википедии»,0,0,2,2
1542,quell'angelo,1,2,0,2
38351,exclusivamente,0,0,2,2
38349,contagens,0,0,2,2
24419,sociedad,0,0,2,2
1539,immagazzinare,1,2,0,2
24421,herregud,0,0,2,2
24423,स्वयं,0,0,2,2
24499,λόγω,0,0,2,2
24502,аппроксимации,0,0,2,2
1517,inserire,1,2,0,2
24579,الجمل,0,0,2,2
38257,agua,0,0,2,2
1507,differenziati,1,2,0,2
51974,equatorial,0,0,2,2
24585,drömmar,0,0,2,2
1505,sapresti,1,2,0,2
51975,മാറി,0,0,2,2
51977,нейросетей,0,0,2,2
24595,healthcare,0,0,2,2
38250,desarrolló,0,0,2,2
24600,സാധാരണയായി,0,0,2,2
24601,ലാരി,0,0,2,2
38244,encyclopédie ,0,0,2,2
24614,άλλως,0,0,2,2
24617,अर्थात,0,0,2,2
24626,вся,0,0,2,2
1496,noam,2,1,1,2
38233,ತಾಯಿಯನ್ನು,0,0,2,2
1495,sollevato,1,2,0,2
38231,écoutez,0,0,2,2
24637,maktspel,0,0,2,2
38229,ويكيميديا،,0,0,2,2
24580,acusação,0,0,2,2
24576,വരുത്തുന്നതിൽ,0,0,2,2
24517,sat,0,0,2,2
24572,мужчина,0,0,2,2
24519,παρασκευή,0,0,2,2
38292,«punto,0,0,2,2
38291,своего,0,0,2,2
1513,connesse,1,2,0,2
38287,структура,0,0,2,2
24530,ಬನ್ನಿ,0,0,2,2
38285,conferences,0,0,2,2
24539,история,0,0,2,2
38277,pequena,0,0,2,2
38275,pouvais,0,0,2,2
24548,xxi,0,0,2,2
51973,रखाव,0,0,2,2
24552,ന്റെ,0,0,2,2
24553,doorgeven,0,0,2,2
38271,سروري,0,0,2,2
24556,όλο,0,0,2,2
24559,felaktigt,0,0,2,2
24560,അർത്ഥമാക്കുന്നു,0,0,2,2
24561,memória,0,0,2,2
24565,أجريت,0,0,2,2
1508,dubbi,1,2,0,2
24988,couvrir,0,0,2,2
24993,ஆங்கிலம்,0,0,2,2
25748,الأمريكيون,0,0,2,2
25481,المبالغة,0,0,2,2
1359,scarsa.,1,2,0,2
52060,ನೋಡಿದ,0,0,2,2
25444,fantásticas,0,0,2,2
25447,crash,0,0,2,2
52061,हैरान,0,0,2,2
25463,mogelijkheden,0,0,2,2
25469,flagged,0,0,2,2
37715,matemática,0,0,2,2
25476,रखें।,0,0,2,2
25480,görüyorum,0,0,2,2
25497,जाना।,0,0,2,2
25540,ccbysalicentie,0,0,2,2
25503,comerlo,0,0,2,2
37695,ലേഖനത്തിന്,0,0,2,2
52065,நேச்சர்,0,0,2,2
37684,descrição,0,0,2,2
25523,gümüş,0,0,2,2
52066,internas,0,0,2,2
25525,existantes,0,0,2,2
52067,επόμενο,0,0,2,2
25529,vandalismprone,0,0,2,2
52068,frankrike,0,0,2,2
25436,länka,0,0,2,2
25435,beseffen,0,0,2,2
37740,vocabulario,0,0,2,2
25430,sofistikerad,0,0,2,2
37791,μικρότερη,0,0,2,2
25351,بمدى,0,0,2,2
25353,debated,0,0,2,2
25358,néerlandais,0,0,2,2
37784,वर्तनी,0,0,2,2
37775,körs,0,0,2,2
25378,säg,0,0,2,2
25382,probabilité,0,0,2,2
25383,soll,0,0,2,2
1368,ossigeno,1,2,0,2
37769,knappt,0,0,2,2
1366,fine.,1,2,0,2
25391,cultures,0,0,2,2
25392,brillantes,0,0,2,2
37766,syntes,0,0,2,2
37765,спрашивает,0,0,2,2
37761,velopdragen,0,0,2,2
52056,versioner,0,0,2,2
25405,voedsel,0,0,2,2
25412,ಕೇಳಿದ್ದೇನೆ,0,0,2,2
25425,équilibre,0,0,2,2
25535,сильно,0,0,2,2
1344,riconosciuto,1,2,0,2
38002,consultées,0,0,2,2
37578,hazards,0,0,2,2
37603,produire,0,0,2,2
37599,ഉറപ്പാക്കുക,0,0,2,2
25641,quite,0,0,2,2
25647,ശരിയായ,0,0,2,2
25653,distribuído,0,0,2,2
37593,féliciter,0,0,2,2
37591,ചെയ്യാത്ത,0,0,2,2
25662,mágicos,0,0,2,2
25668,bacterial,0,0,2,2
1323,buono,1,2,0,2
37569,numerosos,0,0,2,2
25543,pediapress,0,0,2,2
37564,വീട്ടിൽ,0,0,2,2
37563,منفرجة,0,0,2,2
25703,indígenas,0,0,2,2
37558,vertelt,0,0,2,2
25708,sag,0,0,2,2
25717,деятельности,0,0,2,2
52085,विश्वविद्यालयों,0,0,2,2
25727,स्पेनिश,0,0,2,2
25728,olmanın,0,0,2,2
25733,hittar,0,0,2,2
25634,يدفع,0,0,2,2
25633,gifta,0,0,2,2
25624,लें।,0,0,2,2
25619,bryde,0,0,2,2
37667,दूसरी,0,0,2,2
1343,biosfera.,1,2,0,2
25551,cycle,0,0,2,2
37661,അറിയാൻ,0,0,2,2
25555,idiot,0,0,2,2
37657,mdp,0,0,2,2
37651,transphobie,0,0,2,2
1339,elaborazione,1,2,0,2
25573,constraint,0,0,2,2
25577,കൂടിക്കാഴ്‌ച,0,0,2,2
37641,shape,0,0,2,2
25583,مجرد,0,0,2,2
25587,manter,0,0,2,2
37636,mentalt,0,0,2,2
25595,progressivement,0,0,2,2
37632,graphical,0,0,2,2
25606,ರೀತಿ,0,0,2,2
37624,korta,0,0,2,2
37620,bebida,0,0,2,2
25616,apply,0,0,2,2
37616,députés,0,0,2,2
37793,حالك؟,0,0,2,2
37794,محمية,0,0,2,2
25345,dependent,0,0,2,2
37906,energi,0,0,2,2
1416,tavola,1,2,0,2
37926,elegir,0,0,2,2
25131,philosophers,0,0,2,2
37919,bienvenue,0,0,2,2
25141,للمساعدة,0,0,2,2
37916,acte,0,0,2,2
25146,लेता,0,0,2,2
25150,ರಾಜಕುಮಾರ,0,0,2,2
1406,inserendo,1,2,0,2
25156,significations,0,0,2,2
25158,stødte,0,0,2,2
25337,letárgico,0,0,2,2
37897,диска,0,0,2,2
25173,proper,0,0,2,2
37893,ചെയ്തിട്ടുണ്ടെങ്കിൽ,0,0,2,2
25180,divers,0,0,2,2
25182,ഏവർക്കും,0,0,2,2
25184,चुनाव,0,0,2,2
25185,photographs,0,0,2,2
25188,verificar,0,0,2,2
25190,plantar,0,0,2,2
25192,alltså,0,0,2,2
37929,manipulate,0,0,2,2
37934,économique,0,0,2,2
25112,horizontale,0,0,2,2
25104,publicações,0,0,2,2
25006,elegido,0,0,2,2
25007,identifier,0,0,2,2
25008,må,0,0,2,2
37995,smaragder,0,0,2,2
25016,asia,0,0,2,2
25022,planlar,0,0,2,2
25024,попробуйте,0,0,2,2
37981,группы,0,0,2,2
37977,savoirfaire,0,0,2,2
25052,mythes,0,0,2,2
25055,όνομά,0,0,2,2
25059,classify,0,0,2,2
1433,nazionale,1,2,0,2
25069,случаях,0,0,2,2
37960,colonized,0,0,2,2
25071,स्वागत,0,0,2,2
37951,التعليق,0,0,2,2
1429,alternativa,1,2,0,2
52018,ಮಿಲಿಯನ್,0,0,2,2
25093,beslut,0,0,2,2
37942,ബ്യൂറോക്രാറ്റുകൾ,0,0,2,2
25193,vs,0,0,2,2
25195,सदस्यता,0,0,2,2
37884,conhece,0,0,2,2
25271,lucratif,0,0,2,2
25281,ಅರ್ಹನೆಂದು,0,0,2,2
25282,"
bielorrusso",0,0,2,2
25284,تهدف,0,0,2,2
1395,protezione,1,2,0,2
37830,enheder,0,0,2,2
37829,ദൈവമേ,0,0,2,2
25297,aura,0,0,2,2
37818,واراي,0,0,2,2
25306,അതുകൊണ്ട്,0,0,2,2
25308,изначально,0,0,2,2
25310,troublesome,0,0,2,2
25314,καλοί,0,0,2,2
25315,vocabulary,0,0,2,2
25316,comprar,0,0,2,2
37811,gevraagd,0,0,2,2
1391,limitato,1,2,0,2
25323,объёмом,0,0,2,2
25328,artikels,0,0,2,2
25331,ameaça,0,0,2,2
1385,rischio,1,2,0,2
25335,കഴിഞ്ഞ്,0,0,2,2
37833,ഫോൺ,0,0,2,2
37841,cualquiera,0,0,2,2
52035,comparável,0,0,2,2
25266,formel,0,0,2,2
37880,humaine »,0,0,2,2
25206,machinelearning,0,0,2,2
25211,entier,0,0,2,2
25213,willkommen,0,0,2,2
37873,yerime,0,0,2,2
25216,sylt,0,0,2,2
37872,какой,0,0,2,2
37871,laddade,0,0,2,2
37861,முயற்சிக்கவும்,0,0,2,2
37858,slutet,0,0,2,2
25233,demuestra,0,0,2,2
25235,yaptığı,0,0,2,2
25240,myntat,0,0,2,2
37856,பெறவில்லை,0,0,2,2
25246,தேவை,0,0,2,2
37851,kızgın,0,0,2,2
1396,molecole,1,2,0,2
25251,interconnected,0,0,2,2
37850,نرجس,0,0,2,2
25253,धीरेधीरे,0,0,2,2
25259,എളുപ്പമുള്ള,0,0,2,2
43286,எடுத்துக்காட்டு,0,0,2,2
32944,ajudam,0,0,2,2
50734,zoekmachines,0,0,2,2
3495,flusso,1,2,0,2
45312,أيضاً,0,0,2,2
45311,berättade,0,0,2,2
4566,farai,1,2,0,2
7917,citare,1,2,0,2
48778,بنسبة,0,0,2,2
7914,diminuisce.,1,2,0,2
48779,обсуждаются,0,0,2,2
7908,unito,1,2,0,2
50425,أجراها,0,0,2,2
13581,вопросов,0,0,2,2
13583,fortsätter,0,0,2,2
48785,परिणामों,0,0,2,2
50428,preocupaciones,0,0,2,2
13589,παιδί,0,0,2,2
7895,seduta,1,2,0,2
13594,എവിടെയായിരുന്നുവെന്ന്,0,0,2,2
13566,inteira,0,0,2,2
7926,adorabile,1,2,0,2
7927,polari.,1,2,0,2
45318,सपनों,0,0,2,2
13531,videos,0,0,2,2
13532,развития,0,0,2,2
7946,adorabili,1,2,0,2
4562,difficili,1,2,0,2
7944,chimica,1,2,0,2
45337,skaffe,0,0,2,2
50943,வெள்ளிக்கிழமை,0,0,2,2
45333,begge,0,0,2,2
48765,ninguém,0,0,2,2
48769,трафика,0,0,2,2
13548,सरंचना,0,0,2,2
7934,pigro.,1,2,0,2
45324,ridder,0,0,2,2
4565,deposizione,1,2,0,2
45319,zichzelf,0,0,2,2
13596,கணித,0,0,2,2
7885,subì,1,2,0,2
13657,introducir,0,0,2,2
7850,sedimenti,1,2,0,2
13624,مقدمًا,0,0,2,2
45279,geïnteresseerd,0,0,2,2
13626,ಮದುವೆಯಾಗಲು,0,0,2,2
48809,daad,0,0,2,2
50950,ترَ,0,0,2,2
13632,confiabilidade,0,0,2,2
13633,bloqueo,0,0,2,2
7849,un'attività,1,2,0,2
48797,geschikt,0,0,2,2
4585,stimoli,1,2,0,2
4586,gestiti,1,2,0,2
7846,plotkin,2,1,1,2
13646,herself,0,0,2,2
4587,lacrime.,1,2,0,2
7844,duda,2,1,1,2
45266,criaram,0,0,2,2
48808,прошла,0,0,2,2
45280,quiere,0,0,2,2
7857,presi,1,2,0,2
7858,guaio,1,2,0,2
13601,работа,0,0,2,2
50424,الإسبانية,0,0,2,2
45294,വായ്പ,0,0,2,2
7880,nell'angolo,1,2,0,2
7878,l'unica,1,2,0,2
3492,rischi,1,2,0,2
7875,controverse,2,1,1,2
3491,un'intervista,1,2,0,2
45289,доступ,0,0,2,2
48800,vakgebieden,0,0,2,2
45284,displace,0,0,2,2
48804,രഹസ്യമായി,0,0,2,2
50422,पक्ष,0,0,2,2
7862,accurati,1,2,0,2
48807,map,0,0,2,2
48759,hoort,0,0,2,2
13528,അജ്ഞാത,0,0,2,2
7950,frances,2,1,1,2
48729,bromeando,0,0,2,2
8031,dall'ia,1,2,0,2
13429,snigel,0,0,2,2
8028,progettata,1,2,0,2
13437,frau,0,0,2,2
13440,sonhos,0,0,2,2
50930,ходе,0,0,2,2
45393,obviedad,0,0,2,2
8017,sembravano,1,2,0,2
4561,amico.,1,2,0,2
8015,paese,1,2,0,2
13449,conhecido,0,0,2,2
4543,mira,1,2,0,2
8013,learning.,1,2,0,2
8009,sangue,2,1,1,2
8008,carceri,1,2,0,2
50934,chegou,0,0,2,2
48723,കുറച്ചുകാലമായി,0,0,2,2
3526,tribunale,1,2,0,2
45405,பெருமை,0,0,2,2
45408,права,0,0,2,2
45434,उदाहरणों,0,0,2,2
13388,assets,0,0,2,2
45427,poucas,0,0,2,2
48712,distincts,0,0,2,2
8044,saluti,1,2,0,2
13404,saudiarabien,0,0,2,2
13405,становятся,0,0,2,2
13406,وسط,0,0,2,2
45415,ancienne,0,0,2,2
3533,charles,2,1,1,2
8043,risposte,1,2,0,2
3530,tenute,1,2,0,2
8041,risolvibili,1,2,0,2
48717,kaldım,0,0,2,2
13414,дальнейшем,0,0,2,2
8006,l'economia,1,2,0,2
45383,ene,0,0,2,2
13460,gelernt,0,0,2,2
7975,affermazione,1,2,0,2
45355,ತೀಕ್ಷ್ಣ,0,0,2,2
45353,suche,0,0,2,2
7964,banca,1,2,0,2
13514,contrato,0,0,2,2
7963,annuncio,1,2,0,2
13516,verbessern,0,0,2,2
7961,dominare,1,2,0,2
45345,logistic,0,0,2,2
13520,إخبار,0,0,2,2
4558,strutturali,1,2,0,2
7956,sottoposto,1,2,0,2
7955,autorevolezza.,1,2,0,2
13522,τέσσερα,0,0,2,2
7952,occupato.,1,2,0,2
13526,ಗೊತ್ತು,0,0,2,2
13497,включён,0,0,2,2
50939,padrão,0,0,2,2
13466,structurale,0,0,2,2
45365,കിടക്കുന്ന,0,0,2,2
8001,scale,2,1,1,2
45376,évidentes,0,0,2,2
7996,doppia,1,2,0,2
13473,स्पीकर,0,0,2,2
45374,قرار,0,0,2,2
13475,поражена,0,0,2,2
48739,παρακολουθείτε,0,0,2,2
45373,fungerar,0,0,2,2
7989,"campi,",1,2,0,2
48741,κοινή,0,0,2,2
50434,പ്രിയേ,0,0,2,2
48743,lieverd,0,0,2,2
7981,preoccupa,1,2,0,2
13486,duyduğunuzda,0,0,2,2
7977,l'ultimo,1,2,0,2
3485,qualcos'altro.,1,2,0,2
13658,tråkig,0,0,2,2
50394,känd,0,0,2,2
45119,объявил,0,0,2,2
50975,findings,0,0,2,2
7702,eliot,2,1,1,2
13877,υποθέτω,0,0,2,2
7684,divano.,1,2,0,2
45125,pudo,0,0,2,2
4622,accedere,1,2,0,2
48890,wortschatz,0,0,2,2
7677,studiate,1,2,0,2
13908,просят,0,0,2,2
7675,reale,1,2,0,2
13892,создание,0,0,2,2
45113,признана,0,0,2,2
13896,बाप।,0,0,2,2
45111,maakte,0,0,2,2
13902,lägga,0,0,2,2
45109,idéologie,0,0,2,2
3446,catalizzatore,1,2,0,2
45136,extrême,0,0,2,2
13864,ಯಾರು,0,0,2,2
13857,registrerade,0,0,2,2
45160,soldados,0,0,2,2
7721,sessuali,1,2,0,2
45157,internes,0,0,2,2
13830,इण्टरनेट,0,0,2,2
7720,pomeriggio,1,2,0,2
13834,faim,0,0,2,2
13835,acontecimentos,0,0,2,2
48871,gesteld,0,0,2,2
13839,хорошими,0,0,2,2
7717,chiederti,1,2,0,2
4611,imperfetto,1,2,0,2
7713,picco,1,2,0,2
7711,immediate,2,1,1,2
13849,augen,0,0,2,2
45140,முனை,0,0,2,2
45107,കൂടിക്കാഴ്‌ചയുണ്ട്,0,0,2,2
13910,τρόπους,0,0,2,2
3484,notevole,1,2,0,2
7628,dell'atmosfera,1,2,0,2
50982,stiftelsen,0,0,2,2
48918,autriche,0,0,2,2
7632,sacco,1,2,0,2
45068,третье,0,0,2,2
13972,passait,0,0,2,2
7629,numeratori,1,2,0,2
45065,söyleyebilirsin,0,0,2,2
45064,publicidade,0,0,2,2
45104,solaire,0,0,2,2
13977,വിക്കിപീഡിയക്കായി,0,0,2,2
48923,diário,0,0,2,2
13983,ಆಶ್ಚರ್ಯಕರವಾಗಿ,0,0,2,2
50395,உருவாக்க,0,0,2,2
45056,помните,0,0,2,2
13990,objective,0,0,2,2
7620,copre,1,2,0,2
45072,பணம்,0,0,2,2
13964,dili,0,0,2,2
7640,dimentica.,1,2,0,2
13946,découvertes,0,0,2,2
3440,false.,1,2,0,2
13916,وجدت,0,0,2,2
4626,superficiali,1,2,0,2
13921,exceptions,0,0,2,2
13922,കാഴ്ചപ്പാട്,0,0,2,2
13924,உருவாக்கும்,0,0,2,2
13928,مضاء,0,0,2,2
3433,sbagliato.,1,2,0,2
7664,editori.,1,2,0,2
7663,mnist,2,1,1,2
4630,commentando,1,2,0,2
13934,ändra,0,0,2,2
45093,comparten,0,0,2,2
45090,χθες,0,0,2,2
7650,lasciami,1,2,0,2
13821,ಪುನರಾವರ್ತಿಸಲು,0,0,2,2
13819,мной,0,0,2,2
50408,medmindre,0,0,2,2
4595,matto,1,2,0,2
13692,लिख,0,0,2,2
7815,"fatti,",1,2,0,2
3477,coltivate,1,2,0,2
13702,ಪದಗಳಲ್ಲಿ,0,0,2,2
7814,annullare,1,2,0,2
45227,larousse,0,0,2,2
3470,preferirei,1,2,0,2
7807,stia,1,2,0,2
45168,இருந்தன,0,0,2,2
13714,researched,0,0,2,2
7804,valutato,1,2,0,2
13715,boundary,0,0,2,2
13719,ήρθαν,0,0,2,2
7798,impareremo,1,2,0,2
3469,anticipo.,1,2,0,2
45216,لشركة,0,0,2,2
7819,arrabbiata,1,2,0,2
13687,equivocado,0,0,2,2
7820,piantare,1,2,0,2
13683,conjunta,0,0,2,2
45259,tabeller,0,0,2,2
7841,all'anno.,1,2,0,2
7840,destinazione,1,2,0,2
13666,électronique,0,0,2,2
7837,aiuto,1,2,0,2
7834,truppe,1,2,0,2
13669,فضيًا,0,0,2,2
7833,carini,1,2,0,2
13672,തരാമോ,0,0,2,2
48816,صفحاتها,0,0,2,2
7830,famiglia,1,2,0,2
4588,funzionali.,1,2,0,2
7825,corrispondenti,1,2,0,2
4592,riportati,1,2,0,2
48817,ತಿಳಿಸಿ,0,0,2,2
45213,enormt,0,0,2,2
13736,κλικ,0,0,2,2
13738,rejste,0,0,2,2
45187,содержимого,0,0,2,2
45186,некоммерческая,0,0,2,2
13786,ensaio,0,0,2,2
45181,philosophies,0,0,2,2
7757,abbi,1,2,0,2
7756,riserve,1,2,0,2
50410,gärna,0,0,2,2
7747,l'allenamento,1,2,0,2
13798,زيارة,0,0,2,2
13799,dinner,0,0,2,2
7745,esperimento,1,2,0,2
13806,أنحاء,0,0,2,2
7744,influenze,1,2,0,2
7742,fornitori,1,2,0,2
13810,heman,0,0,2,2
50409,достижения,0,0,2,2
13784,கொடுக்க,0,0,2,2
48852,tung,0,0,2,2
7790,guardando.,1,2,0,2
45189,kaum,0,0,2,2
13743,wikitext,0,0,2,2
7783,sostenuta,1,2,0,2
45208,منهم,0,0,2,2
45206,شهرة,0,0,2,2
13753,sociólogo,0,0,2,2
13754,manhã,0,0,2,2
48843,costs,0,0,2,2
4602,nord,2,1,1,2
45203,ಒಬ್ಟೂಸ್,0,0,2,2
7775,rendezvous.,1,2,0,2
13767,απόψε,0,0,2,2
7772,geometry,2,1,1,2
7769,trattavi,1,2,0,2
13774,seas,0,0,2,2
3460,imparassero,1,2,0,2
13378,rely,0,0,2,2
8054,gamma,1,2,0,2
45436,للكلمة,0,0,2,2
13044,despedir,0,0,2,2
3608,interagisce,1,2,0,2
3607,salutarono,1,2,0,2
4454,seduti,1,2,0,2
45660,tilsammen,0,0,2,2
4455,modellano,1,2,0,2
45658,بالكاد,0,0,2,2
8350,aggiunti,1,2,0,2
50476,algún,0,0,2,2
13062,மதிப்பு,0,0,2,2
45650,recommended,0,0,2,2
48575,afortunado,0,0,2,2
3605,darci,1,2,0,2
50475,blockerades,0,0,2,2
48577,κάποια,0,0,2,2
45644,muss,0,0,2,2
13057,coberto,0,0,2,2
8356,individuo,2,1,1,2
45668,verici,0,0,2,2
13021,اعتني,0,0,2,2
8360,sostantivo,1,2,0,2
4449,officer,2,1,1,2
45693,amorality,0,0,2,2
12987,symbolic,0,0,2,2
8392,autorevole,1,2,0,2
45685,redigeringen,0,0,2,2
8383,complesse,1,2,0,2
12997,skärmar,0,0,2,2
3610,limitate,1,2,0,2
45678,கலைக்களஞ்சியமாக,0,0,2,2
45677,واسع,0,0,2,2
50480,بداية,0,0,2,2
4452,presentate,1,2,0,2
13019,pedido,0,0,2,2
8362,passato.,1,2,0,2
8361,cancro,1,2,0,2
50892,النصيحة,0,0,2,2
13063,besef,0,0,2,2
8056,rappresentativo,1,2,0,2
4481,attuali,1,2,0,2
8300,eccezionalmente,1,2,0,2
48592,presentes,0,0,2,2
13089,ஃப்ளூமொக்ஸ்,0,0,2,2
8298,volontaria,1,2,0,2
45620,environnementale,0,0,2,2
50468,recuerde,0,0,2,2
13097,يرجع,0,0,2,2
13100,قالوا,0,0,2,2
8332,qualunque,1,2,0,2
48596,descriptions,0,0,2,2
48597,welk,0,0,2,2
48598,erzogen,0,0,2,2
13103,académica,0,0,2,2
8285,ripetizione.,1,2,0,2
48599,intellectual,0,0,2,2
45612,exploitation,0,0,2,2
13085,tráfico,0,0,2,2
3600,pace,2,1,1,2
8302,snow,2,1,1,2
8303,acquisizione,1,2,0,2
48579,satire,0,0,2,2
50474,suele,0,0,2,2
45636,ले,0,0,2,2
50893,fenômeno,0,0,2,2
48581,സ്കൂളിൽ,0,0,2,2
8323,congratulazioni,1,2,0,2
48586,другую,0,0,2,2
8317,iscriverti,1,2,0,2
50470,ಹೇಳುತ್ತಿರುವುದನ್ನು,0,0,2,2
48588,expor,0,0,2,2
4469,precedenza,1,2,0,2
45629,الهدف,0,0,2,2
8307,incorporano,1,2,0,2
3602,odum,2,1,1,2
4474,accattivante,1,2,0,2
45699,longue,0,0,2,2
8404,stesse,1,2,0,2
12978,حل,0,0,2,2
12902,devagar,0,0,2,2
12889,تحريرها,0,0,2,2
48502,viaje,0,0,2,2
12894,областях,0,0,2,2
8478,copia,1,2,0,2
45752,telle,0,0,2,2
8476,poesia,1,2,0,2
8475,prossimi,1,2,0,2
8472,compresa,1,2,0,2
45701,λέω,0,0,2,2
8471,guardi,1,2,0,2
48507,relevant,0,0,2,2
48508,चाहती,0,0,2,2
12906,αμβλύ,0,0,2,2
12907,kelimeleri,0,0,2,2
4428,shepelyansky,2,1,1,2
8464,divennero,1,2,0,2
8486,umm.,1,2,0,2
4423, gb,2,1,1,2
8492,supponiamo,1,2,0,2
8493,pratica,1,2,0,2
48487,reclamar,0,0,2,2
45781,pouvoir,0,0,2,2
45778,கட்டுரைகளைத்,0,0,2,2
48490,അദ്ദേഹം,0,0,2,2
45777,осуществлён,0,0,2,2
48491,rüyaydı,0,0,2,2
48492,dalga,0,0,2,2
45775,obscenas,0,0,2,2
12870,ब्रेड,0,0,2,2
12871,μέλισσα,0,0,2,2
48494,городе,0,0,2,2
8497,modelli.,1,2,0,2
45766,større,0,0,2,2
12882,oprette,0,0,2,2
45762,seguir,0,0,2,2
12908,எரிகிறது,0,0,2,2
50884,طبعة,0,0,2,2
48511,experimentos,0,0,2,2
48527,dantas,0,0,2,2
4441,candidati,1,2,0,2
45723,réfléchir,0,0,2,2
8421,necessari,1,2,0,2
12945,hel,0,0,2,2
45720,practices,0,0,2,2
45716,ruso,0,0,2,2
48533,nederländska,0,0,2,2
45712,cautions,0,0,2,2
4443,rimedi,1,2,0,2
8414,symbol,2,1,1,2
12963,pocos,0,0,2,2
8413,collega,1,2,0,2
50888,alegações,0,0,2,2
12968,permis,0,0,2,2
45704,ehe,0,0,2,2
12942,positivos,0,0,2,2
4437,calcolato,1,2,0,2
50490,kurohin,0,0,2,2
8434,dell'album,1,2,0,2
12915,بعمل,0,0,2,2
12916,друзей,0,0,2,2
8457,operazioni,1,2,0,2
48513,ಮೆಲಿಸ್ಸಾ,0,0,2,2
12921,எப்போது,0,0,2,2
12926,salades,0,0,2,2
8454,scelte,1,2,0,2
48516,ಶಬ್ದಕೋಶವನ್ನು,0,0,2,2
12928,zengin,0,0,2,2
48517,sexism,0,0,2,2
4434,compiti.,1,2,0,2
3622,grado.,1,2,0,2
12937,मंडल,0,0,2,2
48519,publiée,0,0,2,2
8437,reali,1,2,0,2
45606,classificada,0,0,2,2
45604,aufgaben,0,0,2,2
8278,passando,2,1,1,2
13302,coole,0,0,2,2
50913,ampliación,0,0,2,2
8112,completa,1,2,0,2
13291,ενδιαφέρει,0,0,2,2
8110,c't,1,2,0,2
4521,iniziali,1,2,0,2
48684,व्यक्त,0,0,2,2
13299,primer,0,0,2,2
45479,contrôlant,0,0,2,2
8151,cluster.,1,2,0,2
13306,schreiben,0,0,2,2
4523,dinastia,1,2,0,2
3556,all'anno,1,2,0,2
50917,المدرسة,0,0,2,2
4524,lettere,1,2,0,2
3553,flussi,1,2,0,2
8097,vite,2,1,1,2
8113,portando,1,2,0,2
48680,récompense,0,0,2,2
8120,impersonificazione,1,2,0,2
13281,trots,0,0,2,2
8146,informativa,2,1,1,2
8145,mancante.,1,2,0,2
50908,случая,0,0,2,2
3571,biologici,1,2,0,2
13262,diagnosis,0,0,2,2
8141,segnalare,1,2,0,2
13264,تعمل,0,0,2,2
13266,ಸ್ವರ್ಗ,0,0,2,2
48671,fångst,0,0,2,2
3569,sconosciute,1,2,0,2
45498,സേവനങ്ങൾ,0,0,2,2
8129,negativo.,1,2,0,2
8125,-.,1,2,0,2
8124,pianto,1,2,0,2
8123,oscurando,1,2,0,2
48687,administrador,0,0,2,2
8093,fallo,1,2,0,2
48691,zoek,0,0,2,2
45448,अर्न्तगत,0,0,2,2
13349,finales,0,0,2,2
45445,सेना,0,0,2,2
48701,சாரும்,0,0,2,2
13356,содержание,0,0,2,2
48702,bénéficie,0,0,2,2
8063,finanziamento,1,2,0,2
3547,gestisce,1,2,0,2
8061,variabile,1,2,0,2
13363,lykke,0,0,2,2
3546,sapeva,1,2,0,2
13365,интернета,0,0,2,2
13368,explicó,0,0,2,2
13369,प्रदर्शित,0,0,2,2
13370,உழைப்பது,0,0,2,2
13372,dark,0,0,2,2
8067,febbraio.,1,2,0,2
45449,സമവാക്യത്തിന്റെ,0,0,2,2
8089,fattibile,1,2,0,2
3550,mangio,1,2,0,2
8088,rimuovere,1,2,0,2
4528,raggiungimento,1,2,0,2
50918,rädsla,0,0,2,2
8080,funziona,1,2,0,2
8079,offrire,1,2,0,2
45460,فيمكنك,0,0,2,2
48696,lumières,0,0,2,2
45457,amostra,0,0,2,2
48697,reorganized,0,0,2,2
13335,ήθελε,0,0,2,2
13336,tummen,0,0,2,2
8073,contraddittorie,1,2,0,2
3551,scientifico,1,2,0,2
8069,viveva,1,2,0,2
13341,standing,0,0,2,2
13259,χρόνο,0,0,2,2
13256,ökar,0,0,2,2
13118,لكنها,0,0,2,2
8234,compresi,1,2,0,2
48616,daglig,0,0,2,2
8246,argon,2,1,1,2
3586,fossile,1,2,0,2
45581,uppfattning,0,0,2,2
8239,giornale,1,2,0,2
45579,felipe,0,0,2,2
13150,prenez,0,0,2,2
13159,climatic,0,0,2,2
8157,decrescente,1,2,0,2
48623,suma,0,0,2,2
8232,quantificare,1,2,0,2
8230,arrivato,1,2,0,2
8229,guardarla.,1,2,0,2
8228,incompatibili,1,2,0,2
13167,exactement,0,0,2,2
48626,संचालन,0,0,2,2
4488,rendere,1,2,0,2
45587,membro,0,0,2,2
48615,говорю,0,0,2,2
13138,отправить,0,0,2,2
13120,déconcertés,0,0,2,2
13122,المواقع,0,0,2,2
8269,preparati,1,2,0,2
8265,spaventoso,1,2,0,2
13123,proposed,0,0,2,2
8264,e-mail,1,2,0,2
48605,बह,0,0,2,2
13128,ದಾಟಿದೆ,0,0,2,2
8259,giardino,1,2,0,2
8258,no.,1,2,0,2
45595,miembros,0,0,2,2
48609,quatrième,0,0,2,2
48611,दिसम्बर,0,0,2,2
45592,पीढ़ी,0,0,2,2
45590,dá,0,0,2,2
3583,società.,1,2,0,2
8224,attraversò,1,2,0,2
4492,sovrappongono,1,2,0,2
13209,"
norueguês",0,0,2,2
48648,ಯೋಚಿಸುವುದಿಲ್ಲ,0,0,2,2
45531,மேற்கொள்ளும்,0,0,2,2
4502,amical,2,1,1,2
8186,parentesi,1,2,0,2
3579,guscio,1,2,0,2
48653,ഒരുമിച്ച്,0,0,2,2
8180,credibilità,1,2,0,2
13233,solução,0,0,2,2
13234,перцептрон,0,0,2,2
8178,dell'estensione,1,2,0,2
48656,bounds,0,0,2,2
45516,iniciados,0,0,2,2
45511,skämt,0,0,2,2
4506,governo,2,1,1,2
3573,bayesiano,1,2,0,2
3580,nell'ambiente,1,2,0,2
45537,övervaka,0,0,2,2
45558,diario,0,0,2,2
8198,atroce.,1,2,0,2
8220,starnutito,1,2,0,2
45555,عربة,0,0,2,2
45554,fångade,0,0,2,2
45553,moeite,0,0,2,2
4496,renderà,1,2,0,2
13190,പ്രൈമറി,0,0,2,2
48638,संस्था,0,0,2,2
48639,anomalies,0,0,2,2
13200,قلقة,0,0,2,2
13202,nommé,0,0,2,2
13203,complémentarité,0,0,2,2
45539,சனவரி,0,0,2,2
13205,gênante,0,0,2,2
3581,cipolla,1,2,0,2
48641,εμφάνιση,0,0,2,2
7615,wikiversità,1,2,0,2
13994,डूब,0,0,2,2
44379,religieuses,0,0,2,2
3298,correttamente,1,2,0,2
7043,svilupparsi,1,2,0,2
14704,πήγαν,0,0,2,2
44599,மற்றதைச்,0,0,2,2
7038,potessi,1,2,0,2
7037,addestrate,1,2,0,2
7032,grafica,1,2,0,2
7031,colpito,1,2,0,2
7029,un'occhiata,1,2,0,2
7019,guardarono,1,2,0,2
7027,dall'argomento,1,2,0,2
14719,sunmaktadır,0,0,2,2
7022,esistente,1,2,0,2
14720,ശല്യപ്പെടുത്തുന്നതിൽ,0,0,2,2
14721,article »,0,0,2,2
44591,நபரிடம்,0,0,2,2
3295,professori,1,2,0,2
44603,ಹೋದರು,0,0,2,2
14697,घटना,0,0,2,2
7049,incrociate.,1,2,0,2
44606,«la,0,0,2,2
7074,profonda,1,2,0,2
7073,dibattito,1,2,0,2
14679,gap,0,0,2,2
49198,gelen,0,0,2,2
7067,umile,1,2,0,2
14682,disciplinas,0,0,2,2
14683,tendem,0,0,2,2
14684,mens,0,0,2,2
44611,collect,0,0,2,2
4774,ero,1,2,0,2
7062,riconosciute,1,2,0,2
14689,πρίγκιπας,0,0,2,2
49205,जुड़ा,0,0,2,2
14691,குளிர்ச்சியாக,0,0,2,2
7053,controverso,1,2,0,2
44590,verdi,0,0,2,2
3294,clienti,1,2,0,2
4807,metadati,1,2,0,2
14777,lien,0,0,2,2
49253,научные,0,0,2,2
14768,technologies,0,0,2,2
14769,mitad,0,0,2,2
6967,cittadino,1,2,0,2
6966,multicellulari,1,2,0,2
6958,lingua.,1,2,0,2
14775,достаточно,0,0,2,2
6955,Sapevo,1,2,0,2
44587,producera,0,0,2,2
6949,altrettante,1,2,0,2
14780,സ്വാതന്ത്ര്യവും,0,0,2,2
49265,opdrachten,0,0,2,2
6944,arbitrale,1,2,0,2
6943,affonda,1,2,0,2
6942,responsabilità,1,2,0,2
6941,un'alternativa,1,2,0,2
44559,படிப்பினைகளை,0,0,2,2
6979,abusata,1,2,0,2
6982,tempestosa,1,2,0,2
6983,sviluppate.,1,2,0,2
7013,visibili,1,2,0,2
3291,l'intonazione.,1,2,0,2
3288,guardando,1,2,0,2
7008,copiare,1,2,0,2
44580,requested,0,0,2,2
44579,cidadão,0,0,2,2
7005,implicito,1,2,0,2
50318,ഉള്ളടക്കവും,0,0,2,2
6997,contrassegnato,1,2,0,2
14745,كنا,0,0,2,2
49234,തത്ത്വം,0,0,2,2
49236,hypotheses,0,0,2,2
49237,dazu,0,0,2,2
44567,recueil,0,0,2,2
49240,etou,0,0,2,2
49196,grausame,0,0,2,2
7079,mattina,1,2,0,2
14674,devletleri,0,0,2,2
44668,wikiznanie,0,0,2,2
7150,osservati.,1,2,0,2
14590,सम्पादक,0,0,2,2
3324,gravi,1,2,0,2
49162,l’opposition,0,0,2,2
7143,physis,2,1,1,2
51032,césar,0,0,2,2
51033,drygt,0,0,2,2
4754,knowledge-based,1,2,0,2
7080,economico,1,2,0,2
14601,ಪಡೆಯಲು,0,0,2,2
7138,conosciuto,1,2,0,2
3319,digitali,1,2,0,2
14606,wild,0,0,2,2
7137,rumelhart,2,1,1,2
44663,говорит,0,0,2,2
3318,science.,1,2,0,2
14588,береги,0,0,2,2
7155,avvera.,1,2,0,2
44675,reunião,0,0,2,2
14582,vivants,0,0,2,2
7172,aspettare.,1,2,0,2
44693,समानांतर,0,0,2,2
3332,ea,1,2,0,2
49150,النسخة,0,0,2,2
7167,Cina,1,2,0,2
7166,gennaio [aggiornamento],1,2,0,2
7165,significati,1,2,0,2
44686,посещаемости,0,0,2,2
14570,мелисса,0,0,2,2
7162,diretto,1,2,0,2
3328,tenuti,1,2,0,2
14576,desalienta,0,0,2,2
7160,l'esempio,1,2,0,2
14578,retomar,0,0,2,2
49153,spin,0,0,2,2
3317,suona,1,2,0,2
44657,oficialmente,0,0,2,2
49168,soluções,0,0,2,2
7103,backgammon,1,2,0,2
3309,mediawiki.,1,2,0,2
7099,pensi,1,2,0,2
14656,positives,0,0,2,2
44629,courses,0,0,2,2
44628,regularmente,0,0,2,2
14659,evenwichtig,0,0,2,2
3305,vulcanica,1,2,0,2
14663,बल्कि,0,0,2,2
49186,schule,0,0,2,2
49189,varmt,0,0,2,2
7090,luminosi,1,2,0,2
14665,دولار,0,0,2,2
44621,scoring,0,0,2,2
7086,lavorano,1,2,0,2
14672,neurones,0,0,2,2
49182,acercó,0,0,2,2
7104,precedente,1,2,0,2
49171,organizan,0,0,2,2
14645,cuyas,0,0,2,2
7125,sposa,1,2,0,2
7122,gustoso,1,2,0,2
14624,рендеринга,0,0,2,2
44647,க்கும்,0,0,2,2
14630,ಐಕಾನ್,0,0,2,2
49177,sophistiqué,0,0,2,2
4760,operato,1,2,0,2
14634,نظرًا,0,0,2,2
7112,settimana.,1,2,0,2
44641,fire,0,0,2,2
50331,domínio,0,0,2,2
14640,toplantı,0,0,2,2
44638,ρωτάει,0,0,2,2
14644,viewpoints,0,0,2,2
50329,natuurwetenschappelijk,0,0,2,2
6936,l'attuale,1,2,0,2
4808,certo.,1,2,0,2
3425,carta,2,1,1,2
6777,l'overfitting,1,2,0,2
6782,razionalità,1,2,0,2
44444,لتكون,0,0,2,2
44443,ക്ഷമ,0,0,2,2
14943,fichas,0,0,2,2
6781,contatto.,1,2,0,2
4838,mando,1,2,0,2
49360,rekommenderar,0,0,2,2
6771,reciprocamente.,1,2,0,2
14966,occident,0,0,2,2
14952,rédigés,0,0,2,2
6767,pensanti,1,2,0,2
51069,இன்னும்,0,0,2,2
44433,ಸಮಯ,0,0,2,2
6762,conoscerti.,1,2,0,2
6756,persona.,1,2,0,2
6755,algoritmi.,1,2,0,2
49356,«фонд,0,0,2,2
3248,sky,1,2,0,2
44452,വിക്കിപീഡിയയാണ്,0,0,2,2
3251,falsamente,2,1,1,2
3254,confermare,1,2,0,2
14911,встреча,0,0,2,2
6805,minacce,1,2,0,2
44462,dare,0,0,2,2
44461,волнуйтесь,0,0,2,2
6802,colloquio,1,2,0,2
6801,esempi.,1,2,0,2
14917,serviços,0,0,2,2
50294,скоро,0,0,2,2
6799,reale.,1,2,0,2
6793,alterate,1,2,0,2
6792,"commons,",1,2,0,2
51065,видеть,0,0,2,2
14926,pourraistu,0,0,2,2
6789,offrirti,1,2,0,2
44428,fikir,0,0,2,2
14972,νομίζετε,0,0,2,2
6931,w.,1,2,0,2
49392,levels,0,0,2,2
15012,registran,0,0,2,2
6724,trader,2,1,1,2
6723,l'interesse,1,2,0,2
49390,pedi,0,0,2,2
44395,acyclic,0,0,2,2
51076,kişi,0,0,2,2
4847,lettore,1,2,0,2
6714,interna.,1,2,0,2
44424,seeks,0,0,2,2
49398,tartışmalar,0,0,2,2
44388,राजकुमार,0,0,2,2
6707,formazione.,1,2,0,2
3229,l'inverno,1,2,0,2
6705,sera.,1,2,0,2
15042,aanbieden,0,0,2,2
44381,ಹೋಗುತ್ತಿದ್ದೇನೆ,0,0,2,2
15011,πάρτε,0,0,2,2
15008,правлю,0,0,2,2
15007,propiedad,0,0,2,2
15005,عنك,0,0,2,2
6750,l'equivalente,1,2,0,2
6743,georg,1,2,0,2
49377,മാർഗങ്ങൾ,0,0,2,2
44415,irme,0,0,2,2
14989,campagne,0,0,2,2
14993,فيما,0,0,2,2
6737,incorporava,2,1,1,2
6733,creativi,1,2,0,2
14999,viktigt,0,0,2,2
49384,compose,0,0,2,2
44404,électriques,0,0,2,2
3235,www,2,1,1,2
6729,esitante.,1,2,0,2
6727,ripresa,1,2,0,2
50287,अग्रसर,0,0,2,2
14908,beslissing,0,0,2,2
44465,يتلقى,0,0,2,2
6807,venir,2,1,1,2
14830,faut,0,0,2,2
14818,മുൻകൂട്ടി,0,0,2,2
49312,symbolistes,0,0,2,2
14824,kibar,0,0,2,2
44515,administrativas,0,0,2,2
4814,studiano,1,2,0,2
14828,ആദ്യത്തെ,0,0,2,2
4815,famose,1,2,0,2
4818,..,1,2,0,2
14904,அனைத்து,0,0,2,2
14832,कुंद,0,0,2,2
3272,trovato,1,2,0,2
49318,इंटरैक्टिव,0,0,2,2
4819,lucro.,1,2,0,2
14837,foco,0,0,2,2
4820,globali,1,2,0,2
44507,encyclopaedia,0,0,2,2
14817,assouline,0,0,2,2
6880,maometto,1,2,0,2
6881,temporale.,1,2,0,2
6887,adatte,1,2,0,2
4809,criticò,1,2,0,2
44537,запас,0,0,2,2
6922,dio.,1,2,0,2
6921,verificare,1,2,0,2
14796,nieuws,0,0,2,2
44534,cama,0,0,2,2
49288,രാവിലെ,0,0,2,2
6906,ripeterlo.,1,2,0,2
6905,sistematico,1,2,0,2
44530,encontrado,0,0,2,2
14807,manejo,0,0,2,2
49298,базой,0,0,2,2
51052,plante,0,0,2,2
50305,biçiminde,0,0,2,2
49303,reputation,0,0,2,2
3270,applicabili,1,2,0,2
51054,profond,0,0,2,2
14847,गुमनाम,0,0,2,2
14884,princip,0,0,2,2
6833,vignetta,1,2,0,2
6830,sogno.,1,2,0,2
6826,infelice.,1,2,0,2
49338,உம்,0,0,2,2
6821,apprezzo,1,2,0,2
44477,tillfälliga,0,0,2,2
51062,പറയാൻ‌,0,0,2,2
14895,conectado,0,0,2,2
44472,déterminant,0,0,2,2
50295,சொர்க்கம்,0,0,2,2
3256,scelta,1,2,0,2
6817,vocale.,1,2,0,2
44469,tornouse,0,0,2,2
44468,buch,0,0,2,2
6810,tratte,1,2,0,2
3260,associata,1,2,0,2
44483,πληροφορίες,0,0,2,2
14848,motsvarande,0,0,2,2
44484,ನುಡಿಗಟ್ಟುಗಳನ್ನು,0,0,2,2
14853,publiceerde,0,0,2,2
51055,protégées,0,0,2,2
14859,внимание,0,0,2,2
44496,ನಿಮಿಷಗಳಲ್ಲಿ,0,0,2,2
49323,awarded,0,0,2,2
44494,phones,0,0,2,2
14863,αόριστος,0,0,2,2
44492,saiu,0,0,2,2
14866,duim,0,0,2,2
14870,मुद्दों,0,0,2,2
14873,humilde,0,0,2,2
6851,ampia,1,2,0,2
44487,discuss,0,0,2,2
6843,gelato,1,2,0,2
49330,grecs,0,0,2,2
14543,juli,0,0,2,2
3336,azione,1,2,0,2
44704,балл,0,0,2,2
14178,onthoud,0,0,2,2
44946,ലേഖനത്തിൽ,0,0,2,2
44945,würdest,0,0,2,2
51000,transfer,0,0,2,2
14174,sattın,0,0,2,2
49002,प्रतिबंधित,0,0,2,2
7473,sicuro.,1,2,0,2
7472,community.,1,2,0,2
7470,mette,1,2,0,2
4675,prolog,2,1,1,2
7468,fondamentali,1,2,0,2
4670,espressa,1,2,0,2
7464,svilupparono,1,2,0,2
4674,"confronto,",1,2,0,2
7462,tutti.,1,2,0,2
49005,المرور,0,0,2,2
7457,sito.,1,2,0,2
44947,publicerades,0,0,2,2
48996,تصدر,0,0,2,2
44948,فما,0,0,2,2
44949,sharealike,0,0,2,2
44960,praised,0,0,2,2
7500,attento.,1,2,0,2
4664,riprendere,1,2,0,2
44957,presión,0,0,2,2
7495,corpora,2,1,1,2
14151,kopiera,0,0,2,2
50997,تمزح,0,0,2,2
14153,споров,0,0,2,2
14155,sistémicos,0,0,2,2
3398,informatici,1,2,0,2
7490,chiamante,1,2,0,2
44952,könnte,0,0,2,2
48990,назвать,0,0,2,2
7488,freddo,1,2,0,2
3397,acqueo,1,2,0,2
14185,remonter,0,0,2,2
14193,έκανα,0,0,2,2
14539,distintos,0,0,2,2
49025,உறுதிப்படுத்திக்,0,0,2,2
7428,interessanti.,1,2,0,2
44910,ಸಿಲ್ಲಿ,0,0,2,2
14230,മൂന്നാം,0,0,2,2
14231,thin,0,0,2,2
44906,académico,0,0,2,2
14237,livet,0,0,2,2
51004,أسفل,0,0,2,2
4678,ufficiali,1,2,0,2
7454,loro.,1,2,0,2
14244,huilt,0,0,2,2
44899,apoio,0,0,2,2
14248,उपस्थित,0,0,2,2
3384,smussato,1,2,0,2
7415,iniziare,1,2,0,2
7410,magico,1,2,0,2
14257,village,0,0,2,2
7430,dall'obiettivo,1,2,0,2
7431,significa.,1,2,0,2
51003,τούτου,0,0,2,2
14222,नौकरी,0,0,2,2
44933,således,0,0,2,2
7452,passarmi,1,2,0,2
44932,последние,0,0,2,2
49008,arkadaşınız,0,0,2,2
44924,தனிப்பட்ட,0,0,2,2
14205,participantes,0,0,2,2
14206,நேற்று,0,0,2,2
14207,auparavant,0,0,2,2
44923,അവനോട്,0,0,2,2
3392,terziaria.,1,2,0,2
44917,gebeuren,0,0,2,2
7442,federato,1,2,0,2
14215,accumulated,0,0,2,2
49017,antecipadamente,0,0,2,2
7433,testa.,1,2,0,2
48985,سأقدم,0,0,2,2
50385,العناء,0,0,2,2
14137,sahiptir,0,0,2,2
48957,podemos,0,0,2,2
45015,overlying,0,0,2,2
3416,tematiche,1,2,0,2
48952,molesto,0,0,2,2
7576,cunningham,2,1,1,2
45007,gotta,0,0,2,2
4647,avanzate,1,2,0,2
4648,superficiale,1,2,0,2
14063,apps,0,0,2,2
44966,identifié,0,0,2,2
7564,trasmesso,1,2,0,2
45005,aggregated,0,0,2,2
7563,Lawrence,1,2,0,2
45003,incluidos,0,0,2,2
48958,беспокойство,0,0,2,2
3413,plagio,1,2,0,2
7558,elogiato,1,2,0,2
45016,profundamente,0,0,2,2
7581,ozono,1,2,0,2
7582,parchi,1,2,0,2
14037,parodied,0,0,2,2
14001,perhaps,0,0,2,2
48930,fuera,0,0,2,2
7609,purtroppo,1,2,0,2
14008,animé,0,0,2,2
48932,omhoog,0,0,2,2
45042,diyebilirim,0,0,2,2
50393,dictionnaire,0,0,2,2
45040,ಸಭೆ,0,0,2,2
45034,problème,0,0,2,2
50987,talte,0,0,2,2
14028,ഉണ്ടെന്ന്,0,0,2,2
3418,povero,1,2,0,2
7591,"naturali,",1,2,0,2
48944,வெளியிட்டது,0,0,2,2
48946,descola,0,0,2,2
44996,सलाह,0,0,2,2
7557,equilibrato,1,2,0,2
7548,feeder,2,1,1,2
14113,sought,0,0,2,2
14117,muntra,0,0,2,2
7521,integrata,1,2,0,2
14121,تعتمد,0,0,2,2
14122,உடன்படவில்லை,0,0,2,2
7518,scambio,1,2,0,2
44970,antiquité,0,0,2,2
7512,bellissima,1,2,0,2
44969,schreef,0,0,2,2
3404,svolgono,1,2,0,2
14130,ಪ್ರದೇಶದ,0,0,2,2
48979,بأكملها,0,0,2,2
14131,ವಾಕ್ಯಗಳನ್ನು,0,0,2,2
4659,sorgenti,1,2,0,2
7508,fianco,1,2,0,2
48981,drainage,0,0,2,2
14116,défaut,0,0,2,2
44976,biografías,0,0,2,2
44994,потрясающую,0,0,2,2
14110,demandé,0,0,2,2
7547,maggiormente,1,2,0,2
14087,fonction,0,0,2,2
7544,matematici,1,2,0,2
7543,tanto.,1,2,0,2
48968,hago,0,0,2,2
7535,formali,1,2,0,2
44987,അല്ല,0,0,2,2
48971,incorporating,0,0,2,2
4654,variazione,1,2,0,2
48974,تسير,0,0,2,2
50992,earlier,0,0,2,2
14103,organisé,0,0,2,2
14105,ακούσετε,0,0,2,2
48976,colombiano,0,0,2,2
7523,referendum,2,1,1,2
44891,عدم,0,0,2,2
51008,arias,0,0,2,2
49034,διαγραφή,0,0,2,2
44758,വിജ്ഞാനകോശം,0,0,2,2
3348,terence,1,2,0,2
4717,spaventato,1,2,0,2
14452,suivants ,0,0,2,2
44762,größer,0,0,2,2
49117,wikier,0,0,2,2
44760,أمريكي,0,0,2,2
3347,stimato,1,2,0,2
14460,önemli,0,0,2,2
3355,entrato,1,2,0,2
44757,i̇letişim,0,0,2,2
44754,década,0,0,2,2
44753,spot,0,0,2,2
44749,physician,0,0,2,2
44745,d’algorithmes,0,0,2,2
14477,official,0,0,2,2
14478,قاموا,0,0,2,2
3350,vedo,1,2,0,2
44770,മറ്റും,0,0,2,2
44774,moderate,0,0,2,2
14435,conexión,0,0,2,2
7279,qualcos'altro,1,2,0,2
44789,hänvisar,0,0,2,2
3354,consolidata,1,2,0,2
44787,drüben,0,0,2,2
50355,उनमें,0,0,2,2
7276,fallimenti,1,2,0,2
49098,welkom,0,0,2,2
14423,falls,0,0,2,2
49099,ಇಷ್ಟಪಟ್ಟರೆ,0,0,2,2
14427,ರೀತಿಯಲ್ಲಿ,0,0,2,2
3353,sfruttando,1,2,0,2
44779,generellt,0,0,2,2
14431,человек,0,0,2,2
7265,magici,1,2,0,2
14434,tien,0,0,2,2
14480,montrent,0,0,2,2
7232,pesci,1,2,0,2
44743,primarily,0,0,2,2
7206,metodologia,2,1,1,2
4734,lenti,1,2,0,2
14522,ಅಭಿಪ್ರಾಯಗಳು,0,0,2,2
7202,scienze,1,2,0,2
7201,uccello,1,2,0,2
7196,corrette,1,2,0,2
3338,l'organizzazione,1,2,0,2
49139,يكفي,0,0,2,2
7192,discrepanza,1,2,0,2
4738,personale,1,2,0,2
7190,marvin,1,2,0,2
4739,fortunata,1,2,0,2
7186,facessi.,1,2,0,2
7184,segretamente,1,2,0,2
7183,sguardi,1,2,0,2
44707,நிலத்தின்,0,0,2,2
14512,கண்கள்,0,0,2,2
44724,funded,0,0,2,2
7228,vicina,1,2,0,2
44726,долларов,0,0,2,2
49123,переход,0,0,2,2
49125,summer,0,0,2,2
49126,सोच,0,0,2,2
14485,förvirrad,0,0,2,2
44739,falsch,0,0,2,2
7217,dimensione.,1,2,0,2
4731,anonimi,1,2,0,2
49129,represents,0,0,2,2
7213,sofisticato.,1,2,0,2
3343,vuole.,1,2,0,2
7212,chatbot,2,1,1,2
44730,दोहरा,0,0,2,2
14503,party,0,0,2,2
7209,"scuola,",1,2,0,2
14507,contratados,0,0,2,2
4712,ricompensa,1,2,0,2
14412,lachen,0,0,2,2
44886,ಬಳಸಲು,0,0,2,2
49052,रहती,0,0,2,2
3372,guardato,1,2,0,2
49046,बनाए,0,0,2,2
7379,venga,2,1,1,2
7378,machinery,2,1,1,2
7374,sviluppa,1,2,0,2
49050,partielle,0,0,2,2
7368,barzelletta,1,2,0,2
7366,servono,1,2,0,2
3356,gemelli,1,2,0,2
14321,précédentes,0,0,2,2
14323,conflicts,0,0,2,2
7361,l'autore,1,2,0,2
7359,riconosciuta,1,2,0,2
49054,estudios,0,0,2,2
49055,χαρούμενη,0,0,2,2
7356,pubbliche,1,2,0,2
14302,nybörjare,0,0,2,2
7381,logistica,1,2,0,2
49045,simples,0,0,2,2
3374,rallegrati,1,2,0,2
14270,मेटा,0,0,2,2
49039,gefallen,0,0,2,2
44885,секунду,0,0,2,2
49040,leis,0,0,2,2
14274,ഭാഗം,0,0,2,2
7395,all'articolo,1,2,0,2
7393,programmare,1,2,0,2
7390,newyorkese,1,2,0,2
14282,forstod,0,0,2,2
7388,umani.,1,2,0,2
44876,واليابانية,0,0,2,2
14287,प्रावधान,0,0,2,2
14291,expérimentale,0,0,2,2
7383,quest'ultimo,1,2,0,2
44868,opdagelser,0,0,2,2
7351,elegante,2,1,1,2
44833,assurer,0,0,2,2
14346,विनम्र,0,0,2,2
44803,exeditor,0,0,2,2
44801,συναντήσω,0,0,2,2
7299,cerimonia,1,2,0,2
4708,significative,1,2,0,2
14396,enquête,0,0,2,2
7296,viste,1,2,0,2
44795,അടിസ്ഥാനമാക്കി,0,0,2,2
7294,inviare,1,2,0,2
7293,sull'intelligenza,1,2,0,2
4709,inclusi,1,2,0,2
14401,ലേഖനത്തെ,0,0,2,2
3360,povera,1,2,0,2
44793,invloed,0,0,2,2
44792,correo,0,0,2,2
7287,salutare,1,2,0,2
14409,ogen,0,0,2,2
14388,итак,0,0,2,2
14386,necesariamente,0,0,2,2
14347,dibujo,0,0,2,2
44804,secondary,0,0,2,2
3370,onestamente,1,2,0,2
14350,bankkredit,0,0,2,2
3369,greco,1,2,0,2
7346,riflette,1,2,0,2
49065,वेबसाइटों,0,0,2,2
14360,английской,0,0,2,2
44817,മറ്റൊന്ന്,0,0,2,2
3365,abbracciare,1,2,0,2
7322,piacevole,1,2,0,2
50362,सदस्य,0,0,2,2
4702, ×,2,1,1,2
49076,पदार्थ,0,0,2,2
14377,posee,0,0,2,2
7312,l'ecologia,1,2,0,2
49084,denominators,0,0,2,2
45787,βόλτα,0,0,2,2
12848,desarrollado,0,0,2,2
12846,interrompre,0,0,2,2
11269,βικινέα,0,0,2,2
4142,commesso,1,2,0,2
50750,olduğuna,0,0,2,2
11262,الآراء,0,0,2,2
9813,हुआ।,0,0,2,2
46800,stackars,0,0,2,2
46799,tamaño,0,0,2,2
11268,diffuser,0,0,2,2
50752,formatação,0,0,2,2
46772,пример,0,0,2,2
11276,ചതുപ്പുനിലം,0,0,2,2
9801,göstermek,0,0,2,2
46784,सुभाषितों,0,0,2,2
11284,ചർച്ച,0,0,2,2
11290,στόλλμαν,0,0,2,2
9797,inse,0,0,2,2
9795,aurait,0,0,2,2
46804,indiquer,0,0,2,2
11254,convirtió,0,0,2,2
9817,доступна,0,0,2,2
3888,dima,2,1,1,2
9839,وتعديل,0,0,2,2
11221,पॉइंट,0,0,2,2
9838,yapamayacağınız,0,0,2,2
46828,எடுத்துக்காட்டுகள்,0,0,2,2
3892,affermare,1,2,0,2
3891,comunque.,1,2,0,2
11228,सम्बन्ध,0,0,2,2
3890,bell'uomo,1,2,0,2
46823,κάνοντας,0,0,2,2
4135,voleva,1,2,0,2
47700,xbox,0,0,2,2
9824,சோதனையில்,0,0,2,2
11242,separates,0,0,2,2
3889,aude,2,1,1,2
9820,மின்னஞ்சல்,0,0,2,2
11297,habla,0,0,2,2
47724,intelligenten,0,0,2,2
46717,போன்றவற்றைக்,0,0,2,2
47749,diskuteras,0,0,2,2
50757,satın,0,0,2,2
46737,rol,0,0,2,2
9745,wikcionário,0,0,2,2
3875,credere,1,2,0,2
50620,regardez,0,0,2,2
50619,propriedade,0,0,2,2
11350,literature,0,0,2,2
9741,cumulative,0,0,2,2
47732,പങ്കാളിത്തത്തിലൂടെ,0,0,2,2
11354,posted,0,0,2,2
47750,kingdoms,0,0,2,2
50760,فهذه,0,0,2,2
46729,verbal,0,0,2,2
9737,zitten,0,0,2,2
46722,ونظر,0,0,2,2
46720,ressource,0,0,2,2
46739,surrounding,0,0,2,2
46742,glaube,0,0,2,2
3878,esagerare.,1,2,0,2
9748,எங்கிருந்து,0,0,2,2
4151,locale.,1,2,0,2
9771,тот,0,0,2,2
9763,diskussionsforum,0,0,2,2
11314,تستحق,0,0,2,2
46757,verificabilidade,0,0,2,2
9762,prueba,0,0,2,2
9760,révision,0,0,2,2
11321,സ്ഥലത്താണ്,0,0,2,2
3881,esposizione,1,2,0,2
46746,التحدث,0,0,2,2
50621,وصف,0,0,2,2
11330,ceremony,0,0,2,2
9752,pr,0,0,2,2
46744,mısın,0,0,2,2
9751,sabah,0,0,2,2
11220,bestaan,0,0,2,2
11219,பெயர்,0,0,2,2
46829,звучит,0,0,2,2
11139,operated,0,0,2,2
11127,mannelijk,0,0,2,2
3917,lezione.,1,2,0,2
3916,pozze,1,2,0,2
50739,mooie,0,0,2,2
47650,انا,0,0,2,2
46878,gitmeye,0,0,2,2
9902,പരിശോധിച്ച്,0,0,2,2
47653,absolutamente,0,0,2,2
46830,использоваться,0,0,2,2
47654,konuşmak,0,0,2,2
11145,écrit,0,0,2,2
46872,കേരളത്തിനുള്ളിൽ,0,0,2,2
11149,montré,0,0,2,2
47658,معه,0,0,2,2
9892,stichting,0,0,2,2
11153,grundlegende,0,0,2,2
4123,salinità,1,2,0,2
9919,sustaining,0,0,2,2
9920,repita,0,0,2,2
46892,புகார்,0,0,2,2
11087,zorg,0,0,2,2
50736,volumétrie,0,0,2,2
9948,relativt,0,0,2,2
4117,pc,2,1,1,2
11094,ಸಮಯದವರೆಗೆ,0,0,2,2
9934,sorunlu,0,0,2,2
11095,langsom,0,0,2,2
11097,edges,0,0,2,2
3921,modificati,1,2,0,2
46905,outperformed,0,0,2,2
11101,forêt,0,0,2,2
4120,occasionalmente,1,2,0,2
46899,l’environnement,0,0,2,2
46898,inondé,0,0,2,2
11115,classiques,0,0,2,2
9891,выпущен,0,0,2,2
3909,interessati,1,2,0,2
3908,patch,2,1,1,2
11194,بعيدًا,0,0,2,2
11196,rationality,0,0,2,2
50748,tiende,0,0,2,2
47682,directa,0,0,2,2
9859,ിത്തമാണ്,0,0,2,2
47683,огромных,0,0,2,2
11208,tratan,0,0,2,2
11209,использовалась,0,0,2,2
9856,mantêm,0,0,2,2
4132,sottolineare,1,2,0,2
47688,probably,0,0,2,2
9848,словарный,0,0,2,2
47690,ಮಗಳ,0,0,2,2
47691,comportamientos,0,0,2,2
11213,экспертных,0,0,2,2
9843,audelà,0,0,2,2
9864,mudar,0,0,2,2
9865,विशेषज्ञों,0,0,2,2
4127,caldo,1,2,0,2
50633,पेश,0,0,2,2
47662,schelen,0,0,2,2
11160,vestir,0,0,2,2
3906,nemmeno,1,2,0,2
50743,cambrian,0,0,2,2
47667,ऊपर,0,0,2,2
46856,மிகச்சிறந்த,0,0,2,2
4129,profondamente,1,2,0,2
11175,സുന്ദരനുമാണ്,0,0,2,2
9875,kollektivt,0,0,2,2
11181,supongo,0,0,2,2
3901,recensioni,1,2,0,2
11187,godkännande,0,0,2,2
47676,άκουγα,0,0,2,2
11189,sonunda,0,0,2,2
11191,intrude,0,0,2,2
11369,modifying,0,0,2,2
11371,interdire,0,0,2,2
48484,कॉमंस,0,0,2,2
9535,medidas,0,0,2,2
11582,εσύ,0,0,2,2
9542,dansk,0,0,2,2
11583,மறக்காதீர்கள்,0,0,2,2
46577,आहार,0,0,2,2
11586,ಸುಲಭವಾದ,0,0,2,2
9538,отправлю,0,0,2,2
9536,ನಾರ್ಸಿಸ್,0,0,2,2
9533,പദങ്ങളുടെ,0,0,2,2
9520,confiture,0,0,2,2
11591,bittet,0,0,2,2
11593,enda,0,0,2,2
9530,महीनों,0,0,2,2
11595,सीजेनथेलर,0,0,2,2
47891,orada,0,0,2,2
9524,världens,0,0,2,2
47892,sens ,0,0,2,2
46580,kommet,0,0,2,2
46581,अंतर,0,0,2,2
46583,विशिष्ट,0,0,2,2
46584,أشتري,0,0,2,2
46596,recebe,0,0,2,2
47870,sorduğunda,0,0,2,2
9558,«когда,0,0,2,2
9557,obtive,0,0,2,2
9556,intitulé,0,0,2,2
46592,federated,0,0,2,2
11556,reforço,0,0,2,2
9555,condutas,0,0,2,2
9551,cópia,0,0,2,2
11561,poli,0,0,2,2
4195,conteneva,1,2,0,2
9549,ടെറൻസ്,0,0,2,2
11564,anímate,0,0,2,2
11571,rapporte,0,0,2,2
46586,responsabilidade,0,0,2,2
46567,uanset,0,0,2,2
11603,naturligt,0,0,2,2
47757,बोलना,0,0,2,2
46540,medo,0,0,2,2
11636,என்னவென்று,0,0,2,2
9470,വ്യക്തിയോട്,0,0,2,2
9469,largescale,0,0,2,2
11645,ikiniz,0,0,2,2
46542,stom,0,0,2,2
3826,io',1,2,0,2
11649,rift,0,0,2,2
11652,birleşik,0,0,2,2
9516,leende,0,0,2,2
11654,angst,0,0,2,2
11655,disent,0,0,2,2
50597,berbat,0,0,2,2
47928,arise,0,0,2,2
47929,udgave,0,0,2,2
9461,تاريخ,0,0,2,2
4207,sofisticato,1,2,0,2
9479,systematische,0,0,2,2
11632,tomar,0,0,2,2
47918,ಉಚ್ಚಾರಣೆಯನ್ನು,0,0,2,2
9487,تسمع,0,0,2,2
11604,хорош,0,0,2,2
11606,doute,0,0,2,2
46563,buenas,0,0,2,2
47905,agradecendo,0,0,2,2
46556,«por,0,0,2,2
9501,χρυσή,0,0,2,2
46555,yeux,0,0,2,2
9499,savaşlarına,0,0,2,2
11623,മൂന്നു,0,0,2,2
9498,результате,0,0,2,2
4200,inizia,1,2,0,2
11627,достигла,0,0,2,2
47910,ಬಳಸಬಾರದು,0,0,2,2
4201,editor.,1,2,0,2
46551,думал,0,0,2,2
47869,heter,0,0,2,2
47863,edersiniz,0,0,2,2
11545,olduğumuzu,0,0,2,2
46678,gyldne,0,0,2,2
9700,sufficiently,0,0,2,2
3859,racconta,1,2,0,2
11422,inclusão,0,0,2,2
3858,cohen,2,1,1,2
11424,रखना।,0,0,2,2
47786,duración,0,0,2,2
46680,veía,0,0,2,2
46677,കാഴ്ചപ്പാടുകൾ,0,0,2,2
46602,mathrm,0,0,2,2
9682,टु,0,0,2,2
4167,congratularsi,1,2,0,2
11443,morning,0,0,2,2
47792,exchange,0,0,2,2
4169,sequenza,1,2,0,2
4170,salati,1,2,0,2
46663,الجمعة,0,0,2,2
11416,ಸಂಧಿಸಲು,0,0,2,2
9702,verrast,0,0,2,2
11412,soldier,0,0,2,2
9707,común,0,0,2,2
11381,öppna,0,0,2,2
11382,producir,0,0,2,2
46707,remain,0,0,2,2
11386,क्षमता,0,0,2,2
50616,αγόρι,0,0,2,2
47762,πάτε,0,0,2,2
46703,mainly,0,0,2,2
46702,especialistas,0,0,2,2
9719,थका,0,0,2,2
11395,krävs,0,0,2,2
47766,वर्ग,0,0,2,2
9715,magnífico,0,0,2,2
3866,diamanti,1,2,0,2
46692,profound,0,0,2,2
50766,मतदान,0,0,2,2
3851,affatto,1,2,0,2
11462,يتضمن,0,0,2,2
50774,мультимедийных,0,0,2,2
9607,सब्सक्राइब,0,0,2,2
9604,மொழிகளிலும்,0,0,2,2
11513,मतभेद,0,0,2,2
11514,wikipédia ,0,0,2,2
47843,hazırlandım,0,0,2,2
46621,ಆಹಾರವನ್ನು,0,0,2,2
47846,schémas,0,0,2,2
9591,جميلة,0,0,2,2
47852,ಚಿಕಿತ್ಸೆ,0,0,2,2
9584,касается,0,0,2,2
11527,الروسية,0,0,2,2
11528,रखना,0,0,2,2
4186,ragionamenti,1,2,0,2
11533,móvil,0,0,2,2
4187,straordinario,1,2,0,2
4188,entrata,1,2,0,2
11511,härligt,0,0,2,2
9608,الجمال,0,0,2,2
11466,extrameile,0,0,2,2
11505,ρωτάτε,0,0,2,2
11474,högskola,0,0,2,2
3843,wilson,2,1,1,2
11483,أحد,0,0,2,2
50608,contrário,0,0,2,2
4177,spinge,1,2,0,2
47821,कराया,0,0,2,2
4178,sbagli.,1,2,0,2
11487,duiden,0,0,2,2
50776,اسمها,0,0,2,2
9633,tonight,0,0,2,2
47828,हास्य,0,0,2,2
9628,achieving,0,0,2,2
11496,عشرة,0,0,2,2
47834,ogg,0,0,2,2
9614,الموضوعات,0,0,2,2
9949,avais,0,0,2,2
11084,ഉപയോഗിക്കാൻ‌,0,0,2,2
50642,l’accès,0,0,2,2
47434,gerekmez,0,0,2,2
47425,authoritative,0,0,2,2
10643,காலமாக,0,0,2,2
47192,irmãos,0,0,2,2
10646,fikrim,0,0,2,2
10284,lending,0,0,2,2
47430,carácter,0,0,2,2
50672,remover,0,0,2,2
10662,manipular,0,0,2,2
10675,honneur,0,0,2,2
10663,improving,0,0,2,2
47437,φύγω,0,0,2,2
47181,terceira,0,0,2,2
47441,dein,0,0,2,2
10666,incorporam,0,0,2,2
47179,nederland,0,0,2,2
3992,organizzate,1,2,0,2
47422,trevlig,0,0,2,2
10641,heavens,0,0,2,2
10640,sit,0,0,2,2
47196,മലയാളമടക്കം,0,0,2,2
10612,öppen,0,0,2,2
10320,ratings,0,0,2,2
10319,καλέσετε,0,0,2,2
10619,ಸಣ್ಣ,0,0,2,2
10621,strict,0,0,2,2
10315,errado,0,0,2,2
10623,croisés,0,0,2,2
10314,إس,0,0,2,2
10312,físico,0,0,2,2
50676,physique,0,0,2,2
4000,blackout,2,1,1,2
10302,بحثًا,0,0,2,2
47197,mittagessen,0,0,2,2
10636,independently,0,0,2,2
47416,eight,0,0,2,2
10673,ήξερα,0,0,2,2
3990,analoghi,1,2,0,2
11082,tel,0,0,2,2
47137,vídeos,0,0,2,2
47144,مكبر,0,0,2,2
10221,качества,0,0,2,2
10220,typer,0,0,2,2
3978,osservabile.,1,2,0,2
10219,açıdır,0,0,2,2
47138,ಕೈ,0,0,2,2
10218,ലാഭേച്ഛയില്ലാതെ,0,0,2,2
47471,alınır,0,0,2,2
10256,hosted,0,0,2,2
4068,ridere,1,2,0,2
47131,plágio,0,0,2,2
4071,esclusivamente,1,2,0,2
47126,trevligt,0,0,2,2
10203,أخذ,0,0,2,2
47480,الإصدارات,0,0,2,2
47122,remedies,0,0,2,2
47145,dagen,0,0,2,2
10224,birkaç,0,0,2,2
10724,கட்டுரைகளும்,0,0,2,2
10723,എന്തുകൊണ്ടാണ്,0,0,2,2
50704,forslag,0,0,2,2
47173,fer,0,0,2,2
3985,l'origine,1,2,0,2
10252,лицензию,0,0,2,2
10691,talep,0,0,2,2
10250,mænd,0,0,2,2
4059,pattern.,1,2,0,2
47452,forfærdelig,0,0,2,2
10244,astúrias,0,0,2,2
10241,numerators,0,0,2,2
4065,improvvisamente,1,2,0,2
10710,ಖಚಿತಪಡಿಸಿಕೊಳ್ಳಿ,0,0,2,2
47153,मोटापे,0,0,2,2
10716,மைல்,0,0,2,2
10718,computadora,0,0,2,2
10322,النطق,0,0,2,2
10323,recharge,0,0,2,2
10610,åsikt,0,0,2,2
47352,kolay,0,0,2,2
10415,llamados,0,0,2,2
10493,stegbauer,0,0,2,2
4031,fantasiose,1,2,0,2
10495,शब्दावली,0,0,2,2
10498,വിവാഹത്തിൽ,0,0,2,2
47342,معرفة,0,0,2,2
47348,digg,0,0,2,2
10395,« décisions »,0,0,2,2
47403,നിരവധി,0,0,2,2
47267,മൂന്ന്,0,0,2,2
50685,komplicerad,0,0,2,2
10519,inferencias,0,0,2,2
47266,caractères,0,0,2,2
47359,"
árabe",0,0,2,2
10384,नार्सीसस,0,0,2,2
4034,creativa,1,2,0,2
47284,बल,0,0,2,2
4029,diciamo,1,2,0,2
47287,தவறான,0,0,2,2
10487,financiada,0,0,2,2
47312,ಖಚಿತವಾಗಿ,0,0,2,2
4025,epic,2,1,1,2
10448,precisam,0,0,2,2
10441,основана,0,0,2,2
47321,entière,0,0,2,2
47303,söt,0,0,2,2
10430,’de,0,0,2,2
4028,tony,2,1,1,2
10472,noms,0,0,2,2
10426,biblioteket,0,0,2,2
10473,precisos,0,0,2,2
47295,മനോഹരമായി,0,0,2,2
10478,founder,0,0,2,2
10481,miles,0,0,2,2
10482,konfliktlösning,0,0,2,2
10381,antisocial,0,0,2,2
4038,interwiki,2,1,1,2
10529,दूसरा,0,0,2,2
10346,raízes,0,0,2,2
4005,rousseau,2,1,1,2
10583,الإبداعي,0,0,2,2
47391,groundwater,0,0,2,2
47392,शिक्षाविद,0,0,2,2
47393,winkels,0,0,2,2
10333,aprenda,0,0,2,2
47396,இயங்கி,0,0,2,2
10331,सकते।,0,0,2,2
47221,കരുതി,0,0,2,2
47216,प्रकट,0,0,2,2
4003,totalmente.,1,2,0,2
10601,sensibilité,0,0,2,2
10603,വലിക്കുക,0,0,2,2
10605,constar,0,0,2,2
47213,iria,0,0,2,2
4048,l'esecuzione,1,2,0,2
10347,لاحقًا,0,0,2,2
47259,historiadores,0,0,2,2
10574,poussé,0,0,2,2
10531,licensierad,0,0,2,2
10377,narcissemor,0,0,2,2
47258,उच्च,0,0,2,2
10373,άγγελο,0,0,2,2
10538,διαγραφών,0,0,2,2
10364,ചെയ്ത്,0,0,2,2
10542,ലാറി,0,0,2,2
50681,øg,0,0,2,2
4012,aiutato,1,2,0,2
10552,müssen,0,0,2,2
47378,تلفظ,0,0,2,2
4011,criterio,2,1,1,2
10358,இருவரும்,0,0,2,2
47246,typical,0,0,2,2
10561,sociales,0,0,2,2
10199,gestion,0,0,2,2
3974,cuocere,1,2,0,2
3970,vedendo,1,2,0,2
10023,amendement,0,0,2,2
46982,redigere,0,0,2,2
47573,cebuanospråkiga,0,0,2,2
10033,கொண்டிருக்கிறீர்கள்,0,0,2,2
46973,വിലമതിക്കുന്നില്ല,0,0,2,2
47580,erfarne,0,0,2,2
46969,تعرض,0,0,2,2
46968,entretient,0,0,2,2
47583,espère,0,0,2,2
10919,marquée,0,0,2,2
46964,egoistisk,0,0,2,2
47585,ώρα,0,0,2,2
10995,полной,0,0,2,2
10996,troede,0,0,2,2
46961,switch,0,0,2,2
4108,efficienti,1,2,0,2
47592,معًا,0,0,2,2
10967,reposant,0,0,2,2
10041,répandue,0,0,2,2
47571,أولئك,0,0,2,2
46984,сначала,0,0,2,2
47013,södertörns,0,0,2,2
10068,cognitives,0,0,2,2
10926,battlestar,0,0,2,2
3946,buono.,1,2,0,2
47005,λιγότερο,0,0,2,2
10935,pourrais,0,0,2,2
47561,ഇങ്ങനെ,0,0,2,2
46995,veja,0,0,2,2
10048,verbazingwekkende,0,0,2,2
46993,подождите,0,0,2,2
10954,ആദ്യം,0,0,2,2
10955,geléia,0,0,2,2
50723,увидите,0,0,2,2
10961,helhet,0,0,2,2
47570,terminar,0,0,2,2
11002,λόγους,0,0,2,2
10007,british,0,0,2,2
10006,python,0,0,2,2
11052,aucun,0,0,2,2
46928,iniciativa,0,0,2,2
11055,ativas,0,0,2,2
47610,chateada,0,0,2,2
3932,codice,1,2,0,2
46926,saltwater,0,0,2,2
9976,размещения,0,0,2,2
47613,souligner,0,0,2,2
4114,pena.,1,2,0,2
9968,centuries,0,0,2,2
9967,concordo,0,0,2,2
11072,açısını,0,0,2,2
9962,നിർമ്മിച്ച,0,0,2,2
9955,humanity,0,0,2,2
47625,βιβλιοθήκη,0,0,2,2
16743,curtos,0,0,2,2
46929,بلغة,0,0,2,2
11050,abiotic,0,0,2,2
10005,शुक्र,0,0,2,2
50728,വിജ്ഞാനകോശമാണ്,0,0,2,2
10004,copier,0,0,2,2
11018,börja,0,0,2,2
11020,بأنها,0,0,2,2
9998,disponen,0,0,2,2
46944,protéger,0,0,2,2
11028,contrat,0,0,2,2
47601,preparado,0,0,2,2
46936,vrijwilligers,0,0,2,2
9991,отметку,0,0,2,2
46935,நனவாகும்,0,0,2,2
9988,exemple ,0,0,2,2
50727,പരസ്പരം,0,0,2,2
9983,gegevens,0,0,2,2
4111,chiedo,1,2,0,2
11044,ouvi,0,0,2,2
10073,tropical,0,0,2,2
10074,slet,0,0,2,2
10768,ordning,0,0,2,2
47081,sampled,0,0,2,2
47499,paris,0,0,2,2
10164,town,0,0,2,2
10812,عبارات,0,0,2,2
10814,épico,0,0,2,2
10156,términos,0,0,2,2
47083,rise,0,0,2,2
10820,eventos,0,0,2,2
4084,voti,1,2,0,2
10078,digam,0,0,2,2
3961,avverando,1,2,0,2
47077,дома,0,0,2,2
10836,skruede,0,0,2,2
4085,riprendi,1,2,0,2
47510,araba,0,0,2,2
47512,correctly,0,0,2,2
10142,artiklerne,0,0,2,2
47091,technical,0,0,2,2
10170,valid,0,0,2,2
10172,செல்வது,0,0,2,2
47493,تلتقط,0,0,2,2
10771,மக்கள்,0,0,2,2
47485,trabaje,0,0,2,2
47110,أطول,0,0,2,2
10779,الوصول,0,0,2,2
10190,volunteers,0,0,2,2
47101,tijdje,0,0,2,2
10793,listas,0,0,2,2
4076, miliardi,1,2,0,2
50659,ஆற்றல்,0,0,2,2
10799,незамедлительно,0,0,2,2
47096,bryr,0,0,2,2
10801,குறித்து,0,0,2,2
47095,cellesci,0,0,2,2
47094,roots,0,0,2,2
10180,सुधारने,0,0,2,2
47069,حادة,0,0,2,2
10137,kring,0,0,2,2
47066,принятия,0,0,2,2
10116,αρχείο,0,0,2,2
47533,multimídia,0,0,2,2
47036,nereden,0,0,2,2
47534,verdens,0,0,2,2
10106,tenzij,0,0,2,2
47535,icône,0,0,2,2
47033,تتم,0,0,2,2
47536,baixo,0,0,2,2
10898,diseñador,0,0,2,2
10098,weile,0,0,2,2
10092,stum,0,0,2,2
47027,matters,0,0,2,2
10090,återställa,0,0,2,2
10089,الشكوى,0,0,2,2
47545,കരുതുക,0,0,2,2
10911,проекту,0,0,2,2
4087,waffling,2,1,1,2
10117,birinden,0,0,2,2
3959,averlo,1,2,0,2
47523,أما,0,0,2,2
10136,ಬೇಕಾದುದನ್ನು,0,0,2,2
47514,சமீபத்திய,0,0,2,2
47515,deja,0,0,2,2
47063,parks,0,0,2,2
47517,réseau,0,0,2,2
47518,vores,0,0,2,2
50718,تنزعج,0,0,2,2
10861,കൊള്ളാം,0,0,2,2
10862,ಹೆಚ್ಚಿನ,0,0,2,2
47520,belirtilmeli,0,0,2,2
3952,erik,2,1,1,2
47048,saltet,0,0,2,2
47522,nações,0,0,2,2
47047,അക്യൂട്ട്,0,0,2,2
10875,volledig,0,0,2,2
46530,καθυστέρησης,0,0,2,2
9452,ഇതിലൂടെ,0,0,2,2
9449,ações,0,0,2,2
46012,വിളിക്കുന്നത്,0,0,2,2
46018,juni,0,0,2,2
48319,estés,0,0,2,2
46015,blivit,0,0,2,2
4326,backpropagation,2,1,1,2
46014,выделились,0,0,2,2
46013,ഓർമ്മിക്കുക,0,0,2,2
48323,सो,0,0,2,2
12487,века,0,0,2,2
4332,dell'acqua,1,2,0,2
48327,للشك,0,0,2,2
12497,विस्तृत,0,0,2,2
12498,сетевой,0,0,2,2
46004,jornal,0,0,2,2
12502,страница,0,0,2,2
8811,tpr,2,1,1,2
46001,tendemos,0,0,2,2
8842,pubblicare,1,2,0,2
12475,oft,0,0,2,2
8843,catturare,1,2,0,2
8844,personali,1,2,0,2
12442,curso,0,0,2,2
8863,prontamente,1,2,0,2
46036,субботу,0,0,2,2
12447,शोधकर्ताओं,0,0,2,2
8862,minori,1,2,0,2
12450,corporativa,0,0,2,2
8858,comprare,1,2,0,2
12458,التحقق,0,0,2,2
8851,creep,2,1,1,2
12460,progression,0,0,2,2
8849,portoghese,1,2,0,2
12467,первые,0,0,2,2
8845,licenza.,1,2,0,2
50851,صلاحيات,0,0,2,2
12471,origen,0,0,2,2
12510,overgenomen,0,0,2,2
45995,प्राथमिक,0,0,2,2
46132,परिष्कृत,0,0,2,2
4339,scrive,1,2,0,2
8781,pone,1,2,0,2
12541,partout,0,0,2,2
12542,perception,0,0,2,2
12543,പുസ്തകം,0,0,2,2
8779,estremi,1,2,0,2
12548,descreveu,0,0,2,2
4338,usanze,1,2,0,2
12553,recouvre,0,0,2,2
50854,இருந்தீர்கள்,0,0,2,2
8769,immaginassero,1,2,0,2
12556,بشخص,0,0,2,2
12557,lancement,0,0,2,2
8767,sottodominio,1,2,0,2
12559,animese,0,0,2,2
12561,ˌwɪkɪˈpiːdiə,0,0,2,2
48356,vectores,0,0,2,2
48347,tålmodigt,0,0,2,2
8783,lacus,2,1,1,2
8784,assegnato,1,2,0,2
8787,veramente,1,2,0,2
12515,hacen,0,0,2,2
12518,littéralement,0,0,2,2
8805,«non,1,2,0,2
4333,avvenimenti,1,2,0,2
48338,leads,0,0,2,2
48343,intrusion,0,0,2,2
12524,aktif,0,0,2,2
4336,conservazione,1,2,0,2
8793,critico,1,2,0,2
8792,volessi,1,2,0,2
12533,εκτός,0,0,2,2
12534,ವಿವರಿಸುತ್ತದೆ,0,0,2,2
8790,comunitario,2,1,1,2
8789,mandarti,1,2,0,2
3681,scoprono,1,2,0,2
8864,cresceva,1,2,0,2
46040,ಹುಡುಗರಿಗೆ,0,0,2,2
48304,വിജ്ഞാനകോശത്തിന്റെ,0,0,2,2
48265,formuleringen,0,0,2,2
48260,internets,0,0,2,2
8949,certe,1,2,0,2
12334,техас,0,0,2,2
8948,rapporti,1,2,0,2
50550,tekniskt,0,0,2,2
48263,organized,0,0,2,2
8942,incontrato,1,2,0,2
46100,edited,0,0,2,2
12437,жизнь,0,0,2,2
48268,differentiated,0,0,2,2
8930,l'icona,1,2,0,2
12348,സന്ദേശം,0,0,2,2
46094,hoog,0,0,2,2
12350,irrelevant,0,0,2,2
46091,λεπτά,0,0,2,2
8920,contrasto,1,2,0,2
46107,origins,0,0,2,2
12326,character,0,0,2,2
3716,esame,1,2,0,2
46113,കാഴ്ചപ്പാടുകളും,0,0,2,2
46130,verspreiden,0,0,2,2
12300,abraham,0,0,2,2
48247,prepared,0,0,2,2
46129,computadores,0,0,2,2
12304,användarna,0,0,2,2
46127,अर्थशास्त्र,0,0,2,2
3718,pianeti,1,2,0,2
46125,vidt,0,0,2,2
8967,importasse.,1,2,0,2
8965,piange,1,2,0,2
4299,poteri,1,2,0,2
12312,mobiele,0,0,2,2
48253,ವಿವರಿಸುತ್ತಾರೆ,0,0,2,2
4301,covid,2,1,1,2
46116,devrais,0,0,2,2
8919,potevano,1,2,0,2
12361,ലേഖനങ്ങളുള്ള,0,0,2,2
12362,வணிக,0,0,2,2
12405,nela,0,0,2,2
8885,useresti,1,2,0,2
8884,minori.,1,2,0,2
46057,ಕ್ಲಿಕ್,0,0,2,2
8882,istanza,1,2,0,2
4320,includevano,1,2,0,2
3696,wikizionario,1,2,0,2
46052,escola,0,0,2,2
4321,svolge,1,2,0,2
8874,miglia,1,2,0,2
8873,informale,1,2,0,2
3694,consentono,1,2,0,2
3693,patrol,2,1,1,2
46049,rostros,0,0,2,2
8871,ipotesi.,1,2,0,2
8869,gpus,2,1,1,2
48293,നാല്,0,0,2,2
46063,interrelated,0,0,2,2
3711,esegue,1,2,0,2
4314,dormiva,1,2,0,2
8915,notabilità,1,2,0,2
12365,kommentera,0,0,2,2
46078,accommodate,0,0,2,2
8910,riferirsi,1,2,0,2
12376,ब्रांड,0,0,2,2
8908,suddivide,1,2,0,2
12380,லத்தீன்,0,0,2,2
12381,मौजूद,0,0,2,2
12383,relevancia,0,0,2,2
8899,frank,2,1,1,2
48287,pseudonyme,0,0,2,2
3706,fenomeni,1,2,0,2
12393,सवारी,0,0,2,2
12396,presentatie,0,0,2,2
3704,moglie,1,2,0,2
8764,diceva,1,2,0,2
8763,etiche.,1,2,0,2
50859,διαφωνώ,0,0,2,2
12742,ഇന്ത്യൻഭാഷകളിലും,0,0,2,2
8610,negativi.,1,2,0,2
45854,editoriales,0,0,2,2
8609,wikificazione,1,2,0,2
4388,ammirati,1,2,0,2
3650,restante,2,1,1,2
8607,diritti,1,2,0,2
48430,steps,0,0,2,2
4390,passate,1,2,0,2
45882,venha,0,0,2,2
45849,κόσμο,0,0,2,2
12746,أحب,0,0,2,2
3649,volere,1,2,0,2
48435,samareño,0,0,2,2
50510,добровольцев,0,0,2,2
48438,stumpfe,0,0,2,2
8591,contestati,1,2,0,2
12731,cuatro,0,0,2,2
8611,bambola,1,2,0,2
4384,incontri,1,2,0,2
4379,lingue.,1,2,0,2
12702,மாத்திரமே,0,0,2,2
8637,coronation,2,1,1,2
12704,remplacement,0,0,2,2
45873,πύλη,0,0,2,2
12709,وبعض,0,0,2,2
45870,mathematics,0,0,2,2
12711,förutsäga,0,0,2,2
8634,bicchiere,1,2,0,2
8633,visione.,1,2,0,2
50870,അവസ്ഥയിൽ,0,0,2,2
12715,vieram,0,0,2,2
48419,सोचा,0,0,2,2
8631,norwich,2,1,1,2
48422,şanslısın,0,0,2,2
8623,ammetti,1,2,0,2
12753,ansiklopedi,0,0,2,2
3648,primati,1,2,0,2
50507,collaboratif,0,0,2,2
12810,publicly,0,0,2,2
8551,maniere,1,2,0,2
12813,дня,0,0,2,2
48461,வந்தீர்கள்,0,0,2,2
12817,виду,0,0,2,2
8543,vorrebbe,1,2,0,2
8539,dall'enciclopedia,1,2,0,2
8536,hart,2,1,1,2
12827,movimiento,0,0,2,2
48469,ορισμένους,0,0,2,2
45799,bron,0,0,2,2
12829,senha,0,0,2,2
12830,المكان,0,0,2,2
45792,arrasa,0,0,2,2
48480,व्यवस्थित,0,0,2,2
4418,cattura,1,2,0,2
45811,رأي,0,0,2,2
45813,tengan,0,0,2,2
4399,camera,1,2,0,2
12806,pools,0,0,2,2
45834,visages,0,0,2,2
12774,sulten,0,0,2,2
8577,azzam,2,1,1,2
12777,ಸಂತೋಷದ,0,0,2,2
50505,randevum,0,0,2,2
8570,Titano,1,2,0,2
12786,l’espèce,0,0,2,2
12787,raisonné,0,0,2,2
45826,الموسوعات,0,0,2,2
12792,sprekend,0,0,2,2
45820,representações,0,0,2,2
8561,apertura,2,1,1,2
3646,impedito,1,2,0,2
8560,contribuiscono,1,2,0,2
12804,warring,0,0,2,2
8650,philip,2,1,1,2
12690,meat,0,0,2,2
45965,robe,0,0,2,2
4351,domani.,1,2,0,2
12605,groeide,0,0,2,2
48372,sent,0,0,2,2
12606,പാഠങ്ങൾ,0,0,2,2
48373,verification,0,0,2,2
45941,d’aa,0,0,2,2
8728,phyla,2,1,1,2
8725,vulva,2,1,1,2
8719,c'erano,1,2,0,2
12689,الأمثلة,0,0,2,2
48378,пройти,0,0,2,2
12620,ആവശ്യമായ,0,0,2,2
8714,trasformano,1,2,0,2
4356,scena,1,2,0,2
8710,prolungate,1,2,0,2
8707,"narcisa,",1,2,0,2
45924,ശല്യപ്പെടുത്തുന്ന,0,0,2,2
45942,« pour,0,0,2,2
4347,casella,1,2,0,2
8744,"organismi,",1,2,0,2
8750,sensibili,1,2,0,2
48357,fandt,0,0,2,2
8761,pezzo,1,2,0,2
45958,enoje,0,0,2,2
12575,universidades,0,0,2,2
45957,alter,0,0,2,2
48359,ತಮಾಷೆ,0,0,2,2
12582,leva,0,0,2,2
12584,enciclopédico,0,0,2,2
48362,تحب,0,0,2,2
12585,independence,0,0,2,2
8751,prestarmi,1,2,0,2
45949,importaría,0,0,2,2
45948,resumen,0,0,2,2
12595,συμβαίνουν,0,0,2,2
12596,ಚಿಂತೆ,0,0,2,2
45922,kesinlikle,0,0,2,2
8703,amministratore,1,2,0,2
45918,geweigerd,0,0,2,2
48395,αστειεύεσαι,0,0,2,2
45897,отметил,0,0,2,2
50522,civilization,0,0,2,2
48401,teksten,0,0,2,2
50521,sitzen,0,0,2,2
8665,privato,1,2,0,2
8663,attivi.,1,2,0,2
8662,creatore,1,2,0,2
4368,organismi.,1,2,0,2
8660,rari,1,2,0,2
8659,nuclei,2,1,1,2
12681,gnulinux,0,0,2,2
12683,άντρες,0,0,2,2
4370,all'assenza,1,2,0,2
48407,sinceramente,0,0,2,2
45884,sejt,0,0,2,2
50523,зависимости,0,0,2,2
12661,формального,0,0,2,2
12635,بحث,0,0,2,2
45901,indiquant,0,0,2,2
12636,unable,0,0,2,2
45917,ആവർത്തിക്കാമോ,0,0,2,2
8699,imieliński,2,1,1,2
8695,internazionali,1,2,0,2
12646,μεσημεριανό,0,0,2,2
48386,см,0,0,2,2
4360,dozzine,1,2,0,2
12649,κόρης,0,0,2,2
45908,daarvan,0,0,2,2
8689,soli,1,2,0,2
8688,influenza,1,2,0,2
48388,ipod,0,0,2,2
45904,verwijderen,0,0,2,2
48390,подбодритесь,0,0,2,2
12658,anglaise,0,0,2,2
48246,« wikipedia »,0,0,2,2
8975,qualità.,1,2,0,2
47940,prisons,0,0,2,2
3789,formazione,1,2,0,2
11864,περιγράφουν,0,0,2,2
11866,essay,0,0,2,2
9310,propuesto,0,0,2,2
3790,estranei,1,2,0,2
46399,puestos,0,0,2,2
11876,sov,0,0,2,2
50585,أستحق,0,0,2,2
9305,حالات,0,0,2,2
9292,agradeciendo,0,0,2,2
9303,capables,0,0,2,2
11879,சனிக்கிழமையன்று,0,0,2,2
9301,ಅದೃಷ್ಟದ,0,0,2,2
50807,específico,0,0,2,2
11882,considerable,0,0,2,2
9298,finding,0,0,2,2
11884,bristande,0,0,2,2
46406,emotion,0,0,2,2
48029,display,0,0,2,2
46408,variantes,0,0,2,2
48026,compétences,0,0,2,2
48012,അതുകൊണ്ടുതന്നെ,0,0,2,2
50587,ചങ്ങാതിമാരുമായി,0,0,2,2
48015,interesante,0,0,2,2
9336,universitetet,0,0,2,2
9335,இல்லையென்றால்,0,0,2,2
3797,occidentale.,1,2,0,2
48016,крупным,0,0,2,2
11840,western,0,0,2,2
9329,språkversionerna,0,0,2,2
11846,வைக்க,0,0,2,2
50804,detinha,0,0,2,2
11851,administrator,0,0,2,2
46412,الأمور؟,0,0,2,2
11855,aim,0,0,2,2
50805,experimento,0,0,2,2
9293,voix,0,0,2,2
11887,primært,0,0,2,2
12291,ಮೂಲವನ್ನು,0,0,2,2
11947,сервера,0,0,2,2
11930,jourlà,0,0,2,2
3779,glielo,1,2,0,2
50581,nomes,0,0,2,2
11936,கட்டுரைகளுடன்,0,0,2,2
9260,हाथ,0,0,2,2
11939,invitation,0,0,2,2
46356,बंद,0,0,2,2
46355,الستة,0,0,2,2
4236,velocità,1,2,0,2
11950,soldaten,0,0,2,2
11952,lié,0,0,2,2
48070,negocio,0,0,2,2
46352,manque,0,0,2,2
4248,federale,1,2,0,2
48077,avisos,0,0,2,2
11963,« res,0,0,2,2
3781,votazione,1,2,0,2
11927,düğmesine,0,0,2,2
4239,raffinato,1,2,0,2
46370,head,0,0,2,2
48044,свободы,0,0,2,2
48045,भूखा,0,0,2,2
46389,ഉത്തരവും,0,0,2,2
9286,ಯಾವುದನ್ನಾದರೂ,0,0,2,2
48050,manden,0,0,2,2
46384,décidé,0,0,2,2
3785,incrociata,1,2,0,2
11906,தகவல்கள்,0,0,2,2
11907,devriez,0,0,2,2
11909,آي,0,0,2,2
9280,misiniz,0,0,2,2
9278,मिलेगा,0,0,2,2
46379,niño,0,0,2,2
46376,possess,0,0,2,2
11921,सुविधा,0,0,2,2
11829,reçoit,0,0,2,2
4230,essenzialmente,1,2,0,2
9347,exactly,0,0,2,2
3814,degustazione,1,2,0,2
11714,rolig,0,0,2,2
11716,yankovic,0,0,2,2
46500,accepterar,0,0,2,2
4213,"etichettati,",1,2,0,2
46497,λήμμα,0,0,2,2
3816,mandargli,1,2,0,2
9413,rêves,0,0,2,2
11737,filtering,0,0,2,2
3798,trae,2,1,1,2
3812,suggerisce,1,2,0,2
11741,إصدارات,0,0,2,2
47969,أحضر,0,0,2,2
46483,representatives,0,0,2,2
9404,pekar,0,0,2,2
47971,acerca,0,0,2,2
46479,लाइफ,0,0,2,2
46502,dynasty,0,0,2,2
11712,grusom,0,0,2,2
9426,കൊണ്ടാണ്,0,0,2,2
9429,വിഡ്,0,0,2,2
46526,الحالات,0,0,2,2
47945,ekmeği,0,0,2,2
11687,rechaza,0,0,2,2
9437,mögen,0,0,2,2
11690,महान,0,0,2,2
46517,mandos,0,0,2,2
47946,смотрите,0,0,2,2
9435,حسنًا,0,0,2,2
11694,proposent,0,0,2,2
46512,falschen,0,0,2,2
4212,viaggiando,1,2,0,2
11703,comédia,0,0,2,2
11704,ചോദിച്ചപ്പോൾ,0,0,2,2
11707,piezas,0,0,2,2
47949,récord,0,0,2,2
46475,atrozes,0,0,2,2
46474,ಕನಸಿನ,0,0,2,2
11755,pide,0,0,2,2
47991,interesseret,0,0,2,2
11796,jugées,0,0,2,2
11798,mp,0,0,2,2
9368,tidigt,0,0,2,2
46444,இளவரசன்,0,0,2,2
47998,μικρό,0,0,2,2
4223,cinematch,2,1,1,2
11804,شكك,0,0,2,2
46441,vested,0,0,2,2
46438,числа,0,0,2,2
9359,आशा,0,0,2,2
11812,ചെയ്യുന്ന,0,0,2,2
9350,زوار,0,0,2,2
11814,νάρκισσα,0,0,2,2
3799,pieno,1,2,0,2
46434,faço,0,0,2,2
9375,rompecabezas,0,0,2,2
46453,ಟೆರೆನ್ಸ್,0,0,2,2
11758,redor,0,0,2,2
11785,வாங்க,0,0,2,2
9398,altofalante,0,0,2,2
9396,kl,0,0,2,2
11761,reasoning,0,0,2,2
46470,வணக்கம்,0,0,2,2
11763,тупому,0,0,2,2
4215,raggiunse,1,2,0,2
46467,collectie,0,0,2,2
47977,punkt,0,0,2,2
46466,autoridades,0,0,2,2
50592,şanslı,0,0,2,2
47983,dün,0,0,2,2
46460,الموجودة,0,0,2,2
3803,sostenere,1,2,0,2
46457,request,0,0,2,2
11782,ನಿಧಾನವಾಗಿದೆ,0,0,2,2
9238,गतिविधियों,0,0,2,2
9237,utformning,0,0,2,2
9227,alexandre,0,0,2,2
12191,rubiner,0,0,2,2
50827,γνωρίζετε,0,0,2,2
12183,weekenden,0,0,2,2
9058,rappresentanti,1,2,0,2
9053,rimangono,1,2,0,2
50830,observant,0,0,2,2
9048,wikipedia.org,1,2,0,2
48204,binden,0,0,2,2
9042,"immagini,",1,2,0,2
50568,எது,0,0,2,2
12195,faits,0,0,2,2
12196,فيديو,0,0,2,2
46189,​​je,0,0,2,2
9036,grafici,1,2,0,2
4281,verificato,1,2,0,2
12206,செய்திருந்தால்,0,0,2,2
12208,بأكثر,0,0,2,2
9059,decennio,1,2,0,2
50826,"
इस",0,0,2,2
9060,abito,1,2,0,2
48193,rigor,0,0,2,2
12136,​​om,0,0,2,2
9093,बच्चों,0,0,2,2
9092,esmeraldas,0,0,2,2
48178,сайтом,0,0,2,2
9085,abonner,0,0,2,2
9080,selvatica.,1,2,0,2
12160,получает,0,0,2,2
9079,immagina,1,2,0,2
9078,esatti,1,2,0,2
9072,ripristinano,1,2,0,2
50565,raíces,0,0,2,2
9069,dispositivi.,1,2,0,2
46203,terabytes,0,0,2,2
9066,guidate,1,2,0,2
12173,edemezsiniz,0,0,2,2
12213,macmillan,0,0,2,2
3729,autobus,1,2,0,2
48213,تصنيف,0,0,2,2
4290,fotografia,2,1,1,2
8995,usiamo,1,2,0,2
8994,autonomamente,1,2,0,2
4292,riferiva,1,2,0,2
4293,dall'uomo,1,2,0,2
12257,عزيزتي,0,0,2,2
46148,வழியில்,0,0,2,2
8988,consegnato,1,2,0,2
46146,ilk,0,0,2,2
12272,एन्साइक्लोपीडिया,0,0,2,2
12273,esposa,0,0,2,2
3721,aiutami,1,2,0,2
12282,amerikanere,0,0,2,2
4298,originali,1,2,0,2
12289,länk,0,0,2,2
8978,l'estate,1,2,0,2
46158,tıpkı,0,0,2,2
46160,falsely,0,0,2,2
50558,bientôt,0,0,2,2
48232,mundo​,0,0,2,2
4285,aciclico,1,2,0,2
48219,التعبير,0,0,2,2
46174,promovido,0,0,2,2
4287,piacerebbe,1,2,0,2
48223,consultés,0,0,2,2
50556,ರೀತಿಯದ್ದಾಗಿದೆ,0,0,2,2
46169,αντίο,0,0,2,2
12236,ذي,0,0,2,2
9008,controversie.,1,2,0,2
48228,ordnummer,0,0,2,2
9004,scusa.,1,2,0,2
9003,evidenziato,1,2,0,2
8999,ispirato,1,2,0,2
12240,middag,0,0,2,2
12241,denotar,0,0,2,2
9096,gemakkelijke,0,0,2,2
12129,ιδρυτή,0,0,2,2
11971,ಪ್ರಿಯನು,0,0,2,2
9197,judío,0,0,2,2
12007,ಬೆಳಗಿದೆ,0,0,2,2
9206,الأسئلة,0,0,2,2
3767,direzioni,1,2,0,2
46318,tentando,0,0,2,2
3766,privo,1,2,0,2
3765,ragione.,1,2,0,2
48109,παίρνεις,0,0,2,2
3763,interessa,1,2,0,2
12128,ideologiskt,0,0,2,2
12024,пятница,0,0,2,2
12025,interior,0,0,2,2
12028,свободной,0,0,2,2
9193,werkt,0,0,2,2
12029,الفيلم,0,0,2,2
12030,kullandığı,0,0,2,2
46306,censure,0,0,2,2
12006,inscrevem,0,0,2,2
12004,halen,0,0,2,2
12003,funcionava,0,0,2,2
46321,durumu,0,0,2,2
48087,школе,0,0,2,2
11975,gjorts,0,0,2,2
9225,redactor,0,0,2,2
46334,സന്തോഷം,0,0,2,2
3773,vasta,1,2,0,2
11982,besvärlig,0,0,2,2
11983,abarcaba,0,0,2,2
9218,dække,0,0,2,2
11993,നൽകാൻ,0,0,2,2
11994,ανησυχούσε,0,0,2,2
11995,ಮೂಲ,0,0,2,2
4250,check,2,1,1,2
11997,episch,0,0,2,2
11998,प्रकरणों,0,0,2,2
46323,jättebra,0,0,2,2
9192,carnegiemellon,0,0,2,2
46304,ettiğimi,0,0,2,2
4255,hossein,2,1,1,2
9134,இதன்மூலம்,0,0,2,2
9128,geçebilirsin,0,0,2,2
46249,стоимость,0,0,2,2
48164,способом,0,0,2,2
9113,bibliotheek,0,0,2,2
4264,progress,2,1,1,2
9111,acessível,0,0,2,2
46243,audessus,0,0,2,2
48169,золотая,0,0,2,2
46239,plek,0,0,2,2
12118,referenced,0,0,2,2
12119,habilidades,0,0,2,2
9106,الإعجاب,0,0,2,2
9105,لاروس,0,0,2,2
46238,assouline et,0,0,2,2
48172,seinem,0,0,2,2
3751,chief,2,1,1,2
48152,അമ്മയും,0,0,2,2
9188,കൈകാര്യം,0,0,2,2
46268,république,0,0,2,2
48114,खुशी,0,0,2,2
48115,ಎಂದರ್ಥ,0,0,2,2
9180,ifadeler,0,0,2,2
46289,aprobación,0,0,2,2
12059,должно,0,0,2,2
9170,स्वप्न,0,0,2,2
9166,aparición,0,0,2,2
9157,onlar,0,0,2,2
46281,sterk,0,0,2,2
9156,telefoon,0,0,2,2
50572,عشر,0,0,2,2
9149,suisse,0,0,2,2
9148,narzisse,0,0,2,2
12074,devait,0,0,2,2
48147,ووجدوا,0,0,2,2
3223,davvero.,1,2,0,2
13634,kritikerna,0,0,2,2
47315,सिर्फ,0,0,2,2
15392,tour,0,0,2,2
43656,seasons,0,0,2,2
5436,subodh,2,1,1,2
3077,turner,2,1,1,2
15387,ആധികാരികത,0,0,2,2
15386,doğal,0,0,2,2
5433,sotto.,1,2,0,2
43419,atteindre,0,0,2,2
44170,للمشاركة,0,0,2,2
15382,tantas,0,0,2,2
6468,generalizzazione.,1,2,0,2
16529,gradiente,0,0,2,2
49509,नियंत्रण,0,0,2,2
15379,εγκυκλοπαίδειας,0,0,2,2
43418,ആറ്,0,0,2,2
43911,étionsnous,0,0,2,2
5739,fisici.,1,2,0,2
15375,précédente,0,0,2,2
6100,impiegate,1,2,0,2
43424,systeem,0,0,2,2
15372,मिलती,0,0,2,2
50260,கீழ்,0,0,2,2
43654,بسهولة,0,0,2,2
49523,ಸೂಚಿಸಲು,0,0,2,2
6109,"studio,",1,2,0,2
43426,നാർസിസ്,0,0,2,2
43655,wikification,0,0,2,2
5728,ripetere,1,2,0,2
15398,thanking,0,0,2,2
49520,sehe,0,0,2,2
2960,hinton,2,1,1,2
3078,contesti.,1,2,0,2
51111,gifte,0,0,2,2
44163,stel,0,0,2,2
16519,الخبراء,0,0,2,2
44165,термин,0,0,2,2
16520,posibilidades,0,0,2,2
6101,stupido.,1,2,0,2
5164,settimo,1,2,0,2
15374,éditée,0,0,2,2
43416,logra,0,0,2,2
16169,loan,0,0,2,2
6482,espresso,1,2,0,2
16548,sujette,0,0,2,2
5168,dall'apprendimento,1,2,0,2
2955,nozione,1,2,0,2
50011,yeniden,0,0,2,2
5090,dilbert,2,1,1,2
15810,والكلمة,0,0,2,2
3017,alphazero,2,1,1,2
43405,известна,0,0,2,2
49685,μυστικό,0,0,2,2
6087,esercitati,1,2,0,2
15813,pandemic,0,0,2,2
43900,reglerna,0,0,2,2
5422,discreto,1,2,0,2
16173,увижу,0,0,2,2
5744,aggregati,1,2,0,2
16559,பொருட்டல்ல,0,0,2,2
6485,autoapprendimento,1,2,0,2
15807,helg,0,0,2,2
6090,cpus,2,1,1,2
5165,storiche,1,2,0,2
15363,aussprache,0,0,2,2
44180,squared,0,0,2,2
16535,parada,0,0,2,2
6472,eri,1,2,0,2
16536,weitermachen,0,0,2,2
49506,jornalistas,0,0,2,2
50008,बैठे,0,0,2,2
16538,holen,0,0,2,2
49683,ajout,0,0,2,2
5167,scrivere,1,2,0,2
6093,godere,1,2,0,2
3074,medicine,2,1,1,2
6481,temporaneo,1,2,0,2
5427,Una,1,2,0,2
16175,coleção,0,0,2,2
16543,çapraz,0,0,2,2
3167,augurare,1,2,0,2
43411,revertir,0,0,2,2
49862,distinguish,0,0,2,2
15783,തീയതി,0,0,2,2
43429,سميت,0,0,2,2
15444,विध्वंसक,0,0,2,2
3013,protisti.,1,2,0,2
49667,प्रकाशित,0,0,2,2
16476,الويب،,0,0,2,2
50258,necessarily,0,0,2,2
5467,superiore.,1,2,0,2
3086,naturalmente,2,1,1,2
15438,telling,0,0,2,2
6432,troll,1,2,0,2
5707,osserva,1,2,0,2
44137,webbsidor,0,0,2,2
5460,intervalli,1,2,0,2
16210,முழு,0,0,2,2
5710,vestiti,1,2,0,2
43453,desired,0,0,2,2
15431,"
पिकार्ड",0,0,2,2
5711,'80.,1,2,0,2
43452,تفضل,0,0,2,2
43929,ögon,0,0,2,2
6426,medicina,1,2,0,2
49863,changé,0,0,2,2
15446,totalidad,0,0,2,2
43463,ordenou,0,0,2,2
50257,kitabı,0,0,2,2
49981,benutze,0,0,2,2
6130,venne,1,2,0,2
5104,ereditato,1,2,0,2
49539,neuronaux,0,0,2,2
43932,مستوى,0,0,2,2
49538,gehts,0,0,2,2
43931,maiores,0,0,2,2
3157,riparazione,1,2,0,2
5477,però,1,2,0,2
16470,समतुल्य,0,0,2,2
49984,പ്രകൃതി,0,0,2,2
6129,sufficientemente,1,2,0,2
6128,dovremmo,1,2,0,2
2966,ospitato,1,2,0,2
16214,hoovering,0,0,2,2
5458,capitoli,1,2,0,2
49869,देखी,0,0,2,2
6118,incompetente,1,2,0,2
16487,complexité,0,0,2,2
6114,sessuale,1,2,0,2
44150,ampliamente,0,0,2,2
6113,esci,1,2,0,2
5447,l'energia,1,2,0,2
49999,വിഷയങ്ങൾ,0,0,2,2
15414,turns,0,0,2,2
5721,esercitarsi,1,2,0,2
44153,ούτως,0,0,2,2
16508,doctrine,0,0,2,2
6442,sonno,1,2,0,2
15406,lärt,0,0,2,2
43431,offer,0,0,2,2
6110,controproducente,1,2,0,2
51159,கடன்,0,0,2,2
44158,síntomas,0,0,2,2
49866,arabanın,0,0,2,2
16191,oben,0,0,2,2
16502,worte,0,0,2,2
3083,matrimonio.,1,2,0,2
5448,uber,2,1,1,2
5717,esaminato,1,2,0,2
5456,tu.,1,2,0,2
5455,distinte,1,2,0,2
5716,programmatori,1,2,0,2
43446,preocupações,0,0,2,2
4916,decisionali,1,2,0,2
2963,pensata,1,2,0,2
6435,batterica,1,2,0,2
6436,amministrazione,1,2,0,2
5450,vissuto,1,2,0,2
51218,விரும்புவதை,0,0,2,2
44143,лишнюю,0,0,2,2
15426,श्रेय,0,0,2,2
5454,biologia,1,2,0,2
15775,hayatında,0,0,2,2
51157,predominantemente,0,0,2,2
43645,erişim,0,0,2,2
16170,déterminer,0,0,2,2
4994,contenessero,1,2,0,2
6415,pandemia,1,2,0,2
6529,narciso.,1,2,0,2
15293,åren,0,0,2,2
5381,figlia.,1,2,0,2
49708,englishspeaking,0,0,2,2
5379,dicembre.,1,2,0,2
16585,мальчик,0,0,2,2
6530,scarsamente,1,2,0,2
2947,concentrano,1,2,0,2
44226,connaissez,0,0,2,2
5776,specifiche.,1,2,0,2
5079,adottata,1,2,0,2
15291,ಸಂಧಿಸುವಿಕೆಯನ್ನು,0,0,2,2
15289,бизнесе,0,0,2,2
15861,numarası,0,0,2,2
51104,conservation,0,0,2,2
43692,വാരാന്ത്യത്തിൽ,0,0,2,2
15286,премию,0,0,2,2
44227,ينتهك,0,0,2,2
5774,fluente.,1,2,0,2
16138,maddesini,0,0,2,2
6533,dubbio,1,2,0,2
51168,опубликованы,0,0,2,2
43683,taxa,0,0,2,2
15849,минут,0,0,2,2
50215,poder,0,0,2,2
50024,அழகாகவும்,0,0,2,2
16582,believe,0,0,2,2
16144,بجدية,0,0,2,2
15301,kararlar,0,0,2,2
4902,mescolati,1,2,0,2
3061,Microsoft,1,2,0,2
50134,negócios,0,0,2,2
44222,comentou,0,0,2,2
15852,mujer,0,0,2,2
49482,maart,0,0,2,2
51105,uitspraak,0,0,2,2
5769,modificabile,1,2,0,2
5384,così.,1,2,0,2
49840,विज्ञापन,0,0,2,2
49716,परिवर्तनों,0,0,2,2
49481,windows,0,0,2,2
44189,νέες,0,0,2,2
5182,>,1,2,0,2
6017,dall'esperienza,1,2,0,2
43858,bildning,0,0,2,2
6550,essenziali,1,2,0,2
15880,universities,0,0,2,2
6015,all'anonimato,1,2,0,2
6014,concluso,1,2,0,2
5351,città,1,2,0,2
16603,dedicated,0,0,2,2
4892,esterna,1,2,0,2
43378,sesgado,0,0,2,2
15252,तुंरत,0,0,2,2
6556,dell'ingegneria,1,2,0,2
6012,esistevano,1,2,0,2
6558,discute,2,1,1,2
6010,ecml,2,1,1,2
6560,ripeta,1,2,0,2
49469,ചെയ്യാം,0,0,2,2
4894,riducendo,1,2,0,2
49722,സമവാക്യം,0,0,2,2
15279,تغطيني,0,0,2,2
50034,traduction,0,0,2,2
6535,genetico,1,2,0,2
43867,examined,0,0,2,2
2945,salute,1,2,0,2
4899,marchio,1,2,0,2
44234,credited,0,0,2,2
16589,winter,0,0,2,2
15868,precies,0,0,2,2
43693,очередь,0,0,2,2
4898,scuola,1,2,0,2
16130,ошибка,0,0,2,2
49480,diet,0,0,2,2
44237,अस्वीकार,0,0,2,2
16129,servent,0,0,2,2
15872,اليابانية,0,0,2,2
5369,classificatore,1,2,0,2
50175,pointu,0,0,2,2
6544,prendono,1,2,0,2
43682,возможности,0,0,2,2
5179,ghiacciai,1,2,0,2
49488,الموجود,0,0,2,2
3169,classica,1,2,0,2
3172,divisioni,1,2,0,2
6068,supervisione.,1,2,0,2
6066,soldati,1,2,0,2
16564,भूल,0,0,2,2
6491,facciamo,1,2,0,2
16567,contienen,0,0,2,2
5001,precipitazioni,1,2,0,2
5407,regolarmente,1,2,0,2
6492,dorato,1,2,0,2
15330,τεστ,0,0,2,2
43674,आँखें,0,0,2,2
43893,associate,0,0,2,2
5752,semi-supervisionato,1,2,0,2
15830,полностью,0,0,2,2
15831,passent,0,0,2,2
2951,giusto,1,2,0,2
15327,सुनहरे,0,0,2,2
3170,spiega.,1,2,0,2
50136,policyn,0,0,2,2
3180,incredibilmente,1,2,0,2
15820,musun,0,0,2,2
2954,rimanere,1,2,0,2
15352,brugeres,0,0,2,2
5419,oliver,2,1,1,2
5417,paper,2,1,1,2
15818,κάνουμε,0,0,2,2
5169,integrante,1,2,0,2
15348,examination,0,0,2,2
5746,se.,1,2,0,2
15344,confirmed,0,0,2,2
15341,restrictions,0,0,2,2
50217,அம்மாவாக,0,0,2,2
3018,raccomandato,1,2,0,2
5086,forniscono,1,2,0,2
6072,l'impegno.,1,2,0,2
6071,fresco,2,1,1,2
49693,plaisir,0,0,2,2
49849,ഇതിനർത്ഥം,0,0,2,2
6059,sentire,1,2,0,2
51222,нередко,0,0,2,2
49700,ആരംഭിച്ച,0,0,2,2
5754,cavaliere.,1,2,0,2
6501,lander,2,1,1,2
15317,animar,0,0,2,2
49495,மெல்லியாக,0,0,2,2
43885,журнал,0,0,2,2
51106,installed,0,0,2,2
5759,sposarti,1,2,0,2
15313,novia,0,0,2,2
50216,kinds,0,0,2,2
15310,pillars,0,0,2,2
5004,ipertestuali,1,2,0,2
3179,registrati.,1,2,0,2
6050,benvenuti,1,2,0,2
5761,fetta,1,2,0,2
5396,Wikipedia.,1,2,0,2
43681,gerekiyor,0,0,2,2
44216,ಮದುವೆಯಲ್ಲಿ,0,0,2,2
15848,focusing,0,0,2,2
5397,contestato,1,2,0,2
5176,provi,1,2,0,2
44209,средства,0,0,2,2
3020,voluto,1,2,0,2
49846,changements,0,0,2,2
50017,वाक्यों,0,0,2,2
3175,David,1,2,0,2
15835,vermektedir,0,0,2,2
5404,ricorda.,1,2,0,2
5174,minuti,1,2,0,2
43887,понравилось,0,0,2,2
3063,minimizzazione,1,2,0,2
5400,condivisi,1,2,0,2
6495,logico.,1,2,0,2
6496,intellettuale,1,2,0,2
15322,enerji,0,0,2,2
5758,definizioni,1,2,0,2
6053,-pedia,1,2,0,2
16577,esperanto,0,0,2,2
43679,ayudar,0,0,2,2
6132,manifesta,1,2,0,2
49877,sophisticated,0,0,2,2
5348,ottuso.,1,2,0,2
5626,dipinti,1,2,0,2
6212,risatine,1,2,0,2
15571,നിന്നെ,0,0,2,2
5631,quarta,2,1,1,2
43536,attribuer,0,0,2,2
49939,கிடைத்தது,0,0,2,2
4947,chiedi.,1,2,0,2
6303,autorizzazione.,1,2,0,2
6305,sbalordito,1,2,0,2
6307,approssimativamente,1,2,0,2
6308,l'abilità,1,2,0,2
6310,sgarbatamente,1,2,0,2
15665,​​eller,0,0,2,2
16277,मांग,0,0,2,2
15559,supporting,0,0,2,2
50247,ссылки,0,0,2,2
15558,языкового,0,0,2,2
5634,egoista,1,2,0,2
44055,നൽകി,0,0,2,2
5625,rendi,1,2,0,2
5636,pkdd,2,1,1,2
5623,comportato,1,2,0,2
49909,прекрасно,0,0,2,2
6293,l'estinzione,1,2,0,2
49595,fıkra,0,0,2,2
5563,assomigli,1,2,0,2
44050,experientes,0,0,2,2
44051,संशोधित,0,0,2,2
6222,mandato,1,2,0,2
15657,pronunciación,0,0,2,2
16361,βράδυ,0,0,2,2
16362,perfect,0,0,2,2
6299,m.,1,2,0,2
43594,abordagem,0,0,2,2
5558,autonoma,1,2,0,2
5126,interessato,1,2,0,2
6219,"preoccuparti,",1,2,0,2
51199,स्वर,0,0,2,2
15575,സംരംഭത്തിന്റെ,0,0,2,2
16371,utvecklade,0,0,2,2
15669,متأكدا,0,0,2,2
51208,universalis,0,0,2,2
16267,gylden,0,0,2,2
49946,കരയുകയും,0,0,2,2
16263,repositorio,0,0,2,2
5143,generalizzare,1,2,0,2
6198,bevanda,1,2,0,2
5118,meccanismo,1,2,0,2
5117,preparato,1,2,0,2
43519,பிரகாசமான,0,0,2,2
51196,verbets,0,0,2,2
49949,तौर,0,0,2,2
49582,définie,0,0,2,2
49950,simplesmente,0,0,2,2
43982,appellation,0,0,2,2
6194,L'apprendimento,1,2,0,2
6333,esistere,1,2,0,2
49953,ground,0,0,2,2
6334,cronometra,2,1,1,2
43980,மதிப்புக்குரியது,0,0,2,2
6199,definitivamente,1,2,0,2
49585,uitkomt,0,0,2,2
44069,τεράστιο,0,0,2,2
44072,βικιβιβλία,0,0,2,2
51146,herkesin,0,0,2,2
5549,trattati,1,2,0,2
5641,nominata,1,2,0,2
49632,cooperación,0,0,2,2
16271,பயங்கரமான,0,0,2,2
49633,அனுப்ப,0,0,2,2
2989,vegetabilia,2,1,1,2
15672,प्रमुख,0,0,2,2
6201,dov'è,1,2,0,2
6318,locali,1,2,0,2
5644,includendo,1,2,0,2
43988,надеюсь,0,0,2,2
43604,दलदली,0,0,2,2
5645,computing.,1,2,0,2
6321,servire,1,2,0,2
6322,scoraggia,1,2,0,2
49586,thuiskwam,0,0,2,2
5564,evoluta,1,2,0,2
44001,l’a,0,0,2,2
5619,va.,1,2,0,2
15615,விளையாடுகிறீர்கள்,0,0,2,2
6263,convettivo,1,2,0,2
16326,значок,0,0,2,2
44011,competition,0,0,2,2
16328,eigenlijk,0,0,2,2
5590,conosciamo.,1,2,0,2
43574,ваш,0,0,2,2
2999,battaglia,1,2,0,2
15608,influences,0,0,2,2
15607,ഫ്ലംമോക്സ്,0,0,2,2
43577,fransızca,0,0,2,2
15606,देशों,0,0,2,2
5131,raggruppamento,1,2,0,2
49607,dumm,0,0,2,2
16334,specifika,0,0,2,2
6237,mirano,1,2,0,2
6269,alexnet,2,1,1,2
5135,immaginare,1,2,0,2
5591,"false,",1,2,0,2
6261,uniforme,1,2,0,2
15581,பெறுவீர்கள்,0,0,2,2
15638,корень,0,0,2,2
49919,интересно,0,0,2,2
44016,tidsskriftets,0,0,2,2
6246,documento,2,1,1,2
4958,visto.,1,2,0,2
6240,Equinix,1,2,0,2
5597,sbalordita,1,2,0,2
5595,energetico,1,2,0,2
15624,वैसा,0,0,2,2
43567,ஆபத்துடைய,0,0,2,2
49612,mile,0,0,2,2
5133,velocemente,1,2,0,2
3118,mainstream,2,1,1,2
6253,procedura,1,2,0,2
6254,causato,1,2,0,2
49616,consultée,0,0,2,2
43565,honger,0,0,2,2
44025,σημείο,0,0,2,2
16303,असाइनमेंट,0,0,2,2
5607,complementari,1,2,0,2
5584,preciso,2,1,1,2
15642,eder,0,0,2,2
44042,aient,0,0,2,2
16293,procuram,0,0,2,2
43551,മെച്ചപ്പെട്ട,0,0,2,2
43549,γίνει,0,0,2,2
5571,unici.,1,2,0,2
49932,describes,0,0,2,2
5614,YouTube,1,2,0,2
16348,noise,0,0,2,2
44045,बनने,0,0,2,2
43546,endişelendiğini,0,0,2,2
5616,scenario,2,1,1,2
16350,baixas,0,0,2,2
16351,journals,0,0,2,2
15585,loslegen,0,0,2,2
49910,expansion,0,0,2,2
49621,wetland,0,0,2,2
4949,disprezzo,1,2,0,2
15590,ಕೇಳುತ್ತಿಲ್ಲ,0,0,2,2
5573,dorate,1,2,0,2
49602,libertés,0,0,2,2
6272,modificata,1,2,0,2
43584,reuse,0,0,2,2
4962,continuano,1,2,0,2
15644,düzeltmede,0,0,2,2
44008,elefante,0,0,2,2
5579,applicare,1,2,0,2
4952,plos,2,1,1,2
6235,colonizzato,1,2,0,2
16298,libertine,0,0,2,2
15591,complain,0,0,2,2
44037,attempted,0,0,2,2
6275,priorità,1,2,0,2
5577,genetici.,1,2,0,2
5611,all'università,1,2,0,2
16295,ಇತ್ತೀಚಿನ,0,0,2,2
3117,cognitivi.,1,2,0,2
6281,affogando,1,2,0,2
16257,derovre,0,0,2,2
5651,codici,1,2,0,2
15455,diamantes,0,0,2,2
15495,والزاوية,0,0,2,2
44102,मिलाकर,0,0,2,2
49555,promedio,0,0,2,2
44105,argumentam,0,0,2,2
6387,personaggi,1,2,0,2
6388,intese,1,2,0,2
15729,குறிப்பிடலாம்,0,0,2,2
43628,gördüğü,0,0,2,2
6389,assumere,1,2,0,2
6391,conoscenza.,1,2,0,2
43629,administrada,0,0,2,2
5503,persi,1,2,0,2
6155,l'habitat,1,2,0,2
49554,собираетесь,0,0,2,2
5501,preparata,1,2,0,2
16438,ನೋಟ,0,0,2,2
5152,risulta,1,2,0,2
49551,obtienes,0,0,2,2
43954,videonun,0,0,2,2
16429,lacking,0,0,2,2
4927,cambriana,1,2,0,2
6385,vennero,1,2,0,2
6382,te.,1,2,0,2
6166, anni.,1,2,0,2
49883,paradox,0,0,2,2
6165,supervisionati,1,2,0,2
15717,encyclopedic,0,0,2,2
6163,narcisa.,1,2,0,2
15499,hakkındaki,0,0,2,2
15498,العملية,0,0,2,2
6162,potete,1,2,0,2
2978,soddisfare,1,2,0,2
16424,المهام,0,0,2,2
5507,deciso,1,2,0,2
15497,ute,0,0,2,2
43492,बाप,0,0,2,2
44101,impersonation,0,0,2,2
6156,"piangere,",1,2,0,2
3010,fece,1,2,0,2
6396,fattibilità,1,2,0,2
6399,dicesse,1,2,0,2
49579,अरे,0,0,2,2
5693,equilibrate,1,2,0,2
5486,podcast,2,1,1,2
50164,πατήσει,0,0,2,2
49662,எளிதான,0,0,2,2
15463,actos,0,0,2,2
6137,sicurezza.,1,2,0,2
15459,pu,0,0,2,2
43634,извини,0,0,2,2
6136,permettono,1,2,0,2
15458,странах,0,0,2,2
6134,ppt.,1,2,0,2
4920,ehud,2,1,1,2
49878,chérie,0,0,2,2
43468,groter,0,0,2,2
16218,الملاك,0,0,2,2
3155,portavoce,1,2,0,2
6133,smeraldi,1,2,0,2
5484,dimmi,1,2,0,2
5487,elabora,1,2,0,2
15745,προτάσεων,0,0,2,2
5498,d'argento,1,2,0,2
15469,wachten,0,0,2,2
6402,classificazioni,1,2,0,2
15481,beğendiyseniz,0,0,2,2
6150,stampa,1,2,0,2
49657,appeler,0,0,2,2
6406,facendo.,1,2,0,2
50227,leitura,0,0,2,2
43946,γεύμα,0,0,2,2
49974,ಸೌಂದರ್ಯವು,0,0,2,2
6147,esprimere,1,2,0,2
2973,aiutarmi,1,2,0,2
2972,creava,1,2,0,2
5688,comprensione,1,2,0,2
6407,esteso,1,2,0,2
6143,falsi,1,2,0,2
5106,misurato,1,2,0,2
5492,ecosistema,1,2,0,2
3149,Tretikov,1,2,0,2
4930,assoluto.,1,2,0,2
43963,இதுதான்,0,0,2,2
5510,sfide,1,2,0,2
15530,கிடைக்குமா,0,0,2,2
5148,computazionale.,1,2,0,2
5658,dall'esercito,1,2,0,2
43615,இடமில்லை,0,0,2,2
44088,acontecem,0,0,2,2
50158,ಹೊಂದಿಲ್ಲ,0,0,2,2
15700,αναπτύσσεται,0,0,2,2
16404,المراكز,0,0,2,2
43616,теории,0,0,2,2
15702,read,0,0,2,2
2983,all'ambiente,1,2,0,2
51129,evde,0,0,2,2
5522,Regno,1,2,0,2
15705,brutes,0,0,2,2
43619,праве,0,0,2,2
3139,accetta,1,2,0,2
5661,plausibili,1,2,0,2
49893,yasal,0,0,2,2
6182,sull'argomento,1,2,0,2
44085,destruction,0,0,2,2
49885,चूंकि,0,0,2,2
50250,yapacak,0,0,2,2
5652,lastre,1,2,0,2
3107,generare,1,2,0,2
5533,molestie,1,2,0,2
6339,giochi,1,2,0,2
6340,finire.,1,2,0,2
44081,spinoza,0,0,2,2
16393,glömmer,0,0,2,2
49895,webbplats,0,0,2,2
6345,"più,",1,2,0,2
5655,composti,1,2,0,2
50230,способы,0,0,2,2
44082,involve,0,0,2,2
43977,cubrirme,0,0,2,2
5656,l'input,1,2,0,2
3103,modifica.,1,2,0,2
50148,συνεχίσουν,0,0,2,2
15691,almoço,0,0,2,2
6176,'.,1,2,0,2
49891,ഒര്മയുല്ലപ്പം,0,0,2,2
15521,പ്രശ്നം,0,0,2,2
5520,pannotia,2,1,1,2
5672,climi,1,2,0,2
6171,microrganismi,1,2,0,2
6369,morendo,1,2,0,2
49888,ζούσε,0,0,2,2
43964,ach,0,0,2,2
15508,portaal,0,0,2,2
16233,അയാൾക്ക്,0,0,2,2
4982,grandi.,1,2,0,2
43496,ενεργειακό,0,0,2,2
6371,affari,1,2,0,2
49969,broad,0,0,2,2
16419,അതുപോലെ,0,0,2,2
6373,errore.,1,2,0,2
6168,prenderti,1,2,0,2
16232,dúvida,0,0,2,2
49560,kalla,0,0,2,2
15502,bioinformatics,0,0,2,2
49648,söylemektir,0,0,2,2
15512,risque,0,0,2,2
51194,அவர்களின்,0,0,2,2
44091,ii»,0,0,2,2
2982,madrelingua,1,2,0,2
43622,менее,0,0,2,2
16241,situationen,0,0,2,2
5668,indirizzi,1,2,0,2
49963,tomada,0,0,2,2
44090,тесно,0,0,2,2
16239,« principal »,0,0,2,2
51211,எவ்வளவு,0,0,2,2
49964,andelen,0,0,2,2
3008,pesante,1,2,0,2
4937,rimossi,1,2,0,2
15514,passage,0,0,2,2
6364,sei.,1,2,0,2
50146,voorbeeldzinnen,0,0,2,2
43967,devrait,0,0,2,2
5112,climatici,1,2,0,2
15249,contact,0,0,2,2
5416,civiltà,1,2,0,2
5321,poi.,1,2,0,2
43715,бесконечно,0,0,2,2
5850,simpatici,1,2,0,2
15970,மாயாஜால,0,0,2,2
15086,ausmachen,0,0,2,2
5851,vocabolario,1,2,0,2
15179,millet,0,0,2,2
50277,değiştirilmesi,0,0,2,2
16656,essence,0,0,2,2
6602,assume,2,1,1,2
15182,ótima,0,0,2,2
5852,sbalorditiva.,1,2,0,2
5914,distribuite,1,2,0,2
43716,diğerini,0,0,2,2
50064,glemmer,0,0,2,2
15914,വിദഗ്ദ്ധന്മാർ,0,0,2,2
44294,ಬೇಕು,0,0,2,2
4880,misurazione,1,2,0,2
5819,mangi.,1,2,0,2
15185,स्वादिष्ट,0,0,2,2
5042,gentili,1,2,0,2
50063,reçus,0,0,2,2
5853,spiegazione,1,2,0,2
50121,математике,0,0,2,2
5977,incomplete.,1,2,0,2
43302,gouvernement,0,0,2,2
15907,evolves,0,0,2,2
49816,birden,0,0,2,2
5974,'lento,1,2,0,2
15088,ಕೇಳುತ್ತಿದ್ದಾರೆ,0,0,2,2
49766,revoir,0,0,2,2
15915,моментом,0,0,2,2
44352,limitadas,0,0,2,2
5040,mantenimento,1,2,0,2
4863,belli,1,2,0,2
15917,affaires,0,0,2,2
43832,songs,0,0,2,2
5204,soggetta,1,2,0,2
5193,"edizioni,",1,2,0,2
51237,χρησιμοποιούν,0,0,2,2
44353,hepsini,0,0,2,2
5263,interrompo.,1,2,0,2
5192,menzionato,1,2,0,2
5919,internazionale,1,2,0,2
49451,motsats,0,0,2,2
5025,"bello,",1,2,0,2
6664,minuscola,1,2,0,2
6666,controllate,1,2,0,2
5918,funzionare,1,2,0,2
5848,suonare,1,2,0,2
43799,quão,0,0,2,2
15092,αναθέσεις,0,0,2,2
43742,agradable,0,0,2,2
16088,ರಹಸ್ಯವಾದ,0,0,2,2
16089,милая,0,0,2,2
5915,vincolo,1,2,0,2
4879,anche.,1,2,0,2
5849,tradizionali.,1,2,0,2
15186,contó,0,0,2,2
5062,burocrati,1,2,0,2
50127,كمشروع,0,0,2,2
15204,saiba,0,0,2,2
6675,sua.,1,2,0,2
43749,påståenden,0,0,2,2
16039,negatief,0,0,2,2
44287,вроде,0,0,2,2
3033,udito.,1,2,0,2
16643,externes,0,0,2,2
44286,intuición,0,0,2,2
49775,kinderspiel,0,0,2,2
15201,weise,0,0,2,2
6589,rodinia,2,1,1,2
15075,källhänvisningar,0,0,2,2
15902,مشاهدة,0,0,2,2
5208,ibmer,2,1,1,2
43301,michel,0,0,2,2
49776,точности,0,0,2,2
15206,शेष,0,0,2,2
5331,com'è,1,2,0,2
6588,comprerei,1,2,0,2
5900,trascinare,1,2,0,2
43354,दर्जा,0,0,2,2
44281,hermanos,0,0,2,2
16102,branch,0,0,2,2
15073,kent,0,0,2,2
43841,कंप्यूटर,0,0,2,2
49822,picked,0,0,2,2
3034,politici,2,1,1,2
50280,leisure,0,0,2,2
16727,generates,0,0,2,2
2939,regressione.,1,2,0,2
16099,yapmalıyım,0,0,2,2
5251,paesi.,1,2,0,2
43349,حلمي,0,0,2,2
15187,أدناه,0,0,2,2
5814,youtube.,1,2,0,2
5043,riscontrati,1,2,0,2
5910,maggio.,1,2,0,2
49771,credit,0,0,2,2
16649,distribuição,0,0,2,2
15080,ευγενικά,0,0,2,2
5813,associazioni,1,2,0,2
50100,tornandoa,0,0,2,2
43747,ಕೆಲಸದ,0,0,2,2
44290,mand,0,0,2,2
16096,குழப்பம்,0,0,2,2
6597,creatività,1,2,0,2
6596,ted,2,1,1,2
16097,beispielsätze,0,0,2,2
16646,غاضبًا,0,0,2,2
49772,consultation,0,0,2,2
15193,altaylı,0,0,2,2
43748,bedeutung,0,0,2,2
6594,soggetti,1,2,0,2
49457,wacht,0,0,2,2
5811,sorridendosi,1,2,0,2
49458,riches,0,0,2,2
6659,chiara,1,2,0,2
5924,spezzato,1,2,0,2
16638,μαρμελάδα,0,0,2,2
15935,उच्चतम,0,0,2,2
6625,considerevole,1,2,0,2
5031,cinesi,1,2,0,2
6624,naturali.,1,2,0,2
15949,സഹകരണത്തോടെ,0,0,2,2
43813,«нравится»,0,0,2,2
15937,भीतर,0,0,2,2
15153,trouwen,0,0,2,2
15125,insiders,0,0,2,2
50086,leyendo,0,0,2,2
5940,accessibili,1,2,0,2
50198,विकिक्वोट,0,0,2,2
49811,materiaal,0,0,2,2
15124,sofá,0,0,2,2
5835,decenni,1,2,0,2
43327,logiciel ,0,0,2,2
49749,вообще,0,0,2,2
43328,വിശദീകരിക്കുന്നു,0,0,2,2
15123,pardelà,0,0,2,2
5194,locale,2,1,1,2
50088,olup,0,0,2,2
5028,specializzate,1,2,0,2
49747,letter,0,0,2,2
15155,पढ़,0,0,2,2
15156,исключительно,0,0,2,2
5272,opinioni.,1,2,0,2
49760,inventé,0,0,2,2
44316,удаления,0,0,2,2
5290,costanti,1,2,0,2
4866,dell'abbigliamento,1,2,0,2
4873,rakesh,2,1,1,2
5833,sviluppate,1,2,0,2
49809,höja,0,0,2,2
49435,puisque,0,0,2,2
43323,होगा।,0,0,2,2
6631,sviluppatori,1,2,0,2
44327,poderem,0,0,2,2
49758,ppt,0,0,2,2
5945,aiuteresti,1,2,0,2
5285,tentativo,1,2,0,2
43325,tone,0,0,2,2
5281,contempo,1,2,0,2
51234,förslag,0,0,2,2
3052,guardò,1,2,0,2
5066,glaciali.,1,2,0,2
5033,rapidi,1,2,0,2
15128,تحدث,0,0,2,2
43730,परिणामस्वरूप,0,0,2,2
5032,sottoposta,1,2,0,2
43728,extérieure,0,0,2,2
3211,descrive,1,2,0,2
50125,свободен,0,0,2,2
43732,fest,0,0,2,2
44321,iwf,0,0,2,2
15126,назван,0,0,2,2
50080,उपयोगिता,0,0,2,2
16688,спрашиваю,0,0,2,2
5933,affrontato,1,2,0,2
15956,цели,0,0,2,2
49761,милю,0,0,2,2
16666,continues,0,0,2,2
5299,gestione,1,2,0,2
51183,arrêt,0,0,2,2
5300,dinamica,1,2,0,2
16667,drives,0,0,2,2
49804,deleted,0,0,2,2
15166,പദാവലി,0,0,2,2
3214,peggio,1,2,0,2
6650,"nupedia,",1,2,0,2
5824,foreste,1,2,0,2
5305,fotografie,1,2,0,2
15923,السياسية,0,0,2,2
43829,общих,0,0,2,2
6651,indiano,1,2,0,2
43316,gerelateerd,0,0,2,2
5926,"tuttavia,",1,2,0,2
43719,telegrama,0,0,2,2
49803,banda,0,0,2,2
6652,browser,2,1,1,2
4876,farmaci,1,2,0,2
16087,matériel,0,0,2,2
43831,البكاء,0,0,2,2
15108,advice,0,0,2,2
4867,kamm,2,1,1,2
50069,kiggede,0,0,2,2
5310,fluenti,1,2,0,2
5063,fermati,1,2,0,2
16669,ഉച്ചാരണം,0,0,2,2
49426,operating,0,0,2,2
50091,galactica,0,0,2,2
5826,"comunità,",1,2,0,2
5838,l'inglese,1,2,0,2
15122,traité,0,0,2,2
43824,paradoxe,0,0,2,2
15928,кредит,0,0,2,2
16075,encanta,0,0,2,2
51181,derived,0,0,2,2
16078,finesser,0,0,2,2
6621,intesa,1,2,0,2
43332,сказали,0,0,2,2
50077,draußen,0,0,2,2
6620,accadendo,1,2,0,2
50090,vandaan,0,0,2,2
6619,crisi,1,2,0,2
51086,रो,0,0,2,2
43314,высоко,0,0,2,2
16079,sección,0,0,2,2
16080,लिंक्स,0,0,2,2
3049,settimane,1,2,0,2
6642,misurata,1,2,0,2
6643,prestigio,2,1,1,2
6615,restrizioni,1,2,0,2
5203,visita,1,2,0,2
5827,"Internet,",1,2,0,2
6645,dicono.,1,2,0,2
6646,l'esperienza,1,2,0,2
15214,itibarıyla,0,0,2,2
15135,yapalım,0,0,2,2
43293,privada,0,0,2,2
43291,xviiie siècle,0,0,2,2
43362,jeopardy,0,0,2,2
50047,tråkiga,0,0,2,2
6000,raccolti,1,2,0,2
15058,almacenamiento,0,0,2,2
51175,correcting,0,0,2,2
5218,colore,1,2,0,2
15056,escuchado,0,0,2,2
3039,mh,2,1,1,2
49461,rigdom,0,0,2,2
43771,inserted,0,0,2,2
43782,undersökningar,0,0,2,2
15229,énorme,0,0,2,2
50054,باستخدام,0,0,2,2
16104,нажав,0,0,2,2
6683,solito.,1,2,0,2
5232,interpretativa,2,1,1,2
3194,nell'assistenza,1,2,0,2
44274,எங்கிருந்தோம்,0,0,2,2
6685,suggerimenti.,1,2,0,2
15062,имели,0,0,2,2
16735,வாழ்த்துக்கள்,0,0,2,2
5057,derivate,1,2,0,2
15891,documentaire,0,0,2,2
16006,déterminé,0,0,2,2
16012,suivi,0,0,2,2
2940,consentito,1,2,0,2
50178,britânica,0,0,2,2
5334,poterlo,1,2,0,2
5990,/,1,2,0,2
15059,ದಿನಾಂಕವನ್ನು,0,0,2,2
49823,controversos,0,0,2,2
4888,sull'analisi,1,2,0,2
44266,seeing,0,0,2,2
6569,segnali,1,2,0,2
16731,interacting,0,0,2,2
6565,constable,2,1,1,2
4884,decisionale.,1,2,0,2
16022,glem,0,0,2,2
5235,chiodo,1,2,0,2
5056,nell'interesse,1,2,0,2
6689,tornato,1,2,0,2
49462,vois,0,0,2,2
6570,quell'altoparlante.,1,2,0,2
16106,இருக்கிறீர்களா,0,0,2,2
15063,لأنه,0,0,2,2
3040,openai,2,1,1,2
43765,நினைப்பீர்களா,0,0,2,2
43779,hänger,0,0,2,2
6692,spingono,1,2,0,2
44276,faculdade,0,0,2,2
4854,hosting,2,1,1,2
16615,miguel,0,0,2,2
44275,poucos,0,0,2,2
5883,confondi,1,2,0,2
49726,دواعي,0,0,2,2
6694,sensibilità,1,2,0,2
43786,पूरक,0,0,2,2
5869,rallentamento,1,2,0,2
3197,costruisce,1,2,0,2
49725,gráfico,0,0,2,2
5239,elettronica,1,2,0,2
5347,finiti,1,2,0,2
5059,sull'apprendimento,1,2,0,2
3193,interrogativo.,1,2,0,2
5862,complessiva,1,2,0,2
51097,"
मिन",0,0,2,2
5802,riporta,1,2,0,2
49467,gerekirse,0,0,2,2
5799,narcissa.,1,2,0,2
5801,d'acqua.,1,2,0,2
5215,l'aspetto,1,2,0,2
50055,ऋण,0,0,2,2
5805,salì,1,2,0,2
5893,agente,2,1,1,2
44278,salida,0,0,2,2
5886,biologico,1,2,0,2
16637,വീഡിയോയിൽ,0,0,2,2
16112,géographiques,0,0,2,2
15883,вашим,0,0,2,2
49784,excepcionalmente,0,0,2,2
16620,உடையில்,0,0,2,2
15060,représente,0,0,2,2
50188,siabra,0,0,2,2
5224,accettano,1,2,0,2
43851,crée,0,0,2,2
5795,singolo,1,2,0,2
43757,piensa,0,0,2,2
5871,collegio,1,2,0,2
5336,naso,1,2,0,2
6572,chiedevo,1,2,0,2
3199,diff,2,1,1,2
15888,स्टालमेन,0,0,2,2
43845,بالكامل,0,0,2,2
49410,beleuchtet,0,0,2,2
49733,stuk,0,0,2,2
49413,fiable,0,0,2,2
3038,fammelo,1,2,0,2
50046,viktiga,0,0,2,2
36614,listada,0,0,1,1
48314,aprieto,0,0,1,1
52678,marcadas,0,0,1,1
36062,lilla,0,0,1,1
48352,بالشفرة,0,0,1,1
33463,enfade,0,0,1,1
36483,ಒಬ್ಬ,0,0,1,1
49887,анонимы,0,0,1,1
52236,مليوني,0,0,1,1
49806,dimensionality,0,0,1,1
49889,asteroid,0,0,1,1
49886,சவாரிக்குப்,0,0,1,1
48048,derste,0,0,1,1
48049,violando,0,0,1,1
36485,करोड़,0,0,1,1
48047,карролтон,0,0,1,1
47947,المعرفة,0,0,1,1
36613,जीटरेन,0,0,1,1
33461,ചാനലായ,0,0,1,1
33284,μέσω,0,0,1,1
48315,equivocadas,0,0,1,1
36061,проживет,0,0,1,1
49805,கட்டுரையையும்,0,0,1,1
52237,تكنولوجي,0,0,1,1
48316,säkerställda,0,0,1,1
49792,κέρδισε,0,0,1,1
36057,ಪಟ್ಟಣದ,0,0,1,1
33467,banimento,0,0,1,1
36056,ಕಳುಹಿಸಲು,0,0,1,1
52220,confundido,0,0,1,1
36496,உரிமம்,0,0,1,1
48038,trabajadas,0,0,1,1
48350,fiaskoer,0,0,1,1
49890,ويعتمد,0,0,1,1
52301,paradoxes,0,0,1,1
36497,компьютерные,0,0,1,1
48318,അവയെല്ലാം,0,0,1,1
36050,discourage,0,0,1,1
33325,interrumpiendo,0,0,1,1
49802,وخوادم,0,0,1,1
47952,مصطلح,0,0,1,1
52315,procedente,0,0,1,1
48349,frecuente,0,0,1,1
48036,casper,0,0,1,1
48320,"
इन",0,0,1,1
33322,விதத்தில்,0,0,1,1
33490,வர்த்தக,0,0,1,1
36500,önska,0,0,1,1
48034,captó,0,0,1,1
48321,fameux,0,0,1,1
49894,liking,0,0,1,1
36502,generelt,0,0,1,1
36608,raw,0,0,1,1
33492,علامة,0,0,1,1
36489,nessa,0,0,1,1
47948,பிழைத்திருத்தத்திற்குப்,0,0,1,1
33285,يتزوجني,0,0,1,1
36055,கட்டுரை”யொன்று,0,0,1,1
36610,enviar,0,0,1,1
36490,लेती,0,0,1,1
36491,artikelmaterial,0,0,1,1
36492,criminosas,0,0,1,1
33464,correspondante,0,0,1,1
36054,ചിന്തിക്കുക,0,0,1,1
36053,போலி,0,0,1,1
33466,istersiniz,0,0,1,1
50160,raderats,0,0,1,1
48039,tratava,0,0,1,1
48041,लंबे,0,0,1,1
48040,положение,0,0,1,1
33326,anlıyorum,0,0,1,1
50187,favoriete,0,0,1,1
36052,convoluted,0,0,1,1
50584,ഉച്ചരിക്കുകയാണെന്ന്,0,0,1,1
36609,succesvol,0,0,1,1
48351,avaliação,0,0,1,1
33468,stoppa,0,0,1,1
47951,прошлой,0,0,1,1
36065,comblé,0,0,1,1
47974,proppen,0,0,1,1
35999,wikipediaartikels,0,0,1,1
48059,എന്നിവർ,0,0,1,1
50190,يُنسب,0,0,1,1
33337,afuera,0,0,1,1
48061,anlatabilirsiniz,0,0,1,1
33458,κινείται,0,0,1,1
36075,لمقابلة,0,0,1,1
49791,​​vraag,0,0,1,1
48060,സാദ്ധ്യതയുണ്ട്,0,0,1,1
33336,bepaalde,0,0,1,1
36630,ಬದಲಾಗಿ,0,0,1,1
36467,annoncent,0,0,1,1
33496,slumpmässigt,0,0,1,1
33335,ξεφλουδίστηκε,0,0,1,1
36074,variáveis,0,0,1,1
33497,стран,0,0,1,1
48305,fashion,0,0,1,1
48306,തിരയിലിലൂടെ,0,0,1,1
47941,दौड़ी,0,0,1,1
36468,conducta,0,0,1,1
36073,"
उड़िया",0,0,1,1
52316,gemensamt,0,0,1,1
36072,bulunmaktadır,0,0,1,1
49881,relacione,0,0,1,1
50594,astronomers,0,0,1,1
48058,ficaria,0,0,1,1
36071,описанные,0,0,1,1
48057,മാസത്തെ,0,0,1,1
48062,источников,0,0,1,1
33338,gelmeyen,0,0,1,1
36629,autoaprentissage,0,0,1,1
48065,ذاهب,0,0,1,1
52317,ಡಿಗ್ರಿಗಿಂತ,0,0,1,1
49788,funções,0,0,1,1
33456,நைட்,0,0,1,1
33498,загрузки,0,0,1,1
33341,eetkamer,0,0,1,1
36633,pretendentes,0,0,1,1
50596,geheimnisvolles,0,0,1,1
49918,नमस्ते,0,0,1,1
50580,சாலடுகள்,0,0,1,1
48066,ಹಿಡಿಯಲಿಲ್ಲವೇ,0,0,1,1
36079,taste,0,0,1,1
36462,aménagés,0,0,1,1
52708,drunkning,0,0,1,1
36464,milletin,0,0,1,1
47939,गणना,0,0,1,1
36078,предложениям,0,0,1,1
36632,assustados,0,0,1,1
48063,ethnographique,0,0,1,1
36631,ارتكب,0,0,1,1
33276,acervo,0,0,1,1
33457,börjat,0,0,1,1
36077,ಪರೀಕ್ಷೆಗೆ,0,0,1,1
33340,முன்,0,0,1,1
36076,değişti,0,0,1,1
33339,undrade,0,0,1,1
36463,músicas,0,0,1,1
48355,arrêté,0,0,1,1
48055,dumb,0,0,1,1
36615,cunhou,0,0,1,1
36619,പുറകേ,0,0,1,1
36478,जताया,0,0,1,1
48053,വിലാസത്തിന്റെ,0,0,1,1
36066,ಮಂದ,0,0,1,1
49882,ತಲುಪಲು,0,0,1,1
48308,inspirer,0,0,1,1
36479,ешь,0,0,1,1
33282,ارجو,0,0,1,1
48033,अंक,0,0,1,1
50184,perpetrator,0,0,1,1
36480,köpek,0,0,1,1
36481,høje,0,0,1,1
33283,сотрудничестве,0,0,1,1
48052,thriller,0,0,1,1
33494,istemiyorsa,0,0,1,1
50163,forneçam,0,0,1,1
48051,अन्तर्गत,0,0,1,1
33330,потерял,0,0,1,1
50534,aldeia,0,0,1,1
49884,incrementa,0,0,1,1
36618,ಪೋರ್ಟಲ್ಗೆ,0,0,1,1
50155,arkadaşı,0,0,1,1
36482,kopyalamasını,0,0,1,1
36617,வீடியோவைப்,0,0,1,1
48353,alsjeblieft,0,0,1,1
36616,drown,0,0,1,1
35998,ചുവടെ,0,0,1,1
36621,generar,0,0,1,1
52219,structurées,0,0,1,1
49808,ocidental,0,0,1,1
36473,estágios,0,0,1,1
52694,противоречивые,0,0,1,1
33495,grise,0,0,1,1
36470,самая,0,0,1,1
47943,wikipediadag,0,0,1,1
36070,ഉപയോഗം,0,0,1,1
47944,desinformation,0,0,1,1
52218,الحمد,0,0,1,1
36471,uppmanar,0,0,1,1
36472,വഴിയല്ലാതെ,0,0,1,1
48307,logístico,0,0,1,1
36626,aesthetics,0,0,1,1
48054,ചതുപ്പിന്റെ,0,0,1,1
33278,nebula,0,0,1,1
49916,महत्त्व,0,0,1,1
33279,صلة،,0,0,1,1
36474,flaws,0,0,1,1
36625,leyó,0,0,1,1
52298,çıkmasına,0,0,1,1
36475,bear,0,0,1,1
36624,concentre,0,0,1,1
52707,sécurisées,0,0,1,1
33334,yararlanmasına,0,0,1,1
36476,комментарий,0,0,1,1
36477,ονειρεμένη,0,0,1,1
36068,டிசம்பர்,0,0,1,1
52695,நாட்டிற்கு,0,0,1,1
48309,facing,0,0,1,1
52303,procrastination,0,0,1,1
48322,qu’elle,0,0,1,1
36557,വിടപറഞ്ഞു,0,0,1,1
48346,taşlarından,0,0,1,1
36589,classé,0,0,1,1
36553,ಒಬ್ಬರು,0,0,1,1
33479,terço,0,0,1,1
49794,ludique,0,0,1,1
50157,voyager,0,0,1,1
36588,உருவாக்கப்பட்டு,0,0,1,1
50589,reisde,0,0,1,1
33292,caption,0,0,1,1
50590,научному,0,0,1,1
52225,anerkendt,0,0,1,1
36555,υψηλό,0,0,1,1
36556,الإجتماعيين,0,0,1,1
47993,കുറിച്ചും,0,0,1,1
33477,troops,0,0,1,1
33293,അമിതപ്രാധാന്യമാവാം,0,0,1,1
52224,hypothesized,0,0,1,1
36558,saati,0,0,1,1
36010,betrof,0,0,1,1
47992,fizera,0,0,1,1
33305,rendra,0,0,1,1
36587,парламентский,0,0,1,1
33480,வீடியோவுக்கு,0,0,1,1
47989,البحث،,0,0,1,1
36029,σύζυγος,0,0,1,1
36586,இற்றைப்படுத்தப்படுவதேயாகும்,0,0,1,1
52701,stoppet,0,0,1,1
36562,ഡൈനിംഗ്,0,0,1,1
36552,السعيد,0,0,1,1
36551,ptmwikipediaorg,0,0,1,1
49911,préconisent,0,0,1,1
36590,raisonnement,0,0,1,1
47966,høj,0,0,1,1
36548,seemed,0,0,1,1
36037,झिझक,0,0,1,1
50539,കാമുകിയോ,0,0,1,1
33485,spirit,0,0,1,1
36035,вопросы,0,0,1,1
50535,écrasements,0,0,1,1
48000,illaluktande,0,0,1,1
49900,preguntando,0,0,1,1
47999,متحيزًا,0,0,1,1
36034,действительные,0,0,1,1
49799,laid,0,0,1,1
36033,entorpecen,0,0,1,1
48336,recolección,0,0,1,1
52226,هبوط,0,0,1,1
47967,தொடக்கத்திற்குப்,0,0,1,1
36591,amont,0,0,1,1
49901,καθρέφτη,0,0,1,1
47997,faux,0,0,1,1
48337,processing‏,0,0,1,1
50538,ചെയ്യാമെന്ന്,0,0,1,1
49912,écrite,0,0,1,1
52314,critiquent,0,0,1,1
52308,मालूम।,0,0,1,1
47996,интеллект,0,0,1,1
47995,യന്ത്രപഠനത്തിലാകട്ടെ,0,0,1,1
47968,заболоченный,0,0,1,1
36563,dits,0,0,1,1
36028,especulou,0,0,1,1
36564,التجارية,0,0,1,1
36023,தரப்பில்,0,0,1,1
47981,предоставляется,0,0,1,1
36575,avanços,0,0,1,1
47980,uyarılmaktadır,0,0,1,1
52311,அண்மைய,0,0,1,1
47978,kalitesi,0,0,1,1
52699,описываются,0,0,1,1
48344,vo •,0,0,1,1
36013,fairness,0,0,1,1
33484,confundem,0,0,1,1
49907,librement,0,0,1,1
47975,представлять,0,0,1,1
33299,siglos,0,0,1,1
48345,തെറ്റായ,0,0,1,1
36021,irmã,0,0,1,1
36015,kurallarından,0,0,1,1
49795,ويصفون,0,0,1,1
47972,"
बिकोल",0,0,1,1
47973,kültürlü,0,0,1,1
36016,δυστυχώς,0,0,1,1
36020,rejetés,0,0,1,1
36577,redunda,0,0,1,1
33482,heimlich,0,0,1,1
36578,астрономами,0,0,1,1
36579,സാധിക്കും,0,0,1,1
36580,immangeable,0,0,1,1
33298,ಥಂಬ್ಸ್,0,0,1,1
50186,டிரைவ்வேயை,0,0,1,1
33302,backgrounds,0,0,1,1
33303,formeel,0,0,1,1
36565,kalkylprogram,0,0,1,1
49906,плачете,0,0,1,1
49798,требуется,0,0,1,1
47988,ചിലത്,0,0,1,1
49797,दयालु,0,0,1,1
47987,hörnet,0,0,1,1
52309,vernuftig,0,0,1,1
36026,masturbação,0,0,1,1
36567,المسجليين,0,0,1,1
49904,финансировании,0,0,1,1
33295,écologiques,0,0,1,1
36568,ಕೇಳುತ್ತೇನೆ,0,0,1,1
36569,korean,0,0,1,1
36584,മലയാള,0,0,1,1
52313,grouping,0,0,1,1
49905,paquetes,0,0,1,1
48340,முக்கியமான,0,0,1,1
48341,náhuatl,0,0,1,1
36583,wikipediametadata,0,0,1,1
47986,faydasızdı,0,0,1,1
36570,compañeros,0,0,1,1
33296,पोस्टिंग,0,0,1,1
36582,எடுத்து,0,0,1,1
48342,eigenen,0,0,1,1
47985,hu •,0,0,1,1
33481,tactics,0,0,1,1
36571,содержащий,0,0,1,1
47984,planeo,0,0,1,1
36573,schönes,0,0,1,1
52698,സമർപ്പിക്കപ്പെടുന്ന,0,0,1,1
48002,ratios,0,0,1,1
36047,κεφάλι,0,0,1,1
48324,spill,0,0,1,1
36045,hermosos,0,0,1,1
36515,tornarse,0,0,1,1
33472,partnered,0,0,1,1
33473,desarrollamos,0,0,1,1
48022,"
माज़न्दारिनी",0,0,1,1
36602,φανταχτερά,0,0,1,1
36517,parlementaires,0,0,1,1
33290,ഇന്ത്യയിൽ,0,0,1,1
52221,televisión,0,0,1,1
47955,la •,0,0,1,1
33315,révolutions,0,0,1,1
48021,écrits,0,0,1,1
36519,ಕೇವಲ,0,0,1,1
36600,deemed,0,0,1,1
50185,богат,0,0,1,1
48020,xanadu,0,0,1,1
36520,дворце,0,0,1,1
48325,बिग,0,0,1,1
36521,decirnos,0,0,1,1
36522,söylediğinde,0,0,1,1
36523,ஒரே,0,0,1,1
49896,ortaya,0,0,1,1
33475,hastily,0,0,1,1
36524,craintes,0,0,1,1
33314,அமர்த்த,0,0,1,1
48019,وأنواع,0,0,1,1
48326,أخبرني,0,0,1,1
36526,activist,0,0,1,1
48023,அட்டூழியம்,0,0,1,1
36514,ужасном,0,0,1,1
36513,logowedstrijd,0,0,1,1
33316,accesserna,0,0,1,1
47953,copyrights,0,0,1,1
36504,rettigheder,0,0,1,1
36505,carrying,0,0,1,1
36605,ciddiye,0,0,1,1
33287,ayudarlo,0,0,1,1
48032,sällan,0,0,1,1
50541,people ,0,0,1,1
49793,விளம்பரங்களைக்,0,0,1,1
36507,പാഴ്‌മെയിലാണോയെന്ന്,0,0,1,1
48031,lock,0,0,1,1
48030,partis,0,0,1,1
36508,негибко,0,0,1,1
48028,ಇದಕ್ಕಾಗಿ,0,0,1,1
52704,substitutions,0,0,1,1
52234,ഒന്നാം,0,0,1,1
52233,கால்களை,0,0,1,1
36017,courant,0,0,1,1
36604,κινητό,0,0,1,1
48027,histórico,0,0,1,1
33319,shared,0,0,1,1
36603,delats,0,0,1,1
33318,फुल्का,0,0,1,1
48025,ಹಿಂತಿರುಗಿಸುತ್ತೇನೆ,0,0,1,1
50156,υπερβάλλετε,0,0,1,1
48024,abandonada,0,0,1,1
36512,bornes,0,0,1,1
33317,amatörer,0,0,1,1
48018,karin,0,0,1,1
36527,रॉय,0,0,1,1
36599,அதிநவீனமாக,0,0,1,1
48009,يجعل,0,0,1,1
48333,sürükleyebilir,0,0,1,1
48008,звонка,0,0,1,1
36542,ಚಲಿಸುವ,0,0,1,1
33309,öyle,0,0,1,1
36006,exclusivity,0,0,1,1
33308,تتعلم,0,0,1,1
33487,பகுதிகளில்,0,0,1,1
48007,laissent,0,0,1,1
33307,anlatabilir,0,0,1,1
47963,желаем,0,0,1,1
36543,tændt,0,0,1,1
36595,تهدئة,0,0,1,1
36594,parabenizar,0,0,1,1
36593,advantage,0,0,1,1
48334,açıklar,0,0,1,1
49913,reklamsız,0,0,1,1
47964,issu,0,0,1,1
48006,महिलाओं,0,0,1,1
52307,αδελφά,0,0,1,1
48003,ஃபேஸ்புக்,0,0,1,1
48335,പരിഗണിക്കുന്നു,0,0,1,1
33486,trubbigt,0,0,1,1
52238,ಕನ್ನಡಿಯಲ್ಲಿ,0,0,1,1
47965,ലഭിക്കും,0,0,1,1
36547,разве,0,0,1,1
50540,பதிப்பில்,0,0,1,1
52223,تدور,0,0,1,1
47962,beneficial,0,0,1,1
49897,заведомо,0,0,1,1
36528,ifadelerine,0,0,1,1
52230,தொடங்குவதற்கு,0,0,1,1
47956,alberto,0,0,1,1
47957,предпочтения,0,0,1,1
36529,تجاوزت,0,0,1,1
36530,прослушайте,0,0,1,1
48017,கேளுங்கள்,0,0,1,1
52306,பெரும்பாலான,0,0,1,1
49914,partit,0,0,1,1
52697,ബ്യൂറോക്രാറ്റുകളേയും,0,0,1,1
48348,സാമാന്യവത്കരണത്തെയും,0,0,1,1
36533,அருமையான,0,0,1,1
33313,tí,0,0,1,1
48328,nimmst,0,0,1,1
33312,finden,0,0,1,1
48013,ensaladas,0,0,1,1
36535,влияние,0,0,1,1
47961,карьеры,0,0,1,1
33311,ചിന്തിക്കാൻ,0,0,1,1
33310,econômica,0,0,1,1
36537,thailand,0,0,1,1
48011,unreadable,0,0,1,1
33488,«усилия,0,0,1,1
36043,copo,0,0,1,1
36042,जाऊं,0,0,1,1
48329,எதையும்,0,0,1,1
36539,बचाव,0,0,1,1
48330,acelerou,0,0,1,1
48010,сторону,0,0,1,1
50553,ಅನುಮತಿ,0,0,1,1
33451,വായിക്കുന്നു,0,0,1,1
52679,установлена,0,0,1,1
48190,uyandım,0,0,1,1
52267,классическим,0,0,1,1
33385,offrir,0,0,1,1
48191,பயன்படுத்துவது,0,0,1,1
36290,respekterar,0,0,1,1
48192,volumen,0,0,1,1
36289,ickevinstinriktade,0,0,1,1
36288,finance,0,0,1,1
33429,descumprem,0,0,1,1
36287,comenzado,0,0,1,1
36286,имеется,0,0,1,1
36156,ويقوم,0,0,1,1
33386,assuré,0,0,1,1
36285,أسئلة,0,0,1,1
36284,entails,0,0,1,1
48255,الملح،,0,0,1,1
36291,inició,0,0,1,1
36292,freude,0,0,1,1
36283,« philosophie,0,0,1,1
49821,årsförbrukning,0,0,1,1
50566,obviamente,0,0,1,1
36298,ليه،,0,0,1,1
36297,расстроен,0,0,1,1
33383,вебсерверов,0,0,1,1
36296,selfguided,0,0,1,1
36295,fréquentés,0,0,1,1
36153,ആക്റ്റിവിസത്തിന്റെ,0,0,1,1
52687,clin,0,0,1,1
48259,доступных,0,0,1,1
48258,नींद,0,0,1,1
36294,retener,0,0,1,1
48187,ഉറവിടം,0,0,1,1
36155,எழுதப்பட்ட,0,0,1,1
33384,arguably,0,0,1,1
48256,സാമാന്യവത്കരണം,0,0,1,1
52280,நூலகம்,0,0,1,1
52279,σύγχυση,0,0,1,1
36262,பீட்சா,0,0,1,1
33391,åttonde,0,0,1,1
36162,അനാശാസ്യമായ,0,0,1,1
36272,requérant,0,0,1,1
50563,فامنحه,0,0,1,1
36270,återgavs,0,0,1,1
36269,yolculuk,0,0,1,1
48252,இவை,0,0,1,1
36268,olacaktır,0,0,1,1
36267,élevés,0,0,1,1
50562,ملابس,0,0,1,1
36265,knowledgebased,0,0,1,1
48201,தலைமை,0,0,1,1
33425,conhecêlo,0,0,1,1
33424,побудило,0,0,1,1
48202,aptal,0,0,1,1
48250,استعداد,0,0,1,1
33426,απέρριψε,0,0,1,1
48198,samband,0,0,1,1
48254,myntas,0,0,1,1
33390,undgår,0,0,1,1
36159,ಎಚ್ಚರವಾಯಿತು,0,0,1,1
36281,பயிற்சி,0,0,1,1
50551,الالتقاط,0,0,1,1
36280,romantique,0,0,1,1
48194,சேர்த்து,0,0,1,1
48195,kallt,0,0,1,1
50564,anımsattıkları”,0,0,1,1
49845,ಹುಚ್ಚನಂತೆ,0,0,1,1
36278,parodiadas,0,0,1,1
33388,« réseau,0,0,1,1
36277,bienfondé,0,0,1,1
36160,trophy,0,0,1,1
36275,недостоверность,0,0,1,1
49844,اختباري,0,0,1,1
36161,sujetb,0,0,1,1
36299,techné« l,0,0,1,1
48184,पुस्तकालय,0,0,1,1
36152,héberger,0,0,1,1
33434,сенсация,0,0,1,1
36324,søvnen,0,0,1,1
50545,πρώτος,0,0,1,1
48171,ಮುಳುಗುತ್ತಿದ್ದೇನೆ,0,0,1,1
47935,filtre,0,0,1,1
36140,déclaré,0,0,1,1
36322,τρομερός,0,0,1,1
48269,jämförde,0,0,1,1
48267,τηλεγραφήματος,0,0,1,1
36142,essentielles,0,0,1,1
36320,потерянное,0,0,1,1
50546,indsats,0,0,1,1
36143,αρέσει,0,0,1,1
36319,baisser,0,0,1,1
36144,கேட்கவும்,0,0,1,1
48174,विशेषकर,0,0,1,1
52283,jv •,0,0,1,1
36325,ülkeye,0,0,1,1
36301,статьями,0,0,1,1
36326,подборку,0,0,1,1
48271,spisebordet,0,0,1,1
49851,имел,0,0,1,1
36330,самого,0,0,1,1
36329,редакционным,0,0,1,1
48170,συγχαρώ,0,0,1,1
36137,montrer,0,0,1,1
36138,indenfor,0,0,1,1
33378,sahen,0,0,1,1
33379,информатизация,0,0,1,1
49817,معاكسة,0,0,1,1
36327,хорошие,0,0,1,1
49850,recebido,0,0,1,1
50569,बायोलोजी,0,0,1,1
50181,ontwikkelen,0,0,1,1
36139,சூழலில்,0,0,1,1
50173,reddettiğinden,0,0,1,1
50547,orientados,0,0,1,1
33433,प्रवक्ता,0,0,1,1
36318,தோல்விகளுக்குப்,0,0,1,1
49819,nodige,0,0,1,1
36309,“சிஎசுஎசு”,0,0,1,1
48261,robots ,0,0,1,1
36150,silabarios,0,0,1,1
49820,विकिअलिटी,0,0,1,1
48182,படையினருக்கு,0,0,1,1
36308,popcultuur,0,0,1,1
36307,വിജ്ഞാനപ്രദമായ,0,0,1,1
36306,bristen,0,0,1,1
48183,concurrents,0,0,1,1
36305,impulso,0,0,1,1
33430,цене,0,0,1,1
36304,springe,0,0,1,1
52688,википроектов,0,0,1,1
52265,undersökts,0,0,1,1
48180,entrainement,0,0,1,1
36311,especificar,0,0,1,1
36312,ligt,0,0,1,1
52261,habituel,0,0,1,1
36317,molestia,0,0,1,1
33380,wondering,0,0,1,1
50567,добровольцами,0,0,1,1
48264,الطاولة,0,0,1,1
36147,அழைக்க,0,0,1,1
49818,kurulmuştur,0,0,1,1
36315,documentário,0,0,1,1
48179,handwritten,0,0,1,1
48262,«иракская,0,0,1,1
49848,proposer,0,0,1,1
33432,neuf,0,0,1,1
36149,ordu,0,0,1,1
52262,"
वॉलून",0,0,1,1
36313,கண்காணிக்கப்படுகின்றன,0,0,1,1
49843,അതിനടുത്തുള്ള,0,0,1,1
48205,плюрипотентное,0,0,1,1
48067,μάθω,0,0,1,1
36178,കണ്ണുകളും,0,0,1,1
36217,répartition,0,0,1,1
33415,ingresan,0,0,1,1
48233,तरीकों,0,0,1,1
36215,cortos,0,0,1,1
48241,samfundsvidenskab,0,0,1,1
36214,vikipedistler,0,0,1,1
52275,perfeita,0,0,1,1
36213,спектр,0,0,1,1
36212,μαθητές,0,0,1,1
50176,imprecise,0,0,1,1
36211,mutación,0,0,1,1
33407,игру,0,0,1,1
33408,पन्ना,0,0,1,1
49831,disant,0,0,1,1
49825,είπαν,0,0,1,1
33405,секрет,0,0,1,1
33404,andor,0,0,1,1
36208,ತಾಯಿಯಲ್ಲ,0,0,1,1
36219,uzmanlık,0,0,1,1
33402,ಒಪ್ಪಿಕೊಳ್ಳಿ,0,0,1,1
36177,чихнул,0,0,1,1
36227,решались,0,0,1,1
36226,"
स्लोवाक",0,0,1,1
48230,matbordet,0,0,1,1
33403,uppslagsverksartikel,0,0,1,1
48243,archief,0,0,1,1
49832,расслышал,0,0,1,1
33416,гриффитом,0,0,1,1
48242,drømte,0,0,1,1
52274,yakalayıp,0,0,1,1
36224,framför,0,0,1,1
36223,snail,0,0,1,1
36222,enriquecedor,0,0,1,1
36221,मल्टिपल,0,0,1,1
33409,motkultur,0,0,1,1
52276,femenino,0,0,1,1
33393,starving,0,0,1,1
48237,كثيرا,0,0,1,1
36193,छोड़ने,0,0,1,1
50552,benadrukken,0,0,1,1
36181,ಸಾಲ,0,0,1,1
33413,ಪ್ರಸಿದ್ಧ,0,0,1,1
36192,impedir,0,0,1,1
36182,வந்தன,0,0,1,1
36191,हाइपरलिंक,0,0,1,1
48239,любимое,0,0,1,1
36190,интерфейс,0,0,1,1
48238,exponencial,0,0,1,1
36188,universitetsnivå,0,0,1,1
49828,"
नॉर्वेजियाई",0,0,1,1
36187,üçüncü,0,0,1,1
52277,réseau »,0,0,1,1
36185,håndtere,0,0,1,1
50554,högskolebibliotekarien,0,0,1,1
50177,томах,0,0,1,1
48234,публикуется,0,0,1,1
36196,പറ്റില്ല,0,0,1,1
36206,reichtümer,0,0,1,1
48235,angenehmes,0,0,1,1
36204,débit,0,0,1,1
36203,pose,0,0,1,1
36202,anförts,0,0,1,1
36201,bırakılmış,0,0,1,1
36200,acontece,0,0,1,1
48236,offentlighed,0,0,1,1
49827,अधिकारिक,0,0,1,1
33410,нах,0,0,1,1
36198,hasard,0,0,1,1
49830,instalan,0,0,1,1
36197,perjuicio,0,0,1,1
49829,पुनर्वितरण,0,0,1,1
36180,والفكاهة,0,0,1,1
48229,slid,0,0,1,1
49833,ಹಸಿದಿಲ್ಲ,0,0,1,1
33401,rubies,0,0,1,1
52270,conhecidos,0,0,1,1
36250,быстрые,0,0,1,1
36249,ζαμάνια,0,0,1,1
49841,സന്തുലിതമായ,0,0,1,1
33422,الخوف,0,0,1,1
48210,girdiyse,0,0,1,1
33397,planter,0,0,1,1
36248,سألتقي,0,0,1,1
36247,software​,0,0,1,1
36168,अगला,0,0,1,1
48211,suscetível,0,0,1,1
48212,existed,0,0,1,1
36246,constitué,0,0,1,1
36245,decidir,0,0,1,1
33398,öneriler,0,0,1,1
36169,hoor,0,0,1,1
36251,темпе,0,0,1,1
48209,ക്രിയയായി,0,0,1,1
36176,anglosajón,0,0,1,1
33395,özrümü,0,0,1,1
36261,formado,0,0,1,1
50174,satisfacer,0,0,1,1
36260,злотых,0,0,1,1
36167,trubbiga,0,0,1,1
33394,nauruano,0,0,1,1
49842,προτιμούσα,0,0,1,1
36259,ದೇವದೂತನಂತೆ,0,0,1,1
36258,ತಯಾರಿಸಲು,0,0,1,1
36257,നിലനിൽപ്പുണ്ടാവൂ,0,0,1,1
48206,gfdl —,0,0,1,1
36255,ಒಬಾಮಾ,0,0,1,1
48207,behandelt,0,0,1,1
48249,  €,0,0,1,1
36254,huwelijk,0,0,1,1
48208,ангелом,0,0,1,1
33421,teams,0,0,1,1
52271,لكل,0,0,1,1
36170,مقالات،,0,0,1,1
50557,تكرار,0,0,1,1
36236,talloze,0,0,1,1
36235,ಪ್ರೇರೇಪಿಸುತ್ತದೆ,0,0,1,1
36234,içeriklerinde,0,0,1,1
36233,embaucher,0,0,1,1
49836,powerful,0,0,1,1
48227,avsevärt,0,0,1,1
48245,suivantes ,0,0,1,1
50555,testet,0,0,1,1
52273,увидимся,0,0,1,1
52278,intimate,0,0,1,1
36174,ترقية,0,0,1,1
36231,λειτουργεί,0,0,1,1
36175,questão,0,0,1,1
49834,ejercen,0,0,1,1
48244,"
तेलुगू",0,0,1,1
52272,daarbij,0,0,1,1
48226,campaign,0,0,1,1
48224,درس,0,0,1,1
36240,finsk,0,0,1,1
48215,भौतिक,0,0,1,1
48216,ranting,0,0,1,1
49838,engelskspråkigt,0,0,1,1
48248,प्रणालीगत,0,0,1,1
50179,​​enorme,0,0,1,1
33399,citat,0,0,1,1
36239,мамой,0,0,1,1
49837,കിട്ടി,0,0,1,1
36238,كينيدي,0,0,1,1
48220,kk •,0,0,1,1
48221,rato,0,0,1,1
36237,स्लेशडॉट,0,0,1,1
33419,”can,0,0,1,1
49824,என்பதோடு,0,0,1,1
36136,гриллини,0,0,1,1
50172,முடியாவிட்டால்,0,0,1,1
36332,conotação,0,0,1,1
48296,idi,0,0,1,1
49870,platz,0,0,1,1
33355,flooding,0,0,1,1
36418,sugestões,0,0,1,1
36099,likewise,0,0,1,1
36100,தண்ணீர்,0,0,1,1
36417,λίγα,0,0,1,1
48098,αντιγράψετε,0,0,1,1
36101,உலகின்,0,0,1,1
36102,haces,0,0,1,1
48294,trails,0,0,1,1
48099,учётной,0,0,1,1
36104,enregistrés,0,0,1,1
50183,опубликованными,0,0,1,1
36105,وجمالها,0,0,1,1
48101,consécutifs,0,0,1,1
36419,ಸಿದ್ಧವಾಗಿದೆ,0,0,1,1
36097,franchecomté,0,0,1,1
33447,schrok,0,0,1,1
49872,ಮಾಡಬಹುದೇ,0,0,1,1
36426,yiyecekler,0,0,1,1
49874,легче,0,0,1,1
50168,continuamente,0,0,1,1
36425,«„википедия“,0,0,1,1
36093,ലക്ഷത്തിനടുത്ത്,0,0,1,1
36094,enfaticamente,0,0,1,1
36424,« chaque,0,0,1,1
48095,—se,0,0,1,1
48096,bloquea,0,0,1,1
36423,ولديك,0,0,1,1
36422,gepubliceerd,0,0,1,1
48297,сообщества,0,0,1,1
48097,amnesty,0,0,1,1
33449,perfection,0,0,1,1
36095,التوثيق,0,0,1,1
48292,oopsla,0,0,1,1
50542,probeert,0,0,1,1
50544,kitaplarda,0,0,1,1
50169,gruwelijk,0,0,1,1
36109,vardığında,0,0,1,1
52246,японскими,0,0,1,1
48290,insistent,0,0,1,1
36407,tackling,0,0,1,1
33359,बिलकुल।,0,0,1,1
36111,تغطية,0,0,1,1
50575,вид,0,0,1,1
48110,художник,0,0,1,1
36406,rechtes,0,0,1,1
52692,такая,0,0,1,1
33360,динамику,0,0,1,1
36405,حقول,0,0,1,1
50170,என்னுடன்,0,0,1,1
33444,menge,0,0,1,1
48111,потерпи,0,0,1,1
33445,conceitos,0,0,1,1
36108,फ़ाइलें,0,0,1,1
33356,tust,0,0,1,1
36409,ಅವುಗಳಲ್ಲಿ,0,0,1,1
36414,diego,0,0,1,1
48102,anweisungen,0,0,1,1
33357,الإسبانية،,0,0,1,1
48103,vérification,0,0,1,1
49868,ಬರುತ್ತಾರೆ,0,0,1,1
48105,exploratory,0,0,1,1
36413,கண்ணியமான,0,0,1,1
36412,மனிதர்களாக,0,0,1,1
49867,vietnamese,0,0,1,1
36106,weiteren,0,0,1,1
36411,protective,0,0,1,1
52244,"
basco",0,0,1,1
52245,تقولها,0,0,1,1
52289,маленькой,0,0,1,1
50576,вандализирующими,0,0,1,1
49875,സൂചിപ്പിക്കാൻ,0,0,1,1
36427,άφησέ,0,0,1,1
48093,interessant,0,0,1,1
36449,choice,0,0,1,1
36447,உற்சாகமாக,0,0,1,1
36085,കോണാണ്,0,0,1,1
48075,вверху,0,0,1,1
36446,внесена,0,0,1,1
48301,ಜಾಮ್‌ಗಳನ್ನು,0,0,1,1
36445,координируются,0,0,1,1
36444,administrativos,0,0,1,1
48300,रहना।,0,0,1,1
52239,ಇತ್ತು,0,0,1,1
36086,ಒನ್,0,0,1,1
36087,पानी,0,0,1,1
33344,يصبحن,0,0,1,1
52293,schmieden,0,0,1,1
52292,défunte,0,0,1,1
48078,stirrade,0,0,1,1
36448,ತಂಪಾಗಿದೆ,0,0,1,1
36450,вечеринке,0,0,1,1
52242,hazır,0,0,1,1
52294,germanlanguage,0,0,1,1
36459,​​denne,0,0,1,1
50579,باللغات,0,0,1,1
36457,pojke,0,0,1,1
48069,всей,0,0,1,1
49879,ഭയമായിരുന്നു,0,0,1,1
48303,அனைத்தும்,0,0,1,1
36455,göremezsiniz,0,0,1,1
33343,«central»,0,0,1,1
36454,கிடைக்காதபோது,0,0,1,1
48302,intéressantes,0,0,1,1
36083,ಮಾಡುತ್ತೇನೆಂದರೆ,0,0,1,1
48073,सिर,0,0,1,1
36452,συνομιλίας,0,0,1,1
50578,ಅಸಭ್ಯವಾಗಿ,0,0,1,1
36084,തിരിച്ചറിയാൻ,0,0,1,1
36440,ആരംഭിക്കുന്നത്,0,0,1,1
48079,neşelendirmek,0,0,1,1
36438,notify,0,0,1,1
48080,anglófono,0,0,1,1
36091,виргиния,0,0,1,1
36433,novelties,0,0,1,1
50167,grown,0,0,1,1
36184,vectors,0,0,1,1
36432,استهدفت,0,0,1,1
48090,değmediğini,0,0,1,1
48091,ಪ್ರಶಂಸಿಸುತ್ತೇನೆ,0,0,1,1
33350,licenciado,0,0,1,1
33450,jurken,0,0,1,1
36092,säkert,0,0,1,1
36431,snabbheten,0,0,1,1
48092,فازت,0,0,1,1
36429,имеющее,0,0,1,1
36428,internetencyclopedie,0,0,1,1
48298,tidsskrifter,0,0,1,1
48089,வாசிக்கும்,0,0,1,1
33452,கூட்டாக,0,0,1,1
48088,والمساهمين،,0,0,1,1
33453,"
tailandês",0,0,1,1
50577,कमजोर,0,0,1,1
33454,поддающимися,0,0,1,1
48082,exata,0,0,1,1
48083,മേഖല,0,0,1,1
48085,afogamento,0,0,1,1
36437,усталым,0,0,1,1
49810,ms •,0,0,1,1
50165,சனிக்கிழமை,0,0,1,1
48299,провести,0,0,1,1
36088,എന്നതൊക്കെ,0,0,1,1
49876,उँगलियों,0,0,1,1
33346,bulundurur,0,0,1,1
36436,muero,0,0,1,1
33347,καλύπτει,0,0,1,1
52247,أمستردام،,0,0,1,1
48289,zulke,0,0,1,1
49865,l’automatisation,0,0,1,1
36128,blacklist,0,0,1,1
48148,relicenciar,0,0,1,1
36129,thésaurus,0,0,1,1
48277,يقاس,0,0,1,1
52255,السيرة,0,0,1,1
48149,inédite,0,0,1,1
52287,lignende,0,0,1,1
36130,émergente,0,0,1,1
36353,масштабах,0,0,1,1
48150,metrix,0,0,1,1
36352,biographical,0,0,1,1
48151,cdi,0,0,1,1
52690,kaba,0,0,1,1
36350,jardim,0,0,1,1
48276,« tapez,0,0,1,1
33374,अश्लील,0,0,1,1
33372,طلاقة,0,0,1,1
52254,lu,0,0,1,1
52252,olmasıdır,0,0,1,1
36356,சீரான,0,0,1,1
33440,متقاطعة,0,0,1,1
48141,afogar,0,0,1,1
36127,chef,0,0,1,1
36364,अपमान,0,0,1,1
48143,dépassant,0,0,1,1
33371,ஆசிரியர்,0,0,1,1
48144,दिलाना,0,0,1,1
36361,correctoras,0,0,1,1
36360,வர்த்தகம்,0,0,1,1
36359,защита,0,0,1,1
48145,அறிவியல்,0,0,1,1
36358,israeli,0,0,1,1
52253,«подобное,0,0,1,1
36357,rit,0,0,1,1
48146,للمقالة،,0,0,1,1
36132,المشكلات,0,0,1,1
36349,поговорим,0,0,1,1
36133,fictitious,0,0,1,1
36348,shortening,0,0,1,1
33438,polémiques,0,0,1,1
33437,provável,0,0,1,1
36339,condemned,0,0,1,1
48163,uiquipedia,0,0,1,1
36134,обществом,0,0,1,1
36337,publiken,0,0,1,1
49852,الإطلاق،,0,0,1,1
48165,aturdido,0,0,1,1
36335,helaas,0,0,1,1
48166,знак,0,0,1,1
48274,чувствуете,0,0,1,1
48273,nail,0,0,1,1
48167,hilfreich,0,0,1,1
52284,bibliotheken,0,0,1,1
36135,macroecosystem,0,0,1,1
36340,agricoles,0,0,1,1
48275,प्रसंग,0,0,1,1
48162,stopte,0,0,1,1
48156,يشبهونني,0,0,1,1
48155,apparaten,0,0,1,1
52681,страну,0,0,1,1
33375,tas,0,0,1,1
36346,الأمريكيين,0,0,1,1
49815,defended,0,0,1,1
36345,modstridende,0,0,1,1
36344,മധുരമുള്ള,0,0,1,1
50571,spammers,0,0,1,1
48157,söylediği,0,0,1,1
36342,αποθήκη,0,0,1,1
33376,علمية كتبت,0,0,1,1
48158,tusind,0,0,1,1
48160,موقعًا,0,0,1,1
52258,reinvention,0,0,1,1
33370,широкому,0,0,1,1
33369,диване,0,0,1,1
49864,hæng,0,0,1,1
48117,संवेदनशीलता,0,0,1,1
48118,टक्कर,0,0,1,1
36390,vollständig,0,0,1,1
33443,அதிகப்,0,0,1,1
48119,όνειρά,0,0,1,1
48120,உயர்த்தலாம்,0,0,1,1
36388,англоязычной,0,0,1,1
36387,colabora,0,0,1,1
49812,definan,0,0,1,1
36386,arrive,0,0,1,1
36120,المنسقة,0,0,1,1
48283,"
क्या",0,0,1,1
52250,"
वियतनामी",0,0,1,1
36385,gratulieren,0,0,1,1
49860,reflet,0,0,1,1
36383,respond,0,0,1,1
36392,الأخطاء,0,0,1,1
36119,பாடத்தில்,0,0,1,1
36126,incidenter,0,0,1,1
48284,hittas,0,0,1,1
50543,поисковых,0,0,1,1
36402,أتساءل,0,0,1,1
48286,elbiselerden,0,0,1,1
36115,വെട്ടി,0,0,1,1
36401,praticar,0,0,1,1
48112,promu,0,0,1,1
48113,gives,0,0,1,1
48285,مستقرًا,0,0,1,1
36117,spijker,0,0,1,1
49861,olycklig,0,0,1,1
36396,ಬಂದನು,0,0,1,1
36395,ಉಗುರು,0,0,1,1
36394,ortasındayken,0,0,1,1
36118,άκουσε,0,0,1,1
48116,fournie,0,0,1,1
48121,"
tâmil",0,0,1,1
48122,praktiken,0,0,1,1
48123,количество,0,0,1,1
36380,foran,0,0,1,1
36373,belongs,0,0,1,1
36372,വിജ്ഞാനതൃഷ്ണയുമുള്ള,0,0,1,1
48134,gelinliğimi,0,0,1,1
36371,βυθίζεται,0,0,1,1
50182,burocratas,0,0,1,1
49855,മികച്ചതാണ്,0,0,1,1
33366,ಟಾಪ್,0,0,1,1
48278,rejoignit,0,0,1,1
50171,veinte,0,0,1,1
50573,uddannede,0,0,1,1
33368,posicionó,0,0,1,1
36124,svært,0,0,1,1
48139,ബട്ടണും,0,0,1,1
36125,kalmaktadır,0,0,1,1
48140,chegaram,0,0,1,1
36374,eis,0,0,1,1
48133,fordele,0,0,1,1
49856,detail,0,0,1,1
36123,consideran,0,0,1,1
48282,மகிழ்ச்சி,0,0,1,1
48124,"
galego",0,0,1,1
33441,أشغال,0,0,1,1
33365,gesloten,0,0,1,1
36379,கேள்விக்கு,0,0,1,1
36378,retrata,0,0,1,1
48281,akademisk,0,0,1,1
48129,cümlenin,0,0,1,1
48125,beleidigung,0,0,1,1
48126,foods,0,0,1,1
50574,avancerad,0,0,1,1
48279,αγώνας,0,0,1,1
49859,utilizadores,0,0,1,1
48127,अंगूठे,0,0,1,1
36634,الأيديولوجية,0,0,1,1
47830,हटा,0,0,1,1
36636,maden,0,0,1,1
50132,какаято,0,0,1,1
37243,evolucionan,0,0,1,1
33045,множества,0,0,1,1
37241,гибкая,0,0,1,1
47516,يأتون,0,0,1,1
33047,comenzaba,0,0,1,1
37239, k,0,0,1,1
37238,roter,0,0,1,1
52129,வழமையாக,0,0,1,1
52130,ನೀಡುತ್ತಿದೆ,0,0,1,1
37235,أقرت,0,0,1,1
50653,среднем,0,0,1,1
33049,förutsatt,0,0,1,1
47519,englischsprachigen,0,0,1,1
33050,arrivée,0,0,1,1
37233,بالخوف,0,0,1,1
52735,sesgadas,0,0,1,1
50043,ударилась,0,0,1,1
50042,traummutter,0,0,1,1
52131,ओ,0,0,1,1
37232,författats,0,0,1,1
33044,ಕಳುಹಿಸುತ್ತೇನೆ,0,0,1,1
50131,поисковыми,0,0,1,1
37244,enciclopédicos,0,0,1,1
37245,mensageiro,0,0,1,1
50656,leyes,0,0,1,1
47506,hours,0,0,1,1
33037,बजे,0,0,1,1
47507,ευτυχισμένος,0,0,1,1
47508,reverses,0,0,1,1
37252,ಸುತ್ತುವ,0,0,1,1
33038,instantaneamente,0,0,1,1
37251,privilegier,0,0,1,1
47509,நெரிசல்கள்,0,0,1,1
37250,понравится,0,0,1,1
37249,несогласия,0,0,1,1
33041,αναβαθμίστε,0,0,1,1
37248,vibber,0,0,1,1
33042,distribuciones,0,0,1,1
47513,mantente,0,0,1,1
37247,iyiler,0,0,1,1
50045,opened,0,0,1,1
33043,yöntemleri,0,0,1,1
50655,affärer,0,0,1,1
50041,ativos,0,0,1,1
52132,nietbestaande,0,0,1,1
37231,الأحرف,0,0,1,1
33058,ഒന്നു,0,0,1,1
50033,bevakar,0,0,1,1
33059,insana,0,0,1,1
50032,cevaplamak,0,0,1,1
37214,impossibilité,0,0,1,1
33060,случайно,0,0,1,1
33061,темы,0,0,1,1
47537,remerciant,0,0,1,1
47539,ரொட்டியில்,0,0,1,1
37212,விளையாட்டை,0,0,1,1
37211,നടത്തിയ,0,0,1,1
33062,مقالة،,0,0,1,1
37210,meddelelse,0,0,1,1
33063,urval,0,0,1,1
47540,улыбалась,0,0,1,1
47542,हास्यपूर्ण,0,0,1,1
50654,gedachten,0,0,1,1
52732,الحقيقة،,0,0,1,1
50030,yazar,0,0,1,1
52135,deixálos,0,0,1,1
37216,secretively,0,0,1,1
37217,версиях,0,0,1,1
47521,requereu,0,0,1,1
47531,otimização,0,0,1,1
50040,symbols,0,0,1,1
33053,appelées,0,0,1,1
37228,скомпрометировать,0,0,1,1
33054,βανδαλισμός,0,0,1,1
52133,വിദഗ്ദ്ധനുമായ,0,0,1,1
37227,dependendo,0,0,1,1
37226,ஏற்கிறது,0,0,1,1
50037,സഹായിക്കുമോ,0,0,1,1
37225,wreed,0,0,1,1
47524,unmanned,0,0,1,1
37224,மொழிப்பதிப்புகளில்,0,0,1,1
47526,desfazem,0,0,1,1
37223,zes,0,0,1,1
47527,माइस्पेस,0,0,1,1
50035,مبكرين,0,0,1,1
33056,diffuse,0,0,1,1
37220,δουλεύεις,0,0,1,1
37219,باردة,0,0,1,1
47530,separación,0,0,1,1
50657,ಅನಿಸುತ್ತದೆ,0,0,1,1
37254,सौभाग्य।,0,0,1,1
50048,фигурами,0,0,1,1
47477,வாக்கிய,0,0,1,1
33018,десяти,0,0,1,1
37296,உணவுகளையும்,0,0,1,1
37295,indexing,0,0,1,1
37294,പെരുവെള്ളം,0,0,1,1
37293,चाहता।,0,0,1,1
50057,ga •,0,0,1,1
47479,персонажами,0,0,1,1
33020,opmerking,0,0,1,1
37291,разнообразию,0,0,1,1
47481,« aide »,0,0,1,1
52123,règle,0,0,1,1
33021,pointed,0,0,1,1
47482,fastest,0,0,1,1
37288,ಶಬ್ದವಾಗಿದೆ,0,0,1,1
37287,بينهم،,0,0,1,1
33022,obtienen,0,0,1,1
37286,modernere,0,0,1,1
37285,സലാഡുകളും,0,0,1,1
37284,langage,0,0,1,1
47478,settle,0,0,1,1
50663,surrounded,0,0,1,1
47483,പദങ്ങളോ,0,0,1,1
47475,عينة,0,0,1,1
50058,журналистике,0,0,1,1
52121,yazarlarından,0,0,1,1
37310,healing,0,0,1,1
33014,horreur,0,0,1,1
37309,கூர்மையைக்,0,0,1,1
37308,válida,0,0,1,1
37307,устраняются,0,0,1,1
37306,ehrlich,0,0,1,1
33015,inancıyla,0,0,1,1
37305,tanımlamaktadır,0,0,1,1
47467,quieren,0,0,1,1
47468,приводят,0,0,1,1
47469,номинирована,0,0,1,1
47470,профессиональных,0,0,1,1
37301,oportunista,0,0,1,1
37300,documentatie,0,0,1,1
33016,perçoit,0,0,1,1
50129,കട്ടിലിൽ,0,0,1,1
47474,δημοτικότητα,0,0,1,1
50661,   articles,0,0,1,1
47484,kutusuna,0,0,1,1
37255,nævnt,0,0,1,1
47492,trip,0,0,1,1
50053,pænere,0,0,1,1
33031,"
islandês",0,0,1,1
37263,dehors,0,0,1,1
47496,തെലുഗ്,0,0,1,1
47497,veas,0,0,1,1
47498,fonge,0,0,1,1
50052,διαμαρτύρεται,0,0,1,1
33032,glückwünsche,0,0,1,1
33033,придумал,0,0,1,1
50050,والكورية،,0,0,1,1
37260,toestemming,0,0,1,1
47502,الحاسوب,0,0,1,1
52127,خططًا,0,0,1,1
50130,forvirre,0,0,1,1
47503,utforma,0,0,1,1
47504,capté,0,0,1,1
37257,zusätzlichen,0,0,1,1
37256,الخاطبين,0,0,1,1
33035,повторите,0,0,1,1
47494,слово»,0,0,1,1
37268,llevaré,0,0,1,1
37281,ശ്രമങ്ങൾ‍,0,0,1,1
37269,« quelle,0,0,1,1
33023,forskningsciteringar,0,0,1,1
47486,overturned,0,0,1,1
37278,contenus,0,0,1,1
47487,cercana,0,0,1,1
33024,grafema,0,0,1,1
33025,εγγενείς,0,0,1,1
50056,generosamente,0,0,1,1
37276,ഉപയോഗശൂന്യമായിരുന്നു,0,0,1,1
47488,சோம்பலாகவோ,0,0,1,1
50660,ಮಾಡಲಿದೆ,0,0,1,1
37274,öğreniyorum,0,0,1,1
37273,entropía,0,0,1,1
33026,kurslitteraturen,0,0,1,1
52124,inkluderar,0,0,1,1
33027,تجري,0,0,1,1
47490,poderá,0,0,1,1
33029,coévolue,0,0,1,1
33030,புயல்,0,0,1,1
47491,tatien,0,0,1,1
52136,kostsamt,0,0,1,1
50652,convencidas,0,0,1,1
37312,indonesië,0,0,1,1
52729,डेविड,0,0,1,1
33086,ಸ್ನೇಹಿತರಾಗಿದ್ದರು,0,0,1,1
37128,плохо,0,0,1,1
37127,suspendre,0,0,1,1
52150,γουικιπίντια,0,0,1,1
47584,ഓർഗനൈസേഷൻ,0,0,1,1
50019,βικιταξίδια,0,0,1,1
47586,ആശയത്തിനെ,0,0,1,1
47587,atone,0,0,1,1
47588,δούμε,0,0,1,1
37125,ಅಪ್,0,0,1,1
37208,കത്തിക്കുന്നു,0,0,1,1
47589,opôsse,0,0,1,1
37124,evrimi,0,0,1,1
37123,‘குழுச்,0,0,1,1
33088,tätt,0,0,1,1
37121,مشغولاً,0,0,1,1
47591,വലിയൊരാത്മവിശ്വാസം,0,0,1,1
33089,pratik,0,0,1,1
52151,ഞങ്ങൾക്ക്,0,0,1,1
47593,खातों,0,0,1,1
37129,femme,0,0,1,1
50020,посмотрим,0,0,1,1
37130,प्यू,0,0,1,1
52148,öncesi,0,0,1,1
33082,complementar,0,0,1,1
37145,interpretada,0,0,1,1
37144,ർജ്ജ,0,0,1,1
47574,നല്കേണ്ട,0,0,1,1
33083,såklart,0,0,1,1
47575,orkanen,0,0,1,1
37140,bienvenido,0,0,1,1
47576,தீர்வில்,0,0,1,1
47577,hegemonia,0,0,1,1
37138,autorización,0,0,1,1
52730,realizados,0,0,1,1
37137,çaba,0,0,1,1
37136,reversiones,0,0,1,1
52147,quantity,0,0,1,1
47578,portrayals,0,0,1,1
37134,പറഞ്ഞയച്ചത്,0,0,1,1
47579,mångspråkig,0,0,1,1
47582,أساسي,0,0,1,1
37131,convite,0,0,1,1
47594,пятой“,0,0,1,1
47595,شخصياتها,0,0,1,1
47596,abdecken,0,0,1,1
33098,peña,0,0,1,1
37100,consommation,0,0,1,1
47602,ಕಾಲದಲ್ಲಿ,0,0,1,1
52727,tomo,0,0,1,1
47603,मधुर,0,0,1,1
37099,செய்தீர்கள்,0,0,1,1
47605,μεγάλο,0,0,1,1
50646,выглядел,0,0,1,1
37096,  km,0,0,1,1
33101,воздействию,0,0,1,1
47607,കാശ്മീർ,0,0,1,1
33102,reproducción,0,0,1,1
37093,girl,0,0,1,1
37092,أقدر,0,0,1,1
37091,பரிசைக்,0,0,1,1
37090,häftigt,0,0,1,1
47608,träffat,0,0,1,1
50016,കൈമുതലായുണ്ടാവും,0,0,1,1
33104,மகிழ்ச்சியடைகிறேன்,0,0,1,1
52152,coloquialmente,0,0,1,1
37101,vestimentaire,0,0,1,1
37103,parcialidad,0,0,1,1
52728,ييل,0,0,1,1
33097,empregava,0,0,1,1
37116,संपदा,0,0,1,1
37115,telefoongesprek,0,0,1,1
33092,சாப்பிடலாமா,0,0,1,1
33093,bomis ,0,0,1,1
37114,severler,0,0,1,1
37113,பொதுவாக,0,0,1,1
37112,meistens,0,0,1,1
47597,bogen,0,0,1,1
37110,baka,0,0,1,1
33094,τρομακτική,0,0,1,1
37109,stapte,0,0,1,1
33095,താഴേയ്‌ക്ക്,0,0,1,1
47598,levantou,0,0,1,1
47599,vandalisering,0,0,1,1
33096,தொடங்குங்கள்,0,0,1,1
47600,schnecke,0,0,1,1
37106,germany,0,0,1,1
37105,മറ്റുള്ളവരോട്,0,0,1,1
37104,പറയുന്നതും,0,0,1,1
52146,cubierto,0,0,1,1
47572,τηρούν,0,0,1,1
52145,வேலைக்காரிகள்,0,0,1,1
33067,പ്രവർത്തിക്കണമെന്ന്,0,0,1,1
47550,unintelligent,0,0,1,1
52140,விக்கிப்பீடியாவானது,0,0,1,1
47552,huvudstad,0,0,1,1
37188,കണ്ടതെന്ന്,0,0,1,1
47553,diagnósticos,0,0,1,1
50028,arbre,0,0,1,1
50650,d’idéalisme,0,0,1,1
50649,അവനോടൊപ്പം,0,0,1,1
33069,ಸಂಪತ್ತಿಗೆ,0,0,1,1
50648,corrections,0,0,1,1
47555,செயல்படுகிறீர்களானால்,0,0,1,1
33070,"
نحن",0,0,1,1
52141,provenían,0,0,1,1
47556,حزينة,0,0,1,1
47557,إحساسها,0,0,1,1
47558,classic,0,0,1,1
37183,goza,0,0,1,1
37182,jarre,0,0,1,1
33072,जाये।,0,0,1,1
52137,destansı,0,0,1,1
37191,picture,0,0,1,1
37180,இத்திட்டத்தின்,0,0,1,1
47549,ekleyerek,0,0,1,1
33065,ಗಂಭೀರವಾದ,0,0,1,1
37206,பட்டியலில்,0,0,1,1
37205,упомянули,0,0,1,1
47546,رأسه,0,0,1,1
37203,ಭಾವಿಸಬಹುದು,0,0,1,1
37202,اعمده,0,0,1,1
50651,graffiti,0,0,1,1
37201,ನೇಮಿಸಿಕೊಳ್ಳಬೇಕು,0,0,1,1
37200,découverte,0,0,1,1
33066,buffon,0,0,1,1
37199,tedbir,0,0,1,1
47547,vandalizando,0,0,1,1
37197,godkänt,0,0,1,1
37196,iso,0,0,1,1
47548,alltag,0,0,1,1
50029,കരുതുന്നില്ല,0,0,1,1
37194,artifice,0,0,1,1
37193,redistribuílo,0,0,1,1
37192,indispensables,0,0,1,1
47562,താൾ,0,0,1,1
37179,поиска,0,0,1,1
37148,பெல்,0,0,1,1
37162,ದುರಸ್ತಿ,0,0,1,1
37160,динамика,0,0,1,1
37159,permitió,0,0,1,1
37158,ingenting,0,0,1,1
37157,paródias,0,0,1,1
37156,விரும்ப,0,0,1,1
33076,downloading,0,0,1,1
37155,educadamente,0,0,1,1
47568,connecting,0,0,1,1
50023,तुलनात्मक,0,0,1,1
37154,auténtico,0,0,1,1
37153,winkten,0,0,1,1
50022,“death,0,0,1,1
33078,காரணமாக,0,0,1,1
37152,الجلوس,0,0,1,1
37151,ಕಲಿತಿದ್ದೇವೆ,0,0,1,1
33079,«periodista,0,0,1,1
37150,открытием,0,0,1,1
33080,edersen,0,0,1,1
37149,législation,0,0,1,1
47567,വേറൊരു,0,0,1,1
37163,undersöks,0,0,1,1
52142,экземпляре,0,0,1,1
50025,നൽകുന്നു,0,0,1,1
37178,ചെയ്യുന്നതിനെ,0,0,1,1
47563,டிகிரிக்குக்,0,0,1,1
50647,tøjvask,0,0,1,1
37177,kritiska,0,0,1,1
47564,initié,0,0,1,1
37175,ಕೆಂಪು,0,0,1,1
37174,verticale,0,0,1,1
37173,preserving,0,0,1,1
37172,неспособность,0,0,1,1
37171,frön,0,0,1,1
47565,fonde,0,0,1,1
37169,tanıştığıma,0,0,1,1
37168,seriøst,0,0,1,1
37167,നിങ്ങളെപ്പോലെ,0,0,1,1
52143,presencia,0,0,1,1
37166,değildir,0,0,1,1
50026,தமது,0,0,1,1
47566,ojämn,0,0,1,1
52144,presidenciais,0,0,1,1
52120,पत्नी,0,0,1,1
50059,مديرو,0,0,1,1
52726,modifierd,0,0,1,1
37457,geometría,0,0,1,1
37463,حافلتنا,0,0,1,1
47366,பாராட்டுகிறேன்,0,0,1,1
47367,ക്രൂരവും,0,0,1,1
52099,ഫാൻസി,0,0,1,1
37460,различному,0,0,1,1
37459,صديقين,0,0,1,1
47368,sorabileceğin,0,0,1,1
50096,"
alemão",0,0,1,1
32968,любого,0,0,1,1
47370,peerreview,0,0,1,1
52105,noter,0,0,1,1
50683,விக்கித்,0,0,1,1
47372,заявив,0,0,1,1
37455,librepedia,0,0,1,1
47373,despercebida,0,0,1,1
52100,stond,0,0,1,1
47375,alıştırması,0,0,1,1
32969,ಪುರುಷರು,0,0,1,1
52746,tá,0,0,1,1
37453,biophysique,0,0,1,1
32965,ஊமை,0,0,1,1
50098,кнопка,0,0,1,1
37464,sqlite,0,0,1,1
47365,confronter,0,0,1,1
50101,താളുകൾ‍,0,0,1,1
47355,اللوحات,0,0,1,1
37475,χώρος,0,0,1,1
37474,almam,0,0,1,1
32959,ചാടിയാൽ,0,0,1,1
37473,feraisje,0,0,1,1
47356,ce •,0,0,1,1
37472,jouant,0,0,1,1
47357,прекрасных,0,0,1,1
32961,entsetzlich,0,0,1,1
47362,vidare,0,0,1,1
37471,bedøvet,0,0,1,1
32962,asigna,0,0,1,1
37469,пополните,0,0,1,1
47363,listou,0,0,1,1
37468,σύνθημα,0,0,1,1
37466,« diderot,0,0,1,1
32963,exactitud,0,0,1,1
37465,ficamos,0,0,1,1
52101,amacı,0,0,1,1
50122,lourde,0,0,1,1
47376,классную,0,0,1,1
37437,лицензирования,0,0,1,1
47384,ചേർക്കുമ്പോൾ,0,0,1,1
47385,koldt,0,0,1,1
37435,كشف,0,0,1,1
37434,точка,0,0,1,1
37433,risques,0,0,1,1
37432,géré,0,0,1,1
47386,auktoriteten,0,0,1,1
37430,публикацию,0,0,1,1
37429,സുഖമായിരിക്കും,0,0,1,1
37428,البسيط,0,0,1,1
37427,базу,0,0,1,1
37426,الرائع,0,0,1,1
37425,importo,0,0,1,1
37424,ವಹಿಸುತ್ತೇನೆ,0,0,1,1
37423,significando,0,0,1,1
52743,политической,0,0,1,1
52104,réagir,0,0,1,1
47387,découle,0,0,1,1
37421,omission,0,0,1,1
37436,الفظة,0,0,1,1
37438,lezers,0,0,1,1
37452,പദ്ധതികൾരൂപീകരിക്കുന്നു,0,0,1,1
47383,बनाया,0,0,1,1
37451,результатах,0,0,1,1
37450,meteors,0,0,1,1
52102,datanamnrymd,0,0,1,1
32970,تلتقي,0,0,1,1
50093,cybersécurité,0,0,1,1
37449,beiden,0,0,1,1
37448,घंटी,0,0,1,1
37446,aclu,0,0,1,1
32973,côtés,0,0,1,1
37445,ಬಂದಿದ್ದೇನೆ,0,0,1,1
32974,வழங்கியது,0,0,1,1
50680,борисом,0,0,1,1
47381,வார்த்தையைத்,0,0,1,1
37442,testen,0,0,1,1
32975,официальной,0,0,1,1
50679,spanska,0,0,1,1
37441,eenmaal,0,0,1,1
37440,далее»,0,0,1,1
50678,लिखूंगा,0,0,1,1
37476,ثالث,0,0,1,1
37477,spelling,0,0,1,1
50102,മെലിസ,0,0,1,1
37527,وضعت,0,0,1,1
50111,έδαφος,0,0,1,1
50110,விக்கிப்பீடியாவிற்கு,0,0,1,1
37524,ലഭ്യമല്ലെങ്കിൽ,0,0,1,1
47328,tillod,0,0,1,1
37522,சதுப்புநிலம்,0,0,1,1
50108,dönüyor,0,0,1,1
50116,попасть,0,0,1,1
47330,നാമപദമായി,0,0,1,1
37519,اجتازت,0,0,1,1
37518,πέσεις,0,0,1,1
32951,académicos—,0,0,1,1
37517,പ്രാധാന്യം,0,0,1,1
52092,vecteurs,0,0,1,1
37515,armée,0,0,1,1
47331,гавайского,0,0,1,1
37514,சிறப்புக்கட்டுரைகளிடையே,0,0,1,1
37513,антиэлитаризм,0,0,1,1
37512,بناءً,0,0,1,1
47332,ಸಿದ್ಧಪಡಿಸಿದ್ದೇನೆ,0,0,1,1
47327,αιτήματα,0,0,1,1
37528,ഒന്നിൽ,0,0,1,1
47333,tempérées,0,0,1,1
52090,glittrande,0,0,1,1
37538,അക്ഷരാർത്ഥത്തിൽ,0,0,1,1
37537,disséquées,0,0,1,1
37536,familiares,0,0,1,1
32945,τελειώσουν,0,0,1,1
50112,ಭಾವಿಸಿದ್ದೀರಿ,0,0,1,1
37535,enregistré,0,0,1,1
47317,أصاب,0,0,1,1
37534,ബുദ്ധിയുടെ,0,0,1,1
52088,hemmelighedsfuldt,0,0,1,1
47318,undskylder,0,0,1,1
47320,exacte,0,0,1,1
52749,cultivated,0,0,1,1
32948,пришло,0,0,1,1
47322,घूर,0,0,1,1
47323,pugilat,0,0,1,1
47324,خمس,0,0,1,1
37530,يوميًا,0,0,1,1
47325,எஸ்எம்எஸ்,0,0,1,1
37529,കൂടതൽ,0,0,1,1
37510,ഇതി,0,0,1,1
37508,दूरदूर,0,0,1,1
50103,temporarily,0,0,1,1
37494,لتخبره,0,0,1,1
47343,generallyvague,0,0,1,1
37492,فموسوعة,0,0,1,1
52095,உருவாக்கியுள்ளது,0,0,1,1
47344,eraan,0,0,1,1
47345,ಅದರಿಂದ,0,0,1,1
47346,بإصلاح,0,0,1,1
47347,മൃതമായി,0,0,1,1
47349,nervous,0,0,1,1
37488,acusan,0,0,1,1
37487,bedava,0,0,1,1
47350,strategies,0,0,1,1
37485,βοηθούσες,0,0,1,1
37484,പരാമർശിച്ചിട്ടില്ല,0,0,1,1
37483,ranches,0,0,1,1
37482,movie,0,0,1,1
47351,yasaklı,0,0,1,1
52098,employee,0,0,1,1
37480,süßen,0,0,1,1
37479,everybodywiki,0,0,1,1
37493,ഒഴിവാക്കാറുണ്ട്,0,0,1,1
37495,സ്പീക്കറുകൾ,0,0,1,1
50107,selfreplicating,0,0,1,1
32958,kullanıyoruz,0,0,1,1
37507,खत्म,0,0,1,1
47334,grusomt,0,0,1,1
37506,dirigée,0,0,1,1
47335,diferenciada,0,0,1,1
47336,ஹேங்கவுட்,0,0,1,1
37503,വരുത്തി,0,0,1,1
32955,تشرفت,0,0,1,1
37501,knipogen,0,0,1,1
47337,تنطبق,0,0,1,1
52093,vurgulamakta,0,0,1,1
47338,لصديقهما,0,0,1,1
32956,महाद्वीपों,0,0,1,1
47339,stanislas,0,0,1,1
32957,verdú,0,0,1,1
37499,सिविल,0,0,1,1
50120,entourent,0,0,1,1
37498,பயணத்தை,0,0,1,1
47341,causaba,0,0,1,1
37497,സാധിച്ചു,0,0,1,1
47388,المتبقي,0,0,1,1
32977,demandantes,0,0,1,1
50060,traurig,0,0,1,1
52114,സൗന്ദര്യത്തെയും,0,0,1,1
50669,iescgeekcorpsmali,0,0,1,1
33000,закрывают,0,0,1,1
37348,fundó,0,0,1,1
50071,يغرق,0,0,1,1
37347,följde,0,0,1,1
37346,كمتمم,0,0,1,1
50070,إضافات,0,0,1,1
33001,رسالتي,0,0,1,1
37344,snapte,0,0,1,1
37342,verhungern,0,0,1,1
47389,உணவுக்கு,0,0,1,1
37341,लॉ,0,0,1,1
47446,geuit,0,0,1,1
47447,duymuşsanız,0,0,1,1
47448,trovärdig,0,0,1,1
33003,онлайнэнциклопедии,0,0,1,1
37339,ചപ്പും,0,0,1,1
47449,அழகிய,0,0,1,1
37338,τόνο,0,0,1,1
50068,constara,0,0,1,1
50670,dueños,0,0,1,1
50671,αριθμού,0,0,1,1
32999,ignorant,0,0,1,1
37350,associadas,0,0,1,1
47432,ஷெல்லின்,0,0,1,1
37362,كثير,0,0,1,1
50673,genehmigung,0,0,1,1
32996,massachusetts,0,0,1,1
37360,कुत्ते,0,0,1,1
32997,umarmen,0,0,1,1
52113,أدوات,0,0,1,1
37358,صرف,0,0,1,1
37357,completos,0,0,1,1
37356,ಹೇಳಿದ್ದೇನೆ,0,0,1,1
47435,exciting,0,0,1,1
47436,xvii°siècle,0,0,1,1
32998,ആഗ്രഹിക്കുന്നുവെന്നും,0,0,1,1
47439,internet ,0,0,1,1
37354,symboliques,0,0,1,1
47440,ನನ್ನೊಂದಿಗೆ,0,0,1,1
47442,modificación,0,0,1,1
50073,gebruikmaakten,0,0,1,1
37351,kunstmatige,0,0,1,1
50668,hábil,0,0,1,1
37337,boyle,0,0,1,1
50066,obtendría,0,0,1,1
37324,disseminação,0,0,1,1
33009,grootst,0,0,1,1
37322,explicar,0,0,1,1
37321,júri,0,0,1,1
47462,niveaux ,0,0,1,1
52117,городах,0,0,1,1
47463,владелец,0,0,1,1
37319,എന്നൊക്കെ,0,0,1,1
47464,أقرأ,0,0,1,1
37318,κερδοσκοπικό,0,0,1,1
47465,dependência,0,0,1,1
33011,وجود,0,0,1,1
37317,описывал,0,0,1,1
37316,तुम्हारे,0,0,1,1
50665,تامبا،,0,0,1,1
47466,oprichters,0,0,1,1
33013,philosophical,0,0,1,1
37315,обеспечение,0,0,1,1
37314,ഇടയില്ലാത്ത,0,0,1,1
52119,worldcat,0,0,1,1
47461,ചേർക്കാനാണ്,0,0,1,1
47460,பாங்கு,0,0,1,1
37336,recogida,0,0,1,1
37325,المساعدة,0,0,1,1
37335,സജീവ,0,0,1,1
47453,augmenter,0,0,1,1
33007,thereby,0,0,1,1
50667,ശൂന്യമായ,0,0,1,1
33008,grant,0,0,1,1
50666,அழகையும்,0,0,1,1
37334,отличный,0,0,1,1
37333,அடைந்தார்,0,0,1,1
37332,широко,0,0,1,1
37331,almuerzo,0,0,1,1
47455,شرح,0,0,1,1
47456,subfield,0,0,1,1
47458,espera,0,0,1,1
37328,convaincre,0,0,1,1
52116,ദിവസമാണെന്ന്,0,0,1,1
37327,vänder,0,0,1,1
50065,aposentado,0,0,1,1
47459,regardant,0,0,1,1
37326,والجدير,0,0,1,1
47431,vanwege,0,0,1,1
37364,librarianship,0,0,1,1
50075,nationalities,0,0,1,1
50085,doutrina,0,0,1,1
47401,fotograf,0,0,1,1
37405,எதிர்மறை,0,0,1,1
47402,borrando,0,0,1,1
50123,باحثون,0,0,1,1
37404,opponent,0,0,1,1
37403,utilidade,0,0,1,1
37402,caters,0,0,1,1
37401,"sciences ·
പരിതഃസ്ഥിതിക",0,0,1,1
37400,implausible,0,0,1,1
37399,listo,0,0,1,1
37398,تمكنهم,0,0,1,1
37397,identifierade,0,0,1,1
37396,rythme,0,0,1,1
52741,euh,0,0,1,1
37395,analyseren,0,0,1,1
50124,अध्याय,0,0,1,1
37394,ചിരിക്കാൻ,0,0,1,1
37393,banqueiro,0,0,1,1
37392,நம்ப,0,0,1,1
50084,bulsam,0,0,1,1
32981,bn •,0,0,1,1
32983,snabba,0,0,1,1
47400,"
tagalo",0,0,1,1
37417,τρόποι,0,0,1,1
37416,new •,0,0,1,1
37415,ಪಡೆಯುವವರೆಗೂ,0,0,1,1
47390,المجهولين,0,0,1,1
50089,bemerken,0,0,1,1
52742,ссылается,0,0,1,1
47394,objets,0,0,1,1
47395,ಮಾಡುವವರಿಗೆ,0,0,1,1
37412,सहीसही,0,0,1,1
37411,necesarios,0,0,1,1
37410,uppringare,0,0,1,1
50087,enheter,0,0,1,1
50677,inspirera,0,0,1,1
47398,δάχτυλά,0,0,1,1
37409,liknande,0,0,1,1
47399,değişik,0,0,1,1
37408,bred,0,0,1,1
37407,constater,0,0,1,1
32980,england,0,0,1,1
37390,magnificent,0,0,1,1
37389,användarbefogenheter,0,0,1,1
50076,salientou,0,0,1,1
37374,प्रतिदिन,0,0,1,1
52738,വിശ്വാസയോഗ്യമായ,0,0,1,1
50674,upphov,0,0,1,1
50078,വെക്കുന്നുണ്ട്,0,0,1,1
47419,exercer,0,0,1,1
47421,флорида,0,0,1,1
32991,मूल्य,0,0,1,1
37370,شهر,0,0,1,1
32992,"
सर्बियाई",0,0,1,1
32993,cruzamiento,0,0,1,1
32994,mechanisms,0,0,1,1
47424,perceptrones,0,0,1,1
32995,مضى,0,0,1,1
52737,فلنتحدث,0,0,1,1
47426,periodista,0,0,1,1
52112,തരുന്നതതാണ്,0,0,1,1
47427,kesmek,0,0,1,1
37366,hizo,0,0,1,1
47429,എന്നതിനാൽ,0,0,1,1
37365,antonino,0,0,1,1
37373,تقدمها,0,0,1,1
47414,ಅಹಂಕಾರಿ,0,0,1,1
47404,wordsense,0,0,1,1
47413,jugée,0,0,1,1
47405,zihinsel,0,0,1,1
52106,αμβλείος,0,0,1,1
32984,نصها,0,0,1,1
50126,جميلًا,0,0,1,1
37387,drink,0,0,1,1
37386,രഹസ്യമുണ്ടായിരുന്നു,0,0,1,1
37385,införandet,0,0,1,1
47406,implementar,0,0,1,1
37384,riktig,0,0,1,1
37382,combien,0,0,1,1
32987,खींचें।,0,0,1,1
37381,منسوبة,0,0,1,1
37380,ulsfo,0,0,1,1
47409,freundin,0,0,1,1
37379,løgne,0,0,1,1
37378,αναστατωθεί,0,0,1,1
37377,regards,0,0,1,1
47411,listade,0,0,1,1
47412,επομένως,0,0,1,1
50137,meant,0,0,1,1
37088,صاغ,0,0,1,1
47934,والذي,0,0,1,1
47815,നിയോഗിച്ചിരിക്കുന്നു,0,0,1,1
49954,favoring,0,0,1,1
36797,முழுமையானது,0,0,1,1
36796,vidsträckt,0,0,1,1
47813,عاصفة,0,0,1,1
36794,தொகுப்பதன்,0,0,1,1
36793,« dans,0,0,1,1
36792,எடுத்துக்காட்டுகளைப்,0,0,1,1
47814,रत्नों,0,0,1,1
52720,வழங்கிகள்,0,0,1,1
36789,häufiges,0,0,1,1
36749,miroir,0,0,1,1
36788,الاحتفاظ,0,0,1,1
36787,forstyrret,0,0,1,1
50609,ومخيف,0,0,1,1
36785,resuméer,0,0,1,1
36784,даллас,0,0,1,1
47816,بي،,0,0,1,1
49952,والمساهمين,0,0,1,1
47818,août,0,0,1,1
36782,differ,0,0,1,1
49955,പ്രവചിക്കുകയാകാം,0,0,1,1
47811,संगठित,0,0,1,1
36798,repente,0,0,1,1
47810,редактором,0,0,1,1
47797,aufhörte,0,0,1,1
47799,المحررون,0,0,1,1
36810,kontrol,0,0,1,1
36809,ಮೂಗು,0,0,1,1
49956,parvenant,0,0,1,1
36808,bayer,0,0,1,1
47801,написать,0,0,1,1
47802,puinhoop,0,0,1,1
47803,„википедии“,0,0,1,1
36805,ameliorating,0,0,1,1
47804,departure,0,0,1,1
47806,« usage,0,0,1,1
47809,நிதி,0,0,1,1
36804,informativos,0,0,1,1
36803,l’écriture,0,0,1,1
36802,ಬಸವನ,0,0,1,1
36801,beheerd,0,0,1,1
36800,làdessus,0,0,1,1
52202,твоей,0,0,1,1
47819,вмешивается,0,0,1,1
49951,beliefs,0,0,1,1
36780,felen,0,0,1,1
36763,φοβόμουν,0,0,1,1
47832,"
विशेष",0,0,1,1
47833,நிறுவனத்தால்,0,0,1,1
49945,ഭക്ഷണത്തെക്കുറിച്ച്,0,0,1,1
33222,ಮಾತನಾಡುತ್ತಿದ್ದೀರಿ,0,0,1,1
47836,umduğum,0,0,1,1
47837,परियोजनाएं,0,0,1,1
36758,möjlig,0,0,1,1
47838,lowquality,0,0,1,1
47839,yasaklanmasını,0,0,1,1
33223,والأفضل,0,0,1,1
36755,correta,0,0,1,1
36754,ценю,0,0,1,1
52717,adquiridos,0,0,1,1
47840,cnet,0,0,1,1
47841,ಅತ್ಯುತ್ತಮವಾದದ್ದು,0,0,1,1
49944,samenvatting,0,0,1,1
49943,yakışıklıydı,0,0,1,1
49942,замечательно,0,0,1,1
47842,ನಗಲು,0,0,1,1
36762,creator,0,0,1,1
36764,pertencente,0,0,1,1
36778,carbonandwaterbased,0,0,1,1
35991,wikiversidade,0,0,1,1
36777,تشديد,0,0,1,1
47822,الويكيبيديات،,0,0,1,1
47823,l’action,0,0,1,1
47824,حالك,0,0,1,1
36774,представления,0,0,1,1
52203,स्तरों,0,0,1,1
33220,ശക്തി,0,0,1,1
33221,piecewise,0,0,1,1
47827,ಉಸಿರಾಡಲು,0,0,1,1
36771,alternativos,0,0,1,1
36770,ഇന്റർനെറ്റിലും,0,0,1,1
52204,واحصل,0,0,1,1
36769,stocker,0,0,1,1
50149,растущего,0,0,1,1
36768,लेखन,0,0,1,1
36767,شهورًا,0,0,1,1
50607,baja,0,0,1,1
36766,takipsizliği,0,0,1,1
47829,aware,0,0,1,1
47796,والسلوك,0,0,1,1
47795,മകളായ,0,0,1,1
49957,اللحظة,0,0,1,1
49965,зданий,0,0,1,1
36855,مبنية,0,0,1,1
36854,naken,0,0,1,1
47767,collège,0,0,1,1
52196,konstaterar,0,0,1,1
36853,förespråkare,0,0,1,1
36852,eden,0,0,1,1
36851,σελίδες,0,0,1,1
47768,coluna,0,0,1,1
47769,لله,0,0,1,1
36849,ಸಾಮಾನ್ಯಕ್ಕಿಂತ,0,0,1,1
36848,superprotection,0,0,1,1
47770,الخبرة,0,0,1,1
47771,أكبرها،,0,0,1,1
47772,parecerem,0,0,1,1
47773,викисклада,0,0,1,1
36846,സന്തോഷകരമായ,0,0,1,1
36845,ellen,0,0,1,1
36844,ड्राफ्ट,0,0,1,1
52197,لنفترض,0,0,1,1
33204,resulte,0,0,1,1
47765,ubrugeligt,0,0,1,1
47775,παραδώσει,0,0,1,1
49967,anlayamadım,0,0,1,1
33200,கொடுமை,0,0,1,1
47758,сообществом,0,0,1,1
33201,blockering,0,0,1,1
50617,conduits,0,0,1,1
36869,வந்தாள்,0,0,1,1
52194,pre,0,0,1,1
36867,ouça,0,0,1,1
49970,descripción,0,0,1,1
47760,esthétique,0,0,1,1
36866,வழக்கப்படியான,0,0,1,1
36865,encouraging,0,0,1,1
36862,establecidos,0,0,1,1
49968,deletion,0,0,1,1
47764,spejlet,0,0,1,1
33202,quotidien,0,0,1,1
36860,ಕಳೆದ,0,0,1,1
36859,шесть,0,0,1,1
36858,കുറിപ്പുകളും,0,0,1,1
36857,compartilhada,0,0,1,1
47774,restaurangen,0,0,1,1
33206,корреляцию,0,0,1,1
33213,ilgilenmiyorsan,0,0,1,1
47788,handy,0,0,1,1
36828,ക്ഷീണം,0,0,1,1
49961,vancouversystemet,0,0,1,1
33210,जोर,0,0,1,1
36827,roten,0,0,1,1
36826,vinklad,0,0,1,1
36825,humanmade,0,0,1,1
36824,தொகுப்பாளர்களின்,0,0,1,1
49960,holder,0,0,1,1
49958,multicamadas,0,0,1,1
36822,запрещено,0,0,1,1
36821,النشر,0,0,1,1
36820,تدرب,0,0,1,1
36819,gerenommeerde,0,0,1,1
47790,ஒப்புக்கொள்வது,0,0,1,1
52201,olign,0,0,1,1
36817,فلماذا,0,0,1,1
36816,ഏറെയുണ്ടാകുന്നതുകൊണ്ടുള്ള,0,0,1,1
33211,видов,0,0,1,1
47791,spécificité,0,0,1,1
36829,långsam,0,0,1,1
36830,അഞ്ചുമിനിറ്റിനുള്ളിൽ,0,0,1,1
36841,"
vietnamita",0,0,1,1
50612,sohbet,0,0,1,1
36840,associada,0,0,1,1
50613,eminim,0,0,1,1
36839,recombined,0,0,1,1
33207,susceptibles,0,0,1,1
36838,φρικάρω,0,0,1,1
33208,σκληρή,0,0,1,1
47777,aspekter,0,0,1,1
52722,വാക്യത്തിൽ‌,0,0,1,1
47779,granskat,0,0,1,1
49962,أهلا,0,0,1,1
52199,favorablemente,0,0,1,1
47780,التعاوني،,0,0,1,1
47781,पात्रों,0,0,1,1
47782,vikisözlük,0,0,1,1
47784,சுட,0,0,1,1
47785,¿debería,0,0,1,1
36833,கருத்தைத்,0,0,1,1
36832,hydrological,0,0,1,1
47787,şirket,0,0,1,1
36750,عدة,0,0,1,1
33225,curtir,0,0,1,1
52193,mécaniste,0,0,1,1
36666,förändrats,0,0,1,1
47900,presentan,0,0,1,1
36671,остановились,0,0,1,1
36670,nongouvernementales,0,0,1,1
50601,المتوافقة,0,0,1,1
33259,«громадный»,0,0,1,1
50153,استخدامه,0,0,1,1
47902,buss,0,0,1,1
36668,മര്യാദയുള്ള,0,0,1,1
49926,lt •,0,0,1,1
36665,repeating,0,0,1,1
36748,represalias,0,0,1,1
36664,ağladığın,0,0,1,1
36663,डगलस,0,0,1,1
50600,disais,0,0,1,1
33260,ಸ್ಮೈಲ್ಸ್,0,0,1,1
33261,anthropologie,0,0,1,1
33263,செயற்படுகிறது,0,0,1,1
52712,வடிவமைக்கப்,0,0,1,1
50599,வழிமுறையாகும்,0,0,1,1
52216,rappelé,0,0,1,1
50152,ansiklopediler,0,0,1,1
33257,violents,0,0,1,1
47896,cujas,0,0,1,1
52214,मेज,0,0,1,1
47885,complementos,0,0,1,1
49931,«будущее,0,0,1,1
36684,வரையில்,0,0,1,1
36683,जाऊँगा।,0,0,1,1
47886,okuldan,0,0,1,1
36681,internetföretag,0,0,1,1
49930,demografie,0,0,1,1
33252,अशिष्टता,0,0,1,1
47889,fixes,0,0,1,1
47890,condamné,0,0,1,1
33253,packen,0,0,1,1
49929,சிகிச்சை,0,0,1,1
33255,доме,0,0,1,1
47893,°w﻿,0,0,1,1
33256,चाहें,0,0,1,1
36677,bristfällig,0,0,1,1
47894,parçasını,0,0,1,1
50602,σχέδιο,0,0,1,1
36675,da •,0,0,1,1
36659,മറ്റൊന്നും,0,0,1,1
49925,ஆகியவற்றுக்கு,0,0,1,1
52711,unintelligen,0,0,1,1
47927,определённое,0,0,1,1
36648,utgåvorna,0,0,1,1
33269,lograr,0,0,1,1
33270,hundreds,0,0,1,1
33271,hayalleriyle,0,0,1,1
49922,അതിനർ‌ത്ഥം,0,0,1,1
36647,प्रभावी,0,0,1,1
36646,fiscale,0,0,1,1
50154,«символом,0,0,1,1
49920,barajando,0,0,1,1
47930,ಕುಳಿತುಕೊಳ್ಳುವ,0,0,1,1
36644,meines,0,0,1,1
36643,дайтека,0,0,1,1
33274,arboretums,0,0,1,1
33275,വാൻഡലിസത്തിന്,0,0,1,1
47932,கருத்தொருமிப்புப்,0,0,1,1
36640,ജീവനും,0,0,1,1
36639,குரலின்,0,0,1,1
36638,testimde,0,0,1,1
47933,knutna,0,0,1,1
52709,slott,0,0,1,1
47926,ಕರೆಯಬಹುದು,0,0,1,1
49924,sarayımda,0,0,1,1
33268,gekichert,0,0,1,1
47911,étonné,0,0,1,1
47912,defendam,0,0,1,1
47913,ನೆಡಲು,0,0,1,1
47914,droger,0,0,1,1
36656,وإصلاحه,0,0,1,1
49923,tide,0,0,1,1
52217,துறையில்,0,0,1,1
47915,mirando,0,0,1,1
47916,ಬೆರಗುಗೊಳಿಸುತ್ತದೆ,0,0,1,1
36655,policiam,0,0,1,1
36654,vaincre,0,0,1,1
50598,नगरीय,0,0,1,1
33267,orígenes,0,0,1,1
47919,ಕೈದಿಗಳಿಗೆ,0,0,1,1
36653,décomptant,0,0,1,1
47920,objectives,0,0,1,1
47922,reilly,0,0,1,1
47923,дамами,0,0,1,1
47924,உள்ளடக்கப்பட்ட,0,0,1,1
33249,фразам,0,0,1,1
36687,പാർട്ടികളെക്കുറിച്ചുള്ള,0,0,1,1
33248,ю,0,0,1,1
47857,№ ,0,0,1,1
36732,ethics,0,0,1,1
33231,يظنون,0,0,1,1
36730,പുറത്താക്കിയത്,0,0,1,1
36728,replicadas,0,0,1,1
36727,gefangene,0,0,1,1
36726,erwähnt,0,0,1,1
36725,ആശങ്കകളൊന്നുമില്ല,0,0,1,1
36724,l’accessibilité,0,0,1,1
47859,fangst,0,0,1,1
50604,übliche,0,0,1,1
47861,définir,0,0,1,1
47862,afspiegeling,0,0,1,1
36721,ವಿವರಿಸುವಾಗ,0,0,1,1
36720,wikiwikiwebad,0,0,1,1
33232,находится,0,0,1,1
33233,ഇതിനെക്കുറിച്ച്,0,0,1,1
36719,ரீதியில்,0,0,1,1
33234,роду,0,0,1,1
36717,ovenfra,0,0,1,1
50150,பிற்பகுதியில்,0,0,1,1
52716,τρομερό,0,0,1,1
47865,σύγκριση,0,0,1,1
47856,തൽപരരായ,0,0,1,1
33226,buildings,0,0,1,1
47844,robijnrode,0,0,1,1
47845,والنرويجية,0,0,1,1
49941,tanışın,0,0,1,1
47848,разрешает,0,0,1,1
36743,affirmé,0,0,1,1
47849,foresee,0,0,1,1
47850,இராணுவத்தால்,0,0,1,1
33227,ಎಲ್ಲಿಂದ,0,0,1,1
36741,участвуют,0,0,1,1
36740,taal,0,0,1,1
47854,ஐ,0,0,1,1
49940,തെറ്റാണ്,0,0,1,1
36738,dolu,0,0,1,1
47855,​​wat,0,0,1,1
36737,одноименной,0,0,1,1
36736,новостях,0,0,1,1
36735,обобщённой,0,0,1,1
33229,telefônica,0,0,1,1
36716,لويكيبيديا،,0,0,1,1
36715,arbetat,0,0,1,1
36689,فصاعدًا,0,0,1,1
36701,quién,0,0,1,1
33243,vitória,0,0,1,1
36699,inblick,0,0,1,1
52211,abla,0,0,1,1
33244,πρόσωπό,0,0,1,1
36697,ales,0,0,1,1
33245,formerly,0,0,1,1
47876,tegenkwam,0,0,1,1
33246,attendre,0,0,1,1
47877,وصيغة,0,0,1,1
36696,सेवाओ,0,0,1,1
33247,alterou,0,0,1,1
47878,carolina,0,0,1,1
36694,n’existait,0,0,1,1
47879,дело,0,0,1,1
36692,relevantes,0,0,1,1
36691,الزمرد,0,0,1,1
49933,जाएं,0,0,1,1
47882,intelectuais,0,0,1,1
36690,японском,0,0,1,1
33242,आपसी,0,0,1,1
33241,ലഭിച്ചില്ല,0,0,1,1
47866,hälsningar,0,0,1,1
36702,издаётся,0,0,1,1
36714,يضيف,0,0,1,1
33235,melisa,0,0,1,1
49938,интересных,0,0,1,1
47871,uitzicht,0,0,1,1
47872,sociales…,0,0,1,1
47873,defendido,0,0,1,1
49937,ζητώ,0,0,1,1
52208,упрекать,0,0,1,1
36708,"
पंजाबी",0,0,1,1
36707,войну,0,0,1,1
52209,sock,0,0,1,1
36705,motivera,0,0,1,1
33237,επανάληψη,0,0,1,1
36704,взволнованы,0,0,1,1
47874,ഇതൊക്കെ,0,0,1,1
47875,permissão,0,0,1,1
36703,knams,0,0,1,1
50151,renouvelables,0,0,1,1
49934,μαρμελάδες,0,0,1,1
36870,liaison,0,0,1,1
36872,കുറ്റകരമായ,0,0,1,1
37087,سينتهي,0,0,1,1
47659,wikeepeedeeə,0,0,1,1
33131,bescheiden,0,0,1,1
47657,källkod,0,0,1,1
37015,المتعددة,0,0,1,1
33132,wikipedia »,0,0,1,1
37014,ape,0,0,1,1
37013,amou,0,0,1,1
50004,yazılmaktadır,0,0,1,1
37011,weiteres,0,0,1,1
50003,anmodninger,0,0,1,1
47660,வாழ்ந்தார்,0,0,1,1
52724,ഉൽപത്തി,0,0,1,1
47661,vistas,0,0,1,1
37010,vivrait,0,0,1,1
37009,dynamics,0,0,1,1
33134,förhindrat,0,0,1,1
37008,திட்டங்களையும்,0,0,1,1
33135,ansiktet,0,0,1,1
47663,சந்திக்கிறீர்கள்,0,0,1,1
47664,révisions,0,0,1,1
52170,miró,0,0,1,1
47656,ostan,0,0,1,1
47655,apologies,0,0,1,1
37017,parodique,0,0,1,1
33129,évaluations,0,0,1,1
37025,விக்கித்திட்டம்,0,0,1,1
50637,eettafel,0,0,1,1
37024,ಐದು,0,0,1,1
50636,απουσιάζουν,0,0,1,1
50007,വരുന്നുണ്ടെന്നും,0,0,1,1
47648,طويلة,0,0,1,1
47649,invisibles »,0,0,1,1
33124,"
ब्रिटन",0,0,1,1
33125,объявлено,0,0,1,1
47651,χωριό,0,0,1,1
33126,പരാതിപ്പെടുകയും,0,0,1,1
47652,ενδιαφέρουσα,0,0,1,1
33127,"
urdu",0,0,1,1
50006,iletişimde,0,0,1,1
52168,മോശമായിത്തീർന്നത്,0,0,1,1
33128,indicates,0,0,1,1
37019,материала,0,0,1,1
37018,engelsksprogede,0,0,1,1
52169,redirecionamento,0,0,1,1
37005,pertenecientes,0,0,1,1
37004,dialectos,0,0,1,1
37003,கேள்வியைத்,0,0,1,1
52172,annuelle,0,0,1,1
50001,سنة,0,0,1,1
33138,உலகப்,0,0,1,1
52173,levens,0,0,1,1
52174,ಸಾಮಾನ್ಯವಾಗಿ,0,0,1,1
47674,wollte,0,0,1,1
47675,comprends,0,0,1,1
50140,ഉറക്കമുണർന്നു,0,0,1,1
47677,confirmó,0,0,1,1
50000,ഡിസംബർ,0,0,1,1
47678,مدريد,0,0,1,1
33139,хабрахабр,0,0,1,1
36981,instante,0,0,1,1
36980,philosophiques,0,0,1,1
36979,imaginar,0,0,1,1
33142,interagem,0,0,1,1
36978,"
स्कॉट्स",0,0,1,1
36977,மூழ்கிவிடும்,0,0,1,1
36976,uppfarten,0,0,1,1
36975,بالذكر,0,0,1,1
50634,tillförda,0,0,1,1
36986,förutsättningarna,0,0,1,1
37002,kaydını,0,0,1,1
36987,ಪಡೆದುಕೊಂಡಿದ್ದೇನೆ,0,0,1,1
50002,humorísticas,0,0,1,1
47665,суде,0,0,1,1
47666,κλασικές,0,0,1,1
36999,المعلقة,0,0,1,1
36998,tatlım,0,0,1,1
36997,permiten,0,0,1,1
52171,cuyo,0,0,1,1
33136,golpes,0,0,1,1
47668,वॉचलिस्ट,0,0,1,1
52725,الجنسين،,0,0,1,1
36994,психолога,0,0,1,1
36993,असहमत,0,0,1,1
47669,जोसेफ,0,0,1,1
36992,άγγελος,0,0,1,1
33137,മകളേ,0,0,1,1
47670,encontramos,0,0,1,1
47672,plato,0,0,1,1
36989,einschließlich,0,0,1,1
36988,geçmişinde,0,0,1,1
52166,überfluten,0,0,1,1
37027,tischmanieren,0,0,1,1
47646,викимедиа» —,0,0,1,1
47617,"
मूल",0,0,1,1
37072,ejército,0,0,1,1
47621,primarias,0,0,1,1
37070,പ്രസിദ്ധീകരണാനുമതി,0,0,1,1
37069,अचानक,0,0,1,1
47622,комиксе,0,0,1,1
52156,rocken,0,0,1,1
47624,corrélation,0,0,1,1
37065,സ്റ്റാൾമാൻ,0,0,1,1
37064,antigamente,0,0,1,1
37063,adotada,0,0,1,1
52158,olgudur,0,0,1,1
47626,ದೂರದವರೆಗೆ,0,0,1,1
50010,разделах,0,0,1,1
37059,fond ,0,0,1,1
47627,lipnet,0,0,1,1
33113,собственность,0,0,1,1
37057,sonhou,0,0,1,1
37056,تعلمنا,0,0,1,1
33114,res,0,0,1,1
47619,diplômes,0,0,1,1
50012,φιλικό,0,0,1,1
47629,coutumières,0,0,1,1
37074,இருந்து,0,0,1,1
33106,ಹಣ,0,0,1,1
33107,anlattı,0,0,1,1
50138,ложные,0,0,1,1
52153,оторваться,0,0,1,1
47611,बैंड,0,0,1,1
52154,красивых,0,0,1,1
47612,பிரிவில்,0,0,1,1
37083,versus,0,0,1,1
37081,троллями,0,0,1,1
47614,أعطيك,0,0,1,1
47615,encyclopedically,0,0,1,1
52155,mm,0,0,1,1
47616,आकाश,0,0,1,1
37078,brugt,0,0,1,1
37077,beskrivningsrutan,0,0,1,1
33110,sorprendida,0,0,1,1
37076,fötterna,0,0,1,1
37075,autres ,0,0,1,1
50013,καλύτερος,0,0,1,1
47628,racistas,0,0,1,1
37054,gewijzigde,0,0,1,1
50638,знала,0,0,1,1
47638,dê,0,0,1,1
47639,londonien,0,0,1,1
37037,catégoriser,0,0,1,1
37036,coke,0,0,1,1
50639,அழகும்,0,0,1,1
37035,الويكيبيديون,0,0,1,1
33120,uur,0,0,1,1
47640,брендом,0,0,1,1
47642,വിവരിക്കുമ്പോൾ,0,0,1,1
37034,frokost,0,0,1,1
52164,discontinued,0,0,1,1
37032,wikimini,0,0,1,1
33121,ചൂടാണ്,0,0,1,1
47644,ذوي,0,0,1,1
33122,ढांचा,0,0,1,1
52165,предыдущее,0,0,1,1
37029,ഗുണാങ്ക,0,0,1,1
37028,undersöker,0,0,1,1
33123,sendes,0,0,1,1
47645,filme,0,0,1,1
37039,kommentarbereich,0,0,1,1
33119,கட்டுரையிலும்,0,0,1,1
52161,échéance,0,0,1,1
52163,confundirse,0,0,1,1
37052,विजित,0,0,1,1
47630,لأطلب,0,0,1,1
47631,مقالاً,0,0,1,1
37051,internetsajter,0,0,1,1
37050,അൽഗോരിതങ്ങൾ,0,0,1,1
37049,ಬಿಸಿಯಾಗಿರುತ್ತದೆ,0,0,1,1
47632,alunos,0,0,1,1
37048,udgiver,0,0,1,1
47633,أم,0,0,1,1
37046,κανονικό,0,0,1,1
47634,महीने,0,0,1,1
50640,идете,0,0,1,1
33117,गिगल्स,0,0,1,1
37045,kartofler,0,0,1,1
47635,avantajları,0,0,1,1
50139,മാളിൽ,0,0,1,1
37044,yemeklerden,0,0,1,1
37043,ключевым,0,0,1,1
47636,testte,0,0,1,1
36974,بسلامة,0,0,1,1
36973,nyheter,0,0,1,1
47755,ശ്രമിക്കുക,0,0,1,1
36907,ഐക്കണും,0,0,1,1
36913,botste,0,0,1,1
36912,думать,0,0,1,1
36911,sonríe,0,0,1,1
50622,edilir,0,0,1,1
52186,இயலாது,0,0,1,1
47742,ποτέ,0,0,1,1
47743,ಸಂಪರ್ಕದಲ್ಲಿರಿ,0,0,1,1
33183,മനസ്സിലാക്കുന്നത്,0,0,1,1
36908,தூண்டுகிறது,0,0,1,1
33184,экспертной,0,0,1,1
47680,تقليدية,0,0,1,1
36906,"
servocroata",0,0,1,1
36905,olmadığı,0,0,1,1
33185,बहन,0,0,1,1
36903,добрые,0,0,1,1
36902,πουλί,0,0,1,1
47745,rebellion,0,0,1,1
36900,പോസിറ്റീവും,0,0,1,1
33188,håll,0,0,1,1
36899,appreciate,0,0,1,1
49975,വിക്കിപീഡിയരിൽ,0,0,1,1
33181,കണക്കാക്കാറില്ല,0,0,1,1
49976,dessous,0,0,1,1
36914,وسماع,0,0,1,1
36924,şarkılarda,0,0,1,1
36923,υπευθυνότητας,0,0,1,1
33173,വീഡിയോയിലേക്ക്,0,0,1,1
36922,respectueux,0,0,1,1
47725,achte,0,0,1,1
47726,சொல்லிலிருந்து,0,0,1,1
47729,« wikipedia,0,0,1,1
36919,"
चुवाश",0,0,1,1
47731,பயனர்களின்,0,0,1,1
33174,toekomst,0,0,1,1
50623,distant,0,0,1,1
52185,आते,0,0,1,1
47733,ينسى,0,0,1,1
36917,équivaut,0,0,1,1
49978,स्टेवर्डशिप,0,0,1,1
49977,exposed,0,0,1,1
36916,निरन्तर,0,0,1,1
33179,préparer,0,0,1,1
47739,hegemony,0,0,1,1
36898,gerçekleşirse,0,0,1,1
36897,неприятную,0,0,1,1
52188,çelişkili,0,0,1,1
33195,cached,0,0,1,1
36883,culturelles ,0,0,1,1
36882,விரும்புகின்றனர்,0,0,1,1
47751,ذروته,0,0,1,1
36881,referans,0,0,1,1
36880,exagerar,0,0,1,1
36879,rape,0,0,1,1
36878,என்பதைச்,0,0,1,1
50618,asemejan,0,0,1,1
36877,неточностей —,0,0,1,1
47754,लीजिए,0,0,1,1
36876,nuit,0,0,1,1
49971,aconsejando,0,0,1,1
33198,cresce,0,0,1,1
36875,mödan,0,0,1,1
52190,"
प्रारंभ",0,0,1,1
33199,ಉತ್ಪ್ರೇಕ್ಷಿಸಲು,0,0,1,1
36874,paysagères,0,0,1,1
36873,wherein,0,0,1,1
52192,ഗ്രോഡിയന്റേ,0,0,1,1
33196,شاهدها,0,0,1,1
33194,الكتاب,0,0,1,1
47746,चांदी,0,0,1,1
33193,त्रुटियां,0,0,1,1
36896,पेटेंट,0,0,1,1
36895,editörü,0,0,1,1
33190,клетками,0,0,1,1
36894,ljusa,0,0,1,1
36893,этими,0,0,1,1
36892,multilayer,0,0,1,1
36891,conduisent,0,0,1,1
36890,begins,0,0,1,1
36889,புளகாங்கிதம்,0,0,1,1
36888,sıkıcı,0,0,1,1
49972,ബീഹാറി,0,0,1,1
52723,leçon,0,0,1,1
36887,வங்கிக்,0,0,1,1
36886,ஆசிரியராகப்,0,0,1,1
33192,മലയാളഭാഷയിൽ,0,0,1,1
36885,ஐஸ்கிரீம்,0,0,1,1
50145,cavalgou,0,0,1,1
36884,τρεις,0,0,1,1
52189,услышите,0,0,1,1
47723,öyleyse,0,0,1,1
52184,adoptado,0,0,1,1
47722,matsalen,0,0,1,1
33152,κανόνα—αλλά,0,0,1,1
33155,അന്തരം,0,0,1,1
49994,настройка,0,0,1,1
33157,kennedy,0,0,1,1
33158,rotulada,0,0,1,1
52180,ಉಡುಗೆ,0,0,1,1
36960,έργο,0,0,1,1
50630,αγκαλιάσει,0,0,1,1
47694,hulp,0,0,1,1
47697,“மைசீக்குவல்”,0,0,1,1
36958,possesseur,0,0,1,1
47698,कहें,0,0,1,1
36957,especificados,0,0,1,1
52182,dibujada,0,0,1,1
50628,المرآة,0,0,1,1
47699,കുറവുമുള്ളതായി,0,0,1,1
33159,demostró,0,0,1,1
49993,publishes,0,0,1,1
36953,நிர்வாகக்,0,0,1,1
36952,« appels »,0,0,1,1
49995,sk •,0,0,1,1
33151,gleich,0,0,1,1
47701,visualización,0,0,1,1
50631,نكتة,0,0,1,1
36972,wonderful,0,0,1,1
36971,кампании,0,0,1,1
36969,lättare,0,0,1,1
33144,ಮೂರನೆಯ,0,0,1,1
47684,mirrors,0,0,1,1
33145,accrue,0,0,1,1
49998,усыпана,0,0,1,1
33147,temsil,0,0,1,1
47685,ಹುಡುಗರಲ್ಲಿ,0,0,1,1
49997,മേശ,0,0,1,1
47687,huiquipedia,0,0,1,1
49996,deixa,0,0,1,1
47689,pérennité,0,0,1,1
36965,അതിഭീകരരായ,0,0,1,1
50632,ушли,0,0,1,1
33148,ಅರಮನೆಯಲ್ಲಿ,0,0,1,1
36963,inserida,0,0,1,1
52179,prédictive,0,0,1,1
47692,научной,0,0,1,1
33161,நிலை,0,0,1,1
36951,prisões,0,0,1,1
36926,remunerado,0,0,1,1
47712,المتمثل,0,0,1,1
47713,ശ്രദ്ധയിൽ,0,0,1,1
47714,مصداقيتها,0,0,1,1
47715,noting,0,0,1,1
47716,تعيشها,0,0,1,1
36934,colder,0,0,1,1
36933,aziz,0,0,1,1
47717,कोने,0,0,1,1
47718,acquire,0,0,1,1
33169,raakt,0,0,1,1
36932,ألست,0,0,1,1
52183,ತರಬಹುದೇ,0,0,1,1
36930,controvertidos​,0,0,1,1
49980,bloqueadas,0,0,1,1
33171,veteranos—,0,0,1,1
47719,tido,0,0,1,1
47721,сообщений,0,0,1,1
36928,φυλακές,0,0,1,1
49979,кажется,0,0,1,1
36927,lagunas,0,0,1,1
36939,приготовилась,0,0,1,1
49982,θέα,0,0,1,1
47702,wachsen,0,0,1,1
36940,चूँकि,0,0,1,1
47703,நிறுவனமான,0,0,1,1
50627,التاريخية,0,0,1,1
47705,secundárias,0,0,1,1
49990,buydu,0,0,1,1
49989,færre,0,0,1,1
47706,μήπως,0,0,1,1
49987,logistique,0,0,1,1
49986,ರೋಮಾಂಚನಕಾರಿ,0,0,1,1
36947,jahr,0,0,1,1
49985,സഹായകരമാണോ,0,0,1,1
33165,podrá,0,0,1,1
36945,крупный,0,0,1,1
33166,basket,0,0,1,1
33167,agradável,0,0,1,1
36943,nelson,0,0,1,1
47709,المجتمع ,0,0,1,1
47711,somewhere,0,0,1,1
36941,λεπτό,0,0,1,1
50142,एम्स्टरडाम,0,0,1,1
35992,ಪೆಟ್ಟಿಗೆಯಲ್ಲಿ,0,0,1,1
34218,εκείνους,0,0,1,1
35990,foretrukne,0,0,1,1
34797,examensrapporter,0,0,1,1
49517,ಎಲ್ಲಿಗೆ,0,0,1,1
49516,küçücük,0,0,1,1
34801,overlap,0,0,1,1
34800,പറയാതെ,0,0,1,1
49515,organisée,0,0,1,1
49041,seraitce,0,0,1,1
34799,благонамеренных,0,0,1,1
49514,مصدري,0,0,1,1
33991,принес,0,0,1,1
34796,katıldığımdan,0,0,1,1
34788,deinem,0,0,1,1
33992,ملياري,0,0,1,1
49042,seks,0,0,1,1
49043,caracteres,0,0,1,1
52491,organisationer,0,0,1,1
34793,укрепить,0,0,1,1
33993,married,0,0,1,1
34792,insult,0,0,1,1
50372,продвижении,0,0,1,1
34790,ಅವುಗಳನ್ನು,0,0,1,1
34802,ഭ്രാന്തൻ,0,0,1,1
34803,meşgulüm,0,0,1,1
33987,ജയിലുകളിൽ,0,0,1,1
34804,تنس,0,0,1,1
34816,செய்துள்ளேன்,0,0,1,1
34815,trafic »,0,0,1,1
49029,divulgación,0,0,1,1
49030,जटिल,0,0,1,1
49519,πόλη,0,0,1,1
34814,apresentassem,0,0,1,1
49031,المشاريع,0,0,1,1
34812,brisés,0,0,1,1
34811,τρελό,0,0,1,1
49032,база,0,0,1,1
49033,anna,0,0,1,1
49518,ആരംഭിക്കാൻ,0,0,1,1
34807,reageren,0,0,1,1
49035,scientology,0,0,1,1
49036,അതുകൊണ്ടൊക്കെ,0,0,1,1
34806,بقائمة,0,0,1,1
49037,ಟಿಪ್,0,0,1,1
33986,tradutores,0,0,1,1
34805,يظن,0,0,1,1
34789,begreppet,0,0,1,1
49044,intelectual,0,0,1,1
52603,सुविचारित,0,0,1,1
34005,internetcensur,0,0,1,1
34002,tvärt,0,0,1,1
50369,contribué,0,0,1,1
34774,पुनः,0,0,1,1
34773,വരാനുള്ള,0,0,1,1
49053,الامور؟,0,0,1,1
34003,effectuées,0,0,1,1
50368,ईमानदार,0,0,1,1
34004,apagados,0,0,1,1
34771,interact,0,0,1,1
34769,sparkly,0,0,1,1
50371,مروع,0,0,1,1
34768,пределы,0,0,1,1
52493,wonders,0,0,1,1
34767,नियमित,0,0,1,1
49056,árbol,0,0,1,1
49057,kultiveret,0,0,1,1
49058,değiştirilmeye,0,0,1,1
49059,ورمز,0,0,1,1
49507,существительных,0,0,1,1
50367,conectados,0,0,1,1
34776,मुस्कुराते,0,0,1,1
34001,чертой,0,0,1,1
49508,திருத்தங்கள்,0,0,1,1
34777,внимательно,0,0,1,1
34786,fragezeichen,0,0,1,1
34785,lugna,0,0,1,1
49512,फ्राई,0,0,1,1
50261,സമൂഹത്തിൽ,0,0,1,1
34784,ಪ್ರಯತ್ನಿಸುವಾಗ,0,0,1,1
34783,оперативно,0,0,1,1
33995,narciss,0,0,1,1
34782,basan,0,0,1,1
33996,egípcio,0,0,1,1
49510,teklifler,0,0,1,1
33998,അഭിപ്രായമിടുന്നതിലൂടെ,0,0,1,1
49047,അനാവശ്യ,0,0,1,1
34781,propietario,0,0,1,1
34780,bemvindo,0,0,1,1
33999,сформулировало,0,0,1,1
49049,"law ·
ഭൗതികശാസ്ത്രം ·
pollution",0,0,1,1
34000,«уловка»,0,0,1,1
34778,أشارت,0,0,1,1
49051,ആവശ്യത്തിന്,0,0,1,1
49028,തമാശകളും,0,0,1,1
34818,static,0,0,1,1
49521,synder,0,0,1,1
52479,μέσων,0,0,1,1
33971,പ്രതിബിംബത്തിൽ,0,0,1,1
34857,ஜோசப்,0,0,1,1
50259,hebrea—,0,0,1,1
34856,بعدد,0,0,1,1
34855,многоуровневую,0,0,1,1
33972,يشعر,0,0,1,1
50377,zeldzaamheid,0,0,1,1
34852,cabeça,0,0,1,1
34851,datagenerating,0,0,1,1
34849,വാഗ്ദാനം,0,0,1,1
33984,zoekopdracht,0,0,1,1
34848,момента,0,0,1,1
34847,серебряный,0,0,1,1
52611,содержал,0,0,1,1
33973,aggregate,0,0,1,1
34846,utilizó,0,0,1,1
49529,breit,0,0,1,1
34845,prémunir,0,0,1,1
49528,artificiell,0,0,1,1
49009,öbeğini,0,0,1,1
34858,verwijst,0,0,1,1
34859,rappeler,0,0,1,1
49006,contract,0,0,1,1
49531,σ,0,0,1,1
52613,regardons,0,0,1,1
49003,ulaştığını,0,0,1,1
33966,മനസിലാക്കിയാൽ,0,0,1,1
50381,behandelde,0,0,1,1
34870,γλυκιάς,0,0,1,1
34869,وجهات,0,0,1,1
34868,أوراق,0,0,1,1
52612,കിട്ടുന്ന,0,0,1,1
50379,aconteceu,0,0,1,1
50378,ಕಾಣಿಸುತ್ತಿದ್ದಳು,0,0,1,1
33967,chronométrez,0,0,1,1
34865,abandonaban,0,0,1,1
33968,άλλαξε,0,0,1,1
34864,ideias,0,0,1,1
33969,जागरूकता,0,0,1,1
34863,customers,0,0,1,1
33970,sonuca,0,0,1,1
34862,jemals,0,0,1,1
34861,എല്ലാവരികൾക്കും,0,0,1,1
34844,hierher,0,0,1,1
33974,centralt,0,0,1,1
49010,concreta,0,0,1,1
49021,ستنمو,0,0,1,1
49023,müzik,0,0,1,1
34829,criativa,0,0,1,1
34828,снится,0,0,1,1
33980,renunciou,0,0,1,1
49024,ämnesorienterade,0,0,1,1
52488,بالإسبانية,0,0,1,1
33981,анонимными,0,0,1,1
34825,laundry,0,0,1,1
34824,προσέχεις,0,0,1,1
33982,intet,0,0,1,1
49026,lyt,0,0,1,1
34822,saborosas,0,0,1,1
34821,सतत,0,0,1,1
50375,sağ,0,0,1,1
50374,உரையாடலின்,0,0,1,1
49522,"
फ़िजी",0,0,1,1
49027,تنحاز,0,0,1,1
34819,filtrerades,0,0,1,1
52490,célèbre,0,0,1,1
49022,vererek,0,0,1,1
52486,написаны,0,0,1,1
49011,"
पैन्सिलवेनियाई",0,0,1,1
49020,ಹೆದರುವುದಿಲ್ಲ,0,0,1,1
33975,ಇಷ್ಟಪಡುತ್ತೇನೆ,0,0,1,1
34842,ബോക്സിൽ,0,0,1,1
49012,vicente,0,0,1,1
33976,pangaea,0,0,1,1
49013,специалистам,0,0,1,1
49014,மொழிப்பதிப்பும்,0,0,1,1
49016,നിന്നെക്കുറിച്ച്,0,0,1,1
52482,alışveriş,0,0,1,1
33977,tasty,0,0,1,1
49018,credentials,0,0,1,1
49527,ταξίδευαν,0,0,1,1
33978,annorlunda,0,0,1,1
49526,interesadamente,0,0,1,1
34835,stub,0,0,1,1
49525,குறுக்கிட்டதற்கு,0,0,1,1
49019,पड़ाव,0,0,1,1
49524,നിസാര,0,0,1,1
33979,obligados,0,0,1,1
52484,دعونا,0,0,1,1
34764,конфликтам,0,0,1,1
34763,подкреплены,0,0,1,1
50262,grants,0,0,1,1
34039,وصُفت,0,0,1,1
49104,дисперсией,0,0,1,1
49105,планов,0,0,1,1
34036,microscopic,0,0,1,1
34702,siffror,0,0,1,1
34037,bereikte,0,0,1,1
34038,വസ്ത്രധാരണരീതി,0,0,1,1
49107,jouait,0,0,1,1
34700,formu,0,0,1,1
49108,квартале,0,0,1,1
49109,bevisa,0,0,1,1
34028,семена,0,0,1,1
49110,онлайнсправочников,0,0,1,1
52501,digestive,0,0,1,1
49113,научного,0,0,1,1
34040,salud​,0,0,1,1
34698,кукла,0,0,1,1
50354,उठाया,0,0,1,1
49114,bs •,0,0,1,1
34697,தகவல்களின்,0,0,1,1
34696,proliferation,0,0,1,1
49103,doneren,0,0,1,1
34705,воспроизводимость,0,0,1,1
52605,komik,0,0,1,1
34706,مرجعية,0,0,1,1
34713,granska,0,0,1,1
49094,vurgulamanın,0,0,1,1
49095,déchristianisation,0,0,1,1
34712,വിക്കിപീഡിയർക്ക്,0,0,1,1
49096,bilderna,0,0,1,1
49097,ευχηθείτε,0,0,1,1
34711,"
italiano",0,0,1,1
34031,البرنامج،,0,0,1,1
34710,غدا؟,0,0,1,1
34709,inserir,0,0,1,1
34032,"
कोमीपेर्मायक",0,0,1,1
34033,frihetens,0,0,1,1
52606,அங்கீகரிக்கப்படல்,0,0,1,1
49100,எப்படியாவது,0,0,1,1
34034,exposiciones,0,0,1,1
49101,സുന്ദരനാണെന്ന്,0,0,1,1
34707,kriteriet,0,0,1,1
34035,yiyemiyorsan,0,0,1,1
49102,شجع,0,0,1,1
34695,huil,0,0,1,1
34694,fraudes,0,0,1,1
49116,belge,0,0,1,1
34683,ಹೋಗುತ್ತದೆ,0,0,1,1
34681,reprints,0,0,1,1
34680,ήρεμος,0,0,1,1
34679,beschrieb,0,0,1,1
49119,ಕ್ಷಮೆಯನ್ನು,0,0,1,1
34677,knol —,0,0,1,1
34676,வாழ்க்கையை,0,0,1,1
34675,إلكترونية,0,0,1,1
34048,flummoxade,0,0,1,1
49120,ध्वजांकित,0,0,1,1
49121,समाज,0,0,1,1
49494,autorisations,0,0,1,1
34050,geluksvogel,0,0,1,1
52508,ifrågasatts,0,0,1,1
34673,ಅದೃಷ್ಟವನ್ನು,0,0,1,1
50349,måtte,0,0,1,1
50348,å,0,0,1,1
34672,рубинов,0,0,1,1
34051,indfødte,0,0,1,1
34052,ಭೀಕರ,0,0,1,1
34682,फ़ाइलों,0,0,1,1
49496,характера,0,0,1,1
34693,haftalarca,0,0,1,1
34684,φοβισμένος,0,0,1,1
34692,உணவை,0,0,1,1
34691,dilemmes,0,0,1,1
49497,बताएं,0,0,1,1
34690,الإدارية,0,0,1,1
34689,crítico,0,0,1,1
34041,verschilt,0,0,1,1
34042,depicts,0,0,1,1
49118,ನನಸಾದರೆ,0,0,1,1
34688,læsere,0,0,1,1
34043,состоит,0,0,1,1
52502,preservar,0,0,1,1
34045,hjerne,0,0,1,1
50353,nonhumains,0,0,1,1
52504,plucker,0,0,1,1
50264,otimizam,0,0,1,1
52505,يسألك,0,0,1,1
52506,нежелательными,0,0,1,1
34685,visant,0,0,1,1
50352,participating,0,0,1,1
34029,oturan,0,0,1,1
34027,maldonado ,0,0,1,1
49060,оперирующий,0,0,1,1
34746,ഡിഗ്രിവിദ്യാർത്ഥി,0,0,1,1
50364,മൂലം,0,0,1,1
50363,concourent,0,0,1,1
34013,hoeveelheden,0,0,1,1
50361,apropriadas,0,0,1,1
34749,etablerad,0,0,1,1
52610,scharfe,0,0,1,1
50360,крокером,0,0,1,1
34747,petits,0,0,1,1
49077,കഴിക്കണം,0,0,1,1
34014,διασκεδαστικό,0,0,1,1
52607,voorbereid,0,0,1,1
49078,enterarse,0,0,1,1
49079,energieksempel,0,0,1,1
34744,കന്നഡ,0,0,1,1
34743,stöd,0,0,1,1
52496,moois,0,0,1,1
34742,esszimmer,0,0,1,1
34741,definirse,0,0,1,1
52497,portuguese,0,0,1,1
34740,orienté,0,0,1,1
34012,overzichtsartikelen,0,0,1,1
49073,мэттьюс,0,0,1,1
34753,ഗൃഹപാഠം,0,0,1,1
49072,ay,0,0,1,1
49505,തളർന്നില്ലെന്ന്,0,0,1,1
34761,statistique,0,0,1,1
34009,förberedde,0,0,1,1
49061,uzlaşamamasına,0,0,1,1
49504,obscenidade,0,0,1,1
34759,aristotélicienne,0,0,1,1
49062,conceptions,0,0,1,1
49503,promotional,0,0,1,1
34758,दोषी,0,0,1,1
34757,årlig,0,0,1,1
34756,redistributing,0,0,1,1
49063,skarpaste,0,0,1,1
49064,основного,0,0,1,1
34011,boneca,0,0,1,1
49066,controverse ,0,0,1,1
50366,अवार्ड,0,0,1,1
49068,inconsistencias​,0,0,1,1
49070,foregår,0,0,1,1
50365,ventajas,0,0,1,1
49502,επαγγελματική,0,0,1,1
34738,കരയാൻ,0,0,1,1
49080,rato»,0,0,1,1
34021,ಹೇಳಿದಾಗ,0,0,1,1
50263,definierade,0,0,1,1
34724,प्रयत्न,0,0,1,1
49089,लाद,0,0,1,1
50357,ಹೋಗುವಾಗ,0,0,1,1
34023,ഭൂമിക്ക്,0,0,1,1
49500,habilidad,0,0,1,1
49090,evliliği,0,0,1,1
34721,afortunada,0,0,1,1
34720,प्रौद्योगिकी,0,0,1,1
49091,webbversionen,0,0,1,1
49499,வேலையைப்,0,0,1,1
34718,τράπεζα,0,0,1,1
49092,للهوية,0,0,1,1
34024,görüşme,0,0,1,1
50356,βάση,0,0,1,1
52499,mühen,0,0,1,1
49498,minecraft,0,0,1,1
34717,تميل,0,0,1,1
34714,planlıyorum,0,0,1,1
34022,pedestrian,0,0,1,1
34020,freakade,0,0,1,1
34737,elva,0,0,1,1
49088,അതിശയകരമായി,0,0,1,1
49081,noted,0,0,1,1
34736,zurückwies,0,0,1,1
34735,ജർമൻ,0,0,1,1
49082,entraînement »,0,0,1,1
34015,skyldiga,0,0,1,1
34733,fará,0,0,1,1
52609,домашнее,0,0,1,1
49085,للإعجاب,0,0,1,1
34016,codified,0,0,1,1
34017,licensor,0,0,1,1
49086,использовании,0,0,1,1
52498,précisant ,0,0,1,1
52608,उम्र,0,0,1,1
49087,விளைவிக்கக்கூடிய,0,0,1,1
34731,നീക്കം,0,0,1,1
34730,buiten,0,0,1,1
34728,pathogenic,0,0,1,1
34018,functioning,0,0,1,1
34019,പാമരനും,0,0,1,1
34873,« vandalismes »,0,0,1,1
33965,olduğuydu,0,0,1,1
33964,попадет,0,0,1,1
48905,calmezvous,0,0,1,1
35026,aynada,0,0,1,1
48901,sweetheart,0,0,1,1
33906,χαίρομαι,0,0,1,1
35024,स्कॉट,0,0,1,1
48902,المتباينة,0,0,1,1
52451,reacción,0,0,1,1
48903,தேடுகிறோம்,0,0,1,1
48904,βικιεπιστήμιο,0,0,1,1
35021,"
अरबी",0,0,1,1
35020,تعليقات,0,0,1,1
49571,единственной,0,0,1,1
49567,πλήρως,0,0,1,1
50397,لإخبار,0,0,1,1
48908,webos,0,0,1,1
48909,notorias,0,0,1,1
48910,urbaines,0,0,1,1
48912,«фазы,0,0,1,1
35015,مجتمعة,0,0,1,1
50396,tillåtet,0,0,1,1
35014,എൻട്രോപ്പി,0,0,1,1
48900,உச்சரிப்பைக்,0,0,1,1
48898,llore,0,0,1,1
35028,aldın,0,0,1,1
35029,attitudes,0,0,1,1
48895,tornarmos,0,0,1,1
52448,operado,0,0,1,1
33900,யூகித்தாலும்,0,0,1,1
35039,आंकडों,0,0,1,1
33901,терпеливо,0,0,1,1
35038,sorts,0,0,1,1
35037,важно,0,0,1,1
35036,ದಣಿದಿದ್ದರೆ,0,0,1,1
35035,ώστε,0,0,1,1
52449,levensvatbare,0,0,1,1
35033,donnezlui,0,0,1,1
52450,ayudarte,0,0,1,1
49569,melekle,0,0,1,1
33902,gözleri,0,0,1,1
50251,പരീക്ഷകൾ,0,0,1,1
33904,selecionado,0,0,1,1
35031,ακούτε,0,0,1,1
35030,arkadaşlar,0,0,1,1
33905,programadores,0,0,1,1
48914,aanzet,0,0,1,1
35012,മെച്ചപ്പെടുത്തുന്നുണ്ട്,0,0,1,1
48915,производных,0,0,1,1
52457,ಅವರೊಂದಿಗೆ,0,0,1,1
34999,ಹೇಳುವದನ್ನು,0,0,1,1
34998,غالباً،,0,0,1,1
48925,binnenstapte,0,0,1,1
34996,μεγαλύτερο,0,0,1,1
48926,domaine ,0,0,1,1
34994,compositeur,0,0,1,1
49562,lowerlevel,0,0,1,1
34993,opretholde,0,0,1,1
52622,ವಿವರಿಸುವ,0,0,1,1
48927,बताओ,0,0,1,1
34991,вечер,0,0,1,1
34990,πηδήσω,0,0,1,1
34988,leger,0,0,1,1
33912,idari,0,0,1,1
49561,ജനാധിപത്യ,0,0,1,1
48929,reichtum,0,0,1,1
34987,ajuster,0,0,1,1
34986,ನಾಯಿ,0,0,1,1
34985,betterwritten,0,0,1,1
48924,ಶುಕ್ರವಾರ,0,0,1,1
52623,ثقيلة,0,0,1,1
35011,océaniques,0,0,1,1
48921,echten,0,0,1,1
35010,തിരഞ്ഞെടുത്ത്,0,0,1,1
35009,preguntaba,0,0,1,1
52454,perceptibles,0,0,1,1
35007,langweilig,0,0,1,1
35006,പെർഫക്റ്റാവണം,0,0,1,1
48917,stemmetone,0,0,1,1
35005,teorier,0,0,1,1
49566,पीएचडी,0,0,1,1
33907,testigos,0,0,1,1
35003,débats,0,0,1,1
33908,दिलचस्पी,0,0,1,1
48919,ഇല്ലെങ്കിൽ,0,0,1,1
48920,participatória,0,0,1,1
35001,تفعله,0,0,1,1
49565,பெட்டியில்,0,0,1,1
52624,ಸುಸಂಸ್ಕೃತ,0,0,1,1
33909,tracking,0,0,1,1
49564,बताओ।,0,0,1,1
52455,nourrir,0,0,1,1
33899,dini,0,0,1,1
50398,സന്തോഷവാനാണ്,0,0,1,1
33915,aidezmoi,0,0,1,1
48878,yıkayacağım,0,0,1,1
48875,gepolijst,0,0,1,1
35080,planctu,0,0,1,1
35079,styrkor,0,0,1,1
48876,physicochimiques,0,0,1,1
48877,തോന്നുന്നതുപോലെ,0,0,1,1
50404,сохраняют,0,0,1,1
52441,traditions,0,0,1,1
52626,വിക്കിപീഡിയകളിൽ,0,0,1,1
35077,पूछना,0,0,1,1
48879,brook,0,0,1,1
52446,«площадкой»,0,0,1,1
35075,gazetesi,0,0,1,1
33884,onjuist,0,0,1,1
49580,attirée,0,0,1,1
35074,personnage,0,0,1,1
35073,mücadeleyi,0,0,1,1
48880,gösterilmiştir,0,0,1,1
33887,symbiantelefoner,0,0,1,1
48881,frihed,0,0,1,1
50403,மறந்துவிடுவார்,0,0,1,1
35081,зверский,0,0,1,1
33883,σταθερά,0,0,1,1
50249,referente,0,0,1,1
48874,விக்கிப்பீடியாவாக,0,0,1,1
48868,новая,0,0,1,1
35089,afunda,0,0,1,1
48869,doktorerat,0,0,1,1
48870,neutre,0,0,1,1
33875,juridiska,0,0,1,1
49587,സ്വപ്നത്തെക്കുറിച്ച്,0,0,1,1
35087,ನೋಡುವ,0,0,1,1
33878,widersprüchliche,0,0,1,1
35085,ದಣಿದಿದ್ದೀರಾ,0,0,1,1
48872,espéronsle,0,0,1,1
50248,tese,0,0,1,1
52439,ಮೂಲಗಳನ್ನು,0,0,1,1
52440,പഠിച്ചു,0,0,1,1
33880,oprindelser,0,0,1,1
50407,deforestation,0,0,1,1
35084,déplace,0,0,1,1
35083,അന്താരാഷ്ട്ര,0,0,1,1
33881,ağır,0,0,1,1
49584,മെച്ചപ്പെടുത്തുവാനും,0,0,1,1
35071,uppskattar,0,0,1,1
35070,tolkningar,0,0,1,1
48883,santiago,0,0,1,1
49577,yüzlerce,0,0,1,1
35053,antiguo,0,0,1,1
35052,السجون,0,0,1,1
35051,अद्यतन,0,0,1,1
35050,وبعد,0,0,1,1
35049,interrupting,0,0,1,1
49576,ഉത്ഭവം,0,0,1,1
35048,взял,0,0,1,1
48891,manifestation,0,0,1,1
49575,doğrultusunda,0,0,1,1
35047,aulas,0,0,1,1
35046,أطلب,0,0,1,1
48892,nomeadamente,0,0,1,1
48893,çorbada,0,0,1,1
49573,interests,0,0,1,1
33894,uncorrected,0,0,1,1
35044,phu,0,0,1,1
33895,narcissushand,0,0,1,1
49572,ansvarig,0,0,1,1
33897,लव,0,0,1,1
35054,مجاني,0,0,1,1
33889,പോലെയാണ്,0,0,1,1
35068,പ്ലേറ്റിൽ,0,0,1,1
35056,дартмутского,0,0,1,1
48884,الطب,0,0,1,1
35067,regulation,0,0,1,1
48885,contributes,0,0,1,1
48886,всему,0,0,1,1
50401,ಮುಂದುವರಿಸುವ,0,0,1,1
48887,paradigms,0,0,1,1
35063,эмбриональноподобное,0,0,1,1
52442,associé,0,0,1,1
52625,naamwoord,0,0,1,1
35062,നാർസിസയെ,0,0,1,1
35061,ಬಳಸುತ್ತೀರಿ,0,0,1,1
49578,yann,0,0,1,1
35060,motivations,0,0,1,1
35059,पीटर,0,0,1,1
52443,implicaba,0,0,1,1
35058,créatures,0,0,1,1
50400,klassieke,0,0,1,1
35057,mensuelles,0,0,1,1
50399,وسيول,0,0,1,1
52460,е д свердлов,0,0,1,1
34984,قراءة,0,0,1,1
34875,videnskabsetik,0,0,1,1
34909,डालने,0,0,1,1
48977,текстом,0,0,1,1
49545,ortasındaysanız,0,0,1,1
50256,замка,0,0,1,1
34913,многократно,0,0,1,1
48978,ಪಾರ್ಟಿಯಲ್ಲಿರುವಾಗ,0,0,1,1
34912,изложение,0,0,1,1
34911,conexão,0,0,1,1
49544,отличие,0,0,1,1
33943,north,0,0,1,1
49543,brotbrot,0,0,1,1
33936,hazırlandığını,0,0,1,1
33945,silinebilir,0,0,1,1
33946,comic,0,0,1,1
49542,aanleidinggevende,0,0,1,1
49541,обычный,0,0,1,1
34905,حسنا,0,0,1,1
34904,klockikonen,0,0,1,1
52616,personaje,0,0,1,1
34903,saúde,0,0,1,1
33950,poignée,0,0,1,1
34915,ಅಡ್ಡಿಪಡಿಸಲು,0,0,1,1
33942,numériques,0,0,1,1
50387,ചിന്തിച്ചേക്കാം,0,0,1,1
34918,напомнить,0,0,1,1
34932,arbres,0,0,1,1
48975,इन्सटाल,0,0,1,1
34929,приложенийисточник,0,0,1,1
34928,செய்தாலன்றி,0,0,1,1
34927,τύχη,0,0,1,1
34926,полезным,0,0,1,1
33937,article »aa,0,0,1,1
49546,читателей,0,0,1,1
34925,चुनौती,0,0,1,1
34924,kelimeyle,0,0,1,1
34923,கேட்கிறேன்,0,0,1,1
52474,wiskundeboek,0,0,1,1
33939,serveursquand ,0,0,1,1
50255,encargado,0,0,1,1
34922,கலைக்களஞ்சியமாகும்,0,0,1,1
33941,representante,0,0,1,1
34921,duydunuz,0,0,1,1
34920,ಸೂಪ್‌ನಲ್ಲಿದ್ದೇನೆ,0,0,1,1
34919,ειδικά,0,0,1,1
48982,காலையில்,0,0,1,1
50386,കണ്ടതിൽ,0,0,1,1
52476,ganado,0,0,1,1
52615,திரைப்படங்கள்,0,0,1,1
33955,tidskrift,0,0,1,1
49534,إضافية,0,0,1,1
49533,कायम,0,0,1,1
48991,முதன்மைக்,0,0,1,1
52477,अनुकूल,0,0,1,1
48992,patrón,0,0,1,1
50382,verborreica,0,0,1,1
52478,agreeing,0,0,1,1
33959,एफ़,0,0,1,1
33960,üzerime,0,0,1,1
33961,planları,0,0,1,1
34878,تعايش,0,0,1,1
49532,document,0,0,1,1
48998,seriøs,0,0,1,1
33962,ബേക്കർ,0,0,1,1
48999,സമ്പത്ത്,0,0,1,1
52614,أبعد,0,0,1,1
34876,recommendations,0,0,1,1
49001,помещаю,0,0,1,1
34884,cent,0,0,1,1
48989,июля,0,0,1,1
34900,मिश्रित,0,0,1,1
34886,сосуществовали,0,0,1,1
34899,மாற்றங்களுக்கான,0,0,1,1
34898,équitable,0,0,1,1
33952,methodological,0,0,1,1
34897,откусил,0,0,1,1
34896,gusto,0,0,1,1
34895,descubierto,0,0,1,1
34893,минуту,0,0,1,1
34892,uppsatsens,0,0,1,1
50384,låtar,0,0,1,1
49537,سؤاله,0,0,1,1
49536,ويكيبيديين,0,0,1,1
48987,laccoliths,0,0,1,1
33953,समन्वित,0,0,1,1
48988,precedentes,0,0,1,1
49535,ಪಚ್ಚೆಗಳ,0,0,1,1
33954,kaleme,0,0,1,1
34888,тюрьмах,0,0,1,1
50383,incita,0,0,1,1
34887,saborosa,0,0,1,1
34933,contrasting,0,0,1,1
34934,conformada,0,0,1,1
48931,element,0,0,1,1
48945,"

विकिपीडिया",0,0,1,1
34974,amid,0,0,1,1
34973,oficinas,0,0,1,1
34972,dispensem,0,0,1,1
52620,плакал,0,0,1,1
50392,രഹസ്യവുമായ,0,0,1,1
34971,ødelagt,0,0,1,1
52467,tumor,0,0,1,1
50391,wikiscanninghistorien,0,0,1,1
49556,എഴുത്തുകാരുടേയും,0,0,1,1
34968,إتمام,0,0,1,1
48972,compleet,0,0,1,1
34967,एलेक्सा,0,0,1,1
34965,fournissent,0,0,1,1
52468,காணலாம்,0,0,1,1
50389,мужчин,0,0,1,1
34964,உலாவியையும்,0,0,1,1
48948,swarm,0,0,1,1
34963,отпустила,0,0,1,1
48950,—sobre,0,0,1,1
34961,учреждений,0,0,1,1
34975,verenigd,0,0,1,1
34976,informe,0,0,1,1
52466,titel,0,0,1,1
48942,escriba,0,0,1,1
34983,கூறுகிறார்,0,0,1,1
49558,arkadaşım,0,0,1,1
52461,δίπλα,0,0,1,1
49557,bloquaient,0,0,1,1
34982,déclaraient,0,0,1,1
52462,التصنيف,0,0,1,1
48934,സ്വാധീനമുള്ള,0,0,1,1
48935,desconsolada,0,0,1,1
34981,вебсервер,0,0,1,1
33917,perro,0,0,1,1
48936,atemberaubend,0,0,1,1
48937,местные,0,0,1,1
52463,musea,0,0,1,1
48938,superfluo,0,0,1,1
34979,latinos,0,0,1,1
48939,слове,0,0,1,1
34978,acabó,0,0,1,1
48940,γέλια,0,0,1,1
48941,तभी,0,0,1,1
34960,votos,0,0,1,1
34959,программ,0,0,1,1
48951,gözyaşlarına,0,0,1,1
49547,вошла,0,0,1,1
48962,læring,0,0,1,1
52472,milyon,0,0,1,1
48963,गतिविधियाँ,0,0,1,1
33929,நுபீடியாவிலிருந்த,0,0,1,1
33930,castelo,0,0,1,1
48965,ड्राइववे,0,0,1,1
52618,yaşadığı,0,0,1,1
48966,προσωπικά,0,0,1,1
33931,эффективным,0,0,1,1
34937,കോടതിയോ,0,0,1,1
33932,تفضيل,0,0,1,1
48967,fortunes,0,0,1,1
34936,spaces,0,0,1,1
52617,تخبر,0,0,1,1
48969,stuff,0,0,1,1
33933,надо,0,0,1,1
48970,باراك,0,0,1,1
33935,länkas,0,0,1,1
50388,kalitede,0,0,1,1
48961,ಹೊರಡುವ,0,0,1,1
49548,скачивания,0,0,1,1
34955,ബന്ധവും,0,0,1,1
34940,извиняюсь,0,0,1,1
34954,tartışmalı,0,0,1,1
34953,нанять,0,0,1,1
34952,artikelskrivandet,0,0,1,1
48954,எழுத்துப்பிழைகளைத்,0,0,1,1
34951,« victimes »,0,0,1,1
33921,bird,0,0,1,1
33922,أقدم,0,0,1,1
52470,ladies,0,0,1,1
34949,haline,0,0,1,1
33924,ortak,0,0,1,1
34948,encontró,0,0,1,1
34947,espantoso,0,0,1,1
34946,നിർവചിക്കണം,0,0,1,1
34945,embrasser,0,0,1,1
49553,programın,0,0,1,1
52471,oprettes,0,0,1,1
49552,gestão,0,0,1,1
34942,проступках,0,0,1,1
48959,collaborativement,0,0,1,1
50265,warst,0,0,1,1
49130,അമ്മയ്‌ക്കായി,0,0,1,1
52318,inciclopedia,0,0,1,1
34161,வலை,0,0,1,1
50301,gyldent,0,0,1,1
34158,попрощаться,0,0,1,1
34378,suisseah,0,0,1,1
49436,излагались,0,0,1,1
34377,commander,0,0,1,1
49321,മാനദണ്ഡങ്ങളുപയോഗിച്ചാണ്,0,0,1,1
49322,influyendo,0,0,1,1
34160,yapılabilir,0,0,1,1
52551,gelse,0,0,1,1
34374,castigos,0,0,1,1
34367,omöjlig,0,0,1,1
34373,ansågs,0,0,1,1
34162,δώστε,0,0,1,1
34372,طبيعي,0,0,1,1
49324,hablantes,0,0,1,1
52586,historic,0,0,1,1
34371,arrivent,0,0,1,1
49433,terem,0,0,1,1
34369,വസ്ത്രധാരണത്തിൽ,0,0,1,1
49326,அதிகமில்லை,0,0,1,1
49437,techniek,0,0,1,1
34380,utilidad,0,0,1,1
34156,tomarse,0,0,1,1
34381,ನೋಡಬಹುದಾದ,0,0,1,1
50303,singlecelled,0,0,1,1
50273,holtzbrinck,0,0,1,1
34388,tenga,0,0,1,1
49315,يومًا,0,0,1,1
34151,contemporain,0,0,1,1
49316,ಜಾಗದಲ್ಲಿ,0,0,1,1
34152,gidelim,0,0,1,1
34386,வேர்கள்,0,0,1,1
49317,confundidos,0,0,1,1
34153,sporters,0,0,1,1
34154,kullanılmasını,0,0,1,1
34155,azb •,0,0,1,1
34384,വിജ്ഞാനതൃഷ്ണയും,0,0,1,1
34383,türkiye’den,0,0,1,1
49438,mehlmädchen,0,0,1,1
49319,tafelmanieren,0,0,1,1
34382,"
javanês",0,0,1,1
50302,formulerat,0,0,1,1
52550,التجارب,0,0,1,1
50300,reutilização,0,0,1,1
49327,uttal,0,0,1,1
49492,യു,0,0,1,1
34350,ника,0,0,1,1
52555,varnande,0,0,1,1
34353,voies,0,0,1,1
50296,κοίταζαν,0,0,1,1
34168,stabilizes,0,0,1,1
34352,использовано,0,0,1,1
34351,boken,0,0,1,1
52556,शिक्षण,0,0,1,1
49339,tadic,0,0,1,1
49340,соответствующую,0,0,1,1
34349,அடுத்ததாக,0,0,1,1
34365,exempelmeningar,0,0,1,1
34348,siderian,0,0,1,1
34171,calcified,0,0,1,1
50275,തെറ്റെഴുതിയാൽ,0,0,1,1
34346,tachonado,0,0,1,1
52557,inträffade,0,0,1,1
49342,मुख्यालय,0,0,1,1
34344,klasik,0,0,1,1
49343,अलाइक,0,0,1,1
49344,हफ्ते,0,0,1,1
34355,centrados,0,0,1,1
49428,своем,0,0,1,1
49337,morceau,0,0,1,1
34357,திட்டவடிவம்,0,0,1,1
34164,достоянии,0,0,1,1
34364,пройдёт,0,0,1,1
34363,räknas,0,0,1,1
50299,التنفيذي,0,0,1,1
49328,africans,0,0,1,1
34362,altında,0,0,1,1
34360,oudste,0,0,1,1
49331,ಕುತೂಹಲಕಾರಿ,0,0,1,1
34165,états,0,0,1,1
52552,adicionados,0,0,1,1
49332,imprimir,0,0,1,1
34359,negatieve,0,0,1,1
50274,lorsqu,0,0,1,1
49334,«знание»,0,0,1,1
52553,بروابط,0,0,1,1
52554,decentralizes,0,0,1,1
49431,النصف,0,0,1,1
49335,ക്ഷമാപണം,0,0,1,1
49429,തനതുവ്യക്തിത്വമുള്ള,0,0,1,1
52549,smsar,0,0,1,1
52548,പ്രയത്നത്തിന്,0,0,1,1
34392,आलोचनाओं,0,0,1,1
34140,നാല്പത്തഞ്ച്,0,0,1,1
34434,செல்கிறோம்,0,0,1,1
34433,يضيء,0,0,1,1
49277,identifiable,0,0,1,1
49278,erstaunt,0,0,1,1
50272,βιδώσω,0,0,1,1
49446,πλημμύρα,0,0,1,1
49279,முன்னரே,0,0,1,1
49280,tröga,0,0,1,1
49281,harvested,0,0,1,1
49282,கண்டீர்கள்,0,0,1,1
49441,impresiones,0,0,1,1
49284,تلميحًا,0,0,1,1
34429,acontecimientos,0,0,1,1
49285,aktive,0,0,1,1
49445,देखूंगा।,0,0,1,1
34427,procurála,0,0,1,1
49286,rapides,0,0,1,1
49287,немецкая —,0,0,1,1
34141,συμμετεχόντων,0,0,1,1
49289,ചിലരെ,0,0,1,1
34435,einkaufszentrum,0,0,1,1
49275,имею,0,0,1,1
34436,применена,0,0,1,1
49273,"
catalão",0,0,1,1
34133,meleğiyim,0,0,1,1
34134,ओपन,0,0,1,1
34450,ബ്രെഡിൽ,0,0,1,1
34449,elogiou,0,0,1,1
34448,والمصرية,0,0,1,1
49266,beschikbare,0,0,1,1
49267,प्रस्तावना,0,0,1,1
49268,endorse,0,0,1,1
34444,neus,0,0,1,1
49269,وتذكر,0,0,1,1
34135,волнует,0,0,1,1
34136,endless,0,0,1,1
49271,سلاش,0,0,1,1
34440,भेजते,0,0,1,1
34439,validated,0,0,1,1
34438,öppnades,0,0,1,1
34137,பயணி,0,0,1,1
49448,viennent,0,0,1,1
34437,أخبرتهم,0,0,1,1
34142,واحدًا,0,0,1,1
49290,législatives »,0,0,1,1
34143,ನೆಚ್ಚಿನ,0,0,1,1
34409,ಒಪ್ಪಿಕೊಳ್ಳುತ್ತೇನೆ,0,0,1,1
49442,eserler,0,0,1,1
34405,milliers,0,0,1,1
34404,revolves,0,0,1,1
34403,confundí,0,0,1,1
34148,πηγαίνει,0,0,1,1
49308,durable,0,0,1,1
34402,снилось,0,0,1,1
49309,åtgärder,0,0,1,1
34400,ಬಗ್ಗೆಯೂ,0,0,1,1
49310,المشارك,0,0,1,1
34399,വിശ്വസിക്കാൻ,0,0,1,1
34398,contestada,0,0,1,1
34397,பூட்டப்பட்டு,0,0,1,1
34396,röd,0,0,1,1
34395,delstaten,0,0,1,1
49311,സവാരിക്ക്,0,0,1,1
34394,prost,0,0,1,1
34393,meelmeisjes,0,0,1,1
34149,klass,0,0,1,1
49307,έκδοσή,0,0,1,1
34410,organismo,0,0,1,1
49291,eenzijdiger,0,0,1,1
34411,quinlan,0,0,1,1
49444,dagligen,0,0,1,1
34421,സംസ്കാരത്തെപ്പറ്റിയുമൊക്കെയുള്ള,0,0,1,1
34420,ansiklopedilerindeki,0,0,1,1
49292,அனுமதி,0,0,1,1
49293,censuur,0,0,1,1
49294,يحتاج,0,0,1,1
49295,напиток,0,0,1,1
50306,أسباب,0,0,1,1
49299,инициировал,0,0,1,1
34416,cessé,0,0,1,1
49300,"
बान्युमासन",0,0,1,1
49301,ಭಾವಿಸಿದೆ,0,0,1,1
49302,derinlemesine,0,0,1,1
34146,sønderknust,0,0,1,1
49304,geistig,0,0,1,1
34147,coolen,0,0,1,1
34413,നിരന്തരമായ,0,0,1,1
34412,forskningsresultat,0,0,1,1
49306,avisam,0,0,1,1
34342,محاولة,0,0,1,1
34341,su •,0,0,1,1
49345,تنوي,0,0,1,1
34255,nerviosos,0,0,1,1
34202,sevgili,0,0,1,1
52570,liant,0,0,1,1
52571,gedrukt,0,0,1,1
49382,krydser,0,0,1,1
52572,нынешнюю,0,0,1,1
49383,المستقبلية,0,0,1,1
34258,അവലംബമായി,0,0,1,1
34257,salladın,0,0,1,1
50282,karışmış,0,0,1,1
50283,सवालों,0,0,1,1
34279,log,0,0,1,1
34254,फीडर,0,0,1,1
34253,beskrivs,0,0,1,1
34252,கிடப்பேன்,0,0,1,1
34204,عروض,0,0,1,1
34251,twice,0,0,1,1
34250,gillat,0,0,1,1
52573,सुसंस्कृत,0,0,1,1
34205,omhelzen,0,0,1,1
34249,påpegede,0,0,1,1
34262,övrigt,0,0,1,1
52567,ಒತ್ತಿ,0,0,1,1
34264,മീറ്റിംഗ്,0,0,1,1
34200,circumstances,0,0,1,1
49375,وأقول,0,0,1,1
34276,посадить,0,0,1,1
34275,ficam,0,0,1,1
50289,mme,0,0,1,1
50288,secondclass,0,0,1,1
34199,εξέταση,0,0,1,1
34274,contenha,0,0,1,1
34273,ലിപിയിൽ,0,0,1,1
34272,produziu,0,0,1,1
49414,वार्षिक,0,0,1,1
34271,आर्द्रभूमि,0,0,1,1
49378,properly,0,0,1,1
34270,ஃப்ளூமாக்ஸைப்,0,0,1,1
34269,விக்கிப்பீடியாவினுள்,0,0,1,1
52566,المفضل,0,0,1,1
49379,origem,0,0,1,1
49380,dynamiques,0,0,1,1
34266,« encyclopédie »,0,0,1,1
49381,considerava,0,0,1,1
34248,ക്യാരക്റ്റർ,0,0,1,1
49386,franse,0,0,1,1
49411,تعيينه,0,0,1,1
34228,luidsprekerpictogram,0,0,1,1
49393,ب,0,0,1,1
49394,mostraba,0,0,1,1
49395,нарушениями,0,0,1,1
34223,ενημέρωσης,0,0,1,1
49399,الفاكهة,0,0,1,1
52575,rituals,0,0,1,1
50286,landform,0,0,1,1
52576,episk,0,0,1,1
34222,prächtigen,0,0,1,1
34214,obscurantisme,0,0,1,1
34221,mordisco,0,0,1,1
34220,ഗുണാങ്കങ്ങൾക്ക്,0,0,1,1
49400,verrez,0,0,1,1
34215,разрабатывались,0,0,1,1
49406,υπέρμαχο,0,0,1,1
49402,distinguen​,0,0,1,1
49403,wikimedia​,0,0,1,1
34216,блокирование,0,0,1,1
50284,ml —,0,0,1,1
34212,performances,0,0,1,1
34211,மரகதங்களின்,0,0,1,1
34245,ശബ്ദത്തിന്റെ,0,0,1,1
34210,الأقل,0,0,1,1
34206,customarily,0,0,1,1
34243,несъедобным,0,0,1,1
34242,geçmeniz,0,0,1,1
34241,légèrement,0,0,1,1
34240,guldbrødet,0,0,1,1
34239,എന്തുചെയ്യണമെന്ന്,0,0,1,1
34238,задумывалась,0,0,1,1
34237,wars,0,0,1,1
34236,സ്ലഗ്,0,0,1,1
34207,читателя,0,0,1,1
34235,ഉറക്കത്തിൽ,0,0,1,1
34234,yielded,0,0,1,1
49409,μιλήσουμε,0,0,1,1
34233,கணக்கொன்று,0,0,1,1
49388,existido,0,0,1,1
52574,hvilke,0,0,1,1
49389,vlees,0,0,1,1
49408,tijdlang,0,0,1,1
49391,расчленяются,0,0,1,1
34278,trademark,0,0,1,1
49374,“change,0,0,1,1
34174,ஆங்கிலப்,0,0,1,1
34315,yorumlar,0,0,1,1
49352,utsikt,0,0,1,1
34184,unconscious,0,0,1,1
52582,adorable,0,0,1,1
49353,conscientious,0,0,1,1
34319,تغرق,0,0,1,1
34318,massives,0,0,1,1
34317,अग्रणी,0,0,1,1
34316,decisivas,0,0,1,1
49354,различного,0,0,1,1
49355,transmitiu,0,0,1,1
34281,détection,0,0,1,1
49419,أستراليون,0,0,1,1
49357,aanvullend,0,0,1,1
34312,супе,0,0,1,1
52581,يساهم,0,0,1,1
34186,verkozen,0,0,1,1
34188,functional,0,0,1,1
34189,பங்களிப்பாளர்கள்,0,0,1,1
34310,manieren,0,0,1,1
52560,ആലിംഗനം,0,0,1,1
34322,wikiwikiweb—,0,0,1,1
34323,избегая,0,0,1,1
34182,gitme,0,0,1,1
34325,управлялась,0,0,1,1
49346,ತಕ್ಷಣ,0,0,1,1
52583,cogitans »,0,0,1,1
34338,lämnar,0,0,1,1
34337,وحده,0,0,1,1
34336,sket,0,0,1,1
34177,eventuele,0,0,1,1
34335,intressant,0,0,1,1
49424,نتابع,0,0,1,1
49347,γωνία—αυτή,0,0,1,1
34179,способный,0,0,1,1
50276,chile,0,0,1,1
34332,örnekler,0,0,1,1
34331,ongelooflijk,0,0,1,1
49423,försök,0,0,1,1
34329,tebrik,0,0,1,1
34328,വിളിക്കാൻ,0,0,1,1
50293,atribuir,0,0,1,1
49351,palm,0,0,1,1
34326,sitesini,0,0,1,1
52561,suivie,0,0,1,1
52580,بجانبها,0,0,1,1
49418,массовой,0,0,1,1
34194,mettent,0,0,1,1
34292,água,0,0,1,1
49368,ومصداقيتها,0,0,1,1
34291,программное,0,0,1,1
50291,unutuyor,0,0,1,1
49370,excellent,0,0,1,1
34195,disproportionately,0,0,1,1
34196,lyckligt,0,0,1,1
52564,लेखकों,0,0,1,1
49371,paniek,0,0,1,1
34287,potentiële,0,0,1,1
34286,فربما,0,0,1,1
49372,trist,0,0,1,1
34285,энциклопедий,0,0,1,1
49373,جورنال,0,0,1,1
34283,ಹೇಳು,0,0,1,1
34197,discernir,0,0,1,1
52565,японская —,0,0,1,1
34198,köşedeki,0,0,1,1
34282,upptäcktes,0,0,1,1
49367,ತಂದಿದ್ದೇನೆ,0,0,1,1
49366,interativo,0,0,1,1
34308,европейском,0,0,1,1
34293,ഡാറ്റയാണ്,0,0,1,1
49361,закрыть,0,0,1,1
49362,alia,0,0,1,1
49363,grammaire,0,0,1,1
34305,فماذا,0,0,1,1
34304,effrayé,0,0,1,1
50292,ಮಾತನಾಡಬಲ್ಲಿರಾ,0,0,1,1
52562,dørs,0,0,1,1
34192,तोड़,0,0,1,1
34301,"
bretão",0,0,1,1
52563,olsam,0,0,1,1
34299,modtager,0,0,1,1
49417,φεύγω,0,0,1,1
34298,بطء,0,0,1,1
49364,talimatları,0,0,1,1
50279,കണ്ടെത്തുകയാണ്,0,0,1,1
34296,yenmez,0,0,1,1
34295,yttrande,0,0,1,1
49416,encontrarme,0,0,1,1
34294,"വാൻഡലിസം
വരുന്നത്",0,0,1,1
52545,frequent,0,0,1,1
52589,pretende,0,0,1,1
34131,كبد,0,0,1,1
49477,ആശ്ചര്യപ്പെടുത്തുന്നതാണ്,0,0,1,1
49160,പൊതുഅവലംബ,0,0,1,1
34590,denkst,0,0,1,1
34589,डॉङ्ग,0,0,1,1
49161,அண்மையில்,0,0,1,1
49479,nergisli,0,0,1,1
34077,умного,0,0,1,1
49478,τρομακτικά,0,0,1,1
34588,catalyst,0,0,1,1
34587,duyun,0,0,1,1
34080,activitésréf,0,0,1,1
34608,ഇന്റർനെറ്റുമായി,0,0,1,1
34081,ищете,0,0,1,1
49163,datacenter,0,0,1,1
34586,اقبل,0,0,1,1
34082,prinzen,0,0,1,1
49164,provocó,0,0,1,1
34083,നഗരത്തിലെ,0,0,1,1
34585,cilalı,0,0,1,1
52523,وريجل,0,0,1,1
34084,stelde,0,0,1,1
52522,pålitlighet,0,0,1,1
49157,συναντάς,0,0,1,1
34593,muestran,0,0,1,1
34594,ಟ್,0,0,1,1
34073,συνάντησε,0,0,1,1
34606,sökmotorer,0,0,1,1
34605,συστήματα,0,0,1,1
52517,dol,0,0,1,1
34604,أمير,0,0,1,1
34603,γράφεται,0,0,1,1
34602,intervals,0,0,1,1
50337,مفارقة,0,0,1,1
34074,झांका।,0,0,1,1
34601,glücks,0,0,1,1
49154,títeres,0,0,1,1
34599,rationnelles,0,0,1,1
52519,utsträckning,0,0,1,1
34598,इंटरफ़ेस,0,0,1,1
52520,médicale,0,0,1,1
49156,أيضا،,0,0,1,1
52521,παραπονεθώ,0,0,1,1
50336,uncertain,0,0,1,1
34075,തിരിയുന്നു,0,0,1,1
49476,كطباعة,0,0,1,1
34086,ಇದೀಗ,0,0,1,1
49165,exercice,0,0,1,1
34570,неизвестна,0,0,1,1
49174,exhaustivité,0,0,1,1
52525,procès,0,0,1,1
49175,assistants,0,0,1,1
50333,lida,0,0,1,1
49473,φανταστείτε,0,0,1,1
34566,ചതുപ്പുനിലമായിട്ടുണ്ട്,0,0,1,1
34565,conhecida,0,0,1,1
34564,vastu,0,0,1,1
34563,bazıları,0,0,1,1
34562,traversa,0,0,1,1
49472,viss,0,0,1,1
52526,rules”,0,0,1,1
34094,أفكر,0,0,1,1
34559,конкурсе,0,0,1,1
50332,ervoor,0,0,1,1
34095,interromper,0,0,1,1
34556,استخدم,0,0,1,1
34554,φόρμας,0,0,1,1
50330,paradoxo,0,0,1,1
34569,വിരസമാണ്,0,0,1,1
34571,году»,0,0,1,1
49166,μαριόν,0,0,1,1
34572,ähm,0,0,1,1
50335,ಅರ್ಪಿಸಿದ್ದಕ್ಕಾಗಿ,0,0,1,1
34087,—ordenados,0,0,1,1
34584,hävdade,0,0,1,1
50334,unnecessary,0,0,1,1
50268,s’avérer,0,0,1,1
49167,தாய்க்கு,0,0,1,1
34089,ремонтом,0,0,1,1
34090,vandalizada,0,0,1,1
34581,സമ്പത്തും,0,0,1,1
49169,deneyimi,0,0,1,1
49170,scared,0,0,1,1
34580,മില്ല്യൺ,0,0,1,1
34579,ബെൽഗാം,0,0,1,1
34091,ಸುಂದರವಾಗಿದ್ದನ್ನು,0,0,1,1
49173,stuck,0,0,1,1
49474,காவியத்தைப்,0,0,1,1
34575,മെല്ലിയെക്കുറിച്ച്,0,0,1,1
34574,مجلدًا,0,0,1,1
34573,പ്രവൃത്തികളും,0,0,1,1
34607,സ്വപ്‌നം,0,0,1,1
34609,voulais,0,0,1,1
49179,​​du,0,0,1,1
52509,croises,0,0,1,1
34653,tabelldatafil,0,0,1,1
34652,நோக்கம்,0,0,1,1
34651,malheureux,0,0,1,1
52602,resultant,0,0,1,1
34649,doigt,0,0,1,1
34648,mining‏,0,0,1,1
34647,uitgestorven,0,0,1,1
34646,பிடிப்பு,0,0,1,1
49486,kinesiska,0,0,1,1
52510,കൂടിയ,0,0,1,1
50267,பொறி,0,0,1,1
50344,cs •,0,0,1,1
34062,διαχείρισης,0,0,1,1
34063,exponencialmente,0,0,1,1
50343,kaldırılmasının,0,0,1,1
49138,origines,0,0,1,1
52511,التحيز,0,0,1,1
49485,nonavian,0,0,1,1
49484,yazdıkları,0,0,1,1
34065,еде,0,0,1,1
50345,appuyez,0,0,1,1
34655,"
véneto",0,0,1,1
34656,തമാശയാണ്,0,0,1,1
34059,بالتعب,0,0,1,1
34054,याहू,0,0,1,1
34669,دارتموث,0,0,1,1
34668,précédents,0,0,1,1
49491,åkturen,0,0,1,1
34666,conflits,0,0,1,1
50346,ഫൗണ്ടേഷൻ,0,0,1,1
34665,традиционную,0,0,1,1
34664,falsa—,0,0,1,1
49489,offensantes,0,0,1,1
34663,الحكم,0,0,1,1
34662,cümlede,0,0,1,1
34660,aramada,0,0,1,1
49487,ричарда,0,0,1,1
34659,sebeple,0,0,1,1
49132,bilgileri,0,0,1,1
34057,yiyemiyorum,0,0,1,1
49133,cifras,0,0,1,1
34657,funktionieren,0,0,1,1
34058,ಬ್ರೆಡ್ನಲ್ಲಿ,0,0,1,1
34640,искусства,0,0,1,1
34066,അതിനുപുറമേ,0,0,1,1
49483,rudemente,0,0,1,1
34070,enkyklios,0,0,1,1
34625,publique,0,0,1,1
49147,edebilirler,0,0,1,1
52515,antingen,0,0,1,1
34623,nintendo,0,0,1,1
52516,الوثائقي,0,0,1,1
34622,enviarei,0,0,1,1
34621,अवसर,0,0,1,1
34620,resumo,0,0,1,1
34619,принесет,0,0,1,1
34618,употребляемое,0,0,1,1
50266,vigilant,0,0,1,1
49148,sumado,0,0,1,1
34617,عادة,0,0,1,1
34616,propriétaire,0,0,1,1
50339,moulinwiki,0,0,1,1
50338,ಕಲಿಕೆ,0,0,1,1
34612,loin,0,0,1,1
34072,قلت,0,0,1,1
49151,दिशानिर्देशों,0,0,1,1
34626,bake,0,0,1,1
49146,ചതുപ്പുനിലമാക്കി,0,0,1,1
34639,एडिटरइनचीफ,0,0,1,1
34627,förekomsten,0,0,1,1
34638,placements,0,0,1,1
34637,مؤكدة،,0,0,1,1
34636,الدينية,0,0,1,1
49140,parallèlement,0,0,1,1
52512,agências,0,0,1,1
34635,ಒಪ್ಪಿಕೊಂಡರೆ,0,0,1,1
34634,αμφισβητούμενο,0,0,1,1
52513,дальнейшее,0,0,1,1
34633,parsemé,0,0,1,1
49141,financement,0,0,1,1
34631,നിങ്ങൾക്കാവശ്യമുണ്ടെങ്കിൽ,0,0,1,1
34630,victorian,0,0,1,1
50341,mature,0,0,1,1
49144,staan,0,0,1,1
34068,confuse,0,0,1,1
34629,chain,0,0,1,1
52514,değiştirmiştir,0,0,1,1
49145,പാകിസ്താൻ,0,0,1,1
34069,dediğinizde,0,0,1,1
34096,işlere,0,0,1,1
49180,يتحرك,0,0,1,1
34130,تدين,0,0,1,1
34120,எவராலும்,0,0,1,1
49228,പഠിക്കാൻ,0,0,1,1
49456,recourent,0,0,1,1
49229,sujeito,0,0,1,1
50319,gangen,0,0,1,1
34483,„википедию“ —,0,0,1,1
49230,greenhouse,0,0,1,1
49231,தொனி,0,0,1,1
49232,والواراي,0,0,1,1
49455,hospedada,0,0,1,1
34121,elección,0,0,1,1
50321,persa,0,0,1,1
34480,diyorlar,0,0,1,1
34479,επαναλάβεις,0,0,1,1
34478,великолепного,0,0,1,1
52539,للتسجيل,0,0,1,1
49454,выучите,0,0,1,1
34122,transmitir,0,0,1,1
34476,initiaux,0,0,1,1
34123,éditorial,0,0,1,1
52540,chico,0,0,1,1
49227,തുടക്കത്തിനുശേഷം,0,0,1,1
49226,representadas,0,0,1,1
34488,altan,0,0,1,1
34489,पुस्तकें,0,0,1,1
34499,früheres,0,0,1,1
50320,animada,0,0,1,1
34116,« préjudice,0,0,1,1
34498,combinées,0,0,1,1
34496,بترتيب,0,0,1,1
34495,الكلام,0,0,1,1
34117,вежливо,0,0,1,1
49221,крупнейшей,0,0,1,1
34118,stirrede,0,0,1,1
52590,personnellement,0,0,1,1
49459,agréable,0,0,1,1
34494,forvirrede,0,0,1,1
52537,википроектами,0,0,1,1
34493,يخضع,0,0,1,1
49222,lijkt,0,0,1,1
49223,ведь,0,0,1,1
49224,ശാഖയുടെ,0,0,1,1
34491,datas,0,0,1,1
52538,ಪರಿಸ್ಥಿತಿಯಲ್ಲಿರುವುದು,0,0,1,1
49238,γυμνοσάλιαγκας,0,0,1,1
50317,facettes,0,0,1,1
49239,réutiliser,0,0,1,1
34125,aliments,0,0,1,1
34458,ഉറപ്പുവരുത്തുവാൻ,0,0,1,1
34457,doubt,0,0,1,1
49255,видах,0,0,1,1
34456,probieren,0,0,1,1
49256,аароном,0,0,1,1
34455,possibility,0,0,1,1
49257,mahoma,0,0,1,1
50311,fastslog,0,0,1,1
34127,καταπληκτικός,0,0,1,1
49258,koblet,0,0,1,1
49259,ಹೇಳಬಹುದೇ,0,0,1,1
34128,engendré,0,0,1,1
49452,ಸ್ನೇಹಿತರಿಗೆ,0,0,1,1
50310,limitações,0,0,1,1
50309,ತೀಕ್ಷ್ಣವಾಗಿ,0,0,1,1
34129,comparatif,0,0,1,1
50308,பொத்தானைக்,0,0,1,1
49264,adequadamente,0,0,1,1
34451,bry,0,0,1,1
34126,ελληνική,0,0,1,1
49254,anima,0,0,1,1
34474,സൃഷ്ടിച്ചു,0,0,1,1
34459,fundamentais,0,0,1,1
34472,scholarly,0,0,1,1
50316,ഒരാൾക്ക്,0,0,1,1
49241,"
espanhol",0,0,1,1
34471,ಗೊಂಬೆ,0,0,1,1
34470,ಹೊರಟರು,0,0,1,1
49243,പാർട്ടിയിൽ,0,0,1,1
50315,ksvd,0,0,1,1
34468,stunned,0,0,1,1
34124,l’élection,0,0,1,1
34467,ಮೂಕ,0,0,1,1
49245,wwwwikipediacom،,0,0,1,1
34466,തുമ്മുമ്പോൾ,0,0,1,1
49247,outnyttjade,0,0,1,1
34464,ಆಸಕ್ತಿ,0,0,1,1
49248,emitidos,0,0,1,1
34463,nelerdir,0,0,1,1
49251,обедом,0,0,1,1
50313,വാക്യങ്ങളോ,0,0,1,1
50312,ಎತ್ತಿಕೊಳ್ಳಲಾಗಿದೆ,0,0,1,1
34500,mooiste,0,0,1,1
52535,സഹിഷ്ണുക്കൾ,0,0,1,1
49181,interrumpirte,0,0,1,1
34536,umursayamam,0,0,1,1
34542,uppfyller,0,0,1,1
52529,regularly,0,0,1,1
49190,estuve,0,0,1,1
52530,നാമെല്ലാവരും,0,0,1,1
34540,«нупедии» —,0,0,1,1
34539,verdringen,0,0,1,1
49191,وأحيانًا,0,0,1,1
49192,ಹೆಂಡತಿಯಾಗಿರಬೇಕು,0,0,1,1
49193,озаглавленное,0,0,1,1
34107,contenía,0,0,1,1
49219,अपशब्द,0,0,1,1
52596,അഴുക്ക്,0,0,1,1
34535,sensiz,0,0,1,1
34534,fictício,0,0,1,1
49195,descubrir,0,0,1,1
49197,торговом,0,0,1,1
34108,யூகிக்கிறீர்கள்,0,0,1,1
50270,sıkışıp,0,0,1,1
34109,razones,0,0,1,1
34530,rewrite,0,0,1,1
52597,ಉತ್ತಮವಾಗಿರುತ್ತದೆ,0,0,1,1
50325,older,0,0,1,1
34544,ಕ್ಷಣದಲ್ಲಿ,0,0,1,1
34103,ಗಾಡಿಯೊಂದಿಗೆ,0,0,1,1
52599,sözünü,0,0,1,1
49470,والتشخيص,0,0,1,1
50269,продал,0,0,1,1
34551,arrêtait,0,0,1,1
34550,nãoparcialidade,0,0,1,1
50328,physics,0,0,1,1
34098,അഭിനന്ദിക്കുന്നതിനുള്ള,0,0,1,1
34549,ವ್ಯಕ್ತಿಯು,0,0,1,1
34099,«спасибо,0,0,1,1
49183,दें।,0,0,1,1
49184,pojkvän,0,0,1,1
49185,tunisien,0,0,1,1
34100,préjugés,0,0,1,1
34101,söyler,0,0,1,1
52598,tribunais,0,0,1,1
34546,collaboratively,0,0,1,1
49468,टेलीग्राम,0,0,1,1
50326,പത്രമാസികകളും,0,0,1,1
34545,biografias,0,0,1,1
34529,plagiar,0,0,1,1
49199,уехала,0,0,1,1
49200,काट,0,0,1,1
34516,períodos,0,0,1,1
49211,ಪುನರಾವರ್ತಿಸಬೇಕೆಂದು,0,0,1,1
34515,கோரிக்கைகளை,0,0,1,1
34113,подвергаться,0,0,1,1
49212,azul,0,0,1,1
34513,kapot,0,0,1,1
34512,jaren,0,0,1,1
49213,oneetbaar,0,0,1,1
49214,blockeras,0,0,1,1
34509,للتحدث,0,0,1,1
52592,ವೈಯಕ್ತಿಕವಾಗಿ,0,0,1,1
34508,modifié,0,0,1,1
49216,второе,0,0,1,1
34507,nicer,0,0,1,1
34114,أدى,0,0,1,1
52591,σχολιάζοντας,0,0,1,1
50323,voltar,0,0,1,1
49217,frans,0,0,1,1
34503,laïque,0,0,1,1
34115,добивается,0,0,1,1
49210,കാര്യത്തിനിടയിലാണെങ്കിൽ,0,0,1,1
52533,possuindo,0,0,1,1
52595,ಪುರುಷರನ್ನು,0,0,1,1
52593,"സമൂഹമാണ്
വിക്കിപീഡിയരുടേത്",0,0,1,1
49466,ബാങ്കിനോട്,0,0,1,1
49465,основателя,0,0,1,1
34528,dejó,0,0,1,1
52531,ತಲುಪಿದಾಗ,0,0,1,1
49202,saline,0,0,1,1
49463,ಮಾಡದ,0,0,1,1
52532,commune,0,0,1,1
49203,kaçınılır,0,0,1,1
34110,جزءًا,0,0,1,1
49204,которого,0,0,1,1
34524,авторских,0,0,1,1
34523,والتنظيمات,0,0,1,1
50324,infinitamente,0,0,1,1
49206,έτοιμοι,0,0,1,1
34521,ortasındasın,0,0,1,1
34520,शूट,0,0,1,1
34519,tillykke,0,0,1,1
49207,وهما,0,0,1,1
34518,yunan,0,0,1,1
35090,любимым,0,0,1,1
35091,sostenida,0,0,1,1
48867,ജോലിയുടെ,0,0,1,1
35674,ξαναδώ,0,0,1,1
35680,ಒಳ್ಳೆಯವರಾಗಿರಿ,0,0,1,1
48535,вкусной,0,0,1,1
48536,εμφανίσεις,0,0,1,1
48537,медейко,0,0,1,1
48538,filled,0,0,1,1
35676,rigtighed,0,0,1,1
33620,uppgift,0,0,1,1
48540,هاتفية,0,0,1,1
35675,oc •,0,0,1,1
35673,traerte,0,0,1,1
50483,попрактиковаться,0,0,1,1
52360,desempenho,0,0,1,1
52361,değerlendirilir,0,0,1,1
33621,maintaining,0,0,1,1
49706,liknandeknappen,0,0,1,1
50485,இருவருமே,0,0,1,1
33622,conscientes,0,0,1,1
35671,σπόρους,0,0,1,1
50484,learning”,0,0,1,1
48542,lags,0,0,1,1
52358,hemsidan,0,0,1,1
33619,bulunmuştur,0,0,1,1
49709,beskytte,0,0,1,1
49710,"
malaiala",0,0,1,1
33612,ஆறு,0,0,1,1
33614,patient,0,0,1,1
33615,grind,0,0,1,1
35692,presione,0,0,1,1
35691,போகிறது,0,0,1,1
48530,ليسوا,0,0,1,1
48531,hesitating,0,0,1,1
49714,വ്യാജ,0,0,1,1
48532,åldrarna,0,0,1,1
49713,لمجادلتهم,0,0,1,1
49711,ijsbrand,0,0,1,1
35689,overschreden,0,0,1,1
35687,açlıktan,0,0,1,1
48534,–principalmente,0,0,1,1
35685,behandeld,0,0,1,1
33617,éditoriaux,0,0,1,1
35683,गुज़री,0,0,1,1
52357,"
आयरिश",0,0,1,1
35682,brains,0,0,1,1
35670,telegramm,0,0,1,1
50482,empirisme,0,0,1,1
33874,izliyordu,0,0,1,1
48560,samtal,0,0,1,1
48555,statesman,0,0,1,1
48556,minoritetsuppfattningar,0,0,1,1
48557,percept,0,0,1,1
35651,funcionalidad,0,0,1,1
52365,ആദ്യ,0,0,1,1
48558,versies,0,0,1,1
49704,uykusunda,0,0,1,1
48559,ചേർക്കാവുന്നതാണ്,0,0,1,1
35650,ودقتها,0,0,1,1
35649,announcement,0,0,1,1
35668,produjo,0,0,1,1
35648,obteve,0,0,1,1
35647,owners,0,0,1,1
33626,placer,0,0,1,1
52366,wildness,0,0,1,1
48561,"
eslovaco",0,0,1,1
49703,financés,0,0,1,1
52367,irlandais,0,0,1,1
33627,запретить,0,0,1,1
48562,giderse,0,0,1,1
49705,founding,0,0,1,1
35654,protracted,0,0,1,1
48554,meanings,0,0,1,1
48552,читатель,0,0,1,1
48543,çalışmasının,0,0,1,1
35667,varierande,0,0,1,1
35666,bozuldu,0,0,1,1
35665,ರಜೆ,0,0,1,1
48544,கொண்டுவரலாம்,0,0,1,1
50214,разнородными,0,0,1,1
52363,كبيراً,0,0,1,1
33623,деревушке,0,0,1,1
48545,baseren,0,0,1,1
35662,പാഴ്‌മെയിലുകളെയും,0,0,1,1
35661,υποστηρίζει,0,0,1,1
48546,إيكونوميك,0,0,1,1
35659,krets,0,0,1,1
48547,ലേഖനങ്ങളായി,0,0,1,1
35658,мухаммеда,0,0,1,1
50481,ತಿಳಿದಿದ್ದರಿಂದ,0,0,1,1
48550,επιχείρηση,0,0,1,1
33624,ರುಚಿ,0,0,1,1
48551,divertidas,0,0,1,1
49717,पर्यटन,0,0,1,1
48528,randevunuz,0,0,1,1
35695,susceptibilidad,0,0,1,1
50213,riesige,0,0,1,1
48506,sammanfatta,0,0,1,1
35740,ഉച്ചഭക്ഷണം,0,0,1,1
35739,μιλήσει,0,0,1,1
33597,أحضرت,0,0,1,1
50211,vandrare,0,0,1,1
52352,ಹಿಂದಿನ,0,0,1,1
50492,للإنجليزية,0,0,1,1
35736,ellesmêmes,0,0,1,1
35735,stay,0,0,1,1
35733,kültürde,0,0,1,1
50487,വാക്യങ്ങളെയും,0,0,1,1
35732,historiques,0,0,1,1
33601,βυθιστεί,0,0,1,1
48509,geheimzinnigs,0,0,1,1
50491,gebrochenem,0,0,1,1
48510,independência,0,0,1,1
35728,vardagligt,0,0,1,1
35726,improbable,0,0,1,1
35725,aspecto,0,0,1,1
33602,അതിശയകരമായത്,0,0,1,1
33596,ಎಲ್ಲೋ,0,0,1,1
48505,« good,0,0,1,1
33595,damwikipediaorg,0,0,1,1
33594,survival,0,0,1,1
35758,നോക്കുമ്പോൾ,0,0,1,1
35757,глагольная,0,0,1,1
49729,exclusividade,0,0,1,1
35755,επιτυχής,0,0,1,1
35753,чём,0,0,1,1
33592,получивший,0,0,1,1
48498,opkalder,0,0,1,1
35751,सकूं,0,0,1,1
48499,guarantee,0,0,1,1
48501,iphoneenheter,0,0,1,1
35749,sont ,0,0,1,1
50210,gördüğünden,0,0,1,1
48503,fracción,0,0,1,1
35748,குற்ற,0,0,1,1
33593,संगीत,0,0,1,1
35747,anlamakta,0,0,1,1
48504,"
ताजिक",0,0,1,1
35745,internetencyklopædi,0,0,1,1
35743,balansgång,0,0,1,1
52354,aufschreiben,0,0,1,1
48512,плачущий,0,0,1,1
33603,redigerat,0,0,1,1
35708,derniers,0,0,1,1
35706,ഗുണാങ്കങ്ങളുടെ,0,0,1,1
35705,الفضل,0,0,1,1
49720,animalia,0,0,1,1
33608,beviste,0,0,1,1
48520,കൃത്രിമബുദ്ധിയുടെ,0,0,1,1
48522,resultantes,0,0,1,1
35703,взгляды,0,0,1,1
35702,similares,0,0,1,1
49719,hatırlayın,0,0,1,1
35701,weit,0,0,1,1
49718,நீங்களே,0,0,1,1
33611,ciudad,0,0,1,1
48523,விக்கிப்பீடியாகொம்,0,0,1,1
35698,pedazo,0,0,1,1
48524,experienced,0,0,1,1
48525,оспорено,0,0,1,1
48526,ലഭ്യമായതിനാൽ,0,0,1,1
52356,désaccord,0,0,1,1
35696,മറക്കുന്നു,0,0,1,1
35707,കുലുങ്ങുന്നു,0,0,1,1
48518,തുടക്കംകുറിച്ചത്,0,0,1,1
35723,êtesvous,0,0,1,1
49721,reshaping,0,0,1,1
35722,asombrada,0,0,1,1
52355,ತಿರಸ್ಕರಿಸಿದಳು,0,0,1,1
33604,"
स्वीडिश",0,0,1,1
35721,sunumlar,0,0,1,1
52663,methodology,0,0,1,1
35720,count,0,0,1,1
48514,automatizar,0,0,1,1
49723,pauvres,0,0,1,1
35718,சரிசெய்தல்,0,0,1,1
35717,கற்கள்,0,0,1,1
35715,المغادرة,0,0,1,1
48515,ιππότης,0,0,1,1
33606,arcaísmo,0,0,1,1
33607,exceeding,0,0,1,1
35713,hayvandır,0,0,1,1
52662,निका,0,0,1,1
35712,जापान,0,0,1,1
35711,semantiska,0,0,1,1
35710,ayudaría,0,0,1,1
33628,divinité,0,0,1,1
33630,caparazón,0,0,1,1
48563,katılmak,0,0,1,1
33668,αστεροειδής,0,0,1,1
35581,devez,0,0,1,1
35580,dries,0,0,1,1
35579,tarjetas,0,0,1,1
50461,recebem,0,0,1,1
35578,ارتباط,0,0,1,1
33666,ನಡೆಯುತ್ತಿಲ್ಲ,0,0,1,1
33667,portugueselanguage,0,0,1,1
35577,ഉണ്ടെന്നും,0,0,1,1
49682,fiquei,0,0,1,1
35576,إجماع,0,0,1,1
35596,αλλάξει,0,0,1,1
48610,réalisait,0,0,1,1
33669,செய்யத்,0,0,1,1
48612,инкубаторе,0,0,1,1
35573,सारी,0,0,1,1
33670,mamãe,0,0,1,1
35572,rundad,0,0,1,1
33671,തയ്യാറാണ്,0,0,1,1
48613,америке,0,0,1,1
33672,effectués,0,0,1,1
52657,പറഞ്ഞുകഴിഞ്ഞാലുടൻ,0,0,1,1
48607,atteint,0,0,1,1
50463,وعبارة,0,0,1,1
52381,உழைக்க,0,0,1,1
48601,"
इमिलियाईरोमग्नोल",0,0,1,1
49684,noncollege,0,0,1,1
35593,kritische,0,0,1,1
50464,"
cebuano",0,0,1,1
48602,проверке,0,0,1,1
33659,بنصب,0,0,1,1
35591,franceag,0,0,1,1
48603,المجاور,0,0,1,1
35590,кино,0,0,1,1
35589,raciales,0,0,1,1
33660,لاحق,0,0,1,1
33661,oldun,0,0,1,1
48604,بالعلوم,0,0,1,1
52379,enganado,0,0,1,1
50220,enfocada,0,0,1,1
33663,தீவிரமாக,0,0,1,1
35585,பகுதிகளிலேயே,0,0,1,1
35584,randevusu,0,0,1,1
35583,brudekjole,0,0,1,1
33673,fællesskab,0,0,1,1
33674,matta,0,0,1,1
33675,കണ്ടെത്തുക,0,0,1,1
52382,établies,0,0,1,1
52383,വാർത്തയിൽ,0,0,1,1
52384,атрибутированием,0,0,1,1
35551,« alphago »,0,0,1,1
33681,burn,0,0,1,1
33682,izlediyseniz,0,0,1,1
48624,arena,0,0,1,1
33683,gebruiksvriendelijk,0,0,1,1
35549,الأمر،,0,0,1,1
35548,kelimelerinin,0,0,1,1
35547,названный,0,0,1,1
50221,ملحمي,0,0,1,1
33685,tempestuosa,0,0,1,1
35545,ಕಾಮೆಂಟ್,0,0,1,1
35544,യൂട്യൂബിൽ,0,0,1,1
48625,hjemmeside,0,0,1,1
49676,ಪುನರಾರಂಭಿಸಲು,0,0,1,1
35541,heather,0,0,1,1
35540,yanlışlar,0,0,1,1
50459,കണ്ടെത്താൻ,0,0,1,1
35554,magisch,0,0,1,1
35555,референдум,0,0,1,1
49681,influencées,0,0,1,1
35556,siguiendo,0,0,1,1
35569,ചെയ്ത,0,0,1,1
35568,ऑफ,0,0,1,1
50460,líderes,0,0,1,1
35566,ஆக்கப்பட்டு,0,0,1,1
48617,großartiger,0,0,1,1
35565,mapean,0,0,1,1
33677,ಓಬ್ಟೂಸ್,0,0,1,1
33678,achar,0,0,1,1
35564,librenota,0,0,1,1
35563,veckotidskrifterna,0,0,1,1
35562,конфигурация,0,0,1,1
49680,littéral,0,0,1,1
33679,dignos,0,0,1,1
48619,internacionalmente,0,0,1,1
49679,chapters,0,0,1,1
35561,നേരിട്ടുള്ള,0,0,1,1
48620,هيا,0,0,1,1
48621,التاريخ,0,0,1,1
35558,историю,0,0,1,1
35595,മകളെക്കുറിച്ചും,0,0,1,1
48600,bones,0,0,1,1
48564,rester,0,0,1,1
35627,betona,0,0,1,1
52370,மோசமான,0,0,1,1
48576,reter,0,0,1,1
35631,lehrer,0,0,1,1
35630,குளிர்,0,0,1,1
33639,نزاعات,0,0,1,1
52371,கட்டுரையைத்,0,0,1,1
33640,privilégios,0,0,1,1
49701,वित्त,0,0,1,1
33641,эгоистичный,0,0,1,1
35626,surprises,0,0,1,1
35598,السبب،,0,0,1,1
35625,लिंग,0,0,1,1
52660,повысили,0,0,1,1
49697,upptäckas,0,0,1,1
48578,artikelredigeringar,0,0,1,1
33646,കണക്കുകൂട്ടൽ,0,0,1,1
49696,сингапура,0,0,1,1
35623,بإغرائهم,0,0,1,1
35622,διακόψαμε,0,0,1,1
35621,electrónico,0,0,1,1
49702,suretiyle,0,0,1,1
35632,இப்போதே,0,0,1,1
35633,presos,0,0,1,1
48573,بدون,0,0,1,1
48565,categorieën,0,0,1,1
33631,सॉफ़्टवेयर,0,0,1,1
33632,ξεκινήσετε,0,0,1,1
33633,hergebruikt,0,0,1,1
48566,mémoire,0,0,1,1
35640,levé,0,0,1,1
35639,لإصلاحها,0,0,1,1
33634,energidrik,0,0,1,1
33635,conversatie,0,0,1,1
52369,wikipediarelated,0,0,1,1
33636,tirar,0,0,1,1
35637,verwechseln,0,0,1,1
48568,disallowed,0,0,1,1
33637,créées,0,0,1,1
48569,ökningen,0,0,1,1
35636,soñaste,0,0,1,1
48571,ziyaretçilerinin,0,0,1,1
48572,собой,0,0,1,1
35634,liegst,0,0,1,1
33647,забавный,0,0,1,1
48583,nivå,0,0,1,1
33648,يشبه,0,0,1,1
35613,الإذن,0,0,1,1
50218,ചൈനീസ്,0,0,1,1
35610,conditionne,0,0,1,1
52376,узнаваемы,0,0,1,1
35609,inclusionism,0,0,1,1
35608,visionen,0,0,1,1
52377,ഘട്ടം,0,0,1,1
49687,regeln,0,0,1,1
35607,غاضب,0,0,1,1
35606,ಒಮ್ಮೆ,0,0,1,1
52378,etmelerini,0,0,1,1
35605,மொழிகள்,0,0,1,1
35604,parcial,0,0,1,1
48595,electrónica,0,0,1,1
35602,स्टाप,0,0,1,1
49686,glada,0,0,1,1
35601,восхищенные,0,0,1,1
35600,gewogen,0,0,1,1
35599,fellow,0,0,1,1
33657,anthropique,0,0,1,1
48594,canapé,0,0,1,1
50466,പ്രശ്നമല്ലെന്ന്,0,0,1,1
50473,संभालते,0,0,1,1
49691,पोषण,0,0,1,1
35619,bewonderende,0,0,1,1
33649,الفارسية,0,0,1,1
35618,செய்வதன்,0,0,1,1
50472,culture »,0,0,1,1
33650,destin ,0,0,1,1
33651,thematic,0,0,1,1
33652,ссылкой,0,0,1,1
48590,سأحضر,0,0,1,1
52373,«очень,0,0,1,1
35617,rağmen,0,0,1,1
50469,comentários,0,0,1,1
49694,blokkeerde,0,0,1,1
33653,പതിപ്പുകളുണ്ട്,0,0,1,1
35616,തിരയലിൽ,0,0,1,1
35615,विकिकोट,0,0,1,1
52375,связана,0,0,1,1
49692,δίκαιη,0,0,1,1
35614,obtengas,0,0,1,1
52658,गाइडस्टार,0,0,1,1
48497,diferenciación,0,0,1,1
49731,drømmen,0,0,1,1
33588,العد،,0,0,1,1
35909,ತ್ವರಿತ,0,0,1,1
35914,ತೊಂದರೆಯುಂಟುಮಾಡುವ,0,0,1,1
35913,"
प्रत्येक",0,0,1,1
49767,модель,0,0,1,1
48403,editörleri,0,0,1,1
48404,"
नेपाल",0,0,1,1
48405,κυρίες,0,0,1,1
33537,متاحة,0,0,1,1
48406,தொடங்கினாள்,0,0,1,1
49765,apreço,0,0,1,1
33539,количеством,0,0,1,1
48392,الخلاف,0,0,1,1
33540,guter,0,0,1,1
35908,ചുട്ടെടുക്കാൻ,0,0,1,1
50520,بالعودة,0,0,1,1
49764,среда,0,0,1,1
33542,популярной,0,0,1,1
48408,முக்கியமாகத்,0,0,1,1
35905,പദ്ധതി,0,0,1,1
48409,eski,0,0,1,1
35903,നന്നായിരിക്കും,0,0,1,1
52329,അങ്ങനെയുള്ള,0,0,1,1
35917,dietitian,0,0,1,1
33532,слушайте,0,0,1,1
35920,വരാം,0,0,1,1
48393,πει,0,0,1,1
52326,träumen,0,0,1,1
33528,—மீக்கா,0,0,1,1
48396,meegebracht,0,0,1,1
35932,restent,0,0,1,1
35931,نجت,0,0,1,1
48397,divulgar,0,0,1,1
33529,spécialisés,0,0,1,1
33530,taler,0,0,1,1
52327,ليلة,0,0,1,1
35929,işim,0,0,1,1
48398,രണ്ടാം,0,0,1,1
48399,മാനഭംഗക്കേസുകളിൽ,0,0,1,1
52328,τυχαίνει,0,0,1,1
35926,अन्डू,0,0,1,1
35925,ഒബാമ,0,0,1,1
35924,natuurwetenschap,0,0,1,1
48400,عارض,0,0,1,1
33531,accurately,0,0,1,1
48410,eleştirmiştir,0,0,1,1
48411,ωστόσο,0,0,1,1
35901,نتعلم,0,0,1,1
48420,काल्पनिक,0,0,1,1
48424,confitures,0,0,1,1
33549,ಉಚ್ಚರಿಸುತ್ತಿದ್ದೀರಿ,0,0,1,1
33550,познавательной,0,0,1,1
52330,certainement,0,0,1,1
48425,thirdgeneration,0,0,1,1
35883,десятка»,0,0,1,1
35882,рунета,0,0,1,1
48426,ಕಳುಹಿಸಿದ್ದೀರಿ,0,0,1,1
35881,narcissmamma,0,0,1,1
48427,требовал,0,0,1,1
50513,ಕೋಪಗೊಂಡಿದ್ದಾರೆ,0,0,1,1
50512,சொற்களைத்,0,0,1,1
35878,constituents,0,0,1,1
35877,ನಿಲುಗಡೆ,0,0,1,1
50511,sobrenome,0,0,1,1
33551,ಪ್ರತಿಯೊಬ್ಬರೂ,0,0,1,1
35874,отдельных,0,0,1,1
52331,berømte,0,0,1,1
35873,singulière,0,0,1,1
49759, الويكيبيديا,0,0,1,1
33548,magtmisbrug,0,0,1,1
35900,جالسة,0,0,1,1
35886,merendeels,0,0,1,1
50519,поставил,0,0,1,1
35898,പോയാൽ,0,0,1,1
35897,مساعدتي,0,0,1,1
35896,التنسيق,0,0,1,1
35895,manually,0,0,1,1
48413,ಕ್ರೀಮ್,0,0,1,1
50195,conquest,0,0,1,1
48414,ஒப்புக்கொள்ள,0,0,1,1
50518,अनुदान,0,0,1,1
48416,normer,0,0,1,1
49763,pieds,0,0,1,1
49762,кластеров,0,0,1,1
48417,middelen,0,0,1,1
48418,anlayışı,0,0,1,1
33545,universeel,0,0,1,1
35890,википедией —,0,0,1,1
35889,ಹೇಳಬೇಕಾಗಿದೆ,0,0,1,1
35888,പരിശീലിപ്പിക്കുകയും,0,0,1,1
35887,​​ham,0,0,1,1
35935,hitwise,0,0,1,1
35936,എന്നാലും,0,0,1,1
35871,hierarchical,0,0,1,1
50532,calúnia,0,0,1,1
35975,geçerli,0,0,1,1
48368,noisy,0,0,1,1
48370,robot—,0,0,1,1
52320,uiterlijk,0,0,1,1
48371,вырастет,0,0,1,1
35972,gems,0,0,1,1
33507,решающее,0,0,1,1
50192,contributrices,0,0,1,1
33508,والصحفي,0,0,1,1
33509,достать,0,0,1,1
49769,contenues,0,0,1,1
50531,eqord,0,0,1,1
48374,beobachtete,0,0,1,1
35970,ഹലോ,0,0,1,1
49783,slepend,0,0,1,1
52321,sumarse,0,0,1,1
48376,autorisés,0,0,1,1
35967,ಹೊರತುಪಡಿಸಿ,0,0,1,1
49781,மனரீதியாகக்,0,0,1,1
35965,وإنشاء,0,0,1,1
48367,deelname,0,0,1,1
33506,bulacaksınız,0,0,1,1
50533,instruments,0,0,1,1
49785,வகுப்பில்,0,0,1,1
35989,öğreniyorsan,0,0,1,1
33500,«уборка»,0,0,1,1
35988,ஏழை,0,0,1,1
33501,gelsin,0,0,1,1
49787,apropriada,0,0,1,1
48358,பணக்காரர்,0,0,1,1
35987,zelfstandig,0,0,1,1
52319,അവർ‍,0,0,1,1
35985,reparos,0,0,1,1
48360,உணவிற்கு,0,0,1,1
33502,латинский,0,0,1,1
48361,favorecer,0,0,1,1
33503,persoonlijk,0,0,1,1
35981,lusteloos,0,0,1,1
35980,परिचय,0,0,1,1
48363,assuntos,0,0,1,1
52674,veckotidskrift,0,0,1,1
35979,dk,0,0,1,1
33504,datorer,0,0,1,1
50530,submergée,0,0,1,1
33511,पंथ,0,0,1,1
35962,японии,0,0,1,1
48384,stupide,0,0,1,1
50525,gepatenteerde,0,0,1,1
49773,habitées,0,0,1,1
33523,country,0,0,1,1
35948,колледжа,0,0,1,1
48385,ಧ್ವನಿಸುವ,0,0,1,1
35947,ಸಿನೆಮಾಗಳಿಗಾಗಿ,0,0,1,1
52323,سياق,0,0,1,1
35944,tidligere,0,0,1,1
33524,judiciaire…,0,0,1,1
35942,глагол,0,0,1,1
35941,bijdragers,0,0,1,1
52672,publicitaireréf,0,0,1,1
33525,reich,0,0,1,1
35939,dictionarystyle,0,0,1,1
48389,ദേഷ്യപ്പെടുന്നുവെന്നത്,0,0,1,1
33526,приступим,0,0,1,1
33527,ടെസ്റ്റിൽ‌,0,0,1,1
35937,لطلب,0,0,1,1
48391,ಸೂಚಿಸುತ್ತದೆ,0,0,1,1
35949,quarry,0,0,1,1
49774,cart,0,0,1,1
50528,जीने,0,0,1,1
35951,aylardır,0,0,1,1
33512,удовольствием,0,0,1,1
35961,ουδετερότητας,0,0,1,1
33513,attendues ,0,0,1,1
52322,profite,0,0,1,1
35960,ενοχλητικής,0,0,1,1
35959,собака,0,0,1,1
35958,cèdent,0,0,1,1
48380,वित्तपोषण,0,0,1,1
49778,главным,0,0,1,1
49777,påverka,0,0,1,1
33516,egotistical,0,0,1,1
48381,forretning,0,0,1,1
50527,validation ,0,0,1,1
48382,negativa,0,0,1,1
48383,sammanslagning,0,0,1,1
33518,anlatsaydı,0,0,1,1
50193,démagogie,0,0,1,1
33521,contentious,0,0,1,1
35952,قدمًا,0,0,1,1
35872,statistiskt,0,0,1,1
49756,klædt,0,0,1,1
48496,उत्पीड़क,0,0,1,1
48474,प्रकाशन,0,0,1,1
48472,curve,0,0,1,1
35798,ಆಲೂಗಡ್ಡೆಗಳನ್ನು,0,0,1,1
35797,stumpfen,0,0,1,1
35796,meldde,0,0,1,1
50500,വായിച്ച്,0,0,1,1
52344,africarelated,0,0,1,1
48473,gesproken,0,0,1,1
35794,artikelredigering,0,0,1,1
52345,പുഞ്ചിരിക്കാനും,0,0,1,1
48475,بمعايير,0,0,1,1
50201,празднует,0,0,1,1
48477,portavoz,0,0,1,1
50499,استندت,0,0,1,1
35791,محرك,0,0,1,1
50498,integrating,0,0,1,1
50497,plaques,0,0,1,1
35789,indkørslen,0,0,1,1
35788,asırlardır,0,0,1,1
33578,استمع,0,0,1,1
48479,самим,0,0,1,1
33577,beneficie,0,0,1,1
52343,feinste,0,0,1,1
49738,طورت,0,0,1,1
49739,பிரச்சனையும்,0,0,1,1
35810,publikation,0,0,1,1
35809,empêchant,0,0,1,1
50202,воспользуюсь,0,0,1,1
48462,جماعيا،,0,0,1,1
48463,wijziging,0,0,1,1
52340,ಹಿಡಿದಿಡಬಹುದೇ,0,0,1,1
33575,குழப்பத்தில்,0,0,1,1
48464,электронном,0,0,1,1
48465,தவிர்ப்பது,0,0,1,1
48466,wikipediaartiklars,0,0,1,1
35805,формы,0,0,1,1
35804,supermarket,0,0,1,1
52341,vinkade,0,0,1,1
48468,μεγαλώσετε,0,0,1,1
35802,éditeur,0,0,1,1
49740,चुनूंगा,0,0,1,1
35801,improvements,0,0,1,1
33576,övergav,0,0,1,1
48471,الروبوت,0,0,1,1
35787,maddelerdir,0,0,1,1
33579,acordados,0,0,1,1
48482,intégré,0,0,1,1
49735,legt,0,0,1,1
49734,ദർശനം,0,0,1,1
35770,fils,0,0,1,1
33583,குழுசேர,0,0,1,1
52348,рекорд,0,0,1,1
35769,yapın,0,0,1,1
35768,diferencia,0,0,1,1
35767,архитектуру,0,0,1,1
35766,linnaeus,0,0,1,1
52349,attributionsharealike,0,0,1,1
35765,pitts,0,0,1,1
48493,utilizando,0,0,1,1
33585,l’épistémologie,0,0,1,1
52666,традиционным,0,0,1,1
33587,duur,0,0,1,1
50207,региональные,0,0,1,1
35763,ναρκίσσους,0,0,1,1
35762,पहुँचे,0,0,1,1
48495,webbaserad,0,0,1,1
35760,milyonlarca,0,0,1,1
33582,romaine,0,0,1,1
35771,تطبيق,0,0,1,1
50204,तेज,0,0,1,1
48489,"
मलयालम",0,0,1,1
52347,англоязычного,0,0,1,1
48483,gehaald,0,0,1,1
49736,вандализирована,0,0,1,1
50205,പദമില്ലാത്തതിനാൽ,0,0,1,1
48485,anticlaudianus,0,0,1,1
48486,influir,0,0,1,1
35783,ആശയമാണെന്ന്,0,0,1,1
35782,eksisteret,0,0,1,1
35781,köyde,0,0,1,1
35780,ಆಕ್ರಮಣಕಾರಿ,0,0,1,1
33581,distinguir,0,0,1,1
35779,பள்ளியிலிருந்து,0,0,1,1
35778,causadas,0,0,1,1
35776,serieus,0,0,1,1
35775,சந்தேகம்,0,0,1,1
50206,double,0,0,1,1
35774,mythique,0,0,1,1
35773,başbakanı,0,0,1,1
50495,ख़बरों,0,0,1,1
35811,समारोह,0,0,1,1
35812,excitant,0,0,1,1
35870,ваша,0,0,1,1
48443,werkervaring,0,0,1,1
35854,പലപ്പൊഴും,0,0,1,1
35853,destacando,0,0,1,1
48441,अचंभित,0,0,1,1
35851,arasında,0,0,1,1
52334,ಒಳ್ಳೆಯವರಾಗಿದ್ದಾರೆ,0,0,1,1
35850,tillhör,0,0,1,1
50508,columbia,0,0,1,1
48442,burocracia,0,0,1,1
35847,doctorandos,0,0,1,1
49746,டெர்ரியைப்,0,0,1,1
35813,esboço,0,0,1,1
49745,uz •,0,0,1,1
35845,prepubescent,0,0,1,1
52335,ഉറപ്പായിട്ടും,0,0,1,1
34219,riding,0,0,1,1
50506,sendte,0,0,1,1
33564,relativos,0,0,1,1
33565,executes,0,0,1,1
48444,poderes,0,0,1,1
49744,الأخرى،,0,0,1,1
35855,gevallen,0,0,1,1
48440,correcteurs,0,0,1,1
33561,क्रियाओं,0,0,1,1
48439,geldiniz,0,0,1,1
35868,concentrerait,0,0,1,1
33554,serieuze,0,0,1,1
35867,interactividad,0,0,1,1
35866,добровольных,0,0,1,1
33555,interesado,0,0,1,1
35864,இணையத்தளம்,0,0,1,1
49752,overeenkomstige,0,0,1,1
48431,வரவேற்பு,0,0,1,1
35862,lägger,0,0,1,1
35861,"
कोमी",0,0,1,1
35860,frit,0,0,1,1
48432,inégalitaire,0,0,1,1
48433,تشاهد,0,0,1,1
33559,tilbage,0,0,1,1
35859,validade,0,0,1,1
48434,ಕಾಫಿಯನ್ನು,0,0,1,1
52333,выборкой,0,0,1,1
48436,transport,0,0,1,1
35857,poupée,0,0,1,1
52336,originalforskning,0,0,1,1
33566,അതോ,0,0,1,1
48446,yazılarına,0,0,1,1
35824,encorajar,0,0,1,1
50503,уставшим,0,0,1,1
35823,затмившей,0,0,1,1
49741,vannevar,0,0,1,1
33570,ಬೇರುಗಳನ್ನು,0,0,1,1
48455,تتمتع,0,0,1,1
35822,மாற்றங்களையும்,0,0,1,1
35821,jump,0,0,1,1
35820,voit,0,0,1,1
35819,kvalitetssäkring,0,0,1,1
48458,suites,0,0,1,1
48459,οπτική,0,0,1,1
50501,repetition,0,0,1,1
33571,стакан,0,0,1,1
35818,siri,0,0,1,1
35817,വെയ്കാനും,0,0,1,1
52339,لاحقًا،,0,0,1,1
35815,شخصية,0,0,1,1
33572,ناقصا,0,0,1,1
33573,indiquait,0,0,1,1
52338,ഇവരേയും,0,0,1,1
48453,социологическое,0,0,1,1
35839,فارس,0,0,1,1
35826,quedó,0,0,1,1
48447,दिखता,0,0,1,1
48448,சாதனையாக,0,0,1,1
35837,புத்தகத்தில்,0,0,1,1
35836,ಉಡುಗೊರೆಯನ್ನು,0,0,1,1
50199,censurera,0,0,1,1
48449,görebildiğim,0,0,1,1
33568,inconsistencias,0,0,1,1
48450,मशीनों,0,0,1,1
35834,it •,0,0,1,1
35833,сестра,0,0,1,1
50200,farms,0,0,1,1
35832,разработанный,0,0,1,1
35831,catalisador,0,0,1,1
35830,ശരിയാക്കി,0,0,1,1
48451,imprimables,0,0,1,1
48452,denkt,0,0,1,1
35829,parallèles,0,0,1,1
35828,poses,0,0,1,1
35827,мысленно,0,0,1,1
35539,تواصل,0,0,1,1
33687,acudirse,0,0,1,1
35538,μεμονωμένο,0,0,1,1
52639,dokümanların,0,0,1,1
48791,vermeniz,0,0,1,1
48792,« vitaliste »,0,0,1,1
48793,organization—though,0,0,1,1
52417,попросить,0,0,1,1
48794,d’inclure,0,0,1,1
50241,lie,0,0,1,1
48796,dedikerede,0,0,1,1
35245,práctica,0,0,1,1
33816,करूँगी,0,0,1,1
35244,tamam,0,0,1,1
35264,latinske,0,0,1,1
52418,igennem,0,0,1,1
35243,välmenade,0,0,1,1
48798,amateurastronoom,0,0,1,1
49615,yiyecek,0,0,1,1
33818,تباعدوا,0,0,1,1
35242,"
samarês",0,0,1,1
35240,demek,0,0,1,1
33819,ഇരുവർക്കും,0,0,1,1
35239,sinais,0,0,1,1
33815,عيون,0,0,1,1
52416,رمز,0,0,1,1
35251,yesterday,0,0,1,1
35252,betydelsen,0,0,1,1
48783,llamar,0,0,1,1
33810,träna,0,0,1,1
35263,ومتوازنًا,0,0,1,1
35262,ജോലികൾക്കു,0,0,1,1
33811,والدتهما,0,0,1,1
48784,நிர்வாகிகள்,0,0,1,1
33812,smakprov,0,0,1,1
33813,ноябрь,0,0,1,1
35260,блокировкой,0,0,1,1
50427,formais,0,0,1,1
48787,bijzijn,0,0,1,1
35258,ademen,0,0,1,1
48788,troepen,0,0,1,1
48789,surgiram,0,0,1,1
35256,കാമുകനോ,0,0,1,1
35255,prestes,0,0,1,1
35254,வாழ்க்கையைப்,0,0,1,1
33814,എഡിറ്റുകളെല്ലാം,0,0,1,1
48790,frågades,0,0,1,1
48799,жестокий,0,0,1,1
49614,रिपोजिटरी,0,0,1,1
35237,явно,0,0,1,1
35222,sucedido,0,0,1,1
33830,உணர்ந்தால்,0,0,1,1
37539,διαβάζω,0,0,1,1
35220,uncultivated,0,0,1,1
52421,gewerkt,0,0,1,1
35218,trägen,0,0,1,1
35217,открыта,0,0,1,1
49609,англоязычную,0,0,1,1
35216,government,0,0,1,1
35215,सुस्निंगनु,0,0,1,1
52422,fungerer,0,0,1,1
35213,ആശ്ചര്യകരമായ,0,0,1,1
50245,والزميل,0,0,1,1
35212,സേർച്ച്,0,0,1,1
33832,athéisme,0,0,1,1
35210,bok,0,0,1,1
33833,rêvais,0,0,1,1
35208,ಬಾಲ್ಕನಿಯಲ್ಲಿ,0,0,1,1
35207,finger,0,0,1,1
49608,غيغابايت,0,0,1,1
35221,ഉത്തരം,0,0,1,1
35223,proteção,0,0,1,1
35235,إيه,0,0,1,1
48810,verifieras,0,0,1,1
35234,തുല്യമായ,0,0,1,1
35233,återställs,0,0,1,1
35232,கொண்டிருந்தால்,0,0,1,1
48801,തിരുത്തുവാനും,0,0,1,1
48802,caller,0,0,1,1
33821,جامعيون,0,0,1,1
48803,saturn,0,0,1,1
35230,baserade,0,0,1,1
33822,ടെലിഫോൺ,0,0,1,1
48805,critical,0,0,1,1
49613,wherefrom,0,0,1,1
50420,protestar,0,0,1,1
35226,ഒരുപോലെ,0,0,1,1
49611,ആഗ്രഹിക്കുന്നിടത്തോളം,0,0,1,1
35225,ಹಾಗಾಗಿ,0,0,1,1
33823,verse,0,0,1,1
52638,developmental,0,0,1,1
49610,centuple,0,0,1,1
33828,σκληροί,0,0,1,1
48782,മണമുള്ള,0,0,1,1
35265,indesejável,0,0,1,1
52636,adiós,0,0,1,1
35303,சிலவேளைகளில்,0,0,1,1
50237,visait,0,0,1,1
35308,இவற்றோடு,0,0,1,1
35306,semiprotegidas,0,0,1,1
33795,സൃഷ്ടികളേയും,0,0,1,1
52642,μπερδέψεις,0,0,1,1
52641,chat,0,0,1,1
48760,penny,0,0,1,1
48761,إنشاؤها,0,0,1,1
35304,слышал,0,0,1,1
50238,журналистов,0,0,1,1
48781,spåddes,0,0,1,1
49623,गुजरते,0,0,1,1
33796,optaram,0,0,1,1
35302,ulaşamadı,0,0,1,1
49622,davada,0,0,1,1
50431,न्यायाधीशों,0,0,1,1
48762,இதற்குப்,0,0,1,1
48763,прыгну,0,0,1,1
49620,വിശദീകരിക്കുന്ന,0,0,1,1
35299,globales,0,0,1,1
33792,المنفرج,0,0,1,1
33791,وأكثر,0,0,1,1
35309,authority,0,0,1,1
48757,தன்,0,0,1,1
35317,användaridentitet,0,0,1,1
35316,δημιουργηθεί,0,0,1,1
48754,holistique,0,0,1,1
35315,zuerst,0,0,1,1
49627,எனவும்,0,0,1,1
33786,paysage,0,0,1,1
35314,weniger,0,0,1,1
33787,പരിശീലിപ്പിക്കുകയാണെങ്കിൽ,0,0,1,1
35313,ಕರೆ,0,0,1,1
35312,i̇ngilizcede,0,0,1,1
49625,« modifications,0,0,1,1
52412,എൻസൈക്ലോപീഡിയ,0,0,1,1
33788,ನೀಡಿದ,0,0,1,1
48755,ஆக்க,0,0,1,1
50235,уместно,0,0,1,1
50236,spridning,0,0,1,1
50432,المحايدة،,0,0,1,1
33790,रहो।,0,0,1,1
35310,bijeenkomst,0,0,1,1
35298,arbitraje,0,0,1,1
33799,inocência,0,0,1,1
48766,paulo,0,0,1,1
35279,दबाया,0,0,1,1
48772,इनक्यूबेटर,0,0,1,1
49617,decomposition,0,0,1,1
35274,بياني,0,0,1,1
33805,nascor,0,0,1,1
48773,وكلمة,0,0,1,1
35273,seixas,0,0,1,1
35272,actuar,0,0,1,1
33806,മാന്യമായി,0,0,1,1
33807,migrado,0,0,1,1
48774,"
अप्रैल",0,0,1,1
52414,portant,0,0,1,1
35270,публично,0,0,1,1
48776,έλα,0,0,1,1
35269,കരയുന്നത്,0,0,1,1
52415,περιγράφεται,0,0,1,1
35267,όντα,0,0,1,1
33809,providing,0,0,1,1
48780,snabb,0,0,1,1
35266,ಮಾನಸಿಕವಾಗಿ,0,0,1,1
35278,विकिपिडियन,0,0,1,1
35280,வழங்குகின்றது,0,0,1,1
50430,besat,0,0,1,1
33803,dolan,0,0,1,1
35294,दावे,0,0,1,1
35293,விருந்தில்,0,0,1,1
35292,divertido,0,0,1,1
35291,l’émergence,0,0,1,1
52413,instruções,0,0,1,1
50239,helion,0,0,1,1
35288,выпуска,0,0,1,1
49619,wikiversidad,0,0,1,1
50240,اشتروه,0,0,1,1
33801,sencillez,0,0,1,1
35287,transformée,0,0,1,1
35286,antalet,0,0,1,1
48770,olsa,0,0,1,1
33802,தொலைபேசியில்,0,0,1,1
35283,anglais ,0,0,1,1
48771,enkätundersökningen,0,0,1,1
35282,دموعك,0,0,1,1
49618,പെരുമാറിയ,0,0,1,1
35281,സഞ്ചരിക്കുന്ന,0,0,1,1
35206,straks,0,0,1,1
33834,étiquetées,0,0,1,1
33783,abonnementsknappen,0,0,1,1
33863,δίλημμα,0,0,1,1
35135,मई,0,0,1,1
33861,частому,0,0,1,1
48846,അനുകൂല,0,0,1,1
48847,ഗെയിം,0,0,1,1
35132,finir,0,0,1,1
35131,ಅದರೊಂದಿಗೆ,0,0,1,1
33862,almadınız,0,0,1,1
48848,ayúdame,0,0,1,1
35129,correto,0,0,1,1
35128,sprake,0,0,1,1
35148,violent,0,0,1,1
50411,formulerer,0,0,1,1
35126,httpskryptering,0,0,1,1
35125,exercent,0,0,1,1
48849,சந்திப்பிற்கும்,0,0,1,1
48850,sementes,0,0,1,1
35123,velsmagende,0,0,1,1
48851,känna,0,0,1,1
33864,καροτσάκι,0,0,1,1
35122,reivindicações,0,0,1,1
35136,വാട്ട്സ്ആപ്പ്,0,0,1,1
35137,تجعلني,0,0,1,1
48845,प्रोजेक्टों,0,0,1,1
48844,χρειάζομαι,0,0,1,1
52431,drastic,0,0,1,1
48838,opted,0,0,1,1
35147,sædvanlige,0,0,1,1
48839,ettusen,0,0,1,1
48840,إرباك,0,0,1,1
35146,أعطت,0,0,1,1
49594,നൽകുന്നതിന്,0,0,1,1
50412,நடக்காத,0,0,1,1
48841,സുന്ദരനായിരുന്നു,0,0,1,1
35144,يمرر,0,0,1,1
48842,« bots »,0,0,1,1
33859,filosofen,0,0,1,1
49593,paranız,0,0,1,1
33860,tl •,0,0,1,1
35143,reconoce,0,0,1,1
35142,നടത്തുന്നുമുണ്ട്,0,0,1,1
35141,δοκιμή,0,0,1,1
35140,basıma,0,0,1,1
35139,വിഷമകരമായ,0,0,1,1
49592,kodlu,0,0,1,1
33865,बोट्स,0,0,1,1
48853,സംബന്ധിച്ചിടത്തോളം,0,0,1,1
49588,ಮೆಲ್ಲೀ,0,0,1,1
33871,हीरों,0,0,1,1
48860,inattendues,0,0,1,1
48861,pelarna,0,0,1,1
35102,помешал,0,0,1,1
33872,ihlalleri,0,0,1,1
52628,придерживаются,0,0,1,1
48862,redden,0,0,1,1
33873,minimum,0,0,1,1
35100,பிடித்த,0,0,1,1
52437,etkin,0,0,1,1
35099,presionando,0,0,1,1
52438,മാർച്ച്,0,0,1,1
48863,possua,0,0,1,1
48864,usamos,0,0,1,1
48865,بمجموعة,0,0,1,1
35096,erweitern,0,0,1,1
35095,conferencista,0,0,1,1
48866,சமயங்களில்,0,0,1,1
35093,പൂർത്തിയാക്കട്ടെ,0,0,1,1
52435,забывает,0,0,1,1
35106,ரகசியம்,0,0,1,1
35121,tests,0,0,1,1
52434,endereço,0,0,1,1
48854,sorunu,0,0,1,1
35120,cantonales,0,0,1,1
35119,തുടക്കത്തിൽ,0,0,1,1
52433,düşünmeye,0,0,1,1
48855,talere,0,0,1,1
35117,للامتحان,0,0,1,1
35116,uttalet,0,0,1,1
35115,ontworpen,0,0,1,1
35114,afrique,0,0,1,1
35113,يفسر,0,0,1,1
48857,uruguay,0,0,1,1
35112,للمستخدمين,0,0,1,1
35111,опираться,0,0,1,1
35110,അമിതമായി,0,0,1,1
49590,poängterar,0,0,1,1
35109,പിന്നിലെ,0,0,1,1
35108,مقارنة,0,0,1,1
35107,disque,0,0,1,1
49589,presentador,0,0,1,1
48837,различают,0,0,1,1
49596,ಹೆದರುತ್ತಿದ್ದೆ,0,0,1,1
52424,الحيوية,0,0,1,1
33843,koltuğunuzda,0,0,1,1
35190,പരിപാലിക്കുക,0,0,1,1
35189,μοντέλο,0,0,1,1
35188,"
marata",0,0,1,1
35187,eğitim,0,0,1,1
35186,düzeltilmesini,0,0,1,1
35185,प्रकाशनों,0,0,1,1
35184,шекман,0,0,1,1
49604,suffisant,0,0,1,1
33842,होफ्लिंग,0,0,1,1
52427,πια,0,0,1,1
49598,distribuer,0,0,1,1
50246,पर्ल,0,0,1,1
35180,özgürlüğüm,0,0,1,1
48818,bokstavligen,0,0,1,1
35178,disparidad,0,0,1,1
35177,pricing,0,0,1,1
33845,früher,0,0,1,1
35175,സംശയത്തിന്,0,0,1,1
35174,galardonada,0,0,1,1
35173,تشير,0,0,1,1
35191,कैलिफोर्निया,0,0,1,1
48815,düşürürseniz,0,0,1,1
52634,continuera,0,0,1,1
33840,अरबी,0,0,1,1
35205,quente,0,0,1,1
48811,fuerza,0,0,1,1
35204,കൊടുത്തുകൊണ്ടുള്ള,0,0,1,1
35203,baseados,0,0,1,1
33835,eenieder,0,0,1,1
33836,couches ,0,0,1,1
35202,கூறினார்,0,0,1,1
48812,"navnet
",0,0,1,1
52635,இற்றைப்படுத்தப்படும்,0,0,1,1
49606,malo,0,0,1,1
35198,зрелыми,0,0,1,1
35197,ينوي,0,0,1,1
33838,fået,0,0,1,1
48814,മലയാളത്തിൽ,0,0,1,1
52425,felaktiga,0,0,1,1
35194,للذهاب,0,0,1,1
35193,metal,0,0,1,1
35192,meritsystem,0,0,1,1
33839,تبحث,0,0,1,1
52428,വിക്കിപീഡിയകളായ,0,0,1,1
52632,बोल,0,0,1,1
35171,primaires,0,0,1,1
48830,düşündü,0,0,1,1
35160,أقبل,0,0,1,1
35159,persistencia,0,0,1,1
33853,quejarse,0,0,1,1
52429,νυφικό,0,0,1,1
50415,собрания,0,0,1,1
35157,cometer,0,0,1,1
35156,digitizing,0,0,1,1
35155,оскорблением,0,0,1,1
35154,ಪದದಿಂದ,0,0,1,1
33854,കാണുന്നില്ലെന്ന്‌,0,0,1,1
35153,ഇടമില്ല,0,0,1,1
50414,आंकडे,0,0,1,1
35152,ಪುನರಾವರ್ತಿಸಬೇಕು,0,0,1,1
35151,αχνό,0,0,1,1
33855,sindet,0,0,1,1
48834,fenomenet,0,0,1,1
35150,медиафайлы,0,0,1,1
48835,potencial,0,0,1,1
48836,தேவதையைப்,0,0,1,1
48831,aanbiedingen,0,0,1,1
48828,adverte,0,0,1,1
50416,மாலில்,0,0,1,1
33852,souhaiter,0,0,1,1
35170,चलाये,0,0,1,1
35169,правил,0,0,1,1
48821,अधिनियम,0,0,1,1
33847,pretty,0,0,1,1
35168,knopf,0,0,1,1
35167,heartbroken,0,0,1,1
48823,étions,0,0,1,1
48824,cariño,0,0,1,1
33848,şikayetçi,0,0,1,1
49601,மாவு,0,0,1,1
35165,ದೌರ್ಜನ್ಯವನ್ನು,0,0,1,1
35164,उपलब्धियों,0,0,1,1
35163,besteht,0,0,1,1
35162,سلطات,0,0,1,1
33850,விடயங்கள்,0,0,1,1
48826,ಅಳಬೇಡ,0,0,1,1
49600,fejlede,0,0,1,1
49599,hjemmesider,0,0,1,1
33851,arbetsdelning,0,0,1,1
35318,وقال,0,0,1,1
48753,மாற்றினாள்,0,0,1,1
35537,soep,0,0,1,1
35460,மூளைச்சலவை,0,0,1,1
48677,парламента,0,0,1,1
35466,stemden,0,0,1,1
49664,الآخرون,0,0,1,1
49663,söylenmeyecek,0,0,1,1
50226,аналогична,0,0,1,1
33718,verdenskrig,0,0,1,1
48679,عديم,0,0,1,1
35462,thème ,0,0,1,1
35461,raccorder,0,0,1,1
35459,agilizar,0,0,1,1
50456,universiteit,0,0,1,1
48681,συνειδητοποιείς,0,0,1,1
48682,nicholson,0,0,1,1
35457,داعي,0,0,1,1
33719,vakfı,0,0,1,1
35456,ouvrage,0,0,1,1
35455,beräknades,0,0,1,1
52391,bewundernden,0,0,1,1
35454,svälter,0,0,1,1
49660,मिलेंगे।,0,0,1,1
35467,schweres,0,0,1,1
48676,खुफिया,0,0,1,1
35468,nordkorea,0,0,1,1
48675,inser,0,0,1,1
50455,رأيين,0,0,1,1
48666,titta,0,0,1,1
33708,ಕಾಣುತ್ತಿದ್ದೀರಿ,0,0,1,1
35478,bilmiyorsun,0,0,1,1
35476,shell,0,0,1,1
48667,കണ്ടെത്തും,0,0,1,1
33709,принципе,0,0,1,1
50454,escolhas,0,0,1,1
33710,değiştirilebilir,0,0,1,1
35473,countless,0,0,1,1
33711,പത്രവാർത്തകളും,0,0,1,1
33712,incentivos,0,0,1,1
50453,ചേരുന്നതും,0,0,1,1
48669,iseniz,0,0,1,1
48670,ಪೋಯ್ಸ್ಡ್,0,0,1,1
35472,descrevendoo,0,0,1,1
35470,towards,0,0,1,1
48673,definen,0,0,1,1
48674,итальянский,0,0,1,1
35453,رأيت,0,0,1,1
49659,ഭാഗ്യത്തിന്റെ,0,0,1,1
35452,artig,0,0,1,1
33729,ಜಿಗಿದರೆ,0,0,1,1
48689,telefoniert,0,0,1,1
35437,diskussionssida,0,0,1,1
52395,bağımsızdır,0,0,1,1
35435,геометрии,0,0,1,1
48690,locaux,0,0,1,1
33730,टाइप,0,0,1,1
50449,bulk,0,0,1,1
35433,blanda,0,0,1,1
35432,dağarcığınızı,0,0,1,1
49653,tian,0,0,1,1
50448,வழங்கிக்,0,0,1,1
35431,faça,0,0,1,1
48693,കളികൾ,0,0,1,1
49652,princípio,0,0,1,1
49651,quelles,0,0,1,1
33733,estructura,0,0,1,1
35429,المراجعة,0,0,1,1
35428,അവധി,0,0,1,1
33734,studentuppsatser,0,0,1,1
48688,voortbouwen,0,0,1,1
52394,basması,0,0,1,1
52393,естественно,0,0,1,1
48686,اللغة،,0,0,1,1
35451,تتحدث,0,0,1,1
35450,ತನ್ನನ್ನು,0,0,1,1
35449,ಸ್ಥಳವಿಲ್ಲ,0,0,1,1
33723,hjemmesiden,0,0,1,1
35448,вручена,0,0,1,1
33724,çiviyi,0,0,1,1
33725,повторил,0,0,1,1
35447,प्रोफेसर,0,0,1,1
35446,automatiserade,0,0,1,1
52652,മലയാളത്തിനു,0,0,1,1
35445,വന്ന,0,0,1,1
49654,модификации,0,0,1,1
35444,geçide,0,0,1,1
35443,vidunderligt,0,0,1,1
35442,браках,0,0,1,1
50450,skrivaredigera,0,0,1,1
35441,ലാഭേച്ഛകൂടാതെ,0,0,1,1
33728,preference,0,0,1,1
48685,बेकार,0,0,1,1
33707,﻿°n,0,0,1,1
48664,tenían,0,0,1,1
35427,alegam,0,0,1,1
33695,forskares,0,0,1,1
49674,determinando,0,0,1,1
33691,chapter,0,0,1,1
48640,işaretiyle,0,0,1,1
35517,नेगोशिएशन,0,0,1,1
35516,hot,0,0,1,1
52656,gemakkelijk,0,0,1,1
50223,fatally,0,0,1,1
50458,προωθήθηκα,0,0,1,1
35515,paramètres,0,0,1,1
49673,vågnede,0,0,1,1
35482,пародировал,0,0,1,1
33696,koud,0,0,1,1
49672,исправить,0,0,1,1
33697,« fin,0,0,1,1
35514,antidühring ,0,0,1,1
48643,اعترض,0,0,1,1
35513,grundprincipen,0,0,1,1
49671,wikiformat,0,0,1,1
48646,κοντά,0,0,1,1
35511,d’outils,0,0,1,1
35519,ಇನ್ನೊಂದಕ್ಕೆ,0,0,1,1
35520,σκοπεύω,0,0,1,1
48637,trycka,0,0,1,1
48635,χρυσές,0,0,1,1
35535,diferença,0,0,1,1
33688,يركزون,0,0,1,1
33689,autorités,0,0,1,1
48628,समझाते,0,0,1,1
48629,ενθαρρύνονται,0,0,1,1
49675,görmemişsinizdir,0,0,1,1
35532,"
अफ़्रीकान्स",0,0,1,1
35531,उदघाटन,0,0,1,1
48630,hispana,0,0,1,1
33690,« print,0,0,1,1
35529,ಜೀವಿಗಳು,0,0,1,1
35528,സ്പീക്കറിൽ,0,0,1,1
35527,сайта —,0,0,1,1
48631,மேலிருந்து,0,0,1,1
48632,rejser,0,0,1,1
35525,функциями,0,0,1,1
35524,forcément,0,0,1,1
35523,impreso,0,0,1,1
35521,gentileza,0,0,1,1
35510,некоммерческим,0,0,1,1
35509,выучить,0,0,1,1
48647,ವಿಷಯವಲ್ಲ,0,0,1,1
33703,печатного,0,0,1,1
35493,നാട്ടറിവുകൾ,0,0,1,1
49669,façam,0,0,1,1
48657,memcached,0,0,1,1
35491,stiegler,0,0,1,1
49668,வேண்டத்தகாத,0,0,1,1
35490,पी,0,0,1,1
35489,चक्कर,0,0,1,1
48658,lgbt,0,0,1,1
35488,செல்கிறேன்,0,0,1,1
50457,ontem,0,0,1,1
48659,ತೊಂದರೆಗೊಳಗಾಗಲು,0,0,1,1
48660,ಮಾಹಿತಿಗಾಗಿ,0,0,1,1
48661,meilleurs,0,0,1,1
35486,बनाये,0,0,1,1
48663,danés,0,0,1,1
35485,självklart,0,0,1,1
35484,രണ്ടോ,0,0,1,1
35483,انقر,0,0,1,1
49666,croisée,0,0,1,1
35494,colocar,0,0,1,1
33702,எட்டு,0,0,1,1
33698,திருமணத்தில்,0,0,1,1
48655,எப்படியிருந்தாலும்,0,0,1,1
35508,தமக்கு,0,0,1,1
35507,världskriget,0,0,1,1
35506,ಸುಳಿವು,0,0,1,1
35505,descendente,0,0,1,1
52655,passages,0,0,1,1
35504,varsayalım,0,0,1,1
35503,റെയിൽ‌വേ,0,0,1,1
48650,carte,0,0,1,1
35501,contratarte,0,0,1,1
52386,schlaf,0,0,1,1
35500,विक्शनरी,0,0,1,1
35499,вялости,0,0,1,1
48651,شريحة,0,0,1,1
48652,ചിഹ്നങ്ങളെയും,0,0,1,1
35497,rättvis,0,0,1,1
33701,बनाते,0,0,1,1
49670,stattdessen,0,0,1,1
35496,الرائعة,0,0,1,1
52389,heet,0,0,1,1
33735,лучшее,0,0,1,1
50447,വിലയിരുത്തപ്പെട്ട,0,0,1,1
49628,fêtes,0,0,1,1
35354,александрийской,0,0,1,1
50441,emplaced,0,0,1,1
35359,നൽകുന്നുണ്ട്‌,0,0,1,1
35358,கட்டுரையொன்றை,0,0,1,1
48732,marques,0,0,1,1
35357,έτρεξε,0,0,1,1
49636,fuese,0,0,1,1
33769,منفرج,0,0,1,1
33770,दिशानिर्देश,0,0,1,1
33771,lief,0,0,1,1
33772,framsteg,0,0,1,1
49638,fidedignas,0,0,1,1
35352,invite,0,0,1,1
49635,católico,0,0,1,1
52645,الخطأ,0,0,1,1
50440,ಅರ್ಥವಾಗಿದೆ,0,0,1,1
35349,भागीदारी,0,0,1,1
33773,துடிக்கிறது,0,0,1,1
35348,ولطيفة,0,0,1,1
35347,repairing,0,0,1,1
35346,military,0,0,1,1
48731,marknadsundersökningsföretag,0,0,1,1
48730,repris,0,0,1,1
33767,onvoldoende,0,0,1,1
49637,uitgeroepen,0,0,1,1
35372,denote,0,0,1,1
48722,mejores,0,0,1,1
33763,belangrijke,0,0,1,1
33764,വിചാരിക്കുന്നില്ല,0,0,1,1
50442,அழகானவர்,0,0,1,1
35370,testar,0,0,1,1
35369,отвергла,0,0,1,1
52646,поймешь,0,0,1,1
48724,encorajada,0,0,1,1
48725,"
lituano",0,0,1,1
48727,விளக்க,0,0,1,1
48728,året,0,0,1,1
35364,வைக்கிறது,0,0,1,1
33765,دون,0,0,1,1
52407,ഗുജറാത്തി,0,0,1,1
35363,spiegel,0,0,1,1
35362,películas,0,0,1,1
35361,discrepancy,0,0,1,1
33766,alto،,0,0,1,1
50439,மூவரும்,0,0,1,1
48736,الأوائل,0,0,1,1
35344,"
गुजराती",0,0,1,1
35332,kone,0,0,1,1
48745,muertas,0,0,1,1
49631,altı,0,0,1,1
33781,kalt,0,0,1,1
48746,derseniz,0,0,1,1
50234,حزن,0,0,1,1
35329,croissante,0,0,1,1
49629,vogels,0,0,1,1
48747,प्रिंट,0,0,1,1
48748,işte,0,0,1,1
35327,ஓடினாள்,0,0,1,1
52411,ಪಾದಗಳನ್ನು,0,0,1,1
35325,αντέξτε,0,0,1,1
48749,المميزات,0,0,1,1
35323,ಸುಂದರರು,0,0,1,1
48750,معنى,0,0,1,1
35322,حق,0,0,1,1
48751,aplicáveis,0,0,1,1
48752,യാത്രയ്ക്കിടയിലോ,0,0,1,1
35320,колберт,0,0,1,1
48744,friedrich,0,0,1,1
35333,bought,0,0,1,1
49634,herinneren,0,0,1,1
50433,сердится,0,0,1,1
50437,esboços,0,0,1,1
35342,humanlike,0,0,1,1
52408,notskrift,0,0,1,1
35340,очереди,0,0,1,1
48737,الكلمة؟,0,0,1,1
48738,особо,0,0,1,1
33776,nämn,0,0,1,1
50436,identificados,0,0,1,1
33777,wesen,0,0,1,1
48740,referencias,0,0,1,1
52409,يصف,0,0,1,1
33778,ವಿಭಾಗದಲ್ಲಿ,0,0,1,1
33779,такое,0,0,1,1
48742,ämnesområden,0,0,1,1
50435,«история»,0,0,1,1
35336,وسلبيًا,0,0,1,1
33780,formuleerde,0,0,1,1
50233,honderden,0,0,1,1
35334,användarnamn,0,0,1,1
35373,projelerinde,0,0,1,1
48721,குழந்தை,0,0,1,1
35426,आश्चर्यचकित,0,0,1,1
33748,slak,0,0,1,1
35413,användarens,0,0,1,1
50446,പഞ്ചാബി,0,0,1,1
35412,ficticio,0,0,1,1
35410,accusant,0,0,1,1
48704,персоналом,0,0,1,1
33746,запутаться,0,0,1,1
48705,multidisciplinært,0,0,1,1
35407,السابقة,0,0,1,1
49647,عقولنا,0,0,1,1
48706,ألتو,0,0,1,1
35374,സ്രോതസ്സിന്റെ,0,0,1,1
52399,inovação,0,0,1,1
35406,السائح,0,0,1,1
35405,रूचि,0,0,1,1
50445,geliebt,0,0,1,1
52400,adecuada,0,0,1,1
35403,resimler,0,0,1,1
35402,remnants,0,0,1,1
33749,directivos,0,0,1,1
33750,сотрудничеству,0,0,1,1
35414,региональных,0,0,1,1
33745,ansætte,0,0,1,1
35415,alemana,0,0,1,1
35416,realizou,0,0,1,1
33737,« livres »,0,0,1,1
33738,सी,0,0,1,1
48698,faktamässigt,0,0,1,1
48699,الـ,0,0,1,1
33739,правильнее,0,0,1,1
35424,ejemplo—,0,0,1,1
33740,അഭിനന്ദനങ്ങൾ,0,0,1,1
35423,बतलाता,0,0,1,1
35422,മന്ദഗതിയിലാക്കുന്നു,0,0,1,1
35421,ವಿನಮ್ರ,0,0,1,1
48700,sujeitas,0,0,1,1
33741,seeds,0,0,1,1
33742,protège,0,0,1,1
35420,просит,0,0,1,1
33743,"
cantonês",0,0,1,1
33744,días,0,0,1,1
35419,мясо,0,0,1,1
35418,nachdenken,0,0,1,1
48703,рендеринг,0,0,1,1
50228,магнусом,0,0,1,1
52401,большую,0,0,1,1
49644,помогает,0,0,1,1
35386,ba •,0,0,1,1
33755,helado,0,0,1,1
49642,abrange,0,0,1,1
33757,സ്വതന്ത്രമല്ലാത്ത,0,0,1,1
50229,μιλήσετε,0,0,1,1
35384,wikitekniken,0,0,1,1
35383,படையினருக்கான,0,0,1,1
33758,concepteurs,0,0,1,1
35382,volverse,0,0,1,1
35381,complementary,0,0,1,1
33759,قريبًا,0,0,1,1
48718,analyseras,0,0,1,1
35379,“poor,0,0,1,1
48720,முயற்சித்தது,0,0,1,1
35378,«usuarios»,0,0,1,1
49639,sensacional,0,0,1,1
52405,brandväggen,0,0,1,1
33761,ಕ್ಷಮೆಯಾಚಿಸುತ್ತಿದೆ,0,0,1,1
35376,çalışmayı,0,0,1,1
35375,leverde,0,0,1,1
52404,soumise,0,0,1,1
35387,മിശ്രശബ്ദമാണ്,0,0,1,1
33752,എന്തെങ്കിലുമൊക്കെ,0,0,1,1
48715,लोड,0,0,1,1
48708,مفتوحاً,0,0,1,1
52649,besøgende,0,0,1,1
49643,rasgos,0,0,1,1
35398,gungar,0,0,1,1
35397,ಸಂದರ್ಶನವೊಂದರಲ್ಲಿ,0,0,1,1
48710,plagiarism,0,0,1,1
35396,тонуть,0,0,1,1
50444,general—,0,0,1,1
35395,വിക്കിപീഡിയരായി,0,0,1,1
35394,മുങ്ങാം,0,0,1,1
35393,instalado,0,0,1,1
48711,അഭിനയിക്കുന്നവരാരെല്ലാം,0,0,1,1
52647,förfrågningar,0,0,1,1
35391,ஹலோ,0,0,1,1
35390,ieee,0,0,1,1
48713,تركت,0,0,1,1
48714,soutenue,0,0,1,1
35389,ശരിയാണ്,0,0,1,1
35388,ഇബ്സൻ,0,0,1,1
35843,allezvous,0,0,1,1
43287,starrten,0,0,1,1
47314,ومفيدة,0,0,1,1
51490,adn ,0,0,1,1
41367,wikipedian,0,0,1,1
44563,раза,0,0,1,1
41366,prétendants,0,0,1,1
44564,renvoyé,0,0,1,1
44565,сотрудничество,0,0,1,1
41365,"
लातिन",0,0,1,1
51498,souris,0,0,1,1
41364,المقابلة,0,0,1,1
41363,listor,0,0,1,1
51499,മാതൃകാ,0,0,1,1
44569,endorheic,0,0,1,1
51048,неделю —,0,0,1,1
41360,searches,0,0,1,1
44571,विर्गील,0,0,1,1
44572,успешно,0,0,1,1
41357,கேள்விகளால்,0,0,1,1
44573,увеличения,0,0,1,1
51500,cryptologue,0,0,1,1
44574,தொலைதூரத்தில்,0,0,1,1
44575,syntaxiques,0,0,1,1
41354,semelhanças,0,0,1,1
41353,ആഴ്ചകളോ,0,0,1,1
44576,feest,0,0,1,1
44577,sistêmicos,0,0,1,1
44578,sürdürmelerini,0,0,1,1
44562,दिखायी,0,0,1,1
41368,stanfordbased,0,0,1,1
41369,πολύπλοκος,0,0,1,1
44556,يقوله,0,0,1,1
44553,şirketi,0,0,1,1
41383,damen,0,0,1,1
41382,« réconciliation »,0,0,1,1
44554,kahraman,0,0,1,1
41381,الكسل,0,0,1,1
44555,pedagogiskt,0,0,1,1
51491,corrigen,0,0,1,1
41380,submeterse,0,0,1,1
41379,répétition,0,0,1,1
51493,അഭിപ്രായങ്ങൾ,0,0,1,1
41378,skewed,0,0,1,1
41377,ನಾರ್ಸಿಸಾಳನ್ನು,0,0,1,1
51497,chanceux,0,0,1,1
44557,klokkeikonet,0,0,1,1
51495,önümüzdeki,0,0,1,1
41376,महाकाव्य,0,0,1,1
41375,eric,0,0,1,1
44558,nine,0,0,1,1
41373,üretilen,0,0,1,1
44561,തിരയുന്നുവെങ്കിൽ,0,0,1,1
51496,comemora,0,0,1,1
41372,hænger,0,0,1,1
41371,ستعجبك,0,0,1,1
41370,institutionnalisation,0,0,1,1
41351,пополнит,0,0,1,1
41350,खाने,0,0,1,1
44581,कोटेशन्स,0,0,1,1
41310,கீழாகவும்,0,0,1,1
51044,ತೆಗೆದುಕೊಂಡನು,0,0,1,1
51043,reward,0,0,1,1
41319,الدروس,0,0,1,1
41318,incapacidade,0,0,1,1
51042,egoistische,0,0,1,1
44597,toulouse,0,0,1,1
41315,भूलें।,0,0,1,1
44600,votou,0,0,1,1
41314,unabated,0,0,1,1
41312,പാടുപെട്ട,0,0,1,1
41311,fortytwo,0,0,1,1
41309,segundos,0,0,1,1
44594,deslocar,0,0,1,1
41308,acordei,0,0,1,1
44602,«wikileaks»​,0,0,1,1
41307,प्लेट,0,0,1,1
41305,"
georgiano",0,0,1,1
41304,आइए,0,0,1,1
44604,aplicálas,0,0,1,1
41303,likelihood,0,0,1,1
41302,wakker,0,0,1,1
41300,schätzen,0,0,1,1
44605,കിടക്ക,0,0,1,1
41298,deciden,0,0,1,1
51504,وذهبا,0,0,1,1
51045,മാറ്റുക,0,0,1,1
44582,aanstelling,0,0,1,1
51501,radiostation,0,0,1,1
44583,såvitt,0,0,1,1
41347,kızdırdım,0,0,1,1
41346,erop,0,0,1,1
51046,suponga,0,0,1,1
41345,внешнему,0,0,1,1
41344,मिशन,0,0,1,1
44585,திருத்தங்களைக்,0,0,1,1
44586,للبرنامج,0,0,1,1
41342,роб,0,0,1,1
41341,للمعرفة,0,0,1,1
44589,διστάζω,0,0,1,1
41340,engelskspråkig,0,0,1,1
44592,risitas,0,0,1,1
41339,ಮಾಡಿದ್ದರೆ,0,0,1,1
41337,கலாச்சார,0,0,1,1
41335,"
ऑकिटन",0,0,1,1
41334,fixés,0,0,1,1
51502,køre,0,0,1,1
41331,ائتمانًا,0,0,1,1
41330,достоверности,0,0,1,1
41329,internetgemenskap,0,0,1,1
41328,मीडियन,0,0,1,1
41327,inskränkningar,0,0,1,1
41326,மூல,0,0,1,1
44552,போரின்போது,0,0,1,1
51489,changea,0,0,1,1
41102,ağlamak,0,0,1,1
41386,rösttonen,0,0,1,1
41448,comprovação,0,0,1,1
41447,смеяться,0,0,1,1
41446,participative »,0,0,1,1
44524,ಬೈಟ್,0,0,1,1
41445,"
हक्का",0,0,1,1
41444,finish,0,0,1,1
44525,onderzoeksveld,0,0,1,1
41443,एनसायक्लोपीडिया,0,0,1,1
41442,യന്ത്രപഠനത്തിൽ,0,0,1,1
41441,сбитых,0,0,1,1
44526,reparação,0,0,1,1
41440,væsener,0,0,1,1
41439,wikipédianota,0,0,1,1
41438,கட்டுரை,0,0,1,1
41437,பெயரில்,0,0,1,1
41436,इंतजार,0,0,1,1
41435,உதவிக்கு,0,0,1,1
41434,değiştirmesini,0,0,1,1
41433,αγόρασαν,0,0,1,1
44528,വിക്കിഎഴുതുന്നതെല്ലാം,0,0,1,1
41432,sølv,0,0,1,1
51477,novio,0,0,1,1
41431,घिरे,0,0,1,1
44529,ഗുണനിലവാരം,0,0,1,1
41427,inéluctablement,0,0,1,1
41449,sustainable,0,0,1,1
44522,слизняк,0,0,1,1
44521,धीमी,0,0,1,1
41462,nogmaals,0,0,1,1
41474,lenteur,0,0,1,1
44511,bible,0,0,1,1
41472,ശൈലി,0,0,1,1
41471, ˌwɪkɨˈpiːdiə,0,0,1,1
44512,बनाता,0,0,1,1
41469,sources ,0,0,1,1
41467,ಉದಾಹರಣೆಯೆಂದರೆ,0,0,1,1
44513,κρεβάτι,0,0,1,1
41465,vinkede,0,0,1,1
41464,நேரத்திலும்,0,0,1,1
41463,മേഖലയെ,0,0,1,1
41461,neither,0,0,1,1
41452,korrelerat,0,0,1,1
41460,وارد,0,0,1,1
41459,сообщается,0,0,1,1
44516,നോക്കാറുണ്ട്,0,0,1,1
44517,sparqlen,0,0,1,1
44518,déterminations,0,0,1,1
44519,sr •,0,0,1,1
41456,bakken,0,0,1,1
41455,يُعرف,0,0,1,1
44520,استراتيجية,0,0,1,1
41454,satirizou,0,0,1,1
41453,ريتشارد,0,0,1,1
41426,listelerine,0,0,1,1
41425,மாண்டி’,0,0,1,1
51478,करूँगा,0,0,1,1
44548,devant,0,0,1,1
41402,учтиво,0,0,1,1
41401,extralimitan,0,0,1,1
44543,данное,0,0,1,1
41400,ലക്ഷക്കണക്കിന്,0,0,1,1
51485,மூழ்கடிப்பது,0,0,1,1
44544,garantizar,0,0,1,1
41399,günden,0,0,1,1
51486,الصعب,0,0,1,1
41397,harmonie,0,0,1,1
51050,സ്ക്കൂൾ,0,0,1,1
44546,annoncée,0,0,1,1
41395,ηχείου,0,0,1,1
41404,recreate,0,0,1,1
41394,«администратора»,0,0,1,1
41393,السادس,0,0,1,1
41392,interdisciplinary,0,0,1,1
44549,கண்டறிந்ததோடு,0,0,1,1
41391,exhibiting,0,0,1,1
41390,corée,0,0,1,1
44550,kişilerden,0,0,1,1
51049,visites,0,0,1,1
41388,reputado,0,0,1,1
51487,tegenovergestelde,0,0,1,1
44551,solicitud,0,0,1,1
44542,старые,0,0,1,1
41405,பார்ப்பது,0,0,1,1
41424,behandles,0,0,1,1
41416,أفادت,0,0,1,1
44531,hiperligações,0,0,1,1
44533,википедияудализм,0,0,1,1
41422,подобная,0,0,1,1
41421,jours »,0,0,1,1
41420,വായനക്കാരുടേയും,0,0,1,1
44535,próximas,0,0,1,1
44536,स्तब्ध,0,0,1,1
51482,tøver,0,0,1,1
41419,पदोन्नति,0,0,1,1
41418,courbes,0,0,1,1
41417,fotos,0,0,1,1
41415,редакционную,0,0,1,1
41406,പഠന,0,0,1,1
44538,photographie,0,0,1,1
41414,permise,0,0,1,1
44539,отдельные,0,0,1,1
41412,ಮುಸುಕಿನ,0,0,1,1
41411,expanding,0,0,1,1
41410,அர்த்தமாகும்,0,0,1,1
41409,mcculloch,0,0,1,1
44540,trage,0,0,1,1
41408,आरम्भ,0,0,1,1
41407,κύρια,0,0,1,1
51051,സമൂഹമാണ്,0,0,1,1
44607,ശ്രദ്ധിക്കുന്നവർ,0,0,1,1
44608,«sensibles»,0,0,1,1
41295,målgruppe,0,0,1,1
41294,ettiler,0,0,1,1
51030,വിവര,0,0,1,1
44682,unglück,0,0,1,1
44683,പരിശീലിപ്പിക്കാൻ,0,0,1,1
41163,ночь,0,0,1,1
41162,دراسات,0,0,1,1
41161,क्रोकर,0,0,1,1
41160,juges,0,0,1,1
44685,interrogación,0,0,1,1
41157,officiellt,0,0,1,1
41156,озаглавленная,0,0,1,1
51029,mueves,0,0,1,1
44690,स्कोलरपीडिया,0,0,1,1
41155,ദേഷ്യമാണ്,0,0,1,1
41154,master,0,0,1,1
41153,ಅಭಿಪ್ರಾಯವೇನು,0,0,1,1
41152,വ്യാകരണം,0,0,1,1
41151,caracterización,0,0,1,1
41150,комто,0,0,1,1
44692,eye,0,0,1,1
44694,पार्टी,0,0,1,1
51028,contrer,0,0,1,1
41148,ವೈಫಲ್ಯಗಳ,0,0,1,1
41147,файлы,0,0,1,1
41146,iron,0,0,1,1
44696,gagner,0,0,1,1
51513,periodismo,0,0,1,1
51512,concluye,0,0,1,1
44681,высшим,0,0,1,1
41182,disfavor,0,0,1,1
51510,knapphändigt,0,0,1,1
44669,ಫಿಕ್ಸ್,0,0,1,1
51511,vertegenwoordigers,0,0,1,1
44670,predicted,0,0,1,1
41189,foregik,0,0,1,1
41188,demokrater,0,0,1,1
41187,तय,0,0,1,1
41186,தொழில்நுட்பத்தை,0,0,1,1
44673,नवंबर,0,0,1,1
41184,reemplazado,0,0,1,1
41183,американский,0,0,1,1
41181,புழுக்கமாகப்,0,0,1,1
41168,निगमों,0,0,1,1
41180,ontsluiten,0,0,1,1
41179,inhuren,0,0,1,1
41178,गैरविकिपीडिया,0,0,1,1
41177,إِلى,0,0,1,1
44674,காண்பீர்கள்,0,0,1,1
41175,mutsuz,0,0,1,1
44676,ಖಂಡಿತವಾಗಿಯೂ,0,0,1,1
41172,estonien,0,0,1,1
41171,suscité,0,0,1,1
51031,находящейся,0,0,1,1
44679,निरंतर,0,0,1,1
44697,власти,0,0,1,1
44698,décompté,0,0,1,1
41144,vas,0,0,1,1
41115,избранных,0,0,1,1
44714,असंभव,0,0,1,1
41124,मेक्रो,0,0,1,1
41123,എല്ലാംതന്നെ,0,0,1,1
41122,साक्षात्कारों,0,0,1,1
44715,logique ,0,0,1,1
41120,телефону,0,0,1,1
41119,organizadas,0,0,1,1
41118,ದೊಡ್ಡದಾದ,0,0,1,1
44717,hususlar,0,0,1,1
41117,ಗದ್ದೆ,0,0,1,1
41116,fann,0,0,1,1
44718,oudengels,0,0,1,1
51026,കൂടാതെ,0,0,1,1
41112,verklaring,0,0,1,1
44719,μεγάλη,0,0,1,1
41111,racional,0,0,1,1
44720,maravilhoso,0,0,1,1
44721,endehors,0,0,1,1
44722,prettiest,0,0,1,1
51025,bedenker,0,0,1,1
41107,bulacağınız,0,0,1,1
41106,preconceitos,0,0,1,1
41105,remarquez,0,0,1,1
44723,uzbekistan,0,0,1,1
44713,handlede,0,0,1,1
41125,توم,0,0,1,1
44701,gegenteil,0,0,1,1
41135,ocasionais,0,0,1,1
41142,hävdar,0,0,1,1
44703,contenait,0,0,1,1
41141,åldersgruppen,0,0,1,1
41140,geldiğinizi,0,0,1,1
51514,ಧರಿಸಿದ್ದರು,0,0,1,1
44705,пределах,0,0,1,1
44706,depicted,0,0,1,1
51515,важными,0,0,1,1
44708,கொண்டிருந்தாலும்,0,0,1,1
41136,tallerken,0,0,1,1
44709,പ്രവർത്തനത്തിലൂടെ,0,0,1,1
51516,fylld,0,0,1,1
44712,सांस,0,0,1,1
41134,högre,0,0,1,1
44710,klikken,0,0,1,1
41133,wichtig,0,0,1,1
41132,пометка,0,0,1,1
51517,sends,0,0,1,1
41130,entities,0,0,1,1
41129,basen,0,0,1,1
41128,contribuído,0,0,1,1
41127,i̇skeletor,0,0,1,1
44711,ನೀಡಿ,0,0,1,1
51518,salate,0,0,1,1
41192,விளக்கும்,0,0,1,1
41193,расскажет,0,0,1,1
44667,zugeritten,0,0,1,1
41256,waters,0,0,1,1
41267,डिग,0,0,1,1
41266,ungenießbar,0,0,1,1
41265,viveria,0,0,1,1
41264,добавление,0,0,1,1
51039,problematisera,0,0,1,1
41262,énergisante,0,0,1,1
44623,beland,0,0,1,1
44624,управление,0,0,1,1
41259,പദ്ധതിക്ക്,0,0,1,1
41258,لطيف,0,0,1,1
41257,roda,0,0,1,1
41255,கண்டறியப்பட்டது,0,0,1,1
41269,моём,0,0,1,1
41254,kvinna,0,0,1,1
41253,« notes,0,0,1,1
44625,punhado,0,0,1,1
44626,लाइक,0,0,1,1
41251,സാധ്യമാക്കുന്ന,0,0,1,1
41248,atacadas,0,0,1,1
41247,அறிவிக்கப்பட்டது,0,0,1,1
41246,ಕೊಡುವಷ್ಟು,0,0,1,1
44630,stresses,0,0,1,1
44631,कराते,0,0,1,1
41243,principen,0,0,1,1
44620,விவரிக்கப்,0,0,1,1
41270,eksamen,0,0,1,1
44633,sinkt,0,0,1,1
44613,heliopause,0,0,1,1
44609,।,0,0,1,1
41293,móviles,0,0,1,1
44610,uitwezen,0,0,1,1
41291,anpassas,0,0,1,1
41290,वक्ताओं,0,0,1,1
41289,போவதே,0,0,1,1
41288,repetición,0,0,1,1
41287,abraçar,0,0,1,1
41286,கொள்கையாக,0,0,1,1
41285,consisting,0,0,1,1
44612,крайних,0,0,1,1
51040,gebaseerd,0,0,1,1
41271,permit,0,0,1,1
44615,compromises,0,0,1,1
41280,neutraal,0,0,1,1
41279,சுதந்திரமாக,0,0,1,1
41278,मुहावरा,0,0,1,1
41277,விளங்கிய,0,0,1,1
41276,обозначен,0,0,1,1
44616,obtenida,0,0,1,1
44617,toetsing,0,0,1,1
44618,deberían,0,0,1,1
41273,gouvernance,0,0,1,1
44619,dettaförtydliga,0,0,1,1
44632,lasst,0,0,1,1
44634,матч,0,0,1,1
41195,glockensymbol,0,0,1,1
41206,directmedia,0,0,1,1
51034,الطبي,0,0,1,1
44653,garantizan,0,0,1,1
44654,फैसले,0,0,1,1
41214,спроса,0,0,1,1
41213,понятия,0,0,1,1
41212,βάλτου,0,0,1,1
44655,articulation,0,0,1,1
41210,endişelenmeyin,0,0,1,1
41209,forbid,0,0,1,1
51508,ಫಿಕ್ಸ್‌ನ,0,0,1,1
41207,கொண்டு,0,0,1,1
44656,i̇çeriğinin,0,0,1,1
41216,gebräuchliche,0,0,1,1
41204,bissen,0,0,1,1
44658,varken,0,0,1,1
41202,telefones,0,0,1,1
41201,"
लिंगला",0,0,1,1
41200,majorité,0,0,1,1
41199,unuturlar,0,0,1,1
44661,المربيات,0,0,1,1
41197,коннотацией,0,0,1,1
44664,interrupt,0,0,1,1
41196,ಗಂಟೆ,0,0,1,1
44665,​​opmerking,0,0,1,1
41215,bell,0,0,1,1
51035,தேடலில்,0,0,1,1
44635,അടുത്തത്‌,0,0,1,1
41229,ഗ്നൂ,0,0,1,1
41241,différence,0,0,1,1
44637,consultam,0,0,1,1
41238,चलाया,0,0,1,1
41236,نارسيسا,0,0,1,1
51507,ആദ്യവർഷത്തിൽ,0,0,1,1
41234,dyr,0,0,1,1
41233,वैज्ञानिक,0,0,1,1
51037,kodeord,0,0,1,1
44640,wwe,0,0,1,1
41232,ജീവിതവും,0,0,1,1
44642,நிராகரித்தாள்,0,0,1,1
44645,« dieu,0,0,1,1
51036,houden,0,0,1,1
41227,μόνιμα,0,0,1,1
41226,habitude,0,0,1,1
41225,ശരിയാക്കുന്നു,0,0,1,1
41224,biodiversity,0,0,1,1
41223,geçip,0,0,1,1
44646,yiyeceğe,0,0,1,1
41221,sete,0,0,1,1
41220,لموقع,0,0,1,1
44648,മനുഷ്യനും,0,0,1,1
44649,उदासीन,0,0,1,1
44650,بنصيب,0,0,1,1
41475,تلو,0,0,1,1
41476,resimlerin,0,0,1,1
41478,«какая,0,0,1,1
41655,chiffrement,0,0,1,1
41716,ಕಾರ್ಯನಿರತರಾಗಿರಬಹುದು,0,0,1,1
44354,referenssystem,0,0,1,1
41715,സംഭാഷണമാണ്,0,0,1,1
44355,சலவை,0,0,1,1
44356,оскорбительными,0,0,1,1
41712,encyklopedin,0,0,1,1
41710,قوانين,0,0,1,1
41709,встретить,0,0,1,1
41708,vrijers,0,0,1,1
44358,அதிகாரத்,0,0,1,1
41707,denoting,0,0,1,1
41706,inzamelen,0,0,1,1
41705,بأدوار,0,0,1,1
41704,"
माओरी",0,0,1,1
44359,breaks”,0,0,1,1
44360,triffst,0,0,1,1
41702,கவலைப்பட்டார்,0,0,1,1
44361,ബാൽക്കണിയിൽ,0,0,1,1
41700,பார்ப்போம்,0,0,1,1
41699,допустим,0,0,1,1
44362,انتقد,0,0,1,1
41697,punt,0,0,1,1
44363,четвёртым,0,0,1,1
51083,व्यंग्य,0,0,1,1
41695,ചെയ്യാനോ,0,0,1,1
41718,noktadayım,0,0,1,1
41720,ಸ್ನೇಹಿತರೆಲ್ಲರೂ,0,0,1,1
44351,invalidated,0,0,1,1
41729,ಕಲಿಕೆಯನ್ನು,0,0,1,1
41741,tirasse,0,0,1,1
41737,reparere,0,0,1,1
41736,européens,0,0,1,1
51441,формул,0,0,1,1
41733,matière « chaque,0,0,1,1
44333,अकाउंट,0,0,1,1
44335,bulunabilmesi,0,0,1,1
41732,прилагающейся,0,0,1,1
41731,solutions,0,0,1,1
44336,भूलें,0,0,1,1
44338,désignait,0,0,1,1
41728,нахожусь,0,0,1,1
41721,пользователя,0,0,1,1
44339,resurser,0,0,1,1
44342,ξεκίνησε,0,0,1,1
41726,matemáticos,0,0,1,1
41725,difíciles,0,0,1,1
44343,पैरों,0,0,1,1
44344,sunulmasındaki,0,0,1,1
44345,desacordos,0,0,1,1
44348,ಬಹಳಷ್ಟು,0,0,1,1
41723,बिन्दु,0,0,1,1
44350,genstand,0,0,1,1
41722,épisode,0,0,1,1
44365,മികച്ചതുമാണ്,0,0,1,1
41692,زيارات,0,0,1,1
41691,confina,0,0,1,1
41660,inscrits,0,0,1,1
44382,conclusion,0,0,1,1
51079,tristeza,0,0,1,1
44385,sonsuza,0,0,1,1
51078,duymuşsunuzdur,0,0,1,1
41664,kaliforniya,0,0,1,1
44386,ஆகியவையும்,0,0,1,1
44387,ودعوا,0,0,1,1
51447,തീരുമാനമാണ്,0,0,1,1
41662,cooled,0,0,1,1
41661,çeken,0,0,1,1
44389,सीख,0,0,1,1
51448,voie,0,0,1,1
41666,ötesinde,0,0,1,1
41659,лайк,0,0,1,1
44390,கவனிக்க,0,0,1,1
44392,போதிய,0,0,1,1
51077,बनाना,0,0,1,1
44393,وأعلن,0,0,1,1
44394,πιστεύετε,0,0,1,1
41658,udtalen,0,0,1,1
51449,yüce,0,0,1,1
41657,чикаго,0,0,1,1
51450,julgamento,0,0,1,1
44396,strunta,0,0,1,1
44380,എന്താണെന്ന,0,0,1,1
44378,coding,0,0,1,1
41690,controlled,0,0,1,1
44373,مؤتمر,0,0,1,1
44366,trasfondo,0,0,1,1
41688,ಹಾಡುಗಳಲ್ಲಿ,0,0,1,1
44367,totais,0,0,1,1
51082,பகுதியை,0,0,1,1
41686,comprobase,0,0,1,1
44370,ಅವರನ್ನು,0,0,1,1
41685,seneste,0,0,1,1
44371,pipa,0,0,1,1
44372,acarrearía,0,0,1,1
41682,കുറിക്കാൻ,0,0,1,1
51445,veuillez,0,0,1,1
41680,convergent,0,0,1,1
41668,cyberspace,0,0,1,1
41678,ಬೇರೇನಾದರೂ,0,0,1,1
41677,അവയുടെ,0,0,1,1
44374,"
crioulo",0,0,1,1
41674,ಇದ್ದಕ್ಕಿದ್ದಂತೆ,0,0,1,1
41673,popularidad—,0,0,1,1
44375,"है।
हालाँकि",0,0,1,1
41672,accéder,0,0,1,1
51080,समीक्षाओं,0,0,1,1
44376,habitual,0,0,1,1
51446,प्रचार,0,0,1,1
44377,கடவுச்சொல்லை,0,0,1,1
41742,sorters,0,0,1,1
44332,yazı,0,0,1,1
41745,ಮಾಡಿಲ್ಲ,0,0,1,1
44289,содержала,0,0,1,1
41812,विख्याति,0,0,1,1
41810,toets,0,0,1,1
44279,ηχείο,0,0,1,1
44280,vur,0,0,1,1
44282,покупать,0,0,1,1
51094,pressionou,0,0,1,1
41806,أغسطس،,0,0,1,1
41805,കേരളത്തിലുള്ളവർക്ക്,0,0,1,1
41802,ηρεμήσεις,0,0,1,1
41801,отрицательное,0,0,1,1
44288,kaynaklarıyla,0,0,1,1
41799,kir,0,0,1,1
41813,பங்களிப்பின்,0,0,1,1
41798,объяснениях,0,0,1,1
41797,വസ്ത്രങ്ങൾ,0,0,1,1
41796,umursamıyordu,0,0,1,1
41795,цитируется,0,0,1,1
41794,ಘಟನೆಗಳು,0,0,1,1
44291,установлено,0,0,1,1
41793,அடிப்படையில்,0,0,1,1
41792,besökares,0,0,1,1
44293,сидят,0,0,1,1
41790,fakir,0,0,1,1
41789,uitgehongerd,0,0,1,1
44277,सेल,0,0,1,1
41815,прямую,0,0,1,1
41786,greetings,0,0,1,1
44267,it’s,0,0,1,1
44256,للتحرير،,0,0,1,1
41836,sales,0,0,1,1
44257,वस्तुओं,0,0,1,1
44259,niveles,0,0,1,1
44260,spegeln,0,0,1,1
44262,года — »,0,0,1,1
44263,stieg,0,0,1,1
51098,இருக்கிறாள்,0,0,1,1
41832,தெரிந்தால்,0,0,1,1
41831,grootte,0,0,1,1
41830,volvió,0,0,1,1
41828,agents,0,0,1,1
41817,പോകുമെന്ന്,0,0,1,1
51435,desistindo,0,0,1,1
41827,metadata,0,0,1,1
44268,കീഴിൽ,0,0,1,1
44269,massivement,0,0,1,1
44270,presumiblemente,0,0,1,1
41821,namnrymder,0,0,1,1
41820,قناة,0,0,1,1
44272,fantaisistes,0,0,1,1
41818,gene,0,0,1,1
44273,низкокачественные,0,0,1,1
51096,argumentée,0,0,1,1
41787,المشكلة,0,0,1,1
41785,стандартном,0,0,1,1
44331,casualidad,0,0,1,1
44319,slecht,0,0,1,1
50113,أمرا,0,0,1,1
44311,باستنتاج,0,0,1,1
51438,лучших,0,0,1,1
44312,gibiler,0,0,1,1
51090,ತಪ್ಪಾದ,0,0,1,1
44313,imagen—,0,0,1,1
44314,localizados,0,0,1,1
41756,oiseaux,0,0,1,1
44315,takes,0,0,1,1
41755,യാത്ര,0,0,1,1
51089,നാണ്‌,0,0,1,1
41753,hoge,0,0,1,1
41762,தாயும்,0,0,1,1
44322,stage,0,0,1,1
51087,സുന്ദരിയായിരുന്നതിനാൽ,0,0,1,1
41750,അതുകൊണ്ട്‌,0,0,1,1
41749,atribuyen,0,0,1,1
44323,västerländska,0,0,1,1
44324,قولها,0,0,1,1
44325,harsh,0,0,1,1
41748,substantivo,0,0,1,1
44326,existía,0,0,1,1
44328,ακούστε,0,0,1,1
44330,തടയേണ്ട,0,0,1,1
44310,kilometers,0,0,1,1
41763,численных,0,0,1,1
44296,физиком,0,0,1,1
41776,карьере»,0,0,1,1
41784,robôs,0,0,1,1
41783,jobbet,0,0,1,1
41782,правка,0,0,1,1
44298,வியக்க,0,0,1,1
44300,गंभीरता,0,0,1,1
41781,ദക്ഷതയോടെ,0,0,1,1
41780,besorgt,0,0,1,1
51093,kafayı,0,0,1,1
41779,profiel,0,0,1,1
41778,الملكية,0,0,1,1
44302,"
हम",0,0,1,1
44303,forberedt,0,0,1,1
41764,ಖಚಿತವಾಗಿದೆಯೇ,0,0,1,1
41774,جعلتها,0,0,1,1
44304,vermelho,0,0,1,1
51092,കാര്യനിർവ്വാഹകരുടെ,0,0,1,1
41771,abrió,0,0,1,1
44306,رجل,0,0,1,1
44307,قرية,0,0,1,1
44308,الأمور,0,0,1,1
51091,παρουσίαση,0,0,1,1
44309,оптических,0,0,1,1
41766,ಶಬ್ದವನ್ನು,0,0,1,1
41765,permitida,0,0,1,1
51075,oğlum,0,0,1,1
51452,الواضح,0,0,1,1
44510,ülkenin,0,0,1,1
41652,acrescentando,0,0,1,1
44463,haklarında,0,0,1,1
44466,питтсбургского,0,0,1,1
44467,கீழேயுள்ள,0,0,1,1
41545,weggestuurd,0,0,1,1
41544,confusos,0,0,1,1
41543,consorcio,0,0,1,1
41542,«обсуждение»,0,0,1,1
51469,ಕೆಳಗಿನ,0,0,1,1
41540,má,0,0,1,1
41539,ഉദാഹരണങ്ങളിലെ,0,0,1,1
51063,какихто,0,0,1,1
41537,prendstoi,0,0,1,1
41536,поверить,0,0,1,1
41535,consciemment,0,0,1,1
41534,ಬಡ್ತಿ,0,0,1,1
41532,ಸಿದ್ಧರಿದ್ದೀರಿ,0,0,1,1
41531,പൂർവ്വസ്ഥിതിയിലെത്തുവാൻ,0,0,1,1
41530,mottaglig,0,0,1,1
41529,generality,0,0,1,1
41528,individu,0,0,1,1
44473,பதிவுசெய்த,0,0,1,1
41526,woordenschat,0,0,1,1
44474,konuşmayı,0,0,1,1
41525,വ്യക്തിപരമായി,0,0,1,1
44478,അസ്വസ്ഥനാണ്,0,0,1,1
51468,ഭാവിയിലെ,0,0,1,1
41550,ಅರ್ಥಮಾಡಿಕೊಳ್ಳಲು,0,0,1,1
41551,boğuşuyorum,0,0,1,1
41561,graça,0,0,1,1
44449,தளங்களுக்கான,0,0,1,1
41571,تزايد,0,0,1,1
44450,« ville,0,0,1,1
41569,oradaki,0,0,1,1
41568,pressas,0,0,1,1
44451,δάγκωμα,0,0,1,1
41565,tituló,0,0,1,1
41564,lingüísticas,0,0,1,1
44453,فعلت,0,0,1,1
41563,paradoxalement,0,0,1,1
41562,confirmer,0,0,1,1
41560,происходило,0,0,1,1
41552,ദീർഘനാളായി,0,0,1,1
41559,«седьмой,0,0,1,1
44454,وسعد,0,0,1,1
41558,κήπο,0,0,1,1
44455,பஸ்,0,0,1,1
44456,വിചാരിച്ചു,0,0,1,1
51064,ಹಿಸಿದ್ದೇನೆ,0,0,1,1
44459,précision,0,0,1,1
41556,återanvändas,0,0,1,1
44460,wortnummer,0,0,1,1
41555,afripédia,0,0,1,1
41554,redistribution,0,0,1,1
44479,reunir,0,0,1,1
41523,spacecraft,0,0,1,1
41522,salater,0,0,1,1
41490,வழக்கமான,0,0,1,1
41501,lecun,0,0,1,1
51059,quisieras,0,0,1,1
51056,മന്ദഗതിയിലാകുന്നു,0,0,1,1
41498,sammeln,0,0,1,1
41497,zor,0,0,1,1
41496,afkomstig,0,0,1,1
44495,дышать,0,0,1,1
41495,kısmının,0,0,1,1
41494,narsisizm,0,0,1,1
41493,தொலைபேசியை,0,0,1,1
41492,अपेक्षाकृत,0,0,1,1
44502,डूबने,0,0,1,1
41503,dificuldade,0,0,1,1
41487,картофеля,0,0,1,1
41486,источниками,0,0,1,1
44505,мае,0,0,1,1
41485,движение,0,0,1,1
44506,milhares,0,0,1,1
41483,διανομή,0,0,1,1
44508,αναζήτηση,0,0,1,1
44509,студентов,0,0,1,1
41481,авторов,0,0,1,1
41480,άχρηστο,0,0,1,1
51053,البذور,0,0,1,1
44490,soto ,0,0,1,1
41504,ഉറപ്പുവരുത്തുന്നതിന്,0,0,1,1
51061,funnits,0,0,1,1
44482,allgemeinen,0,0,1,1
44480,indrømmer,0,0,1,1
41521,التهجئة،,0,0,1,1
41520,കണ്ടെത്തിയാൽ,0,0,1,1
41519,scorpions—features,0,0,1,1
41518,குறிக்கிறீர்கள்,0,0,1,1
41517,tissues,0,0,1,1
41516,гораздо,0,0,1,1
41515,podrán,0,0,1,1
44481,traced,0,0,1,1
41514,influencé,0,0,1,1
41513,ناطقة,0,0,1,1
41512,утонуть,0,0,1,1
41505,resor,0,0,1,1
51470,prisioneiros,0,0,1,1
44485,βαρύ,0,0,1,1
44486,açısından,0,0,1,1
41510,görmek,0,0,1,1
41509,menina,0,0,1,1
41508,kalırsınız,0,0,1,1
51471,gällande,0,0,1,1
41507,contended,0,0,1,1
41506,പതിവ്,0,0,1,1
51060,подождать,0,0,1,1
44489,ties,0,0,1,1
44448,εξετάσεις,0,0,1,1
41573,ಪ್ರಯತ್ನಿಸುತ್ತಿದೆ,0,0,1,1
44447,соберись,0,0,1,1
41619,ಬಯಸಿದ್ದರು,0,0,1,1
41628,mínima,0,0,1,1
51458,hände,0,0,1,1
41626,entropy,0,0,1,1
44406,സൈനികർക്കായി,0,0,1,1
44408,económicos,0,0,1,1
44409,traditionnelle,0,0,1,1
44410,ನೀರಸವಾಗಿದೆ,0,0,1,1
51073,expertgranskning,0,0,1,1
41622,ലൈക്ക്,0,0,1,1
41621,வேலையைச்,0,0,1,1
41620,toman,0,0,1,1
41618,erfahrung,0,0,1,1
41630,inanimate,0,0,1,1
51460,deli,0,0,1,1
44411,publicaron,0,0,1,1
41617,ವಿರೋಧಾಭಾಸ,0,0,1,1
44413,പ്രവർത്തിക്കുന്നില്ലെങ്കിൽ,0,0,1,1
44416,president,0,0,1,1
41616,எண்ணை,0,0,1,1
41615,ബന്ധത്തെക്കുറിച്ച്,0,0,1,1
44417,internet »,0,0,1,1
41614,oproportionerligt,0,0,1,1
41613,codificación,0,0,1,1
44418,விடய,0,0,1,1
41629,दूसरों,0,0,1,1
41631,istekte,0,0,1,1
44419,लिखें,0,0,1,1
41643,அருமையானவை,0,0,1,1
41651,berörde,0,0,1,1
41650,χρησιμοποιημένη,0,0,1,1
44401,norteamericano,0,0,1,1
41648,приятным,0,0,1,1
44402,olhares,0,0,1,1
41647,gestionar,0,0,1,1
41646,принц,0,0,1,1
41645,interdisciplinar,0,0,1,1
51454,കാലുകൾ,0,0,1,1
41644,yakalayamadım,0,0,1,1
44403,تتحرك,0,0,1,1
51456,cy •,0,0,1,1
41632,ankam,0,0,1,1
41641,buluşmayı,0,0,1,1
41640,войны,0,0,1,1
41639,സംവൃതോകാരത്തിന്റെ,0,0,1,1
51457,admit,0,0,1,1
41637,யோசிக்கிறேன்,0,0,1,1
41636,inaktiv,0,0,1,1
41635,amendment,0,0,1,1
44405,söyleyen,0,0,1,1
41634,artificiels,0,0,1,1
41633,التقليدية,0,0,1,1
51074,prevented,0,0,1,1
41612,சூடாக,0,0,1,1
41611,esclareceu,0,0,1,1
44446,ज़रा,0,0,1,1
41581,approfondie,0,0,1,1
41588,mixed,0,0,1,1
41587,историк,0,0,1,1
44436,ഒപ്റ്റിമൈസേഷൻ,0,0,1,1
41586,ദിനപത്രങ്ങളാണ്,0,0,1,1
41585,സോഫ്റ്റ്,0,0,1,1
41584,appreciation,0,0,1,1
51068,ಕೆಲಸವಿದೆ,0,0,1,1
44437,contraignants,0,0,1,1
44438,ഉച്ചകഴിഞ്ഞ്,0,0,1,1
41582,للبنك,0,0,1,1
51464,ಶಿಕ್ಷಕನು,0,0,1,1
41580,കർമ്മ,0,0,1,1
41590,répercussions,0,0,1,1
41579,предварительной,0,0,1,1
44439,delecionismo,0,0,1,1
41578,ertoe,0,0,1,1
41577,cherchez,0,0,1,1
44440,примере,0,0,1,1
41576,உதவியாக,0,0,1,1
44441,imaginez,0,0,1,1
41574,αποδέχομαι,0,0,1,1
51067,لمحاولات,0,0,1,1
51066,маркой,0,0,1,1
44445,visuelle,0,0,1,1
41589,yapacağım,0,0,1,1
41592,المشاريع،,0,0,1,1
41610,ಅತ್ಯಾಚಾರ,0,0,1,1
44429,«the,0,0,1,1
41609,yapamayacak,0,0,1,1
44420,patiemment,0,0,1,1
44422,mesclamse,0,0,1,1
44423,culto​​​,0,0,1,1
41607,تقارير,0,0,1,1
41605,மாறிவிட்டாள்,0,0,1,1
44426,एकार्ट,0,0,1,1
41603,निति,0,0,1,1
44427,phusika,0,0,1,1
51462,ತಮಾಷೆಯಾಗಿದೆ,0,0,1,1
41601,succinct,0,0,1,1
51072,marxiste,0,0,1,1
41593,avbryter,0,0,1,1
41599,analys,0,0,1,1
41598,малым,0,0,1,1
41597,modifiable,0,0,1,1
41596,aufnehmen,0,0,1,1
51071,fortsetzt,0,0,1,1
51070,வலைதளத்துக்கு,0,0,1,1
41595,накоплению,0,0,1,1
44430,عشوائية,0,0,1,1
51463,sujeira,0,0,1,1
44431,telephone,0,0,1,1
44434,βασίζεται,0,0,1,1
41103,नवम्बर,0,0,1,1
41101,« à,0,0,1,1
37541,अनुभवहीन,0,0,1,1
40647,братские,0,0,1,1
40629,avoiding,0,0,1,1
40628,läroböcker,0,0,1,1
40627,контента,0,0,1,1
45094,പ്രവർത്തിച്ചവർ,0,0,1,1
40625,γελάει,0,0,1,1
51607,diste,0,0,1,1
40624,insinuer,0,0,1,1
45096,nepbeller,0,0,1,1
40622,consecuentemente,0,0,1,1
45097,virgil,0,0,1,1
40621,разделом,0,0,1,1
40618,மூழ்கிவிடுவார்கள்,0,0,1,1
50979,ordenadas,0,0,1,1
40616,തീരുമാനങ്ങളിലെത്താൻ,0,0,1,1
45098,describing,0,0,1,1
40614,преданная,0,0,1,1
40613,uncertainty,0,0,1,1
45099,sucinta,0,0,1,1
50978,одинединственный,0,0,1,1
45101,الغالب,0,0,1,1
40612,المجلات,0,0,1,1
45102,непроверенной,0,0,1,1
45105,ಸಾರ್ವಕಾಲಿಕ,0,0,1,1
45106,prometteuses,0,0,1,1
45108,тайно,0,0,1,1
45091,romains,0,0,1,1
45089,ajuda,0,0,1,1
40630,httpdewikipediaorg,0,0,1,1
45082,inactivity,0,0,1,1
40645,студент,0,0,1,1
45074,എത്തിച്ചേരേണ്ട,0,0,1,1
40643,الاقتباس,0,0,1,1
45075,connaître,0,0,1,1
45076,bakıyordu,0,0,1,1
40640,tanrıya,0,0,1,1
45077,واجه,0,0,1,1
40638,للتماسك،,0,0,1,1
45078,acrecentando,0,0,1,1
45079,ಆರ್ಥಿಕತೆಯು,0,0,1,1
45080,seng,0,0,1,1
51605,félicitations,0,0,1,1
40631,"
ज़ाज़ाकी",0,0,1,1
51606,مذهلًا,0,0,1,1
50981,والضحكات,0,0,1,1
45083,உள்ளுணர்வைக்,0,0,1,1
45084,respectivamente,0,0,1,1
45085,universität,0,0,1,1
45086,எனும்,0,0,1,1
40634,नही।,0,0,1,1
50980,harías,0,0,1,1
45087,teori,0,0,1,1
45088,इनकार,0,0,1,1
40632,ಸಲಾಡ್,0,0,1,1
45110,bizimle,0,0,1,1
50977,وما,0,0,1,1
40607,stipule,0,0,1,1
40572,soppa,0,0,1,1
45129,vereyim,0,0,1,1
51613,редактируются,0,0,1,1
45130,transcendantalistes,0,0,1,1
45131,उधार,0,0,1,1
40577,aktad,0,0,1,1
40576,évaluation,0,0,1,1
40575,تعليمية,0,0,1,1
40574,gevolg,0,0,1,1
51614,maneiras,0,0,1,1
45132,للمساهمة,0,0,1,1
40573,smiles,0,0,1,1
40571,запрашивая,0,0,1,1
40581,çoğu,0,0,1,1
45137,бурной,0,0,1,1
40569,привлечь,0,0,1,1
40568,convenient,0,0,1,1
40567,ನೋಡಿಲ್ಲ,0,0,1,1
40566,сложную,0,0,1,1
40565,suffit,0,0,1,1
40564,financeiros,0,0,1,1
45141,monthly,0,0,1,1
40562,കാലങ്ങളായി,0,0,1,1
45143,méritais,0,0,1,1
40561,चिड़िया,0,0,1,1
50976,αυτού,0,0,1,1
45127,திருத்தங்களைப்,0,0,1,1
45112,négatives,0,0,1,1
45120,"
कन्नड़",0,0,1,1
45114,webosbased,0,0,1,1
45115,geotechnical,0,0,1,1
45116,automobile,0,0,1,1
40602,alianza,0,0,1,1
45117,пообщаться,0,0,1,1
45118,ಸಂತೋಷವಾಗಿದ್ದೇನೆ,0,0,1,1
40599,பையன்,0,0,1,1
40598,αισθάνεστε,0,0,1,1
40597,قارئ،,0,0,1,1
40596,بإمكان,0,0,1,1
40594,عملها,0,0,1,1
40593,exagerarla,0,0,1,1
45126,projectwide,0,0,1,1
45121,تشتكي,0,0,1,1
45122,cruels,0,0,1,1
40591,сложных,0,0,1,1
45123,എന്നതിൻറെ,0,0,1,1
45124,விக்கியைப்,0,0,1,1
40590,graphes,0,0,1,1
40589,chair,0,0,1,1
40587,διαδίκτυο,0,0,1,1
40586,dije,0,0,1,1
40585,semence ,0,0,1,1
40584,മറ്റുള്ളവർക്ക്,0,0,1,1
45073,articlecreating,0,0,1,1
40648,halsizlik,0,0,1,1
44725,जितने,0,0,1,1
45070,välmenande,0,0,1,1
45013,bærende,0,0,1,1
40709,நர்சிஸாவைப்,0,0,1,1
40708,titlen,0,0,1,1
40705,ميلًا,0,0,1,1
40704,правосудия,0,0,1,1
45017,aims,0,0,1,1
40703,समझाएं,0,0,1,1
45018,ومنشورات,0,0,1,1
45019,وبالمثل،,0,0,1,1
45022,frikipedia,0,0,1,1
40702,വരുന്നവർ,0,0,1,1
51588,noticiado,0,0,1,1
40700,yapabilmek,0,0,1,1
40699,κατανοητή,0,0,1,1
45023,животное,0,0,1,1
51589,कम्पनी,0,0,1,1
40697,പരീക്ഷണം,0,0,1,1
40696,υπενθυμίσω,0,0,1,1
40695,louco,0,0,1,1
45024,убита,0,0,1,1
45025,قسم,0,0,1,1
45026,ومعترف,0,0,1,1
40692,programación,0,0,1,1
50988,वीलेन,0,0,1,1
40690,°′″n,0,0,1,1
40711,ആശയം,0,0,1,1
45012,достоверность,0,0,1,1
45011,enheten,0,0,1,1
40724,fourniture,0,0,1,1
40732,खरीदना,0,0,1,1
40731,redistribute,0,0,1,1
44998,ನುಡಿಗಟ್ಟುಗಳ,0,0,1,1
40730,interpretations,0,0,1,1
45000,ഭ്രാന്താണ്,0,0,1,1
45002,landsby,0,0,1,1
45004,ориентирован,0,0,1,1
40729,называемая,0,0,1,1
40728,ಜನರಿಗೆ,0,0,1,1
40727,الماضية,0,0,1,1
40725,féminines,0,0,1,1
40723,saai,0,0,1,1
40714,δείπνο,0,0,1,1
40722,"
लातवियाई",0,0,1,1
45006,опасения,0,0,1,1
40720,مرتبات،,0,0,1,1
40719,återställdes,0,0,1,1
51586,الرائحة,0,0,1,1
40718,sjunka,0,0,1,1
45008,assembled,0,0,1,1
40716,stilmallar,0,0,1,1
45009,redactado,0,0,1,1
40715,müthiş,0,0,1,1
45010,øverst,0,0,1,1
45030,adicionada,0,0,1,1
45031,grijze,0,0,1,1
45032,सभा,0,0,1,1
40657,έπεσε,0,0,1,1
40667,हैं।अमेरिकी,0,0,1,1
45052,ولكنه,0,0,1,1
51598,« conservation,0,0,1,1
40665,പറയുന്നതുപോലെ,0,0,1,1
45054,descubiertos,0,0,1,1
51599,içeriğe,0,0,1,1
45055,gradual,0,0,1,1
40660,arrastar,0,0,1,1
40659,kibarca,0,0,1,1
40658,materiales,0,0,1,1
51601,undskyldning,0,0,1,1
45057,svagheter,0,0,1,1
50985,добьетесь,0,0,1,1
45059,reclamando,0,0,1,1
40656,reconnaissant,0,0,1,1
45060,மந்தமாக்குகிறது,0,0,1,1
45062,примерно,0,0,1,1
45063,gemeinsame,0,0,1,1
51602,ಸುಂದರವಾದ,0,0,1,1
51603,канады,0,0,1,1
51604,meninger,0,0,1,1
50983,ऊर्जा,0,0,1,1
40650,характер,0,0,1,1
40649,narcismoeder,0,0,1,1
40668,temse,0,0,1,1
40670,betarask •,0,0,1,1
45033,değiştirdi,0,0,1,1
40678,vueltas,0,0,1,1
40687,indhold,0,0,1,1
40685,hayal,0,0,1,1
40684,fomenta,0,0,1,1
40683,encontramse,0,0,1,1
50986,награды,0,0,1,1
45036,حاد,0,0,1,1
45037,confirmaba,0,0,1,1
45038,शैलीगत,0,0,1,1
45039,അഭിനന്ദിക്കുന്നു,0,0,1,1
51592,പതിപ്പാണ്‌,0,0,1,1
51593,योजनायें,0,0,1,1
40677,وcebuano،,0,0,1,1
40671,analisado,0,0,1,1
40676,அழுத்துவதன்,0,0,1,1
45041,элли,0,0,1,1
45043,الطحين,0,0,1,1
51595,دائما,0,0,1,1
45044,തൽക്ഷണം,0,0,1,1
40674,actué,0,0,1,1
45045,dialecten,0,0,1,1
45047,recorde,0,0,1,1
45048,سيناريو,0,0,1,1
45049,وغمز,0,0,1,1
45050,african,0,0,1,1
51615,párrafo,0,0,1,1
45145,отбора,0,0,1,1
45147,பணியாற்றியவர்,0,0,1,1
45148,görünmesini,0,0,1,1
45229,directrice,0,0,1,1
45230,estadístico,0,0,1,1
50957,ಕ್ಯಾಲಿಫೋರ್ನಿಯಾದಲ್ಲಿ,0,0,1,1
45232,ofensiva,0,0,1,1
45233,ismine,0,0,1,1
45236,μάτι,0,0,1,1
40445,الجامعات،,0,0,1,1
50956,belonging,0,0,1,1
40444,"
स्पेनी",0,0,1,1
45238,ನೀಡಲಾಗುತ್ತದೆ,0,0,1,1
45239,പൂന്തോട്ടത്തിൽ,0,0,1,1
45240,بيزنس,0,0,1,1
40442,തുടങ്ങുന്നത്,0,0,1,1
40441,தங்கமாக,0,0,1,1
40440,impacta,0,0,1,1
45241,eenvoudigste,0,0,1,1
40439,பயணம்,0,0,1,1
40438,بالمشاريع,0,0,1,1
50955,ಕಾಣಿಸುತ್ತಾಳೆ,0,0,1,1
45243,princesse,0,0,1,1
45244,चर्चा,0,0,1,1
45245,heredó,0,0,1,1
45246,നിർമ്മിച്ചതാണ്,0,0,1,1
45247,knop,0,0,1,1
40432,voyages,0,0,1,1
45228,أستمر,0,0,1,1
40450,فستان,0,0,1,1
45225,متحيزة،,0,0,1,1
45218,ಚಾನಲ್,0,0,1,1
40470,είδε,0,0,1,1
45212,amável,0,0,1,1
40469,jeanpierre,0,0,1,1
40468,टिप्पणीकारों,0,0,1,1
45215,tief,0,0,1,1
40467,computationally,0,0,1,1
40466,сэнгера,0,0,1,1
40465,écritures,0,0,1,1
40464,அறிக்கையையும்,0,0,1,1
45217,الإنجليزي,0,0,1,1
40463,¿dónde,0,0,1,1
40461,acepto,0,0,1,1
51628,alın,0,0,1,1
40460,leer,0,0,1,1
45219,energía,0,0,1,1
45220,sel,0,0,1,1
45221,പതിപ്പാണ്,0,0,1,1
45222,ನೋಡಿಕೊಳ್ಳಿ,0,0,1,1
40457,पत्र,0,0,1,1
40455,தகுதியானவன்,0,0,1,1
40453,ആർതർ,0,0,1,1
40452,defensores,0,0,1,1
45223,достоверной,0,0,1,1
45224,énfasis,0,0,1,1
50954,എന്നില്ല,0,0,1,1
40431,مساءً,0,0,1,1
40430,συνειδητοποιήσετε,0,0,1,1
40396,encontre,0,0,1,1
51637,auktoriteter,0,0,1,1
51638,utgivningsbevis,0,0,1,1
51639,“பல்நிலை,0,0,1,1
45268,രത്നങ്ങളിലും,0,0,1,1
51640,engelsktalande,0,0,1,1
45269,программному,0,0,1,1
40400,tyckte,0,0,1,1
40399,പക്ഷിയുടെതുപോലെയുള്ള,0,0,1,1
45270,ശ്രദ്ധിക്കുന്നില്ല,0,0,1,1
40398,டெல்லியில்,0,0,1,1
40397,liedjes,0,0,1,1
45271,bezighoudt,0,0,1,1
45267,mordaza,0,0,1,1
40394,kopiere,0,0,1,1
40393,somente,0,0,1,1
45272,अर्थशास्त्री,0,0,1,1
45273,கொடுக்கப்,0,0,1,1
50951,ആകസ്‌മിക,0,0,1,1
40388,αγγλόφωνη,0,0,1,1
40387,religionskritik,0,0,1,1
45276,ووجهات,0,0,1,1
45277,berömda,0,0,1,1
45278,passionnés,0,0,1,1
40383,изменение,0,0,1,1
40404,übertreiben,0,0,1,1
40406,åkte,0,0,1,1
51632,உலகெங்கிலுமுள்ள,0,0,1,1
40420,arquitetura,0,0,1,1
45248,ನನಸಾಗುತ್ತದೆ,0,0,1,1
45250,whose,0,0,1,1
51633,പിടിച്ചില്ലേ,0,0,1,1
40426,അപ്രാപ്യമല്ല,0,0,1,1
40425,uzatır,0,0,1,1
51634,afirmación,0,0,1,1
45251,sınıfta,0,0,1,1
45252,« pédia »,0,0,1,1
51635,പന്തിരുകുലം,0,0,1,1
51636,வாதங்களையும்,0,0,1,1
40421,μπράβο,0,0,1,1
40419,peerreviewed,0,0,1,1
40407,locura»,0,0,1,1
40418,alemãode,0,0,1,1
45254,semiprotected,0,0,1,1
45255,முறைமை,0,0,1,1
40415,março,0,0,1,1
50953,speak,0,0,1,1
50952,supérieur,0,0,1,1
45258,achèterais,0,0,1,1
40412,guldguldbröd,0,0,1,1
45261,செயன்முறையின்,0,0,1,1
45262,éducation,0,0,1,1
40408,entidades,0,0,1,1
40471,españa,0,0,1,1
45211,ஆவண,0,0,1,1
40473,تنشأ,0,0,1,1
40524,soluciones,0,0,1,1
45165,ശ്രമം,0,0,1,1
45166,religieux,0,0,1,1
40531,ρωτώ,0,0,1,1
45167,modersmål,0,0,1,1
40530,δροσερός,0,0,1,1
50972,boodschapper,0,0,1,1
45170,प्यारा,0,0,1,1
45171,läraren,0,0,1,1
40527,problematic,0,0,1,1
40526,الاتفاق,0,0,1,1
40525,പുനർജീവിച്ചു,0,0,1,1
45172,древней,0,0,1,1
51620,ಹೋಗುವುದಿಲ್ಲ,0,0,1,1
40523,facia,0,0,1,1
40522,ಒಪ್ಪಲು,0,0,1,1
51621,πάρει,0,0,1,1
45173,trustees,0,0,1,1
45174,написал,0,0,1,1
45175,foton,0,0,1,1
50970,कीजिय,0,0,1,1
40519,slug,0,0,1,1
40518,artikelhistorik,0,0,1,1
40517,källhänvisning,0,0,1,1
40516,organisées,0,0,1,1
45164,metamorphosed,0,0,1,1
40534,heltäckande,0,0,1,1
40515,produtivos,0,0,1,1
40545,gostasse,0,0,1,1
40556,rotord,0,0,1,1
51616,estudiante,0,0,1,1
45149,സംരംഭം,0,0,1,1
40554,owned,0,0,1,1
50974,eneste,0,0,1,1
40553,تحطمت,0,0,1,1
45151,qualité »ab,0,0,1,1
45152,blocked,0,0,1,1
40550,अधिकतर,0,0,1,1
45153,longstanding,0,0,1,1
45156,внимания,0,0,1,1
45158,oiseau,0,0,1,1
51619,ഔട്ട്പുട്ടിലേക്കുള്ള,0,0,1,1
45161,ontbrak,0,0,1,1
40542,emeralds,0,0,1,1
51618,gerenommeerd,0,0,1,1
40540,publiek,0,0,1,1
40539,носящего,0,0,1,1
45162,sustenance,0,0,1,1
40538,grafemas,0,0,1,1
50973,νερό,0,0,1,1
45163,chelsea,0,0,1,1
40537,हवाई,0,0,1,1
40536,foncière,0,0,1,1
45178,adil,0,0,1,1
50969,entendre,0,0,1,1
40474,framework,0,0,1,1
40488,نفسه,0,0,1,1
45196,वैद्यता,0,0,1,1
40492,concordamos,0,0,1,1
51625,science »,0,0,1,1
40491,doutoranda,0,0,1,1
45197,vanskelig,0,0,1,1
45198,كاتب,0,0,1,1
45199,صخرة,0,0,1,1
45200,frotté,0,0,1,1
40489,beundrande,0,0,1,1
50962,выходной,0,0,1,1
45202,kopiëren,0,0,1,1
40487,votações,0,0,1,1
40495,formidable,0,0,1,1
40486,vrijwel,0,0,1,1
40485,ആശ്ചര്യപ്പെടുത്തുന്ന,0,0,1,1
40484,anger,0,0,1,1
40483,негативной,0,0,1,1
50960,hésitant,0,0,1,1
40478,voltam,0,0,1,1
51626,convención,0,0,1,1
45209,prisoners,0,0,1,1
45210,астрономической,0,0,1,1
40476,stormfuldt,0,0,1,1
40475,επιβάλλουν,0,0,1,1
40494,programspråket,0,0,1,1
45195,написанном,0,0,1,1
40514,காலாண்டில்,0,0,1,1
40507,понимающей,0,0,1,1
50968,filtro,0,0,1,1
40513,belgeleme,0,0,1,1
40512,évaluer,0,0,1,1
40511,clés,0,0,1,1
50967,glücklich,0,0,1,1
50966,البيانية,0,0,1,1
45182,обслужены,0,0,1,1
45185,asociación,0,0,1,1
40509,elske,0,0,1,1
40508,ash,0,0,1,1
50965,aimeriez,0,0,1,1
45188,تي,0,0,1,1
51624,atualizam,0,0,1,1
40505,necesitamos,0,0,1,1
40504,chiste,0,0,1,1
40503,റോമൻ,0,0,1,1
45190,المسائل,0,0,1,1
51623,ಕೋನ,0,0,1,1
40501,നന്ദിയുണ്ട്,0,0,1,1
40500,ρίτσαρντ,0,0,1,1
40499,prononcez,0,0,1,1
40498,പാടേ,0,0,1,1
50964,رسمي,0,0,1,1
45194,croire,0,0,1,1
40733,качаешься,0,0,1,1
40734,ഭാഗവും,0,0,1,1
44995,penis,0,0,1,1
40920,மனிதனுக்கு,0,0,1,1
44811,prato,0,0,1,1
40982,adieux,0,0,1,1
40981,accommodation,0,0,1,1
40980,elogiando,0,0,1,1
44812,मीठी,0,0,1,1
40978,dileyebilirsiniz,0,0,1,1
51017,mérite,0,0,1,1
40977,общем,0,0,1,1
51016,pestañas,0,0,1,1
51542,ആവേശത്തിലാണ്,0,0,1,1
44813,traditionella,0,0,1,1
40975,दबाकर,0,0,1,1
44814,partenariats,0,0,1,1
44816,mensajero,0,0,1,1
40974,नीदरलैंड,0,0,1,1
44818,ಹ್ಯಾಂಗ್,0,0,1,1
51015,പ്രവർത്തിക്കുന്നുണ്ടെങ്കിൽ,0,0,1,1
44821,ayer,0,0,1,1
40973,çapında,0,0,1,1
40972,upwards,0,0,1,1
40971,फेडरल,0,0,1,1
51014,lækre,0,0,1,1
40969,neerlandesa,0,0,1,1
40968,efetivamente,0,0,1,1
40967,प्रतियोगिता,0,0,1,1
44810,ദശലക്ഷം,0,0,1,1
44808,ಸರಿಯಾಗಿರುತ್ತೇನೆ,0,0,1,1
40983,assuming,0,0,1,1
40992,വരുത്തുന്നു,0,0,1,1
41002,discuter,0,0,1,1
44796,activité,0,0,1,1
41001,ಗೊಂದಲಕ್ಕೊಳಗಾದ,0,0,1,1
41000,tallrik,0,0,1,1
44797,النهائية,0,0,1,1
44798,mystère,0,0,1,1
44800,tillåts,0,0,1,1
40999,تأسيس,0,0,1,1
40998,invocadas,0,0,1,1
51536,хотела,0,0,1,1
40994,gestart,0,0,1,1
51537,höjde,0,0,1,1
40984,højttaler,0,0,1,1
51538,hierover,0,0,1,1
44805,brister,0,0,1,1
40990,merak,0,0,1,1
40989,ടെറിയോടും,0,0,1,1
40988,ஓட்டங்கள்,0,0,1,1
44806,syntaxe,0,0,1,1
44807,दस्तावेजों,0,0,1,1
51540,endangered,0,0,1,1
40987,välkommen,0,0,1,1
40986,editassem,0,0,1,1
40985,apelaram,0,0,1,1
44826,സ്പാനിഷ്,0,0,1,1
44827,âme,0,0,1,1
40965,—administrador—,0,0,1,1
44861,limace,0,0,1,1
44853,contestée,0,0,1,1
44854,açıldı,0,0,1,1
44856,pensez,0,0,1,1
44857,nationaal,0,0,1,1
40937,κάπου,0,0,1,1
40936,сайты,0,0,1,1
40935,secretos,0,0,1,1
40934,autorité,0,0,1,1
44858,skratta,0,0,1,1
44859,cto,0,0,1,1
44860,പോർട്ടലിലൂടെ,0,0,1,1
40932,personagem,0,0,1,1
44852,ifølge,0,0,1,1
40931,amador,0,0,1,1
44862,سعيدا,0,0,1,1
51548,الذهبية,0,0,1,1
40930,parliamentary,0,0,1,1
51012,"
quirguiz",0,0,1,1
44866,cumulatively,0,0,1,1
40926,haberlerde,0,0,1,1
44869,അശ്ലീല,0,0,1,1
44870,centrase,0,0,1,1
40923,identidad,0,0,1,1
40922,guided,0,0,1,1
40940,وعليك,0,0,1,1
40942,relatórios,0,0,1,1
40964,l’entrainement,0,0,1,1
44838,"
डीलीट",0,0,1,1
40963,city,0,0,1,1
40962,प्रविष्टियाॅं,0,0,1,1
44828,hy •,0,0,1,1
44829,экономически,0,0,1,1
40959,id,0,0,1,1
40958,görünüyorlardı,0,0,1,1
44831,வலியுறுத்துவதைப்,0,0,1,1
44832,يترجموا,0,0,1,1
44834,minimization,0,0,1,1
44835,مباشرة,0,0,1,1
44837,മന്ദഗതിയിലാണ്,0,0,1,1
44839,വസ്ത്രം,0,0,1,1
44850,പ്രതിപാദനത്തെയും,0,0,1,1
40952,humanidades,0,0,1,1
44840,« guerres,0,0,1,1
44842,φάσμα,0,0,1,1
40949,μιλήσεις,0,0,1,1
51546,ذا,0,0,1,1
44843,അളവിലുള്ള,0,0,1,1
40946,disk,0,0,1,1
44844,droit ,0,0,1,1
44848,ചോദിക്കണമെങ്കിൽ,0,0,1,1
40944,குறிப்பிட்டுள்ளது,0,0,1,1
44849,clúster,0,0,1,1
41003,sulter,0,0,1,1
44794,controvertidos,0,0,1,1
41004,impossibles,0,0,1,1
51023,óbvio,0,0,1,1
51525,oxfordsystemet,0,0,1,1
41078,ജർമ്മൻ,0,0,1,1
41077,பார்வையிட,0,0,1,1
41076,intermingled,0,0,1,1
44744,lyst,0,0,1,1
41075,പിന്നിൽ,0,0,1,1
44746,især,0,0,1,1
41073,подтверждения,0,0,1,1
44747,anlatırsa,0,0,1,1
41070,بجد,0,0,1,1
44750,διαγλωσσικές,0,0,1,1
41069,متباينة،,0,0,1,1
41082,bekostnad,0,0,1,1
44752,demanda,0,0,1,1
44755,ಆಬ್ಟ್ಯೂಸ್,0,0,1,1
44756,gitmeme,0,0,1,1
41066,ചിത്രങ്ങളും,0,0,1,1
44759,கட்டுரைகளிலும்,0,0,1,1
41064,erreichte,0,0,1,1
41063,закончится,0,0,1,1
41062,weerlegging,0,0,1,1
44761,detaljerat,0,0,1,1
44763,നല്ലതുപോലെയാണ്,0,0,1,1
41059,فأخبرني,0,0,1,1
51523,kaçınmak,0,0,1,1
41083,«народная,0,0,1,1
51528,wikipediaartikler,0,0,1,1
44736,petición,0,0,1,1
44727,uitspreekt,0,0,1,1
44728,divulgado,0,0,1,1
41099,नाराज,0,0,1,1
41098,étiquettes,0,0,1,1
41097,പങ്കിടാൻ,0,0,1,1
44732,espelho,0,0,1,1
41095,ದೇವದೂತನಾಗಿದ್ದೇನೆ,0,0,1,1
44733,birisidir,0,0,1,1
44734,speglade,0,0,1,1
44735,exibição,0,0,1,1
41093,φτιαγμένο,0,0,1,1
44737,lyngfelt,0,0,1,1
41084,desanimadoras,0,0,1,1
41092,сотен,0,0,1,1
44738,normalde,0,0,1,1
51520,ശ്രദ്ധിക്കാനാകില്ലെന്ന്,0,0,1,1
44740,fazerem,0,0,1,1
44741,bedövad,0,0,1,1
41087,وطعمه,0,0,1,1
51522,brincam,0,0,1,1
51024,തുടങ്ങിയിട്ടില്ല,0,0,1,1
41086,lenguaje,0,0,1,1
41085,accepter,0,0,1,1
44742,ipucunu,0,0,1,1
41058,ശാസ്ത്രജ്ഞന്മാർ,0,0,1,1
41056,मस्तिष्क,0,0,1,1
41005,கட்டிப்பிடிக்க,0,0,1,1
41020,പരാതിപ്പെടാൻ,0,0,1,1
51533,phrased,0,0,1,1
44782,contrasted,0,0,1,1
41027,चीज़,0,0,1,1
44783,சொற்றொடர்களைப்,0,0,1,1
44784,computerprogramma,0,0,1,1
41024,बेवकूफी,0,0,1,1
44785,softwares,0,0,1,1
41023,schommelt,0,0,1,1
44786,toppositie,0,0,1,1
41022,"
malaio",0,0,1,1
41021,കരച്ചിൽ,0,0,1,1
44790,joaquín,0,0,1,1
41031,بيركمان,0,0,1,1
41017,presides,0,0,1,1
41016,aurais,0,0,1,1
41015,தேர்ந்தெடுக்கப்பட்ட,0,0,1,1
41014,fizesse,0,0,1,1
51021,القديم,0,0,1,1
41012,опыта,0,0,1,1
44791,wint,0,0,1,1
41010,cycles,0,0,1,1
51535,спрашивал,0,0,1,1
41007,здравоохранении,0,0,1,1
41006,bibliograaf,0,0,1,1
41029,ಸಾಗುವುದು,0,0,1,1
44781,interstellar,0,0,1,1
41055,कोरियाई,0,0,1,1
44767,தொகுத்துள்ளார்,0,0,1,1
41054,مسح,0,0,1,1
41053,والتحيزات,0,0,1,1
44764,புன்னகைக்கச்,0,0,1,1
51530,централизованного,0,0,1,1
44765,bindi,0,0,1,1
41051,cultured,0,0,1,1
41050,kurucularından,0,0,1,1
41049,jardin,0,0,1,1
41048,напуган,0,0,1,1
41047,подавляющее,0,0,1,1
41045,теме»,0,0,1,1
41043,खरीदूंगा,0,0,1,1
41032,tarihindeki,0,0,1,1
44772,certas,0,0,1,1
51531,uitgespookt,0,0,1,1
44775,prenais,0,0,1,1
41039,conduzido,0,0,1,1
41038,"വിജ്ഞാനശകലങ്ങൾ
ചേർക്കുന്നവർക്കുണ്ടായേക്കാവുന്ന",0,0,1,1
41036,двумя,0,0,1,1
41035,generalizable,0,0,1,1
44776,bestäms,0,0,1,1
41034,naturae,0,0,1,1
44777,battle,0,0,1,1
44778,imposible,0,0,1,1
40921,oprindelse,0,0,1,1
44873,piadas,0,0,1,1
40735,प्रथम,0,0,1,1
44874,göründüğünde,0,0,1,1
40802,organisés,0,0,1,1
40800,guidant,0,0,1,1
40799,ethnologie,0,0,1,1
44953,вышедших,0,0,1,1
44954,telefonda,0,0,1,1
40795,удаление,0,0,1,1
40794,ആളുകൾക്ക്,0,0,1,1
40793,meatspace,0,0,1,1
44955,kritisk,0,0,1,1
40790,அன்பான,0,0,1,1
44956,جعل,0,0,1,1
50994,problemáticos,0,0,1,1
40787,ombads,0,0,1,1
40786,aralık,0,0,1,1
44958,noiva,0,0,1,1
44959,intégralité,0,0,1,1
40784,disagree,0,0,1,1
40783,basque,0,0,1,1
40782,أخبرتك,0,0,1,1
40781,suck,0,0,1,1
40780,enfados,0,0,1,1
44961,грантом,0,0,1,1
44962,märka,0,0,1,1
40779,transação,0,0,1,1
44964,enkelte,0,0,1,1
40803,προσφορές,0,0,1,1
40804,layout,0,0,1,1
50998,mini,0,0,1,1
44942,διανεμηθεί,0,0,1,1
40828,ಮೈಲಿಗೆ,0,0,1,1
40827,frihet,0,0,1,1
40826,visuel,0,0,1,1
44939,nonsensical,0,0,1,1
44940,recognizes,0,0,1,1
44941,habermas,0,0,1,1
40822,seferinde,0,0,1,1
40821,चाहेंगे,0,0,1,1
40820,மூக்கைக்,0,0,1,1
40819,സമാനമായ,0,0,1,1
40818,слез,0,0,1,1
51573,epostadress,0,0,1,1
44951,gestopt,0,0,1,1
44943,journalists,0,0,1,1
40817,ജോലികൾ,0,0,1,1
40816,முன்னதான,0,0,1,1
40815,dejaste,0,0,1,1
44944,يتوقف,0,0,1,1
40813,lições,0,0,1,1
50999,واضحة,0,0,1,1
51574,låne,0,0,1,1
40807,പൂരകസംവിധാനമായാണ്‌,0,0,1,1
44950,അസ്സാമീസ്,0,0,1,1
40805,μοιάζεις,0,0,1,1
40777,مرتبكًا,0,0,1,1
40776,ζώνης,0,0,1,1
44965,aménageurs,0,0,1,1
40743,تسجيل,0,0,1,1
40753,القياسي,0,0,1,1
40752,statistiquement,0,0,1,1
40751,मास्टर,0,0,1,1
40750,وأصبحت,0,0,1,1
40749,labsresearch,0,0,1,1
50991,organizar,0,0,1,1
40747,trouvait,0,0,1,1
40746,കഴിഞ്ഞത്,0,0,1,1
40745,طفيف،,0,0,1,1
44984,ಬಿಟ್ಟಿದ್ದರೆ,0,0,1,1
50990,പ്രിയങ്കരമെന്നും,0,0,1,1
44986,intresserade,0,0,1,1
51580,вечера,0,0,1,1
50989,permitindo,0,0,1,1
40741,meestal,0,0,1,1
40740,വാക്യങ്ങൾ,0,0,1,1
44988,இன்பம்,0,0,1,1
44989,educated,0,0,1,1
40738,ecoregion,0,0,1,1
51584,barely,0,0,1,1
44990,لمقالة،,0,0,1,1
40737,faktarutor,0,0,1,1
44992,satisfactorios,0,0,1,1
44993,einverstanden,0,0,1,1
51582,programação,0,0,1,1
40755,guerras,0,0,1,1
44967,estritas,0,0,1,1
40766,filmlerde,0,0,1,1
40775,febrero,0,0,1,1
51576,predilecta,0,0,1,1
40773,عليهم,0,0,1,1
44968,മനസിലാക്കാൻ,0,0,1,1
40772,vendo,0,0,1,1
40770,urls,0,0,1,1
40769,"ethics ·
environmental",0,0,1,1
40768,ಹುಡುಕುತ್ತಿದ್ದರೆ,0,0,1,1
40767,ஊக்கத்துடன்,0,0,1,1
44971,நேர்மையாக,0,0,1,1
44972,spørgsmålstegn,0,0,1,1
40765,prediga,0,0,1,1
40756,अकार्डिंग,0,0,1,1
44973,അനായാസമായ,0,0,1,1
44974,assumant,0,0,1,1
40763,κατάλληλο,0,0,1,1
51578,культурный,0,0,1,1
50993,içerik,0,0,1,1
40761,« doncosaque »,0,0,1,1
40760,archieven,0,0,1,1
40759,അനുവദിക്കുക,0,0,1,1
40758,bilmediği,0,0,1,1
44978,التدمير,0,0,1,1
44979,ಮಾಡಬೇಕಾದದ್ದು,0,0,1,1
40829,готовы,0,0,1,1
40830,tids,0,0,1,1
40831,पूर्ण,0,0,1,1
51005,aquifers,0,0,1,1
44888,മുന്നോട്ടുപോയില്ല,0,0,1,1
40896,престижны,0,0,1,1
51007,redirecionar,0,0,1,1
51554,imiter,0,0,1,1
44892,balanceamento,0,0,1,1
51556,knolकृपया,0,0,1,1
44893,devras,0,0,1,1
40893,comentar,0,0,1,1
44894,købte,0,0,1,1
40891,personligt,0,0,1,1
51006,കർഷകൻ,0,0,1,1
51558,കൊള്ളാം,0,0,1,1
51553,bett,0,0,1,1
40889,gevolgen,0,0,1,1
44896,عيوب,0,0,1,1
44900,conserving,0,0,1,1
44901,constitutional,0,0,1,1
40885,ongelukkig,0,0,1,1
40884,ноябре,0,0,1,1
51559,regrouper ,0,0,1,1
51560,состояние,0,0,1,1
40883,εμπορικό,0,0,1,1
40882,टोफेल,0,0,1,1
44902,diariamente,0,0,1,1
44887,വിക്കിസോഫ്റ്റ്,0,0,1,1
51009,пользовательского,0,0,1,1
44903,”smaklöst”,0,0,1,1
40908,muscles,0,0,1,1
40917,violated,0,0,1,1
40916,claros,0,0,1,1
40915,ekonomin,0,0,1,1
40914,alınarak,0,0,1,1
40913,"
ख्मेर",0,0,1,1
44877,consultent,0,0,1,1
40912,مهذب,0,0,1,1
40911,субботних,0,0,1,1
44878,almennyttig,0,0,1,1
40910,вероятностей,0,0,1,1
40909,sorrindo,0,0,1,1
44879,thermally,0,0,1,1
51552,engendrement,0,0,1,1
44880,работающих,0,0,1,1
40907,meritsystemverktyg,0,0,1,1
44883,μέχρι,0,0,1,1
44884,ಮುಂದುವರಿಸಲು,0,0,1,1
40905,google​—,0,0,1,1
40903,قادم,0,0,1,1
51551,اقتراحات,0,0,1,1
40901,منع,0,0,1,1
51010,ആചാരങ്ങളാൽ,0,0,1,1
40898,തോന്നണമെങ്കിൽ,0,0,1,1
40897,സൗകര്യം,0,0,1,1
40881,cinéma,0,0,1,1
51562,заботился,0,0,1,1
40832,sevk,0,0,1,1
40845,புத்தகமான,0,0,1,1
40853,editores»,0,0,1,1
40852,génération,0,0,1,1
44925,avslöjande,0,0,1,1
40851,qualificavam,0,0,1,1
44926,تشاركها,0,0,1,1
44927,ಹೋಗಬೇಕಾಗಿದೆ,0,0,1,1
51571,subnational,0,0,1,1
51572,ny,0,0,1,1
44928,ψυχικά,0,0,1,1
44929,devastation,0,0,1,1
44931,detailed,0,0,1,1
40844,ശ്രദ്ധിക്കാൻ,0,0,1,1
40855,опытов,0,0,1,1
40843,открытость,0,0,1,1
40842,exceptionnellement,0,0,1,1
44934,«срезать,0,0,1,1
44935,बैठी,0,0,1,1
51001,വർദ്ധിക്കുമ്പോൾ,0,0,1,1
40838,abstraite,0,0,1,1
40836,ciência,0,0,1,1
40835,увидела,0,0,1,1
40834,श्रृंखला,0,0,1,1
40833,ಕೇಳದಿದ್ದಾಗ,0,0,1,1
44937,konuşuyordu,0,0,1,1
40854,conselho,0,0,1,1
44922,языке»,0,0,1,1
44904,தட்டில்,0,0,1,1
40869,citizens,0,0,1,1
51563,hipotético,0,0,1,1
40877,kötüsü,0,0,1,1
40876,عربته,0,0,1,1
44905,specialområden,0,0,1,1
44907,överens,0,0,1,1
44908,отменить,0,0,1,1
51564,oi,0,0,1,1
44909,riche,0,0,1,1
51565,தரக்கணிப்பீட்டு,0,0,1,1
40871,ангела,0,0,1,1
40870,läsarens,0,0,1,1
44911,l’esprit,0,0,1,1
44920,goleiro,0,0,1,1
40867,datters,0,0,1,1
44913,yazan,0,0,1,1
44914,sitesine,0,0,1,1
40864,– million,0,0,1,1
51567,رسول,0,0,1,1
44916,स्वाद।,0,0,1,1
40861,никогда,0,0,1,1
40860,analogisme,0,0,1,1
40859,nytt,0,0,1,1
40858,erudita,0,0,1,1
44918,surveillants,0,0,1,1
44255,nederig,0,0,1,1
41838,ചാനൽ,0,0,1,1
41839,yönleriyle,0,0,1,1
42832,"
फरवरी",0,0,1,1
43621,استطلاع,0,0,1,1
42805,произносите,0,0,1,1
42804,mécènes,0,0,1,1
42802,செயலதிகாரியான,0,0,1,1
42801,وكأنه,0,0,1,1
42800,ತೀಕ್ಷ್ಣವಾದ,0,0,1,1
42799,samtalet,0,0,1,1
42797,"
galês",0,0,1,1
42796,preferences,0,0,1,1
43625,molecule,0,0,1,1
42795,பத்து,0,0,1,1
42794,ತನ್ನದೇ,0,0,1,1
42793,inadéquation,0,0,1,1
51301,சிக்கல்களையும்,0,0,1,1
51302,അന്നുകണ്ട,0,0,1,1
43626,fortune,0,0,1,1
42789,τονίσετε,0,0,1,1
51303,undue,0,0,1,1
42787,कृत्रिम,0,0,1,1
42786,professional,0,0,1,1
42785,وولاية,0,0,1,1
43627,« lois »,0,0,1,1
43630,قبيح,0,0,1,1
43631,signs,0,0,1,1
43632,സ്വാതന്ത്ര്യമില്ല,0,0,1,1
43620,—que,0,0,1,1
51300,discourages,0,0,1,1
42808,bilen,0,0,1,1
43613,திருத்தல்,0,0,1,1
42829,huvudet,0,0,1,1
43606,fyr,0,0,1,1
42826,obtuviste,0,0,1,1
43607,lembramse,0,0,1,1
43608,графов,0,0,1,1
42824,récapitulant,0,0,1,1
43609,هاواي,0,0,1,1
42822,sobreviveu,0,0,1,1
43610,läxor,0,0,1,1
43611,другим»,0,0,1,1
43612,بنهاية,0,0,1,1
42820,"में।
इसके",0,0,1,1
42809,propôs,0,0,1,1
42819,ανοικτής,0,0,1,1
42818,betonen,0,0,1,1
42817,recherches,0,0,1,1
51299,एहसास,0,0,1,1
51195,polis,0,0,1,1
42816,theorists,0,0,1,1
43614,söta,0,0,1,1
42814,brødet,0,0,1,1
42813,adopte,0,0,1,1
42812,tilfældigvis,0,0,1,1
42811,कारणों,0,0,1,1
42783,اختبار,0,0,1,1
51304,tercih,0,0,1,1
42782,réciproquement,0,0,1,1
42752,bibliothek,0,0,1,1
42758,تفعل؟,0,0,1,1
43646,பார்க்கும்,0,0,1,1
43647,soup,0,0,1,1
42757,लायब्रेरी,0,0,1,1
42756,بالقلق,0,0,1,1
43649,hatan,0,0,1,1
51307,المساهمة,0,0,1,1
43650,ചെയ്തു,0,0,1,1
42754,ಸರಿಯೇ,0,0,1,1
43652,ഒട്ടുമിക്ക,0,0,1,1
51191,apavorante,0,0,1,1
42751,கடுமையான,0,0,1,1
43643,вторичных,0,0,1,1
42750,sprechersymbol,0,0,1,1
51190,smaken,0,0,1,1
42749,språkversionen,0,0,1,1
51309,dijera,0,0,1,1
42748,gustaban,0,0,1,1
42747,بلغته,0,0,1,1
42746,föreställ,0,0,1,1
43657,obtain,0,0,1,1
42744,സത്യവിരുദ്ധമായ,0,0,1,1
42743,versuche,0,0,1,1
43658,искусственного,0,0,1,1
43644,arbetsflöden,0,0,1,1
42761,evaluates,0,0,1,1
42781,årevis,0,0,1,1
43638,являвшаяся,0,0,1,1
42780,realizó,0,0,1,1
42779,randomly,0,0,1,1
42778,интонацию,0,0,1,1
51193,ನೀವೇ,0,0,1,1
42777,பயனர்களை,0,0,1,1
42776,sinophones,0,0,1,1
43635,stan,0,0,1,1
42773,എന്നിങ്ങനെയുള്ള,0,0,1,1
43636,നല്ലവനായിരുന്നു,0,0,1,1
51305,εκτυπωθεί,0,0,1,1
43637,almanızı,0,0,1,1
42771,entraîne,0,0,1,1
42762,родном,0,0,1,1
51306,классические,0,0,1,1
42770,المتحدة،,0,0,1,1
42769,hrw,0,0,1,1
43639,elk,0,0,1,1
42767,ಮತ್ತೊಮ್ಮೆ,0,0,1,1
42766,എഴുതാൻപോരുന്നവരാ‍യാൽ,0,0,1,1
43640,пояснении,0,0,1,1
43641,ಉದಾಹರಣೆಯಲ್ಲಿ,0,0,1,1
42764,formuler,0,0,1,1
43642,machistas,0,0,1,1
42763,unumerit,0,0,1,1
42830,förändrade,0,0,1,1
42833,ക്രിക്കറ്റ്,0,0,1,1
51432,lagrar,0,0,1,1
42834,αναφέρει,0,0,1,1
42896,expend,0,0,1,1
42895,orageuse,0,0,1,1
43557,magnifikt,0,0,1,1
42893,magique,0,0,1,1
42892,encombrants,0,0,1,1
42891,limitaría,0,0,1,1
43559,favorece,0,0,1,1
43560,likhet,0,0,1,1
42888,വിക്കിവിരുദ്ധരെ,0,0,1,1
42887,« créées,0,0,1,1
43561,चारों,0,0,1,1
43562,estrategia,0,0,1,1
43563,rosto,0,0,1,1
42883,connectivity,0,0,1,1
43564,медицины,0,0,1,1
42881,कामों,0,0,1,1
42880,företagens,0,0,1,1
42879,today’s,0,0,1,1
42878,αποδείξετε,0,0,1,1
51201,இழுப்பதாகவோ,0,0,1,1
42876,schleppenden,0,0,1,1
43568,necesaria,0,0,1,1
42875,الابتسامات,0,0,1,1
43569,sociologer,0,0,1,1
43571,കാര്യങ്ങൾക്ക്,0,0,1,1
43556,användarnas,0,0,1,1
42897,υπομονετικά,0,0,1,1
42898,إفراغ,0,0,1,1
43547,break,0,0,1,1
42919,بدونك,0,0,1,1
42918,imaginables,0,0,1,1
51204,ഓണത്തെപ്പറ്റി,0,0,1,1
43544,interpretações,0,0,1,1
51202,экзамену,0,0,1,1
42914,وأطلقت,0,0,1,1
42913,массовых,0,0,1,1
42912,fotografias,0,0,1,1
42910,ಸ್ಟುಪೆಂಡಸ್,0,0,1,1
42909,വേണ്ടി,0,0,1,1
42908,iterative,0,0,1,1
43550,parliez,0,0,1,1
42899,synthetic,0,0,1,1
42905,движется,0,0,1,1
42904,देगा,0,0,1,1
42903,точность,0,0,1,1
42902,dirt,0,0,1,1
43552,processamento,0,0,1,1
43553,εκτεθούν,0,0,1,1
43554,ciddi,0,0,1,1
42901,بمصادر,0,0,1,1
51285,എന്നതുപോലുള്ള,0,0,1,1
43555,транспорте,0,0,1,1
51286,χώρα,0,0,1,1
42872,figuras,0,0,1,1
43573,nette,0,0,1,1
42871,серьезной,0,0,1,1
51295,നോക്കിയപ്പോൾ,0,0,1,1
43593,producto,0,0,1,1
42852,fixa,0,0,1,1
42851,марки,0,0,1,1
42850,robotisées,0,0,1,1
51292,expenses,0,0,1,1
42849,interpretadas,0,0,1,1
42848,sucré,0,0,1,1
42847,océans,0,0,1,1
43596,underground,0,0,1,1
51294,സംഭാഷണത്തിൽ‌,0,0,1,1
43597,способность,0,0,1,1
42843,ऑप्टिकल,0,0,1,1
43591,desactualización,0,0,1,1
51296,philips,0,0,1,1
42842,ഭക്ഷ്യയോഗ്യമല്ലാത്ത,0,0,1,1
42841,использованием,0,0,1,1
51198,jeux,0,0,1,1
51197,ಸಹಿಸಿಕೊಳ್ಳಿ,0,0,1,1
43600,espéranto,0,0,1,1
42839,savunulmaktadır,0,0,1,1
42838,சார்,0,0,1,1
43601,расширяется,0,0,1,1
43602,perçues,0,0,1,1
43603,nyttigt,0,0,1,1
43592,автор,0,0,1,1
43590,annotated,0,0,1,1
42870,офисы,0,0,1,1
43583,kommentarfältet,0,0,1,1
42869,beds,0,0,1,1
51288,обобщённое,0,0,1,1
42868,förolämpning,0,0,1,1
51289,предоставлением,0,0,1,1
42866,syrie,0,0,1,1
51290,அழகைத்,0,0,1,1
42864,overused,0,0,1,1
43575,approprié,0,0,1,1
43579,entertainment,0,0,1,1
42862,stansifer,0,0,1,1
43580,bioinformatique,0,0,1,1
42860,liberado,0,0,1,1
42853,retourner,0,0,1,1
43585,constat,0,0,1,1
51291,atrás,0,0,1,1
42859,necesita,0,0,1,1
43586,remonte,0,0,1,1
42857,ಹೊರಬಂದು,0,0,1,1
42856,മൂലയിൽത്തന്നെ,0,0,1,1
43587,نشأتها,0,0,1,1
42855,afirmó,0,0,1,1
43588,വഷളായി,0,0,1,1
42854,التبرعات,0,0,1,1
51200,असमर्थ,0,0,1,1
42742,الواحد,0,0,1,1
43659,matarna,0,0,1,1
43660,நடைமுறைப்படுத்தி,0,0,1,1
43661,lekkerste,0,0,1,1
43729,joueur,0,0,1,1
43733,നോട്ടത്തിൽ,0,0,1,1
42621,cidade,0,0,1,1
42620,löpande,0,0,1,1
43734,télégramme,0,0,1,1
43735,புதிதாக,0,0,1,1
43736,όμορφα,0,0,1,1
43737,സൃഷ്ടിക്കാറുണ്ടെങ്കിലും,0,0,1,1
42618,cbn,0,0,1,1
51324,connexions,0,0,1,1
42616,riktlinjerna,0,0,1,1
51325,राज्य,0,0,1,1
42615,मच,0,0,1,1
42614,"
वेल्स",0,0,1,1
42613,sacaste,0,0,1,1
42612,ಸಂಪತ್ತು,0,0,1,1
42611,landed,0,0,1,1
43738,udviklet,0,0,1,1
43739,"
suaíli",0,0,1,1
43740,acessar,0,0,1,1
42609,capacity,0,0,1,1
43741,முன்னால்,0,0,1,1
43743,perguntoulhe,0,0,1,1
42606,ശിൽപ്പികൾ,0,0,1,1
43744,batatas,0,0,1,1
42623,кэше,0,0,1,1
42624,labelliser,0,0,1,1
42625,preservando,0,0,1,1
42636,« a,0,0,1,1
43717,модным,0,0,1,1
42646,செய்திகளில்,0,0,1,1
42645,ഫൗണ്ടേഷന്റെ,0,0,1,1
42644,—bifurcaciones—,0,0,1,1
42643,preferindo,0,0,1,1
42642,geträumt,0,0,1,1
42641,normaal,0,0,1,1
42640,مقالاتها،,0,0,1,1
42638,αμφιβολίας,0,0,1,1
42637,publicité,0,0,1,1
43721,essentia,0,0,1,1
51182,"
यूनानी",0,0,1,1
42626,culpable,0,0,1,1
42635,« modes,0,0,1,1
42634,prenant,0,0,1,1
51180,нами,0,0,1,1
42631,cogna,0,0,1,1
43724,damaged,0,0,1,1
43725,monate,0,0,1,1
43726,விக்கிப்பீடியாவிற்கும்,0,0,1,1
43727,эксперимента,0,0,1,1
51323,betrat,0,0,1,1
42629,vienen,0,0,1,1
42628,protester»,0,0,1,1
43745,haklarından,0,0,1,1
42605,chiffré,0,0,1,1
42604,lèvres,0,0,1,1
42574,socio,0,0,1,1
42583,ഉപയോക്താക്കളും,0,0,1,1
51177,operation,0,0,1,1
42581,உடன்படுகிறேன்,0,0,1,1
43767,tropics,0,0,1,1
51333,deskundigen,0,0,1,1
42578,கருத்தொருமிப்பின்,0,0,1,1
43768,ethnocentrique,0,0,1,1
43769,уроки,0,0,1,1
43770,feiten,0,0,1,1
42576,smartmobiler,0,0,1,1
51334,പുസ്തകത്തിൽ,0,0,1,1
42573,insuffisances,0,0,1,1
43764,таково,0,0,1,1
43773,ഉപേക്ഷിച്ചിട്ടുണ്ടെങ്കിൽ,0,0,1,1
43775,ahogarse,0,0,1,1
43776,functie,0,0,1,1
42568,включала,0,0,1,1
43780,அமைந்திருந்தது,0,0,1,1
43781,bağlamında,0,0,1,1
43783,सूचित,0,0,1,1
43784,probations,0,0,1,1
42564,verständnisvoller,0,0,1,1
51176,ulaşıp,0,0,1,1
42563,tænk,0,0,1,1
51330,especializadas,0,0,1,1
43763,संसाधन,0,0,1,1
42603,gnupedia,0,0,1,1
42591,vivas,0,0,1,1
42602,krypteringen,0,0,1,1
42601,connaît,0,0,1,1
43746,etmekle,0,0,1,1
42598,hong,0,0,1,1
42597,लड़का,0,0,1,1
43750,readable,0,0,1,1
43751,decimotercer,0,0,1,1
42595,يستخدمون,0,0,1,1
43753,ιανουαρίου,0,0,1,1
42593,actualisation,0,0,1,1
42592,निर्माणात्मक,0,0,1,1
51326,важнейших,0,0,1,1
43762,எப்போதுமே,0,0,1,1
43755,eras,0,0,1,1
42589,anonymity,0,0,1,1
43758,पाँच,0,0,1,1
51327,मेमोरियम,0,0,1,1
43759,हमला,0,0,1,1
51328,hp,0,0,1,1
43760,underwater,0,0,1,1
42586,allée,0,0,1,1
51179,ஆடைகளின்,0,0,1,1
51178,സൂക്ഷ്മത,0,0,1,1
43761,eklerler,0,0,1,1
42647,yanında,0,0,1,1
42649,показывает,0,0,1,1
42650,zorgelijke,0,0,1,1
42706,ಖಚಿತವಾಗಿದೆಯೆ,0,0,1,1
51188,förslaget,0,0,1,1
42714,بيريشيت،,0,0,1,1
51314,ನಿರರ್ಗಳವಾಗಲು,0,0,1,1
42712,இருக்கின்றன,0,0,1,1
42711,وتحصل,0,0,1,1
51315,nourris,0,0,1,1
43680,betegner,0,0,1,1
42710,திருமணத்திற்கு,0,0,1,1
42709,«значимой»,0,0,1,1
43685,frais,0,0,1,1
43686,overnemen,0,0,1,1
42705,cherche,0,0,1,1
42716,ഹീബ്രു,0,0,1,1
42704,ഭാഷയുമായി,0,0,1,1
43687,kultur,0,0,1,1
43688,kvalitetssäkrade,0,0,1,1
42702,soucies,0,0,1,1
43689,admiten,0,0,1,1
51187,வேகத்தில்,0,0,1,1
43691,βάλετε,0,0,1,1
42699,пишет,0,0,1,1
42698,sondage,0,0,1,1
42697,existían,0,0,1,1
42696,неплохо,0,0,1,1
42715,സന്തോഷമുണ്ട്,0,0,1,1
42717,« italie »,0,0,1,1
42694,அட்டவணை,0,0,1,1
43668,conférences,0,0,1,1
42740,എന്നതിന്,0,0,1,1
42739,അതിനു,0,0,1,1
42738,உதவிக்காக,0,0,1,1
43662,háganme,0,0,1,1
43663,χαζή,0,0,1,1
43666,இதையெல்லாம்,0,0,1,1
42736,hastigt,0,0,1,1
42735,souple,0,0,1,1
42733,brengt,0,0,1,1
43667,simplifié,0,0,1,1
42731,hochzeitskleid,0,0,1,1
42730,தொலைபேசி,0,0,1,1
43678,изменила,0,0,1,1
43669,πανεπιστήμιο,0,0,1,1
43670,ಬಂತು,0,0,1,1
43671,wikimedia—,0,0,1,1
43672,кого,0,0,1,1
42724,идеологической,0,0,1,1
43673,इनकी,0,0,1,1
51312,തംബ്‌സ്,0,0,1,1
42722,keyfi,0,0,1,1
42721,ಸರಿಪಡಿಸಲು,0,0,1,1
43676,हास्यास्पद,0,0,1,1
42719,hablemos,0,0,1,1
42695,benötigen,0,0,1,1
42692,myxozoa,0,0,1,1
42651,يسجلون,0,0,1,1
43709,facultades,0,0,1,1
42670,inform,0,0,1,1
51184,levrel,0,0,1,1
42669,prisonniers,0,0,1,1
43708,വിക്കിപീഡിയർക്കായുള്ള,0,0,1,1
42668,encantada,0,0,1,1
42667,projektredigeringar,0,0,1,1
42666,lift,0,0,1,1
42665,stunning,0,0,1,1
42663,qualité ,0,0,1,1
51317,dessus,0,0,1,1
51318,filosóficas,0,0,1,1
42661,ಆಶ್ಚರ್ಯ,0,0,1,1
42672,teach,0,0,1,1
42660,الوحيدة,0,0,1,1
43710,wikireto,0,0,1,1
42659,yaptığınız,0,0,1,1
42658,regelbundna,0,0,1,1
42656,держала,0,0,1,1
42655,chato,0,0,1,1
43711,​​for,0,0,1,1
43712,العمومية,0,0,1,1
43713,காத்திருக்கச்,0,0,1,1
43714,échanger,0,0,1,1
42652,instrumento,0,0,1,1
42671,പ്രവൃത്തിയെക്കുറിച്ച്,0,0,1,1
43704,ಐಸ್,0,0,1,1
42691,வைரங்களில்,0,0,1,1
43697,مقتبساً,0,0,1,1
42690,céus,0,0,1,1
42689,permitirse,0,0,1,1
42688,பெறுவாள்,0,0,1,1
43694,distinct,0,0,1,1
51316,identifiés,0,0,1,1
42686,hayallerindeki,0,0,1,1
43695,menselijke,0,0,1,1
43696,viajó,0,0,1,1
42685,‎wikipidia‏؛,0,0,1,1
42684,plåga,0,0,1,1
42683,destacado,0,0,1,1
43699,visões,0,0,1,1
51185,пар,0,0,1,1
42682,வரிசை’யில்,0,0,1,1
42681,nämligen,0,0,1,1
42680,будете,0,0,1,1
43700,sensíveis,0,0,1,1
43702,efe,0,0,1,1
42678,hazırsınız,0,0,1,1
42677,учителем,0,0,1,1
51186,restored,0,0,1,1
43703,utbildning,0,0,1,1
42676,технологии,0,0,1,1
42675,«откатить,0,0,1,1
43542,gentemot,0,0,1,1
42921,·i,0,0,1,1
42922,निमंत्रण,0,0,1,1
43105,compartilhados,0,0,1,1
43371,görünüyor,0,0,1,1
43171,bidragen,0,0,1,1
43170,putting,0,0,1,1
43169,kararı,0,0,1,1
43168,குறுக்கிடுகிறது,0,0,1,1
43167,främställs,0,0,1,1
43166,вопросительным,0,0,1,1
51253,ಅವರೆಲ್ಲರನ್ನೂ,0,0,1,1
43372,incógnito,0,0,1,1
43163,colaboraciones,0,0,1,1
43373,ಬೇಕಾದುದಾದರೆ,0,0,1,1
51226,schools,0,0,1,1
43162,collaboratives,0,0,1,1
43376,bracket,0,0,1,1
51254,yapılır,0,0,1,1
43160,skills,0,0,1,1
43159,வென்றது,0,0,1,1
43158,உடைந்துவிட்டது,0,0,1,1
43377,сфера,0,0,1,1
51225,minister,0,0,1,1
51255,stelle,0,0,1,1
43379,hapşırdığında,0,0,1,1
43154,plateformes,0,0,1,1
43153,beantworten,0,0,1,1
51257,generated,0,0,1,1
43370,பயணத்தைத்,0,0,1,1
43174,delega,0,0,1,1
43369,சொற்றொடரின்,0,0,1,1
43184,kvalitetsbrister,0,0,1,1
43197,ελα,0,0,1,1
43348,wikipédiameta,0,0,1,1
43194,تسلسلات,0,0,1,1
43193,مكتوبة,0,0,1,1
43192,publicasse,0,0,1,1
43350,soupe,0,0,1,1
43351,фламмокс,0,0,1,1
43352,людям,0,0,1,1
43189,ಆರು,0,0,1,1
43187,തയ്യാറാക്കികൊണ്ടിരിക്കുന്നു,0,0,1,1
51250,"
लुम्बार्ट",0,0,1,1
43183,costumes,0,0,1,1
43365,derhâl,0,0,1,1
43355,goudgoud,0,0,1,1
43356,aftes,0,0,1,1
43181,henüz,0,0,1,1
43358,купили,0,0,1,1
43180,ಸ್ಥಳೀಯ,0,0,1,1
51251,fundamentalt,0,0,1,1
43359,destes,0,0,1,1
43360,adopta,0,0,1,1
43179,zenginlik,0,0,1,1
43363,ಬೆಳ್ಳಿ,0,0,1,1
43364,ಮಾಡುತ್ತಿದ್ದೀಯಾ,0,0,1,1
43380,возникающие,0,0,1,1
51258,തിരുത്തിക്കോളും,0,0,1,1
43152,caixa,0,0,1,1
43116,تمول,0,0,1,1
43126,tentant,0,0,1,1
51261,catalane,0,0,1,1
43124,solicitaron,0,0,1,1
43123,القادم؟,0,0,1,1
43122,generelle,0,0,1,1
43121,executiva,0,0,1,1
43120,totally,0,0,1,1
43392,tremendously,0,0,1,1
43119,внешних,0,0,1,1
43118,saknat,0,0,1,1
43117,fördelade,0,0,1,1
43115,μάθετε,0,0,1,1
43390,അർബുദം,0,0,1,1
43393,трудно,0,0,1,1
43114,ˌwɪkɨˈpiːdiə,0,0,1,1
43113,أسأل,0,0,1,1
43112,yeterince,0,0,1,1
43111,sesin,0,0,1,1
43394,interdisciplinära,0,0,1,1
43109,с англ,0,0,1,1
43108,« comme,0,0,1,1
43395,revient,0,0,1,1
43396,kommentere,0,0,1,1
43107,kombination,0,0,1,1
43127,وتراجعت,0,0,1,1
43129,मर्दानी,0,0,1,1
43151,jupiter,0,0,1,1
43142,കൂട്ടങ്ങളായി,0,0,1,1
43150,krama,0,0,1,1
43381,arises,0,0,1,1
43149,vinklade,0,0,1,1
43148,रेटिंग्स,0,0,1,1
43147,ترغب,0,0,1,1
43146,شاكرا,0,0,1,1
43382,linguistics,0,0,1,1
43383,mutuas,0,0,1,1
43145,നഷ്‌ടപ്പെട്ടു,0,0,1,1
43144,coule,0,0,1,1
43143,suportada,0,0,1,1
43384,ലേഖനമെഴുതാനുദ്ദേശിക്കുന്ന,0,0,1,1
43130,residence,0,0,1,1
43385,entregue,0,0,1,1
43386,ಎಳೆಯಬಹುದು,0,0,1,1
51224,бизнес,0,0,1,1
43139,ചെയ്യപ്പെടുന്നു,0,0,1,1
43138,discount,0,0,1,1
43137,வார்த்தைகளுக்கு,0,0,1,1
43388,affedersiniz,0,0,1,1
43135,επικό,0,0,1,1
51260,telefonat,0,0,1,1
43133,ഇടാൻ,0,0,1,1
43131,irgendetwas,0,0,1,1
43347,подвез,0,0,1,1
51228,otlet,0,0,1,1
43199,calunioso,0,0,1,1
43308,appui,0,0,1,1
43300,சிறைச்சாலைகளில்,0,0,1,1
43260,« pays,0,0,1,1
43259,सलेक्ट,0,0,1,1
43258,delivered,0,0,1,1
43257,ουρανούς,0,0,1,1
43256,kilomètre,0,0,1,1
43303,ಬಳಸುತ್ತೇವೆ,0,0,1,1
43304,പ്രത്യേകതയാണ്,0,0,1,1
43305,എന്നുപറയുക,0,0,1,1
43306,رخصة,0,0,1,1
43307,सबसेट,0,0,1,1
43309,admiring,0,0,1,1
43299,yerini,0,0,1,1
43251,കണ്ടെത്താം,0,0,1,1
43250,spaarnestad,0,0,1,1
43249,ಟೈಪ್,0,0,1,1
43311,असफल,0,0,1,1
43248,whom,0,0,1,1
43313,работников,0,0,1,1
43247,råka,0,0,1,1
43246,serres,0,0,1,1
43245,அந்தக்,0,0,1,1
43315,acercando,0,0,1,1
43242,konferanslarda,0,0,1,1
43261,النطاقات,0,0,1,1
43263,मूलभूत,0,0,1,1
43317,вдохновлённые,0,0,1,1
51238,articles »,0,0,1,1
43288,നിഷ്പക്ഷമായ,0,0,1,1
43283,aldığınızda,0,0,1,1
51239,gozar,0,0,1,1
43289,challenging,0,0,1,1
43290,செய்கிறேன்,0,0,1,1
43282,prinses,0,0,1,1
43281,sainte,0,0,1,1
43292,മാനദണ്ഡങ്ങളെ,0,0,1,1
51240,jungs,0,0,1,1
43278,"
नाहुआतल",0,0,1,1
43277,организацией,0,0,1,1
43273,हूवरिंग,0,0,1,1
43264,ετοιμάστηκα,0,0,1,1
43295,развития»,0,0,1,1
43296,ಇರಲು,0,0,1,1
51241,ஆச்சரியமான,0,0,1,1
43271,birisine,0,0,1,1
51242,когонибудь,0,0,1,1
43269,operational,0,0,1,1
43297,injurieuse,0,0,1,1
43268,wikipediaförfattarna,0,0,1,1
43267,идет,0,0,1,1
43266,opmerken,0,0,1,1
43265,ഇവരും,0,0,1,1
43241,vándalos,0,0,1,1
43319,വേരുകളുണ്ട്,0,0,1,1
51249,étape,0,0,1,1
43210,ഭയന്ന്,0,0,1,1
43220,இருங்கள்,0,0,1,1
43336,ಎನ್,0,0,1,1
43219,kodning,0,0,1,1
43218,பங்களிப்புக்களை,0,0,1,1
51229,ஆரம்பமானது,0,0,1,1
43216,أخطاء,0,0,1,1
43215,custo,0,0,1,1
43214,യോജിക്കാനാവുന്ന,0,0,1,1
43213,மோசமானது,0,0,1,1
43212,rulelearning,0,0,1,1
43211,genome,0,0,1,1
43209,şifresini,0,0,1,1
43333,farine,0,0,1,1
43338,истории,0,0,1,1
43339,спросили,0,0,1,1
43207,greatly,0,0,1,1
43206,οδηγίες,0,0,1,1
43205,മകളും,0,0,1,1
43340,التقدير,0,0,1,1
43203,meegaan,0,0,1,1
43342,excuse,0,0,1,1
43201,تنمو,0,0,1,1
43345,அறிவுள்ள,0,0,1,1
43346,ജോലിയും,0,0,1,1
43335,hermana,0,0,1,1
43221,ಬೀಜಗಳನ್ನು,0,0,1,1
43320,gruppe,0,0,1,1
43230,engineers,0,0,1,1
43321,للتعلم,0,0,1,1
43239,получена,0,0,1,1
43238,consideró,0,0,1,1
43322,नवीनतम,0,0,1,1
43236,bayésien,0,0,1,1
43235,നുറുങ്ങ്,0,0,1,1
43234,திட்டங்களைச்,0,0,1,1
43233,illiterate,0,0,1,1
51235,شديدة,0,0,1,1
43324,തിരുത്തി,0,0,1,1
43231,സംസാരിക്കുന്നു,0,0,1,1
51245,குறிக்க,0,0,1,1
51230,middel,0,0,1,1
43229,embodied,0,0,1,1
51246,सह,0,0,1,1
43326,dictate,0,0,1,1
43227,unterhaltung,0,0,1,1
43226,jamás,0,0,1,1
43225,corridor,0,0,1,1
51247,améliorer »,0,0,1,1
43223,pequenas,0,0,1,1
51248,technieken,0,0,1,1
43329,अनुवादित,0,0,1,1
43330,വെബ്‌,0,0,1,1
43106,കശ്മീർ,0,0,1,1
43104,verbform,0,0,1,1
43541,pleurs,0,0,1,1
43103,"
दूसरा",0,0,1,1
42988,atribuído,0,0,1,1
43489,continuité,0,0,1,1
51280,hayret,0,0,1,1
42985,attracts,0,0,1,1
42983,кэширующих,0,0,1,1
42982,любому,0,0,1,1
42981,connaissances »,0,0,1,1
43490,участника,0,0,1,1
42979,cape,0,0,1,1
43493,“tax,0,0,1,1
42978,çocuğa,0,0,1,1
42977,பெற்றுக்,0,0,1,1
51212,ചെയ്യുകയും,0,0,1,1
42975,udsigt,0,0,1,1
43495,النخبوية,0,0,1,1
42974,تراقبها,0,0,1,1
42973,കേൾക്കാൻ,0,0,1,1
43497,improduktivt,0,0,1,1
42971,bekleyin,0,0,1,1
42970,റിക്ക്,0,0,1,1
43498,lagstiftning,0,0,1,1
51281,kalkylark,0,0,1,1
42968,وعملت,0,0,1,1
43499,செப்டம்பர்,0,0,1,1
43501,الفلبين,0,0,1,1
43487,dispensés,0,0,1,1
42989,¿estaría,0,0,1,1
43482,പാവയും,0,0,1,1
43002,സ്ഥാനത്ത്,0,0,1,1
43010,perigosas,0,0,1,1
43462,ведущих,0,0,1,1
43008,வாரங்கள்,0,0,1,1
51215,planejando,0,0,1,1
43465,i̇yiyim,0,0,1,1
43466,reklamer,0,0,1,1
51214,എത്തിച്ചേരുകയാണ്,0,0,1,1
43004,metric,0,0,1,1
43469,विज्ञापनदाता,0,0,1,1
43470,ಕಂಡಿದೆ,0,0,1,1
43471,korsar,0,0,1,1
43472,مرتين,0,0,1,1
43479,"
फ़िनिश",0,0,1,1
43473,largar,0,0,1,1
42999,കടന്നുപോകാം,0,0,1,1
42998,англоцентризме,0,0,1,1
42997,marche,0,0,1,1
42996,houvesse,0,0,1,1
42995,suddenly,0,0,1,1
43474,bestknown,0,0,1,1
43476,rouge,0,0,1,1
42994,güzelliğinden,0,0,1,1
51213,ನಯವಾಗಿ,0,0,1,1
42992,டைம்,0,0,1,1
43502,schlief,0,0,1,1
42964,revelado,0,0,1,1
43503,சுற்றுலாப்,0,0,1,1
43534,infoga,0,0,1,1
42939,வழங்கியதற்கு,0,0,1,1
43527,αίσθηση,0,0,1,1
42938,usualmente,0,0,1,1
42937,sufixo,0,0,1,1
43528,എഴുതുമ്പോൾ,0,0,1,1
42936,erfaring,0,0,1,1
43529,محتوياتها؛,0,0,1,1
43530,утонченный,0,0,1,1
42935,αποτυχίες,0,0,1,1
43531,trente,0,0,1,1
43532,ನೀವು,0,0,1,1
42933,crystallize,0,0,1,1
43524,affirmations,0,0,1,1
43535,ثمل,0,0,1,1
42932,മൂർച്ചയെ,0,0,1,1
42931,dime,0,0,1,1
51207,foreslået,0,0,1,1
42929,миру,0,0,1,1
43537,existência,0,0,1,1
42927,inexpertos,0,0,1,1
51206,vuil,0,0,1,1
42925,gmatı,0,0,1,1
43539,eliminó,0,0,1,1
43540,erreichen,0,0,1,1
43525,riskerar,0,0,1,1
43522,അക്ഷരങ്ങളെയും,0,0,1,1
42962,παλάτι,0,0,1,1
42953,остановить»,0,0,1,1
42961,slave,0,0,1,1
43504,deposunda,0,0,1,1
42960,svagt,0,0,1,1
43506,المعروفين,0,0,1,1
43507,yakalayamadıysan,0,0,1,1
43509,സൂചിപ്പിക്കുന്നു,0,0,1,1
43510,silber,0,0,1,1
43511,പതിച്ചിരുന്നു,0,0,1,1
43513,جمالك,0,0,1,1
42955,şahsen,0,0,1,1
42954,ickeadministratörer,0,0,1,1
42952,encantado,0,0,1,1
42940,"
arménio",0,0,1,1
42951,inscreverse,0,0,1,1
43515,पात्र,0,0,1,1
42949,referese,0,0,1,1
42948, milhões,0,0,1,1
43516,antag,0,0,1,1
43517,обучаемой,0,0,1,1
43518,दिखाई,0,0,1,1
42945,topten,0,0,1,1
42944,പേർക്കും,0,0,1,1
42943,تسألك,0,0,1,1
43520,приближается,0,0,1,1
43460,chemistry,0,0,1,1
43459,compitieron,0,0,1,1
51216,сделан,0,0,1,1
43414,ем,0,0,1,1
43074,отражаться,0,0,1,1
51267,νοιάζεσαι,0,0,1,1
43406,pedophilia,0,0,1,1
51220,cartas,0,0,1,1
51219,allmänheten,0,0,1,1
43410,иерархическая,0,0,1,1
43069,spain,0,0,1,1
43068,φτάσω,0,0,1,1
43412,أتلانتيك,0,0,1,1
43413,bazar,0,0,1,1
43066,बोलचाल,0,0,1,1
43415,—cuya,0,0,1,1
51265,quejan,0,0,1,1
43064,technologically,0,0,1,1
43417,étonnée,0,0,1,1
43061,verket,0,0,1,1
43060,gratuitement,0,0,1,1
43059,അന്ന്,0,0,1,1
43057,കൊണ്ടുപോകും,0,0,1,1
43056,குனூ,0,0,1,1
43420,cayó,0,0,1,1
43054,ओक्स्फोर्ड,0,0,1,1
43053,பெரியதும்,0,0,1,1
43052,aprenden,0,0,1,1
43404,höger,0,0,1,1
43077,இவற்றுள்,0,0,1,1
43421,notablemente,0,0,1,1
51221,reed,0,0,1,1
43102,الروابط,0,0,1,1
43101,прямое,0,0,1,1
43100,associëren,0,0,1,1
43099,« robots »,0,0,1,1
43098,updating,0,0,1,1
43096,ziyaret,0,0,1,1
51262,വീഡിയോയുടെ,0,0,1,1
43095,называется,0,0,1,1
43398,días—,0,0,1,1
43093,γαλλικός,0,0,1,1
43092,गहराई,0,0,1,1
51263,rubíes,0,0,1,1
43078,வாரம்,0,0,1,1
43088,أصابعي,0,0,1,1
43401,qualifié,0,0,1,1
43086,politikendk,0,0,1,1
43085,βοήθησέ,0,0,1,1
43402,hersenen,0,0,1,1
43084,धारणा,0,0,1,1
43083,deputy,0,0,1,1
43082,гарантирует,0,0,1,1
43081,echte,0,0,1,1
43080,cultiver,0,0,1,1
43079,inland,0,0,1,1
43051,intentionnalité,0,0,1,1
43049,région,0,0,1,1
51275,विन्यास,0,0,1,1
43454,إقراضي,0,0,1,1
43443,hänga,0,0,1,1
43030,saniye,0,0,1,1
43447,monde »,0,0,1,1
43029,കർത്തവ്യമാണ്,0,0,1,1
43028,unterricht,0,0,1,1
43027,uitpraten,0,0,1,1
43448,democratic,0,0,1,1
43449,தம்மிடையேயான,0,0,1,1
43450,aimait,0,0,1,1
43451,sensibles,0,0,1,1
43024,полезных,0,0,1,1
43023,hugely,0,0,1,1
43032,коллектив,0,0,1,1
43022,துவக்கல்,0,0,1,1
43021,सटीकता,0,0,1,1
43020,αδερφή,0,0,1,1
51274,отправлении,0,0,1,1
43019,vieil,0,0,1,1
43456,vervangen,0,0,1,1
43017,connaissant,0,0,1,1
43016,ദയനീയമാണെന്ന്,0,0,1,1
43457,confianza,0,0,1,1
43458,அழுவதையும்,0,0,1,1
43013,spare,0,0,1,1
43442,подъехала,0,0,1,1
43441,നല്ലൊരു,0,0,1,1
43422,délicieux,0,0,1,1
43430,позицию,0,0,1,1
43423,autoconfirmados,0,0,1,1
43048,بإنشاء,0,0,1,1
51268,эмпирически,0,0,1,1
43047,താൽപ്പര്യമില്ല,0,0,1,1
43046,എന്താണെന്ന്‌,0,0,1,1
43044,onderzoeksresultaten,0,0,1,1
43043,thoughts,0,0,1,1
43042,αγενή,0,0,1,1
43425,encargó,0,0,1,1
43427,indkøbscentret,0,0,1,1
43428,förbryllade,0,0,1,1
43039,financiers,0,0,1,1
43440,небесам»,0,0,1,1
43037,телеграмму,0,0,1,1
43432,ارى,0,0,1,1
43434,regroupe,0,0,1,1
43435,kanıtlamazsanız,0,0,1,1
51270,replacement,0,0,1,1
43436,ಮೈಲಿ,0,0,1,1
43437,planering,0,0,1,1
43034,fleisch,0,0,1,1
43033,использовалось,0,0,1,1
43438,promotie,0,0,1,1
43439,теоретическим,0,0,1,1
42562,حلم,0,0,1,1
42561,وسأراكم,0,0,1,1
43787,gmt,0,0,1,1
44129,مدهش,0,0,1,1
51132,ഏവർക്കുമറിവുള്ളതാണല്ലോ,0,0,1,1
42088,വെളിപ്പെടുത്തുന്നു,0,0,1,1
51131,consigue,0,0,1,1
51393,നിലവിലുണ്ട്,0,0,1,1
42086,namorada,0,0,1,1
51130,erholt,0,0,1,1
42084,φοβερό,0,0,1,1
44092,stormigt,0,0,1,1
42080,மாற்றங்களைப்,0,0,1,1
42079,чей,0,0,1,1
51127,« jouer »,0,0,1,1
42078,കേൾക്കുന്നില്ല,0,0,1,1
42077,जताई।,0,0,1,1
42076,extractos,0,0,1,1
44093,обобщению,0,0,1,1
51396,relectures,0,0,1,1
42075,desktops,0,0,1,1
51126,hoşgörü,0,0,1,1
44096,κυριολεκτικά,0,0,1,1
42072,minderheidstalen,0,0,1,1
42071,запросу,0,0,1,1
44097,lutou,0,0,1,1
44098,providence,0,0,1,1
42070,разрушительных,0,0,1,1
42069,பார்த்தால்,0,0,1,1
44086,друга,0,0,1,1
42090,ജീവനക്കാരൻ,0,0,1,1
42091,என்றும்,0,0,1,1
42101,عيني,0,0,1,1
44076,φυσικό,0,0,1,1
42107,ಕೇಳಬಹುದಾದ,0,0,1,1
42106,وبراون،,0,0,1,1
44077,älskling,0,0,1,1
44078,nyheder,0,0,1,1
42105,"
यिद्दी",0,0,1,1
51388,προς,0,0,1,1
44079,dutch,0,0,1,1
42104,смотрели,0,0,1,1
51389,unterbrechen,0,0,1,1
44080,λήμματά,0,0,1,1
51390,राजनीतिक,0,0,1,1
42092,servantes,0,0,1,1
51391,romantisme,0,0,1,1
42100,visioenen,0,0,1,1
42098,ambiguïté,0,0,1,1
42097,കണ്ട,0,0,1,1
42096,landscape,0,0,1,1
51392,вызван,0,0,1,1
42095,apoiam,0,0,1,1
44083,topical,0,0,1,1
44084,aplicables,0,0,1,1
42094,επισκεφτούν,0,0,1,1
42093,fuertes,0,0,1,1
44099,killen,0,0,1,1
51125,podrias,0,0,1,1
42067,രാത്രിയിൽ,0,0,1,1
42037,وكلمات,0,0,1,1
42046,assignment,0,0,1,1
51121,artikelsidan,0,0,1,1
42044,définit,0,0,1,1
42043,förvirra,0,0,1,1
44119,fishing,0,0,1,1
42041,अन्तरजाल,0,0,1,1
51120,compañía,0,0,1,1
42040,ιστοχώρο,0,0,1,1
51119,angesehen,0,0,1,1
42038,noticed,0,0,1,1
44122,izinli,0,0,1,1
42036,kelimedir,0,0,1,1
44118,olayları,0,0,1,1
42035,மாற்றங்கள்’,0,0,1,1
44123,décrit,0,0,1,1
44125,അർത്ഥമാക്കുന്നതിന്,0,0,1,1
51116,ദിവസേന,0,0,1,1
42033,нашу,0,0,1,1
42032,veckan,0,0,1,1
42031,μητέρας,0,0,1,1
51403,выполняя,0,0,1,1
42030,aniden,0,0,1,1
42029,യന്ത്രപഠനത്തെ,0,0,1,1
44127,وfrench،,0,0,1,1
42047,الإصدارات،,0,0,1,1
42049,прецедентов —,0,0,1,1
42066,ನಡತೆ,0,0,1,1
42056,ಹೊಂದಿರುವ,0,0,1,1
51398,licenciés,0,0,1,1
44100,klickt,0,0,1,1
42064,tamamlanmış,0,0,1,1
51399,रिपब्लिक,0,0,1,1
42062,التهنئة,0,0,1,1
51124,caps,0,0,1,1
42059,intelectual —,0,0,1,1
44106,αγαπημένο,0,0,1,1
44107,കൂട്ടായ്മയിൽ,0,0,1,1
44108,définitivement,0,0,1,1
42057,birbirinden,0,0,1,1
42055,மெதுவாகவும்,0,0,1,1
44116,الجماعي،,0,0,1,1
42054,usædvanligt,0,0,1,1
44109,amostragem,0,0,1,1
42053,многослойный,0,0,1,1
42052,ஆடை,0,0,1,1
42051,ചങ്ങാതിമാരും,0,0,1,1
42050,المحررين،,0,0,1,1
44110,expertas,0,0,1,1
44111,aangeboden,0,0,1,1
44112,présidentielle,0,0,1,1
44113,кофе,0,0,1,1
44115,правительственных,0,0,1,1
42108,d’individus,0,0,1,1
42109,mess,0,0,1,1
42110,المكونات,0,0,1,1
42172,droomde,0,0,1,1
44028,trabalhado,0,0,1,1
42182,வளர்ந்த,0,0,1,1
44029,கட்டுரைத்,0,0,1,1
42181,implícita,0,0,1,1
42180,attributes,0,0,1,1
42179,നേടിയെടുക്കാവുന്നതേയുള്ളൂ,0,0,1,1
44031,ονειρευόσασταν,0,0,1,1
44032,беспорядок,0,0,1,1
42175,ethnicities,0,0,1,1
42174,tipografía,0,0,1,1
42173,व्यवसाय,0,0,1,1
42171,terá,0,0,1,1
44026,दलित,0,0,1,1
42170,പറയുകയായിരുന്നു,0,0,1,1
44033,kleines,0,0,1,1
42168,милой,0,0,1,1
42167,हमलों,0,0,1,1
42166,دليل,0,0,1,1
44034,enforce,0,0,1,1
44035,फ्रीडम,0,0,1,1
42165,попрощавшись,0,0,1,1
44036,vandaliserat,0,0,1,1
51138,funciona,0,0,1,1
44038,blandad,0,0,1,1
44027,மீதான,0,0,1,1
44024,gangliaaf,0,0,1,1
42162,അമേരിക്കയിൽ,0,0,1,1
44015,photosynthesis,0,0,1,1
42202,hartstikke,0,0,1,1
42201,exaggerate,0,0,1,1
42200,somalí,0,0,1,1
42199,στρατό,0,0,1,1
44012,يُسمح,0,0,1,1
44013,செய்வதற்கான,0,0,1,1
51141,«истории»,0,0,1,1
42196,truppen,0,0,1,1
51140,bâtir,0,0,1,1
51381,உதவுவீர்கள்,0,0,1,1
44014,faixa,0,0,1,1
42193,atualizado,0,0,1,1
44023,مناقشة,0,0,1,1
44017,erziehen,0,0,1,1
44018,«писатьправить,0,0,1,1
44019,kelimesinden,0,0,1,1
42191,läste,0,0,1,1
44020,engines‏,0,0,1,1
42189,связывания,0,0,1,1
44021,πόλεμο,0,0,1,1
44022,категориям,0,0,1,1
42187,résume,0,0,1,1
51382,कठिन,0,0,1,1
51139,والمتألقة,0,0,1,1
44040,reviendra,0,0,1,1
42161,casarse,0,0,1,1
44075,conferências,0,0,1,1
42121,பார்க்காதபோது,0,0,1,1
42130,политикам,0,0,1,1
44060,örneğinde,0,0,1,1
42129,എവിടെയാണെന്ന്,0,0,1,1
42128,ولكي,0,0,1,1
44061,nationale,0,0,1,1
42127,desmentida,0,0,1,1
42125,wordpresscom,0,0,1,1
44065,எழுதப்பட்டது,0,0,1,1
42124,recouverte,0,0,1,1
51134,değiştirmektedir,0,0,1,1
44067,إثارة,0,0,1,1
44068,verbum,0,0,1,1
44058,uncyclopedia,0,0,1,1
42120,contrastando,0,0,1,1
42119,इयर्स,0,0,1,1
42118,sahipse,0,0,1,1
42117,akademisyenler,0,0,1,1
42116,chimiques,0,0,1,1
44070,единственным,0,0,1,1
42114,spaß,0,0,1,1
44071,dénonçant,0,0,1,1
44073,probabiliste,0,0,1,1
51133,осознание,0,0,1,1
42111,kleding,0,0,1,1
44059,yenilerinin,0,0,1,1
42133,mødested,0,0,1,1
42160,ahnung,0,0,1,1
44046,व्यतीत,0,0,1,1
42159,التقليدية،,0,0,1,1
42158,svårare,0,0,1,1
42155,هارفارد،,0,0,1,1
42154,испанская —,0,0,1,1
42153,yediğim,0,0,1,1
42152,феврале,0,0,1,1
42151,perigosos,0,0,1,1
44044,ഉണ്ടായേക്കാവുന്ന,0,0,1,1
51383,rentrant,0,0,1,1
42150,ഇഷ്ടമാണെന്ന്,0,0,1,1
42149,μιλώντας,0,0,1,1
44047,falhas,0,0,1,1
42134,அழைக்கப்படும்,0,0,1,1
42146,போக,0,0,1,1
42145,beroemde,0,0,1,1
42144,ಕೆಟ್ಟ,0,0,1,1
44049,मार्च,0,0,1,1
51136,kalın,0,0,1,1
42140,ктонибудь,0,0,1,1
42139,instrument,0,0,1,1
44052,textbased,0,0,1,1
42137,நாசீஸின்,0,0,1,1
42136,dudosos,0,0,1,1
44054,അത്ഭുതപ്പെട്ടു,0,0,1,1
44128,மூலையில்,0,0,1,1
51405,πλούσιος,0,0,1,1
44010,kahvenizi,0,0,1,1
42026,ഉപയോക്താക്കളിൽ,0,0,1,1
41910,حاول,0,0,1,1
41909,ಅನುಭವವನ್ನು,0,0,1,1
51108,klas,0,0,1,1
41908,ಅವನಾಗಬಹುದು,0,0,1,1
41907,critère,0,0,1,1
44208,succession,0,0,1,1
41906,സ്വപ്നങ്ങളുടെ,0,0,1,1
51107,nysede,0,0,1,1
44211,contemporaine,0,0,1,1
44213,العشوائي,0,0,1,1
44214,உருவாக்குகிறது,0,0,1,1
41899,മനസ്സും,0,0,1,1
41898,anual,0,0,1,1
41897,düşünün,0,0,1,1
41896,никак,0,0,1,1
41895,—enero,0,0,1,1
41894,സൗകര്യപ്രദമാണ്,0,0,1,1
51428,eventuella,0,0,1,1
41892,nono,0,0,1,1
44217,desarrollados,0,0,1,1
41891,undergoing,0,0,1,1
44218,talenversies,0,0,1,1
41889,எடுத்துக்கொண்டது,0,0,1,1
41888,ಆಸಕ್ತಿಯಿಲ್ಲ,0,0,1,1
44219,அழகை,0,0,1,1
44207,çıkarmanız,0,0,1,1
41911,يصدق,0,0,1,1
41912,methane,0,0,1,1
44203,bedacht,0,0,1,1
44192,devoir,0,0,1,1
44193,எங்காவது,0,0,1,1
44195,اثنين,0,0,1,1
41927,stoppe,0,0,1,1
41926,ek,0,0,1,1
44197,enseignements,0,0,1,1
44198,expresidente,0,0,1,1
44201,സമർപ്പിക്കുക,0,0,1,1
44202,quitte,0,0,1,1
41924,ಚಿಂತಿಸಬೇಡ,0,0,1,1
51420,opportunity,0,0,1,1
41922,åtminstone,0,0,1,1
51109,критерии,0,0,1,1
44204,maestro,0,0,1,1
41921,incompatible,0,0,1,1
41920,chimiste,0,0,1,1
44205,αυτοί,0,0,1,1
41918,resistência,0,0,1,1
41917,தொங்க,0,0,1,1
41916,ഭാഷയിലുള്ള,0,0,1,1
51422,மீளமைக்கவோ,0,0,1,1
51423,anglaises,0,0,1,1
41915,polarisering,0,0,1,1
41914,доступен,0,0,1,1
41887,வழக்குரைஞர்கள்,0,0,1,1
41886,செய்யப்படுகின்றன,0,0,1,1
41885,supernatural,0,0,1,1
51430,ياهو,0,0,1,1
41857,عنوان,0,0,1,1
41856,rig,0,0,1,1
41855,исследовании,0,0,1,1
44243,സുഹൃത്തുക്കളോട്,0,0,1,1
44244,eurocentric,0,0,1,1
41854,soldiers,0,0,1,1
44246,المساعد,0,0,1,1
44247,ವಿವಾಹದ,0,0,1,1
41851,سيتم,0,0,1,1
44248,boşum,0,0,1,1
44250,സന്ദേശങ്ങളിൽ,0,0,1,1
51431,launches,0,0,1,1
41858,​​of,0,0,1,1
41850,verspreiding,0,0,1,1
44251,enslashdot,0,0,1,1
41848,вандализму,0,0,1,1
44252,ptmobilewikipediaorg,0,0,1,1
41846,kullandığında,0,0,1,1
44253,menos—,0,0,1,1
41843,correos,0,0,1,1
44254,cinéaste,0,0,1,1
41842,διεθνής,0,0,1,1
41841,secciones,0,0,1,1
41840,çalışmalarda,0,0,1,1
44241,istediği,0,0,1,1
41859,entornos,0,0,1,1
44220,voetnoten,0,0,1,1
41872,favoriser,0,0,1,1
41883,dérangeraitil,0,0,1,1
41882,probable,0,0,1,1
44221,متوازن,0,0,1,1
41880,சிரமமாக,0,0,1,1
41879,trajet,0,0,1,1
44223,άνθρωπος,0,0,1,1
41876,solide,0,0,1,1
44225,jugar,0,0,1,1
41875,unifiés ,0,0,1,1
41874,demasia,0,0,1,1
41873,नान,0,0,1,1
41870,ಅಳುತ್ತಿದ್ದೀರಿ,0,0,1,1
51429,തമാശ,0,0,1,1
41869,læringen,0,0,1,1
41868,introduzido,0,0,1,1
51103,exhibits,0,0,1,1
51102,إليهم,0,0,1,1
44232,africâner,0,0,1,1
41865,nn •,0,0,1,1
44233,asesino,0,0,1,1
41863,vatikanen,0,0,1,1
41862,ज्यामिति,0,0,1,1
44236,huit,0,0,1,1
51101,mascotas,0,0,1,1
41932,учебник,0,0,1,1
41933,توقفنا,0,0,1,1
44191,operação,0,0,1,1
41995,सहायक,0,0,1,1
42004,الرهيب,0,0,1,1
42003,cuba,0,0,1,1
42002,அனுபவத்தைப்,0,0,1,1
42001,криминального,0,0,1,1
42000,variedad,0,0,1,1
44144,conquistas,0,0,1,1
44145,eins,0,0,1,1
41998,vêlo,0,0,1,1
44146,eons,0,0,1,1
44147,ضخمة,0,0,1,1
44148,servidas,0,0,1,1
44149,göstermiştir,0,0,1,1
51412,belief,0,0,1,1
44151,videodaki,0,0,1,1
44154,ποιότητας,0,0,1,1
41991,ഇറ്റാലിയൻ,0,0,1,1
44155,tegenstrijdige,0,0,1,1
44156,നിങ്ങൾക്കത്,0,0,1,1
41988,പത്രങ്ങൾ,0,0,1,1
44157,schmeckendes,0,0,1,1
51112,സഹായിക്കൂ,0,0,1,1
41986,δύσκολη,0,0,1,1
41985,sentado,0,0,1,1
44159,ಡ್ರಿಂಕ್‌ನೊಂದಿಗೆ,0,0,1,1
42005,llevo,0,0,1,1
44142,используем,0,0,1,1
44161,нетрадиционной,0,0,1,1
44133,problème »,0,0,1,1
51406,சாப்பிடு,0,0,1,1
42024,firent,0,0,1,1
42023,karşısında,0,0,1,1
44131,acadêmico,0,0,1,1
42022,provocerande,0,0,1,1
42021,"
मांक्स",0,0,1,1
44132,бедной,0,0,1,1
51407,കഴിയാത്തതിനാൽ,0,0,1,1
42019,δουλέψεις,0,0,1,1
42018,поле,0,0,1,1
42017,pedras,0,0,1,1
44134,meşguldün,0,0,1,1
42007,ದಿನದಿಂದ,0,0,1,1
44135,javascript,0,0,1,1
42014,verificadores,0,0,1,1
51409,ilustrativa,0,0,1,1
42012,vente,0,0,1,1
42011,زائر،,0,0,1,1
51115,высокого,0,0,1,1
51410,giyinmiş,0,0,1,1
44136,einstellen,0,0,1,1
51114,лицензии,0,0,1,1
44139,κωδικό,0,0,1,1
44141,ആവർത്തനം,0,0,1,1
44160,мнению,0,0,1,1
44162,സ്വർണ്ണത്തിൽ,0,0,1,1
44190,потребность,0,0,1,1
41946,നല്ലവനാണ്,0,0,1,1
44178,المزايا,0,0,1,1
44179,uuu,0,0,1,1
41953,jihadistes,0,0,1,1
41952,βοηθήσεις,0,0,1,1
41951,viaf,0,0,1,1
44181,externas,0,0,1,1
41950,ബന്ധപ്പെട്ടിരിക്കുന്നു,0,0,1,1
41949,frappant,0,0,1,1
44182,amongst,0,0,1,1
44183,ಉತ್ತರಿಸಲು,0,0,1,1
41947,αδιάφορος,0,0,1,1
44184,discordo,0,0,1,1
41958,πρόκειται,0,0,1,1
41945,menino,0,0,1,1
41943,ampliaría,0,0,1,1
41942,git,0,0,1,1
41941,स्लेव,0,0,1,1
41940,shelf,0,0,1,1
44186,"
गैलिसियाई",0,0,1,1
44187,« vigilance,0,0,1,1
41938,केस,0,0,1,1
41937,qualities,0,0,1,1
44188,ಹೊಂದಿದ್ದಾನೆ,0,0,1,1
41936,എന്നെഴുതുന്നു,0,0,1,1
44177,confère »,0,0,1,1
44176,وتحاول,0,0,1,1
41983,проделал,0,0,1,1
44168,вызванной,0,0,1,1
41982,balcony,0,0,1,1
51413,affamé,0,0,1,1
41980,സാമൂഹ്യവിരുദ്ധർ,0,0,1,1
41977,oublie,0,0,1,1
44166,artikelform,0,0,1,1
51414,girlfriend,0,0,1,1
41974,confie,0,0,1,1
51415,langdurig,0,0,1,1
51416,массовое,0,0,1,1
41973,போர்டல்,0,0,1,1
44167,κρατήσουμε,0,0,1,1
44169,arkadaşla,0,0,1,1
41959,образовался,0,0,1,1
41969,वर्षों,0,0,1,1
41967,पांचवीं,0,0,1,1
51417,النسبة,0,0,1,1
41965,механизма,0,0,1,1
41964,hayranlık,0,0,1,1
41963,ഇംഗ്ലീഷ്‌,0,0,1,1
41962,lægge,0,0,1,1
44174,люблю,0,0,1,1
41961,നടത്തുന്നതിനാണ്,0,0,1,1
41960,sänkte,0,0,1,1
44175,нашем,0,0,1,1
42203,предложил,0,0,1,1
42205,eserin,0,0,1,1
42559,تحتل,0,0,1,1
42383,propelling,0,0,1,1
43860,общенаучных,0,0,1,1
43861,başarısız,0,0,1,1
42452,vecteur,0,0,1,1
43863,அமைப்புகளையும்,0,0,1,1
42450,முந்தையவை,0,0,1,1
42449,inferencial,0,0,1,1
42448,«новости»,0,0,1,1
42447,parlant,0,0,1,1
42446,حفلة,0,0,1,1
43864,no»,0,0,1,1
43865,proyectos​,0,0,1,1
51353,roumain,0,0,1,1
43868,നല്ലതാണെന്ന,0,0,1,1
42441,правилам,0,0,1,1
43869,எதிர்மாறாக,0,0,1,1
42440,ബിസിനസ്സ്,0,0,1,1
43870,obligada,0,0,1,1
43871,русскоязычной,0,0,1,1
51354,സങ്കീർണ്ണമായ,0,0,1,1
42437,porção,0,0,1,1
43872,ξεκινήσουμε,0,0,1,1
43873,olagligt,0,0,1,1
43874,மயங்கிவிட்டேன்,0,0,1,1
51355,astra,0,0,1,1
43875,crossbow,0,0,1,1
42454,hızlandı,0,0,1,1
42455,hoşsunuz,0,0,1,1
42456,அவளை,0,0,1,1
42470,المتناقضة,0,0,1,1
43850,compton,0,0,1,1
42479,genéticos,0,0,1,1
42478,विकिसोर्स,0,0,1,1
42477,δυνατής,0,0,1,1
42476,  voitures,0,0,1,1
42475,exposure,0,0,1,1
42474,ಮೆದುಳನ್ನು,0,0,1,1
42473,bone,0,0,1,1
51352,σαλάτες,0,0,1,1
42472,oätligt,0,0,1,1
42471,поддерживаемые,0,0,1,1
42469,بملكية,0,0,1,1
42458,പങ്കെടുക്കുമ്പോൾ,0,0,1,1
42468,wonder,0,0,1,1
43855,sorudan,0,0,1,1
42467,snabbare,0,0,1,1
42466,euros,0,0,1,1
42465,incierto,0,0,1,1
43856,« immanente » ,0,0,1,1
43857,conversely,0,0,1,1
42462,نسخها,0,0,1,1
42461,распечатал,0,0,1,1
42460,ஆள்களப்,0,0,1,1
42459,بدت,0,0,1,1
42433,يكرر,0,0,1,1
43877,ಆಶ್ಚರ್ಯಚಕಿತರಾದರು,0,0,1,1
43878,நடத்தை,0,0,1,1
43895,zus,0,0,1,1
43890,funktionsprincip,0,0,1,1
42403,englen,0,0,1,1
42402,narsizaydı,0,0,1,1
42401,تفسرها,0,0,1,1
42400,repræsenteret,0,0,1,1
43891,monta,0,0,1,1
43892,المستقلة,0,0,1,1
42398,château,0,0,1,1
43894,gratitude,0,0,1,1
42396,citada,0,0,1,1
42395,freshwater,0,0,1,1
42393,ಸಹಾಯಕವಾಗಿದೆಯೆ,0,0,1,1
43889,أخرى؟,0,0,1,1
42392,cometió,0,0,1,1
43897,навестить,0,0,1,1
43898,pedanteri,0,0,1,1
42390,wilderness—wild,0,0,1,1
42389,leckeren,0,0,1,1
42388,εργασίας,0,0,1,1
51361,d’adaptation,0,0,1,1
42387,வழங்கப்பட்டுக்,0,0,1,1
51166,ركضت,0,0,1,1
42386,طرف,0,0,1,1
51165,краткое,0,0,1,1
42405,reformed,0,0,1,1
42407,nyskapade,0,0,1,1
42431,общественным,0,0,1,1
42419,nat,0,0,1,1
42429,durdurduk,0,0,1,1
43879,separado,0,0,1,1
42427,mercury,0,0,1,1
42426,hatalı,0,0,1,1
51357,البحث,0,0,1,1
43880,அழைப்பில்,0,0,1,1
42423,lapso,0,0,1,1
43881,സ്ഥലത്തെ,0,0,1,1
43882,பிரிட்டானிக்கா,0,0,1,1
42421,साथी,0,0,1,1
42420,sınavda,0,0,1,1
42418,गैरलाभकारी,0,0,1,1
51360,выпустило,0,0,1,1
43883,തുടർന്നുള്ള,0,0,1,1
42416,உருவாக்கப்பட்டது,0,0,1,1
42415,تفسيراتهم,0,0,1,1
51358,πρόσωπο,0,0,1,1
42414,собственных,0,0,1,1
51359,vanmorgen,0,0,1,1
51167,analistas,0,0,1,1
42412,arrangeras,0,0,1,1
42411,verifiera,0,0,1,1
43888,കണക്കാക്കപ്പെടുന്നുവിക്കിസോഫ്‌റ്റ്‌വെയർ,0,0,1,1
42408,stumpfer,0,0,1,1
43849,undersökningsgruppen,0,0,1,1
43848,പറഞ്ഞുകൊണ്ട്,0,0,1,1
43847,d’administration,0,0,1,1
42527,സ്വർണ്ണം,0,0,1,1
42538,beynimizi,0,0,1,1
42537,navegava,0,0,1,1
42536,إدارة,0,0,1,1
42535,voltaire,0,0,1,1
42533,पीपुल्स,0,0,1,1
43800,έθιμα,0,0,1,1
42532,याचना,0,0,1,1
43801,оценено,0,0,1,1
42530,ट्रांसक्लुजन,0,0,1,1
42529,tax”,0,0,1,1
42528,temporary,0,0,1,1
42526,прилагающаяся,0,0,1,1
42539,intervalos,0,0,1,1
43802,robótica,0,0,1,1
43803,pests,0,0,1,1
51342,muñeca,0,0,1,1
43804,панорамы,0,0,1,1
51343,πάρτι,0,0,1,1
51173,tragt,0,0,1,1
43806,धीरे,0,0,1,1
42524,கிடைக்கவேண்டும்”,0,0,1,1
43807,ನಿಧಾನಗತಿಯಲ್ಲಿ,0,0,1,1
43808,വിലയില്ല,0,0,1,1
51172,fehlern,0,0,1,1
51339,diagrams,0,0,1,1
42540,emploient ,0,0,1,1
43811,stycken,0,0,1,1
43791,നിർമ്മാണപഠന,0,0,1,1
43788,« youtube »,0,0,1,1
42557,yaparsın,0,0,1,1
43789,especializados,0,0,1,1
42556,ρόλους,0,0,1,1
42555,"
क्वैचुआ",0,0,1,1
42554,corner,0,0,1,1
42553,verloren,0,0,1,1
42552,rejection,0,0,1,1
42551,adapter,0,0,1,1
51174,koştu,0,0,1,1
42549,recevoir,0,0,1,1
43792,exprimées,0,0,1,1
42541,أنف,0,0,1,1
43793,brute,0,0,1,1
42547,مستويات,0,0,1,1
43794,détermine,0,0,1,1
43795,പൊതുവായതും,0,0,1,1
42546,попали,0,0,1,1
42545,majeur ,0,0,1,1
51335,legitimiteten,0,0,1,1
51337,обучению,0,0,1,1
43797,progressive,0,0,1,1
51338,ஏற்படுத்துவதைத்,0,0,1,1
43798,കണ്ടെത്തുന്ന,0,0,1,1
43810,обсуждения,0,0,1,1
43812,பயன்படுத்தித்,0,0,1,1
42480,قانونين,0,0,1,1
51347,citadas,0,0,1,1
42501,πατώντας,0,0,1,1
42499,உரிமை,0,0,1,1
42498,وثقافة,0,0,1,1
43833,divulgou,0,0,1,1
43834,ಪರಸ್ಪರ,0,0,1,1
51170,ചുറ്റും,0,0,1,1
42494,സന്ദേശങ്ങളെ,0,0,1,1
43835,parar,0,0,1,1
42492,للمحتوى,0,0,1,1
43836,dummer,0,0,1,1
42491,tuzu,0,0,1,1
43837,başarılı,0,0,1,1
43830,británica»,0,0,1,1
42490,വിവാഹ,0,0,1,1
51348,sunmaya,0,0,1,1
43838,घबराए,0,0,1,1
42487,reptiles,0,0,1,1
51349,conocía,0,0,1,1
43840,الاصطناعي,0,0,1,1
42485,цифрового,0,0,1,1
42483,gorilas,0,0,1,1
43842,mirent,0,0,1,1
43843,سيول,0,0,1,1
43844,الفزع,0,0,1,1
51345,нарцису,0,0,1,1
43828,دائم,0,0,1,1
42520,yalnızca,0,0,1,1
42513,கடி,0,0,1,1
51344,остановить,0,0,1,1
42519,«получение,0,0,1,1
42518,highquality,0,0,1,1
43814,utgångspunkt,0,0,1,1
42517,приходили,0,0,1,1
42516,typographie,0,0,1,1
43815,geçmişinden,0,0,1,1
51171,artful,0,0,1,1
42514,hr •,0,0,1,1
43817,especie,0,0,1,1
43819,complutense,0,0,1,1
43820,slag,0,0,1,1
43827,зачем,0,0,1,1
42511,рунете —,0,0,1,1
42510,പ്രവർത്തനങ്ങളിൽ,0,0,1,1
43821,troupes,0,0,1,1
42508,formatering,0,0,1,1
43822,вышла,0,0,1,1
42507,minimize,0,0,1,1
42506,вкусных,0,0,1,1
42505,contaba,0,0,1,1
43825,ಒಲವು,0,0,1,1
42504,interviennent,0,0,1,1
43826,solely,0,0,1,1
43899,ಅನುಮಾನಕ್ಕೆ,0,0,1,1
42381,спала,0,0,1,1
44009,demandais,0,0,1,1
51163,μηεγκυκλοπαιδικούς,0,0,1,1
43971,konudaki,0,0,1,1
42272,favoriniz,0,0,1,1
51150,गैलिक,0,0,1,1
43973,iniciar,0,0,1,1
43974,المائدة,0,0,1,1
42269,génèrent,0,0,1,1
51148,emeğiniz,0,0,1,1
42266,التعليمات,0,0,1,1
42265,diminishing,0,0,1,1
43978,thema,0,0,1,1
42264,மனமார்ந்த,0,0,1,1
42263,பொருந்தக்கூடிய,0,0,1,1
42262,شكر,0,0,1,1
43979,फंसेंगे,0,0,1,1
42260,araştırmada,0,0,1,1
42259,затопленный,0,0,1,1
43981,ننظر,0,0,1,1
51147,എനർജി,0,0,1,1
43983,kuşunki,0,0,1,1
43984,deformational,0,0,1,1
43985,teklifini,0,0,1,1
43986,سبتمبر,0,0,1,1
42254,забавное,0,0,1,1
42253,போர்ட்டலுக்குள்,0,0,1,1
42252,ന്നിപ്പറയുന്നത്,0,0,1,1
42274,рассказ,0,0,1,1
43970,mıyım,0,0,1,1
43969,encoded,0,0,1,1
43965,обходительный,0,0,1,1
43961,polysémique,0,0,1,1
42297,inlägg,0,0,1,1
42296,تسعة,0,0,1,1
43962,klingon,0,0,1,1
42294,"
टोंगीयाई",0,0,1,1
42292,individer,0,0,1,1
42291,قيودًا,0,0,1,1
42290,языковыми,0,0,1,1
42289,election,0,0,1,1
42288,बँधा,0,0,1,1
42287,скрещенные,0,0,1,1
42286,communitywide,0,0,1,1
43968,கற்றலைத்,0,0,1,1
51372,kommunistiska,0,0,1,1
42285,ആകുവാൻ,0,0,1,1
42284,الأراضي,0,0,1,1
42283,октябрю,0,0,1,1
42282,вероятностью,0,0,1,1
42281,सम्पूर्ण,0,0,1,1
42280,இருந்தனர்,0,0,1,1
42279,vrijwillige,0,0,1,1
42278,أليكسا,0,0,1,1
42277,creëren,0,0,1,1
42276,choices,0,0,1,1
51374,нечисловыми,0,0,1,1
51375,ആരുണ്ടാക്കി,0,0,1,1
42249,samengewerkt,0,0,1,1
51380,provision,0,0,1,1
42226,realización,0,0,1,1
44000,played,0,0,1,1
42224,objects—the,0,0,1,1
51378,strenge,0,0,1,1
51142,erstaunlichste,0,0,1,1
42221,выборе,0,0,1,1
44002,പത്തുവാചകം,0,0,1,1
42220,qu’une,0,0,1,1
44003,يتعلَّم,0,0,1,1
42219,exactitude,0,0,1,1
42218,ressources,0,0,1,1
42217,وراء,0,0,1,1
43999,artikelämnen,0,0,1,1
44004,руководствуются,0,0,1,1
42215,исследователь,0,0,1,1
42214,رد,0,0,1,1
42213,нос,0,0,1,1
44005,médiathèque,0,0,1,1
42212,underbar,0,0,1,1
44006,bakayım,0,0,1,1
42210,φύσης,0,0,1,1
42209,skriverier,0,0,1,1
44007,सबस्क्रिप्शनओनली,0,0,1,1
42207,редактируемой,0,0,1,1
42227,«зверство»,0,0,1,1
42229,καν,0,0,1,1
43987,ಯಾರೋ,0,0,1,1
42238,ντυμένος,0,0,1,1
42248,ചാലക്കുടി,0,0,1,1
42247,ಅದ್ಭುತವಾಗಿ,0,0,1,1
42245,volgt,0,0,1,1
43989,fondamental,0,0,1,1
42244,llevadas,0,0,1,1
42243,ಹಲೋ,0,0,1,1
42242,sachez,0,0,1,1
43990,программные,0,0,1,1
42240,rubin,0,0,1,1
43991,recurre,0,0,1,1
42239,remuneradas,0,0,1,1
51145,högsta,0,0,1,1
42230,أمره,0,0,1,1
42236,bakışları,0,0,1,1
43993,إشارة,0,0,1,1
51144,"
रूसिन",0,0,1,1
42235,crudivorismo,0,0,1,1
43995,stapt,0,0,1,1
42233,nacheinander,0,0,1,1
42232,நன்றாகச்,0,0,1,1
51143,war •,0,0,1,1
43997,അൽഗോരിതം,0,0,1,1
43998,ഫിക്സ്,0,0,1,1
51377,ചോദ്യമാണ്,0,0,1,1
42299,générales,0,0,1,1
43960,urban,0,0,1,1
51151,enfiar,0,0,1,1
42350,கோணமாகும்,0,0,1,1
42359,равен,0,0,1,1
42357,ಹಸಿದಿದ್ದೇನೆ,0,0,1,1
43913,compraram,0,0,1,1
42356,excités,0,0,1,1
42355,അപേക്ഷിച്ച്,0,0,1,1
42354,писатель,0,0,1,1
51362,تشغلها,0,0,1,1
43914,കുറവല്ല,0,0,1,1
42353,mécaniques,0,0,1,1
42352,idioma»,0,0,1,1
43916,semenciers,0,0,1,1
42349,sphère,0,0,1,1
42361,πρόσβασής,0,0,1,1
43917,informan,0,0,1,1
43918,اختلاف,0,0,1,1
51363,ആരെയോ,0,0,1,1
42346,refleksion,0,0,1,1
42345,lisent,0,0,1,1
42344,violações,0,0,1,1
42343,الطلبات,0,0,1,1
43920,السبب,0,0,1,1
51364,ومتطور,0,0,1,1
42341,ನಕಾರಾತ್ಮಕ,0,0,1,1
42340,للاهتمام,0,0,1,1
42360,radicalement,0,0,1,1
42362,extensiones,0,0,1,1
43921,minam,0,0,1,1
43909,survives,0,0,1,1
51162,castle,0,0,1,1
43902,respecta,0,0,1,1
42378,திட்டமாகவும்,0,0,1,1
43903,lyden,0,0,1,1
42375,yoluna,0,0,1,1
43904,ترميز,0,0,1,1
51161,ಬೇಕಾಗಿಲ್ಲ,0,0,1,1
43907,uzaklaştılar,0,0,1,1
42374,primária,0,0,1,1
43908,учитель,0,0,1,1
42373,«abrió,0,0,1,1
42372,இணையதளம்,0,0,1,1
43912,adivinhado,0,0,1,1
43910,ഹാംഗ്,0,0,1,1
42371,buchstäblich,0,0,1,1
42370,மொழிக்,0,0,1,1
42369,pregunto,0,0,1,1
42368,civiles,0,0,1,1
42367,pedagogos,0,0,1,1
42366,tic,0,0,1,1
42365,véhicule,0,0,1,1
51160,περιθώριο,0,0,1,1
42364,asociado,0,0,1,1
42363,traeré,0,0,1,1
42339,തടസ്സപ്പെടുത്തിയതിൽ,0,0,1,1
43922,प्रगति,0,0,1,1
42300,इकलौती,0,0,1,1
43948,ξύπνησα,0,0,1,1
43942,severos,0,0,1,1
43943,المتوازنة,0,0,1,1
42314,sağlar,0,0,1,1
43944,الاصابع,0,0,1,1
43945,दबाव,0,0,1,1
42313,ತೀವ್ರ,0,0,1,1
42312,dvs,0,0,1,1
43947,acımasızca,0,0,1,1
42311,mall,0,0,1,1
42310,ನಿಲ್ಲಿಸಿದಂತೆ,0,0,1,1
42309,വാങ്ങാൻ,0,0,1,1
42308,задаваемых,0,0,1,1
51369,позволяло,0,0,1,1
43949,لعقد,0,0,1,1
42307,വിവരത്തെ,0,0,1,1
43950,കൃത്യമായി,0,0,1,1
43951,renovar,0,0,1,1
43953,ağlamasın,0,0,1,1
42305,दूं,0,0,1,1
42304,conjunction,0,0,1,1
42303,semestre,0,0,1,1
42302,கேள்விப்பட்டிருக்கிறேன்,0,0,1,1
43955,അത്തരത്തിൽ,0,0,1,1
43958,குறிப்பிடவில்லை,0,0,1,1
43941,envolvidas,0,0,1,1
42316,«espejos»—,0,0,1,1
42338,തലയിൽ,0,0,1,1
42326,anarchism,0,0,1,1
43923,സ്കൂൾ,0,0,1,1
42335,τηλεφωνική,0,0,1,1
43924,dagar,0,0,1,1
42334,tayyip,0,0,1,1
42333,followup,0,0,1,1
42332,blinkede,0,0,1,1
43925,तिहाई,0,0,1,1
42330,рисунками,0,0,1,1
43927,जोड़ेंविकिपीडिया,0,0,1,1
43928,защиты,0,0,1,1
42327,يتعلق,0,0,1,1
51155,conseguirá,0,0,1,1
51152,aboutit,0,0,1,1
51154,officiële,0,0,1,1
51153,regardé,0,0,1,1
43934,കോട്ട,0,0,1,1
43935,vanligen,0,0,1,1
42322,وتعددت,0,0,1,1
43936,التنبيهات,0,0,1,1
43937,имела,0,0,1,1
43938,المضيفون،,0,0,1,1
42319,редактор,0,0,1,1
42318,samarbetar,0,0,1,1
42317,बहुभाषी,0,0,1,1
40382,télévisé,0,0,1,1
45281,complaining,0,0,1,1
40381,यूरोपीय,0,0,1,1
46614,videodur,0,0,1,1
50778,photographique,0,0,1,1
38455,es •,0,0,1,1
38454,starte,0,0,1,1
38453,"
सिसलीयाई",0,0,1,1
38452,العلاجات,0,0,1,1
51939,colaboradores—,0,0,1,1
51940,ചതുപ്പ്,0,0,1,1
38451,पूर्वाग्रहों,0,0,1,1
46631,க்மாட்டை,0,0,1,1
46632,langsame,0,0,1,1
46634,நடித்த,0,0,1,1
38449,solitude,0,0,1,1
38448,некоторое,0,0,1,1
38447,ಪದಕ್ಕೆ,0,0,1,1
46635,المصرفي,0,0,1,1
51941,estudiante​,0,0,1,1
46636,desacordo,0,0,1,1
38446,செயல்களைப்,0,0,1,1
50777,дням,0,0,1,1
38445,denoising,0,0,1,1
46638,espinoza,0,0,1,1
38443,zazaki,0,0,1,1
46639,soruyor,0,0,1,1
46640,कैचिंग,0,0,1,1
46642,arrays,0,0,1,1
46629,ആഗ്രഹിക്കുന്നത്,0,0,1,1
46627,reconhecida,0,0,1,1
38459,nyttige,0,0,1,1
51938,palats,0,0,1,1
46615,geest,0,0,1,1
38476,discernible,0,0,1,1
38475,stødende,0,0,1,1
46617,എല്ലാക്കാലവും,0,0,1,1
38474,crédito,0,0,1,1
51937,​​en,0,0,1,1
46618,envers,0,0,1,1
38472,kökenine,0,0,1,1
38471,reflect,0,0,1,1
38470,privée,0,0,1,1
46619,வந்தார்கள்,0,0,1,1
46620,sou,0,0,1,1
46626,முக்கிய,0,0,1,1
38469,primitif,0,0,1,1
46622,burro,0,0,1,1
50780,وقبل,0,0,1,1
38467,vermuten,0,0,1,1
38466,ಮಾತನಾಡುವ,0,0,1,1
38465,cenas,0,0,1,1
50779,satmanı,0,0,1,1
38464,പറയുമ്പോൾ,0,0,1,1
38462,conquistado,0,0,1,1
46624,bredt,0,0,1,1
46625,ഉപയോക്താവിനെ,0,0,1,1
38439,dialects,0,0,1,1
38438,​​dette,0,0,1,1
38437,الأكاديمية,0,0,1,1
38405,نتيجة,0,0,1,1
38413,ಯು,0,0,1,1
38412,vue »,0,0,1,1
38411,википе́дия,0,0,1,1
46658,കൈവരിക്കാൻ,0,0,1,1
46659,απόψεων,0,0,1,1
38409,forests,0,0,1,1
38408,περιβάλλουν,0,0,1,1
50772,« décrire,0,0,1,1
38407,formål,0,0,1,1
38406,वॉन,0,0,1,1
51947,morrendo,0,0,1,1
46662,lithify,0,0,1,1
50773,милыми,0,0,1,1
50771,sabedoria,0,0,1,1
38403,handlinger,0,0,1,1
46664,meertalige,0,0,1,1
51948,പറയാമോ,0,0,1,1
46665,राजनितिक,0,0,1,1
46666,редакторы,0,0,1,1
38402,новейший,0,0,1,1
46667,விக்கிப்பீடியாகாம்,0,0,1,1
46669,syster,0,0,1,1
38400,saberia,0,0,1,1
51949,overmatige,0,0,1,1
46657,saute,0,0,1,1
51945,uppifrån,0,0,1,1
38436,அறைக்குள்,0,0,1,1
38426,réf,0,0,1,1
46643,reparieren,0,0,1,1
38434,deliberately,0,0,1,1
38433,പദത്തിന്,0,0,1,1
51943,şeyleri,0,0,1,1
38432,والرجل,0,0,1,1
46644,തീരുമാനിച്ച്,0,0,1,1
38431,underhållande,0,0,1,1
38430,नवाचार,0,0,1,1
38429,våren,0,0,1,1
38428,unterschiedlichen,0,0,1,1
38427,öfkeliydi,0,0,1,1
46645,выдал,0,0,1,1
38416,व्यवहार,0,0,1,1
38425,misslyckanden,0,0,1,1
46646,व्यस्तता,0,0,1,1
46647,применения,0,0,1,1
38424,நொடியில்,0,0,1,1
38423,implementatie,0,0,1,1
38421,çoğalmıştır,0,0,1,1
46648,geldim,0,0,1,1
46649,റൂമിലേക്ക്,0,0,1,1
46651,مقالاته,0,0,1,1
46654,otobüsümüz,0,0,1,1
38417,рецензированы,0,0,1,1
38477,सीखें,0,0,1,1
50782,niche,0,0,1,1
38940,maastricht,0,0,1,1
38478,comestible,0,0,1,1
46568,enfatizando,0,0,1,1
38545,ಮಂಚದ,0,0,1,1
38544,देंगे।,0,0,1,1
46569,fart,0,0,1,1
38543,манеры,0,0,1,1
46570,انطلق,0,0,1,1
38542,subvenciones,0,0,1,1
46571,ഉപയോക്താക്കളുടെ,0,0,1,1
38541,allemagne,0,0,1,1
38540,saldırıya,0,0,1,1
46572,accusent,0,0,1,1
38538,ambicioso,0,0,1,1
38537,विकिवर्सिटी,0,0,1,1
46573,parisnanterre,0,0,1,1
38535,disposer,0,0,1,1
46574,genomineerd,0,0,1,1
46575,மூளை,0,0,1,1
46576,угрозами,0,0,1,1
38531,للقوانين,0,0,1,1
46578,fågel,0,0,1,1
38529,caras,0,0,1,1
38528,ನೋಡುತ್ತಿದ್ದರೆ,0,0,1,1
38527,drop,0,0,1,1
38526,расположенных,0,0,1,1
38525,isolées,0,0,1,1
46566,ही।,0,0,1,1
38549,sauvegarde,0,0,1,1
38550,ಬಂದಿದೆಯೆಂದರೆ,0,0,1,1
46559,высмеивают,0,0,1,1
46552,vagueness,0,0,1,1
46553,ними,0,0,1,1
38573,perfecte,0,0,1,1
38572,ഉൾപ്പെടെ,0,0,1,1
38571,அமைப்பதாக,0,0,1,1
50786,ആക്യുറസി,0,0,1,1
38569,pos,0,0,1,1
38567,plagiarizing,0,0,1,1
38566,moeilijke,0,0,1,1
46557,directives,0,0,1,1
46558,wetenschappen,0,0,1,1
46560,keuzes,0,0,1,1
38551,വൃത്തികെട്ട,0,0,1,1
46562,जावा,0,0,1,1
38563,"
इस्परान्तो",0,0,1,1
38562,बराक,0,0,1,1
51927,parmakları,0,0,1,1
38559,الظهيرة,0,0,1,1
38558,ateliers,0,0,1,1
38557,"
हंगेरियाई",0,0,1,1
38556,ಪ್ರಶ್ನೆಗಳಿಗೆ,0,0,1,1
46564,ಎನರ್ಜಿ,0,0,1,1
51928,götürürüm,0,0,1,1
38552,издавался,0,0,1,1
46579,உங்களுடைய,0,0,1,1
46582,filipino,0,0,1,1
38522,аннотируя,0,0,1,1
38486,expansions,0,0,1,1
46599,இரண்டாம்,0,0,1,1
46600,condenou,0,0,1,1
38496,revisados,0,0,1,1
51934,محظوظًا,0,0,1,1
38494,isterdim,0,0,1,1
38493,mêmes,0,0,1,1
38490,frontend,0,0,1,1
38489,magisteruppsats,0,0,1,1
38488,страницах,0,0,1,1
46603,വിയോജിക്കുന്നു,0,0,1,1
46604,coutumes,0,0,1,1
38485,ആദ്യതാളിൽ,0,0,1,1
46598,liever,0,0,1,1
38484,بالنساء,0,0,1,1
46605,uppgifterna,0,0,1,1
46606,ಕೇಳುತ್ತಿದ್ದರೆ,0,0,1,1
50783,tercümelerine,0,0,1,1
51936,എമ്മിൽ,0,0,1,1
38481,lagar,0,0,1,1
46608,confondu,0,0,1,1
46611,inúmeras,0,0,1,1
46612,représenter,0,0,1,1
46613,acabará,0,0,1,1
38479,comets,0,0,1,1
38497,dispostos,0,0,1,1
46597,التعديل,0,0,1,1
46585,secretamente,0,0,1,1
46591,ht •,0,0,1,1
38519,usability,0,0,1,1
46587,награду,0,0,1,1
50784,turkiet,0,0,1,1
38517,nås,0,0,1,1
46588,congé,0,0,1,1
38515,നിയോഗിക്കുന്ന,0,0,1,1
38514,ಗೊಂದಲಗೊಳಿಸುವುದು,0,0,1,1
38512,എന്നിവയിൽ,0,0,1,1
46589,sistem,0,0,1,1
38510,épidémique,0,0,1,1
46590,δουλέψτε,0,0,1,1
38508,omfattande,0,0,1,1
51933,inicio,0,0,1,1
38506,ledde,0,0,1,1
38505,namorado,0,0,1,1
38504,vivia,0,0,1,1
46593,« instruction »,0,0,1,1
38503,المجتمعية،,0,0,1,1
38502,обсерватории»,0,0,1,1
46594,النتيجة,0,0,1,1
38501,முதற்பக்கத்தில்,0,0,1,1
46595,offensant,0,0,1,1
38500,cérebro,0,0,1,1
38499,जानवर,0,0,1,1
46670,bodde,0,0,1,1
46671,സ്വാഭാവികമായും,0,0,1,1
38398,عالية,0,0,1,1
46672,månader,0,0,1,1
51971,ಸೂಚನೆಗಳನ್ನು,0,0,1,1
46750,ickeengelska,0,0,1,1
46753,முனைப்பான,0,0,1,1
38289,ಪ್ರತಿಕ್ರಿಯಿಸಲು,0,0,1,1
38288,misleidende,0,0,1,1
46754,accounts,0,0,1,1
46755,incredible,0,0,1,1
38286,noun,0,0,1,1
46758,verebilirsin,0,0,1,1
38284,« proches,0,0,1,1
38283,பயனுள்ள,0,0,1,1
38282,normales,0,0,1,1
46760,constitutionnelle,0,0,1,1
38281,مفيدًا,0,0,1,1
50754,dira,0,0,1,1
46762,главной,0,0,1,1
51972,ರೂಪಿಸುತ್ತಿದ್ದೇನೆ,0,0,1,1
38279,lees,0,0,1,1
38278,плачет,0,0,1,1
46763,suffisante,0,0,1,1
46765,قناتي,0,0,1,1
46766,vand,0,0,1,1
38274,അമേരിക്കക്കാരനായ,0,0,1,1
46767,ವಸ್ತುಗಳು,0,0,1,1
38273,affecting,0,0,1,1
38294,नमक,0,0,1,1
46748,британской,0,0,1,1
38295,divulgadas,0,0,1,1
38306,tembelleştiriyor,0,0,1,1
51966,pies,0,0,1,1
38315,tilbageværende,0,0,1,1
38314,bakgrund,0,0,1,1
46736,приобретала,0,0,1,1
38313,çeviri,0,0,1,1
38311,перелицензировать,0,0,1,1
46738,sucedidas,0,0,1,1
46740,σχέση,0,0,1,1
38310,മന്ദഗതിയിലായിരുന്നു,0,0,1,1
38309,contributos,0,0,1,1
46741,ಶ್ರಮವಹಿಸಬೇಕೆಂದು,0,0,1,1
50756,søde,0,0,1,1
38296,مهتمًا,0,0,1,1
51967,retoma,0,0,1,1
38305,விளக்குங்கள்,0,0,1,1
51968,επικριθεί,0,0,1,1
38303,δέκα,0,0,1,1
38302,தொகுக்கக்கூடியவாறு,0,0,1,1
38301,планировалось,0,0,1,1
38300,ಪಕ್ಕದಲ್ಲಿರುವ,0,0,1,1
38299,بالمحتوى,0,0,1,1
51969,अंग्रेजीभाषा,0,0,1,1
46745,proíbem,0,0,1,1
51970,numérique »,0,0,1,1
46768,ആരംഭിച്ചത്‌,0,0,1,1
46769,പ്രശ്നങ്ങളെ,0,0,1,1
46770,saken,0,0,1,1
38243,«андрушевской,0,0,1,1
46805,വകതിരിക്കാൻ,0,0,1,1
46806,redaktörer,0,0,1,1
46808,தயாராகிவிட்டேன்,0,0,1,1
46809,polerad,0,0,1,1
46810,dictionaries,0,0,1,1
38248,прогнозирования,0,0,1,1
46811,иными,0,0,1,1
38247,абсолютно,0,0,1,1
38246,igualmente,0,0,1,1
38245,கற்றுக்கொள்ளப்,0,0,1,1
46812,ಕುಳಿತಳು,0,0,1,1
38242,статей»,0,0,1,1
46802,discordando,0,0,1,1
46813,eo •,0,0,1,1
46814,വെള്ളപ്പൊക്കം,0,0,1,1
38241,juxtaposition,0,0,1,1
46815,وإحلال,0,0,1,1
46817,survived,0,0,1,1
51978,rentré,0,0,1,1
46818,ഇരിക്കുന്ന,0,0,1,1
46819,κάντε,0,0,1,1
46820,buluşmaya,0,0,1,1
38239,выборки —,0,0,1,1
46822,കാഴ്ച,0,0,1,1
46803,alison,0,0,1,1
38252,utilisons,0,0,1,1
46771,இதுவரை,0,0,1,1
38261,dissected,0,0,1,1
46773,fusión,0,0,1,1
38269,yapmanın,0,0,1,1
38268,misspellings,0,0,1,1
46775,intimidatorias,0,0,1,1
46776,внесённые,0,0,1,1
50753,staring,0,0,1,1
46782,exato,0,0,1,1
38265,neiging,0,0,1,1
38264,एडिटोरिअल,0,0,1,1
38263,सोचते,0,0,1,1
38262,востребованным»,0,0,1,1
38260,cumulant,0,0,1,1
51976,неопытных,0,0,1,1
46786,തുടങ്ങുവാനോ,0,0,1,1
46787,γαλλία,0,0,1,1
38259,நாசீசஸ்,0,0,1,1
46788,στάση,0,0,1,1
46789,चयन,0,0,1,1
46790,ആണി,0,0,1,1
46791,неоднократно,0,0,1,1
46794,യോജിക്കുന്നു,0,0,1,1
46795,tvivl,0,0,1,1
50751,intellectuel,0,0,1,1
38255,théorique,0,0,1,1
38317,avsedda,0,0,1,1
51965,καταλάβω,0,0,1,1
46735,ajoutant,0,0,1,1
38365,وقتًا,0,0,1,1
46688,observateurs,0,0,1,1
38374,editando,0,0,1,1
38373,കനത്ത,0,0,1,1
46689,обязательно,0,0,1,1
50767,ingetrokken,0,0,1,1
46690,åbne,0,0,1,1
38370,रायटर्स,0,0,1,1
38369,arcade,0,0,1,1
38368,kop,0,0,1,1
38367,rundt,0,0,1,1
38366,unbalanced,0,0,1,1
38364,ascendieron,0,0,1,1
50768,التعليم,0,0,1,1
46691,передаётся,0,0,1,1
38363,assar,0,0,1,1
38362,fill,0,0,1,1
38361,متحمسون,0,0,1,1
38360,figurant,0,0,1,1
50765,كوب,0,0,1,1
46694,بعضهما,0,0,1,1
38358,independiente,0,0,1,1
38357,travail »,0,0,1,1
46695,magst,0,0,1,1
38355,книгах,0,0,1,1
46687,ευφυή,0,0,1,1
38376,redigeringsgränssnitt,0,0,1,1
51955,обама,0,0,1,1
46682,ತಿಳಿದಿರಬೇಕು,0,0,1,1
38396,originalomslaget,0,0,1,1
46673,intervalle,0,0,1,1
38394,fatos,0,0,1,1
50770,typique,0,0,1,1
46675,τρίμηνο,0,0,1,1
38393,ಬದಲಿಗೆ,0,0,1,1
38392,будущая,0,0,1,1
50769,छींक,0,0,1,1
38391,toepassing,0,0,1,1
38390,zeneca,0,0,1,1
46681,ಒಳ್ಳೆಯವರು,0,0,1,1
46683,داخلية,0,0,1,1
38379,londinense,0,0,1,1
51953,неявную,0,0,1,1
46684,сайтов,0,0,1,1
38387,progresser,0,0,1,1
46685,inverificáveis,0,0,1,1
38386,diseñada,0,0,1,1
38385,പരിശീലന,0,0,1,1
46686,averió,0,0,1,1
38384,érudition,0,0,1,1
38383,रैंक,0,0,1,1
38381,eliminadores,0,0,1,1
38380,följt,0,0,1,1
46696,والبرتغالية,0,0,1,1
46697,പരിഗണനയും,0,0,1,1
50758,vus,0,0,1,1
51962,shell—including,0,0,1,1
38332,"
volapuque",0,0,1,1
38331,ಉಲ್ಲೇಖಿಸಿಲ್ಲ,0,0,1,1
46718,customs,0,0,1,1
38330,compréhensive,0,0,1,1
46719,configuration,0,0,1,1
50762,trabajadora,0,0,1,1
50761,सोचिए,0,0,1,1
51961,decidió,0,0,1,1
46726,وقانون,0,0,1,1
46727,patatas,0,0,1,1
38326,சாப்பிடக்கூடிய,0,0,1,1
38325,persons,0,0,1,1
46715,சொல்லக்கூடிய,0,0,1,1
38324,ubiquiste,0,0,1,1
38323,ender,0,0,1,1
46730,semantisk,0,0,1,1
46731,tends,0,0,1,1
38322,circuits,0,0,1,1
46732,பயன்படுத்துகிறோம்,0,0,1,1
51963,നാർസിസയുടെ,0,0,1,1
38319,meeste,0,0,1,1
38318,الفشل,0,0,1,1
51964,« wikipédia,0,0,1,1
46733,noie,0,0,1,1
46716,finalidade,0,0,1,1
38333,pushing,0,0,1,1
46698,estén,0,0,1,1
46705,excluílas,0,0,1,1
46699,omstridte,0,0,1,1
38350,وترى,0,0,1,1
38348,strategisk,0,0,1,1
38347,βιβλιογραφία,0,0,1,1
38346,редакционных,0,0,1,1
38345,εξυπηρετούν,0,0,1,1
50764,القائمون,0,0,1,1
46701,प्रयास।,0,0,1,1
38343,ಬಳಕೆಗಾಗಿ,0,0,1,1
51956,അസ്വസ്ഥനാകരുതെന്ന്,0,0,1,1
46704,உருவாக்கியிருப்பர்,0,0,1,1
46706,फिलोसोफी,0,0,1,1
46714,ഇപ്പോൾ,0,0,1,1
38341,vaso,0,0,1,1
38340,بعنوان,0,0,1,1
38339,ലേഖനങ്ങളാണ്,0,0,1,1
46708,mönstret,0,0,1,1
38338,gebruikmaakte,0,0,1,1
46709,netfront,0,0,1,1
50763,comprueba,0,0,1,1
46711,leert,0,0,1,1
46712,geçtiğini,0,0,1,1
46713,odasına,0,0,1,1
38334,« bon,0,0,1,1
38576,поставлена,0,0,1,1
38577,பங்களிப்பையும்,0,0,1,1
38578,sliep,0,0,1,1
38745,सैन,0,0,1,1
38819,ಆಗಲು,0,0,1,1
38818,consagrados,0,0,1,1
46368,seront,0,0,1,1
46369,ισορροπημένες,0,0,1,1
38817,inconsistências,0,0,1,1
46371,அழாதபடி,0,0,1,1
38816,தாக்குதல்,0,0,1,1
51883,ಗೂಗಲ್‌ಗೆ,0,0,1,1
46372,மறுத்துரைத்த,0,0,1,1
38814,éternué,0,0,1,1
46374,assurent,0,0,1,1
38813,வேர்,0,0,1,1
46377,ज़र्मन,0,0,1,1
46378,علق,0,0,1,1
50810,താൽപ്പര്യമുണ്ടെന്ന്,0,0,1,1
38809,حديثًا,0,0,1,1
38808,வந்தான்,0,0,1,1
38807,மனிதன்,0,0,1,1
38806,ഇതര,0,0,1,1
38805,εκπλαγείτε,0,0,1,1
46381,вайнбергером,0,0,1,1
50809,julien,0,0,1,1
46382,relating,0,0,1,1
38801,meleğe,0,0,1,1
46383,ejes,0,0,1,1
38821,administração,0,0,1,1
38822,globe,0,0,1,1
46366,اعتقاده,0,0,1,1
51880,gerektirir,0,0,1,1
46348,υπερβολικά,0,0,1,1
46349,percevait,0,0,1,1
46353,eveneens,0,0,1,1
38841,vecka,0,0,1,1
38840,«научнообразовательный,0,0,1,1
38839,പിന്തുണയോടെയാണ്,0,0,1,1
51878,आजादी,0,0,1,1
46354,النزاعات،,0,0,1,1
38835,vorbereitet,0,0,1,1
38834,snavs,0,0,1,1
38833,оксфордского,0,0,1,1
38832,wegener,0,0,1,1
46365,notice,0,0,1,1
51881,ونتيجة,0,0,1,1
46357,dolaylı,0,0,1,1
46358,βάζω,0,0,1,1
38829,sentouse,0,0,1,1
46360,يعتقد,0,0,1,1
46361,entgegen,0,0,1,1
51882,справочного,0,0,1,1
46362,soldado,0,0,1,1
38827,ലഭിക്കേണ്ടതാണ്,0,0,1,1
46364,γεμίσουμε,0,0,1,1
38826,उतना,0,0,1,1
38799,tryckt,0,0,1,1
46385,wikiviajes,0,0,1,1
46386,ναρκίσσας,0,0,1,1
46407,elbiseyle,0,0,1,1
46402,demeliyim,0,0,1,1
38767,—incluidos,0,0,1,1
46403,rappelle,0,0,1,1
38765,confiera,0,0,1,1
38764,« violation,0,0,1,1
46404,темам,0,0,1,1
46405,kvinde,0,0,1,1
38760,ಸುಸ್ತಾಗಿಲ್ಲ,0,0,1,1
38759,சகோதரியாகவோ,0,0,1,1
38758,تشجيعاً,0,0,1,1
38757,maratones,0,0,1,1
38756,ചുവന്ന,0,0,1,1
38768,keen,0,0,1,1
38755,problemas​,0,0,1,1
51889,المنزلي,0,0,1,1
38753,немецкой,0,0,1,1
50806,tepeden,0,0,1,1
46410,ഒറ്റ,0,0,1,1
38752,«cerrar,0,0,1,1
38751,संघर्ष,0,0,1,1
46411,ಅದೃಷ್ಟಶಾಲಿ,0,0,1,1
51891,équatoriale,0,0,1,1
38749,végétaux,0,0,1,1
46413,lister,0,0,1,1
46401,drengen,0,0,1,1
51885,تمضي,0,0,1,1
46387,registradas,0,0,1,1
38783,depleting,0,0,1,1
38796,മത്സരം,0,0,1,1
38794,utsatt,0,0,1,1
38793,glycoproteins,0,0,1,1
38792,brødbrød,0,0,1,1
46390,« article,0,0,1,1
46391,изданием,0,0,1,1
50808,интересуют,0,0,1,1
46393,ulykkelig,0,0,1,1
38786,милые,0,0,1,1
38785,ознакомления,0,0,1,1
38784,താനും,0,0,1,1
38782,കണ്ടുപിടിക്കലാണ്,0,0,1,1
38769, تم,0,0,1,1
46394,yaptıysa,0,0,1,1
38781,grander,0,0,1,1
38780,пределами,0,0,1,1
38779,വിഷയങ്ങളിലെ,0,0,1,1
38776,‎wikibidija‏,0,0,1,1
46396,confidencialmente,0,0,1,1
38775,décontenancée,0,0,1,1
38773,systémique,0,0,1,1
38772,ഫലത്തിലെത്താൻ,0,0,1,1
38771,vehicles,0,0,1,1
38770,ಭೇಟಿ,0,0,1,1
46347,நுபீடியாவிற்கும்,0,0,1,1
38843,местности,0,0,1,1
38844,எடுத்துக்காட்டில்,0,0,1,1
38908,verbluft,0,0,1,1
46299,relevé,0,0,1,1
38917,ξεχνούν,0,0,1,1
46300,مدة,0,0,1,1
38916,جزء,0,0,1,1
46302,റഫറൻസുകളുമായി,0,0,1,1
46305,असंगति,0,0,1,1
51864,cartes,0,0,1,1
38912,haphazard,0,0,1,1
51865,ഇല്ലെന്നല്ല,0,0,1,1
38910,избранные,0,0,1,1
46308,supposed,0,0,1,1
46309,rangés,0,0,1,1
38919,года»,0,0,1,1
46310,nacemos,0,0,1,1
46312,nutricionista,0,0,1,1
46313,أرتدي,0,0,1,1
50817,adicionou,0,0,1,1
38903,orientadas,0,0,1,1
38902,« portail »,0,0,1,1
38901,പ്രസിദ്ധീകരണങ്ങളും,0,0,1,1
46316,posicionado,0,0,1,1
38900,чисто,0,0,1,1
46317,apresentou,0,0,1,1
38898,güzelliğe,0,0,1,1
38918,australia,0,0,1,1
46297,ಮಾಣಿಕ್ಯಗಳ,0,0,1,1
38896,relación,0,0,1,1
46292,lujo,0,0,1,1
46287,ഓർമയോ,0,0,1,1
38937,ονείρων,0,0,1,1
46288,necesaria—,0,0,1,1
38936,couru,0,0,1,1
38935,ಸಾಲವಾಗಿ,0,0,1,1
38934,utgår,0,0,1,1
51861,múltiple,0,0,1,1
46290,—deliberadamente,0,0,1,1
38932,γραμμένη,0,0,1,1
38931,oublient,0,0,1,1
46291,bereikt,0,0,1,1
51862,données ,0,0,1,1
38921,vaguely,0,0,1,1
46293,എന്നിലുടനീളം,0,0,1,1
51863,tiver,0,0,1,1
46294,إخطاره,0,0,1,1
38927,ಪಡೆದರೆ,0,0,1,1
50819,cárceles,0,0,1,1
38926,herşey,0,0,1,1
38925,மென்மையானது,0,0,1,1
46295,सर्विस,0,0,1,1
46296,ಒಬ್ಟ್ಯೂಸ್,0,0,1,1
38923,vetenskaplig,0,0,1,1
38922,"
मिस्री",0,0,1,1
51867,великой,0,0,1,1
38894,വേണമെങ്കിൽ,0,0,1,1
51877,verlasse,0,0,1,1
38854,награждения,0,0,1,1
46335,പ്രശ്നത്തേക്കാൾ,0,0,1,1
38862,frivilliga,0,0,1,1
38861,первых,0,0,1,1
38860,காட்டவும்,0,0,1,1
38858,mécanismes,0,0,1,1
46336,kullanırlar,0,0,1,1
38857,تضع,0,0,1,1
46339,piedade,0,0,1,1
38856,engelsksproget,0,0,1,1
46340,kafanız,0,0,1,1
38855,ಕ್ರಿಯಾಪದವಾಗಿ,0,0,1,1
46341,لكشف,0,0,1,1
46333,dite,0,0,1,1
46343,περάσεις,0,0,1,1
51875,erdoğan,0,0,1,1
38851,skeçler,0,0,1,1
38850,omslaget,0,0,1,1
46344,மறந்துவிடுகிறார்கள்,0,0,1,1
46345,infört,0,0,1,1
38847,hospedagem,0,0,1,1
46346,potentiellement,0,0,1,1
38846,изучали,0,0,1,1
38845,parenté,0,0,1,1
51876,സുഖമാണോ,0,0,1,1
38865,maalesef,0,0,1,1
50815,transgenre,0,0,1,1
38892,janis,0,0,1,1
38878,लिखित,0,0,1,1
38890,لجميع,0,0,1,1
51868,¿y,0,0,1,1
46320,ಉಪ್ಪು,0,0,1,1
38888,неточными,0,0,1,1
38886,accepté,0,0,1,1
38885,извлечением,0,0,1,1
38884,выпустил,0,0,1,1
50816,интеллектуальной,0,0,1,1
46324,σμαράγδια,0,0,1,1
38880,നിരൂപണങ്ങൾ,0,0,1,1
38879,base ,0,0,1,1
38877,influencia,0,0,1,1
46331,காதலி,0,0,1,1
51871,mestadels,0,0,1,1
38875,обращают,0,0,1,1
38874,compared,0,0,1,1
38872,velho,0,0,1,1
38871,दें,0,0,1,1
46325,வாக்கியத்தில்,0,0,1,1
38869,الأحوال,0,0,1,1
46326,готовности,0,0,1,1
46327,போலல்லாது,0,0,1,1
46328,nonlinearity,0,0,1,1
46329,βρωμιά,0,0,1,1
46414,سفراء,0,0,1,1
46416,ചെയ്യുന്നതെന്തും,0,0,1,1
38579,വിക്കിയിലെ,0,0,1,1
46417,befindet,0,0,1,1
38640,mr •,0,0,1,1
38639,ഉണ്ടാകും,0,0,1,1
38638,медленный,0,0,1,1
38637,защиту,0,0,1,1
38636,diciéndola,0,0,1,1
38635,incompréhensible,0,0,1,1
38634,متطورًا,0,0,1,1
38632,competitive,0,0,1,1
46508,mejore,0,0,1,1
46509,debris,0,0,1,1
46510,plataforma,0,0,1,1
46513,zögernd,0,0,1,1
46514,ക്ലാസിക്കൽ,0,0,1,1
51917,நினைத்துப்,0,0,1,1
46516,मुख्यधारा,0,0,1,1
38627,rörde,0,0,1,1
38626,undesired,0,0,1,1
38625,പണികളിലേതെങ്കിലും,0,0,1,1
38623,பதிப்பிடக்கூடிய,0,0,1,1
38622,"
वर्तमान",0,0,1,1
46518,सा,0,0,1,1
51918,kalbi,0,0,1,1
38621,ഒച്ചയുടെ,0,0,1,1
46519,αναστατωθείς,0,0,1,1
50793,модные,0,0,1,1
50794,أجزاء,0,0,1,1
38641,സംസാരിച്ചിരിക്കാം,0,0,1,1
46505,"
टाटर",0,0,1,1
51913,engelsktalende,0,0,1,1
46488,आना,0,0,1,1
46490,लटकाओ।,0,0,1,1
46491,assumed,0,0,1,1
38653,википроекты,0,0,1,1
46493,മുൻപുള്ള,0,0,1,1
38652,गरीब,0,0,1,1
51911,« même,0,0,1,1
46494,ends,0,0,1,1
50795,ശ്രദ്ധപുലർത്തുന്നു,0,0,1,1
38651,pai,0,0,1,1
51912,освободить,0,0,1,1
46496,колеблясь,0,0,1,1
38642,الأفراد,0,0,1,1
38649,graines,0,0,1,1
46498,मुहम्मद,0,0,1,1
51914,собравшей,0,0,1,1
51915,frequência,0,0,1,1
38648,reduce,0,0,1,1
38647,наличию,0,0,1,1
38646,wurden,0,0,1,1
46499,റിപ്പബ്ലിക്ക്,0,0,1,1
38644,competir,0,0,1,1
38643,ദേഷ്യപ്പെട്ടതുപോലെയാണെന്ന്,0,0,1,1
46503,istediğini,0,0,1,1
46520,என்பதற்குப்,0,0,1,1
38619,sekunde,0,0,1,1
38618,bouchée,0,0,1,1
38588,stannar,0,0,1,1
46538,plattformar,0,0,1,1
38597,κινείσαι,0,0,1,1
38595,pair,0,0,1,1
38594,sammanfogats,0,0,1,1
46543,amoralidade,0,0,1,1
46544,despedirse,0,0,1,1
46545,verlagsgesellschaft,0,0,1,1
38590,feit,0,0,1,1
46546,разработанная,0,0,1,1
46547,masculine,0,0,1,1
46548,الإستراتيجية,0,0,1,1
50788,അല്ലാത്തവയെയും,0,0,1,1
38600,réussit,0,0,1,1
38587,byen,0,0,1,1
38586,passé,0,0,1,1
51923,congratulating,0,0,1,1
38585,laboral,0,0,1,1
46550,ilustrador,0,0,1,1
38584,والمجتمع,0,0,1,1
38583,mythologiques,0,0,1,1
51924,وجه,0,0,1,1
38581,والـ,0,0,1,1
38580,योंगल,0,0,1,1
50787,φταρνίστηκε,0,0,1,1
38599,சந்திப்பைப்,0,0,1,1
38601,प्रसारित,0,0,1,1
46521,матерью,0,0,1,1
38610,suffisent,0,0,1,1
46522,διότι,0,0,1,1
46523,становится,0,0,1,1
50792,κεντρικής,0,0,1,1
38616,നാർസിസിന്റെ,0,0,1,1
38615,உடைந்தாள்,0,0,1,1
51920,മീറ്റിംഗായിരുന്നു,0,0,1,1
38614,participa,0,0,1,1
38613,løb,0,0,1,1
46527,poderi,0,0,1,1
46528,പിസ്സ,0,0,1,1
50791,chats,0,0,1,1
38609,escravos,0,0,1,1
46537,ayudarme,0,0,1,1
51921,algemene,0,0,1,1
50789,uppsala,0,0,1,1
46532,sofra,0,0,1,1
38608,അതിന്,0,0,1,1
38607,вебсервера,0,0,1,1
38606,próprias,0,0,1,1
46533,λήθαργοι,0,0,1,1
46534,координации,0,0,1,1
46535,mixture,0,0,1,1
38603,addressed,0,0,1,1
46536,गले,0,0,1,1
38656,wendt,0,0,1,1
46486,குழுவொன்று,0,0,1,1
46485,κρύο,0,0,1,1
46436,ഇവർക്ക്,0,0,1,1
38721,çarptığı,0,0,1,1
38720,செய்துகொண்டிருந்தபோது,0,0,1,1
46431,mélisse,0,0,1,1
38718,फ्रांसिस्को,0,0,1,1
46432,programmoduler,0,0,1,1
46433,felsefe,0,0,1,1
38715,جننت,0,0,1,1
46435,jämförelse,0,0,1,1
38713,أستطع,0,0,1,1
38712,едва,0,0,1,1
38711,വിദ്യാ‍ഭ്യാസത്തിന്റെ,0,0,1,1
46437,заставил,0,0,1,1
46430,என்பவர்,0,0,1,1
46439,medieråd,0,0,1,1
38709,இறுதிகளிலும்,0,0,1,1
46442,കൂട്ടിച്ചേർത്തെന്നുവരും,0,0,1,1
46443,effectuer,0,0,1,1
38706,நிர்வாகிகளினால்,0,0,1,1
51895,betygsätta,0,0,1,1
38705,chamar,0,0,1,1
38704,zoophilia,0,0,1,1
38703,detenerte,0,0,1,1
51896,clique,0,0,1,1
38702,хороши,0,0,1,1
38722,hazırlanmış,0,0,1,1
46429,skillnaden,0,0,1,1
46446,ದೂರ,0,0,1,1
46423,கனவைப்,0,0,1,1
46418,आयी,0,0,1,1
46419,положительной,0,0,1,1
38743,servrarb,0,0,1,1
46420,källförteckningen,0,0,1,1
38742,destaca,0,0,1,1
38741,"ശാസ്ത്രം ·
geosciences ·
soil",0,0,1,1
38739,poliment,0,0,1,1
51892,havaiana,0,0,1,1
38737,قرّر,0,0,1,1
50803,எனக்,0,0,1,1
38736,influenced,0,0,1,1
38735,users ,0,0,1,1
38724,"
कापमपंगन",0,0,1,1
46425,oyununuzu,0,0,1,1
38734,madrid​,0,0,1,1
38733,мобильным,0,0,1,1
38732,கருத்துகள்,0,0,1,1
38731,ಸಂತೋಷ,0,0,1,1
38730,أصدق,0,0,1,1
46426,"
basquir",0,0,1,1
38729,afluencia,0,0,1,1
38728,créateurs,0,0,1,1
46427,homonymes,0,0,1,1
38725,ಬದಲಾಗಿದ್ದಾಳೆ,0,0,1,1
51898,ಹಾಯಿಸಿದರು,0,0,1,1
38701,представлена,0,0,1,1
46484,uttalar,0,0,1,1
38671,foucault,0,0,1,1
46463,toleransen,0,0,1,1
46464,wikipedista,0,0,1,1
38677,കോളർ‌,0,0,1,1
46465,pointofview,0,0,1,1
38675,mediawikiprogramvaran,0,0,1,1
46468,proveito,0,0,1,1
46469,surprend,0,0,1,1
38674,പ്രാധാന്യമുണ്ട്,0,0,1,1
38673,followed,0,0,1,1
38672,tekniske,0,0,1,1
46471,восприимчивость,0,0,1,1
38670,anciennes,0,0,1,1
51905,немецких,0,0,1,1
38669,einzige,0,0,1,1
38668,upphovsrättsbrott,0,0,1,1
50798,தேடுகிறீர்கள்,0,0,1,1
38666,выполнения,0,0,1,1
46477,टेलीफोन,0,0,1,1
46478,wiskundehuiswerk,0,0,1,1
46480,विध्वंसप्रवण,0,0,1,1
46481,ಆಲಸ್ಯ,0,0,1,1
46482,realizadas,0,0,1,1
38661,espirrou,0,0,1,1
38659,സുഹൃത്തുക്കളും,0,0,1,1
46461,ചെയ്യുന്നില്ല,0,0,1,1
38680,بلغ,0,0,1,1
46447,وصبر,0,0,1,1
51901,الإشارة,0,0,1,1
51899,"
सामोगितियाई",0,0,1,1
46448,கவலைப்படுகிறாள்,0,0,1,1
38698,σχολιάστε,0,0,1,1
38697,أظهر,0,0,1,1
38696,dåsedansk,0,0,1,1
38695,yapılmış,0,0,1,1
38694,приписывают,0,0,1,1
50802,içerdiğini,0,0,1,1
46450,വ്യാപകമായി,0,0,1,1
46451,duydum,0,0,1,1
46452,"
todos",0,0,1,1
46454,aliens”,0,0,1,1
46459,записей,0,0,1,1
38688,اعتبار,0,0,1,1
38687,запросов,0,0,1,1
38686,énergétique,0,0,1,1
46455,μοναδικό,0,0,1,1
38684,influenciado,0,0,1,1
38683,atarsa,0,0,1,1
46456,اعتذارى,0,0,1,1
50801,ईमेल,0,0,1,1
51902,bestond,0,0,1,1
50799,αναφοράς,0,0,1,1
51904,neuronal,0,0,1,1
38237,instituciones,0,0,1,1
38232,പ്രവൃത്തിയാണെന്ന്,0,0,1,1
51979,سرعان,0,0,1,1
47205,bezaaid,0,0,1,1
52051,заинтересованы,0,0,1,1
52052,العظمى,0,0,1,1
52053,faydalı,0,0,1,1
47167,altas,0,0,1,1
37778,apaixonadamente,0,0,1,1
37777,объёмов,0,0,1,1
47168,δυστυχισμένο,0,0,1,1
37776,हाउ,0,0,1,1
47169,فالكلمة,0,0,1,1
47170,സമൂഹത്തെ,0,0,1,1
37774,பரபரப்பான,0,0,1,1
37773,προσπαθείτε,0,0,1,1
37772,kontakter,0,0,1,1
47172,larmes,0,0,1,1
47174,"
vi",0,0,1,1
50703,newer,0,0,1,1
37771,kredisini,0,0,1,1
47177,manifestations,0,0,1,1
37768,pourront,0,0,1,1
52055,саду,0,0,1,1
47178,cumhurbaşkanı,0,0,1,1
37767,உருவாக்கப்பட்ட,0,0,1,1
47180,basado,0,0,1,1
37764,ಮೆಸೆಂಜರ್,0,0,1,1
37763,conexiones,0,0,1,1
37782,pl •,0,0,1,1
37783,returns,0,0,1,1
47165,κρυφά,0,0,1,1
47157,самостоятельно,0,0,1,1
37800,robotics,0,0,1,1
47151,связи,0,0,1,1
47154,മര്യാദ,0,0,1,1
37798,gegaan,0,0,1,1
37797,de ,0,0,1,1
52047,ровно,0,0,1,1
52048,narsis,0,0,1,1
52049,comunicação,0,0,1,1
37795,بوقاحة,0,0,1,1
47155,بلا,0,0,1,1
47156,juiz,0,0,1,1
47158,جعلني,0,0,1,1
52050,книги,0,0,1,1
47159,intihal,0,0,1,1
47160,இணையத்,0,0,1,1
47161,μιλούσε,0,0,1,1
37790,மாற்றம்,0,0,1,1
47162,تحلم,0,0,1,1
47163,renforcement,0,0,1,1
37788,multilinear,0,0,1,1
50705,تعاملت,0,0,1,1
37787,आवाज़,0,0,1,1
47164,المائة,0,0,1,1
37786,diskussionssidan,0,0,1,1
37762,лучшую,0,0,1,1
37760,identifie,0,0,1,1
37759,ونفس,0,0,1,1
52062,الإضافة,0,0,1,1
37737,reportaje,0,0,1,1
37736,أعضاء,0,0,1,1
47198,തോന്നാത്ത,0,0,1,1
37734,diagnose,0,0,1,1
37733,சரியா,0,0,1,1
37732,opérationnellement,0,0,1,1
37731,воздействия,0,0,1,1
47200,क्रम,0,0,1,1
37730,grameri,0,0,1,1
37729,ölüyorum,0,0,1,1
37728,செயற்பட,0,0,1,1
47201,позиционирует,0,0,1,1
37739,leiden,0,0,1,1
37726,diyebileceğine,0,0,1,1
37725, —,0,0,1,1
37724,σκληρός,0,0,1,1
52063,güzelce,0,0,1,1
37722,ನೋಡದಿದ್ದಾಗ,0,0,1,1
37721,مجانية,0,0,1,1
47202,mountainous,0,0,1,1
50699,baffling,0,0,1,1
37718,скажешь,0,0,1,1
37717,routière,0,0,1,1
37716,отмечая,0,0,1,1
37738,entiendo,0,0,1,1
47195,parodies,0,0,1,1
47182,اعتمادها,0,0,1,1
47189,сверху,0,0,1,1
37758,jams,0,0,1,1
37757,hoefler,0,0,1,1
37756,എന്നതിനർത്ഥം,0,0,1,1
50702,ехали,0,0,1,1
37754,تحديدًا,0,0,1,1
37753,ಲಿಂಕ್,0,0,1,1
47185,മകളുടെ,0,0,1,1
37752,inclusréf,0,0,1,1
50701,لاتينية,0,0,1,1
47187,यो,0,0,1,1
47188,commis,0,0,1,1
37751,إجازة,0,0,1,1
37741,frygtelige,0,0,1,1
52058,hawaïen,0,0,1,1
37750,enkätsvaren,0,0,1,1
47190,विकिस्केनर,0,0,1,1
37749,soulignées,0,0,1,1
47191,எடுக்கப்பட்டது,0,0,1,1
37747,nécessité,0,0,1,1
37746,εκτιμώ,0,0,1,1
47193,tryckta,0,0,1,1
37744,இரண்டிலும்,0,0,1,1
37743,renforcée,0,0,1,1
47194,belonged,0,0,1,1
52045,совместно,0,0,1,1
37802,ആരംഭിക്കാം,0,0,1,1
37803,"
इतिहासकार",0,0,1,1
47102,"
यूक्रेनी",0,0,1,1
52037,reporting,0,0,1,1
37864,போட்டி,0,0,1,1
37863,aback,0,0,1,1
37862,derivative,0,0,1,1
47093,atmosphériques,0,0,1,1
52038,vain »,0,0,1,1
37859,útiles,0,0,1,1
47098,проектами,0,0,1,1
47100,മോശമായ,0,0,1,1
37857,böyle,0,0,1,1
52039,αλλάξουν,0,0,1,1
37854,рассказывалось,0,0,1,1
37867,sink,0,0,1,1
37853,«психбольницу,0,0,1,1
50714,consultant,0,0,1,1
47105,woordnummer,0,0,1,1
50712,ಆವರಿಸಬಹುದೇ,0,0,1,1
47111,بقدر,0,0,1,1
47112,φτωχοί,0,0,1,1
47113,рассмотрим,0,0,1,1
37849,théorise,0,0,1,1
37848,vacilando,0,0,1,1
37847,c’est,0,0,1,1
37846,إخبارهم,0,0,1,1
37866,ഇവർ,0,0,1,1
37868,entendez,0,0,1,1
37845,burayı,0,0,1,1
37879,πλάι,0,0,1,1
47074,വായനക്കാർക്കോ,0,0,1,1
47075,उर्फ,0,0,1,1
37888,destiné,0,0,1,1
37887,அதிகரிப்பதன்,0,0,1,1
47078,redevenue,0,0,1,1
37886,இயல்பாக,0,0,1,1
47079,ಎಲ್ಲದಕ್ಕೂ,0,0,1,1
50715,sprankelende,0,0,1,1
37883,story,0,0,1,1
52034,enregistrées,0,0,1,1
37881,обозначает,0,0,1,1
47084,duração,0,0,1,1
37869,ഒരാളെ,0,0,1,1
47086,κοινού,0,0,1,1
37878,байесовские,0,0,1,1
52036,ग्रिल्लिनी,0,0,1,1
37876,framfört,0,0,1,1
37875,الغداء,0,0,1,1
47087,skrivstugor,0,0,1,1
37874,பானத்துடன்,0,0,1,1
47088,utilização,0,0,1,1
47089,inmediato,0,0,1,1
47092,الخامسة,0,0,1,1
37870,чувство,0,0,1,1
47114,இணைப்பாக,0,0,1,1
47115,aşar,0,0,1,1
50707,ಚಿಹ್ನೆಯೊಂದಿಗೆ,0,0,1,1
37814,സമ്മതിക്കുന്നുവെന്ന്,0,0,1,1
37823,بخلاف,0,0,1,1
37822,корни,0,0,1,1
37821,والمحطة,0,0,1,1
52041,dergelijks,0,0,1,1
37820,brott,0,0,1,1
37819,författad,0,0,1,1
37817,kalırsa,0,0,1,1
47140,خاطئًا,0,0,1,1
37816,basculer,0,0,1,1
37815,woke,0,0,1,1
47141,magasiner,0,0,1,1
37813,நுட்பக்,0,0,1,1
37824,proyecto​,0,0,1,1
52042,permitiria,0,0,1,1
47142,passetil,0,0,1,1
47143,സ്വതന്ത്രവിജ്ഞാനകോശം,0,0,1,1
47146,അതുമായി,0,0,1,1
47147,विकीवर्सिटी,0,0,1,1
52043,ejecutarían,0,0,1,1
37807,nachts,0,0,1,1
47149,जाऊंगा।,0,0,1,1
37805,يخبار,0,0,1,1
37804,groep,0,0,1,1
47150,கட்டுரைகளுக்கு,0,0,1,1
47136,bage,0,0,1,1
37825,лицом,0,0,1,1
37843,tarihin,0,0,1,1
37834,अनजाने,0,0,1,1
50710,अतिरंजित,0,0,1,1
47119,στρατιώτες,0,0,1,1
37842,bijdrage,0,0,1,1
47121,بنظام,0,0,1,1
37840,καλιφόρνια,0,0,1,1
47123,комментарием,0,0,1,1
37839,aptitudes,0,0,1,1
37838,അപ്പം,0,0,1,1
37837,colonisation,0,0,1,1
47124,χρησιμότητα,0,0,1,1
37835,tenant,0,0,1,1
37832,प्रभाविकता,0,0,1,1
47135,расширена,0,0,1,1
47127,absurd,0,0,1,1
47128,bookstores,0,0,1,1
50708,reparar,0,0,1,1
47129,подчеркнуть,0,0,1,1
37831,arborescente,0,0,1,1
47130,drivs,0,0,1,1
47132,отсюда,0,0,1,1
47133,nådde,0,0,1,1
37828,üniversiteye,0,0,1,1
37827,ಮುರಿದುಬಿದ್ದಿದೆ,0,0,1,1
37826,géographie,0,0,1,1
47204,yaşamda,0,0,1,1
37714,холодно,0,0,1,1
37890,fivethirtyeight,0,0,1,1
47206,المشرقة,0,0,1,1
47270,поставив,0,0,1,1
47271,بمثل,0,0,1,1
37598,ನಿಮ್ಮಂತೆಯೇ,0,0,1,1
52078,отнести,0,0,1,1
37597,நகைச்சுவையைச்,0,0,1,1
37596,освещение,0,0,1,1
47272,envision,0,0,1,1
47273,pouviez,0,0,1,1
37594,होस्टिंग,0,0,1,1
47274,uzmanların,0,0,1,1
47275,afirmando,0,0,1,1
47276,επίσημη,0,0,1,1
52080,يسافرون,0,0,1,1
50690,உணர,0,0,1,1
50689,англоязычный,0,0,1,1
37592,hunde,0,0,1,1
47278,onmiddellijk,0,0,1,1
47279,costumbres,0,0,1,1
52081,downward,0,0,1,1
47280,تُعرف,0,0,1,1
47281,سأخذه,0,0,1,1
37589,ومحركات,0,0,1,1
47282,constamment,0,0,1,1
37588,своим,0,0,1,1
37587,ലഭിച്ചുവെന്ന്,0,0,1,1
37600,கட்டுரைகளைப்,0,0,1,1
37601,merdé,0,0,1,1
52077,färdade,0,0,1,1
37615,कर्मचारियों,0,0,1,1
37623,"
नॉर्मन",0,0,1,1
37622,നീ,0,0,1,1
37621,atribuições,0,0,1,1
47260,ಮಾಂಸದ,0,0,1,1
50692,"
estamos",0,0,1,1
37619,ಸ್ಪಾಟ್,0,0,1,1
37618,intends,0,0,1,1
47261,vazgeçmektedir,0,0,1,1
47262,beruhige,0,0,1,1
50691,помимо,0,0,1,1
47263,tidningen,0,0,1,1
37614,കാത്തിരിക്കാൻ,0,0,1,1
47269,juridiques,0,0,1,1
37613,glædeligt,0,0,1,1
37612,выдать,0,0,1,1
47264,ഉണ്ടായത്,0,0,1,1
47265,consist,0,0,1,1
37610,ಮುಳುಗುವುದು,0,0,1,1
37608,مذهلة,0,0,1,1
37607,universitários,0,0,1,1
37606,anlamamı,0,0,1,1
37605,narzissen,0,0,1,1
47268,llegaron,0,0,1,1
37604,synker,0,0,1,1
37586,подвергавшихся,0,0,1,1
47283,प्रतिबिंब,0,0,1,1
37585,ಗೊತ್ತಿಲ್ಲ,0,0,1,1
37550,ലേഖകസംഘം,0,0,1,1
37557,سُئلت,0,0,1,1
37556,república,0,0,1,1
47299,fnr,0,0,1,1
37555,അഭിമുഖത്തിലോ,0,0,1,1
47300,مدخلات,0,0,1,1
47301,besuchen,0,0,1,1
50686,iniciais,0,0,1,1
37554,aussprechen,0,0,1,1
47304,சென்றால்,0,0,1,1
37552,деятельность,0,0,1,1
37551,കൂട്ടിച്ചേർത്തോളും,0,0,1,1
47305,edelstenen,0,0,1,1
47297,tonu,0,0,1,1
52086,തടവുകാരെ,0,0,1,1
37548,langue »,0,0,1,1
47306,anpassa,0,0,1,1
52087,bandeaux,0,0,1,1
47307,sexuais,0,0,1,1
47309,lembrálo,0,0,1,1
37546,அழுகிறீர்கள்,0,0,1,1
47310,arıyorsun,0,0,1,1
37544,ಅಳುತ್ತಿದ್ದರೆ,0,0,1,1
47311,intressanta,0,0,1,1
37542,نفسها،,0,0,1,1
47298,будьте,0,0,1,1
37559,سيئة,0,0,1,1
37584,garaj,0,0,1,1
37573,intentado,0,0,1,1
37583,பிடிக்க,0,0,1,1
37582,ನೆನಪಿಸಲು,0,0,1,1
37581,cirka,0,0,1,1
37580,காலம்வரை,0,0,1,1
47285,uhøfligt,0,0,1,1
37577,интернетсправочником,0,0,1,1
37576,قالت,0,0,1,1
37575,« on,0,0,1,1
52082,politiskt,0,0,1,1
37574,görüşmesinde,0,0,1,1
47286,espalhar,0,0,1,1
47288,βοήθεια,0,0,1,1
47296,"economics ·
environmental",0,0,1,1
37571,"
मिनांगकाबाउ",0,0,1,1
47289,samlas,0,0,1,1
37570,மன்னிப்பை,0,0,1,1
47290,άλλους,0,0,1,1
52083,क्षति,0,0,1,1
47293,frozen,0,0,1,1
37566,ανόητος,0,0,1,1
50688,ഉപയോഗിക്കാത്തതെന്താണ്,0,0,1,1
47294,മങ്ങിയ,0,0,1,1
37562,coletar,0,0,1,1
37561,wikinotícias,0,0,1,1
37625,moldar,0,0,1,1
37626,difficilement,0,0,1,1
37627,делаются,0,0,1,1
37680,lieblich,0,0,1,1
37690,पर्सन,0,0,1,1
47222,döndü,0,0,1,1
47223,बनाम,0,0,1,1
37687,adorável,0,0,1,1
47224,telaşa,0,0,1,1
37686,الزوار,0,0,1,1
37685,திரும்பப்,0,0,1,1
47225,മാണിക്യ,0,0,1,1
37683,revertidos,0,0,1,1
37682,ഡബ്ല്യു,0,0,1,1
37681,одежды,0,0,1,1
47226,apresentada,0,0,1,1
37693,പതാകവാഹക,0,0,1,1
47227,معطل,0,0,1,1
47228,बर्क्मेन,0,0,1,1
37678,καταπληκτικά,0,0,1,1
47229,energiedrank,0,0,1,1
37676,upphovsrättsdirektivet,0,0,1,1
37675,accepterer,0,0,1,1
47231,thousand,0,0,1,1
50698,doll,0,0,1,1
37673,مسؤولون,0,0,1,1
47232,assinatura,0,0,1,1
37672,excelente,0,0,1,1
37692,சியர்ஸ்,0,0,1,1
37694,mundial​,0,0,1,1
37670,worthy,0,0,1,1
47212,veelen,0,0,1,1
47207,vastzit,0,0,1,1
37713,concluent,0,0,1,1
47208,seyahatleri,0,0,1,1
52064,slette,0,0,1,1
37712,вставкам,0,0,1,1
47209,पाठों,0,0,1,1
47210,siffran,0,0,1,1
37711,virtually,0,0,1,1
37710,möjliggjorde,0,0,1,1
37709,pourriezvous,0,0,1,1
47211,vérifiables,0,0,1,1
37708,красная,0,0,1,1
47217,പുനരാരംഭിക്കാൻ‌,0,0,1,1
37707,polícia,0,0,1,1
37706,பதிலளிக்குமுகமாக,0,0,1,1
37704,blair,0,0,1,1
37703,добавлять,0,0,1,1
47214,مهتم,0,0,1,1
37701,مناقشتهم،,0,0,1,1
37700,الأكبر,0,0,1,1
37699,källkritik,0,0,1,1
37698,இருந்ததா,0,0,1,1
47215,antologin,0,0,1,1
37696,envisager,0,0,1,1
37671,டெர்சி,0,0,1,1
37669,ejaculação,0,0,1,1
37628,compreensiva,0,0,1,1
47255,കമ്പ്യൂട്ടറുകളെ,0,0,1,1
37646,настоящем,0,0,1,1
37645,وحتى,0,0,1,1
47250,sauriezvous,0,0,1,1
50694,ಆಹ್ಲಾದಕರ,0,0,1,1
37643,மாட்டாள்,0,0,1,1
37642,anglófona,0,0,1,1
47251,halve,0,0,1,1
47252,abandoned,0,0,1,1
47254,golpea,0,0,1,1
37640,controversiales,0,0,1,1
37639,происхождение,0,0,1,1
37638,viajando,0,0,1,1
52074,brauche,0,0,1,1
37637,ಪದಗಳಿವೆ,0,0,1,1
50693,şeklinde,0,0,1,1
37635,digitais,0,0,1,1
37634,kapitalistiska,0,0,1,1
37633,зачастую,0,0,1,1
47256,നിങ്ങളോടൊപ്പം,0,0,1,1
47257,ഏറി,0,0,1,1
52075,مزحة,0,0,1,1
37630,кодом,0,0,1,1
52076,lessem,0,0,1,1
37629,χάσει,0,0,1,1
37647,vécue,0,0,1,1
52072,ಭಾಗವನ್ನು,0,0,1,1
47233,paradigme,0,0,1,1
47240,ಯಾವುದರ,0,0,1,1
47234,низкокачественной,0,0,1,1
37668,ജ്യാമിതി,0,0,1,1
47235,brett,0,0,1,1
47236,setzen,0,0,1,1
37666,engraçado,0,0,1,1
37665,എഴുതുന്നത്,0,0,1,1
50696,начаты,0,0,1,1
52069,britannique,0,0,1,1
37662,sufrió,0,0,1,1
47237,தெரிவித்தது,0,0,1,1
47239,الأفارقة,0,0,1,1
37660,inné »,0,0,1,1
47247,chanceuse,0,0,1,1
47241,batırdım,0,0,1,1
37659,guldgyldent,0,0,1,1
37658,climatique,0,0,1,1
47242,jugé,0,0,1,1
47243,σκέφτεται,0,0,1,1
52071,लक्ष्य,0,0,1,1
37655,скачать,0,0,1,1
37654,रहने,0,0,1,1
50695,खबर,0,0,1,1
37652,ಶಾಸ್ತ್ರೀಯ,0,0,1,1
47245,പട്ടിണി,0,0,1,1
37889,arkivversionen,0,0,1,1
47073,primeiras,0,0,1,1
38230,கொடுக்கும்,0,0,1,1
46940,കൊടുക്കുന്നു,0,0,1,1
38119,ನಾಮಪದವಾಗಿ,0,0,1,1
51996,découlent,0,0,1,1
38118,പ്രദേശത്ത്,0,0,1,1
38117,envelops,0,0,1,1
38116,remercie,0,0,1,1
38115,inrikesdepartementets,0,0,1,1
46909,автоматизированный,0,0,1,1
38113,موافق,0,0,1,1
38112,kant,0,0,1,1
51997,upphovspersonerna,0,0,1,1
38111,നല്ലതെന്ന്,0,0,1,1
46910,γεμάτη,0,0,1,1
38110,ಸೀನುವಾಗ,0,0,1,1
38109,ബരാക്,0,0,1,1
38108,ഒരുപക്ഷേ,0,0,1,1
38107,τραγούδια,0,0,1,1
38106,asistentes,0,0,1,1
38105,сэнгеру,0,0,1,1
38104,उल्लेखनीय,0,0,1,1
38103,sandım,0,0,1,1
46911,financiero,0,0,1,1
50735,proibições,0,0,1,1
51998,thermal,0,0,1,1
38101,لاتيني,0,0,1,1
38100,échappentréf,0,0,1,1
46908,desnecessário,0,0,1,1
38120,élections,0,0,1,1
38121,drunkna,0,0,1,1
50737,tornando,0,0,1,1
38144,வாசகரும்,0,0,1,1
46889,guiñaron,0,0,1,1
46890,karışırsa,0,0,1,1
38142,ಸಾಬೀತುಪಡಿಸದ,0,0,1,1
46891,intresseväckande,0,0,1,1
38140,konferensartikeln,0,0,1,1
38138,"
स्कॉटिश",0,0,1,1
38137,voorzien,0,0,1,1
46893,कोल्बेर्ट,0,0,1,1
46894,supin,0,0,1,1
51994,"
बास्क",0,0,1,1
46895,सतर्क,0,0,1,1
38122,kalbe,0,0,1,1
46896,bretón,0,0,1,1
46901,ذكي,0,0,1,1
46903,நோக்கமற்றது,0,0,1,1
46904,وأنواعًا,0,0,1,1
38132,ecke,0,0,1,1
38131,использует,0,0,1,1
38130,بأدب,0,0,1,1
38128,organic,0,0,1,1
38126,gymnasieexamen,0,0,1,1
46906,cobrindo,0,0,1,1
38123,win,0,0,1,1
46913,കാണിച്ചു,0,0,1,1
46914,rightarrow,0,0,1,1
46915,intitulada,0,0,1,1
38066,hissediyorum,0,0,1,1
46927,περιστατικά,0,0,1,1
38076,exagérer,0,0,1,1
38075,പോലും,0,0,1,1
38072,مجهودك,0,0,1,1
52001,ಅಧಿಕೃತ,0,0,1,1
46931,चित्रमाला,0,0,1,1
38070,lecturers,0,0,1,1
38069,boğulabilir,0,0,1,1
38068,upprörda,0,0,1,1
38067,raakte,0,0,1,1
46932,يتعاونون,0,0,1,1
46933,सकारात्मक,0,0,1,1
38078,zweifel,0,0,1,1
38064,ആഗ്രഹിക്കുന്നതെന്തും,0,0,1,1
46934,нильса,0,0,1,1
38063,umursayamazdım,0,0,1,1
38062,udgaven,0,0,1,1
38061,adres,0,0,1,1
52004,aimant,0,0,1,1
38060,തണ്ണീർത്തടമാണ്,0,0,1,1
38059,fondant,0,0,1,1
38057,подпадает,0,0,1,1
38056,—tras,0,0,1,1
38055,некоторого,0,0,1,1
50729,മടിക്കുന്നു,0,0,1,1
46924,وعمل,0,0,1,1
38099,ಯಾವುದೇ,0,0,1,1
38089,بعامين،,0,0,1,1
38098,cidadãos,0,0,1,1
50733,തർക്കം,0,0,1,1
38097,توقفت,0,0,1,1
38096,birleşiminden,0,0,1,1
50731,അഭിപ്രായമിടാൻ,0,0,1,1
38095,συνεχίστε,0,0,1,1
51999,overdrijven,0,0,1,1
38093,അറിയില്ലെന്ന്,0,0,1,1
38092,ast •,0,0,1,1
38091,yazılan,0,0,1,1
38090,turistin,0,0,1,1
38088,guldbrödet,0,0,1,1
38080,अधीन,0,0,1,1
38087,hemlighetsfullt,0,0,1,1
38086,leckersten,0,0,1,1
46917,suffisamment,0,0,1,1
46919,ستعيش,0,0,1,1
38084,categorize,0,0,1,1
46920,sanmıyorum,0,0,1,1
38082,vader,0,0,1,1
38081,buggy,0,0,1,1
46922,നടുങ്ങിപ്പോയി,0,0,1,1
50730,repeated,0,0,1,1
46923,declarações,0,0,1,1
46888,प्रोग्राम,0,0,1,1
50738,görünmesine,0,0,1,1
46887,abiertas,0,0,1,1
38196,creerlo,0,0,1,1
38207,സങ്കീർണ്ണവും,0,0,1,1
46843,നേടിയിട്ടുണ്ടെങ്കിൽ,0,0,1,1
46844,tolke,0,0,1,1
38205,irréductibles,0,0,1,1
38204,குழப்புவது,0,0,1,1
38203,explicabilité,0,0,1,1
46845,टर्म्स,0,0,1,1
38201,موسوعي,0,0,1,1
38199,samentrekking,0,0,1,1
50747,வேலையும்,0,0,1,1
38197,melhoram,0,0,1,1
38195,frankrijk,0,0,1,1
38210,αφήσει,0,0,1,1
46846,zukünftige,0,0,1,1
51985,araştırmayı,0,0,1,1
38193,सेवी,0,0,1,1
38192,फैंसी,0,0,1,1
38191,encantaría,0,0,1,1
46849,sayfayı,0,0,1,1
46850,متعددة,0,0,1,1
51986,लगेगी।,0,0,1,1
46851,odf,0,0,1,1
38189,dukker,0,0,1,1
46853,herbert,0,0,1,1
38208,billeder,0,0,1,1
38211,auc,0,0,1,1
50745,λογότυπο,0,0,1,1
38220,كلية,0,0,1,1
46831,принял,0,0,1,1
46832,വെള്ളിയാഴ്ചയാണെന്ന്,0,0,1,1
38228,sınava,0,0,1,1
38227,продовольствие,0,0,1,1
46834,sleep,0,0,1,1
38226,نومها,0,0,1,1
38225,sousdomaine,0,0,1,1
46835,gradientes,0,0,1,1
38223,minor,0,0,1,1
46836,gittiğinde,0,0,1,1
38221,ужин,0,0,1,1
51981,ألف,0,0,1,1
38212,användarkonto,0,0,1,1
38219,"
लिम्बुर्गियाई",0,0,1,1
51983,बढ़ेगा,0,0,1,1
46837,медицинским,0,0,1,1
38218,திட்டமாகச்,0,0,1,1
38217,написанных,0,0,1,1
38216,भेजूंगा,0,0,1,1
46838,использовался,0,0,1,1
46840,простая,0,0,1,1
38214,karıştırdım,0,0,1,1
46841,ದೌರ್ಜನ್ಯದ,0,0,1,1
46842,kaynakları,0,0,1,1
38187,скромной,0,0,1,1
38185,مسؤولة,0,0,1,1
38146,लिखती,0,0,1,1
46875,повсеместная,0,0,1,1
46868,തീരുമാനിക്കേണ്ടതുണ്ട്,0,0,1,1
51990,العكس,0,0,1,1
38162,dismissed,0,0,1,1
46870,ಬೆಳಗಬಹುದು,0,0,1,1
46871,portugais,0,0,1,1
38160,बताती,0,0,1,1
38159,continent,0,0,1,1
46873,denis,0,0,1,1
50740,நண்பர்,0,0,1,1
38157,innehöll,0,0,1,1
46874,amplio,0,0,1,1
46876,nähe,0,0,1,1
46867,deleting,0,0,1,1
46877,« ne,0,0,1,1
51991,nere,0,0,1,1
38154,சாங்கரால்,0,0,1,1
51993,dénotant,0,0,1,1
46880,envió,0,0,1,1
38151,ನಿಮ್ಮಲ್ಲಿ,0,0,1,1
38150,"
क्राइमियाई",0,0,1,1
38149,பார்த்தார்,0,0,1,1
46884,possuíam,0,0,1,1
38148,மேலதிகமாக,0,0,1,1
46886,παρανόηση,0,0,1,1
51989,salle,0,0,1,1
38163,франции,0,0,1,1
46855,remplacé,0,0,1,1
38174,compétitif,0,0,1,1
38183,ഉറുമ്പുകൂട്ടത്തെ,0,0,1,1
46857,takımın,0,0,1,1
38182,വശമാണ്,0,0,1,1
46858,herhaalt,0,0,1,1
50744,جئت,0,0,1,1
38180,challenged,0,0,1,1
38179,schlecht,0,0,1,1
38178,récit,0,0,1,1
46859,ограничиваются,0,0,1,1
38175,ಪ್ರಾಣಿ,0,0,1,1
46860,изменилась,0,0,1,1
38173,préoccupe,0,0,1,1
38165,எனப்படும்,0,0,1,1
46861,मॉल,0,0,1,1
46862,உருவாக்கி,0,0,1,1
38172,ഘട്ടത്തിൽ,0,0,1,1
50742,γυρίζει,0,0,1,1
46864,ಬಯಸಿದ,0,0,1,1
46865,logoları,0,0,1,1
51988,bays,0,0,1,1
38169,ಅರಿತುಕೊಳ್ಳಬೇಕಾದ,0,0,1,1
38168,ಮಧ್ಯಾಹ್ನದ,0,0,1,1
38167,പണ്ഡിതനും,0,0,1,1
46866,moeilijk,0,0,1,1
46939,palace,0,0,1,1
38053,damerne,0,0,1,1
47072,ನೋಡುತ್ತಾ,0,0,1,1
46941,ursäkta,0,0,1,1
47020,क्वाडि्ृगा,0,0,1,1
52019,സംസാരിക്കുന്നുണ്ടാകാം,0,0,1,1
52021,मंदव्यंजित,0,0,1,1
37948,ukrainian,0,0,1,1
52022,കുട്ടി,0,0,1,1
47022,equivalente,0,0,1,1
52023,velocidade,0,0,1,1
47024,faune,0,0,1,1
37946,школы,0,0,1,1
47025,έως,0,0,1,1
37945,இதழ்,0,0,1,1
37944,تكررها,0,0,1,1
37943,பரந்த,0,0,1,1
47026,tommelfingrene,0,0,1,1
52024,informationskällor,0,0,1,1
47028,ஐந்து,0,0,1,1
47029,fewer,0,0,1,1
37940,கோட்டை,0,0,1,1
52025,ನೀವಿರಿ,0,0,1,1
37938,नक़ल,0,0,1,1
37937,resultatet,0,0,1,1
37936,"
hebraico",0,0,1,1
47030,joueurs,0,0,1,1
37935,basée,0,0,1,1
47031,afspreken,0,0,1,1
37949,разговора,0,0,1,1
37950,mesafede,0,0,1,1
47018,മാർഗമാണിത്,0,0,1,1
37961,ಸೋಲಿಸುತ್ತಾನೆ,0,0,1,1
47003,വംശജരെക്കാളും,0,0,1,1
47004,auprès,0,0,1,1
37968,bio,0,0,1,1
37967,τύπος,0,0,1,1
47007,தரவரிசையில்,0,0,1,1
37966,herrera,0,0,1,1
47008,связывают,0,0,1,1
47009,frontpage,0,0,1,1
37964,mês,0,0,1,1
37963,tekstpassages,0,0,1,1
52015,adivinara,0,0,1,1
47011,gennembrud,0,0,1,1
47017,rediffuser,0,0,1,1
47012,biriyle,0,0,1,1
37959,smage,0,0,1,1
47014,hsts,0,0,1,1
37957,ഇരുപതിനായിരം,0,0,1,1
47015,δώσουμε,0,0,1,1
52016,polegar,0,0,1,1
47016,выпустить,0,0,1,1
37955,dublinés,0,0,1,1
37954,одиноко»,0,0,1,1
37953,المطولة,0,0,1,1
37952,للإشارة,0,0,1,1
47032,وجودنا,0,0,1,1
37933,भली,0,0,1,1
37932,معا,0,0,1,1
37899,gebeurde,0,0,1,1
37908,അറിഞ്ഞിരിക്കണം,0,0,1,1
47056,மறுப்புக்களுக்கான,0,0,1,1
50717,cyclones,0,0,1,1
37905,nudity,0,0,1,1
37904,zwinkerten,0,0,1,1
37903,"
इलोकानो",0,0,1,1
37902,بموجب,0,0,1,1
47060, €,0,0,1,1
37901,updates,0,0,1,1
47061,والخوادم,0,0,1,1
37900,occitane,0,0,1,1
52033,cep,0,0,1,1
47053,exploration,0,0,1,1
37898,veelvoorkomend,0,0,1,1
47064,خارجية,0,0,1,1
47065,لطيفان,0,0,1,1
47067,ഇതിനായി,0,0,1,1
37895,شخص،,0,0,1,1
37894,triggered,0,0,1,1
47068,உங்களுக்குச்,0,0,1,1
47070,troca,0,0,1,1
37892,nació,0,0,1,1
47071,оболочки,0,0,1,1
37891,gedroeg,0,0,1,1
37909,fermée,0,0,1,1
37911,cujos,0,0,1,1
47034,نتائج,0,0,1,1
37923,d’évaluation,0,0,1,1
37931,repose,0,0,1,1
37930,äußersten,0,0,1,1
37928,تدريجية,0,0,1,1
47037,brisé,0,0,1,1
47039,subió,0,0,1,1
37927,receiver,0,0,1,1
52027,sounds,0,0,1,1
47040,jämförbar,0,0,1,1
52028,запутал,0,0,1,1
47041,വിക്കിപീഡിയരും,0,0,1,1
47042,michelle,0,0,1,1
37922,porcentaje,0,0,1,1
47049,complicada,0,0,1,1
37921,anglosakson,0,0,1,1
37920,ontwikkeld,0,0,1,1
47044,propriété,0,0,1,1
37918,جرب,0,0,1,1
52029,ನೀರು,0,0,1,1
37917,trataste,0,0,1,1
47045,καλύτερη,0,0,1,1
47046,пытаетесь,0,0,1,1
37914,مشتقة,0,0,1,1
37913,rød,0,0,1,1
37912,निर्देशांक,0,0,1,1
47002,войск,0,0,1,1
37970,हेंडलिंग,0,0,1,1
47001,paradojas,0,0,1,1
46965,puedas,0,0,1,1
38031,sentiment,0,0,1,1
38030,dimension,0,0,1,1
38029,அதையே,0,0,1,1
38028,разницы,0,0,1,1
38027,önünde,0,0,1,1
52008,marinarkeologi,0,0,1,1
46962,communityproduced,0,0,1,1
38026,оценок,0,0,1,1
38025,yavaşça,0,0,1,1
46963,uppenbart,0,0,1,1
38024,وثالث,0,0,1,1
38023,préfère,0,0,1,1
38033,विकटियोनरी,0,0,1,1
46966,°′″w﻿,0,0,1,1
46967,πεινάτε,0,0,1,1
38021,aanleidinggevend,0,0,1,1
50725,அனுபவம்,0,0,1,1
38020,ಖರೀದಿಸುವುದಿಲ್ಲ,0,0,1,1
38019,implémentation,0,0,1,1
46970,இக்,0,0,1,1
38017,трое,0,0,1,1
38016,yolunu,0,0,1,1
46971,σωστή,0,0,1,1
38015,குறிப்பாக,0,0,1,1
38032,språkupplagan,0,0,1,1
46960,വിഷയത്തിലെ,0,0,1,1
52009,snegl,0,0,1,1
46950,പരിചയപ്പെടാം,0,0,1,1
46943,bugle,0,0,1,1
38050,blockeringar,0,0,1,1
38049,cevap,0,0,1,1
46945,എടുക്കാൻ,0,0,1,1
46946,mostrar,0,0,1,1
52005,l’entraînant,0,0,1,1
38045,garry,0,0,1,1
38044,входного,0,0,1,1
46947,tilbyde,0,0,1,1
46948,പൊതുവായി,0,0,1,1
46949,ruwe,0,0,1,1
38041,ممثلون,0,0,1,1
38036,आमेरिकेन,0,0,1,1
38040,दृश्य,0,0,1,1
46951,sıktığım,0,0,1,1
46952,согласиться,0,0,1,1
46953,experimente,0,0,1,1
38038,آخرين,0,0,1,1
46954,educativos,0,0,1,1
46955,deportes,0,0,1,1
46956,füße,0,0,1,1
46957,constitution,0,0,1,1
38037,நோக்கமாகும்,0,0,1,1
46958,eigenaar,0,0,1,1
46974,« exemple,0,0,1,1
38012,നല്ലതാണെങ്കിൽ,0,0,1,1
47000,ಕುದುರೆಯಂತಹ,0,0,1,1
37980,vicinity,0,0,1,1
46992,cayo,0,0,1,1
52011,infeliz,0,0,1,1
37988,höra,0,0,1,1
37987,collecté,0,0,1,1
37986,скучно,0,0,1,1
50722,تبكي,0,0,1,1
37984,وسري,0,0,1,1
37983,തയ്യാറായി,0,0,1,1
37982,الفكرة,0,0,1,1
46994,ingick,0,0,1,1
52012,snelle,0,0,1,1
37979,καρφί,0,0,1,1
46990,cömert,0,0,1,1
37978,traditionallycompiled,0,0,1,1
46996,يلقى,0,0,1,1
37976,categorization,0,0,1,1
52013,τουρίστας,0,0,1,1
37974,इयर,0,0,1,1
46997,சூப்பில்,0,0,1,1
52014,وأبل,0,0,1,1
37973,fund,0,0,1,1
37972,ಅವನೊಂದಿಗೆ,0,0,1,1
46998,ಸುಸೇವ್,0,0,1,1
46999,bahsetme,0,0,1,1
46991,front,0,0,1,1
37990,wikiespecies,0,0,1,1
46975,projetada,0,0,1,1
38001,أيًا,0,0,1,1
46976,bakıcısı,0,0,1,1
38010,hoogkwalitatieve,0,0,1,1
46977,aispecific,0,0,1,1
46978,reflektion,0,0,1,1
38008,предпочтение,0,0,1,1
46979,ഉപയോഗിച്ചാൽ,0,0,1,1
46980,ταξιδιών,0,0,1,1
38007,raymond,0,0,1,1
38006,रही।,0,0,1,1
46981,يشمل,0,0,1,1
38003,رحلاته,0,0,1,1
46983,يتجاوز,0,0,1,1
37991,बुलाया,0,0,1,1
50724,എന്നതുപോലെയാണ്,0,0,1,1
37999,несвободные,0,0,1,1
37998,पहुँचने,0,0,1,1
46985,förekommande,0,0,1,1
46986,afectados,0,0,1,1
37997,عليه,0,0,1,1
46987,ಬಯಸದಿದ್ದರೆ,0,0,1,1
46988,automáticos»,0,0,1,1
37993,okunulacak,0,0,1,1
37992,plet,0,0,1,1
46989,പഠനത്തിലൂടെ,0,0,1,1
38939,conmovido,0,0,1,1
46286,offering,0,0,1,1
40380,narcisini,0,0,1,1
39933,verwarren,0,0,1,1
39906,angive,0,0,1,1
51712,संदेह,0,0,1,1
39905,പദങ്ങൾ‌,0,0,1,1
45615,pedirle,0,0,1,1
39904,foros,0,0,1,1
39903,उबाऊ,0,0,1,1
45616,നല്ലവരായിരിക്കുക,0,0,1,1
45619,gelin,0,0,1,1
51713,substituída,0,0,1,1
39899,последнюю,0,0,1,1
51714,almaya,0,0,1,1
39898,pioneer,0,0,1,1
50895,वेंबेर्गेर,0,0,1,1
45622,सलेक्शन,0,0,1,1
39895,நகைச்சுவை,0,0,1,1
39894,integrity,0,0,1,1
39892,confundi,0,0,1,1
39891,plötzlich,0,0,1,1
39890,fångar,0,0,1,1
45625,draft,0,0,1,1
50894,intentional,0,0,1,1
45627,múltiplos,0,0,1,1
39888,emploie,0,0,1,1
39886,படுக்கை,0,0,1,1
39885,arbcom,0,0,1,1
39907,noncommercial,0,0,1,1
39908,judicial,0,0,1,1
39909,particuliers,0,0,1,1
45609,ligações,0,0,1,1
51709,волнуйся,0,0,1,1
39930,"
ऑसिशियाई",0,0,1,1
39929,തമ്മിലുള്ള,0,0,1,1
39928,çarpıcı,0,0,1,1
45599,quotidiennes,0,0,1,1
45600,yansıtmaya,0,0,1,1
39926,ಆಲಿಸಿ,0,0,1,1
45601,gravity,0,0,1,1
45602,начнем,0,0,1,1
39924,editorial​​,0,0,1,1
50896,chemical,0,0,1,1
39922,വാക്യ,0,0,1,1
39910,falsidades,0,0,1,1
45610,സൗരയൂഥത്തിൽ,0,0,1,1
39920,disharmoni,0,0,1,1
39919,മാതൃകയെ,0,0,1,1
51710,calcular,0,0,1,1
39917,weed,0,0,1,1
39915,révèle,0,0,1,1
39914,ف,0,0,1,1
51711,كتابه,0,0,1,1
39912,denying,0,0,1,1
45613,dell,0,0,1,1
45614,supprimer,0,0,1,1
39884,‘மைக்கேல்,0,0,1,1
45630,എഴുതുന്നത്‌,0,0,1,1
51715,repetição,0,0,1,1
45657,модифицировано,0,0,1,1
45649,πρώτη,0,0,1,1
39857,avvisade,0,0,1,1
39856,ശ്രമകരമായിത്തോന്നാം,0,0,1,1
45651,பக்கத்தின்,0,0,1,1
39855,الدراسات,0,0,1,1
39854,darin,0,0,1,1
39853,göras,0,0,1,1
45652,erronée,0,0,1,1
39850,apresentar,0,0,1,1
45654,« dépourvus,0,0,1,1
45655,проснулся,0,0,1,1
45659,bultin,0,0,1,1
39860,സെൽ,0,0,1,1
45661,workaround,0,0,1,1
39847,émergeant,0,0,1,1
39846,predeterminada,0,0,1,1
45662,giriş,0,0,1,1
39844,citerad,0,0,1,1
45664,entendrez,0,0,1,1
39842,categorisation,0,0,1,1
45665,विश्वास,0,0,1,1
39840,καθένας,0,0,1,1
39839,compromis,0,0,1,1
39838,കാണരുത്,0,0,1,1
39859,ædelstene,0,0,1,1
45648,ஆண்களை,0,0,1,1
39881,ലഭ്യമായാൽ,0,0,1,1
39872,энергетический,0,0,1,1
45631,тупыми,0,0,1,1
39879,wait,0,0,1,1
45632,انفتاحًا,0,0,1,1
39878,suscetibilidade,0,0,1,1
39877,"
दुनिया",0,0,1,1
51716,കൃത്യതയും,0,0,1,1
45633,करायेगा।,0,0,1,1
39875,عطس,0,0,1,1
45634,universele,0,0,1,1
39873,fanger,0,0,1,1
45637,الخيارات,0,0,1,1
51718,आज़माएँ,0,0,1,1
45647,weitere,0,0,1,1
45638,надёжности,0,0,1,1
45639,examplestasks,0,0,1,1
45640,planten,0,0,1,1
45641,babosa,0,0,1,1
39868,كلي,0,0,1,1
45642,anlam,0,0,1,1
45645,décrivait,0,0,1,1
39865,пароль,0,0,1,1
39864,पीड़ित,0,0,1,1
39863,"
bengali",0,0,1,1
45646,desirable,0,0,1,1
39932,анализа,0,0,1,1
39934,actualité,0,0,1,1
38941,efterfølgende,0,0,1,1
50899,zout,0,0,1,1
45552,обо,0,0,1,1
39993,ಹಲವಾರು,0,0,1,1
39992,ilgilerini,0,0,1,1
39991,learning‏,0,0,1,1
39990,прачечную,0,0,1,1
45556,fransk,0,0,1,1
50904,ಮುಂದುವರೆಸು,0,0,1,1
39988,historikern,0,0,1,1
45557,ಇಲ್ಲದೆ,0,0,1,1
39986,സൈർ,0,0,1,1
39985,beteckna,0,0,1,1
45559,"
checo",0,0,1,1
39983,улучшайте,0,0,1,1
45560,journée,0,0,1,1
39982,உற்சாகப்படுத்துங்கள்,0,0,1,1
45562,télévisées,0,0,1,1
45563,kullanılmak,0,0,1,1
39980,टाइम,0,0,1,1
45564,चिन्हित,0,0,1,1
45565,மந்தமாகிவிட்டது,0,0,1,1
39978,aufzumuntern,0,0,1,1
51703,مقطعين,0,0,1,1
45566,vergelijkend,0,0,1,1
45567,genotypes,0,0,1,1
45568,ഒരോ,0,0,1,1
45551,fondée,0,0,1,1
45550,ധരിച്ചിട്ടുണ്ടെന്നും,0,0,1,1
45549,الإعلامية,0,0,1,1
40005,എന്തുചെയ്യും,0,0,1,1
40019,diyor,0,0,1,1
45532,macaque,0,0,1,1
45533,"
आर्मिनियाई",0,0,1,1
40016,negativos,0,0,1,1
45534,possède,0,0,1,1
45535,قابلة,0,0,1,1
40013,வாழ்த்துவதற்கான,0,0,1,1
45536,एनलाइटएनमेंट,0,0,1,1
40010,φτωχή,0,0,1,1
40009,"
लिगुरियाई",0,0,1,1
40006,ആശയക്കുഴപ്പത്തിലാക്കുക,0,0,1,1
45541,permitidas,0,0,1,1
39996,eliminação,0,0,1,1
45543,казались,0,0,1,1
40002,ಅಮ್ಮನಾಗಿ,0,0,1,1
45544,mutluyum,0,0,1,1
40001,മറയ്ക്കാൻ,0,0,1,1
45545,accélération,0,0,1,1
45546,korkmuştu,0,0,1,1
39999,شيركي،,0,0,1,1
45547,az •,0,0,1,1
39997,accent,0,0,1,1
45548,assimilable,0,0,1,1
51701,निष्क्रिय,0,0,1,1
39976,étend,0,0,1,1
39975,imprécis,0,0,1,1
45569,रहें,0,0,1,1
39947,गारंटी,0,0,1,1
45588,satisfactoria,0,0,1,1
45589,الملحوظة،,0,0,1,1
45591,πνιγεί,0,0,1,1
39953,statens,0,0,1,1
45593,கூறும்போது,0,0,1,1
39952,മെല്ലിയോടും,0,0,1,1
39951,formam,0,0,1,1
45594,electronicawedstrijd,0,0,1,1
39949,الإلكترونية,0,0,1,1
45596,സംഘം,0,0,1,1
39948,ಮಾಡುತ್ತೀರಾ,0,0,1,1
39946,விரைவு,0,0,1,1
45585,parisien,0,0,1,1
39945,ദുഷ്പ്രവൃത്തി,0,0,1,1
39944,शास्त्रीय,0,0,1,1
51706,steder,0,0,1,1
45597,veré,0,0,1,1
39941,publicitaires,0,0,1,1
39940,ചെയ്യുന്നതിലൂടെയാണ്,0,0,1,1
39939,التحريرية,0,0,1,1
50901,وقدم,0,0,1,1
39938,സൂചിപ്പിക്കുന്നതിന്,0,0,1,1
39937,الخمس,0,0,1,1
39936,« or,0,0,1,1
45586,الإحصائية,0,0,1,1
39957,விஞ்சி,0,0,1,1
39974,நிறுவனத்தின்,0,0,1,1
45577,« moments,0,0,1,1
45570,bahsederken,0,0,1,1
39972,painting,0,0,1,1
45571,ഉദ്യമമായി,0,0,1,1
39970,തയ്യാറാക്കിയിട്ടുണ്ട്,0,0,1,1
45572,حين,0,0,1,1
39969,prévois,0,0,1,1
50903,അഭിനയിച്ചതിൽ,0,0,1,1
45573,αναγράφεται,0,0,1,1
45574,estu,0,0,1,1
45576,beschrijvingsvak,0,0,1,1
39968,ശബ്ദമാണ്,0,0,1,1
45578,erstaunlicher,0,0,1,1
39958,пародируются,0,0,1,1
39967,nonfiction,0,0,1,1
51705,dérangerait,0,0,1,1
39965,ഒരുപാട്,0,0,1,1
39964,rechazó,0,0,1,1
45580,appalling,0,0,1,1
39963,التحليلات,0,0,1,1
39962,"
turco",0,0,1,1
45583,dağıtma,0,0,1,1
39960,पर्यटक,0,0,1,1
50902,empty,0,0,1,1
39959,упростить,0,0,1,1
45669,നാളത്തേക്ക്,0,0,1,1
45670,विकिकोटे,0,0,1,1
45671,internetbaserede,0,0,1,1
45672,registrar,0,0,1,1
45746,डरा,0,0,1,1
39717,щелкнувший,0,0,1,1
39716,സുന്ദരിയും,0,0,1,1
51729,പലരുണ്ടാവുംഅവരുടെ,0,0,1,1
45747,bijgewerkt,0,0,1,1
39714,передаёт,0,0,1,1
39712,narsizaya,0,0,1,1
39711,பதிப்பாக,0,0,1,1
45749,migrated,0,0,1,1
45750,çıldırdığımı,0,0,1,1
51730,tevens,0,0,1,1
51731,agent,0,0,1,1
45753,humide,0,0,1,1
39709,விரல்களில்,0,0,1,1
39708,lunar,0,0,1,1
39707,glaciation,0,0,1,1
39706,produits,0,0,1,1
45754,anlamsızca,0,0,1,1
45756,умно,0,0,1,1
39705,publicadas,0,0,1,1
45758,conspirar,0,0,1,1
39703,yakalanma,0,0,1,1
39702,tim,0,0,1,1
39701,multidões,0,0,1,1
45759,ناحية,0,0,1,1
39718,nessas,0,0,1,1
39719,कहेगा,0,0,1,1
39720,செருமானிய,0,0,1,1
50885,registrado,0,0,1,1
39744,பொறுமையாகவும்,0,0,1,1
50886,bureaucracy,0,0,1,1
45735,участия,0,0,1,1
39740,collabore,0,0,1,1
39739,συμβεί,0,0,1,1
45737,समझा,0,0,1,1
45738,pocas,0,0,1,1
51728,gebeurd,0,0,1,1
39736,intrinsically,0,0,1,1
39734,συνέβαινε,0,0,1,1
39733,أندرو,0,0,1,1
45740,тобой,0,0,1,1
39721,immediately,0,0,1,1
45741,gruppen,0,0,1,1
39731,intercepter,0,0,1,1
45742,violés,0,0,1,1
39730,aufgehört,0,0,1,1
39728,fresco»,0,0,1,1
45744,ನಿಧಾನವಾಗಿದ್ದೇನೆ,0,0,1,1
39726,الخلوي؟,0,0,1,1
39725,stockholms,0,0,1,1
39724,vergeten,0,0,1,1
39723,levende,0,0,1,1
45745,dérange,0,0,1,1
39700,उलझन,0,0,1,1
51732,кластерах,0,0,1,1
45760,corchetes,0,0,1,1
45789,kişiye,0,0,1,1
51735,टुकड़ा,0,0,1,1
39679,ಅಭ್ಯಾಸ,0,0,1,1
50878,prévaloir,0,0,1,1
50877,يحمل,0,0,1,1
39678,ಯಾವಾಗ,0,0,1,1
39677,٪,0,0,1,1
39676,svenskt,0,0,1,1
39675,ഉണ്ടാവില്ലെന്നർത്ഥം,0,0,1,1
39674,intimidad,0,0,1,1
39673,subgrupos,0,0,1,1
39672,അയയ്ക്കും,0,0,1,1
39670,الكوكب,0,0,1,1
45783,angår,0,0,1,1
39669,ongewild,0,0,1,1
45791,elders,0,0,1,1
50876,ഉണ്ടായിരുന്നുവെന്ന്,0,0,1,1
39666,എടുക്കുന്നു,0,0,1,1
45793,ನಕಲಿಸಲು,0,0,1,1
51736,descartan,0,0,1,1
51737,inkl,0,0,1,1
39664,votar,0,0,1,1
39663,بالغ,0,0,1,1
39662,hatırlatmak,0,0,1,1
51738,carry,0,0,1,1
45784,столько,0,0,1,1
39681,resolved,0,0,1,1
39699,responsabilités,0,0,1,1
45772,live,0,0,1,1
39698,упоминай,0,0,1,1
50881,profondes »,0,0,1,1
45763,отдельный,0,0,1,1
45764,ಫಿಕ್ಸ್‌ನಲ್ಲಿದೆ,0,0,1,1
39696,fingrarna,0,0,1,1
39695,manager,0,0,1,1
45765,parameters,0,0,1,1
50880,consta,0,0,1,1
45770,അത്താഴത്തിന്,0,0,1,1
39693,αφοσιωμένη,0,0,1,1
45771,τείνουμε,0,0,1,1
50879,ഭാഗ്യവാനായ,0,0,1,1
39682,istiyor,0,0,1,1
39691,«непредубеждения»,0,0,1,1
45773,valendo,0,0,1,1
45774,καλής,0,0,1,1
51733,жена,0,0,1,1
45776,தும்மும்போது,0,0,1,1
39688,പറയണം,0,0,1,1
39687,ಮಾಡಬೇಕು,0,0,1,1
39686,yale,0,0,1,1
45779,probeerde,0,0,1,1
45780,corrigées,0,0,1,1
39683,എഴുതപ്പെടുന്നത്,0,0,1,1
39745,அறியப்பட்டிருந்தாலும்,0,0,1,1
39746,προτίμησης,0,0,1,1
39747,എടുത്ത,0,0,1,1
51723,revision,0,0,1,1
39810,roupa,0,0,1,1
45692,கணிப்பிடும்,0,0,1,1
39809,épique,0,0,1,1
39808,σωστός,0,0,1,1
45694,surgem,0,0,1,1
45695,fausses,0,0,1,1
39807,सवार्त्ज़,0,0,1,1
39806,financieele,0,0,1,1
45696,एजेंसीयों,0,0,1,1
39805,небольшие,0,0,1,1
39804,स्थिर,0,0,1,1
45697,grönvall,0,0,1,1
45691,comencemos,0,0,1,1
39803,üzereyseniz,0,0,1,1
45698,predictivo,0,0,1,1
45700,أتضور,0,0,1,1
39801,generating,0,0,1,1
39799,ಹೇಳಿದ್ದು,0,0,1,1
39798,ought,0,0,1,1
39797,llamaba,0,0,1,1
39796,garagem,0,0,1,1
45702,schmutz,0,0,1,1
45703,barajaron,0,0,1,1
39794,dikes,0,0,1,1
50889,സമ്പൂർണ്ണമാക്കുന്നതിനും,0,0,1,1
45690,jornada,0,0,1,1
45705,grundskoleexamen,0,0,1,1
39824,supervisor,0,0,1,1
39833,صنع,0,0,1,1
45673,viajes,0,0,1,1
39832,πίστευε,0,0,1,1
51721,токио,0,0,1,1
39830,ziehen,0,0,1,1
45675,catastrophe,0,0,1,1
51722,المسجلون,0,0,1,1
45676,расскажи,0,0,1,1
39827,delta,0,0,1,1
39826,fold,0,0,1,1
39825,πληρώσει,0,0,1,1
45681,avaliado,0,0,1,1
39812,cruelle,0,0,1,1
39823,வினை,0,0,1,1
39821,повсюду,0,0,1,1
45682,"
sundanês",0,0,1,1
50891,seçkin,0,0,1,1
45683,புரிந்துகொள்வதில்,0,0,1,1
39818,enenciclopedia,0,0,1,1
45686,fonctionnent,0,0,1,1
45687,höfling en,0,0,1,1
50890,внесёнными,0,0,1,1
39814,subsurface,0,0,1,1
39813,adı,0,0,1,1
39793,saludos,0,0,1,1
39792,entonación,0,0,1,1
39748,пришел,0,0,1,1
45726,superó,0,0,1,1
45725,vivre,0,0,1,1
39766,sexuada,0,0,1,1
39765,insanlar,0,0,1,1
39764,preferia,0,0,1,1
39763,கடக்கிறீர்கள்,0,0,1,1
39762,நிறுவனர்கள்,0,0,1,1
50887,extensively,0,0,1,1
39760,planlægger,0,0,1,1
39759,ತೋಟದಲ್ಲಿ,0,0,1,1
39758,afbryder,0,0,1,1
39757,summarizing,0,0,1,1
45727,zweiten,0,0,1,1
39768,inexplorable,0,0,1,1
45729,lebte,0,0,1,1
39753,förändra,0,0,1,1
45730,കുറവുള്ള,0,0,1,1
45731,"
esperanto",0,0,1,1
39752,للمقالات,0,0,1,1
51727,edifícios,0,0,1,1
45732,волшебный,0,0,1,1
39751,aportaciones,0,0,1,1
45733,низкие,0,0,1,1
39749,naber,0,0,1,1
45734,exercée,0,0,1,1
39767,normalement,0,0,1,1
39769,engagé,0,0,1,1
45706,கேட்கக்கூடிய,0,0,1,1
39784,قمت,0,0,1,1
39791,ατρόμητο,0,0,1,1
45707,tomber,0,0,1,1
39789,ನಿಧಾನವಾಗಿರುತ್ತದೆ,0,0,1,1
45708,തെളിയിച്ചില്ലെങ്കിൽ,0,0,1,1
45709,guia,0,0,1,1
45710,cultivée,0,0,1,1
39788,ಅಲಂಕಾರಿಕ,0,0,1,1
39787,متصل,0,0,1,1
39786,टूट,0,0,1,1
45711,وضعك,0,0,1,1
39785,stylistic,0,0,1,1
39783,мировым,0,0,1,1
39770,استيقظت,0,0,1,1
45715,governamental,0,0,1,1
45717,wikibased,0,0,1,1
45718,австрии,0,0,1,1
39780,grof,0,0,1,1
39779,cultivé,0,0,1,1
45722,ഉചിതമല്ല,0,0,1,1
39775,വൃത്തിയാക്കൽ,0,0,1,1
39774,накормим,0,0,1,1
39773,schienen,0,0,1,1
39772,قفزت,0,0,1,1
45724,desfrutam,0,0,1,1
40020,alacak,0,0,1,1
51700,ಹಿಸಿದರೂ,0,0,1,1
45530,مطعم,0,0,1,1
40204,accepteert,0,0,1,1
40266,जानेमन,0,0,1,1
45349,« encyclopédie,0,0,1,1
40264,hazlo,0,0,1,1
45351,faisait,0,0,1,1
45352,стивен,0,0,1,1
50941,—imprecisiones,0,0,1,1
51660,naaktslak,0,0,1,1
45356,പ്രതിനിധാനം,0,0,1,1
40262,oturup,0,0,1,1
50940,عظيم,0,0,1,1
51662,മുങ്ങുന്നു,0,0,1,1
45357,mermeladas,0,0,1,1
45359,ekmekle,0,0,1,1
40259,occasionnée,0,0,1,1
40258,பல்கலைக்கழகத்தில்,0,0,1,1
45361,ವಿಷಯಗಳನ್ನು,0,0,1,1
40257,публичное,0,0,1,1
40256,அறிமுகப்படுத்தியது,0,0,1,1
45362,المجاني,0,0,1,1
45364,conflitos,0,0,1,1
40254,"
asturiano",0,0,1,1
40252,inner,0,0,1,1
40251,அச்சுறுத்தல்,0,0,1,1
40250,telifi,0,0,1,1
40249,भागीदार,0,0,1,1
45348,ചെറുതുള്ളികൾ,0,0,1,1
40269,salutations,0,0,1,1
45347,سيبدو,0,0,1,1
45341,റാണിയില്ലാത്ത,0,0,1,1
45338,интеллекта,0,0,1,1
40291,விரும்புவதில்லை,0,0,1,1
40290,планете,0,0,1,1
45339,durdurabilir,0,0,1,1
40289,بذلك؟,0,0,1,1
40288,pasaran,0,0,1,1
40287,parlement,0,0,1,1
40286,ماء؟,0,0,1,1
40284,torsdag,0,0,1,1
40283,incompleta,0,0,1,1
40282,तस्वीरें,0,0,1,1
45342,clásicas,0,0,1,1
40270,abrazar,0,0,1,1
40280,المعارض,0,0,1,1
51656,détecter,0,0,1,1
51657,etiquetas,0,0,1,1
40277,حساب,0,0,1,1
45344,ലൈബ്രറി,0,0,1,1
40276,താല്പര്യമുള്ള,0,0,1,1
51658,¿cuáles,0,0,1,1
40273,ഗെയിമിനെ,0,0,1,1
40272,defienden,0,0,1,1
45346,ಪಾಠದಲ್ಲಿ,0,0,1,1
40271,പതിവിലും,0,0,1,1
40248,मानचित्र,0,0,1,1
45366,opgewonden,0,0,1,1
40246,agira,0,0,1,1
40217,பிரச்சினைகள்,0,0,1,1
45386,glauben,0,0,1,1
40225,integrated,0,0,1,1
40224,cavaleiro,0,0,1,1
45387,söylemesi,0,0,1,1
45388,källan,0,0,1,1
45390,выйдете,0,0,1,1
45391,скотт,0,0,1,1
51669,russa,0,0,1,1
45392,"
नीपोलिटाई",0,0,1,1
40219,ಬಳಸಿದರೆ,0,0,1,1
40218,intégralement,0,0,1,1
40216,índice,0,0,1,1
40226,olmaktan,0,0,1,1
51670,обнаружить,0,0,1,1
40215,ضمان,0,0,1,1
40214,çevrilmiş,0,0,1,1
40210,¿quién,0,0,1,1
45396,للتغيير،,0,0,1,1
40209,desistir,0,0,1,1
45397,contredite,0,0,1,1
40208,genoptage,0,0,1,1
40207,considerarla,0,0,1,1
45399,അപ്പോൾ,0,0,1,1
45400,handful,0,0,1,1
45385,விக்கிப்பீடியாவிலிருந்து,0,0,1,1
45384,surprised,0,0,1,1
40245,podrías,0,0,1,1
45375,ഉപജ്ഞാതാവ്,0,0,1,1
45367,ആശയക്കുഴപ്പത്തിലാകുന്നത്,0,0,1,1
51665,stormy,0,0,1,1
40242,pay,0,0,1,1
45368,മെഷീൻ,0,0,1,1
50937,réparées,0,0,1,1
40240,aesthetic,0,0,1,1
45370,ವೇಗದಲ್ಲಿರಲು,0,0,1,1
45371,آراء,0,0,1,1
45372,منظر,0,0,1,1
51666,читаю,0,0,1,1
40236,traído,0,0,1,1
40235,bridle,0,0,1,1
50935,bars,0,0,1,1
40234,التأكيد,0,0,1,1
40233,المخربون,0,0,1,1
40232,medias,0,0,1,1
40231,désuets,0,0,1,1
40230,телефоном,0,0,1,1
45377,asegúrese,0,0,1,1
40229,വളരെക്കാലമായിരിക്കുന്നു,0,0,1,1
45378,മാതൃകയിൽപ്പോലും,0,0,1,1
40228,gallego,0,0,1,1
45379,wikinoticias,0,0,1,1
50936,walter,0,0,1,1
40292,balans,0,0,1,1
45334,അപ്പപ്പോഴത്തെ,0,0,1,1
40294,adım,0,0,1,1
40346,salladığın,0,0,1,1
40355,parcs,0,0,1,1
40354,diverge,0,0,1,1
45295,neurophysiologiste,0,0,1,1
40352,صرحت,0,0,1,1
45297,riesgos,0,0,1,1
40351,gråt,0,0,1,1
50947,полезно,0,0,1,1
40350,encyclopédique,0,0,1,1
40349,yapılmaktadır,0,0,1,1
40348,பெண்கள்,0,0,1,1
40347,принцип,0,0,1,1
40345,ಪುಸ್ತಕದಲ್ಲಿ,0,0,1,1
45293,artikelrekommendation,0,0,1,1
45298,rettelse,0,0,1,1
45299,பெறும்போது,0,0,1,1
45301,நல்லவை,0,0,1,1
40342,semantics,0,0,1,1
45302,biografieën,0,0,1,1
45303,polémicos,0,0,1,1
40340,таков,0,0,1,1
40339,obtén,0,0,1,1
40338,σπασμένη,0,0,1,1
45304,заданиями,0,0,1,1
50946,articulação,0,0,1,1
51646,sauvage,0,0,1,1
45292,gleichnamigen,0,0,1,1
40334,считала,0,0,1,1
45287,ಸ್ನೇಹಿತ,0,0,1,1
40379,ελληνόφωνη,0,0,1,1
40378,ஐகானையும்,0,0,1,1
40377,open—anyone,0,0,1,1
40376,dioxide,0,0,1,1
45282,sökverktyg,0,0,1,1
45283,расположена,0,0,1,1
50949,traduite,0,0,1,1
40373,verjaardag,0,0,1,1
45285,upphovsrätt,0,0,1,1
45286,मेटाविकी,0,0,1,1
51643,obteniez,0,0,1,1
40370,hypertekst,0,0,1,1
40359,सिटीजेंडियम,0,0,1,1
40369,പ്രവർത്തിക്കുമെന്ന്,0,0,1,1
40368,articles ,0,0,1,1
45288,جوعا,0,0,1,1
51644,bereit,0,0,1,1
40366,privilégio,0,0,1,1
40364,الجاني,0,0,1,1
40363,πλανήτη,0,0,1,1
45290,पडेगा,0,0,1,1
40361,sohbetin,0,0,1,1
40360,djupintervjuer,0,0,1,1
45291,traducido,0,0,1,1
40335,دعنى,0,0,1,1
40333,nase,0,0,1,1
51653,maravilloso,0,0,1,1
45325,மனைவியாக,0,0,1,1
50944,fraile,0,0,1,1
40313,corresponding,0,0,1,1
45317,पैसा,0,0,1,1
40311,فهذا,0,0,1,1
40310,« passeur »,0,0,1,1
45320,pojken,0,0,1,1
45321,अंतर्गत,0,0,1,1
45322,tillförlitlig,0,0,1,1
40308,hverdag,0,0,1,1
40307,أصليًا,0,0,1,1
51651,overbrugt,0,0,1,1
45326,necesito,0,0,1,1
45314,डिस्क्स,0,0,1,1
40302,тексты,0,0,1,1
40301,ಇನ್ನು,0,0,1,1
40300,düşündüm,0,0,1,1
40299,biotope,0,0,1,1
45327,depend,0,0,1,1
45328,ഏറെ,0,0,1,1
45329,الاتجاه,0,0,1,1
45330,imminente,0,0,1,1
45331,kulağa,0,0,1,1
45332,ईमानदारी,0,0,1,1
40295,ಮೀರಿ,0,0,1,1
45315,التجاري,0,0,1,1
40315,مذهلاً,0,0,1,1
40332,столь,0,0,1,1
40323,вашем,0,0,1,1
45305,открытым,0,0,1,1
40331,pollueur,0,0,1,1
40330,имеющейся,0,0,1,1
40329,отмечено,0,0,1,1
40328,польская,0,0,1,1
40327,adicionam,0,0,1,1
45306,verktygs,0,0,1,1
45307,annesiyle,0,0,1,1
40325,टेबल,0,0,1,1
40324,storbritanniens,0,0,1,1
45308,testing,0,0,1,1
40322,статистическим,0,0,1,1
45313,അനുഭവപ്പെട്ടേക്കാം,0,0,1,1
40321,robijnen,0,0,1,1
51647,поздравить,0,0,1,1
40320,alternative »,0,0,1,1
51648,تشكيل,0,0,1,1
40319,ഇരിക്കുന്നതുപോലെയാണ്,0,0,1,1
45309,ബന്ധങ്ങൾ,0,0,1,1
51649,सच्चाई,0,0,1,1
45310,поняли,0,0,1,1
40317,fría,0,0,1,1
50945,طرقها,0,0,1,1
40316,झुलस,0,0,1,1
45401,الفائدة,0,0,1,1
45402,universally,0,0,1,1
40023,ഓപ്റ്റിക്കൽ,0,0,1,1
40201,περιγράψετε,0,0,1,1
40087,vies,0,0,1,1
50912,volop,0,0,1,1
40085,бедный,0,0,1,1
40084,blinkade,0,0,1,1
50911,tercüme,0,0,1,1
45488,indépendants,0,0,1,1
40082,ಮಧ್ಯದಲ್ಲಿದ್ದೀರಿ,0,0,1,1
51689,வங்கிக்கு,0,0,1,1
45489,pronouncing,0,0,1,1
45490,berna,0,0,1,1
40079,التراكمية,0,0,1,1
45491,хранятся,0,0,1,1
40078,எங்களுடன்,0,0,1,1
45492,gymnasieelever,0,0,1,1
45494,пойти,0,0,1,1
45495,isologo,0,0,1,1
50910,moverse,0,0,1,1
40076,विकिसूक्ति,0,0,1,1
40075,dérivée,0,0,1,1
50909,इनके,0,0,1,1
45499,المطاف,0,0,1,1
51691,ചരിത്രത്തെപ്പറ്റിയും,0,0,1,1
45500,قطعة,0,0,1,1
40072,kıyafet,0,0,1,1
40071,скобок,0,0,1,1
40088,grupper,0,0,1,1
40089,strickland,0,0,1,1
51688,tv,0,0,1,1
45476,повседневного,0,0,1,1
40107,ಸೈರ್,0,0,1,1
45468,sprecher,0,0,1,1
40106,വ്യവസ്ഥിതിയുടെ,0,0,1,1
45469,ιστό,0,0,1,1
45470,değilseniz,0,0,1,1
51682,وبسبب,0,0,1,1
51683,hund,0,0,1,1
45471,எளிமையான,0,0,1,1
40102,danmark,0,0,1,1
45475,разговор,0,0,1,1
40101,مجموع,0,0,1,1
45477,ദിനമായി,0,0,1,1
40090,add,0,0,1,1
50916,ننتقل,0,0,1,1
40097,يهدف,0,0,1,1
40096,dîner,0,0,1,1
45482,आरोन,0,0,1,1
51686,proost,0,0,1,1
40094,emprega,0,0,1,1
45483,пять,0,0,1,1
50915,السينما,0,0,1,1
50914,dinle,0,0,1,1
40091,दिमाग,0,0,1,1
45485,caracteriza,0,0,1,1
51692,lagrade,0,0,1,1
45501,ಅನುಭವವಿಲ್ಲದೆ,0,0,1,1
40069,सराहना,0,0,1,1
40034,stehen,0,0,1,1
40041,idéologique,0,0,1,1
45517,lyckades,0,0,1,1
45518,முடிவுகளில்,0,0,1,1
45519,secondaire,0,0,1,1
45520,bardakçı,0,0,1,1
45522,hornear,0,0,1,1
40037,meewerken,0,0,1,1
50906,നോക്കാം,0,0,1,1
40035,bebek,0,0,1,1
45523,испугался,0,0,1,1
45524,comediante,0,0,1,1
51697,quo,0,0,1,1
40043,др,0,0,1,1
40032,engendra,0,0,1,1
45525,sommeil,0,0,1,1
45526,напугала,0,0,1,1
50905,précipitations,0,0,1,1
40030,« facebook »,0,0,1,1
40028,دانيال,0,0,1,1
45527,alternativ,0,0,1,1
40026,—wikipedia—,0,0,1,1
40025,twijfel,0,0,1,1
45529,горем,0,0,1,1
40024,gemeenschappen,0,0,1,1
40042,dick,0,0,1,1
40044,alemães,0,0,1,1
40066,rapidly,0,0,1,1
45505,الأحياء,0,0,1,1
45503,الرقم,0,0,1,1
40065,prejudicial,0,0,1,1
51693,sitter,0,0,1,1
40064,"होगी।
ये",0,0,1,1
51694,മെല്ലെയായിരുന്നു,0,0,1,1
40062,விடைபெறாமல்,0,0,1,1
40061,« gauchiste » »,0,0,1,1
40060,ಪ್ರಜ್ಞೆಯು,0,0,1,1
40059,morse,0,0,1,1
45504,மெர்ரி,0,0,1,1
40057,அனுப்புங்கள்,0,0,1,1
40055,credenciados,0,0,1,1
45515,രീതിയിലേക്ക്,0,0,1,1
45508,ಹೊಳೆಯುವ,0,0,1,1
40053,ಸಿಕ್ಕಿದ್ದು,0,0,1,1
45509,webaroo,0,0,1,1
50907,تعاونياً,0,0,1,1
40050,sketches,0,0,1,1
45510,nossas,0,0,1,1
40048,políglota,0,0,1,1
40047,पूछे,0,0,1,1
51695,आपजानते,0,0,1,1
45513,periodically,0,0,1,1
45514,epostamda,0,0,1,1
40108,بأوسمة,0,0,1,1
40109,ficticia,0,0,1,1
45467,நபரின்,0,0,1,1
40172,asterisco,0,0,1,1
40180,verenigde,0,0,1,1
45419,السويدية،,0,0,1,1
45420,устарел,0,0,1,1
45421,êxtase,0,0,1,1
45422,голосов,0,0,1,1
40177,nonwhite,0,0,1,1
45423,critiquée,0,0,1,1
50922,présentait,0,0,1,1
45424,hyperlink,0,0,1,1
45428,تضر,0,0,1,1
40173,بصراحة,0,0,1,1
45429,तलाश,0,0,1,1
45418,destinadas,0,0,1,1
45432,рубиновое,0,0,1,1
45433,ஒழுங்குபடுத்தப்பட்டிருக்கும்,0,0,1,1
40168,совершила,0,0,1,1
40167,ನಡೆಯುತ್ತಿದ್ದರೆ,0,0,1,1
45437,السياسة,0,0,1,1
40164,ಯಾವುವು,0,0,1,1
40161,कार्यालय,0,0,1,1
40160,കണ്ടെത്തിയ,0,0,1,1
40159,μοναδική,0,0,1,1
40158,unikke,0,0,1,1
40157,تنتشر,0,0,1,1
40181,يسمح,0,0,1,1
45417,блюд,0,0,1,1
40156,“விக்கிமீடீயா”,0,0,1,1
45409,लंबा,0,0,1,1
45403,şaşkınlık,0,0,1,1
40200,vindo,0,0,1,1
40199,നിർത്തിയപ്പോൾ,0,0,1,1
40198,halvautomatiserade,0,0,1,1
40197,स्टैनफोर्ड,0,0,1,1
50928,juiste,0,0,1,1
45404,யோசித்துக்கொண்டிருந்தேன்,0,0,1,1
40195,അടിച്ചു,0,0,1,1
40194,basados,0,0,1,1
40193,gratuite,0,0,1,1
50926,فاجئك,0,0,1,1
40191,kritiseret,0,0,1,1
45416,результатом,0,0,1,1
40190,വരുമെന്നും,0,0,1,1
50925,elskede,0,0,1,1
40188,siglo,0,0,1,1
45410,concrétisation,0,0,1,1
40187,e symposium,0,0,1,1
45411,gülümsemesini,0,0,1,1
40185,സിസോപ്പുകൾ,0,0,1,1
45413,parcourant,0,0,1,1
45414,हैकृपया,0,0,1,1
40182,இருக்கவும்,0,0,1,1
50924,некорректным,0,0,1,1
45438,desenvolver,0,0,1,1
40155,contato,0,0,1,1
45466,ajustes,0,0,1,1
40122,പ്രാവീണ്യമുള്ളവരാകാനുള്ള,0,0,1,1
45454,أصول,0,0,1,1
45455,udføre,0,0,1,1
40126,journey,0,0,1,1
40125,luminosity,0,0,1,1
45458,математического,0,0,1,1
45459,подошел,0,0,1,1
45461,physiques,0,0,1,1
45463,одноимённым,0,0,1,1
51680,kleid,0,0,1,1
40123,пользоваться,0,0,1,1
45465,quienes,0,0,1,1
40121,redacción,0,0,1,1
45453,ಕಾಣುತ್ತದೆ,0,0,1,1
40120,fulllength,0,0,1,1
40119,mantenido,0,0,1,1
40118,മാലാഖയെപ്പോലെയാണ്,0,0,1,1
40117,evaluar,0,0,1,1
40116,посмотрел,0,0,1,1
40115,представьте,0,0,1,1
40114,presidential,0,0,1,1
40113,inspira,0,0,1,1
40112,поновому»,0,0,1,1
40111,சந்திப்புக்கு,0,0,1,1
51681,hjärna,0,0,1,1
51679,miradas,0,0,1,1
40130,liberty,0,0,1,1
40153,karikatüründe,0,0,1,1
45443,affect,0,0,1,1
40152,hiérarchique,0,0,1,1
40150,boursier ,0,0,1,1
40149,kırmızı,0,0,1,1
45439,ತಿನ್ನಬೇಕು,0,0,1,1
40147,ரொட்டியால்,0,0,1,1
45440,spændende,0,0,1,1
45441,സബ്‌സ്‌ക്രൈബുചെയ്യാൻ,0,0,1,1
40145,ಆಘಾತಕ್ಕೊಳಗಾಗಿದ್ದಳು,0,0,1,1
40144,കാര്യങ്ങൾക്കെല്ലാം,0,0,1,1
40143,douradas,0,0,1,1
45442,देखकर,0,0,1,1
51674,لهجات,0,0,1,1
40131,modereras,0,0,1,1
40142,ಪ್ರವೇಶಿಸಿದರು,0,0,1,1
40141,ámbito,0,0,1,1
40140,paciente,0,0,1,1
45447,anlayışlı,0,0,1,1
40138,chien,0,0,1,1
51675,versucht,0,0,1,1
40135,बढ़ें,0,0,1,1
50919,förhoppningsvis,0,0,1,1
45450,دعا,0,0,1,1
45452,прерываю,0,0,1,1
40132,orbital,0,0,1,1
45794,"
वैस्पियाई",0,0,1,1
39660,enables,0,0,1,1
45795,காதலன்,0,0,1,1
39109,"
romeno",0,0,1,1
39178,biyografi,0,0,1,1
39177,экономика,0,0,1,1
39176,corregir,0,0,1,1
39175,sueca,0,0,1,1
39173,സ്വർണ്ണവണ്ടി,0,0,1,1
46131,waraywaray,0,0,1,1
39171,ക്രിയേറ്റീവ്,0,0,1,1
39170,secondaires,0,0,1,1
46133,ανοικτό,0,0,1,1
39169,creates,0,0,1,1
51825, مليار,0,0,1,1
46134,χρησιμοποιούσατε,0,0,1,1
39167,wezens,0,0,1,1
46135,இல்லாத,0,0,1,1
46136,zümrüt,0,0,1,1
39166,uteslutande,0,0,1,1
39165,wenig,0,0,1,1
46137,представительств,0,0,1,1
39163,विनम्रता,0,0,1,1
39162,चीजों,0,0,1,1
39161,പിറക്കുകയായി,0,0,1,1
39160,verdelen,0,0,1,1
46141,εισαι,0,0,1,1
39157,gne,0,0,1,1
39156,விருத்தி,0,0,1,1
39179,waffling—encouraged,0,0,1,1
46126,replace,0,0,1,1
39181,विकिपीडिया।,0,0,1,1
50839,φόρεμα,0,0,1,1
46105,وتقنيات,0,0,1,1
39195,arkadaşlarınızdan,0,0,1,1
46106,selfreplication,0,0,1,1
46109,справочником,0,0,1,1
46110,некоторая,0,0,1,1
39193,deneyim,0,0,1,1
46111,خاص,0,0,1,1
39192,أبريل,0,0,1,1
39191,وتحرير,0,0,1,1
46115,"
अंतर",0,0,1,1
46117,അതിനായി,0,0,1,1
39187,schauen,0,0,1,1
39182,serão,0,0,1,1
46118,şövalye,0,0,1,1
46119,retaining,0,0,1,1
39186,ആളുണ്ടെന്നർഥം,0,0,1,1
39185,oprit,0,0,1,1
46120,ചിലപ്പോഴെല്ലാം,0,0,1,1
51822,പൂർണ്ണമായ,0,0,1,1
46121,νόημα,0,0,1,1
46122,χαμόγελα,0,0,1,1
46123,вреда,0,0,1,1
39183,входные,0,0,1,1
46124,ders,0,0,1,1
39155,pourvus,0,0,1,1
46142,synen,0,0,1,1
39153,சொல்லை,0,0,1,1
39120,checking,0,0,1,1
39129,upright,0,0,1,1
39128,ಮೂಲೆಯಲ್ಲಿಯೇ,0,0,1,1
39127,stupéfiant,0,0,1,1
46156,لطبيعة,0,0,1,1
39125,possíveis,0,0,1,1
39124,मंत्री,0,0,1,1
46157,invalidado,0,0,1,1
46159,nede,0,0,1,1
39122,പൊതുവായ,0,0,1,1
50835,medewerkers,0,0,1,1
46162,tags,0,0,1,1
39119,deixou,0,0,1,1
39131,censar,0,0,1,1
46163,ചെയ്താണ്,0,0,1,1
39118,ακόμη,0,0,1,1
39117,tendo,0,0,1,1
39116,achevé,0,0,1,1
39115,பக்கச்,0,0,1,1
39114,tensor,0,0,1,1
51833,verstehe,0,0,1,1
46164,edilmiş,0,0,1,1
39113,ಇಮೇಲ್‌ನಲ್ಲಿ,0,0,1,1
39112,nationell,0,0,1,1
39111,إنجليزية,0,0,1,1
46155,¿perdóneme,0,0,1,1
46154,volken,0,0,1,1
39152,kinderen,0,0,1,1
39141,ementas,0,0,1,1
39151,ഘട്ടത്തിലും,0,0,1,1
50838,microcurrents,0,0,1,1
39149,tvätt,0,0,1,1
39148,शेयर,0,0,1,1
39147,व्हाट्सएप,0,0,1,1
46145,heurística,0,0,1,1
39145,fourthlargest,0,0,1,1
39144,enviada,0,0,1,1
39143,families,0,0,1,1
51826,yoksa,0,0,1,1
39142,खपत,0,0,1,1
46147,overhand,0,0,1,1
51832,amateurwetenschappers,0,0,1,1
46149,بالنسخة,0,0,1,1
46150,geradeaus,0,0,1,1
51828,forumsnote,0,0,1,1
39138,sürü,0,0,1,1
39137,uniques,0,0,1,1
46151,tollen,0,0,1,1
50837,सिस्टम,0,0,1,1
51830,ಇಲ್ಲಿಯೇ,0,0,1,1
39136,oluşturacak,0,0,1,1
46152,установил,0,0,1,1
39134,¿eh,0,0,1,1
39197,recevant,0,0,1,1
39198,شوارتز,0,0,1,1
51821,ശാസ്ത്രം,0,0,1,1
46066,تضمن,0,0,1,1
51807,ಶ್ರೀಮಂತರು,0,0,1,1
46061,ab,0,0,1,1
39260,निर्देशों,0,0,1,1
39259,photo,0,0,1,1
39258,सरकारी,0,0,1,1
46062,نشرها,0,0,1,1
39257,сомнений,0,0,1,1
39256,vapeur,0,0,1,1
46064,computación,0,0,1,1
46065,éloignée,0,0,1,1
39254,объектом,0,0,1,1
50844,отца,0,0,1,1
46059,முறையான,0,0,1,1
51810,nda,0,0,1,1
39250,frío,0,0,1,1
39249,കാര്യമോ,0,0,1,1
39248,συνεχίσω,0,0,1,1
46069,ತಾಳ್ಮೆಯಿಂದ,0,0,1,1
46070,arabasına,0,0,1,1
51812,apporté,0,0,1,1
46071,microsystem,0,0,1,1
39246,relies,0,0,1,1
46072,ступит,0,0,1,1
39245,ναρκίσια,0,0,1,1
46060,ആരംഭിക്കാനുള്ള,0,0,1,1
39263,ah,0,0,1,1
46074,viens,0,0,1,1
46051,μπερδέψα,0,0,1,1
39280,téléphonie,0,0,1,1
39279,biotechnologies,0,0,1,1
46045,जितना,0,0,1,1
51802,أمريكا,0,0,1,1
46046,ethnologues,0,0,1,1
39277,διάφορες,0,0,1,1
46047,fejler,0,0,1,1
46048,tadı,0,0,1,1
39275,equipped,0,0,1,1
39274,références »,0,0,1,1
50848,galten,0,0,1,1
39273,äktenskapet,0,0,1,1
39264,இப்பக்கத்தைப்,0,0,1,1
39272,traités,0,0,1,1
46053,τύχης,0,0,1,1
51803,sizden,0,0,1,1
46054,സാവധാനത്തിൽ,0,0,1,1
39270,പരിശോധിച്ച,0,0,1,1
39269,попросите,0,0,1,1
46055,gelmiş,0,0,1,1
50847,pertenecen,0,0,1,1
50846,распределённую,0,0,1,1
50845,साल,0,0,1,1
46058,انعكاسه,0,0,1,1
39244,sizes,0,0,1,1
39241,памяти,0,0,1,1
46104,generiek,0,0,1,1
39210,spreche,0,0,1,1
46090,añadidura,0,0,1,1
39219,tendría,0,0,1,1
50841,tercera,0,0,1,1
39217,neuen,0,0,1,1
39216,reads,0,0,1,1
39213,min •,0,0,1,1
39212,defendia,0,0,1,1
46095,ഗ്രഹങ്ങളിൽ,0,0,1,1
46096,തുടക്കംകുറിച്ചത്‌,0,0,1,1
46097,स्वचालित,0,0,1,1
46098,wikiform,0,0,1,1
39209,गाने,0,0,1,1
39220,ദൂതനോടും,0,0,1,1
39208,vinklingarna,0,0,1,1
39207,сравнить,0,0,1,1
46099,trupperna,0,0,1,1
39206,компаниявладелец,0,0,1,1
39205,belgique,0,0,1,1
46101,ಭೇಟಿಯಾಗುತ್ತೀರಿ,0,0,1,1
39203,المنخفضة,0,0,1,1
39202,результатов,0,0,1,1
50840,класс,0,0,1,1
39201,variadas,0,0,1,1
46103,பார்த்ததில்லை,0,0,1,1
46089,east,0,0,1,1
46088,جزيلاً,0,0,1,1
39240,lacked,0,0,1,1
39232,обнять,0,0,1,1
51813,നൈട്രജൻ,0,0,1,1
39239,விக்கிப்பீடியாக்களில்,0,0,1,1
39238,guidance,0,0,1,1
39237,സ്വപ്നങ്ങളിൽ,0,0,1,1
46075,starting,0,0,1,1
39236,പകുതി,0,0,1,1
46076,systematically,0,0,1,1
39235,oneindig,0,0,1,1
46077,υποτονική,0,0,1,1
51815,देती,0,0,1,1
46079,പ്രക്രിയയിലൂടെ,0,0,1,1
39231,लक्षित,0,0,1,1
46087,дорогой,0,0,1,1
46080,japanska,0,0,1,1
46082,gitmek,0,0,1,1
46083,സന്നദ്ധസമൂഹം,0,0,1,1
46084,méritos,0,0,1,1
51816,uttal vɪkɪ,0,0,1,1
51817,awareness,0,0,1,1
39224,oceanography,0,0,1,1
50842,«офис»,0,0,1,1
39222,språklänkar,0,0,1,1
39221,ಬಯಸುತ್ತಾಳೆ,0,0,1,1
46086,interrogation,0,0,1,1
46166,والثاني,0,0,1,1
46167,irait,0,0,1,1
50849,millimetre,0,0,1,1
39107,analytics,0,0,1,1
46235,objectivité,0,0,1,1
39001,പ്രയോഗിച്ചുകൊണ്ടാണ്,0,0,1,1
39000,ஒலிக்கிறோம்,0,0,1,1
46237,لطفاء,0,0,1,1
38998,உயர்ந்தது,0,0,1,1
38997,ಶುಭಾಶಯಗಳು,0,0,1,1
38996,சாப்பிடுவது,0,0,1,1
38995,χρησιμοποιήσεις,0,0,1,1
46240,प्राणी,0,0,1,1
46241,frontières,0,0,1,1
38993,activas—,0,0,1,1
46242,bag,0,0,1,1
38990,لكتاباتهم،,0,0,1,1
46244,مهما,0,0,1,1
38989,வழிகளை,0,0,1,1
46245,ಖಂಡಿತ,0,0,1,1
46246,കൊണ്ടുവന്നിട്ടുണ്ട്,0,0,1,1
38986,بمصدر،,0,0,1,1
46247,pladsen,0,0,1,1
38985,kanılara,0,0,1,1
38984,fundamentally,0,0,1,1
38983,ideográmicos,0,0,1,1
46248,‘இணைய,0,0,1,1
38981,anônima,0,0,1,1
38980,sondés,0,0,1,1
39002,جوجل,0,0,1,1
39003,sorrisos,0,0,1,1
46234,sleeping,0,0,1,1
46225,sokpopaccounts,0,0,1,1
39020,عصفور,0,0,1,1
46218,characterized,0,0,1,1
46219,ماي,0,0,1,1
39019,особенности,0,0,1,1
46220,ಪ್ರಕಾರಕ್ಕಿಂತ,0,0,1,1
51850,pratiquezla,0,0,1,1
46221,playing,0,0,1,1
46222,വിഷയത്തിൽ,0,0,1,1
39017,തരംതിരിക്കാൻ,0,0,1,1
51851,одиночный,0,0,1,1
46223,preguntaron,0,0,1,1
46226,ബുദ്ധിമുട്ടാണെന്നകാര്യം,0,0,1,1
50823,ஒருமுறை,0,0,1,1
46227,स्थल,0,0,1,1
46228,précis,0,0,1,1
39013,беспокою,0,0,1,1
39012,signos,0,0,1,1
39011,മാജിക്,0,0,1,1
39010,concluding,0,0,1,1
46230,edilmez,0,0,1,1
46231,forskningsartiklar,0,0,1,1
39008,παλιό,0,0,1,1
39007,statements,0,0,1,1
51853,hacían,0,0,1,1
46251,खरीदा,0,0,1,1
38978,скрестив,0,0,1,1
46253,confirmé,0,0,1,1
46277,dolarımı,0,0,1,1
46271,സമ്മതിക്കുകയും,0,0,1,1
51859,registados,0,0,1,1
46272,crosses,0,0,1,1
46273,بليدًا,0,0,1,1
46274,wikiproyectos,0,0,1,1
38952,inexactitudes,0,0,1,1
38951,vidas,0,0,1,1
46275,അതത്,0,0,1,1
38950,elimination,0,0,1,1
38949,استطعت,0,0,1,1
50822,désordre,0,0,1,1
46278,bokkapitlet,0,0,1,1
38957,مصرفي,0,0,1,1
46279,cares,0,0,1,1
46280,oförskämt,0,0,1,1
38948,ತಿಳಿದಿದೆಯೆ,0,0,1,1
38947,inexacta,0,0,1,1
50820,exam,0,0,1,1
46282,चीनी,0,0,1,1
51860,نائمة,0,0,1,1
38944,"सका।
usa",0,0,1,1
46283,spawned,0,0,1,1
46285,sunulmalıdır,0,0,1,1
38942,позволить,0,0,1,1
38956,சிறந்தவர்,0,0,1,1
38958,ζώο,0,0,1,1
38977,hängst,0,0,1,1
38967,substantial,0,0,1,1
38976,viajou,0,0,1,1
46257,സ്വതന്ത്രനാണോ,0,0,1,1
46258,shooting,0,0,1,1
38974,ويكيبديا،,0,0,1,1
46259,калифорнии,0,0,1,1
38973,environnementales,0,0,1,1
46260,सामी,0,0,1,1
38971,hoparlöre,0,0,1,1
38970,удачного,0,0,1,1
46262,evitan,0,0,1,1
46263,بأمان,0,0,1,1
46264,बताएं।,0,0,1,1
46270,delivers,0,0,1,1
38966,крайне,0,0,1,1
38965,ചേർക്കണം,0,0,1,1
38964,harboring,0,0,1,1
46265,август,0,0,1,1
46266,segos,0,0,1,1
51857,heldere,0,0,1,1
38962,arkivera,0,0,1,1
46267,dönüştürme,0,0,1,1
38961,physicists,0,0,1,1
46269,технология,0,0,1,1
38959,ذكيًا,0,0,1,1
39021,ಬಂದ,0,0,1,1
46214,يجيب,0,0,1,1
39022,marche ,0,0,1,1
46186,إليها,0,0,1,1
46181,företeelse,0,0,1,1
46182,ಮಾಡಿದರೆ,0,0,1,1
46183,பரீட்சைக்கு,0,0,1,1
39082,ಮನೆಯ,0,0,1,1
50833,गैरलाभ,0,0,1,1
39081,നര്ചിഷ,0,0,1,1
46184,armee,0,0,1,1
46185,operadores,0,0,1,1
51838,"
क्रोएशियाई",0,0,1,1
39079,atelle,0,0,1,1
39078,coincided,0,0,1,1
46187,odası,0,0,1,1
51837,ಗೆಳೆಯನಿಗೆ,0,0,1,1
39076,ikinci,0,0,1,1
39075,копиями,0,0,1,1
46188,ocultas,0,0,1,1
39074,dozens,0,0,1,1
39073,aniversario,0,0,1,1
51839,hoppar,0,0,1,1
51840,സമവായത്തിലൂടെ,0,0,1,1
39070,hurtig,0,0,1,1
39069,കെട്ടുറപ്പുള്ള,0,0,1,1
46190,debates,0,0,1,1
39067,performed,0,0,1,1
39087,لبعض,0,0,1,1
39089,ஆங்கிலச்,0,0,1,1
46191,கவலைப்படாதே,0,0,1,1
39098,platonicien,0,0,1,1
46168,spite,0,0,1,1
39106,हैंडसम,0,0,1,1
39105,анонсировала,0,0,1,1
46170,ஸ்பீக்கர்,0,0,1,1
39103,يسير؟,0,0,1,1
39102,മുന്നോട്ടുപോകുക,0,0,1,1
46171,téléchargeables,0,0,1,1
50834,mått,0,0,1,1
51835,ಚಂದಾದಾರರಾಗಲು,0,0,1,1
39099,jolie,0,0,1,1
46172,repetidos,0,0,1,1
39097,diretor,0,0,1,1
46180,utländska,0,0,1,1
46176,favorisant,0,0,1,1
46177,calculated,0,0,1,1
39096,pequeno,0,0,1,1
39095,filer,0,0,1,1
46178,ψάχνετε,0,0,1,1
39094,أربكتك,0,0,1,1
39093,werkwoordsvorm,0,0,1,1
46179,sonraki,0,0,1,1
39092,validity,0,0,1,1
51836,прогнала,0,0,1,1
39091,моим,0,0,1,1
39065,எல்லாக்,0,0,1,1
39063,مجالهم,0,0,1,1
46213,λεκτικό,0,0,1,1
46209,يستطع,0,0,1,1
46202,τέλειο,0,0,1,1
39041,गड़बड़,0,0,1,1
39040,பிட்,0,0,1,1
46204,descargar,0,0,1,1
39039,символ,0,0,1,1
51845,باحث,0,0,1,1
46205,dejar,0,0,1,1
46206,أتناوله,0,0,1,1
39037,épaisse,0,0,1,1
46207,इट,0,0,1,1
46208,verilmez,0,0,1,1
39033,commit,0,0,1,1
50825,sl •,0,0,1,1
46210,fortsætter,0,0,1,1
39032,रणनीति,0,0,1,1
39031,cometidos,0,0,1,1
51847,отмечены,0,0,1,1
46211,புவியியல்,0,0,1,1
39028,verdrietig,0,0,1,1
39027,hauteur,0,0,1,1
39026,эразма,0,0,1,1
46212,പ്രവർത്തകർ,0,0,1,1
39025,premières,0,0,1,1
39024,пытался,0,0,1,1
51844,procure,0,0,1,1
39042,comptant,0,0,1,1
39062,kanun,0,0,1,1
39053,sarılmak,0,0,1,1
39061,verkrachtingsincidenten,0,0,1,1
46192,bröllopsklänning,0,0,1,1
50829,wunderschön,0,0,1,1
39060,நுபீடியாவிலிருந்து,0,0,1,1
39059,والكتالونية,0,0,1,1
46193,zweedstalige,0,0,1,1
50828,yiyemediğim,0,0,1,1
39057,défi ,0,0,1,1
51843,ചെയ്യാനാവുന്ന,0,0,1,1
46194,aristotle,0,0,1,1
39055,والمواقع,0,0,1,1
46196,കഴിയാത്ത,0,0,1,1
46201,établissements,0,0,1,1
46197,undertiden,0,0,1,1
39051,εσένα,0,0,1,1
39050,верификации,0,0,1,1
39049,изложением,0,0,1,1
39048,weltkriegs,0,0,1,1
46198,rammer,0,0,1,1
46199,джеймс,0,0,1,1
39047,exigir,0,0,1,1
46200,справочника,0,0,1,1
39045,verre,0,0,1,1
39044,τερενς,0,0,1,1
46044,gisteravond,0,0,1,1
46043,valorizado,0,0,1,1
39659,الأكبر،,0,0,1,1
45905,روعة,0,0,1,1
45866,sorrir,0,0,1,1
39542,monte,0,0,1,1
45867,недостатков,0,0,1,1
39541,зеркале,0,0,1,1
39540,വിക്കിപീഡിയക്ക്,0,0,1,1
50871,öğleden,0,0,1,1
45869,matriz,0,0,1,1
39538,анализом,0,0,1,1
39537,itibaren,0,0,1,1
39536,സ്വർണ്ണനിറത്തിലായിരുന്നപ്പോൾ,0,0,1,1
51753,глобальное,0,0,1,1
39535,تحقق,0,0,1,1
39534,rewards,0,0,1,1
45871,istemediğimde,0,0,1,1
45872,favorisée,0,0,1,1
39532,இழுக்கவும்,0,0,1,1
39531,പിടിച്ചില്ല,0,0,1,1
39530,സാമാന്യം,0,0,1,1
50869,утверждают,0,0,1,1
45875,pensées,0,0,1,1
39526,batalha,0,0,1,1
39525,avísame,0,0,1,1
45876,സംരക്ഷിക്കുക,0,0,1,1
39523,memnuniyet,0,0,1,1
39522,isteyebilirim,0,0,1,1
45865,تعديلها,0,0,1,1
45864,चाहे,0,0,1,1
39543,diamonds,0,0,1,1
39553,efterfrågar,0,0,1,1
45853,δεξιά,0,0,1,1
39561,ovanför,0,0,1,1
39560,ವರ್ಷ,0,0,1,1
39559,கொள்ளாதீர்கள்,0,0,1,1
39558,figures,0,0,1,1
51751,allés,0,0,1,1
39557,kritiek,0,0,1,1
39556,presidentdirecteur,0,0,1,1
45857,voorstellen,0,0,1,1
39555,slide,0,0,1,1
39554,самоубийство,0,0,1,1
39552,путешествий,0,0,1,1
39544,banklånet,0,0,1,1
39551,പ്ലാനിങ്,0,0,1,1
39550,sneezed,0,0,1,1
50872,tränen,0,0,1,1
45858,gubernamental,0,0,1,1
45859,credenciales,0,0,1,1
39547,நகரத்தின்,0,0,1,1
45860,ವಾಟ್ಸಾಪ್,0,0,1,1
45861,gerir,0,0,1,1
39546,лицензирован,0,0,1,1
45862,législateur,0,0,1,1
45863,mathematically,0,0,1,1
45877,хватает,0,0,1,1
45878,"
दक्षिण",0,0,1,1
45879,"
japonês",0,0,1,1
39487,تشكر,0,0,1,1
45892,போகிறதென்றால்,0,0,1,1
39497,ಸುದ್ದಿ,0,0,1,1
39496,​​det,0,0,1,1
39495,selfdriving,0,0,1,1
45894,« é »,0,0,1,1
39493,minderårig,0,0,1,1
45895,ചിലമേഖലകളെ,0,0,1,1
45896,τρως,0,0,1,1
39490,d’aller,0,0,1,1
45898,techniciens,0,0,1,1
45899,fahrt,0,0,1,1
39486,attrapé,0,0,1,1
39499,projetsa,0,0,1,1
39485,inducción,0,0,1,1
39484,путешествовала,0,0,1,1
39481,فعله,0,0,1,1
39480,fnissar,0,0,1,1
39479,numéricos,0,0,1,1
39478,ಹೋದರೆ,0,0,1,1
45902,ಒಳ್ಳೆಯವನು,0,0,1,1
45903,bloggers,0,0,1,1
39475,பிடிக்கவில்லையா,0,0,1,1
39474,أَنَّ,0,0,1,1
39472,garten,0,0,1,1
39498,இடத்தை,0,0,1,1
39500,उबुन्टु,0,0,1,1
45880,സമീപകാല,0,0,1,1
45887,depicting,0,0,1,1
39518,fria,0,0,1,1
39517,meşgulse,0,0,1,1
45881,waarschijnlijk,0,0,1,1
39516,paciência,0,0,1,1
39515,تعديلات،,0,0,1,1
45883,порнографическими,0,0,1,1
39513,applicables,0,0,1,1
50868,ಅಭಿಪ್ರಾಯವಿಲ್ಲ,0,0,1,1
45885,gaseous,0,0,1,1
39511,ويبكي,0,0,1,1
45886,ग्रिफ़िथ,0,0,1,1
39509,πίτσα,0,0,1,1
39501,തർക്ക,0,0,1,1
50866,धन,0,0,1,1
45888,पड़ा,0,0,1,1
39507,découvertes »,0,0,1,1
51756,பட்டியலைப்,0,0,1,1
51757,அகங்காரமான,0,0,1,1
51758,httpenwikipediaorg,0,0,1,1
39504,unternehmen,0,0,1,1
45889,тупоумный,0,0,1,1
45890,utvärderade,0,0,1,1
45891,lutté,0,0,1,1
51759,"
जापानी",0,0,1,1
45852,üçü,0,0,1,1
39563,കഴിച്ചതിനുശേഷം,0,0,1,1
39564,klassificerat,0,0,1,1
51745,pratiquer,0,0,1,1
45808,موثوقة،,0,0,1,1
39633,chansons,0,0,1,1
45809,forekommer,0,0,1,1
45810,choses ,0,0,1,1
39632,çalışma,0,0,1,1
39631,rohde,0,0,1,1
45812,paciencia,0,0,1,1
45814,públicos—,0,0,1,1
39629,своему,0,0,1,1
45815,falsedad,0,0,1,1
39628,reçue,0,0,1,1
39626,ഉപയോഗിക്കുന്നത്,0,0,1,1
39635,identifique,0,0,1,1
51746,öğrendim,0,0,1,1
39624,blockerar,0,0,1,1
45816,reversión,0,0,1,1
45817,istediğiniz,0,0,1,1
39620,αλάτι,0,0,1,1
45819,மனம்,0,0,1,1
39619,என்சிச்லோபெடியா,0,0,1,1
39617,paz,0,0,1,1
39616,இடத்தைக்,0,0,1,1
39615,ærligt,0,0,1,1
39614,tillförlitligheten,0,0,1,1
45807,بنسخ,0,0,1,1
39636,bias–variance,0,0,1,1
39613,labores,0,0,1,1
39648,deprived,0,0,1,1
51739,ಮಾಡಲ್ಪಟ್ಟಿದೆ,0,0,1,1
45796,alten,0,0,1,1
45797,tersi,0,0,1,1
45798,guerel,0,0,1,1
51740,hjärtskadad,0,0,1,1
39655,commençait,0,0,1,1
39654,ഒരർത്ഥത്തിൽ,0,0,1,1
39652,scales,0,0,1,1
51741,rommelig,0,0,1,1
51742,परिभाषायें,0,0,1,1
39650,væk,0,0,1,1
45800,bankaya,0,0,1,1
39637,भारी,0,0,1,1
39646,transforme,0,0,1,1
39645,"
तिब्बती",0,0,1,1
45801,waved,0,0,1,1
45802,ουσιαστικό,0,0,1,1
39643,умным,0,0,1,1
39642,चलना,0,0,1,1
39641,accredited,0,0,1,1
39640,prochain,0,0,1,1
45805,لتربيهم,0,0,1,1
45806,complémentaires,0,0,1,1
39638,للتعبير,0,0,1,1
45821,señalar,0,0,1,1
39612,карету,0,0,1,1
39565,ámsterdam,0,0,1,1
45846,ഹിന്ദി,0,0,1,1
39587,പോകണമെന്ന്,0,0,1,1
45841,information ,0,0,1,1
45842,documentada,0,0,1,1
45843,ജീവൻ,0,0,1,1
39585,अमान्य,0,0,1,1
45844,évolutif,0,0,1,1
39583,consideration,0,0,1,1
39581,spiken,0,0,1,1
39580,أخبرت,0,0,1,1
39579,فيرجينيا,0,0,1,1
39578,лидер,0,0,1,1
39577,مجهود,0,0,1,1
45839,gfdle,0,0,1,1
39576,டோஃபிள்,0,0,1,1
45847,imediatamente,0,0,1,1
39574,suppression,0,0,1,1
39573,vb,0,0,1,1
39572,dokument,0,0,1,1
39570,türden,0,0,1,1
39569,выиграла,0,0,1,1
45850,lejos,0,0,1,1
39568,extrasolar,0,0,1,1
45851,صديقك,0,0,1,1
39566,toxic,0,0,1,1
51750,μαζικής,0,0,1,1
39589,بها،,0,0,1,1
39611,pertenece,0,0,1,1
45831,ointelligent,0,0,1,1
45823,errónea,0,0,1,1
45825,laissemoi,0,0,1,1
39608,والتحرير,0,0,1,1
39607,d’indifférenciation,0,0,1,1
45827,വരിക,0,0,1,1
39606,മുന്നോട്ടു,0,0,1,1
45829,rubriker,0,0,1,1
39604,dekken,0,0,1,1
39603,ξαφνικά,0,0,1,1
51747,«в,0,0,1,1
45830,coexistieron,0,0,1,1
39600,combinée,0,0,1,1
39590,ಸ್ನೇಹಿತನನ್ನು,0,0,1,1
39599,pludselig,0,0,1,1
51748,ψηφιακή,0,0,1,1
39598,haydi,0,0,1,1
45832,paródia,0,0,1,1
45833,concepten,0,0,1,1
39595,കോഫി,0,0,1,1
39594,framträdande,0,0,1,1
45835,honored,0,0,1,1
45837,والإحصاء,0,0,1,1
39592,والصينية,0,0,1,1
45838,издателями,0,0,1,1
39471,coexistir,0,0,1,1
45906,vermeiden,0,0,1,1
39283,അടുത്തത്,0,0,1,1
39468,similar—,0,0,1,1
45997,synapses,0,0,1,1
45998,έχεις,0,0,1,1
45999,inférieur,0,0,1,1
46000,المبادئ,0,0,1,1
39346,выглядит,0,0,1,1
39345,സത്യസന്ധമായി,0,0,1,1
46002,tribos,0,0,1,1
51787,सपने,0,0,1,1
39344,утро,0,0,1,1
39343,wikipediaförfattare,0,0,1,1
51788,dergelijke,0,0,1,1
39340,наблюдаемой,0,0,1,1
46005,season,0,0,1,1
39338,dosyalarının,0,0,1,1
51789,lastly,0,0,1,1
39336,blijkt,0,0,1,1
46006,السماء,0,0,1,1
39335,போகும்,0,0,1,1
46007,दर्शाता,0,0,1,1
46008,കാലാന്തരത്തിൽ,0,0,1,1
46009,selección,0,0,1,1
46011,عدت,0,0,1,1
39332,بمواصلة,0,0,1,1
39331,استوحت,0,0,1,1
39330,desencorajam,0,0,1,1
45996,wikiality​,0,0,1,1
45994,κοιμόταν,0,0,1,1
45993,कोर्ट,0,0,1,1
51782,тематики,0,0,1,1
45984,знаком,0,0,1,1
39369,allégories,0,0,1,1
51779,கைதிகள்,0,0,1,1
39367,धनवानों,0,0,1,1
39366,പുറത്തുള്ള,0,0,1,1
39365,konst,0,0,1,1
45986,ലഭിച്ചാൽ,0,0,1,1
51781,स्टेटस,0,0,1,1
39363,blijf,0,0,1,1
39362,reage,0,0,1,1
45987,tornou,0,0,1,1
50855,genellikle,0,0,1,1
51785,സുന്ദരിയാകാൻ,0,0,1,1
45988,الحق,0,0,1,1
39359,emprestar,0,0,1,1
45989,«интервики»ссылки,0,0,1,1
39358,personalizadas,0,0,1,1
39357,പറയുന്ന,0,0,1,1
39356,الدعم,0,0,1,1
39355,بالضغط,0,0,1,1
39354,eficientes,0,0,1,1
45990,അവയ്ക്ക്,0,0,1,1
39352,رقيقة,0,0,1,1
45991,മീ,0,0,1,1
39329,supieran,0,0,1,1
51790,incômodo,0,0,1,1
50852,mitigation,0,0,1,1
39296,أمستردام,0,0,1,1
39304,πανηγυρίζεις,0,0,1,1
39303,keşke,0,0,1,1
46031,bienvenidos,0,0,1,1
39301,initiativet,0,0,1,1
46032,regardèrent,0,0,1,1
46033,когдато,0,0,1,1
51798,appropriée,0,0,1,1
39298,goods,0,0,1,1
39297,renovable,0,0,1,1
46034,لكى,0,0,1,1
46035,ಬಳಲುತ್ತಿದ್ದೇನೆ,0,0,1,1
39295,overstromen,0,0,1,1
39306,ലഭ്യമായിരിക്കണം,0,0,1,1
39294,kullanılmaz,0,0,1,1
39293,лауреат,0,0,1,1
46037,medium,0,0,1,1
39291,acepte,0,0,1,1
39290,algorithmically,0,0,1,1
39289,phrasen,0,0,1,1
39288,കാണപ്പെടും,0,0,1,1
50850,broadcast,0,0,1,1
46041,ошибке»,0,0,1,1
51801,உதாரணத்திற்கு,0,0,1,1
46042,lourd,0,0,1,1
39305,lättåtkomliga,0,0,1,1
39307,journalister,0,0,1,1
39325,поанглийски,0,0,1,1
39317,arbejder,0,0,1,1
51791,impressionante,0,0,1,1
46016,varsayılmaktadır,0,0,1,1
46017,ഇവർക്കാണ്,0,0,1,1
51792,താക്കീതുകൾ,0,0,1,1
39323,verblüffend,0,0,1,1
39322,görünmek,0,0,1,1
39321,कंजर्वापीडिया,0,0,1,1
39320,ಅವಳನ್ನು,0,0,1,1
39319,chaud,0,0,1,1
46019,transformative,0,0,1,1
46021,irgendwo,0,0,1,1
39316,இயங்குகிறது,0,0,1,1
46030,dúvidas,0,0,1,1
39315,snowpacks,0,0,1,1
46022,cooperation,0,0,1,1
51794,normdatei,0,0,1,1
39312,nobelpristagare,0,0,1,1
46024,guarantees,0,0,1,1
46025,ಅಂತಹ,0,0,1,1
39311,extinctions,0,0,1,1
51795,linguistic,0,0,1,1
46027,तीसरे,0,0,1,1
39309,contradictory,0,0,1,1
46028,bibliothèques,0,0,1,1
39370,زالوا,0,0,1,1
45982,volontaire,0,0,1,1
45981,замене,0,0,1,1
39435,"
कॉर्सिकाई",0,0,1,1
39443,allinclusive,0,0,1,1
45929,téléversement,0,0,1,1
45930,வருகிறார்கள்,0,0,1,1
45931,contido,0,0,1,1
45932,removed,0,0,1,1
50865,compositor,0,0,1,1
45933,المتداولة,0,0,1,1
45934,уроков,0,0,1,1
45935,baixa,0,0,1,1
45938,ಮಲಗಿದ್ದಾಗ,0,0,1,1
39436,giydiğim,0,0,1,1
51766,peace,0,0,1,1
39445,viviría,0,0,1,1
45939,തെറ്റിദ്ധരിക്കുന്ന,0,0,1,1
39434,ആശംസകൾ,0,0,1,1
39433,प्रविष्ट,0,0,1,1
45940,uğramasını,0,0,1,1
39432,politicamente,0,0,1,1
39430,yapmadan,0,0,1,1
39428,replaces,0,0,1,1
39427,papers,0,0,1,1
39425,rempli,0,0,1,1
45943,والفرنسية,0,0,1,1
39423,ಒಂದಕ್ಕಿಂತ,0,0,1,1
39444,inclusion,0,0,1,1
39446,viande,0,0,1,1
39421,yanındaki,0,0,1,1
45913,projetados,0,0,1,1
45909,பசியாக,0,0,1,1
39466,لمشروع,0,0,1,1
39465,emulated,0,0,1,1
45910,colectivamente—,0,0,1,1
39464,локьером,0,0,1,1
51762,hurricanes,0,0,1,1
39462,распределяются,0,0,1,1
39461,велась,0,0,1,1
51763,multilingües,0,0,1,1
39459,penalidades,0,0,1,1
45911,நினைத்திருந்தது,0,0,1,1
45914,lignendeknappen,0,0,1,1
51764,ستفعل,0,0,1,1
39455,termijn,0,0,1,1
39454,تشاهدون,0,0,1,1
45915,статью»,0,0,1,1
39451,следовали,0,0,1,1
45919,resourceconsuming,0,0,1,1
45920,communes,0,0,1,1
45921,beatles,0,0,1,1
45923,ritt,0,0,1,1
45926,clasificarse,0,0,1,1
45927,ವಜ್ರಗಳಿಂದ,0,0,1,1
45928,ഇഫക്റ്റ്,0,0,1,1
39422,والماس,0,0,1,1
50862,förklaringen,0,0,1,1
39372,refuses,0,0,1,1
45975,imagination,0,0,1,1
45968,klassen,0,0,1,1
39392,المجموعة,0,0,1,1
51774,systematisk,0,0,1,1
45969,العلماء،,0,0,1,1
45970,şarkı,0,0,1,1
39388,generalizations,0,0,1,1
45971,cogito,0,0,1,1
39387,sémantiques,0,0,1,1
39386,சாயங்காலம்,0,0,1,1
39385,गर्म,0,0,1,1
45974,ದುರದೃಷ್ಟವಶಾತ್,0,0,1,1
51775,мешают,0,0,1,1
45966,declined,0,0,1,1
39382,சேர்ந்த,0,0,1,1
45977,ενθουσιασμένοι,0,0,1,1
39381,पाऊँगी।,0,0,1,1
45978,памятник,0,0,1,1
45979,ചേർന്നൊരു,0,0,1,1
39376,venaient,0,0,1,1
39375,motivated,0,0,1,1
45980,opeten,0,0,1,1
51776,ஒருங்கிணைந்து,0,0,1,1
39373,duplicating,0,0,1,1
51777,популярное,0,0,1,1
45967,قيمة,0,0,1,1
51771,онлайнпроекта,0,0,1,1
51768,internetvrienden,0,0,1,1
39409,allmänbildning,0,0,1,1
45945,kullanarak,0,0,1,1
39418,mystery,0,0,1,1
45946,responsável,0,0,1,1
45947,practicar,0,0,1,1
50861,alamazsınız,0,0,1,1
45950,مشروعا,0,0,1,1
45951,march update,0,0,1,1
39412,सर्चिंग,0,0,1,1
45952,manga,0,0,1,1
39411,maomé,0,0,1,1
39410,ತೆಗೆದುಕೊಂಡರೆ,0,0,1,1
39408,दोष,0,0,1,1
45964,incluían,0,0,1,1
45954,fantastic,0,0,1,1
45955,வாழ்வாள்,0,0,1,1
39406,ஆண்டில்,0,0,1,1
39404,göremeyeceğimi,0,0,1,1
45959,bios,0,0,1,1
45960,despidieron,0,0,1,1
51770,sevmesiydi,0,0,1,1
39400,ويشكو,0,0,1,1
45961,beantwoorden,0,0,1,1
39398,adolescents,0,0,1,1
45962,hug,0,0,1,1
41760,talar,0,0,1,1
26376,വിക്കിപീഡിയരുണ്ട്,0,0,1,1
32942,preguiçoso,0,0,1,1
12269,وديسمبر,0,0,1,1
12256,ondernemer,0,0,1,1
12258,ತಿಳುವಳಿಕೆಯಿದ್ದರೆ,0,0,1,1
12260,കുഴഞ്ഞുമറിഞ്ഞു,0,0,1,1
12262,αγαπούσε,0,0,1,1
12264,yapmadığınız,0,0,1,1
12265,deem,0,0,1,1
12266,abd,0,0,1,1
12270,springs,0,0,1,1
12290,ತೆಗೆದುಕೊಳ್ಳುತ್ತೇನೆ,0,0,1,1
12276,എന്നിവയാണ്,0,0,1,1
12277,الفاخرة,0,0,1,1
12280,classifications,0,0,1,1
12281,lanserat,0,0,1,1
12283,améliorezle,0,0,1,1
12286,विकियात्रा,0,0,1,1
12287,vardera,0,0,1,1
12254,تعطلت,0,0,1,1
12253,reliée,0,0,1,1
12251,aangezien,0,0,1,1
12248,красивая,0,0,1,1
12224,волочить,0,0,1,1
12226,tillämpliga,0,0,1,1
12229,ضعيف,0,0,1,1
12230,chariot,0,0,1,1
12231,connectionism,0,0,1,1
12232,ആഴ്ച,0,0,1,1
12235,alejandro,0,0,1,1
12237,حركة,0,0,1,1
12238,trabalhando,0,0,1,1
12239,soruda,0,0,1,1
12242,gidin,0,0,1,1
12243,uninitiated,0,0,1,1
12244,estamos,0,0,1,1
12246,உருவாக்கத்திற்கான,0,0,1,1
12247,எங்கள்,0,0,1,1
12288,understrege,0,0,1,1
12292,« bonnes »,0,0,1,1
12344,draws,0,0,1,1
12330,excited,0,0,1,1
12322,compromise,0,0,1,1
12323,néanmoins,0,0,1,1
12324,பயனர்களும்,0,0,1,1
12325,panslavon,0,0,1,1
12327,ljuset,0,0,1,1
12328,partialité,0,0,1,1
12329,अभिवादन,0,0,1,1
12331,arkadaşlarınıza,0,0,1,1
12293,सोचने,0,0,1,1
12332,voyageaient,0,0,1,1
12333,desinformação,0,0,1,1
12335,encouraged,0,0,1,1
12337,atmosphere—within,0,0,1,1
12339,loi,0,0,1,1
12341,pédia,0,0,1,1
12342,الطالب,0,0,1,1
12321,shipments,0,0,1,1
12319,disclose,0,0,1,1
12317,dificultades,0,0,1,1
12316,ಪ್ರಕಾಶಮಾನವಾದ,0,0,1,1
12294,"
आयमार",0,0,1,1
12295,என்பதே,0,0,1,1
12296,plaignants,0,0,1,1
12297,ചവറും,0,0,1,1
12298,ഇല്ലയോ,0,0,1,1
12301,शुक्रिया,0,0,1,1
12303,समुच्चय,0,0,1,1
12305,vidéos etc,0,0,1,1
12308,nogensinde,0,0,1,1
12309,εργασία,0,0,1,1
12310,slowing,0,0,1,1
12311,подрывает,0,0,1,1
12313,நிகழும்,0,0,1,1
12314,lithosphere,0,0,1,1
12315,​​tag,0,0,1,1
12223,prinz,0,0,1,1
12222,storlek,0,0,1,1
12221,ലിപികളും,0,0,1,1
12144,существительное,0,0,1,1
12133,concernées,0,0,1,1
12134,общедоступная,0,0,1,1
12135,рода,0,0,1,1
12137,siquiera,0,0,1,1
12138,zamanlar,0,0,1,1
12141,ஏற்படுத்தவில்லை,0,0,1,1
12142,gefällt,0,0,1,1
12145,forbløffet,0,0,1,1
12219,språkgrupp,0,0,1,1
12146,அச்சத்தினாலும்,0,0,1,1
12148,परियोजनाएंजैसे,0,0,1,1
12149,"
उज़्बैक",0,0,1,1
12150,congratulations,0,0,1,1
12151,d’attribuer,0,0,1,1
12152,διατήρηση,0,0,1,1
12153,høre,0,0,1,1
12132,προσβολή,0,0,1,1
12130,allesomvattende,0,0,1,1
12126,കൊടുത്തിരുന്ന,0,0,1,1
12124,dalaïlamaréf,0,0,1,1
12103,نوعًا,0,0,1,1
12106,venezuela,0,0,1,1
12107,technè,0,0,1,1
12108,yaparsınız,0,0,1,1
12109,procuran,0,0,1,1
12110,isimli,0,0,1,1
12111,rart,0,0,1,1
12112,ಟವು,0,0,1,1
12114,merkezinde,0,0,1,1
12115,compraría,0,0,1,1
12116,gulches,0,0,1,1
12117,"
मंगोलियाई",0,0,1,1
12120,ಎಲ್ಲರೂ,0,0,1,1
12122,clean,0,0,1,1
12123,"
सोमाली",0,0,1,1
12154,därefter,0,0,1,1
12156,retención,0,0,1,1
12157,katı,0,0,1,1
12184,பேசும்,0,0,1,1
12188,स्थायी,0,0,1,1
12190,അവയെ,0,0,1,1
12193,البرمجية،,0,0,1,1
12198,présidentielles,0,0,1,1
12199,сборы,0,0,1,1
12200,sowieso,0,0,1,1
12201,அப்பால்,0,0,1,1
12202,ಇಬ್ಬರಿಗೂ,0,0,1,1
12204,evidencia,0,0,1,1
12210,observandoa,0,0,1,1
12212,νύχτα,0,0,1,1
12214,tratados,0,0,1,1
12216,വിചാരിക്കുന്നത്,0,0,1,1
12217,ಖರೀದಿಸಿದ,0,0,1,1
12218,commençons,0,0,1,1
12186,wikimodellen,0,0,1,1
12182,takılmıyorsun,0,0,1,1
12158,sağladı,0,0,1,1
12181,pressure,0,0,1,1
12161,avançados,0,0,1,1
12162,т н,0,0,1,1
12163,overal,0,0,1,1
12165,nivelar,0,0,1,1
12166,humannature,0,0,1,1
12167,ಹೇಳೋಣ,0,0,1,1
12168,σταυρωμένα,0,0,1,1
12169,написанием,0,0,1,1
12170,formuleringsarbetet,0,0,1,1
12171,സുഹൃത്തിനോട്,0,0,1,1
12174,qualifier,0,0,1,1
12175,έννοιες,0,0,1,1
12176,haus,0,0,1,1
12178,exibir,0,0,1,1
12180,ഉറങ്ങുമ്പോൾ,0,0,1,1
12343,ಭಾರೀ,0,0,1,1
12345,iran,0,0,1,1
12101,gevangenen,0,0,1,1
12517,"
संस्कृत",0,0,1,1
12506,некоммерческого,0,0,1,1
12507,практически,0,0,1,1
12509,армией,0,0,1,1
12511,and—most,0,0,1,1
12512,வாசகர்களையும்,0,0,1,1
12514,wikipediagemeenschap,0,0,1,1
12516,olursun,0,0,1,1
12519,umgegangen,0,0,1,1
12537,oke,0,0,1,1
12521,kompakt,0,0,1,1
12522,संयोजन,0,0,1,1
12523,طويلًا,0,0,1,1
12528,verstehen,0,0,1,1
12530,zenginliği,0,0,1,1
12532,reconsideró,0,0,1,1
12535,ஒப்புக்கொண்டால்,0,0,1,1
12505,eğilimindeyiz,0,0,1,1
12504,shapes,0,0,1,1
12503,därigenom,0,0,1,1
12501,egoïstische,0,0,1,1
12478,complejidad,0,0,1,1
12479,मनोनीत,0,0,1,1
12480,voces,0,0,1,1
12483,abstengan,0,0,1,1
12484,idiomáticas,0,0,1,1
12485,та,0,0,1,1
12486,hemmelighed,0,0,1,1
12488,görüşmek,0,0,1,1
12490,anzugeben,0,0,1,1
12491,nära,0,0,1,1
12493,характерной,0,0,1,1
12494,балкона,0,0,1,1
12495,ændret,0,0,1,1
12499,esquece,0,0,1,1
12500,വിലയിരുത്തി,0,0,1,1
12536,парадокс,0,0,1,1
12538,yüksek,0,0,1,1
12346,വസ്തുതകളോട്,0,0,1,1
12583,الضابطة,0,0,1,1
12571,lider,0,0,1,1
12572,गढ़ा,0,0,1,1
12573,просмотренных,0,0,1,1
12576,spannends,0,0,1,1
12577,сериала,0,0,1,1
12580,chargée,0,0,1,1
12581,horsligne,0,0,1,1
12587,пятым,0,0,1,1
12539,édition »,0,0,1,1
12588,قرض,0,0,1,1
12590,anonimato,0,0,1,1
12592,décoder,0,0,1,1
12593,ಮಾಡಲ್ಪಟ್ಟನು,0,0,1,1
12597,descubrimiento,0,0,1,1
12598,прошли,0,0,1,1
12599,подлог,0,0,1,1
12570,informella,0,0,1,1
12569,incrémentale,0,0,1,1
12568,identifiées,0,0,1,1
12567,മുറിച്ചുകടക്കുമെന്നും,0,0,1,1
12540,ವಿಧಾನವೆಂದರೆ,0,0,1,1
12544,limonpedia,0,0,1,1
12545,सीमित,0,0,1,1
12547,bagunçado,0,0,1,1
12549,« tentatives,0,0,1,1
12550,parcialmente,0,0,1,1
12551,سابق,0,0,1,1
12552,خطأك,0,0,1,1
12554,किताब,0,0,1,1
12555,пользователям,0,0,1,1
12558,اراك,0,0,1,1
12562,requiring,0,0,1,1
12563,implementation,0,0,1,1
12564,hansson,0,0,1,1
12566,ചീത്തയായി,0,0,1,1
12477,disculparse,0,0,1,1
12476,"
neerlandês",0,0,1,1
12474,காரியத்தைச்,0,0,1,1
12390,rubinmarmelade,0,0,1,1
12378,eligió,0,0,1,1
12379,खींच,0,0,1,1
12384,absolutely,0,0,1,1
12385,communiqué,0,0,1,1
12386,مجهولون,0,0,1,1
12387,ഭാഗ്യമെന്ന്,0,0,1,1
12388,ಚಲನಚಿತ್ರಗಳಿಗೆ,0,0,1,1
12397,escolas,0,0,1,1
12473,jonger,0,0,1,1
12398,verängstigt,0,0,1,1
12399,grædende,0,0,1,1
12400,betaalde,0,0,1,1
12401,vriendelijke,0,0,1,1
12402,തലച്ചോറിനെ,0,0,1,1
12406,प्राधिकृत,0,0,1,1
12409,unfeasible,0,0,1,1
12377,τεράστια,0,0,1,1
12375,വേണ്ടത്ര,0,0,1,1
12374,strip,0,0,1,1
12372,признать,0,0,1,1
12347,கோடல்கள்,0,0,1,1
12349,बढ़ावा,0,0,1,1
12351,الأصليون,0,0,1,1
12353,الإضافة،,0,0,1,1
12354,« machine,0,0,1,1
12355,hayas,0,0,1,1
12357,rill,0,0,1,1
12358,ഓർമ്മിക്കുകയും,0,0,1,1
12359,keşfi,0,0,1,1
12360,красивом,0,0,1,1
12363,двойных,0,0,1,1
12366,sills,0,0,1,1
12367,മൃഗമാണെന്നും,0,0,1,1
12368,முரட்டுத்தனமாக,0,0,1,1
12371,മാസങ്ങളിൽ,0,0,1,1
12410,لكم,0,0,1,1
12411,ambas,0,0,1,1
12412,lessive,0,0,1,1
12440,internetbaserade,0,0,1,1
12443,എന്ത്,0,0,1,1
12444,opdateringen,0,0,1,1
12448,fonctionner,0,0,1,1
12449,ಅದಕ್ಕಾಗಿ,0,0,1,1
12452,മിനുസമുള്ളതുമാണ്,0,0,1,1
12453,பயனாளிகள்,0,0,1,1
12456,obtenido,0,0,1,1
12459,आलू,0,0,1,1
12461,norvégien,0,0,1,1
12462,dispyter,0,0,1,1
12465,pleure,0,0,1,1
12466,postlisterne,0,0,1,1
12468,innovateurs,0,0,1,1
12469,morimos,0,0,1,1
12470,högerperspektiv,0,0,1,1
12441,έλεγες,0,0,1,1
12439,بالتالي,0,0,1,1
12414,sökbar,0,0,1,1
12438,dichotomiquement,0,0,1,1
12415,factibles,0,0,1,1
12417,गोपनीयता,0,0,1,1
12419,avsiktligen,0,0,1,1
12420,مستنقع,0,0,1,1
12421,ಇಷ್ಟಪಡುವ,0,0,1,1
12422,प्रारूप,0,0,1,1
12423,masturbation,0,0,1,1
12427,eqdfw,0,0,1,1
12428,язык,0,0,1,1
12429,سياسة,0,0,1,1
12430,ഉറപ്പാണോ,0,0,1,1
12431,nätgemenskap,0,0,1,1
12433,പകർത്താൻ,0,0,1,1
12435,ربحية,0,0,1,1
12436,peuplements,0,0,1,1
12102,ഉദാഹരണ,0,0,1,1
12100,exceptionellt,0,0,1,1
32941,مسافة,0,0,1,1
11780,codificada,0,0,1,1
11769,എങ്ങനെയിരിക്കും,0,0,1,1
11770,ചെയ്യണമെന്ന്,0,0,1,1
11771,ಹಿಡಿಯದಿದ್ದರೆ,0,0,1,1
11772,poussée,0,0,1,1
11773,اتهم,0,0,1,1
11775,quejas,0,0,1,1
11776,بالأرقام,0,0,1,1
11781,gl •,0,0,1,1
11794,وتخصصهم,0,0,1,1
11783,endeavor,0,0,1,1
11786,verschijnen,0,0,1,1
11787,istisnalar,0,0,1,1
11788,disambiguation,0,0,1,1
11789,mastersmagisterexamen,0,0,1,1
11790,مجلة أدبيات,0,0,1,1
11791,पृष्टों,0,0,1,1
11768,gesprochen,0,0,1,1
11767,frågeställningarna,0,0,1,1
11766,aimais,0,0,1,1
11765,etsem,0,0,1,1
11744,atuais,0,0,1,1
11746,altruista—,0,0,1,1
11747,ஆய்வாளரின்,0,0,1,1
11748,insanlara,0,0,1,1
11749,mütevazı,0,0,1,1
11750,svåra,0,0,1,1
11751,prospectivement,0,0,1,1
11752,ironfilled,0,0,1,1
11753,judiciais,0,0,1,1
11754,संसद,0,0,1,1
11757,wikimed,0,0,1,1
11759,eu •,0,0,1,1
11760,पुस्क्तकों,0,0,1,1
11762,αποφεύγοντας,0,0,1,1
11764,éviter,0,0,1,1
11793,esthétiques,0,0,1,1
11797,middenin,0,0,1,1
11860,dégustation,0,0,1,1
11844,tillfälligt,0,0,1,1
11835,mammalian,0,0,1,1
11836,perdu,0,0,1,1
11837,ifaktor,0,0,1,1
11838,حيادية,0,0,1,1
11839,मजेदार,0,0,1,1
11841,piscaram,0,0,1,1
11842,намерения,0,0,1,1
11845,φανταστικά,0,0,1,1
11800,sides,0,0,1,1
11847,पिछले,0,0,1,1
11848,لتسوية,0,0,1,1
11850,الأمريكية،,0,0,1,1
11852,दूंगा,0,0,1,1
11853,ta •,0,0,1,1
11854,دمج,0,0,1,1
11857,crude,0,0,1,1
11833,للمخربين,0,0,1,1
11832,نسبيًا,0,0,1,1
11830,கேட்கிறீர்களா,0,0,1,1
11824,wegwerken,0,0,1,1
11801,missvisande,0,0,1,1
11802,joint,0,0,1,1
11805,संबोधित,0,0,1,1
11806,subdesarrollados,0,0,1,1
11807,lieblingssmartwort,0,0,1,1
11808,sw •,0,0,1,1
11809,كامل،,0,0,1,1
11810,killing,0,0,1,1
11811,ampliada,0,0,1,1
11813,знай,0,0,1,1
11817,दोंनों,0,0,1,1
11818,"
búlgaro",0,0,1,1
11821,பக்கக்,0,0,1,1
11822,montant,0,0,1,1
11823,réparation,0,0,1,1
11743,ούτε,0,0,1,1
11742,binnenkort,0,0,1,1
11740,union,0,0,1,1
11660,മകൾ,0,0,1,1
11647,nærmede,0,0,1,1
11650,уравновешенным,0,0,1,1
11651,diskussionen,0,0,1,1
11653,كويكب،,0,0,1,1
11656,styrke,0,0,1,1
11657,onderverdeeld,0,0,1,1
11658,intenta,0,0,1,1
11661,создают,0,0,1,1
11738,ändamålet,0,0,1,1
11662,freier,0,0,1,1
11664,explaining,0,0,1,1
11667,heraus,0,0,1,1
11668,kredisine,0,0,1,1
11672,فلست,0,0,1,1
11674,отключены,0,0,1,1
11676,बच्चा,0,0,1,1
11646,doutorado,0,0,1,1
11644,informaticien,0,0,1,1
11642,അവസാനത്തിലും,0,0,1,1
11641,totalement,0,0,1,1
11613,motsvarade,0,0,1,1
11614,εβδομάδες,0,0,1,1
11617,услуга,0,0,1,1
11618,قريبا,0,0,1,1
11620,കാണുമ്പോൾ,0,0,1,1
11621,предвзятость,0,0,1,1
11624,кемто,0,0,1,1
11625,गोर्मनने,0,0,1,1
11628,tricky,0,0,1,1
11630,совокупность,0,0,1,1
11631,பதிப்புக்களில்,0,0,1,1
11634,ಹೇಳಿದೆ,0,0,1,1
11638,antigua,0,0,1,1
11639,masivo,0,0,1,1
11640,visually,0,0,1,1
11678,പ്രവർത്തനം,0,0,1,1
11679,νιώθω,0,0,1,1
11680,vigtige,0,0,1,1
11710,lighthearted,0,0,1,1
11713,obscurs,0,0,1,1
11715,πάνε,0,0,1,1
11717,kuralları,0,0,1,1
11718,يو,0,0,1,1
11719,medier,0,0,1,1
11720,справа,0,0,1,1
11721,முறையை,0,0,1,1
11723,pointofsale,0,0,1,1
11725,исключением,0,0,1,1
11726,anmen,0,0,1,1
11727,അവസ്ഥകളെ,0,0,1,1
11728,autobús,0,0,1,1
11731,hediye,0,0,1,1
11732,provoqué,0,0,1,1
11734,gedachtegoed,0,0,1,1
11711,издательством,0,0,1,1
11709,publiquement,0,0,1,1
11682,kanunu,0,0,1,1
11708,έμαθα,0,0,1,1
11683,annars,0,0,1,1
11684,ಸಂದರ್ಭದಲ್ಲಿ,0,0,1,1
11686,bölümünde,0,0,1,1
11688,مندهشة,0,0,1,1
11691,सशक्त,0,0,1,1
11693,sizable,0,0,1,1
11695,ашберн,0,0,1,1
11696,ಕೇಳುತ್ತಿರಲಿಲ್ಲ,0,0,1,1
11697,transcendance,0,0,1,1
11698,moatti,0,0,1,1
11699,congrès,0,0,1,1
11700,പരസ്പരബന്ധമില്ലാത്ത,0,0,1,1
11701,mundiais,0,0,1,1
11702,demitidos,0,0,1,1
11706,noyer,0,0,1,1
11858,തോന്നുന്നുവെങ്കിൽ,0,0,1,1
11861,إنترويكي،,0,0,1,1
12099,вызванных,0,0,1,1
12037,പദങ്ങൾക്കും,0,0,1,1
12023,irs,0,0,1,1
12026,genders,0,0,1,1
12027,äldsta,0,0,1,1
12033,societies,0,0,1,1
12034,करना।,0,0,1,1
12035,viu,0,0,1,1
12036,സ്രോതസ്സുകളെയും,0,0,1,1
12038,pares​,0,0,1,1
12051,ഫ്ലംമോക്സായി,0,0,1,1
12039,trem,0,0,1,1
12040,correcciones,0,0,1,1
12041,имеющей,0,0,1,1
12043,respecter,0,0,1,1
12044,péréa,0,0,1,1
12045,затопление,0,0,1,1
12047,സ്ഥാപിതമായതും,0,0,1,1
12021,النظام،,0,0,1,1
12020,сохранить,0,0,1,1
12019,மனிதனும்,0,0,1,1
12018,acusála,0,0,1,1
11989,elektronisk,0,0,1,1
11990,basándose,0,0,1,1
11991,вебсайта,0,0,1,1
11992,நிலமானது,0,0,1,1
11996,вчера,0,0,1,1
11999,sourced,0,0,1,1
12000,கூர்மையானது,0,0,1,1
12002,högskolekurser,0,0,1,1
12008,പെരുപ്പിച്ചു,0,0,1,1
12009,varier,0,0,1,1
12010,i̇çeriklerin,0,0,1,1
12014,grego,0,0,1,1
12015,abordan,0,0,1,1
12016,acabou,0,0,1,1
12017,உறுதிப்படுத்தப்படாத,0,0,1,1
12050,culte,0,0,1,1
12052,μορφή,0,0,1,1
11862,أنتما,0,0,1,1
12087,обоката,0,0,1,1
12079,simplifier,0,0,1,1
12080,conflitantes,0,0,1,1
12081,reisen,0,0,1,1
12082,tandis,0,0,1,1
12083,ആൾക്കാരെ,0,0,1,1
12084,ökade,0,0,1,1
12085,cocacola,0,0,1,1
12088,προσπαθήστε,0,0,1,1
12053,بالضحك,0,0,1,1
12090,администраторов,0,0,1,1
12091,दिसंबर,0,0,1,1
12092,seeking,0,0,1,1
12094,adición,0,0,1,1
12096,வெற்றிகரமாக,0,0,1,1
12097,χίλια,0,0,1,1
12098,நாட்களாக,0,0,1,1
12078,signifier,0,0,1,1
12077,restrições,0,0,1,1
12076,restaurar,0,0,1,1
12075,hospedados,0,0,1,1
12054,സംഭാഷണത്തിനിടയിലാണെങ്കിൽ,0,0,1,1
12056,கேள்விப்பட்டிருக்கிறீர்கள்,0,0,1,1
12057,överflödigt,0,0,1,1
12060,propiciado,0,0,1,1
12061,ചീത്തയാണോ,0,0,1,1
12062,databasdumpar,0,0,1,1
12063,അഭ്യർത്ഥനകൾ,0,0,1,1
12064,consegue,0,0,1,1
12066,représentant,0,0,1,1
12067,evolucionando,0,0,1,1
12068,"
आलेमैनिक",0,0,1,1
12070,செய்துள்ளீர்கள்,0,0,1,1
12071,achtergelaten,0,0,1,1
12072,migrés,0,0,1,1
12073,oficina,0,0,1,1
11988,القيمة,0,0,1,1
11987,gern,0,0,1,1
11986,المطور,0,0,1,1
11913,—término,0,0,1,1
11898,preparé,0,0,1,1
11899,parecían,0,0,1,1
11900,عدداً,0,0,1,1
11903,amusing,0,0,1,1
11908,iğrençtir,0,0,1,1
11911,telgraf,0,0,1,1
11912,staten,0,0,1,1
11914,оставайтесь,0,0,1,1
11984,ajude,0,0,1,1
11915,பேசினால்,0,0,1,1
11916,matériels,0,0,1,1
11917,إدارتها,0,0,1,1
11918,profuse,0,0,1,1
11919,مختلفين,0,0,1,1
11920,നൽകാം,0,0,1,1
11922,acerta,0,0,1,1
11896,distributes,0,0,1,1
11893,fournit,0,0,1,1
11892,arkadaşlarına,0,0,1,1
11890,esquecem,0,0,1,1
11863,أتحدث,0,0,1,1
11865,கேட்டிருக்கலாம்,0,0,1,1
11867,तकनीक,0,0,1,1
11868,télévisée,0,0,1,1
11869,постоянные,0,0,1,1
11873,человечества,0,0,1,1
11874,retirados,0,0,1,1
11877,psalms,0,0,1,1
11878,المتكررين,0,0,1,1
11880,assustador,0,0,1,1
11881,تحويها,0,0,1,1
11883,δελχί,0,0,1,1
11885,transformations,0,0,1,1
11886,βικιφθέγματα,0,0,1,1
11889,φίλη,0,0,1,1
11923,وسيمه,0,0,1,1
11925,tenido,0,0,1,1
11926,périodes,0,0,1,1
11958,éditoriale ,0,0,1,1
11960,ನಂಬಲು,0,0,1,1
11961,шварцем,0,0,1,1
11964,σχολίων,0,0,1,1
11965,остальная,0,0,1,1
11966,regard,0,0,1,1
11967,våldtäktsincidenterna,0,0,1,1
11968,εστιατόριο,0,0,1,1
11969,கொண்டது,0,0,1,1
11970,ലേഖകരുടെ,0,0,1,1
11972,ನಿಲ್ಲಿಸಿ,0,0,1,1
11973,imprime,0,0,1,1
11974,assiste,0,0,1,1
11976,sur ,0,0,1,1
11977,σκύλος,0,0,1,1
11979,inondation,0,0,1,1
11959,المذاق,0,0,1,1
11957,inútiles,0,0,1,1
11931,посещений,0,0,1,1
11956,assemblée,0,0,1,1
11932,ഇന്നും,0,0,1,1
11933,ситуаций,0,0,1,1
11934,സ്ഥാനക്കയറ്റം,0,0,1,1
11937,സംസ്കാരവും,0,0,1,1
11938,aleatória,0,0,1,1
11940,erste,0,0,1,1
11941,ആധികാരിക,0,0,1,1
11943,bredvid,0,0,1,1
11944,slight,0,0,1,1
11945,hissediyorsanız,0,0,1,1
11946,searching,0,0,1,1
11948,respectivas,0,0,1,1
11951,poser,0,0,1,1
11953,khosla,0,0,1,1
11955,ascending,0,0,1,1
12601,முழுவதுமாகப்,0,0,1,1
12603,योजनाओं,0,0,1,1
12604,يتفق,0,0,1,1
13219,जोनाथन,0,0,1,1
13211,étymologique,0,0,1,1
13213,freecontent,0,0,1,1
13214,வீட்டுப்பாடம்,0,0,1,1
13215,paced,0,0,1,1
13216,bakalım,0,0,1,1
13217,γνώριζε,0,0,1,1
13218,ಟೇಬಲ್,0,0,1,1
13221,extinct,0,0,1,1
13240,plays,0,0,1,1
13226,многочисленных,0,0,1,1
13227,விளம்பர,0,0,1,1
13228,ഇംഗ്ലീഷിലാണ്,0,0,1,1
13229,प्रारम्भ,0,0,1,1
13235,"
प्राचीन",0,0,1,1
13237,fullaste,0,0,1,1
13238,inherited,0,0,1,1
13210,منفرجًا,0,0,1,1
13208,മുഴുവനും,0,0,1,1
13207,استخراج,0,0,1,1
13204,حقا,0,0,1,1
13183,situaban,0,0,1,1
13184,tedavi,0,0,1,1
13185,जोड़ा,0,0,1,1
13186,பார்க்கும்போது,0,0,1,1
13187,hakkı,0,0,1,1
13188,रुचि,0,0,1,1
13189,சாப்பிடமுடியாத,0,0,1,1
13191,enige,0,0,1,1
13192,наибольшее,0,0,1,1
13194,desempeño,0,0,1,1
13195,الألمانية،,0,0,1,1
13196,μαρίνα,0,0,1,1
13197,عقليًا,0,0,1,1
13199,ಬರಲಿದೆ,0,0,1,1
13201,«bibliotecario»,0,0,1,1
13239,irmos,0,0,1,1
13241,недели,0,0,1,1
13303,dotters,0,0,1,1
13283,പ്രിന്റ്,0,0,1,1
13275,للمشروع,0,0,1,1
13276,ووضوحًا,0,0,1,1
13277,टर्म,0,0,1,1
13278,aussieht,0,0,1,1
13279,بعدم,0,0,1,1
13280,tekrarlamanız,0,0,1,1
13282,لمواقع,0,0,1,1
13284,यू॰एस॰,0,0,1,1
13242,അവിശ്വസനീയമാംവിധം,0,0,1,1
13285,adquirir,0,0,1,1
13287,stück,0,0,1,1
13288,несбалансированность,0,0,1,1
13292,प्रक्टिसस,0,0,1,1
13296,வார்த்தைகளில்,0,0,1,1
13297,заимствовано,0,0,1,1
13298,gelişimini,0,0,1,1
13274,élever,0,0,1,1
13273,paternitépartage,0,0,1,1
13270,ഉപയോഗിക്കാനുള്ള,0,0,1,1
13269,extremt,0,0,1,1
13243,παρακολουθώντας,0,0,1,1
13244,मुद्रित,0,0,1,1
13245,egentligen,0,0,1,1
13246,"
थाई",0,0,1,1
13248,പരിഹാരത്തിലും,0,0,1,1
13249,aldığı,0,0,1,1
13251,серьёзных,0,0,1,1
13253,εξηγήστε,0,0,1,1
13254,γλυκό,0,0,1,1
13255,இவ்விணையப்,0,0,1,1
13257,البذاءة,0,0,1,1
13258,कॉलेज,0,0,1,1
13263,approuvés,0,0,1,1
13265,operan,0,0,1,1
13268,retirada,0,0,1,1
13182,مستهلك,0,0,1,1
13181,மூழ்குவதைக்,0,0,1,1
13179,soumis,0,0,1,1
13111,gouvernée,0,0,1,1
13104,väluppfostrad,0,0,1,1
13105,ambiguidade,0,0,1,1
13106,السلام,0,0,1,1
13107,olvide,0,0,1,1
13108,дорогое,0,0,1,1
13109,хихикала,0,0,1,1
13110,लोडबेलेंसिंग,0,0,1,1
13112,touristen,0,0,1,1
13177,വൃദ്ധനായ,0,0,1,1
13113,simgesine,0,0,1,1
13114,സാധിക്കണമെങ്കിൽ,0,0,1,1
13115,عزا,0,0,1,1
13116,rapazes,0,0,1,1
13121,administrativa,0,0,1,1
13125,récentes »,0,0,1,1
13129,ಭಾವಿಸಿದ್ದೇನೆ,0,0,1,1
13102,பயன்படுத்தினால்,0,0,1,1
13101,latinisé,0,0,1,1
13099,infobox,0,0,1,1
13098,الشأن,0,0,1,1
13077,tg •,0,0,1,1
13078,sänkts,0,0,1,1
13079,σκοπός,0,0,1,1
13080,zoet,0,0,1,1
13081,kullandıkları,0,0,1,1
13082,geliştireceği,0,0,1,1
13083,lointain,0,0,1,1
13086,sake,0,0,1,1
13087,ഒരിക്കൽ,0,0,1,1
13088,φόβος,0,0,1,1
13090,ഹോം,0,0,1,1
13093,visie,0,0,1,1
13094,ரகசியமான,0,0,1,1
13095,കൃത്രിമം,0,0,1,1
13096,ಹಿಡಿದುಕೊಳ್ಳಿ,0,0,1,1
13130,ವ್ಯಕ್ತಿಯ,0,0,1,1
13131,påminna,0,0,1,1
13132,unnatural,0,0,1,1
13154,ಮರೆತುಹೋಗುತ್ತಾನೆ,0,0,1,1
13156,critic,0,0,1,1
13158,españolas,0,0,1,1
13160,മികച്ചതാക്കുക,0,0,1,1
13161,طردت,0,0,1,1
13162,ಪ್ರವಾಹ,0,0,1,1
13163,столе,0,0,1,1
13164,adivinhar,0,0,1,1
13165,ugly,0,0,1,1
13168,فريد,0,0,1,1
13169,സമയമാണ്,0,0,1,1
13170,ഉപയോഗിക്കും,0,0,1,1
13171,стволовых,0,0,1,1
13172,—clusters—,0,0,1,1
13173,السرعة،,0,0,1,1
13175,meters,0,0,1,1
13155,നാണ്,0,0,1,1
13153,begejstrede,0,0,1,1
13133,இன்றிரவு,0,0,1,1
13152,déclarer,0,0,1,1
13134,künt,0,0,1,1
13135,грязь,0,0,1,1
13136,revolution,0,0,1,1
13137,assumer,0,0,1,1
13139,dresses,0,0,1,1
13140,verificación,0,0,1,1
13141,stalin,0,0,1,1
13142,сработает,0,0,1,1
13143,തിരഞ്ഞെടുപ്പുകളെക്കുറിച്ച്,0,0,1,1
13144,wikipediawebbgränssnitt,0,0,1,1
13146,рассказала,0,0,1,1
13147,görüyorsunuz,0,0,1,1
13148,ಸಂಪೂರ್ಣ,0,0,1,1
13149,gerealiseerd,0,0,1,1
13151,टेलीविजन,0,0,1,1
13300,സൃഷ്ടിക്കണമെന്ന്,0,0,1,1
13304,μπροστά,0,0,1,1
12607,рыночную,0,0,1,1
13477,rette,0,0,1,1
13465,outlining,0,0,1,1
13468,αντίθετο,0,0,1,1
13469,ಪಡೆದುಕೊಂಡೆ,0,0,1,1
13470,भले,0,0,1,1
13471,предназначенная,0,0,1,1
13472,മാനദണ്ഡങ്ങൾ,0,0,1,1
13474,ocurriendo,0,0,1,1
13478,partition,0,0,1,1
13491,следствием,0,0,1,1
13479,cruza,0,0,1,1
13480,للتدرب,0,0,1,1
13481,رأته,0,0,1,1
13483,ما،,0,0,1,1
13484,blogs,0,0,1,1
13487,estabilizado,0,0,1,1
13488,adlı,0,0,1,1
13462,internacionales,0,0,1,1
13461,trans,0,0,1,1
13459,вошёл,0,0,1,1
13458,έναρξη,0,0,1,1
13434,оказаться,0,0,1,1
13436,gosta,0,0,1,1
13438,ആവുന്നതിനു,0,0,1,1
13439,شخصياً,0,0,1,1
13441,छोटी,0,0,1,1
13442,soulevé,0,0,1,1
13445,nämns,0,0,1,1
13446,итальянских,0,0,1,1
13448,преувеличить,0,0,1,1
13450,posse,0,0,1,1
13451,descenso,0,0,1,1
13452,wikia,0,0,1,1
13453,चित्र,0,0,1,1
13454,meningsmotståndare,0,0,1,1
13457,tweede,0,0,1,1
13490,തിരുത്തലുകൾക്കൊടുവിൽ,0,0,1,1
13492,மாதங்களில்,0,0,1,1
13305,клиффордом,0,0,1,1
13539,கிளிக்,0,0,1,1
13527,schaut,0,0,1,1
13530,இருப்பதாகவும்,0,0,1,1
13534,defecto,0,0,1,1
13535,പാട്ടുകളിൽ,0,0,1,1
13536,மீளப்பெறவோ,0,0,1,1
13537,påbegyndt,0,0,1,1
13538,запрещённых,0,0,1,1
13540,واجهته,0,0,1,1
13494,philippe,0,0,1,1
13541,tegnsætning,0,0,1,1
13542,жестокое,0,0,1,1
13543,образовано,0,0,1,1
13544,sidvisningar,0,0,1,1
13545,yazılanın,0,0,1,1
13546,أسوأ,0,0,1,1
13547,практики,0,0,1,1
13525,anticonsenso,0,0,1,1
13524,verschiedenen,0,0,1,1
13521,sensory,0,0,1,1
13519,stellte,0,0,1,1
13495,donald,0,0,1,1
13498,എന്നിട്ട്,0,0,1,1
13499,suspender,0,0,1,1
13500,företeelsen,0,0,1,1
13504,nodes,0,0,1,1
13505,उत्पादों,0,0,1,1
13506,സംഭവിച്ച,0,0,1,1
13507,വിതരണം,0,0,1,1
13508,दोहराना,0,0,1,1
13509,funcionalidade,0,0,1,1
13510,தொடங்கப்பட்டது,0,0,1,1
13511,bemærke,0,0,1,1
13512,wells,0,0,1,1
13515,παραδοσιακές,0,0,1,1
13518,officially,0,0,1,1
13432,تسأل,0,0,1,1
13430,coğrafyada,0,0,1,1
13428,indícios,0,0,1,1
13344,ಮಹಾಯುದ್ಧದ,0,0,1,1
13332,अंगूठा,0,0,1,1
13334,begrijp,0,0,1,1
13337,skipped,0,0,1,1
13338,كذلك؟,0,0,1,1
13339,الأفلام,0,0,1,1
13342,isst,0,0,1,1
13343,зависит,0,0,1,1
13345,காபியை,0,0,1,1
13427,mislukkingen,0,0,1,1
13347,percentage,0,0,1,1
13351,manteau,0,0,1,1
13353,ദുസ്വപ്നം,0,0,1,1
13354,syltetøj,0,0,1,1
13355,ورائعًا,0,0,1,1
13357,മാർഗദർശിത,0,0,1,1
13358,பயணத்தின்போது,0,0,1,1
13331,bevæger,0,0,1,1
13330,розенцвейг,0,0,1,1
13329,ayudarías,0,0,1,1
13328,enojes,0,0,1,1
13307,वित्तीय,0,0,1,1
13308,majoritaire,0,0,1,1
13309,konuşulan,0,0,1,1
13310,нарушения,0,0,1,1
13312,cenar,0,0,1,1
13313,"modell
",0,0,1,1
13316,meteen,0,0,1,1
13317,kritiker,0,0,1,1
13320,ستساعدني,0,0,1,1
13322,സിന്ധൂനദീതടസംസ്കാരം,0,0,1,1
13323,censurer,0,0,1,1
13324,सटीक,0,0,1,1
13325,omarbetats,0,0,1,1
13326,ಪುನರಾವರ್ತನೆ,0,0,1,1
13327,highdimensional,0,0,1,1
13360,محرريها,0,0,1,1
13361,polêmica,0,0,1,1
13362,oriental,0,0,1,1
13398,относился,0,0,1,1
13400,قانون,0,0,1,1
13401,ജീവിതരേഖ,0,0,1,1
13402,migrent,0,0,1,1
13407,sinken,0,0,1,1
13408,stratégiquement,0,0,1,1
13409,مقاطعتك,0,0,1,1
13410,placeholder,0,0,1,1
13411,participer,0,0,1,1
13413,മറ്റേയാൾക്ക്,0,0,1,1
13416,tchakavien,0,0,1,1
13418,मिनटों,0,0,1,1
13419,gericht,0,0,1,1
13420,نيوبيديا،,0,0,1,1
13421,longo,0,0,1,1
13422,diferencias,0,0,1,1
13399,forståelige,0,0,1,1
13397,критиков,0,0,1,1
13366,gelenekleriyle,0,0,1,1
13396,riesgo,0,0,1,1
13373,instaure,0,0,1,1
13377,சொல்லிக்,0,0,1,1
13379,εκπλήσσει,0,0,1,1
13380,والأوكرانية،,0,0,1,1
13381,rebuttal,0,0,1,1
13383,carencia,0,0,1,1
13384,recommenceras,0,0,1,1
13385,mümkündür,0,0,1,1
13387,ರೆಸ್ಟೋರೆಂಟ್,0,0,1,1
13389,"
वे",0,0,1,1
13390,censure »,0,0,1,1
13391,stigmergic,0,0,1,1
13392,പരിശോധനാ,0,0,1,1
13393,redaktion,0,0,1,1
13395,विभाजन,0,0,1,1
13075,المصنوع,0,0,1,1
13074,märkspråken,0,0,1,1
13073,крест,0,0,1,1
12767,episkt,0,0,1,1
12754,dumt,0,0,1,1
12757,संकलित,0,0,1,1
12758,croatia,0,0,1,1
12759,optout,0,0,1,1
12761,счёт,0,0,1,1
12765,увидеть,0,0,1,1
12766,வலைப்பக்க,0,0,1,1
12769,english،,0,0,1,1
12788,മൂന്നും,0,0,1,1
12770,léthargiques,0,0,1,1
12771,rce,0,0,1,1
12775,продуктов,0,0,1,1
12776,otomatik,0,0,1,1
12778,मीडियाविकी,0,0,1,1
12780,confinée,0,0,1,1
12781,attachées,0,0,1,1
12752,خلالها,0,0,1,1
12749,базы,0,0,1,1
12748,καφέ,0,0,1,1
12747,dénuées,0,0,1,1
12722,مقابلات,0,0,1,1
12723,klottrares,0,0,1,1
12725,paradigm,0,0,1,1
12727,അതൊട്ട്‌,0,0,1,1
12728,raros,0,0,1,1
12729,स्कोप,0,0,1,1
12732,تحت,0,0,1,1
12733,المتعمدة,0,0,1,1
12736,« liste,0,0,1,1
12738,bråkdel,0,0,1,1
12740,الكريهة,0,0,1,1
12741,diskutera,0,0,1,1
12743,financial,0,0,1,1
12744,égalitaire,0,0,1,1
12745,herzlich,0,0,1,1
12782,ಹತ್ತಿರ,0,0,1,1
12789,രഥം,0,0,1,1
13072,plotseling,0,0,1,1
12831,"
हिन्दी",0,0,1,1
12821,uitdrukking,0,0,1,1
12822,നാർസിസയും,0,0,1,1
12823,популярным,0,0,1,1
12824,tastiest,0,0,1,1
12825,sampling,0,0,1,1
12826,എന്തിന്,0,0,1,1
12828,collaboratifs,0,0,1,1
12834,μιλούσατε,0,0,1,1
12790,തീര്ച്ചയായും,0,0,1,1
12835,удаляют,0,0,1,1
12836,недавние,0,0,1,1
12837,gabinete,0,0,1,1
12838,ख़राब,0,0,1,1
12839,filtrados,0,0,1,1
12841,बर्खास्त,0,0,1,1
12843,கட்டுரைக்குமான,0,0,1,1
12819,consultar,0,0,1,1
12816,норманом,0,0,1,1
12815,സ്കോർ,0,0,1,1
12814,adn,0,0,1,1
12793,tendrás,0,0,1,1
12794,мнений,0,0,1,1
12795,поймали,0,0,1,1
12796,beğenerek,0,0,1,1
12797,élaboration,0,0,1,1
12798,legislação,0,0,1,1
12800,manzara,0,0,1,1
12802,μέρους,0,0,1,1
12803,выводы,0,0,1,1
12805,tadım,0,0,1,1
12807,объявление,0,0,1,1
12808,причинам,0,0,1,1
12809,மாலை,0,0,1,1
12811,electric,0,0,1,1
12812,grootser,0,0,1,1
12721,знака,0,0,1,1
12720,externe,0,0,1,1
12719,gebruikers,0,0,1,1
12640,mücevherler,0,0,1,1
12631,pionnier,0,0,1,1
12632,للإجابة,0,0,1,1
12633,قصة,0,0,1,1
12634,فكلمة,0,0,1,1
12637,« naissance »,0,0,1,1
12638,ചെയ്യാതെ,0,0,1,1
12639,verloop,0,0,1,1
12642,تخيل,0,0,1,1
12718,num,0,0,1,1
12643,irishtimescom​​,0,0,1,1
12645,rangeringsystem,0,0,1,1
12647,способствовало,0,0,1,1
12648,avoirw,0,0,1,1
12650,تقتصر,0,0,1,1
12651,शिक्षाविदों,0,0,1,1
12652,التأثير,0,0,1,1
12630,تتزوجني,0,0,1,1
12629,webbserver,0,0,1,1
12628,vikipedist,0,0,1,1
12627,ಎಲ್ಲೀ,0,0,1,1
12608,оставался,0,0,1,1
12609,« wiki »,0,0,1,1
12611,வகைப்படுத்தப்படும்,0,0,1,1
12612,diretora,0,0,1,1
12613,máximo,0,0,1,1
12614,ವಾರ,0,0,1,1
12615,பக்கங்களை,0,0,1,1
12616,restricciones,0,0,1,1
12618,शुक्रवार,0,0,1,1
12619,kvartal,0,0,1,1
12621,संतुलित,0,0,1,1
12622,handlung,0,0,1,1
12623,wikiprojeto,0,0,1,1
12624,രോഗികളുടെ,0,0,1,1
12626,മനസ്സിലായില്ലെങ്കിൽ‌,0,0,1,1
12653,onmogelijke,0,0,1,1
12654,nedenini,0,0,1,1
12657,غبي,0,0,1,1
12688,kullanacağım,0,0,1,1
12692,référant,0,0,1,1
12694,донизу,0,0,1,1
12695,malı,0,0,1,1
12696,эпизодах,0,0,1,1
12698,разочарованием,0,0,1,1
12699,വെച്ച്,0,0,1,1
12700,lågkvalitetsändringar,0,0,1,1
12701,einde,0,0,1,1
12705,aquel,0,0,1,1
12706,categorização,0,0,1,1
12707,சிக்கியிருப்பதை,0,0,1,1
12708,отвечающие,0,0,1,1
12710,ويليز,0,0,1,1
12713,لدولة,0,0,1,1
12716,ನಾರ್ಸಿಸಾದ,0,0,1,1
12691,सलाद,0,0,1,1
12685,എന്തുണ്ട്,0,0,1,1
12659,നിർവഹിക്കാൻ,0,0,1,1
12684,secrète,0,0,1,1
12660,complet,0,0,1,1
12664,satisfactory,0,0,1,1
12665,fracaso,0,0,1,1
12666,interessanter,0,0,1,1
12667,جلست,0,0,1,1
12668,ολόκληρη,0,0,1,1
12669,"
वोलापूक",0,0,1,1
12670,கற்பழிப்பு,0,0,1,1
12671,henvender,0,0,1,1
12672,kullanıma,0,0,1,1
12673,hittade,0,0,1,1
12674,bordssätt,0,0,1,1
12675,condemns,0,0,1,1
12676,المزهرة,0,0,1,1
12682,drømmemor,0,0,1,1
12844,wapediatjänsten,0,0,1,1
12845,письме,0,0,1,1
12849,censée,0,0,1,1
13001,koppla,0,0,1,1
12992,आखिरी,0,0,1,1
12993,"
malgaxe",0,0,1,1
12994,perdi,0,0,1,1
12995,поразительная,0,0,1,1
12996,bytes,0,0,1,1
12998,поиске,0,0,1,1
12999,etmez,0,0,1,1
13003,humanidad»,0,0,1,1
12958,cerebro,0,0,1,1
13005,உரையாடலையும்,0,0,1,1
13006,religion,0,0,1,1
13007,sabrosas,0,0,1,1
13008,recaudación,0,0,1,1
13009,ഔദ്യോഗിക,0,0,1,1
13010,"
फ़्रान्सीसी",0,0,1,1
13011,organise,0,0,1,1
12991,மீளமைக்கப்படக்,0,0,1,1
12990,തിരികെ,0,0,1,1
12988,प्लेटफोर्म,0,0,1,1
12986,blanking,0,0,1,1
12962,kaffee,0,0,1,1
12965,टी,0,0,1,1
12967,admites,0,0,1,1
12969,afundar,0,0,1,1
12970,tormentosa,0,0,1,1
12975,നിയമവിരുദ്ധരെ,0,0,1,1
12976,suivi »,0,0,1,1
12977,минутный,0,0,1,1
12979,കുറിക്കുന്നു,0,0,1,1
12980,samhället,0,0,1,1
12981,öbekleri,0,0,1,1
12982,ويحق,0,0,1,1
12983,silverbröd,0,0,1,1
12984,мюнхене,0,0,1,1
12985,klädkänsla,0,0,1,1
13014,альтернатива,0,0,1,1
13015,تقنية,0,0,1,1
13017,ಮುಂದುವರಿಸಿ,0,0,1,1
13045,miraron,0,0,1,1
13047,fallacieuse,0,0,1,1
13048,informeel,0,0,1,1
13051,governing,0,0,1,1
13052,förstasidan,0,0,1,1
13054,наплевать,0,0,1,1
13055,zhyue •,0,0,1,1
13056,ಬಂದಿದ್ದರು,0,0,1,1
13058,erfarenhet,0,0,1,1
13060,самоорганизацией,0,0,1,1
13061,numarasını,0,0,1,1
13064,ಹೇಳದೆ,0,0,1,1
13065,അഹംഭാവമുള്ള,0,0,1,1
13066,intresseområden,0,0,1,1
13068,dreng,0,0,1,1
13070,pueblo,0,0,1,1
13046,ഇപ്രകാരം,0,0,1,1
13043,حقوق,0,0,1,1
13018,computerprogrammeur,0,0,1,1
13042,"
गन",0,0,1,1
13020,highend,0,0,1,1
13022,signera,0,0,1,1
13023,différences,0,0,1,1
13024,اتضح,0,0,1,1
13025,hawaiiaans,0,0,1,1
13026,общедоступным,0,0,1,1
13029,എന്നതിൽ,0,0,1,1
13033,inelegant,0,0,1,1
13034,புன்னகைத்தனர்,0,0,1,1
13035,குறிப்பிட,0,0,1,1
13036,സമാനമായത്,0,0,1,1
13038,चूक,0,0,1,1
13039,presentados,0,0,1,1
13040,accesses,0,0,1,1
13041,математика,0,0,1,1
12959,fåtal,0,0,1,1
12957,लगता।,0,0,1,1
12850,வேலைக்கு,0,0,1,1
12887,aire,0,0,1,1
12877,probabilísticas,0,0,1,1
12878,bedt,0,0,1,1
12879,difíceis,0,0,1,1
12881,pierres,0,0,1,1
12883,diles,0,0,1,1
12884,تخبره,0,0,1,1
12886,செய்வது,0,0,1,1
12888,savezvous,0,0,1,1
12956,"
birmanês",0,0,1,1
12890,എന്തും,0,0,1,1
12891,ಹೊಂದಿಲ್ಲದಿದ್ದರೆ,0,0,1,1
12892,afogando,0,0,1,1
12893,ಮೊದಲಿಗೆ,0,0,1,1
12895,habían,0,0,1,1
12896,identificaba,0,0,1,1
12897,القاسي,0,0,1,1
12876,caught,0,0,1,1
12875,കണ്ടെത്തലുകളും,0,0,1,1
12873,depth,0,0,1,1
12872,rosário,0,0,1,1
12851,recomenda,0,0,1,1
12852,precedes,0,0,1,1
12854,другая,0,0,1,1
12857,decírselo,0,0,1,1
12858,värdelöst,0,0,1,1
12859,அமர்ந்திருக்கிறார்கள்,0,0,1,1
12860,கேள்விக்குறியுடன்,0,0,1,1
12861,καθένα,0,0,1,1
12862,  euros,0,0,1,1
12863,veritabanından,0,0,1,1
12864,supérieures,0,0,1,1
12865,νωρίτερα,0,0,1,1
12866,titeln,0,0,1,1
12868,ήρθα,0,0,1,1
12869,περιλαμβάνει,0,0,1,1
12898,aktivitet,0,0,1,1
12900,illustrative,0,0,1,1
12901,revertingreverted,0,0,1,1
12933,മനസ്സിലാക്കേണ്ടതെല്ലാം,0,0,1,1
12936,тема,0,0,1,1
12938,instans,0,0,1,1
12940,corretos,0,0,1,1
12941,genoptager,0,0,1,1
12943,وسيم,0,0,1,1
12944,superstitions,0,0,1,1
12946,utseendet,0,0,1,1
12947,выросла,0,0,1,1
12948,fundamentalmente,0,0,1,1
12949,അറിയാമോ,0,0,1,1
12950,impossibilitadas,0,0,1,1
12951,geduld,0,0,1,1
12952,ödeviniz,0,0,1,1
12954,ஸ்லக்,0,0,1,1
12955,القرض,0,0,1,1
12934,solvable,0,0,1,1
12932,പ്രകാരം,0,0,1,1
12903,hitting,0,0,1,1
12931,diante,0,0,1,1
12904,செய்யக்கூடாது,0,0,1,1
12905,retórico,0,0,1,1
12909,подмигнули,0,0,1,1
12910,وتبدو,0,0,1,1
12911,representatividad,0,0,1,1
12912,steady,0,0,1,1
12913,dee,0,0,1,1
12914,الكريمة,0,0,1,1
12917,அவரிடம்,0,0,1,1
12920,الشروع,0,0,1,1
12922,consacré,0,0,1,1
12924,enten,0,0,1,1
12927,تستغرق,0,0,1,1
12929,administrados,0,0,1,1
12930,dürüst,0,0,1,1
11611,acusado,0,0,1,1
11610,പുഞ്ചിരിച്ചു,0,0,1,1
11609,lika,0,0,1,1
10348,ويكيمانيا,0,0,1,1
10336,என்பதைப்,0,0,1,1
10338,компании,0,0,1,1
10339,yolculuktan,0,0,1,1
10340,utgivaren,0,0,1,1
10341,считает,0,0,1,1
10343,अर्स,0,0,1,1
10345,vermek,0,0,1,1
10349,höll,0,0,1,1
10363,പറഞ്ഞിട്ടുണ്ട്,0,0,1,1
10350,എട്ട്,0,0,1,1
10351,подготовился,0,0,1,1
10354,tarafsızlık,0,0,1,1
10355,importarme,0,0,1,1
10356,anfangen,0,0,1,1
10359,bekler,0,0,1,1
10360,officielles,0,0,1,1
10335,ενθαρρύνεις,0,0,1,1
10334,fbi,0,0,1,1
10332,താഴെയാണ്,0,0,1,1
10330,ಮಾತನಾಡೋಣ,0,0,1,1
10306,spiegelsites,0,0,1,1
10307,പുറമേ,0,0,1,1
10308,raison »,0,0,1,1
10309,உணவுகள்,0,0,1,1
10310,образования,0,0,1,1
10311,خارجية،,0,0,1,1
10313,vivantes,0,0,1,1
10316,sorarsa,0,0,1,1
10317,israël,0,0,1,1
10324,ಎಂಟು,0,0,1,1
10325,toegankelijke,0,0,1,1
10326,tebrikleri,0,0,1,1
10327,محادثة؟,0,0,1,1
10328,vida»,0,0,1,1
10329,likeknop,0,0,1,1
10361,demuestre,0,0,1,1
10365,खोये,0,0,1,1
10414,étapes,0,0,1,1
10402,തിരുത്തൽ,0,0,1,1
10394,redaktionella,0,0,1,1
10396,« wikimedia »,0,0,1,1
10397,estaría,0,0,1,1
10398,étendra,0,0,1,1
10399,empoderar,0,0,1,1
10400,localized,0,0,1,1
10401,company,0,0,1,1
10403,geologic,0,0,1,1
10366,ρουμπίνια,0,0,1,1
10404,സാക്ഷാത്കരിക്കുമെന്ന്,0,0,1,1
10406,realizando,0,0,1,1
10407,cassation,0,0,1,1
10408,любыми,0,0,1,1
10409,техническое,0,0,1,1
10410,skyldig,0,0,1,1
10411,ಅವಳೊಂದಿಗೆ,0,0,1,1
10393,واكتب,0,0,1,1
10392,suporte,0,0,1,1
10391,mids,0,0,1,1
10390,ಉತ್ತಮವಾದದ್ದನ್ನು,0,0,1,1
10367,solicitação,0,0,1,1
10368,benedicto,0,0,1,1
10369,forhåbentlig,0,0,1,1
10371,πιστέψω,0,0,1,1
10372,bıraktıysanız,0,0,1,1
10374,separar,0,0,1,1
10375,kökler,0,0,1,1
10376,uninformed,0,0,1,1
10378,categorias,0,0,1,1
10380,noruego,0,0,1,1
10383,abartmak,0,0,1,1
10385,ஆரம்பிக்கப்படும்,0,0,1,1
10387,aangeslagen,0,0,1,1
10388,يكافئ,0,0,1,1
10389,galen,0,0,1,1
10305,fotoğrafları,0,0,1,1
10304,quebrou,0,0,1,1
10300,üst,0,0,1,1
10228,sammanfattade,0,0,1,1
10213,എപ്പോൾ,0,0,1,1
10214,destacados,0,0,1,1
10215,خائفًا,0,0,1,1
10217,amerikansk,0,0,1,1
10222,enteros,0,0,1,1
10226,предпочел,0,0,1,1
10227,осознанном,0,0,1,1
10229,лицензируются,0,0,1,1
10299,anciens,0,0,1,1
10230,noem,0,0,1,1
10231,அழைத்துச்,0,0,1,1
10232,متزايد,0,0,1,1
10236,uitzonderlijk,0,0,1,1
10237,framgår,0,0,1,1
10238,पाठकों,0,0,1,1
10239,incompletas,0,0,1,1
10212,inundação,0,0,1,1
10211,നിർമ്മിച്ചിരിക്കുന്നത്,0,0,1,1
10210,toparla,0,0,1,1
10209,يعتبر,0,0,1,1
10187,seguido,0,0,1,1
10188,وتغيرت,0,0,1,1
10191,dn,0,0,1,1
10192,forsinkelse,0,0,1,1
10193,شاهد,0,0,1,1
10194,രെക്കഗ്നിഷൻ,0,0,1,1
10196,rough,0,0,1,1
10198,एकत्रित,0,0,1,1
10200,«квадрига»,0,0,1,1
10201,dengeli,0,0,1,1
10202,ಅಳುತ್ತಿರುವ,0,0,1,1
10205,‘அண்மைய,0,0,1,1
10206,spécifique,0,0,1,1
10207,கட்டுப்பாடுகளைக்,0,0,1,1
10208,έξι,0,0,1,1
10240,निगरानी,0,0,1,1
10245,வில்லை,0,0,1,1
10246,ресурсов,0,0,1,1
10277,بإصدارات,0,0,1,1
10281,mei,0,0,1,1
10283,لنذهب,0,0,1,1
10285,consultable,0,0,1,1
10286,cümleleri,0,0,1,1
10288,नोल,0,0,1,1
10289,miroirs,0,0,1,1
10290,கண்ணீருக்கு,0,0,1,1
10291,hotter,0,0,1,1
10292,रेटिंग,0,0,1,1
10293,مدققو,0,0,1,1
10294,обращается,0,0,1,1
10295,afficher,0,0,1,1
10296,participe,0,0,1,1
10297,चित्रwiki,0,0,1,1
10298,الجنساني,0,0,1,1
10279,inappropriée,0,0,1,1
10273,авторского,0,0,1,1
10247,ydi,0,0,1,1
10272,शुभकामना,0,0,1,1
10249,известны,0,0,1,1
10251,hemispheres,0,0,1,1
10253,പ്രാപ്തിയാക്കുകയും,0,0,1,1
10254,κλάμα,0,0,1,1
10255,sayısı,0,0,1,1
10258,underpolicyer,0,0,1,1
10261,ആളുകളുടെ,0,0,1,1
10262,ಇಡೀ,0,0,1,1
10263,"गया।
जुलाई",0,0,1,1
10265,decades,0,0,1,1
10266,ബംഗാളി,0,0,1,1
10267,réciproque,0,0,1,1
10269,representerats,0,0,1,1
10270,associações,0,0,1,1
10271,grekiskans,0,0,1,1
10413,concluíram,0,0,1,1
10417,zaden,0,0,1,1
10664,« discussion »,0,0,1,1
10579,ربطها,0,0,1,1
10568,kedeligt,0,0,1,1
10569,religiously,0,0,1,1
10572,ζητήσετε,0,0,1,1
10573,كمشتبه,0,0,1,1
10575,профессионализму,0,0,1,1
10576,подход,0,0,1,1
10577,ಸಲಹೆಯನ್ನು,0,0,1,1
10581,désencyclopédie,0,0,1,1
10594,edward,0,0,1,1
10584,därifrån,0,0,1,1
10585,pub,0,0,1,1
10586,ഉപയോഗിച്ചുകൊണ്ട്,0,0,1,1
10588,vagonun,0,0,1,1
10589,ದಣಿದ,0,0,1,1
10591,duidt,0,0,1,1
10592,donantes,0,0,1,1
10567,उसमें,0,0,1,1
10565,directrices,0,0,1,1
10564,സ്തംഭിച്ചുപോകുന്നത്,0,0,1,1
10563,schwester,0,0,1,1
10534,sache,0,0,1,1
10535,ಓಡಿಹೋದಳು,0,0,1,1
10537,സംബന്ധിക്കുന്ന,0,0,1,1
10539,voren,0,0,1,1
10541,petition,0,0,1,1
10543,meşhur,0,0,1,1
10546,nombrar,0,0,1,1
10548,പെരുമാറിയത്,0,0,1,1
10549,टूटा,0,0,1,1
10551,länders,0,0,1,1
10556,désignées,0,0,1,1
10557,итоге,0,0,1,1
10558,वापस,0,0,1,1
10559,harbor,0,0,1,1
10562,vigtigste,0,0,1,1
10593,അതിർത്തി,0,0,1,1
10595,മാതൃവെബ്‌സൈറ്റിനെക്കാൾ,0,0,1,1
10418,spitzen,0,0,1,1
10645,biologiques,0,0,1,1
10633,schlimmer,0,0,1,1
10634,गेब्रियल,0,0,1,1
10635,വെയർ,0,0,1,1
10637,തിരഞ്ഞെടുക്കുന്നതാണ്,0,0,1,1
10638,yazılmakta,0,0,1,1
10642,ഉള്ളവരായതിനാൽ,0,0,1,1
10644,मीट,0,0,1,1
10649,allait,0,0,1,1
10596,mfl,0,0,1,1
10650,situer,0,0,1,1
10651,novel,0,0,1,1
10652,kruist,0,0,1,1
10653,ബാധകമായ,0,0,1,1
10657,ஏற்றுக்கொள்கிறேன்,0,0,1,1
10658,unlike,0,0,1,1
10660,லிப்ரேவை,0,0,1,1
10630,தொடர,0,0,1,1
10627,ζητήσω,0,0,1,1
10626,afslutte,0,0,1,1
10624,कमयूनिटीस,0,0,1,1
10597,посвящён,0,0,1,1
10598,ಪಠ್ಯಕ್ಕೆ,0,0,1,1
10599,studentens,0,0,1,1
10604,неуклонно,0,0,1,1
10606,strider,0,0,1,1
10607,கவலைப்படாதீர்கள்,0,0,1,1
10608,wikipedianerna,0,0,1,1
10609,religieuse,0,0,1,1
10611,olmayın,0,0,1,1
10613,lis,0,0,1,1
10614,apropiado,0,0,1,1
10615,വാക്യങ്ങളും,0,0,1,1
10616,confusion,0,0,1,1
10618,sobrecargas,0,0,1,1
10622,открытие,0,0,1,1
10533,φάει,0,0,1,1
10530,aprendendo,0,0,1,1
10528,geliştirin,0,0,1,1
10458,elaborado,0,0,1,1
10451,sitta,0,0,1,1
10452,уровню,0,0,1,1
10453,തൂപ്പുകാരുമാണ്,0,0,1,1
10454,"
जनवरी",0,0,1,1
10455,வெளித்தொகுப்புக்களை,0,0,1,1
10456,برنامجا,0,0,1,1
10457,formulated,0,0,1,1
10459,الكبرى,0,0,1,1
10526,സ്വരം,0,0,1,1
10460,பிரதிபலிப்பில்,0,0,1,1
10461,utformad,0,0,1,1
10462,refus,0,0,1,1
10463,discussed,0,0,1,1
10465,способа,0,0,1,1
10466,bedank,0,0,1,1
10467,вернулась,0,0,1,1
10449,pássaro,0,0,1,1
10446,उठाते,0,0,1,1
10445,reais,0,0,1,1
10444,llega,0,0,1,1
10420,വിക്കിപീഡിയകളിലും,0,0,1,1
10421,relire,0,0,1,1
10422,употребить,0,0,1,1
10423,убедитесь,0,0,1,1
10424,вклады,0,0,1,1
10427,changing,0,0,1,1
10428,olmadan,0,0,1,1
10431,storbritannien,0,0,1,1
10432,traveled,0,0,1,1
10433,nylige,0,0,1,1
10435,enyongle,0,0,1,1
10436,envergure,0,0,1,1
10438,மாதம்,0,0,1,1
10439,الهائلة,0,0,1,1
10442,namiddag,0,0,1,1
10468,friere,0,0,1,1
10469,கொள்கைக்கு,0,0,1,1
10471,للأكل,0,0,1,1
10505,தந்தி,0,0,1,1
10508,χρήσιμες,0,0,1,1
10509,सांख्यिकीय,0,0,1,1
10510,أخفقت,0,0,1,1
10512,التحرير،,0,0,1,1
10513,лондоне,0,0,1,1
10514,specialized,0,0,1,1
10515,जाकर,0,0,1,1
10516,"
किर्घिज़",0,0,1,1
10517,pragmatic,0,0,1,1
10518,incrustar,0,0,1,1
10520,declining,0,0,1,1
10521,захватывающее,0,0,1,1
10522,fotorrealista,0,0,1,1
10523,spektrum,0,0,1,1
10525,aprende,0,0,1,1
10506,समझना,0,0,1,1
10504,ವ್ಯಾಕರಣ,0,0,1,1
10474,ലാബിൽ,0,0,1,1
10503,entonação,0,0,1,1
10475,подожди,0,0,1,1
10476,bryter,0,0,1,1
10479,oturmak,0,0,1,1
10480,erwähne,0,0,1,1
10483,ekonomi,0,0,1,1
10484,മധുരമുള്ളതുമായ,0,0,1,1
10485,ημιτελής,0,0,1,1
10486,liminar,0,0,1,1
10488,பால்கனியில்,0,0,1,1
10489,zehn,0,0,1,1
10490,buluyorum,0,0,1,1
10492,förrän,0,0,1,1
10494,fatih,0,0,1,1
10499,സാദ്ധ്യതയുണ്ടാവാറുണ്ട്।,0,0,1,1
10500,редакционном,0,0,1,1
10185,conservar,0,0,1,1
10182,ലിങ്ക്,0,0,1,1
10181,الدراسة,0,0,1,1
9833,intervention ,0,0,1,1
9822,reseñados,0,0,1,1
9823,landlocked,0,0,1,1
9825,illustrée,0,0,1,1
9826,upptäckte,0,0,1,1
9828,totémisme,0,0,1,1
9830,kritikere,0,0,1,1
9832,المال؟,0,0,1,1
9834,oavsett,0,0,1,1
9855,статистику,0,0,1,1
9841,tridimensional,0,0,1,1
9842,polish,0,0,1,1
9844,şükür,0,0,1,1
9847,tuyau,0,0,1,1
9849,"
रोमान्श",0,0,1,1
9850,ബി,0,0,1,1
9851,"
inglês",0,0,1,1
9821,متعدد,0,0,1,1
9819,ಪಠ್ಯ,0,0,1,1
9818,cuestiones,0,0,1,1
9815,antérieurs,0,0,1,1
9791,அழகு,0,0,1,1
9794,फ़िक्स,0,0,1,1
9796,devrionsnous,0,0,1,1
9798,прекрасна,0,0,1,1
9799,والصربية,0,0,1,1
9800,begreep,0,0,1,1
9802,pouce,0,0,1,1
9805,fließende,0,0,1,1
9807,ministère,0,0,1,1
9808,ജീവിതത്തിലെ,0,0,1,1
9809,вниз,0,0,1,1
9810,الموقف,0,0,1,1
9811,ஆவர்,0,0,1,1
9812,குறிப்பிடப்படுகிறது,0,0,1,1
9814,cobrir,0,0,1,1
9853,geheim,0,0,1,1
9857,skede,0,0,1,1
10178,habido,0,0,1,1
9895,ട്ട്,0,0,1,1
9884,patocka,0,0,1,1
9885,வாங்கிய,0,0,1,1
9888,centralized,0,0,1,1
9889,आंतरिक,0,0,1,1
9890,проходит,0,0,1,1
9893,påpekar,0,0,1,1
9894,unmögliche,0,0,1,1
9896,دوت,0,0,1,1
9858,विकिइन्फो,0,0,1,1
9897,ಪಿಜ್ಜಾ,0,0,1,1
9899,defendida,0,0,1,1
9901,красивый,0,0,1,1
9903,süslü,0,0,1,1
9904,implement,0,0,1,1
9905,adicción»,0,0,1,1
9908,идей,0,0,1,1
9883,medverkan,0,0,1,1
9882,nyt,0,0,1,1
9881,нуждаются,0,0,1,1
9880,fallstudie,0,0,1,1
9860,níveis,0,0,1,1
9861,معروفًا,0,0,1,1
9863,ആവേശകരവും,0,0,1,1
9866,sonido,0,0,1,1
9867,палец,0,0,1,1
9868,deneyin,0,0,1,1
9869,موعدًا,0,0,1,1
9870,hovedet,0,0,1,1
9871,كلاسيكية,0,0,1,1
9872,பணிவுடன்,0,0,1,1
9873,πρώτο,0,0,1,1
9874,skickade,0,0,1,1
9876,tartışmanın,0,0,1,1
9877,مبتسمين,0,0,1,1
9879,lekkere,0,0,1,1
9790,etmek”,0,0,1,1
9789,സർവ്വകലാശാലയിൽ,0,0,1,1
9788,"
chinês",0,0,1,1
9709,பக்கம்’,0,0,1,1
9697,çoğunluğu,0,0,1,1
9698,hohe,0,0,1,1
9699,engelen,0,0,1,1
9701,anlatırken,0,0,1,1
9705,blindtester,0,0,1,1
9706,osaklig,0,0,1,1
9708,gemas,0,0,1,1
9710,ранних,0,0,1,1
9786,приходите,0,0,1,1
9711,ब्रेकेट,0,0,1,1
9712,അസാമാന്യമായ,0,0,1,1
9713,puéril,0,0,1,1
9714,«проверяемость,0,0,1,1
9716,संघ,0,0,1,1
9717,pictures,0,0,1,1
9720,б,0,0,1,1
9696,ira,0,0,1,1
9695, milliards,0,0,1,1
9694,डच,0,0,1,1
9693,российскую,0,0,1,1
9666,marginaux,0,0,1,1
9667,κάποιες,0,0,1,1
9669,cosmological,0,0,1,1
9670,popularisés,0,0,1,1
9671,ಹಾಸಿಗೆಯ,0,0,1,1
9673,tranche,0,0,1,1
9675,φέτος,0,0,1,1
9676,создала,0,0,1,1
9678,فلنفعل,0,0,1,1
9681,твёрдым,0,0,1,1
9686,omfattning,0,0,1,1
9688,τόπο,0,0,1,1
9689,والدة,0,0,1,1
9691,скопировать,0,0,1,1
9692,rádio,0,0,1,1
9722,leken,0,0,1,1
9724,ninetenths,0,0,1,1
9725,shells,0,0,1,1
9755,dermed,0,0,1,1
9759,beispiele,0,0,1,1
9761,ನಾರುವ,0,0,1,1
9764,तीक्ष्ण,0,0,1,1
9765,बोलने,0,0,1,1
9768,நுபீடியாவானது,0,0,1,1
9769,fluid,0,0,1,1
9772,natureculture,0,0,1,1
9773,mistet,0,0,1,1
9777,ocensurerade,0,0,1,1
9778,egoist,0,0,1,1
9779,तीसरी,0,0,1,1
9780,dakikalar,0,0,1,1
9781,erbjudande,0,0,1,1
9784,администраторы,0,0,1,1
9785,postagens,0,0,1,1
9758,marcando,0,0,1,1
9754,respectivement,0,0,1,1
9727,temor,0,0,1,1
9750,yaparım,0,0,1,1
9728,split,0,0,1,1
9730,счастлив,0,0,1,1
9731,ulteriores,0,0,1,1
9732,அழைப்பாளருக்கோ,0,0,1,1
9733,tutabilmek,0,0,1,1
9735,പതിപ്പുകളുണ്ട്‌,0,0,1,1
9736,karşılaştığı,0,0,1,1
9738,passada,0,0,1,1
9739,வைக்கும்,0,0,1,1
9740,gubernamentales,0,0,1,1
9742,pruebas,0,0,1,1
9744,كاثرين,0,0,1,1
9746,μάθημα,0,0,1,1
9747,recognition‏،,0,0,1,1
9749,മുൻപ്,0,0,1,1
9909,منهجي،,0,0,1,1
9915,சொல்வதாகவும்,0,0,1,1
9918, года,0,0,1,1
10097,पकड़ने,0,0,1,1
10080,выучили,0,0,1,1
10084,அழுத்திப்,0,0,1,1
10085,جمالها,0,0,1,1
10086,ए,0,0,1,1
10087,hızlandırın,0,0,1,1
10093,problemáticas,0,0,1,1
10094,investigan,0,0,1,1
10099,organisaties,0,0,1,1
10045,उद्धृत,0,0,1,1
10100,støttes,0,0,1,1
10101,superan,0,0,1,1
10104,repetitive,0,0,1,1
10105,utilisées,0,0,1,1
10107,அறிந்திருக்க,0,0,1,1
10108,يتحدث,0,0,1,1
10109,refléter,0,0,1,1
10079,supervisory,0,0,1,1
10075,législationsu,0,0,1,1
10072,ernaast,0,0,1,1
10071,abusive,0,0,1,1
10047,ഭാഷകളിലും,0,0,1,1
10049,غرفة,0,0,1,1
10050,yorker,0,0,1,1
10053,καταλάβει,0,0,1,1
10054,presenteert,0,0,1,1
10055,professionnelle,0,0,1,1
10056,amusante,0,0,1,1
10057,kasparov,0,0,1,1
10058,कहेंगे,0,0,1,1
10060,glimlachte,0,0,1,1
10061,comprarte,0,0,1,1
10063,vriendinnen,0,0,1,1
10065,tratar,0,0,1,1
10069,équilibrer,0,0,1,1
10070,serverklustren,0,0,1,1
10110,ബാങ്കിന്റെ,0,0,1,1
10111,kullanmıyorsunuz,0,0,1,1
10112,വരുത്താൻ,0,0,1,1
10147,ಸುಂದರವಾಗಿದ್ದೀರಿ,0,0,1,1
10150,استثنائي,0,0,1,1
10151,ಬಸ್,0,0,1,1
10153,camada,0,0,1,1
10155,blackbody,0,0,1,1
10157,அதற்குப்,0,0,1,1
10159,കണക്ക്,0,0,1,1
10160,interesa,0,0,1,1
10161,drückt,0,0,1,1
10162,desea,0,0,1,1
10165,kullanılabilir,0,0,1,1
10166,അറിയാവുന്ന,0,0,1,1
10168,οικουμενικής,0,0,1,1
10169,கூடுவன,0,0,1,1
10175,എഴുതാവുന്നതുകൊണ്ട്,0,0,1,1
10176,koyuyorum,0,0,1,1
10149,kwaad,0,0,1,1
10146,imprecisas,0,0,1,1
10115,avoided,0,0,1,1
10145,അഭിപ്രായ,0,0,1,1
10118,viajaban,0,0,1,1
10119,ഇന്റലിജൻസ്,0,0,1,1
10120,द्वितीय,0,0,1,1
10121,demecinde,0,0,1,1
10123,legitimidad,0,0,1,1
10124,центре,0,0,1,1
10127,révélant,0,0,1,1
10129,முயற்சிக்கும்போது,0,0,1,1
10130,குதித்தால்,0,0,1,1
10131,leta,0,0,1,1
10132,कॉपी,0,0,1,1
10133,continuant,0,0,1,1
10134,convenir,0,0,1,1
10135,cohérence,0,0,1,1
10143,accordant,0,0,1,1
10046,contribue,0,0,1,1
10044,naturally,0,0,1,1
9921,புத்தகத்தை,0,0,1,1
9965,présentés,0,0,1,1
9957,विस्मयित,0,0,1,1
9958,വലിച്ചിടുക,0,0,1,1
9959,"
तुर्क",0,0,1,1
9960,περιέγραφε,0,0,1,1
9961,ಜೈಲುಗಳಲ್ಲಿ,0,0,1,1
9963,colonies,0,0,1,1
9964,coopératif »,0,0,1,1
9970,كاسم,0,0,1,1
10043,arbitrage,0,0,1,1
9971,oxygenation,0,0,1,1
9972,squelette,0,0,1,1
9973,കടന്നുപോകാൻ,0,0,1,1
9977,பராக்,0,0,1,1
9978,драгоценными,0,0,1,1
9979,തരാം,0,0,1,1
9981,mammals,0,0,1,1
9954,உதாரணமாகச்,0,0,1,1
9953,பங்களிப்புகளைப்,0,0,1,1
9951,ravi,0,0,1,1
9947,nez,0,0,1,1
9922,probabilidad,0,0,1,1
9924,onaylamadıkları,0,0,1,1
9925,répartissent,0,0,1,1
9926,proportions,0,0,1,1
9929,வைத்தீர்கள்,0,0,1,1
9930,weliswaar,0,0,1,1
9931,förstående,0,0,1,1
9932,बताएंगे,0,0,1,1
9933,estompée,0,0,1,1
9936,reshaped,0,0,1,1
9937,εθνικοτήτων,0,0,1,1
9938,अमीर,0,0,1,1
9939,revisionréf,0,0,1,1
9942,"
irlandês",0,0,1,1
9945,probabilidades,0,0,1,1
9982,அச்சுவழிப்,0,0,1,1
9986,söyledi,0,0,1,1
9989,யூடியூப்,0,0,1,1
10017,aburrido,0,0,1,1
10019,jämnt,0,0,1,1
10020,​​lange,0,0,1,1
10021,quinta,0,0,1,1
10024,вирджилом,0,0,1,1
10026,упоминающимся,0,0,1,1
10027,алгоритм,0,0,1,1
10028,ಅಲ್ಲವೇ,0,0,1,1
10029,additions,0,0,1,1
10030,vandálicas,0,0,1,1
10031,modales,0,0,1,1
10032,feasible,0,0,1,1
10036,udtale,0,0,1,1
10039,μικρά,0,0,1,1
10040,performansı,0,0,1,1
10042,sens »,0,0,1,1
10018,videnskabeligt,0,0,1,1
10016,ಕಾಣಿಸುತ್ತಾನೆ,0,0,1,1
9990,atmen,0,0,1,1
10015,toenemen,0,0,1,1
9993,знаменитости,0,0,1,1
9994,wikipédien,0,0,1,1
9995,مواضيع,0,0,1,1
9996,eigendom,0,0,1,1
9997,förhindra,0,0,1,1
9999,فروع,0,0,1,1
10001,موضعاً,0,0,1,1
10002,actualités,0,0,1,1
10008,opzetten,0,0,1,1
10009,cometí,0,0,1,1
10010,moderação,0,0,1,1
10011,लिखने,0,0,1,1
10012,sixième,0,0,1,1
10013,breathe,0,0,1,1
10014,ജൂലൈ,0,0,1,1
10661,கலந்துரையாடல்களுக்குப்,0,0,1,1
10665,fugles,0,0,1,1
11602,ಪ್ರಕಾರ,0,0,1,1
11303,pior,0,0,1,1
11295,وبهذا,0,0,1,1
11296,указан,0,0,1,1
11298,eliminaria,0,0,1,1
11299,ecologists,0,0,1,1
11300,slösa,0,0,1,1
11301,defect,0,0,1,1
11302,tendência,0,0,1,1
11304,विकिट्रेवल,0,0,1,1
11315,bräuchen,0,0,1,1
11305,startsidan,0,0,1,1
11306,framförs,0,0,1,1
11307,habitable,0,0,1,1
11308,gravedad,0,0,1,1
11310,تغيير,0,0,1,1
11311,ακαδημαϊκό,0,0,1,1
11312,varié,0,0,1,1
11294,решившегося,0,0,1,1
11293,mencione,0,0,1,1
11292,வருத்தப்படுகிறீர்கள்,0,0,1,1
11291,bibliotekariens,0,0,1,1
11273,identitet,0,0,1,1
11274,பக்கம்,0,0,1,1
11275,सेलेब्रेट्स,0,0,1,1
11277,officiella,0,0,1,1
11278,on—the,0,0,1,1
11279,déisme ,0,0,1,1
11280,jedoch,0,0,1,1
11281,chartes,0,0,1,1
11282,ഡോളർ,0,0,1,1
11283,conspiracy,0,0,1,1
11285,села,0,0,1,1
11286,प्रोटेस्टर,0,0,1,1
11287,تقريبًا،,0,0,1,1
11288,படித்துக்கொண்டிருக்கிறேன்,0,0,1,1
11289,أسألك,0,0,1,1
11313,transmit,0,0,1,1
11316,إحدى,0,0,1,1
11368,resulta,0,0,1,1
11357,grubun,0,0,1,1
11345,качаешь,0,0,1,1
11347,габриэлем,0,0,1,1
11348,yalan,0,0,1,1
11351,ابنتك,0,0,1,1
11352,ബസ്,0,0,1,1
11353,grossièrement,0,0,1,1
11356,പ്രത്യേകിച്ച്,0,0,1,1
11358,طبيعية,0,0,1,1
11317,eleştirilerine,0,0,1,1
11359,fængsler,0,0,1,1
11360,menschen,0,0,1,1
11361,обеспечивает,0,0,1,1
11362,permisesx,0,0,1,1
11363,ahogamiento,0,0,1,1
11364,básico,0,0,1,1
11365,αφού,0,0,1,1
11343,adding,0,0,1,1
11342,recopier,0,0,1,1
11339,உணர்வு,0,0,1,1
11338,உதவுகிறது,0,0,1,1
11318,κάθονται,0,0,1,1
11320,تجنب,0,0,1,1
11322,प्रतिनिधित्व,0,0,1,1
11323,ഇംഗ്ലീഷിലെ,0,0,1,1
11324,ആയതുകൊണ്ട്,0,0,1,1
11325,namely,0,0,1,1
11326,depende,0,0,1,1
11327,ചേരുന്നവരെ,0,0,1,1
11328,βασικοί,0,0,1,1
11329,कंटेंट,0,0,1,1
11332,cümleler,0,0,1,1
11333,tafel,0,0,1,1
11335,propuestas,0,0,1,1
11336,ആസ്വദിക്കും,0,0,1,1
11337,démissionne,0,0,1,1
11272,şehit,0,0,1,1
11271,formé,0,0,1,1
11270,conheço,0,0,1,1
11193,αποκτήσετε,0,0,1,1
11177,yrkeskategorier,0,0,1,1
11178,maître,0,0,1,1
11179,दर्पण,0,0,1,1
11180,sunduğu,0,0,1,1
11184,classés,0,0,1,1
11185,जीता,0,0,1,1
11192,वेर्कस्टाट,0,0,1,1
11195,ಕಾರ್ಯನಿರತವಾಗಿದೆ,0,0,1,1
11267,संपादकीय,0,0,1,1
11199,بالعرض,0,0,1,1
11203,acadêmica,0,0,1,1
11204,cloning,0,0,1,1
11205,скрестите,0,0,1,1
11206,scaling,0,0,1,1
11207,മലയാളികളാണ്,0,0,1,1
11210,маленькие,0,0,1,1
11176,അതു,0,0,1,1
11174,préhistoire,0,0,1,1
11173,تعديله,0,0,1,1
11172,பேச்சாளர்கள்,0,0,1,1
11148,ಪ್ರಾಮಾಣಿಕವಾಗಿ,0,0,1,1
11150,இணையத்தளங்களின்,0,0,1,1
11151,«ты»,0,0,1,1
11152,bekende,0,0,1,1
11154,παγκόσμιο,0,0,1,1
11157,eerlijk,0,0,1,1
11158,soe,0,0,1,1
11159,beğenme,0,0,1,1
11161,ameliorate,0,0,1,1
11163,ickevetenskaplig,0,0,1,1
11164,kommen,0,0,1,1
11165,टाटर,0,0,1,1
11169,indicada,0,0,1,1
11170,أوباما,0,0,1,1
11171,assistant,0,0,1,1
11211,تتبعهم،,0,0,1,1
11212,collegiale,0,0,1,1
11214,descrito,0,0,1,1
11239,sıfatlar,0,0,1,1
11241,"
occitano",0,0,1,1
11244,dorf,0,0,1,1
11246,दुर्भाग्य,0,0,1,1
11248,falsedades,0,0,1,1
11249,preocupação,0,0,1,1
11250,assess,0,0,1,1
11252,francophone,0,0,1,1
11253,зарегистрированный,0,0,1,1
11257,المفضلة,0,0,1,1
11258,bahsetmediniz,0,0,1,1
11259,कॉफी,0,0,1,1
11261,trovärdiga,0,0,1,1
11264,glatt,0,0,1,1
11265,വരുമ്പോൾ,0,0,1,1
11266,weitergab,0,0,1,1
11240,возможных,0,0,1,1
11238,பறவையைப்,0,0,1,1
11215,выяснила,0,0,1,1
11237,doisje,0,0,1,1
11216,الى,0,0,1,1
11217,documentos,0,0,1,1
11218,علمت,0,0,1,1
11222,"
baixo",0,0,1,1
11225,wikipédiag,0,0,1,1
11226,garantiza,0,0,1,1
11227,scruté,0,0,1,1
11229,mühim,0,0,1,1
11230,تحسينات,0,0,1,1
11231,hävde,0,0,1,1
11232,क्रिमसन,0,0,1,1
11233,sociobiologie,0,0,1,1
11234,ಮಾತನಾಡುತ್ತಾ,0,0,1,1
11235,«сообщить,0,0,1,1
11236,വിലമതിക്കാനാവാത്തത്,0,0,1,1
11367,campanha,0,0,1,1
11370,κολλήσετε,0,0,1,1
10667,προφέρετε,0,0,1,1
11530,பயனரின்,0,0,1,1
11519,خذ,0,0,1,1
11520,historik,0,0,1,1
11522,projeler,0,0,1,1
11523,bazılarının,0,0,1,1
11524,multiagent,0,0,1,1
11525,tendency,0,0,1,1
11529,സൗന്ദര്യവും,0,0,1,1
11531,सम्मेलनों,0,0,1,1
11543,kollaborativa,0,0,1,1
11532,etmesini,0,0,1,1
11534,kommentieren,0,0,1,1
11535,ചേർന്ന്,0,0,1,1
11536,ಗ್ಮಾಟ್,0,0,1,1
11538,doğrulanabilecek,0,0,1,1
11539,σοβαρά,0,0,1,1
11540,"
usbeque",0,0,1,1
11518,geoinformação,0,0,1,1
11517,ವಾರಗಳು,0,0,1,1
11516,usagers,0,0,1,1
11512,केमलकेस,0,0,1,1
11491,посетителям,0,0,1,1
11493,mentionnez,0,0,1,1
11495,wikípedo,0,0,1,1
11497,dinî,0,0,1,1
11498,complexiteit,0,0,1,1
11500,अभिनेता,0,0,1,1
11501,officiels,0,0,1,1
11502,gætte,0,0,1,1
11503,rapportés,0,0,1,1
11504,sammanhållande,0,0,1,1
11506,"
इतालवी",0,0,1,1
11507,vengera,0,0,1,1
11508,maç,0,0,1,1
11509,സാമുവൽ,0,0,1,1
11510,ಪರಿಸ್ಥಿತಿಯಲ್ಲಿರಬೇಕು,0,0,1,1
11541,καλούντα,0,0,1,1
11544,സാധ്യമാക്കിയത്,0,0,1,1
11372,ബന്ധപ്പെടുത്തിയ,0,0,1,1
11590,satírico,0,0,1,1
11580,fungera,0,0,1,1
11581,வளர்ந்து,0,0,1,1
11584,новых,0,0,1,1
11585,cálmate,0,0,1,1
11587,தேர்வுகள்,0,0,1,1
11588,aufhalten,0,0,1,1
11589,consistência,0,0,1,1
11592,அதிநவீன,0,0,1,1
11546,постепенно,0,0,1,1
11594,freely,0,0,1,1
11596,"
स्लोवेनियाई",0,0,1,1
11597,ತೊಂದರೆಗೊಳಿಸುವುದಕ್ಕೆ,0,0,1,1
11598,excuser,0,0,1,1
11599,ഉച്ചഭക്ഷണത്തിന്,0,0,1,1
11600,yaptıysanız,0,0,1,1
11601,вышло,0,0,1,1
11579,δικιο,0,0,1,1
11578,atrapado,0,0,1,1
11577,yakut,0,0,1,1
11576,എന്നിവയൊക്കെ,0,0,1,1
11547,heritage,0,0,1,1
11548,ಯೋಜಿಸುತ್ತಿದ್ದೇನೆ,0,0,1,1
11549,ಪಡೆದಿದ್ದೀರಾ,0,0,1,1
11550,boring,0,0,1,1
11551,yere,0,0,1,1
11552,hepimiz,0,0,1,1
11554,ചിലരാകട്ടെ,0,0,1,1
11555,symbolicknowledgebased,0,0,1,1
11557,ωραίο,0,0,1,1
11558,कोरिया,0,0,1,1
11560,മനുഷ്യന്,0,0,1,1
11562,foreslå,0,0,1,1
11569,восемь,0,0,1,1
11572,സേവന,0,0,1,1
11573,olhando,0,0,1,1
11490,обед,0,0,1,1
11489,ഉറവിടങ്ങളുണ്ട്,0,0,1,1
11488,dismoi,0,0,1,1
11415,wikiversité,0,0,1,1
11401,حرب,0,0,1,1
11402,ಎದೆಗುಂದಿದಳು,0,0,1,1
11404,سأغادر,0,0,1,1
11405,omitiendo,0,0,1,1
11407,tevoorschijn,0,0,1,1
11410,تيمز,0,0,1,1
11413,போன்றவற்றிலிருந்து,0,0,1,1
11417,parallèle,0,0,1,1
11486,искусствоведческой,0,0,1,1
11418,släktforskare,0,0,1,1
11425,गुस्से,0,0,1,1
11426,இருந்தோம்,0,0,1,1
11427,azar,0,0,1,1
11428,oylamalarına,0,0,1,1
11429,açıklama,0,0,1,1
11430,universitarios,0,0,1,1
11400,αντανάκλαση,0,0,1,1
11399,expose,0,0,1,1
11398,baseret,0,0,1,1
11397,manners,0,0,1,1
11373,beskrive,0,0,1,1
11374,olvidan,0,0,1,1
11375,eclipsando,0,0,1,1
11376,السعي,0,0,1,1
11377,ஸ்டுபண்டஸ்,0,0,1,1
11379,തിരഞ്ഞെടുക്കാൻ,0,0,1,1
11383,системную,0,0,1,1
11384,заметьте,0,0,1,1
11385,खुली,0,0,1,1
11388,украинскими,0,0,1,1
11389,concordar,0,0,1,1
11390,ಕೂಡ,0,0,1,1
11391,имеешь,0,0,1,1
11392,uitlegde,0,0,1,1
11393,أذكرك,0,0,1,1
11431,ಒಳ್ಳೆಯವನಾಗಿದ್ದೆ,0,0,1,1
11432,பழைய,0,0,1,1
11433,மிகப்,0,0,1,1
11459,botanists,0,0,1,1
11461,وبالنسبة,0,0,1,1
11463,gosto,0,0,1,1
11464,διεύθυνση,0,0,1,1
11467,போதுமானதாக,0,0,1,1
11469,ستصل,0,0,1,1
11472,arriverez,0,0,1,1
11475,अल्पकालिक,0,0,1,1
11476,excessivo,0,0,1,1
11477,udgaver,0,0,1,1
11478,describen,0,0,1,1
11480,sonrisas,0,0,1,1
11481,"start
पारंपरिक",0,0,1,1
11482,medicate,0,0,1,1
11484,nun,0,0,1,1
11485,வேண்டுமானாலும்,0,0,1,1
11460,qu’en,0,0,1,1
11458,يحاول,0,0,1,1
11434,diderot,0,0,1,1
11456,diyorsun,0,0,1,1
11435,вправе,0,0,1,1
11436,placés,0,0,1,1
11437,debería,0,0,1,1
11438,majeurs,0,0,1,1
11439,wedstrijd,0,0,1,1
11440,ortnamn,0,0,1,1
11441,مساهمون,0,0,1,1
11444,பிரித்தானிக்கா,0,0,1,1
11445,نقودًا,0,0,1,1
11448,ഒരാൾ,0,0,1,1
11449,diversité,0,0,1,1
11450,ಇಂಗ್ಲಿಷ್ನಲ್ಲಿ,0,0,1,1
11451,gældende,0,0,1,1
11453,linéaire,0,0,1,1
11455,chevalier,0,0,1,1
11147,المتوسط,0,0,1,1
11146,हफ्तों,0,0,1,1
11144,വന്ന്,0,0,1,1
10833,وdutch,0,0,1,1
10818,behind,0,0,1,1
10819,lund,0,0,1,1
10821,രാജ്യത്തേക്ക്,0,0,1,1
10822,ideell,0,0,1,1
10824,умышленно,0,0,1,1
10825,डीलीट,0,0,1,1
10831,“davutoğlu’nun,0,0,1,1
10834,couler,0,0,1,1
10845,embarcarse,0,0,1,1
10837,büyütmek,0,0,1,1
10838,incommensurables,0,0,1,1
10839,точный,0,0,1,1
10840,prohíbe,0,0,1,1
10841,pregunte,0,0,1,1
10842,திடீரென்று,0,0,1,1
10843,ноги,0,0,1,1
10817,пересматривают,0,0,1,1
10816,திறமூல,0,0,1,1
10815,"
हैतियाई",0,0,1,1
10813,доставляют,0,0,1,1
10791,l’utilisateur,0,0,1,1
10792,creaciones,0,0,1,1
10794,språkversion,0,0,1,1
10796,ಗೆಳೆಯ,0,0,1,1
10797,усилие,0,0,1,1
10798,займемся,0,0,1,1
10800,gekeken,0,0,1,1
10803,கூட,0,0,1,1
10804,hechas,0,0,1,1
10805,reportedly,0,0,1,1
10806,emenda,0,0,1,1
10807,είπα,0,0,1,1
10808,समन्वय,0,0,1,1
10810,тупого,0,0,1,1
10811,yakın,0,0,1,1
10844,директор,0,0,1,1
10846,ಪ್ರಾರಂಭಿಸೋಣ,0,0,1,1
11141,beyler,0,0,1,1
10885,அதிர்ச்சியடைந்தாள்,0,0,1,1
10877,agrupan,0,0,1,1
10878,nævner,0,0,1,1
10880,philosophyak,0,0,1,1
10881,tokens,0,0,1,1
10882,combined,0,0,1,1
10883,मांगने,0,0,1,1
10884,خاملة,0,0,1,1
10886,மனிதர்,0,0,1,1
10848,cellular,0,0,1,1
10887,bg •,0,0,1,1
10888,தயாரித்தேன்,0,0,1,1
10890,infantil​​,0,0,1,1
10891,auxquels,0,0,1,1
10896,emocionamos,0,0,1,1
10897,corroborado,0,0,1,1
10899,வளர்ப்பதற்கு,0,0,1,1
10876,உதவுங்கள்,0,0,1,1
10872,देश,0,0,1,1
10871,أعارض,0,0,1,1
10870,сети,0,0,1,1
10850,niesde,0,0,1,1
10851,decentralizing,0,0,1,1
10852,entières,0,0,1,1
10854,بالعربية,0,0,1,1
10855,elevate,0,0,1,1
10856,planerat,0,0,1,1
10859,tomó,0,0,1,1
10860,объёму,0,0,1,1
10863,ಯೋಜನೆ,0,0,1,1
10864,അത്‌,0,0,1,1
10865,mbh,0,0,1,1
10866,subcampo,0,0,1,1
10867,ips,0,0,1,1
10868,«википедия»,0,0,1,1
10869,horen,0,0,1,1
10790,طبيعة,0,0,1,1
10788,şeye,0,0,1,1
10786,decimale,0,0,1,1
10713,valeurs…,0,0,1,1
10703,وأخذت,0,0,1,1
10704,nationales,0,0,1,1
10706,തനിക്ക്,0,0,1,1
10707,compensaban,0,0,1,1
10708,"
panjabi",0,0,1,1
10709,lyssna,0,0,1,1
10712,உருளைக்கிழங்கை,0,0,1,1
10714,affiliation,0,0,1,1
10785,toerist,0,0,1,1
10715,lentes,0,0,1,1
10722,ضد,0,0,1,1
10725,ചോദിക്കാൻ‌,0,0,1,1
10726,включения,0,0,1,1
10727,sh •,0,0,1,1
10728,innegociable,0,0,1,1
10731,cierta,0,0,1,1
10702,locomotion‏,0,0,1,1
10701,инноваторству,0,0,1,1
10700,حيال,0,0,1,1
10697,ταξίδεψε,0,0,1,1
10668,apparut,0,0,1,1
10672,ஏற்படுத்தப்பட்டுள்ள,0,0,1,1
10676,தலைப்புச்,0,0,1,1
10678,отсеиваются,0,0,1,1
10679,சுயாதீனமாக,0,0,1,1
10680,വിക്കിയിലേക്കും,0,0,1,1
10683,arm,0,0,1,1
10684,запись,0,0,1,1
10685,ευχαρίστησή,0,0,1,1
10687,modificado,0,0,1,1
10688,கொண்டிருந்தார்கள்,0,0,1,1
10689,شهريًا,0,0,1,1
10692,smiling,0,0,1,1
10693,genaamd,0,0,1,1
10694,كاذبة,0,0,1,1
10732,nieste,0,0,1,1
10733,хуже,0,0,1,1
10734,cite,0,0,1,1
10758,búsquedas,0,0,1,1
10760,لمقطع,0,0,1,1
10762,المختلفة,0,0,1,1
10763,illimité,0,0,1,1
10764,assistir,0,0,1,1
10765,fdims,0,0,1,1
10766,çocuğum,0,0,1,1
10769,теорий,0,0,1,1
10770,различия,0,0,1,1
10772,लीब्रे,0,0,1,1
10773,gekleed,0,0,1,1
10774,அல்லவா,0,0,1,1
10775,tratamiento,0,0,1,1
10776,autorisation,0,0,1,1
10781,سلسلة,0,0,1,1
10784,والسؤال,0,0,1,1
10759,hilf,0,0,1,1
10757,заботиться,0,0,1,1
10735,ಕೃತ್ಯವನ್ನು,0,0,1,1
10755,ತುದಿ,0,0,1,1
10737,besøge,0,0,1,1
10738,कोवेन,0,0,1,1
10740,« repose,0,0,1,1
10741,rejeitando,0,0,1,1
10742,റൊട്ടിയുമായി,0,0,1,1
10743,بالو,0,0,1,1
10744,satan,0,0,1,1
10745,deixar,0,0,1,1
10746,sende,0,0,1,1
10747,جادًا,0,0,1,1
10748,возьму,0,0,1,1
10749,tabulated,0,0,1,1
10752,التفاصيل,0,0,1,1
10753,outliers,0,0,1,1
10754,अपरंपरागत,0,0,1,1
10900,ಚೀರ್ಸ್,0,0,1,1
10901,mentally,0,0,1,1
10903,ഉപ്പ്,0,0,1,1
11067,enverrai,0,0,1,1
11054,செல்லத்,0,0,1,1
11056,dirigeerden,0,0,1,1
11059,aprèsmidi,0,0,1,1
11061,arka,0,0,1,1
11062,desacuerdo,0,0,1,1
11063,പ്രണേതാവായ,0,0,1,1
11066,बाहरी,0,0,1,1
11068,subdomínio,0,0,1,1
11012,മേഖലകളിൽ,0,0,1,1
11069,motsätter,0,0,1,1
11070,доктриной,0,0,1,1
11071,förväntas,0,0,1,1
11074,ശ്രദ്ധിക്കുന്നു,0,0,1,1
11076,outre,0,0,1,1
11078,bezoeker,0,0,1,1
11079,كفعل,0,0,1,1
11053,ignores,0,0,1,1
11047,സംവിധാനം,0,0,1,1
11046,kaputt,0,0,1,1
11043,придется,0,0,1,1
11014,göz,0,0,1,1
11021,rothenburg,0,0,1,1
11023,सियोल,0,0,1,1
11024,collaborateurs,0,0,1,1
11025,deliberate,0,0,1,1
11026,entré,0,0,1,1
11027,страх,0,0,1,1
11029,புன்னகைக்கிறாள்,0,0,1,1
11030,песнях,0,0,1,1
11034,കുഴപ്പത്തിലാണ്,0,0,1,1
11035,обоих,0,0,1,1
11036,пошли,0,0,1,1
11037,специальных,0,0,1,1
11039,oppose,0,0,1,1
11042,നല്ലവരായിരുന്നു,0,0,1,1
11080,« rapide »,0,0,1,1
11086,clásica,0,0,1,1
11090,kızınızın,0,0,1,1
11119,surpreendentemente,0,0,1,1
11121,മാംസം,0,0,1,1
11122,интересное,0,0,1,1
11125,confirming,0,0,1,1
11126,faitesmoi,0,0,1,1
11128,overalt,0,0,1,1
11129,subversivos,0,0,1,1
11130,எதிரான,0,0,1,1
11131,apparent,0,0,1,1
11133,новостей,0,0,1,1
11134,ವಹಿಸಿ,0,0,1,1
11135,इंडीपेनडेंस,0,0,1,1
11136,beleidigend,0,0,1,1
11137,പാർട്ടിപ്രവർത്തകൻ,0,0,1,1
11138,dérangetil,0,0,1,1
11140,चेहरे,0,0,1,1
11120,தரங்கள்,0,0,1,1
11118,ജോലിഭാരം,0,0,1,1
11091,угрожают,0,0,1,1
11117,nuitlà,0,0,1,1
11092,σύνδεσμο,0,0,1,1
11093,tidsperiod,0,0,1,1
11099,сводятся,0,0,1,1
11100,использовал,0,0,1,1
11102,моих,0,0,1,1
11103,üzgün,0,0,1,1
11104,reaches,0,0,1,1
11105,тону,0,0,1,1
11106,അറിയപ്പെട്ടിരുന്നെങ്കിലും,0,0,1,1
11107,máster,0,0,1,1
11109,अमृत,0,0,1,1
11110,reputação,0,0,1,1
11111,الكتابة,0,0,1,1
11112,primære,0,0,1,1
11116,noticeable,0,0,1,1
11013,سطح,0,0,1,1
11010,imputáveis,0,0,1,1
10904,بحجب,0,0,1,1
10940,admiração,0,0,1,1
10931,appareils,0,0,1,1
10932,வெளியேறுகிறேன்,0,0,1,1
10933,hilsner,0,0,1,1
10936,uncovered,0,0,1,1
10937,вашингтоне,0,0,1,1
10938,baktığım,0,0,1,1
10939,zware,0,0,1,1
10943,تدوين,0,0,1,1
11009,neuesten,0,0,1,1
10944,மார்ச்,0,0,1,1
10945,wereld,0,0,1,1
10946,discutido,0,0,1,1
10948,engouement,0,0,1,1
10949,للقلق,0,0,1,1
10951,உசாத்துணைப்,0,0,1,1
10952,إتش,0,0,1,1
10930,negotiating,0,0,1,1
10929,aceito,0,0,1,1
10927,hemlighet,0,0,1,1
10925,ícono,0,0,1,1
10905,adapted,0,0,1,1
10906,ചിയേഴ്സ്,0,0,1,1
10907,وتحريك,0,0,1,1
10908,torne,0,0,1,1
10909,επαφή,0,0,1,1
10910,unevenness,0,0,1,1
10912,‘வழங்கி’யில்,0,0,1,1
10914,amplo,0,0,1,1
10915,zaken,0,0,1,1
10916,okuyorum,0,0,1,1
10917,देन,0,0,1,1
10920,അഭിപ്രായമില്ല,0,0,1,1
10921,touristique,0,0,1,1
10923,ഇമെയിലിൽ,0,0,1,1
10924,ಕಾರ್ಯಯೋಜನೆಗಳಿವೆ,0,0,1,1
10956,hemsk,0,0,1,1
10959,iddia,0,0,1,1
10960,saisies,0,0,1,1
10985,παρέα,0,0,1,1
10987,überstrapaziertes,0,0,1,1
10988,التكنولوجيا,0,0,1,1
10990,تسويته,0,0,1,1
10991,अभियोगपत्र,0,0,1,1
10994,സാഹചര്യത്തിലായിരിക്കുക,0,0,1,1
10997,arriba,0,0,1,1
10998,dormindo,0,0,1,1
10999,പെരുമാറ്റവും,0,0,1,1
11000,amper,0,0,1,1
11001,مكالمة,0,0,1,1
11003,объясните,0,0,1,1
11004,طرق,0,0,1,1
11005,yapmanı,0,0,1,1
11006,bajada,0,0,1,1
11007,persönlich,0,0,1,1
10986,fornøjelse,0,0,1,1
10983,movida,0,0,1,1
10962,sönder,0,0,1,1
10982,മലയാളീകരണമാണ്,0,0,1,1
10963,προσφορά,0,0,1,1
10964,στρατεύματα,0,0,1,1
10966,காரணம்,0,0,1,1
10969,weinst,0,0,1,1
10970,fundaram,0,0,1,1
10971,yapılmıştır,0,0,1,1
10972,klaar,0,0,1,1
10974,colonisés,0,0,1,1
10975,regulate,0,0,1,1
10976,صرح,0,0,1,1
10977,répondu,0,0,1,1
10978,detuvo,0,0,1,1
10979,leg,0,0,1,1
10980,усилия,0,0,1,1
10981,partide,0,0,1,1
13550,китайских,0,0,1,1
13552,stykker,0,0,1,1
13553,vann,0,0,1,1
16165,forecasting,0,0,1,1
16157,अर्थव्यवस्था,0,0,1,1
16158,operates,0,0,1,1
16159,கேள்வியைக்,0,0,1,1
16160,lösta,0,0,1,1
16161,hearing,0,0,1,1
16162,إمتاعًا,0,0,1,1
16163,αυτής,0,0,1,1
16167,testées,0,0,1,1
16181,لكني,0,0,1,1
16168,രസകരമാണ്,0,0,1,1
16171,നിർത്തുക,0,0,1,1
16172,primaria»​,0,0,1,1
16176,ஆக்கங்கள்,0,0,1,1
16177,فيوجد,0,0,1,1
16178,வருகின்றது,0,0,1,1
16179,nãousuários,0,0,1,1
16154,estratégia,0,0,1,1
16152,polysémie,0,0,1,1
16151,κρέας,0,0,1,1
16150,capítulos,0,0,1,1
16126,கட்டுரையை,0,0,1,1
16127,olanak,0,0,1,1
16128,ಕುಳಿತಿದ್ದಾರೆ,0,0,1,1
16131,leída,0,0,1,1
16134,зайдите,0,0,1,1
16135,новости,0,0,1,1
16136,tombé,0,0,1,1
16137,plazo,0,0,1,1
16140,sprogversion,0,0,1,1
16141,κάποτε,0,0,1,1
16142,gale,0,0,1,1
16143,انتهي,0,0,1,1
16145,självmord,0,0,1,1
16148,blikken,0,0,1,1
16149,ശ്രമിക്കുകയായിരുന്നു,0,0,1,1
16180,ethvert,0,0,1,1
16182,उतने,0,0,1,1
16242,türetilmiştir,0,0,1,1
16223,ஆழமாக,0,0,1,1
16212,doğrudan,0,0,1,1
16215,चले,0,0,1,1
16216,removido,0,0,1,1
16217,sidst,0,0,1,1
16219,onzichtbaar,0,0,1,1
16220,μήνες,0,0,1,1
16222,regresión,0,0,1,1
16224,gebrek,0,0,1,1
16183,வழிமுறைகள்,0,0,1,1
16226,synergies,0,0,1,1
16227,drunknar,0,0,1,1
16228,“border,0,0,1,1
16229,المتزايد,0,0,1,1
16231,تكميلي,0,0,1,1
16234,rattraper,0,0,1,1
16238,иллинойс,0,0,1,1
16211,آمل,0,0,1,1
16209,ऊपरी,0,0,1,1
16206,jenny,0,0,1,1
16205,फ्लुमोक्स,0,0,1,1
16184,espagnol,0,0,1,1
16185,смущенной,0,0,1,1
16186,atmosphère,0,0,1,1
16187,fédérales,0,0,1,1
16188,bat,0,0,1,1
16192,humor,0,0,1,1
16194,seem,0,0,1,1
16195,பதிப்பொன்றை,0,0,1,1
16196,konuşalım,0,0,1,1
16197,historiska,0,0,1,1
16199,تحته,0,0,1,1
16201,множественного,0,0,1,1
16202,teaching,0,0,1,1
16203,சொல்கிறது,0,0,1,1
16204,platenhoes,0,0,1,1
16125,συγκεντρώνονται,0,0,1,1
16123,expérimentation,0,0,1,1
16122,plug,0,0,1,1
16045,വിശേഷം,0,0,1,1
16035,iyiyim,0,0,1,1
16036,कैसी,0,0,1,1
16037,ರುಚಿಯ,0,0,1,1
16040,citado,0,0,1,1
16041,الخلافات,0,0,1,1
16042,अभिनय,0,0,1,1
16044,இன்றுவரை,0,0,1,1
16047,irse,0,0,1,1
16121,rejettent,0,0,1,1
16048,« naturelle »,0,0,1,1
16049,adorerais,0,0,1,1
16051,asian,0,0,1,1
16052,ചിന്തിക്കുകയായിരുന്നു,0,0,1,1
16053,копии,0,0,1,1
16054,alcanzó,0,0,1,1
16055,yokmuş,0,0,1,1
16034,சம்பிரதாயத்துக்காக,0,0,1,1
16033,bureaukrater,0,0,1,1
16032,ಕಾಣಲು,0,0,1,1
16031,разговаривали,0,0,1,1
16005,onionspotatoes,0,0,1,1
16007,dão,0,0,1,1
16008,применялись,0,0,1,1
16010,nuttige,0,0,1,1
16014,"
सुन्दा",0,0,1,1
16015,arkadaşların,0,0,1,1
16016,franskspråkiga,0,0,1,1
16018,başta,0,0,1,1
16019,fonctionnement ,0,0,1,1
16021,समाविष्टि,0,0,1,1
16023,உரைக்கு,0,0,1,1
16024,السيبوانية,0,0,1,1
16025,έφυγε,0,0,1,1
16026,أخت,0,0,1,1
16029,redactores,0,0,1,1
16056,mandarei,0,0,1,1
16057,كلهم,0,0,1,1
16058,культурных,0,0,1,1
16086,« six,0,0,1,1
16091,ದೀರ್ಘಕಾಲದವರೆಗೆ,0,0,1,1
16092,колонке,0,0,1,1
16093,schönen,0,0,1,1
16094,inquiétude,0,0,1,1
16095,rusa,0,0,1,1
16098,tıklanan,0,0,1,1
16100,αγγλικές,0,0,1,1
16101,البيروقراطيون،,0,0,1,1
16107,schloss,0,0,1,1
16109,distribuida,0,0,1,1
16110,bilgiyi,0,0,1,1
16111,произошло,0,0,1,1
16114,aclamados,0,0,1,1
16116,കാണപ്പെട്ടു,0,0,1,1
16119,«энциклопедия»,0,0,1,1
16090,proving,0,0,1,1
16085,sange,0,0,1,1
16059,tercümesi,0,0,1,1
16084,வந்து,0,0,1,1
16060,एसएमएस,0,0,1,1
16061,συνεχίσει,0,0,1,1
16063,adequação,0,0,1,1
16064,रोजेनजवीग,0,0,1,1
16066,acknowledged,0,0,1,1
16067,الفساتين,0,0,1,1
16068,وفَر,0,0,1,1
16069,எல்லி,0,0,1,1
16070,yarayacağını,0,0,1,1
16071,മനുഷ്യനിർമിതമായ,0,0,1,1
16072,implementeringen,0,0,1,1
16073,അതിശയിപ്പിച്ചു,0,0,1,1
16081,merged,0,0,1,1
16082,declínio,0,0,1,1
16083,നിയന്ത്രിക്കപ്പെട്ടിരിക്കുന്നു,0,0,1,1
16240,إيقافك,0,0,1,1
16243,صحتك,0,0,1,1
16458,iyisin,0,0,1,1
16390,ನಮ್ಮೊಂದಿಗೆ,0,0,1,1
16383,अच्छा।,0,0,1,1
16384,ഇടമില്ലെന്ന്,0,0,1,1
16385,जानता,0,0,1,1
16386,ಇದ್ದವು,0,0,1,1
16387,vindos,0,0,1,1
16388,συστηματική,0,0,1,1
16389,aplicadas,0,0,1,1
16392,indirilmesi,0,0,1,1
16403,gülmeye,0,0,1,1
16394,gösterenlerin,0,0,1,1
16395,ediyorlarmış,0,0,1,1
16396,homo,0,0,1,1
16397,kontorskonto,0,0,1,1
16398,d’avoir,0,0,1,1
16399,hänvisning,0,0,1,1
16400,produzida,0,0,1,1
16382,sudden,0,0,1,1
16381,ಜನರು,0,0,1,1
16380,normalden,0,0,1,1
16379,கற்றுக்கொண்டோம்,0,0,1,1
16358,webbgränssnitt,0,0,1,1
16360,வரும்,0,0,1,1
16363,приглашения,0,0,1,1
16364,الفظيعة,0,0,1,1
16365,mümkün,0,0,1,1
16366,compensations,0,0,1,1
16367,കൂടെ,0,0,1,1
16369,"
योरूबा",0,0,1,1
16370,"
मालागासे",0,0,1,1
16372,politikalarından,0,0,1,1
16373,twenty,0,0,1,1
16374,ಸಲಹೆಗಳು,0,0,1,1
16375,ಕ್ರಿಯಾಪದವು,0,0,1,1
16377,binary,0,0,1,1
16378,സാഹചര്യമാണ്,0,0,1,1
16402,मांसके,0,0,1,1
16405,данному,0,0,1,1
16244,hiérarchisation,0,0,1,1
16444,योगदानकर्ताज्ञान,0,0,1,1
16435,προετοιμαζόμουν,0,0,1,1
16436,afi,0,0,1,1
16437,суток,0,0,1,1
16439,விலங்கு,0,0,1,1
16440,battleground,0,0,1,1
16441,grob,0,0,1,1
16443,angebot,0,0,1,1
16446,exemples ,0,0,1,1
16406,semiautomaticamente,0,0,1,1
16447,المصروفات,0,0,1,1
16448,قريب,0,0,1,1
16451,ζητά,0,0,1,1
16452,لتبدو,0,0,1,1
16453,grippe,0,0,1,1
16454,أحمر,0,0,1,1
16455,hadn,0,0,1,1
16434,உதவிகரமாக,0,0,1,1
16433,yazdıklarını,0,0,1,1
16432,ആഗ്രഹിച്ചില്ല,0,0,1,1
16431,связаны,0,0,1,1
16408,jesucristo,0,0,1,1
16409,hemmeligt,0,0,1,1
16411,весь,0,0,1,1
16412,حر،,0,0,1,1
16413,"
रूसी",0,0,1,1
16415,മെസഞ്ചർ,0,0,1,1
16416,الوصف,0,0,1,1
16418,bekämpar,0,0,1,1
16420,خادم,0,0,1,1
16421,sabrosa,0,0,1,1
16422,ഭാഗ്യവാൻ,0,0,1,1
16425,வா,0,0,1,1
16426,touristiques,0,0,1,1
16427,സാഹചര്യത്തെ,0,0,1,1
16430,retorting,0,0,1,1
16356,høflig,0,0,1,1
16355,traduire,0,0,1,1
16354,beats,0,0,1,1
16285,schatz,0,0,1,1
16273,പോകാമെന്ന്,0,0,1,1
16274,händelser,0,0,1,1
16278,المهمة,0,0,1,1
16279,отрицательной,0,0,1,1
16280,ಬಳಸುತ್ತಿತ್ತು,0,0,1,1
16282,empregam,0,0,1,1
16284,aussicht,0,0,1,1
16286,ಕಾರ್ಯನಿರ್ವಹಿಸುತ್ತಿದ್ದರೆ,0,0,1,1
16349,παντρευτώ,0,0,1,1
16287,angives,0,0,1,1
16288,informó,0,0,1,1
16289,للباحثين,0,0,1,1
16290,أتمنى,0,0,1,1
16292,necessity,0,0,1,1
16294,отличная,0,0,1,1
16297,ответами,0,0,1,1
16272,популярный,0,0,1,1
16270,dumpen,0,0,1,1
16269,architecture,0,0,1,1
16268,تنافسية,0,0,1,1
16245,"
तुर्कमैनी",0,0,1,1
16246,kino,0,0,1,1
16247,ധർമ്മസങ്കടമുള്ള,0,0,1,1
16249,الطبيعية,0,0,1,1
16250,betroffen,0,0,1,1
16251,ditesleur,0,0,1,1
16253,internetanvändarna,0,0,1,1
16254,редактироваться,0,0,1,1
16255,psychologie,0,0,1,1
16256,ലോസ്സ്,0,0,1,1
16258,persondatorer,0,0,1,1
16259,angebote,0,0,1,1
16260,gathered,0,0,1,1
16261,groeien,0,0,1,1
16262,etki,0,0,1,1
16299,múnich,0,0,1,1
16301,الساعة,0,0,1,1
16302,بوت,0,0,1,1
16325,esclarecido,0,0,1,1
16330,loved,0,0,1,1
16332,séquences,0,0,1,1
16333,мороженого,0,0,1,1
16336,fontenelle,0,0,1,1
16337,industrielles,0,0,1,1
16338,διαμάντια,0,0,1,1
16339,procedures,0,0,1,1
16340,ಹಾಕುತ್ತಿದ್ದೇನೆ,0,0,1,1
16341,لتعانق,0,0,1,1
16342,gebruikelijke,0,0,1,1
16343,വ്യാമോഹിതനാണ്,0,0,1,1
16344,gerçekleşmez,0,0,1,1
16345,ആർക്കെങ്കിലും,0,0,1,1
16346,"हों।
इन",0,0,1,1
16347,सेवानिवृत्त,0,0,1,1
16327,humanities,0,0,1,1
16324,editem,0,0,1,1
16304,للتغيير,0,0,1,1
16323,εγκυκλοπαίδεια»,0,0,1,1
16305,ஒருவராக,0,0,1,1
16306,करेगी।,0,0,1,1
16307,ущербной,0,0,1,1
16308,hänvisningar,0,0,1,1
16309,employée,0,0,1,1
16310,اثنا,0,0,1,1
16312,கேள்விகளில்,0,0,1,1
16313,அவற்றில்,0,0,1,1
16315,மின்னஞ்சலில்,0,0,1,1
16316,работ,0,0,1,1
16317,erger,0,0,1,1
16318,болота,0,0,1,1
16319,frightening,0,0,1,1
16320,чьи,0,0,1,1
16321,дэвидом,0,0,1,1
16004,ligar,0,0,1,1
16002,существовало,0,0,1,1
16001,önceki,0,0,1,1
15682,εξασκηθείτε,0,0,1,1
15674,ämne,0,0,1,1
15675,certainty,0,0,1,1
15676,पिज्जा,0,0,1,1
15677,मैक्स,0,0,1,1
15678,—usemod—,0,0,1,1
15679,maldonado​,0,0,1,1
15681,അതിശക്തമായ,0,0,1,1
15683,आलोचना,0,0,1,1
15698,goto,0,0,1,1
15685,எழுந்தேன்,0,0,1,1
15687,motivation,0,0,1,1
15688,العلوم في,0,0,1,1
15689,ഉദാഹരണം,0,0,1,1
15692,écoute,0,0,1,1
15694,सुव्यवस्थित,0,0,1,1
15695,resumos,0,0,1,1
15673,ஒப்புக்கொள்கிறேன்,0,0,1,1
15671,dilemmasmartwörter,0,0,1,1
15668,dyka,0,0,1,1
15667,خوارزميات,0,0,1,1
15647,definitivt,0,0,1,1
15649,ervaring,0,0,1,1
15650,steigern,0,0,1,1
15651,grecque,0,0,1,1
15652,voelt,0,0,1,1
15654,beğeneceğinizi,0,0,1,1
15655,entendement,0,0,1,1
15658,കൊടുങ്കാറ്റ്,0,0,1,1
15659,собственностинеавторитетный,0,0,1,1
15660,വിവേകം,0,0,1,1
15661,uiteindelijk,0,0,1,1
15662,perceber,0,0,1,1
15663,بحذف,0,0,1,1
15664,konuşuyordun,0,0,1,1
15666,голосованиях,0,0,1,1
15697,romantic,0,0,1,1
15703,financée,0,0,1,1
16000,அவனுடைய,0,0,1,1
15748,μάλλον,0,0,1,1
15736,infrecuentes,0,0,1,1
15737,ускорить,0,0,1,1
15738,женщина,0,0,1,1
15739,ലഭിക്കുമ്പോൾ,0,0,1,1
15741,تتطلب,0,0,1,1
15746,skribenterna,0,0,1,1
15747,शो,0,0,1,1
15749,ممل,0,0,1,1
15704,karakter,0,0,1,1
15751,общим,0,0,1,1
15752,kanıdır,0,0,1,1
15754,шутишь,0,0,1,1
15755,avancement,0,0,1,1
15756,вручении,0,0,1,1
15757,restées,0,0,1,1
15759,لمنتدى,0,0,1,1
15734,வழியாக,0,0,1,1
15733,nuire,0,0,1,1
15730,comprobado,0,0,1,1
15728,والمناقشات,0,0,1,1
15706,அங்குள்ள,0,0,1,1
15707,négatif,0,0,1,1
15708,εκπληκτικά,0,0,1,1
15710,novatos,0,0,1,1
15712,narcissemamma,0,0,1,1
15714,आयोजन,0,0,1,1
15715,sacralisation,0,0,1,1
15716,wiederholt,0,0,1,1
15718,hongrois,0,0,1,1
15721,galardones,0,0,1,1
15722,свойственна,0,0,1,1
15723,resultaram,0,0,1,1
15725,അർത്ഥമില്ലാത്ത,0,0,1,1
15726,जेल,0,0,1,1
15727,predesignated,0,0,1,1
15646,ചിലതിന്,0,0,1,1
15645,ജനനം,0,0,1,1
15643,κορυφαίες,0,0,1,1
15568,ದಿನನಿತ್ಯದ,0,0,1,1
15556,американская,0,0,1,1
15557,ಚತುರನಾಗಿದ್ದನು,0,0,1,1
15560,நர்சிசாவின்,0,0,1,1
15563,nuttig,0,0,1,1
15564,تقوم,0,0,1,1
15566,bedömas,0,0,1,1
15567,കണ്ടതുമുതൽ,0,0,1,1
15569,വന്നത്,0,0,1,1
15641,«человеком,0,0,1,1
15572,mirada,0,0,1,1
15573,الغربية,0,0,1,1
15574,faller,0,0,1,1
15576,كم,0,0,1,1
15578,amené,0,0,1,1
15579,underutilized,0,0,1,1
15580,ناه,0,0,1,1
15555,tillit,0,0,1,1
15552,blockera,0,0,1,1
15551,provavelmente,0,0,1,1
15550,полная,0,0,1,1
15535,улыбнуться,0,0,1,1
15536,ನೋಡಿ,0,0,1,1
15537,quartal,0,0,1,1
15538,almalıyız,0,0,1,1
15539,splits,0,0,1,1
15540,irão,0,0,1,1
15541,हिन्दी,0,0,1,1
15542,forem,0,0,1,1
15543,mencionarse,0,0,1,1
15544,zoos,0,0,1,1
15545,ആചരിക്കുന്നു,0,0,1,1
15546,вверх,0,0,1,1
15547,கிராமத்தில்,0,0,1,1
15548,personnels,0,0,1,1
15549,humanisme,0,0,1,1
15582,nordpertinence,0,0,1,1
15583,approved,0,0,1,1
15584,ей,0,0,1,1
15614,പങ്കുവയ്ക്കുന്നു,0,0,1,1
15617,«votaciones»,0,0,1,1
15618,administrateur,0,0,1,1
15619,حيرة,0,0,1,1
15622,burger,0,0,1,1
15623,करूं,0,0,1,1
15625,importantly—it,0,0,1,1
15626,blijven,0,0,1,1
15627,censored,0,0,1,1
15628,അമ്മയല്ലേ,0,0,1,1
15629,ரிச்சர்ட்,0,0,1,1
15631,commercialisé,0,0,1,1
15632,relatados,0,0,1,1
15636,സംസാരിക്കുന്നത്,0,0,1,1
15637,alamaz,0,0,1,1
15640,permanently,0,0,1,1
15616,डॉइशलैंड,0,0,1,1
15613,അവയിൽ‌,0,0,1,1
15586,coexistiram,0,0,1,1
15612,खिलाते,0,0,1,1
15587,встречаетесь,0,0,1,1
15588,coola,0,0,1,1
15589,wikimedia…,0,0,1,1
15592,വിഷമിക്കുന്നുവെന്നും,0,0,1,1
15593,istemeyeceğini,0,0,1,1
15594,λατρεύω,0,0,1,1
15596,élément,0,0,1,1
15597,arıyorsanız,0,0,1,1
15599,ഉപയോഗിക്കാവുന്ന,0,0,1,1
15603,ഭൗതികപ്രപഞ്ചത്തെ,0,0,1,1
15604,traîner,0,0,1,1
15605,للموارد,0,0,1,1
15609,amsterdã,0,0,1,1
15610,developers,0,0,1,1
15611,persian,0,0,1,1
15760,ಕರೆಯಲು,0,0,1,1
15761,réussir,0,0,1,1
15764,गाँव,0,0,1,1
15927,onions,0,0,1,1
15916,slutgiltig,0,0,1,1
15918,дочери,0,0,1,1
15920,anexadas,0,0,1,1
15921,suriname,0,0,1,1
15924,doel,0,0,1,1
15925,χρήσιμο,0,0,1,1
15926,llegaste,0,0,1,1
15929,áustria,0,0,1,1
15887,historiens »,0,0,1,1
15931,उत्साहित,0,0,1,1
15932,блестящие,0,0,1,1
15933,продолжите,0,0,1,1
15936,disseram,0,0,1,1
15938,തെളിവുകൾ,0,0,1,1
15939,догадаются,0,0,1,1
15941,commentary,0,0,1,1
15913,unavailability,0,0,1,1
15912,bringe,0,0,1,1
15909,wann,0,0,1,1
15908,تنسيق,0,0,1,1
15890,jenna,0,0,1,1
15892,columnist,0,0,1,1
15893,cardon,0,0,1,1
15894,studded,0,0,1,1
15895,है।कनाडा,0,0,1,1
15896,croyait,0,0,1,1
15897,மொழியில்,0,0,1,1
15898,feelings,0,0,1,1
15899,കേരള,0,0,1,1
15900,sacred,0,0,1,1
15901,قدم,0,0,1,1
15903,déconcertée,0,0,1,1
15904,எனப்,0,0,1,1
15905,சொல்,0,0,1,1
15906,uğraşısı,0,0,1,1
15942,çocuklar,0,0,1,1
15943,forneça,0,0,1,1
15944,иметься,0,0,1,1
15975,авторитетные,0,0,1,1
15978,transcendentalist,0,0,1,1
15979,esenciales,0,0,1,1
15981,lucir,0,0,1,1
15982,பின்னரே,0,0,1,1
15983,الآخرين،,0,0,1,1
15985,instancia,0,0,1,1
15988,فكل,0,0,1,1
15989,θυμάστε,0,0,1,1
15990,hawaii,0,0,1,1
15991,fniser,0,0,1,1
15992,வாக்கியங்களை,0,0,1,1
15993,uddybende,0,0,1,1
15994,παντρεμένοι,0,0,1,1
15996,primair,0,0,1,1
15999,düğme,0,0,1,1
15977,قال,0,0,1,1
15974,hatam,0,0,1,1
15950,oriente,0,0,1,1
15973,благодарю,0,0,1,1
15951,zim,0,0,1,1
15952,suprême,0,0,1,1
15953,immuables ,0,0,1,1
15954,vriendin,0,0,1,1
15957,अभियान,0,0,1,1
15958,தகவல்,0,0,1,1
15959,gelmesi,0,0,1,1
15960,gönderdin,0,0,1,1
15962,prejuicios,0,0,1,1
15963,amerikalılar,0,0,1,1
15964,ಕೂಡಿದೆ,0,0,1,1
15966,നല്കിയിരിക്കുന്നു,0,0,1,1
15968,பயமாக,0,0,1,1
15969,ಮಾಡಿದ್ದೀರಿ,0,0,1,1
15971,основатели,0,0,1,1
15889,lyckas,0,0,1,1
15885,øje,0,0,1,1
15765,matérielle,0,0,1,1
15808,göreceksiniz,0,0,1,1
15798,profits,0,0,1,1
15799,arıyoruz,0,0,1,1
15801,balcon,0,0,1,1
15802,taliban,0,0,1,1
15803,innehållsdrivet,0,0,1,1
15804,റഷ്യൻ,0,0,1,1
15806,oprichtte,0,0,1,1
15809,தூண்டுதலால்,0,0,1,1
15884,basura,0,0,1,1
15814,exclusively,0,0,1,1
15815,ಸ್ಲಗ್,0,0,1,1
15821,etmeden,0,0,1,1
15822,ideological,0,0,1,1
15823,instantly,0,0,1,1
15824,événements,0,0,1,1
15825,philosophe,0,0,1,1
15796,barnstars,0,0,1,1
15795,rangeret,0,0,1,1
15793,سيئًا,0,0,1,1
15790,contribuiu,0,0,1,1
15766,καθοριστεί,0,0,1,1
15767,natten,0,0,1,1
15768,idéalement,0,0,1,1
15770,والمتغيرات,0,0,1,1
15772,participer »,0,0,1,1
15777,censurerar,0,0,1,1
15778,enfants,0,0,1,1
15779,incorporates,0,0,1,1
15781,ಹಾಳುಮಾಡಿದೆ,0,0,1,1
15782,культура,0,0,1,1
15785,norteamericana,0,0,1,1
15786,skepsis,0,0,1,1
15787,сказано,0,0,1,1
15788,ca,0,0,1,1
15789,notoriedade,0,0,1,1
15826,champion,0,0,1,1
15827,ಗೊತ್ತು,0,0,1,1
15828,ಬೆಳ್ಳಿಯನ್ನು,0,0,1,1
15860,prejudices,0,0,1,1
15864,ചെയ്യാത്തത്,0,0,1,1
15865,asien,0,0,1,1
15866,dussintal,0,0,1,1
15867,litteratur,0,0,1,1
15869,ജില്ലയെച്ചൊല്ലി,0,0,1,1
15870,പിറക്കുന്നു,0,0,1,1
15871,പ്രവേശിച്ചുവെങ്കിൽ,0,0,1,1
15873,stilzwijgend,0,0,1,1
15874,സ്റ്റഫ്,0,0,1,1
15875,ಹಾಕಿದರೆ,0,0,1,1
15876,αυξήθηκε,0,0,1,1
15877,അമർത്തി,0,0,1,1
15878,എത്തി,0,0,1,1
15881,ödevlerle,0,0,1,1
15882,groepsverstand,0,0,1,1
15863,نيويورك،,0,0,1,1
15859,etikettregler,0,0,1,1
15832,النص,0,0,1,1
15858,fodre,0,0,1,1
15833,förhållande,0,0,1,1
15834,elmaslarla,0,0,1,1
15836,magisches,0,0,1,1
15837,صعوبة,0,0,1,1
15842,утверждения,0,0,1,1
15843,absorbing,0,0,1,1
15844,κοινά,0,0,1,1
15845,разведывательного,0,0,1,1
15846,realized,0,0,1,1
15847,policydrivet,0,0,1,1
15850,löst,0,0,1,1
15853,sayfada,0,0,1,1
15854,handle,0,0,1,1
15855,взаимодействию,0,0,1,1
15857,fusion,0,0,1,1
16457,“controlada”,0,0,1,1
16460,medelåldern,0,0,1,1
15532,filho,0,0,1,1
17083,vikipediler,0,0,1,1
17074,നീങ്ങുക,0,0,1,1
17076,ausgewogenen,0,0,1,1
17077,المضللة,0,0,1,1
17079,zurückkommen,0,0,1,1
17080,صوت,0,0,1,1
17081,pronoun,0,0,1,1
17082,ertrage,0,0,1,1
17084,kommentarsfält,0,0,1,1
17098,ಅಮೆರಿಕಾದಲ್ಲಿ,0,0,1,1
17085,турист,0,0,1,1
17086,दर्जे,0,0,1,1
17089,cargo,0,0,1,1
17092,recherchons,0,0,1,1
17093,mitigate,0,0,1,1
17094,ಪುನರಾರಂಭಿಸಿ,0,0,1,1
17095,البريد,0,0,1,1
17073,बड़ी,0,0,1,1
17072,yapıldığı,0,0,1,1
17071,fitting,0,0,1,1
17070,esforços,0,0,1,1
17042,இலகுவில்,0,0,1,1
17043,diverged,0,0,1,1
17045,criarlos,0,0,1,1
17046,حساء,0,0,1,1
17048,mahvettim,0,0,1,1
17054,تحسَن,0,0,1,1
17055,şimdiye,0,0,1,1
17057,spectroscopy,0,0,1,1
17058,colocan,0,0,1,1
17059,malintencionadas,0,0,1,1
17060,وتركز,0,0,1,1
17063,istemezdim,0,0,1,1
17064,அளவுத்திட்டத்துக்கு,0,0,1,1
17068,außergewöhnlich,0,0,1,1
17069,surveillés,0,0,1,1
17097,исходным,0,0,1,1
17104,ಇನ್ನಷ್ಟು,0,0,1,1
17172,categoría,0,0,1,1
17156,politically,0,0,1,1
17146,filtreringen,0,0,1,1
17149,olman,0,0,1,1
17150,എന്താണെന്ന്,0,0,1,1
17151,повторила,0,0,1,1
17152,gekleidet,0,0,1,1
17153,interativas,0,0,1,1
17154,ಉತ್ತಮಗೊಳಿಸುವುದು,0,0,1,1
17158,жёстких,0,0,1,1
17105,ينشئا,0,0,1,1
17159,المجانية,0,0,1,1
17162,politely,0,0,1,1
17163,wiknic,0,0,1,1
17165,biologists,0,0,1,1
17166,mandou,0,0,1,1
17167,equilibrado,0,0,1,1
17169,വണ്ടി,0,0,1,1
17145,imite,0,0,1,1
17144,ದಾಳಿಕೋರರು,0,0,1,1
17143,ಲೈಕ್,0,0,1,1
17140,ನಿಮಿಷದಲ್ಲಿ,0,0,1,1
17106,करेगा।,0,0,1,1
17107,article—have,0,0,1,1
17108,സങ്കീർണ്ണത,0,0,1,1
17109,المجال,0,0,1,1
17111,написан,0,0,1,1
17117,wikiprocedurerne,0,0,1,1
17118,conocer,0,0,1,1
17123,αγαπητοί,0,0,1,1
17124,βικιθήκη,0,0,1,1
17127,நடுநிலைமையை,0,0,1,1
17131,izquierdista,0,0,1,1
17133,geomagnetic,0,0,1,1
17134,കാണാത്ത,0,0,1,1
17136,ചെയ്തിട്ടില്ല,0,0,1,1
17138,بغض,0,0,1,1
17041,inclut,0,0,1,1
17040,eliminando,0,0,1,1
17039,ಅದ್ಭುತವಾಗಿದ್ದೀರಿ,0,0,1,1
16981,mauvaise,0,0,1,1
16972,migration,0,0,1,1
16974,kaynaklarla,0,0,1,1
16975,поздравления,0,0,1,1
16976,παραπονεθεί,0,0,1,1
16977,sammanfattas,0,0,1,1
16978,ചർച്ചകളും,0,0,1,1
16980,الإداريين,0,0,1,1
16982,rattachée,0,0,1,1
17038,كيو,0,0,1,1
16983,abordé,0,0,1,1
16984,évaluant,0,0,1,1
16985,någonstans,0,0,1,1
16986,ترفض,0,0,1,1
16987,ಪ್ರವಾಸವನ್ನು,0,0,1,1
16988,आइसक्रीम,0,0,1,1
16989,atlamamın,0,0,1,1
16971,الفيضان,0,0,1,1
16969,επιλογές,0,0,1,1
16968,latijn,0,0,1,1
16966,പ്രമുഖ,0,0,1,1
16944,रचना,0,0,1,1
16945,mängd,0,0,1,1
16946,dormait,0,0,1,1
16950,excesivo,0,0,1,1
16951,ρωτήθηκε,0,0,1,1
16952,الظروف,0,0,1,1
16954,paleis,0,0,1,1
16955,newsletters,0,0,1,1
16956,செய்திகள்,0,0,1,1
16957,மன்னிப்பு,0,0,1,1
16960,शराबी,0,0,1,1
16961,تتجاهل,0,0,1,1
16962,llevan,0,0,1,1
16963,castillo,0,0,1,1
16965,economische,0,0,1,1
16991,« caractère,0,0,1,1
16993,conference,0,0,1,1
16994,soğuk,0,0,1,1
17017,التفرد,0,0,1,1
17019,очевидной,0,0,1,1
17020,مقصود,0,0,1,1
17022,യാത്രയെക്കുറിച്ചോ,0,0,1,1
17024,असत्यापित,0,0,1,1
17025,conterem,0,0,1,1
17026,trädgård,0,0,1,1
17027,kultiverad,0,0,1,1
17028,construite,0,0,1,1
17029,المتطوعين،,0,0,1,1
17031,التالية,0,0,1,1
17032,ചെയ്തിട്ടില്ലെങ്കിൽ,0,0,1,1
17033,சதுப்புநிலமானது,0,0,1,1
17034,connaissezvous,0,0,1,1
17036,പ്രശസ്തമായ,0,0,1,1
17037,rockez,0,0,1,1
17018,served,0,0,1,1
17016,ими,0,0,1,1
16995,caltechstudenten,0,0,1,1
17015,bout,0,0,1,1
16996,огромного,0,0,1,1
16997,constitute,0,0,1,1
16999,caes,0,0,1,1
17000,مئات,0,0,1,1
17001,привилегий,0,0,1,1
17002,அப்பட்டமானதைக்,0,0,1,1
17003,grundprinciper,0,0,1,1
17004,"
मिंग्रिलियाई",0,0,1,1
17005,मान,0,0,1,1
17009,редакторских,0,0,1,1
17010,modernos,0,0,1,1
17011,sekiz,0,0,1,1
17012,ಪ್ರೀತಿಯ,0,0,1,1
17013,värre,0,0,1,1
17014,типизировать,0,0,1,1
17171,coût,0,0,1,1
17175,syrien,0,0,1,1
16461,ஒன்றுக்கு,0,0,1,1
17330,وخسرت,0,0,1,1
17318,தாக்குதலுக்குள்ளாகும்,0,0,1,1
17319,शुक्रिया।,0,0,1,1
17320,ಆಹಾರದ,0,0,1,1
17324,kırıldı,0,0,1,1
17326,heterogen,0,0,1,1
17328,necessidade,0,0,1,1
17329,കണ്ണടച്ചു,0,0,1,1
17332,नीतियां,0,0,1,1
17342,aún,0,0,1,1
17333,iie siècle,0,0,1,1
17334,iyisi,0,0,1,1
17335,"
तागलोग",0,0,1,1
17336,«подписаться»,0,0,1,1
17337,ontmoeting,0,0,1,1
17338,ಕಾರ್ಯನಿರ್ವಹಿಸದಿದ್ದರೆ,0,0,1,1
17340,المقاطعة,0,0,1,1
17317,बिन्दुओं,0,0,1,1
17316,manifeste,0,0,1,1
17313,absurdos,0,0,1,1
17312,hızlıca,0,0,1,1
17292,éventuelles,0,0,1,1
17295,ലോകം,0,0,1,1
17296,disentangles,0,0,1,1
17297,compañero,0,0,1,1
17298,heette,0,0,1,1
17299,മുഴുകിയിരിക്കുന്നു,0,0,1,1
17300,സഹായിക്കുന്നതിൽ,0,0,1,1
17301,इसी,0,0,1,1
17302,renseignement,0,0,1,1
17303,മനസിലാക്കുകയും,0,0,1,1
17304,lov,0,0,1,1
17306,borç,0,0,1,1
17307,sanırım,0,0,1,1
17310,ba,0,0,1,1
17311,serais,0,0,1,1
17341,புகழ்பெற்ற,0,0,1,1
17343,exitosa,0,0,1,1
17176,lv •,0,0,1,1
17388,välmodig,0,0,1,1
17372,divergem,0,0,1,1
17373,narzissa,0,0,1,1
17376,தன்னார்வலர்களால்,0,0,1,1
17378,père,0,0,1,1
17382, kilotonne,0,0,1,1
17384,supresores,0,0,1,1
17387,tier,0,0,1,1
17390,arrêtés,0,0,1,1
17345,التحقق،,0,0,1,1
17392,författares,0,0,1,1
17394,exploitée,0,0,1,1
17396,ഇവ,0,0,1,1
17398,applikationer,0,0,1,1
17403,comienzos,0,0,1,1
17404,بشأنه,0,0,1,1
17405,publier,0,0,1,1
17371,ಸಿಕ್ಕಿದ್ದೇನೆ,0,0,1,1
17370,smilende,0,0,1,1
17369,optique,0,0,1,1
17367,செல்போனைப்,0,0,1,1
17347,حافزًا,0,0,1,1
17349,seawater,0,0,1,1
17350,பரிந்துரைகள்,0,0,1,1
17351,démarche,0,0,1,1
17352,trettonde,0,0,1,1
17354,персонаж,0,0,1,1
17355,ತಬ್ಬಿಕೊಳ್ಳಲು,0,0,1,1
17356,collectif,0,0,1,1
17358,extensões,0,0,1,1
17360,"
लग्ज़म्बर्गी",0,0,1,1
17361,"design ·
environmental",0,0,1,1
17362,prédiction,0,0,1,1
17363,повторяется,0,0,1,1
17365,weint,0,0,1,1
17366,kutsche,0,0,1,1
17290,بالك؟,0,0,1,1
17289,وتحريره,0,0,1,1
17288,describir,0,0,1,1
17214,βασικούς,0,0,1,1
17202,archean,0,0,1,1
17203,الطبعة،,0,0,1,1
17205,современных,0,0,1,1
17209,октябре,0,0,1,1
17210,milliarder,0,0,1,1
17211,tarefas,0,0,1,1
17212,«список,0,0,1,1
17216,ಪ್ರಪಂಚದಾದ್ಯಂತ,0,0,1,1
17287,prøver,0,0,1,1
17218,«pequeño,0,0,1,1
17219,queixa,0,0,1,1
17220,diagnostics,0,0,1,1
17221,बहक,0,0,1,1
17223,söylemeyi,0,0,1,1
17224,jornalista,0,0,1,1
17225,ನಿರ್ಧಾರ,0,0,1,1
17201,классифицирующий,0,0,1,1
17200,medeniyeti,0,0,1,1
17199,displaced,0,0,1,1
17198,أفسدت,0,0,1,1
17177,لوصف,0,0,1,1
17178,முடிவிலும்,0,0,1,1
17179,മോശമായ,0,0,1,1
17180,ஆராய,0,0,1,1
17181,wedding,0,0,1,1
17184,असंगत,0,0,1,1
17187,parálo,0,0,1,1
17188,"
indonésio",0,0,1,1
17189,sive,0,0,1,1
17190,eruit,0,0,1,1
17192,saisie,0,0,1,1
17193,knepig,0,0,1,1
17195,divisé,0,0,1,1
17196,"
esloveno",0,0,1,1
17197,ಮುಕ್ತನಾಗಿದ್ದೇನೆ,0,0,1,1
17226,ağlıyorsa,0,0,1,1
17229,promoção,0,0,1,1
17230,handwriting,0,0,1,1
17257,жаргоне,0,0,1,1
17259,ನೋಡುತ್ತಿದ್ದಾರೆ,0,0,1,1
17260,பயன்பாட்டிற்காகவும்,0,0,1,1
17261,pornoactrices,0,0,1,1
17265,மேற்பார்வையிடல்களுக்குப்,0,0,1,1
17268,estabelecida,0,0,1,1
17269,обзор,0,0,1,1
17271,προστεθούν,0,0,1,1
17274,வேல்ஸையே,0,0,1,1
17275,λίθους,0,0,1,1
17279,hole,0,0,1,1
17281,"हैं।
विशेष",0,0,1,1
17282,помахали,0,0,1,1
17283,mevcut,0,0,1,1
17285,لسوء,0,0,1,1
17286,sud,0,0,1,1
17258,конференциях,0,0,1,1
17256,gentagelse,0,0,1,1
17231,rápida,0,0,1,1
17255,அணிந்திருந்தார்,0,0,1,1
17232,söylüyor,0,0,1,1
17234,hakaretlere,0,0,1,1
17236,eventually,0,0,1,1
17237,regista,0,0,1,1
17239,ക്രൂരതയും,0,0,1,1
17240,réunis,0,0,1,1
17243,चिंतित,0,0,1,1
17244,центральным,0,0,1,1
17245,albumet,0,0,1,1
17246,cosmic,0,0,1,1
17248,വിയോജിക്കുകയും,0,0,1,1
17249,ಮೇಜಿನ,0,0,1,1
17250,modificaron,0,0,1,1
17252,apoyando,0,0,1,1
17254,ಮಗು,0,0,1,1
16942,യന്ത്രപഠനത്തിനു,0,0,1,1
16940,aufgeregt,0,0,1,1
16938,instituida,0,0,1,1
16631,ನಿಯಮಗಳನ್ನು,0,0,1,1
16624,गुणधर्मों,0,0,1,1
16625,dagbladet,0,0,1,1
16626,initiales,0,0,1,1
16627,équilibrés,0,0,1,1
16628,وأريد,0,0,1,1
16629,ചെയ്തെടുക്കുന്നു,0,0,1,1
16630,благом,0,0,1,1
16632,bumped,0,0,1,1
16647,inhabited,0,0,1,1
16633,beskrivelsesboksen,0,0,1,1
16634,“எச்டிஎம்எல்”,0,0,1,1
16639,tentar,0,0,1,1
16640,ταπεινή,0,0,1,1
16641,ದೇವದೂತರೊಂದಿಗೆ,0,0,1,1
16642,dbpedia,0,0,1,1
16644,« meilleures,0,0,1,1
16622,secuencia,0,0,1,1
16617,напечатаны,0,0,1,1
16616,sœur,0,0,1,1
16614,التحذيرات,0,0,1,1
16591,വ്യക്തിയുടെ,0,0,1,1
16592,μάθει,0,0,1,1
16593,barbe,0,0,1,1
16594,reemplazo,0,0,1,1
16595,تحتفظ,0,0,1,1
16596,unterwegs,0,0,1,1
16597,फोरम,0,0,1,1
16601,canciones,0,0,1,1
16602,ίσχυαν,0,0,1,1
16604,الكفاية,0,0,1,1
16606,കുടുങ്ങുമ്പോൾ,0,0,1,1
16608,keken,0,0,1,1
16609,تيرنس,0,0,1,1
16611,panne,0,0,1,1
16613,wikipedia»​​​​,0,0,1,1
16645,ursprungligen,0,0,1,1
16648,alfabetos,0,0,1,1
16937,igual,0,0,1,1
16694,d’identification »,0,0,1,1
16682,phases,0,0,1,1
16683,erhvervserfaring,0,0,1,1
16686,verifiable,0,0,1,1
16687,रुचियों,0,0,1,1
16690,avons,0,0,1,1
16691,مقياس,0,0,1,1
16693,textbooks,0,0,1,1
16695,വാങ്ങിയ,0,0,1,1
16650,dayan,0,0,1,1
16696,rastreado,0,0,1,1
16698,вебсайт,0,0,1,1
16699,любила,0,0,1,1
16700,versionshistorik,0,0,1,1
16701,والمحللون,0,0,1,1
16702,അമ്മയ്ക്ക്,0,0,1,1
16704,оплачиваемых,0,0,1,1
16681,प्रेमी,0,0,1,1
16678,വിവരസ്രോതസ്സുകളും,0,0,1,1
16677,miroitements,0,0,1,1
16675,birçoğunu,0,0,1,1
16652,isterse,0,0,1,1
16653,neoproterozoic,0,0,1,1
16655,മാസത്തിൽ,0,0,1,1
16657,неделю,0,0,1,1
16658,редакции,0,0,1,1
16659,texas,0,0,1,1
16660,tome,0,0,1,1
16661,medewerker,0,0,1,1
16662,oluşur,0,0,1,1
16663,ofrecen,0,0,1,1
16665,subtropical,0,0,1,1
16671,savunmaktadır,0,0,1,1
16672,yakalayana,0,0,1,1
16673,американских,0,0,1,1
16674,تعاونيًا,0,0,1,1
16588,grusomme,0,0,1,1
16587,autoclavagem,0,0,1,1
16584,subtropicaleréf,0,0,1,1
16500,случаются,0,0,1,1
16490,filarkivet,0,0,1,1
16492,περιοχή,0,0,1,1
16493,lleve,0,0,1,1
16494,admettez,0,0,1,1
16496,voormalig,0,0,1,1
16498,l’occasion,0,0,1,1
16499,suceden,0,0,1,1
16501,yatağa,0,0,1,1
16583,لغتا,0,0,1,1
16503,gütmeyen,0,0,1,1
16504,problématiques,0,0,1,1
16506,المادية,0,0,1,1
16507,insan,0,0,1,1
16509,spared,0,0,1,1
16510,तकनीकी,0,0,1,1
16512,accroître,0,0,1,1
16489,ഇമെയിൽ,0,0,1,1
16488,аспирантом,0,0,1,1
16485,huvudsakliga,0,0,1,1
16484,политике,0,0,1,1
16463,வாட்ஸ்அப்,0,0,1,1
16465,"
बवारियाई",0,0,1,1
16466,jehová,0,0,1,1
16467,stickprov,0,0,1,1
16468,lägstanivå,0,0,1,1
16469,removing,0,0,1,1
16473,anadili,0,0,1,1
16474,soleil ,0,0,1,1
16475,एनर्जी,0,0,1,1
16477,assert,0,0,1,1
16478,ಕಂಡಿದ್ದೀರಿ,0,0,1,1
16480,നല്ലതാണെന്ന്,0,0,1,1
16481,ക്ലാസ്സിൽ,0,0,1,1
16482,λίγες,0,0,1,1
16483,principper,0,0,1,1
16513,jeu ,0,0,1,1
16514,исходят,0,0,1,1
16515,ditesnous,0,0,1,1
16551,tillmätas,0,0,1,1
16554,mobiles,0,0,1,1
16555,تقييم,0,0,1,1
16556,അന്ധാളിച്ച്,0,0,1,1
16557,comum,0,0,1,1
16562,critique,0,0,1,1
16563,അർഹതയുണ്ടെന്ന്,0,0,1,1
16565,fysiska,0,0,1,1
16568,beskrivande,0,0,1,1
16570,starta,0,0,1,1
16572,optaria,0,0,1,1
16574,историография,0,0,1,1
16575,jefe,0,0,1,1
16578,سوبود,0,0,1,1
16580,blanding,0,0,1,1
16581,mobilanpassade,0,0,1,1
16552,erika,0,0,1,1
16547,опыт,0,0,1,1
16516,confusa,0,0,1,1
16546,മേശപ്പുറത്ത്,0,0,1,1
16517,விளம்பரங்களின்,0,0,1,1
16521,oförenligt,0,0,1,1
16523,unutulmamalıdır,0,0,1,1
16525,planteamiento,0,0,1,1
16526,обычаями,0,0,1,1
16527,வாக்கெடுப்பும்,0,0,1,1
16528,femhundra,0,0,1,1
16530,cliquant,0,0,1,1
16531,basingstoke,0,0,1,1
16532,repentinamente,0,0,1,1
16534,tıklayarak,0,0,1,1
16537,redigerare,0,0,1,1
16540,embark,0,0,1,1
16541,schéma,0,0,1,1
16545,விரும்புகிறாள்,0,0,1,1
16706,الثانية،,0,0,1,1
16708,கொண்டார்,0,0,1,1
16711,roches,0,0,1,1
16868,സുഹൃത്തുക്കളായിരുന്നു,0,0,1,1
16859,propiamente,0,0,1,1
16861,மேஜையில்,0,0,1,1
16862,μεγαλώσει,0,0,1,1
16863,ചെയ്യരുത്,0,0,1,1
16864,ವಾಕ್ಯವನ್ನು,0,0,1,1
16866,ബാങ്ക്‌,0,0,1,1
16867,wikificere,0,0,1,1
16869,tivéssemos,0,0,1,1
16820,बनता,0,0,1,1
16870,chegavam,0,0,1,1
16871,keskinliği,0,0,1,1
16872,ಯೂಟ್ಯೂಬ್‌ನಲ್ಲಿ,0,0,1,1
16873,«неудобных»,0,0,1,1
16875,ಹೆಚ್ಚಿಸುವುದು,0,0,1,1
16878,ومراجعة,0,0,1,1
16879,wikipediaprojektets,0,0,1,1
16858,принести,0,0,1,1
16857,chegando,0,0,1,1
16855,أريده,0,0,1,1
16854,ജ്ഞാനമല്ല,0,0,1,1
16826,பெரிதாக,0,0,1,1
16827,государственную,0,0,1,1
16828,работах,0,0,1,1
16830,πηγή,0,0,1,1
16831,आठ,0,0,1,1
16834,प्रोग्रामिंग,0,0,1,1
16837,"
अम्हारिक",0,0,1,1
16838,perpetuidad,0,0,1,1
16839,gehouden,0,0,1,1
16840,«открытие,0,0,1,1
16842,ಹಣವಿದೆ,0,0,1,1
16845,διάσημο,0,0,1,1
16849,വിക്കിപീഡിയകൾ,0,0,1,1
16851,başlıca,0,0,1,1
16852,islas,0,0,1,1
16881,функций,0,0,1,1
16882,comedor,0,0,1,1
16883,حان,0,0,1,1
16913,октября,0,0,1,1
16917,känsliga,0,0,1,1
16918,sidans,0,0,1,1
16919,précaution,0,0,1,1
16921,l’on,0,0,1,1
16922,lett,0,0,1,1
16923,amerikalıların,0,0,1,1
16924,கட்டுரைகளை,0,0,1,1
16925,conhecer,0,0,1,1
16926,auteursrechtelijke,0,0,1,1
16927,ಹಿಂಜರಿಯುತ್ತಿದೆ,0,0,1,1
16929,refoulée,0,0,1,1
16930,ಮಹಾಕಾವ್ಯವನ್ನು,0,0,1,1
16933,aceptados,0,0,1,1
16935,конечная,0,0,1,1
16936,workload,0,0,1,1
16914,വെയറിന്റെ,0,0,1,1
16912,المركز,0,0,1,1
16884,accountability,0,0,1,1
16911,забывают,0,0,1,1
16885,ужасна,0,0,1,1
16886,ഹിക്കുന്നതുപോലെ,0,0,1,1
16887,construites,0,0,1,1
16890,ಪೂರ್ತಿ,0,0,1,1
16892,incompréhensions,0,0,1,1
16893,öppenheten,0,0,1,1
16894,സാങർ,0,0,1,1
16895,trykke,0,0,1,1
16896,litígios,0,0,1,1
16897,الواردة,0,0,1,1
16898,ஐகானைக்,0,0,1,1
16901,såväl,0,0,1,1
16904,അർഹനാണെന്ന്,0,0,1,1
16906,ذكر,0,0,1,1
16910,uğrayan,0,0,1,1
16821,önemlidir,0,0,1,1
16819,hattest,0,0,1,1
16712,"science ·
ഹൈഡ്രോളജി",0,0,1,1
16749,fouilles,0,0,1,1
16740,yemeğinde,0,0,1,1
16741,gezegd,0,0,1,1
16742,sentar,0,0,1,1
16744,argumenta,0,0,1,1
16746,ilan,0,0,1,1
16747,blijft,0,0,1,1
16748,"
português",0,0,1,1
16754,സ്വതന്ത്രമായി,0,0,1,1
16818,уходить,0,0,1,1
16755,серьезно,0,0,1,1
16756,appelle,0,0,1,1
16757,exclusão,0,0,1,1
16758,röportajda,0,0,1,1
16759,d’autant,0,0,1,1
16760,l’« homme,0,0,1,1
16761,وكل,0,0,1,1
16739,brandchannel,0,0,1,1
16738,suède,0,0,1,1
16737,خطيرة،,0,0,1,1
16734,incorrectas,0,0,1,1
16714,espuria,0,0,1,1
16715,ün,0,0,1,1
16716,revise,0,0,1,1
16718,ενότητα,0,0,1,1
16720,søster,0,0,1,1
16721,يمثل,0,0,1,1
16722,салаты,0,0,1,1
16723,musée,0,0,1,1
16724,ക്യാൻസർ,0,0,1,1
16725,миллион,0,0,1,1
16726,ಮುಳುಗಿಸುವುದು,0,0,1,1
16728,partagés,0,0,1,1
16729,katıldığını,0,0,1,1
16730,knapp,0,0,1,1
16732,بالتشعب,0,0,1,1
16762,जाएगा,0,0,1,1
16763,ഗണത്തിൽപ്പെടുന്നു,0,0,1,1
16766,leaving,0,0,1,1
16791,he •,0,0,1,1
16796,beschreibungsfeld,0,0,1,1
16798,egenintresse,0,0,1,1
16799,வழங்கப்பட்டது,0,0,1,1
16801,γραμματική,0,0,1,1
16803,yakutların,0,0,1,1
16804,kazanmış,0,0,1,1
16805,прослеживает,0,0,1,1
16807,مثلا،,0,0,1,1
16808,freeknowledge,0,0,1,1
16809,അപ്പ്,0,0,1,1
16810,ലഭിക്കണമെങ്കിൽ,0,0,1,1
16814,inteiro,0,0,1,1
16815,അന്തരീക്ഷത്തിന്,0,0,1,1
16816,منطقي,0,0,1,1
16817,ಭಾಗವು,0,0,1,1
16794,spirituel,0,0,1,1
16790,एसोसिएशन,0,0,1,1
16768,betecknar,0,0,1,1
16789,expliquez,0,0,1,1
16769,تجاهل,0,0,1,1
16770,مخطئ,0,0,1,1
16772,amaba,0,0,1,1
16773,partager,0,0,1,1
16774,hazırlanırken,0,0,1,1
16775,homework,0,0,1,1
16777,‘மென்பொருட்கள்’,0,0,1,1
16778,disposal,0,0,1,1
16779,interventions,0,0,1,1
16780,умный,0,0,1,1
16782,النظرات,0,0,1,1
16783,основной,0,0,1,1
16785,бесчисленное,0,0,1,1
16787,வேறுபட்டிருப்பதைக்,0,0,1,1
16788,ernstige,0,0,1,1
15533,والاستنتاجي,0,0,1,1
15531,elevar,0,0,1,1
13554,എത്രത്തോളമാവണം,0,0,1,1
14232,والإسبانية,0,0,1,1
14216,gebrekkig,0,0,1,1
14217,περίπτωση,0,0,1,1
14218,lyfter,0,0,1,1
14219,ऑस्ट्रिया,0,0,1,1
14227,códigos,0,0,1,1
14228,λέγω,0,0,1,1
14229,plastic,0,0,1,1
14233,ഉരുളക്കിഴങ്ങ്,0,0,1,1
14247,शहर,0,0,1,1
14234,കാലെടുത്തുവച്ചാൽ,0,0,1,1
14235,பெறுவேன்,0,0,1,1
14236,inferences,0,0,1,1
14240,ringa,0,0,1,1
14242,प्रिक्स,0,0,1,1
14243,kadın,0,0,1,1
14245,proporcionaron,0,0,1,1
14214,culturas,0,0,1,1
14213,जाग,0,0,1,1
14212,dataskyddsförordningen,0,0,1,1
14211,माग्नस,0,0,1,1
14187,الدمية,0,0,1,1
14190,çamaşır,0,0,1,1
14194,നെഗറ്റീവ്,0,0,1,1
14195,онлайнголосований,0,0,1,1
14197,независимыми,0,0,1,1
14198,तीखे,0,0,1,1
14199,ಕೇಳಿ,0,0,1,1
14200,വിത്തുകൾ,0,0,1,1
14201,commentant,0,0,1,1
14202,sunulması,0,0,1,1
14203,sentez,0,0,1,1
14204,കഴിവനുസരിച്ച്,0,0,1,1
14208,началась,0,0,1,1
14209,принято,0,0,1,1
14210,المنتجين,0,0,1,1
14246,مثالية,0,0,1,1
14249,нагрузку,0,0,1,1
14306,africa,0,0,1,1
14293,kullanıcıları,0,0,1,1
14283,codfw,0,0,1,1
14284,​​te,0,0,1,1
14285,disminuir,0,0,1,1
14286,ಬುದ್ಧಿಹೀನ,0,0,1,1
14288,énervé,0,0,1,1
14289,musste,0,0,1,1
14290,طاقة,0,0,1,1
14294,योग्यता,0,0,1,1
14250,anlamadınız,0,0,1,1
14296,सोफे,0,0,1,1
14297,ഇഷ്ടമാണ്,0,0,1,1
14298,maddenin,0,0,1,1
14299,വശങ്ങളും,0,0,1,1
14301,periodísticos,0,0,1,1
14303,manned,0,0,1,1
14304,ltd,0,0,1,1
14279,ಗಣಿತದ,0,0,1,1
14278,ort,0,0,1,1
14277,population,0,0,1,1
14276,غدًا,0,0,1,1
14253,адамсом,0,0,1,1
14254,desordenado,0,0,1,1
14256,«obra,0,0,1,1
14258,признаете,0,0,1,1
14259,അറിയില്ലായിരുന്നു,0,0,1,1
14260,ನಾವೆಲ್ಲರೂ,0,0,1,1
14261,δημιουργικής,0,0,1,1
14262,caráter,0,0,1,1
14264,explication,0,0,1,1
14265,خاصية,0,0,1,1
14267,ശ്രദ്ധപുലർത്തുക,0,0,1,1
14271,saudações,0,0,1,1
14272,хеллером,0,0,1,1
14273,നിങ്ങള്ക്ക്,0,0,1,1
14275,благодарен,0,0,1,1
14186,മാണിക്യത്തിന്റെ,0,0,1,1
14183,pornografiska,0,0,1,1
14182,olgulara,0,0,1,1
14096,incorporación,0,0,1,1
14083,hakikaten,0,0,1,1
14085,выходящие,0,0,1,1
14086,skapats,0,0,1,1
14089,reaching,0,0,1,1
14091,boven,0,0,1,1
14092,tilfældig,0,0,1,1
14094,preguiçosas,0,0,1,1
14098,അമ്മയായിരുന്നു,0,0,1,1
14181,welt,0,0,1,1
14099,chiffrer,0,0,1,1
14100,स्ट्रिप,0,0,1,1
14101,наш,0,0,1,1
14104,aprendiesen,0,0,1,1
14106,മായ്ച്ചുകളയാറുമുണ്ട്,0,0,1,1
14107,uppmärksammades,0,0,1,1
14108,sonst,0,0,1,1
14082,لvice,0,0,1,1
14081,يفوق,0,0,1,1
14079,ದೇಶಕ್ಕೆ,0,0,1,1
14078,அவர்களுக்கு,0,0,1,1
14051,മനസിലാക്കരുത്,0,0,1,1
14052,fixe ,0,0,1,1
14053,ಎಂಬುದನ್ನು,0,0,1,1
14055,cotidiana,0,0,1,1
14056,ومشتق,0,0,1,1
14060,burası,0,0,1,1
14061,spids,0,0,1,1
14064,"
विष्णुप्रिया",0,0,1,1
14065,raisonnable »,0,0,1,1
14068,अनुमानतः,0,0,1,1
14069,costolo,0,0,1,1
14070,الزواج,0,0,1,1
14075,couramment,0,0,1,1
14076,respirer,0,0,1,1
14077,ilerlemek,0,0,1,1
14111,plateau,0,0,1,1
14112,saint,0,0,1,1
14115,أوصلك,0,0,1,1
14149,escolhidos,0,0,1,1
14154,grubu,0,0,1,1
14157,ಜೀವಂತವಾಗಿದ್ದ,0,0,1,1
14158,вкладчиков,0,0,1,1
14162,overdrive,0,0,1,1
14163,универсальная,0,0,1,1
14164,cliquer,0,0,1,1
14165,"
दिवेही",0,0,1,1
14166,ഗേറ്റ്സിന്റെ,0,0,1,1
14170,sostienen,0,0,1,1
14171,വന്നിട്ടുണ്ടെന്നും,0,0,1,1
14173,autonomie,0,0,1,1
14175,കവിഞ്ഞു,0,0,1,1
14176,arkiverade,0,0,1,1
14179,angstaanjagenders,0,0,1,1
14180,dönmeme,0,0,1,1
14150,fournies,0,0,1,1
14148,cognition,0,0,1,1
14118,ужасными,0,0,1,1
14145,başlıklı,0,0,1,1
14120,yemelisin,0,0,1,1
14123,форматах,0,0,1,1
14124,അനുവദിക്കുന്നുണ്ട്,0,0,1,1
14126,hond,0,0,1,1
14128,கொண்டுள்ளேன்,0,0,1,1
14132,mediação,0,0,1,1
14133,trabalhista,0,0,1,1
14135,parfait,0,0,1,1
14136,bob,0,0,1,1
14138,விக்கியை,0,0,1,1
14139,حلقة,0,0,1,1
14140,метод,0,0,1,1
14141,संगोष्ठी,0,0,1,1
14143,ère,0,0,1,1
14144,payant,0,0,1,1
14305,bogstaveligt,0,0,1,1
14307,struggled,0,0,1,1
14538, millions de fichiers,0,0,1,1
14465,inundación,0,0,1,1
14455,ആവർത്തിക്കണമെന്ന്,0,0,1,1
14456,universelle »,0,0,1,1
14457,üzülme,0,0,1,1
14459,संयुक्त,0,0,1,1
14462,പ്രമുഖരുടെ,0,0,1,1
14463,flourish,0,0,1,1
14464,согласия,0,0,1,1
14466,qu’on,0,0,1,1
14476,lisanslanmaktadır,0,0,1,1
14467,المحتوى،,0,0,1,1
14469,முடுக்கிவிடுங்கள்,0,0,1,1
14470,actualizó,0,0,1,1
14471,magiske,0,0,1,1
14472,μπορούν,0,0,1,1
14473,രാജകുമാരൻ,0,0,1,1
14474,utvecklat,0,0,1,1
14454,मुद्दा,0,0,1,1
14453,хранилища,0,0,1,1
14451,possibilités,0,0,1,1
14450,бесполезен,0,0,1,1
14428,பிரமாதமாக,0,0,1,1
14429,remaniée,0,0,1,1
14430,baktı,0,0,1,1
14432,اغتيال,0,0,1,1
14433,وجهي,0,0,1,1
14436,débattre,0,0,1,1
14437,എടുത്തുക്കൊള്ളാം,0,0,1,1
14438,förhandsgranskning,0,0,1,1
14440,κύρος,0,0,1,1
14441,discern,0,0,1,1
14442,തകർന്നു,0,0,1,1
14443,ബെൽ,0,0,1,1
14444,ooit,0,0,1,1
14445,σύνταξη,0,0,1,1
14447,гарвардской,0,0,1,1
14475,свободного,0,0,1,1
14482,ελαφρώς,0,0,1,1
14308,commencent,0,0,1,1
14525,indian,0,0,1,1
14514,ലേഖനങ്ങളിലും,0,0,1,1
14515,ಆದ,0,0,1,1
14517,تكريم,0,0,1,1
14518,mathebuch,0,0,1,1
14521,complaint,0,0,1,1
14523,ಸುಸ್ತಾಗುವುದಿಲ್ಲ,0,0,1,1
14524,engeller,0,0,1,1
14526,நர்சிசாவைப்,0,0,1,1
14483,построения,0,0,1,1
14527,മറയ്‌ക്കാൻ‌,0,0,1,1
14529,അംഗീകരിക്കപ്പെട്ടിരിക്കുന്ന,0,0,1,1
14530,ex ,0,0,1,1
14531,tisch,0,0,1,1
14533,territoires,0,0,1,1
14534,مربى,0,0,1,1
14536,minimizing,0,0,1,1
14511,எடுக்கலாமா,0,0,1,1
14510,வழமையான,0,0,1,1
14509,русском,0,0,1,1
14508,caísse,0,0,1,1
14486,"
कोरियाई",0,0,1,1
14487,gleiche,0,0,1,1
14490,humanidade,0,0,1,1
14491,cuantas,0,0,1,1
14493,proprietário,0,0,1,1
14494,reducir,0,0,1,1
14496,ловушки,0,0,1,1
14497,metin,0,0,1,1
14498,dissimilar,0,0,1,1
14499,баллотироваться,0,0,1,1
14500,drôle,0,0,1,1
14501,கூடியனவாய்,0,0,1,1
14502,обработки,0,0,1,1
14505,دخل,0,0,1,1
14506,قلعة,0,0,1,1
14425,यूजमोडविकी,0,0,1,1
14422,желающим,0,0,1,1
14421,алгоритмы,0,0,1,1
14345,guían,0,0,1,1
14336,conjunctions,0,0,1,1
14337,пользователями,0,0,1,1
14338,والعبارات,0,0,1,1
14339,mantidos,0,0,1,1
14342,scenes,0,0,1,1
14343,ceb,0,0,1,1
14344,تهمه,0,0,1,1
14348,rendimiento,0,0,1,1
14420,chiques,0,0,1,1
14349,തന്നാൽ,0,0,1,1
14351,"
francês",0,0,1,1
14353,عالمية،,0,0,1,1
14354,severas,0,0,1,1
14355,comenta,0,0,1,1
14356,тон,0,0,1,1
14357,bitecek,0,0,1,1
14335,நாசீஸை,0,0,1,1
14334,englische,0,0,1,1
14333,നാനാവിധ,0,0,1,1
14330,filtres,0,0,1,1
14309,remplazada,0,0,1,1
14311,affectations,0,0,1,1
14312,جديد,0,0,1,1
14313,flour,0,0,1,1
14314,создавать,0,0,1,1
14316,نرسيسا,0,0,1,1
14318,столлмана,0,0,1,1
14319,определение,0,0,1,1
14322,ifadenin,0,0,1,1
14324,modificam,0,0,1,1
14325,углы»,0,0,1,1
14326,comente,0,0,1,1
14327,privado,0,0,1,1
14328,assign,0,0,1,1
14329,ಆಡುಮಾತಿನಂತಿದೆ,0,0,1,1
14358,дитя,0,0,1,1
14359,counterparts,0,0,1,1
14361,frågetecken,0,0,1,1
14390,frontière,0,0,1,1
14393,mismo​,0,0,1,1
14394,atribuídos,0,0,1,1
14395,المناسبة،note,0,0,1,1
14397,qualified,0,0,1,1
14398,संक्षिप्त,0,0,1,1
14400,الفترة,0,0,1,1
14403,அவளைப்,0,0,1,1
14404,വേർതിരിക്കുന്നത്,0,0,1,1
14405,bidragsgivarna,0,0,1,1
14413,zamanı,0,0,1,1
14415,komende,0,0,1,1
14416,innebar,0,0,1,1
14417,പ്രതിഭാസങ്ങളെയും,0,0,1,1
14418,καλλιέργεια,0,0,1,1
14419,عامية,0,0,1,1
14391,بالإصدارات,0,0,1,1
14389,croît,0,0,1,1
14363,അയയ്ക്കാനോ,0,0,1,1
14387,उठाया।,0,0,1,1
14364,टाडिक,0,0,1,1
14366,άλλον,0,0,1,1
14367,zevkle,0,0,1,1
14371,qualificatif,0,0,1,1
14372,καταπληκτικού,0,0,1,1
14373,تذكرها,0,0,1,1
14376,ಉಡುಪಿನಲ್ಲಿದ್ದಾಗ,0,0,1,1
14378,परत,0,0,1,1
14379,വാർത്ത,0,0,1,1
14380,vermeld,0,0,1,1
14381,relus,0,0,1,1
14382,handhållna,0,0,1,1
14383,fotográfica,0,0,1,1
14384,സ്താനാർബുദം,0,0,1,1
14385,incorporation,0,0,1,1
14050,tasting,0,0,1,1
14048,intervient,0,0,1,1
14047,பதிவுகள்,0,0,1,1
13722,ويكي،,0,0,1,1
13709,uygulanmak,0,0,1,1
13711,endişeye,0,0,1,1
13712,incrivelmente,0,0,1,1
13716,راي,0,0,1,1
13718,featuring,0,0,1,1
13720,avantage,0,0,1,1
13721,onderbreek,0,0,1,1
13725,நிலமாகக்,0,0,1,1
13748,súper,0,0,1,1
13728,seventh,0,0,1,1
13729,الزيارات,0,0,1,1
13731,ಶೀತವಾಗಿದೆ,0,0,1,1
13732,എഴുതാവുന്ന,0,0,1,1
13733,വിദ്യാർത്ഥികൾക്കായുള്ള,0,0,1,1
13739,dybt,0,0,1,1
13745,kolaylaştırmak,0,0,1,1
13707,coexistia,0,0,1,1
13706,पायी,0,0,1,1
13705,contraseña,0,0,1,1
13704,ತಿಳಿದಿರುವುದರಿಂದ,0,0,1,1
13682,விதிவிலக்காக,0,0,1,1
13684,ವಿಷಾದಿಸುತ್ತೇನೆ,0,0,1,1
13685,போன்றன,0,0,1,1
13686,hice,0,0,1,1
13688,आटा,0,0,1,1
13689,purposefully,0,0,1,1
13690,stcentury,0,0,1,1
13691,الدنا،,0,0,1,1
13693,soplo,0,0,1,1
13694,selamlar,0,0,1,1
13695,ഷെല്ലിന്റെ,0,0,1,1
13696,الفرعي,0,0,1,1
13698,picante,0,0,1,1
13701,suivis,0,0,1,1
13703,ಆರಂಭದ,0,0,1,1
13746,durable »,0,0,1,1
13749,elastic,0,0,1,1
14044,gerektiğidir,0,0,1,1
13795,müstakbel,0,0,1,1
13785,anneme,0,0,1,1
13787,लगाती,0,0,1,1
13789,بتلميحات,0,0,1,1
13790,நடைமுறையை,0,0,1,1
13791,русская —,0,0,1,1
13792,توش,0,0,1,1
13793,കഴിയുന്നില്ലെങ്കിൽ,0,0,1,1
13797,slot,0,0,1,1
13750,drukning,0,0,1,1
13800,سلبي,0,0,1,1
13802,λειτουργήσει,0,0,1,1
13803,praising,0,0,1,1
13804,серверах,0,0,1,1
13805,drukken,0,0,1,1
13807,എല്ലാവരും,0,0,1,1
13808,संध्या।,0,0,1,1
13783,навсегда,0,0,1,1
13781,fomentado,0,0,1,1
13780,hörs,0,0,1,1
13779,τέρρι,0,0,1,1
13751,ಟೀಕಿಸಿ,0,0,1,1
13752,ನೋಡುತ್ತದೆ,0,0,1,1
13755,«cómo,0,0,1,1
13756,നേറ്റീവ്,0,0,1,1
13757,இணையானது,0,0,1,1
13761,fastnar,0,0,1,1
13762,kultiviert,0,0,1,1
13763,entreolharam,0,0,1,1
13765,rechazado,0,0,1,1
13768,verificadas,0,0,1,1
13769,rastrear,0,0,1,1
13770,diğerinin,0,0,1,1
13771,القليلة,0,0,1,1
13777,അവസാനം,0,0,1,1
13778,intensivo,0,0,1,1
13681,ಸಂಬಂಧವಿದೆ,0,0,1,1
13680,ausgeglichen,0,0,1,1
13679,الحرب,0,0,1,1
13599,eğlenceli,0,0,1,1
13588,fornærmelse,0,0,1,1
13590,inductively,0,0,1,1
13591,والتنسيق,0,0,1,1
13592,шутите,0,0,1,1
13593,प्रेमिका,0,0,1,1
13597,மொழிகளைக்,0,0,1,1
13598,थोडा,0,0,1,1
13602,जिनका,0,0,1,1
13676,millennium,0,0,1,1
13603,ಸುಲಭವಾಗಿ,0,0,1,1
13604,മുൻ,0,0,1,1
13605,d’intuition,0,0,1,1
13607,adaptive,0,0,1,1
13610,ಹೇಳಬಹುದಾದ,0,0,1,1
13612,افعل,0,0,1,1
13614,मापदंडों,0,0,1,1
13586,assiette,0,0,1,1
13585,വീഡിയോയിൽ‌,0,0,1,1
13582,ക്രോസ്സ്,0,0,1,1
13578,texter,0,0,1,1
13555,надёжным,0,0,1,1
13556,കഴിക്കൂ,0,0,1,1
13558,kullanılarak,0,0,1,1
13560,nécessitent,0,0,1,1
13561,«criterios,0,0,1,1
13562,घूमते,0,0,1,1
13563,θαυμαστικές,0,0,1,1
13564,ಧ್ವನಿಯನ್ನು,0,0,1,1
13565,методами,0,0,1,1
13568,hetgeen,0,0,1,1
13569,تكونا,0,0,1,1
13570,moeilijker,0,0,1,1
13571,тесте,0,0,1,1
13573,ಫಲಿತಾಂಶವನ್ನು,0,0,1,1
13576,примеров,0,0,1,1
13615,incorporés,0,0,1,1
13616,ಶನಿವಾರದಂದು,0,0,1,1
13617,advances,0,0,1,1
13651,denuncias,0,0,1,1
13653,compraron,0,0,1,1
13655,λέγατε,0,0,1,1
13656,صعد,0,0,1,1
13659,apprenant,0,0,1,1
13660,priorité,0,0,1,1
13661,रोका,0,0,1,1
13662,ansiklopedilerden,0,0,1,1
13663,التطبيق,0,0,1,1
13664,ويدعو,0,0,1,1
13667,güiquipedia,0,0,1,1
13668,फ्लुमॉक्स,0,0,1,1
13670,öğrenciler,0,0,1,1
13671,അവനോട്‌,0,0,1,1
13673,വിശ്വസിക്കുന്നവരിപ്പോൾ,0,0,1,1
13674,licencesf,0,0,1,1
13652,सुनना,0,0,1,1
13650,estelle,0,0,1,1
13619,ಗೊಂದಲಕ್ಕೊಳಗಾದವು,0,0,1,1
13649,മീറ്റിംഗിന്,0,0,1,1
13620,கலைக்களஞ்சியத்,0,0,1,1
13621,implementations,0,0,1,1
13622,പാവം,0,0,1,1
13625,précondition,0,0,1,1
13627,perda,0,0,1,1
13628,விரல்கள்,0,0,1,1
13629,ditesvous,0,0,1,1
13635,ಮುಂದುವರಿಯಲು,0,0,1,1
13637,hemos,0,0,1,1
13638,plaatsen,0,0,1,1
13641,classes,0,0,1,1
13642,செய்யப்பட்டுள்ளன,0,0,1,1
13643,dépendant,0,0,1,1
13644,لتحديد,0,0,1,1
13645,உதவியுடன்,0,0,1,1
13809,ತೊರೆಯುತ್ತಿದ್ದೇನೆ,0,0,1,1
13811,checked,0,0,1,1
13812,നിർദ്ദേശിച്ചിട്ടുള്ള,0,0,1,1
13979,definerer,0,0,1,1
13969,العلوم،,0,0,1,1
13970,التنقيب,0,0,1,1
13971,begegnete,0,0,1,1
13973,ikilem,0,0,1,1
13974,ಉದಾಹರಣೆಗಳು,0,0,1,1
13975,ಮನೆಕೆಲಸವನ್ನು,0,0,1,1
13976,കാണാനായതിൽ,0,0,1,1
13980,ændre,0,0,1,1
13940,stadt,0,0,1,1
13981,guild,0,0,1,1
13982,тарелке,0,0,1,1
13984,طعام,0,0,1,1
13986,revidera,0,0,1,1
13987,ακόμα,0,0,1,1
13988,servrarna,0,0,1,1
13989,sınıfın,0,0,1,1
13968,ಶಾಂತಗೊಳಿಸಿ,0,0,1,1
13966,costume,0,0,1,1
13965,prazo,0,0,1,1
13963,والغالبية,0,0,1,1
13942,स्नो,0,0,1,1
13943,utsätts,0,0,1,1
13944,ίδρυση,0,0,1,1
13948,supplies,0,0,1,1
13949,വസ്തുതകളിലൂന്നിയുള്ള,0,0,1,1
13950,entendía,0,0,1,1
13951,центром,0,0,1,1
13953,വാക്കിനെക്കുറിച്ച്,0,0,1,1
13954,உச்சரிக்கிறீர்கள்,0,0,1,1
13955,eventuellt,0,0,1,1
13956,великобритании,0,0,1,1
13958,movido,0,0,1,1
13959,judiciaires,0,0,1,1
13961,शूरवीर,0,0,1,1
13962,ja •,0,0,1,1
13991,ஆச்சரியப்படுகிறீர்கள்,0,0,1,1
13992,विज्ञान,0,0,1,1
13993,निर्दिष्ट,0,0,1,1
14023,آداب,0,0,1,1
14025,mineral,0,0,1,1
14026,தாக்கத்தை,0,0,1,1
14027,вопросах,0,0,1,1
14029,største,0,0,1,1
14030,behaves,0,0,1,1
14032,विद्यार्थी,0,0,1,1
14033,അസാധ്യമായ,0,0,1,1
14034,değiştirebilir,0,0,1,1
14035,बेस्ट,0,0,1,1
14036,مسيئة،,0,0,1,1
14038,красоту,0,0,1,1
14040,webbliknande,0,0,1,1
14041,подбодрить,0,0,1,1
14042,تجربتهم,0,0,1,1
14043,പാഠത്തിൽ,0,0,1,1
14024,совсем,0,0,1,1
14021,مسكين,0,0,1,1
13995,protista,0,0,1,1
14020,يجعلني,0,0,1,1
13998,ശബ്‌ദം,0,0,1,1
13999,rends,0,0,1,1
14002,cheaper,0,0,1,1
14003,deeper,0,0,1,1
14004,heerlijk,0,0,1,1
14005,ಯೋಚಿಸಿ,0,0,1,1
14007,नियम,0,0,1,1
14009,sängmamma,0,0,1,1
14010,ryssland,0,0,1,1
14011,يمتلك,0,0,1,1
14012,politikasıdır,0,0,1,1
14014,व्युत्पन्न,0,0,1,1
14016,وبنائها,0,0,1,1
14017,verdadeiras,0,0,1,1
14019,traducciones,0,0,1,1
13941,ക്ലിക്കുചെയ്ത്,0,0,1,1
13939,точку,0,0,1,1
13813,estrategias,0,0,1,1
13856,ಅವಕಾಶವಿಲ್ಲ,0,0,1,1
13846,ഗ്നു,0,0,1,1
13847,demasiada,0,0,1,1
13848,رحلتك,0,0,1,1
13850,എഴുതുന്നുണ്ട്,0,0,1,1
13853,சாதிக்காத,0,0,1,1
13854,ставились,0,0,1,1
13855,ಪ್ರದೇಶವನ್ನು,0,0,1,1
13858,energievoorbeeld,0,0,1,1
13938,وهؤلاء,0,0,1,1
13862,सातवीं,0,0,1,1
13863,биологических,0,0,1,1
13865,matthews,0,0,1,1
13866,குறிக்கப்,0,0,1,1
13867,shortly,0,0,1,1
13868,मार्मिक,0,0,1,1
13869,katılamadım,0,0,1,1
13845,जोड़ें,0,0,1,1
13844,recently,0,0,1,1
13843,सीमाओं,0,0,1,1
13841,samspel,0,0,1,1
13814,உச்சரிப்பை,0,0,1,1
13815,விதிகளை,0,0,1,1
13816,पिला,0,0,1,1
13817,complétés,0,0,1,1
13820,δομημένων,0,0,1,1
13823,roden,0,0,1,1
13825,நன்றாகத்,0,0,1,1
13826,неэкспертами,0,0,1,1
13827,соответствующей,0,0,1,1
13828,ആരംഭിച്ചപ്പോഴാണ്,0,0,1,1
13831,chances,0,0,1,1
13832,besökarna,0,0,1,1
13836,номинациях,0,0,1,1
13837,hobbes,0,0,1,1
13838,الاختبار,0,0,1,1
13871,fühle,0,0,1,1
13872,എഴുതിയ,0,0,1,1
13873,ഉണ്ടായിരിക്കണമെന്ന്,0,0,1,1
13901,vandallamalarına,0,0,1,1
13905,objections,0,0,1,1
13906,forbi,0,0,1,1
13911,ποτό,0,0,1,1
13912,polaires,0,0,1,1
13913,φροντίστε,0,0,1,1
13914,развивается,0,0,1,1
13915,fleste,0,0,1,1
13917,datasets,0,0,1,1
13918,pointforpoint,0,0,1,1
13923,വിവരങ്ങളെ,0,0,1,1
13925,എന്നറിയുവാൻ,0,0,1,1
13932,निर्भर,0,0,1,1
13933,uitgebreider,0,0,1,1
13935,ubicó,0,0,1,1
13936,confiance,0,0,1,1
13904,വലുതാണെന്ന്,0,0,1,1
13900,cair,0,0,1,1
13874,qualitatif,0,0,1,1
13898,manipulates,0,0,1,1
13875,സാധ്യമാക്കുന്നത്,0,0,1,1
13876,acima,0,0,1,1
13878,вредительское,0,0,1,1
13880,தொடரச்,0,0,1,1
13882,ಹೋಗಬಹುದು,0,0,1,1
13883,tracts,0,0,1,1
13884,funny,0,0,1,1
13885,владеет,0,0,1,1
13886,resultaten,0,0,1,1
13889,ശക്തമായി,0,0,1,1
13890,обнаружено,0,0,1,1
13891,parody,0,0,1,1
13893,viagens,0,0,1,1
13894,എടുത്തുമാറ്റുക,0,0,1,1
13895,trillion,0,0,1,1
14537,μπόρεσα,0,0,1,1
14540,balanced,0,0,1,1
15527,parentheses,0,0,1,1
15192,sorabilirsiniz,0,0,1,1
15180,pleures,0,0,1,1
15181,inscrever,0,0,1,1
15183,мысль,0,0,1,1
15184,mühe,0,0,1,1
15189,основными,0,0,1,1
15190,institutions,0,0,1,1
15191,செய்யும்படி,0,0,1,1
15194,”machine,0,0,1,1
15212,quedaría,0,0,1,1
15196,hamburger,0,0,1,1
15197,erbjuder,0,0,1,1
15199,obligation,0,0,1,1
15205,لبعضهما,0,0,1,1
15208,இருக்கிறோம்,0,0,1,1
15209,швеции,0,0,1,1
15210,embaixo,0,0,1,1
15178,вонючая,0,0,1,1
15177,supported,0,0,1,1
15176,जड़ी,0,0,1,1
15174,diretivo,0,0,1,1
15148,autoproduction,0,0,1,1
15149,ficará,0,0,1,1
15150,pasas,0,0,1,1
15152,घुस,0,0,1,1
15157,reenters,0,0,1,1
15158,бегло,0,0,1,1
15159,പരിശീലനങ്ങളെക്കുറിച്ചും,0,0,1,1
15160,സ്വതന്ത്രമായ,0,0,1,1
15164,disruptive,0,0,1,1
15168,πηγής,0,0,1,1
15169,தொடங்க,0,0,1,1
15170,தூங்கும்போது,0,0,1,1
15171,количеству,0,0,1,1
15172,inedible,0,0,1,1
15173,scolastique ,0,0,1,1
15211,мозгу,0,0,1,1
15213,ಕಲಿಯಲು,0,0,1,1
15268,концепцию,0,0,1,1
15256,அமைதிப்படுத்திக்,0,0,1,1
15242,aardappelen,0,0,1,1
15243,ومقاومته,0,0,1,1
15246,dépendent,0,0,1,1
15247,yapacaklarını,0,0,1,1
15251,spams,0,0,1,1
15253,unterbreche,0,0,1,1
15255,turned,0,0,1,1
15257,wikipediawatchorg,0,0,1,1
15215,kontakten,0,0,1,1
15258,உள்ளடக்க,0,0,1,1
15259,chamou,0,0,1,1
15262,وجدوا,0,0,1,1
15263,ग्रह,0,0,1,1
15264,اصبروا,0,0,1,1
15265,തൂങ്ങുക,0,0,1,1
15266,messages,0,0,1,1
15241,biodiésel,0,0,1,1
15240,innehållsstyrande,0,0,1,1
15239,recht,0,0,1,1
15237,except,0,0,1,1
15216,apport,0,0,1,1
15217,tat,0,0,1,1
15218,البطاطس,0,0,1,1
15219,പിടിച്ചില്ലെന്ന്,0,0,1,1
15222,താഴേക്കും,0,0,1,1
15223,consultores,0,0,1,1
15225,سانجر،,0,0,1,1
15226,bağlantı,0,0,1,1
15227,hunting,0,0,1,1
15228,hvornår,0,0,1,1
15230,undeveloped,0,0,1,1
15232,καλές,0,0,1,1
15233,kwartaal,0,0,1,1
15234,шоу,0,0,1,1
15235,ضخم,0,0,1,1
15147,كريم؟,0,0,1,1
15146,bovendien,0,0,1,1
15145,എഡിറ്റ്,0,0,1,1
15070,"
वेल्श",0,0,1,1
15061,விற்றதை,0,0,1,1
15064,retirado,0,0,1,1
15065,limitée,0,0,1,1
15066,determinación,0,0,1,1
15067,شخصا,0,0,1,1
15068,سكان,0,0,1,1
15069,മതിയായ,0,0,1,1
15071,വിക്കിയിൽ,0,0,1,1
15144,herum,0,0,1,1
15072,സമീപനത്തിന്,0,0,1,1
15077,πούλησες,0,0,1,1
15078,klikke,0,0,1,1
15079,asuntos,0,0,1,1
15081,ತಿರುಗುತ್ತಾನೆ,0,0,1,1
15082,viquipedia,0,0,1,1
15083,öğrenebilirsiniz,0,0,1,1
15055,иду,0,0,1,1
15052,naked,0,0,1,1
15051,ಮುಖದ,0,0,1,1
15050,احتمالية,0,0,1,1
15019,സൃഷ്ടിച്ച്,0,0,1,1
15021,मुस्कुराने,0,0,1,1
15025,രാജകുമാരനെയോ,0,0,1,1
15026,oneerlijke,0,0,1,1
15028,சோர்வாகவும்,0,0,1,1
15029,تستطع,0,0,1,1
15032,أعطى,0,0,1,1
15033,weken,0,0,1,1
15036,relatar,0,0,1,1
15037,άνθρωποι,0,0,1,1
15039,disagreeing,0,0,1,1
15040,ميتشيل,0,0,1,1
15043,لصدفة,0,0,1,1
15046,aprendizado,0,0,1,1
15048,ilgisizlik,0,0,1,1
15084,praktijk,0,0,1,1
15091,libresoft,0,0,1,1
15093,substantia,0,0,1,1
15117,находящихся,0,0,1,1
15119,ತೊಂದರೆಗೊಳಿಸಿದ್ದಕ್ಕೆ,0,0,1,1
15120,atteignait,0,0,1,1
15121,президентские,0,0,1,1
15127,vanvittigt,0,0,1,1
15129,συνεχίσεις,0,0,1,1
15130,സ്വതന്ത്രനാണ്,0,0,1,1
15131,consultables,0,0,1,1
15132,sahip,0,0,1,1
15133,attesté,0,0,1,1
15134,fassiez,0,0,1,1
15136,சாங்கரையேச்,0,0,1,1
15137,fliken,0,0,1,1
15138,uppfattar,0,0,1,1
15141,hicieras,0,0,1,1
15143,forskningsstandarder,0,0,1,1
15118,çıkmasını,0,0,1,1
15115,законов,0,0,1,1
15095,بإرسال,0,0,1,1
15114,confunde,0,0,1,1
15097,spicules,0,0,1,1
15098,பயன்படுத்தப்படலாம்,0,0,1,1
15099,ορίζουν,0,0,1,1
15100,werkwoord,0,0,1,1
15101,запутаетесь,0,0,1,1
15102,وتوقيت,0,0,1,1
15103,positionnement,0,0,1,1
15105,الحساسة,0,0,1,1
15106,verschiedene,0,0,1,1
15107,fixed,0,0,1,1
15109,somehow,0,0,1,1
15110,informático,0,0,1,1
15111,suspected,0,0,1,1
15112,oud,0,0,1,1
15113,editan,0,0,1,1
15267,llama,0,0,1,1
15269,reddit,0,0,1,1
14544,efficiency,0,0,1,1
15439,рэнди,0,0,1,1
15428,बॉक्स,0,0,1,1
15429,இலவசமா,0,0,1,1
15430,يبتسم,0,0,1,1
15432,поддержанию,0,0,1,1
15434,varient,0,0,1,1
15435,identifiant,0,0,1,1
15436,hawaiano​,0,0,1,1
15441,voorbij,0,0,1,1
15454,существенное,0,0,1,1
15443,ಪಡೆಯಬೇಕು,0,0,1,1
15445,μαγική,0,0,1,1
15447,الشقيقة،,0,0,1,1
15449,അർത്ഥമാണ്,0,0,1,1
15450,воды,0,0,1,1
15451,لكلمتين,0,0,1,1
15452,kina,0,0,1,1
15427,приписывается,0,0,1,1
15424,ecstatic,0,0,1,1
15423,முடிக்கிறேன்,0,0,1,1
15422,മൂർച്ചയുള്ളതും,0,0,1,1
15400,दाईं,0,0,1,1
15401,призваны,0,0,1,1
15402,barnskyddslagstiftning,0,0,1,1
15403,"
स्वाहिली",0,0,1,1
15407,antiélitisme,0,0,1,1
15408,referenciadas,0,0,1,1
15409,بالخارج,0,0,1,1
15410,مساهمين,0,0,1,1
15411,yield,0,0,1,1
15413,ecosystems,0,0,1,1
15416,anrufer,0,0,1,1
15417,حياديتها،,0,0,1,1
15418,scotland,0,0,1,1
15419,"
उदाहरण",0,0,1,1
15420,الاعتماد،,0,0,1,1
15453,уволены,0,0,1,1
15456,noemt,0,0,1,1
15270,रहस्य,0,0,1,1
15509,trevligare,0,0,1,1
15493,wind,0,0,1,1
15494,പഠനത്തിന്,0,0,1,1
15496,барак,0,0,1,1
15500,محل,0,0,1,1
15503,ряда,0,0,1,1
15504,failures,0,0,1,1
15506,поговорить,0,0,1,1
15510,«истина,0,0,1,1
15457,பயன்படுத்துவீர்கள்,0,0,1,1
15511,aufgewacht,0,0,1,1
15513,unfortunately,0,0,1,1
15517,εκείνο,0,0,1,1
15519,исследовательский,0,0,1,1
15520,ειλικρινά,0,0,1,1
15522,οποτεδήποτε,0,0,1,1
15525,recherche ,0,0,1,1
15492,décerné,0,0,1,1
15491,бесплатно,0,0,1,1
15489,régions,0,0,1,1
15488,विज्ञापनपर,0,0,1,1
15461,vandalized,0,0,1,1
15467,damerna,0,0,1,1
15470,новую,0,0,1,1
15471,citaträtten,0,0,1,1
15473,baker,0,0,1,1
15474,στατιστικές,0,0,1,1
15475,സഹായത്തിനായി,0,0,1,1
15477,tartışılır,0,0,1,1
15478,excel,0,0,1,1
15479,billions,0,0,1,1
15480,infrequent,0,0,1,1
15484,αλήθεια,0,0,1,1
15485,tillåtna,0,0,1,1
15486,seriös,0,0,1,1
15487,ഉണ്ടാവും,0,0,1,1
15399,ka •,0,0,1,1
15396,compactness,0,0,1,1
15395,വ്യവസ്ഥിതികളുടെയും,0,0,1,1
15314,distribuable,0,0,1,1
15302,readability,0,0,1,1
15303,volvería,0,0,1,1
15304,ألواح,0,0,1,1
15306,ಸುಂದರವಾಗಿದ್ದನು,0,0,1,1
15307,anulada,0,0,1,1
15311,பொம்மை,0,0,1,1
15312,बदलने,0,0,1,1
15315,persistent,0,0,1,1
15394,nyare,0,0,1,1
15316,webs,0,0,1,1
15320,ಸಮಾಚಾರ,0,0,1,1
15321,لأمها,0,0,1,1
15324,essayait,0,0,1,1
15325,exacta,0,0,1,1
15328,கட்டுப்பாடில்லாத,0,0,1,1
15329,fdl,0,0,1,1
15300,उठाये,0,0,1,1
15299,internetanvändare,0,0,1,1
15298,uygunluğu,0,0,1,1
15297,അഥവാ,0,0,1,1
15271,factuais,0,0,1,1
15273,vocation,0,0,1,1
15274,википедистов,0,0,1,1
15275,март,0,0,1,1
15276,forsøgte,0,0,1,1
15277,وعندما,0,0,1,1
15280,conditional,0,0,1,1
15281,गईं।,0,0,1,1
15282,கட்டுரைகளான,0,0,1,1
15283,trentaine,0,0,1,1
15284,പുതിയതായി,0,0,1,1
15285,kabuğumun,0,0,1,1
15292,isn,0,0,1,1
15294,"
कुर्द",0,0,1,1
15296,നോക്കിയിരുന്നു,0,0,1,1
15331,ನೋಡಿದಾಗಿನಿಂದ,0,0,1,1
15332,import,0,0,1,1
15333,ಪ್ರೀತಿಸುತ್ತಿಲ್ಲ,0,0,1,1
15367,computation,0,0,1,1
15370,davranış,0,0,1,1
15371,yayımlanmış,0,0,1,1
15373,ಪ್ರಯಾಣಿಸುತ್ತಿದ್ದಾಗ,0,0,1,1
15376,revenues,0,0,1,1
15377,ತಲುಪಿತು,0,0,1,1
15378,probablement,0,0,1,1
15380,разграничение,0,0,1,1
15381,актов,0,0,1,1
15383,للإنترنت,0,0,1,1
15384,basada,0,0,1,1
15385,объективно,0,0,1,1
15388,υπηρέτησε,0,0,1,1
15390,വലുതുമായ,0,0,1,1
15391,darunter,0,0,1,1
15393,மங்கலான,0,0,1,1
15368,ತೊಂದರೆಗೊಳಗಾಗಿದ್ದೇನೆ,0,0,1,1
15366,formaliserat,0,0,1,1
15334,серверные,0,0,1,1
15365,conocen,0,0,1,1
15338,haklısın,0,0,1,1
15339,മരിയനെ,0,0,1,1
15340,ഭാഷാസ്വാധീനമുണ്ടാവും,0,0,1,1
15343,aşağıya,0,0,1,1
15345,främjas,0,0,1,1
15349,heavily,0,0,1,1
15350,contextdependent,0,0,1,1
15351,archive,0,0,1,1
15353,vinod,0,0,1,1
15355,intelligentie,0,0,1,1
15357,ран,0,0,1,1
15358,rob,0,0,1,1
15360,लाल,0,0,1,1
15362,അവർക്ക്,0,0,1,1
15364,വിലയിരുത്തുന്നു,0,0,1,1
15018,vokse,0,0,1,1
15016,incluyen,0,0,1,1
15015,doğa,0,0,1,1
14708,introduces,0,0,1,1
14695,relaterade,0,0,1,1
14696,medley,0,0,1,1
14699,انتقل,0,0,1,1
14701,falsehoods,0,0,1,1
14702,فوقي,0,0,1,1
14706,классификаторы,0,0,1,1
14707,уроке,0,0,1,1
14709,असफलता,0,0,1,1
14726,"
दूसरे",0,0,1,1
14710,constituted,0,0,1,1
14714,scheibe,0,0,1,1
14715,confeccionar,0,0,1,1
14716,gemeten,0,0,1,1
14717,concentrée,0,0,1,1
14718,أريكتك,0,0,1,1
14722,placozoans—animals,0,0,1,1
14694,നിർവചനത്തെയാണ്,0,0,1,1
14693,échoué,0,0,1,1
14692,wending,0,0,1,1
14690,ನಿನ್ನೆ,0,0,1,1
14664,generalize,0,0,1,1
14667,applicable,0,0,1,1
14668,zufällig,0,0,1,1
14669,initiatieven,0,0,1,1
14671,beskrivit,0,0,1,1
14673,community ,0,0,1,1
14675,കഴിക്കുന്നു,0,0,1,1
14676,lesser,0,0,1,1
14677,போராடிய,0,0,1,1
14678,நண்பர்களிடம்,0,0,1,1
14681,bicholim,0,0,1,1
14685,sınavınız,0,0,1,1
14686,والعربية,0,0,1,1
14687,ಹೇಳಿದ್ದಳು,0,0,1,1
14688,ethane,0,0,1,1
14724,seslendirilmiş,0,0,1,1
14727,blacking,0,0,1,1
15014,partner,0,0,1,1
14761,തണുത്തവരായിരിക്കാൻ,0,0,1,1
14754,இதற்கான,0,0,1,1
14755,condicionales,0,0,1,1
14756,وأنتم,0,0,1,1
14757,ödül,0,0,1,1
14758,nyhetsmedia,0,0,1,1
14759,ಅಷ್ಟಾಗಿ,0,0,1,1
14760,envoyé,0,0,1,1
14762,teller,0,0,1,1
14728,chefe,0,0,1,1
14763,negotiation»,0,0,1,1
14764,வரைவிலக்கணம்,0,0,1,1
14765,comienzo,0,0,1,1
14770,papel,0,0,1,1
14772,प्रतिनिधि,0,0,1,1
14773,والدتك,0,0,1,1
14774,importância,0,0,1,1
14753,κατάλαβα,0,0,1,1
14752,ചുറ്റിപ്പറ്റിയുള്ള,0,0,1,1
14750,правило,0,0,1,1
14749,konular,0,0,1,1
14729,jugements,0,0,1,1
14730,ежегодном,0,0,1,1
14732,bildbank,0,0,1,1
14734,paren,0,0,1,1
14735,chartier,0,0,1,1
14736,tutuklular,0,0,1,1
14737,transition,0,0,1,1
14739,ekmeme,0,0,1,1
14740,leuke,0,0,1,1
14741,no •,0,0,1,1
14742,wikicodeq,0,0,1,1
14743,commentaires,0,0,1,1
14744,actualización,0,0,1,1
14747,doorheeft,0,0,1,1
14748,« seuls,0,0,1,1
14662,αμερόληπτα,0,0,1,1
14660,இறைச்சி,0,0,1,1
14658,adressen,0,0,1,1
14583,transformer,0,0,1,1
14571,எதிர்மறையாக,0,0,1,1
14572,knappen,0,0,1,1
14575,principlenote,0,0,1,1
14577,கட்டைவிரலைக்,0,0,1,1
14579,égoïste,0,0,1,1
14580,contrastes,0,0,1,1
14581,ಣಾತ್ಮಕವಾಗಿರಬಹುದು,0,0,1,1
14585,മൂന്നുപേരും,0,0,1,1
14657,целом,0,0,1,1
14586,coauteurs,0,0,1,1
14589,lagförslag,0,0,1,1
14591,لتأثير,0,0,1,1
14592,epost,0,0,1,1
14593,aborígenes,0,0,1,1
14596,reikte,0,0,1,1
14599,материнарциссе,0,0,1,1
14568,tapez,0,0,1,1
14567,réaction,0,0,1,1
14566,நம்,0,0,1,1
14565,fou,0,0,1,1
14545,extensions,0,0,1,1
14546,solapa,0,0,1,1
14549,bære,0,0,1,1
14550,kolaydır,0,0,1,1
14551,cezaevlerinde,0,0,1,1
14552,svmwikipediaorg,0,0,1,1
14553,ഭക്ഷണവും,0,0,1,1
14554,tidens,0,0,1,1
14555,variétés,0,0,1,1
14556,negativas,0,0,1,1
14557,artigt,0,0,1,1
14560,participante,0,0,1,1
14562,провели,0,0,1,1
14563,hæren,0,0,1,1
14564,inférieure,0,0,1,1
14600,سنوات,0,0,1,1
14602,الجميع,0,0,1,1
14603,вопросами,0,0,1,1
14629,dedicaba,0,0,1,1
14632,бесплатного,0,0,1,1
14633,sansade,0,0,1,1
14635,desfazer,0,0,1,1
14636,apresentação,0,0,1,1
14637,preassigned,0,0,1,1
14638,выполнять,0,0,1,1
14642,traduzido,0,0,1,1
14647,beweerde,0,0,1,1
14648,ഇന്ന്‌,0,0,1,1
14649,zeros,0,0,1,1
14650,بأنك,0,0,1,1
14651,имевшихся,0,0,1,1
14652,attracting,0,0,1,1
14654,शब्दजाल,0,0,1,1
14655,википедиях,0,0,1,1
14631,pudiste,0,0,1,1
14628,anunciou,0,0,1,1
14605,weekendontdekking,0,0,1,1
14627,“பிஎச்பி”,0,0,1,1
14607,സ്വകാര്യലാഭത്തിനു,0,0,1,1
14608,betrekkelijk,0,0,1,1
14609,reporters,0,0,1,1
14610,teklif,0,0,1,1
14611,неверными,0,0,1,1
14612,скопирована,0,0,1,1
14613,användes,0,0,1,1
14616,ವಿವರಣಾ,0,0,1,1
14617,frygt,0,0,1,1
14618,alloué,0,0,1,1
14619,deveriam,0,0,1,1
14620,रेडियो,0,0,1,1
14621,voudrait,0,0,1,1
14625,graham,0,0,1,1
14626,बेहतरीन,0,0,1,1
14776,ky •,0,0,1,1
14779,αγγελιοφόρου,0,0,1,1
14781,उठा,0,0,1,1
14941,algorithmiques,0,0,1,1
14932,opbeuren,0,0,1,1
14933,இழந்துவிட்டேன்,0,0,1,1
14934,تستأنف,0,0,1,1
14935,parlamentosu,0,0,1,1
14937,تزيد,0,0,1,1
14938,задача,0,0,1,1
14939,passwort,0,0,1,1
14942,удалена,0,0,1,1
14897,वही,0,0,1,1
14945,வழிகளைத்,0,0,1,1
14946,incompetentes,0,0,1,1
14947,"
वैनितियाई",0,0,1,1
14948,ஒருபோதும்,0,0,1,1
14949,തോന്നുന്ന,0,0,1,1
14950,hazırlayıp,0,0,1,1
14953,خوان,0,0,1,1
14931,ಬಯಸುವ,0,0,1,1
14927,अवधारणा,0,0,1,1
14924,imagina»,0,0,1,1
14922,вышел,0,0,1,1
14901,ಖರೀದಿಸಲು,0,0,1,1
14902,bilgilerden,0,0,1,1
14903,العشرة,0,0,1,1
14905,inativado,0,0,1,1
14906,отображена,0,0,1,1
14907,ಆಶಾದಾಯಕವಾಗಿ,0,0,1,1
14909,sociólogos,0,0,1,1
14910,sérieux,0,0,1,1
14913,воздействий,0,0,1,1
14914,അലക്കു,0,0,1,1
14915,интернетсайт,0,0,1,1
14918,ναρκισσισμός,0,0,1,1
14919,appeared,0,0,1,1
14920,curtindo,0,0,1,1
14921,discrepó,0,0,1,1
14954,ordnade,0,0,1,1
14955,منقوشة,0,0,1,1
14956,получили,0,0,1,1
14985,указанные,0,0,1,1
14987,ಪ್ರತಿಬಿಂಬದಲ್ಲಿ,0,0,1,1
14988,جنوني,0,0,1,1
14991,घोंघे,0,0,1,1
14994,remanescentes,0,0,1,1
14995,değiştirmesiyle,0,0,1,1
14996,populära,0,0,1,1
14997,സുവേ,0,0,1,1
15000,रोचक,0,0,1,1
15001,வடிவம்,0,0,1,1
15003,relationerna,0,0,1,1
15004,ആദ്യശ്രമം,0,0,1,1
15006,भूमण्डल,0,0,1,1
15009,gilla,0,0,1,1
15010,عهد,0,0,1,1
15013,exceto,0,0,1,1
14986,معاديًا,0,0,1,1
14984,உருவாக்குதல்,0,0,1,1
14957,வழக்கத்தை,0,0,1,1
14983,википедияинклюзионизм,0,0,1,1
14958,questionado,0,0,1,1
14959,proposé,0,0,1,1
14964,കണ്ടിട്ട്,0,0,1,1
14965,лицензия,0,0,1,1
14967,retain,0,0,1,1
14970,годах,0,0,1,1
14971,encontradas,0,0,1,1
14973,atende,0,0,1,1
14974,progresiva,0,0,1,1
14975,kämpade,0,0,1,1
14976,"
बांग्ला",0,0,1,1
14977,courte,0,0,1,1
14978,காட்டாது,0,0,1,1
14979,backen,0,0,1,1
14980,correcto,0,0,1,1
14898,recordarte,0,0,1,1
14896,നിർജീവമാണ്,0,0,1,1
14782,произносить,0,0,1,1
14816,träume,0,0,1,1
14808,தொடர்வதற்கு,0,0,1,1
14809,consola,0,0,1,1
14811,ciencias,0,0,1,1
14812,वेबसाइट्स,0,0,1,1
14813,ഇല്ലഅവലംബം,0,0,1,1
14814,التي،,0,0,1,1
14815,editálos,0,0,1,1
14819,போகிறோம்,0,0,1,1
14894,publiceras,0,0,1,1
14820,af •,0,0,1,1
14821,katılım,0,0,1,1
14822,verspreid,0,0,1,1
14823,நேர்மறை,0,0,1,1
14825,iluminado,0,0,1,1
14826,செயற்பாடு’,0,0,1,1
14827,froh,0,0,1,1
14805,mentaal,0,0,1,1
14803,œil,0,0,1,1
14802,gratulera,0,0,1,1
14801,холодным,0,0,1,1
14783,ഒന്നുമില്ല,0,0,1,1
14784,தாயைக்,0,0,1,1
14785,இருவருக்கும்,0,0,1,1
14788,χρησιμοποιεί,0,0,1,1
14789,excitante,0,0,1,1
14790,அறிவித்தார்,0,0,1,1
14791,permaneceu,0,0,1,1
14792,deviendra,0,0,1,1
14793,katkıda,0,0,1,1
14794,открыт,0,0,1,1
14795,ആശയക്കുഴപ്പത്തിലാക്കി,0,0,1,1
14797,methoden,0,0,1,1
14798,stiftelsens,0,0,1,1
14799,disposait,0,0,1,1
14800,nilsson,0,0,1,1
14829,मददगार,0,0,1,1
14831,telefonumu,0,0,1,1
14834,straight,0,0,1,1
14871,നൽകണം,0,0,1,1
14876,إضافي,0,0,1,1
14877,poll,0,0,1,1
14878,предсказывать,0,0,1,1
14879,tellurique,0,0,1,1
14880,genel,0,0,1,1
14881,تشجيع,0,0,1,1
14882,receitas,0,0,1,1
14883,confiaron,0,0,1,1
14885,avser,0,0,1,1
14887,центра,0,0,1,1
14889,tareas,0,0,1,1
14890,"
ईडो",0,0,1,1
14891,kütüphanenin,0,0,1,1
14892,transclusão,0,0,1,1
14893,caducar,0,0,1,1
14874,харуко,0,0,1,1
14865,designation,0,0,1,1
14838,"
macedónio",0,0,1,1
14864,marco,0,0,1,1
14839,кнр,0,0,1,1
14841,irresponsible,0,0,1,1
14842,тест,0,0,1,1
14843,இலக்கணம்,0,0,1,1
14844,പ്രിയപ്പെട്ടവനാണ്,0,0,1,1
14845,всеми,0,0,1,1
14846,جنولينكس,0,0,1,1
14849,звук,0,0,1,1
14850,webpagina,0,0,1,1
14851,motståndare,0,0,1,1
14857,clay,0,0,1,1
14858,handicapant,0,0,1,1
14860,writingclarification,0,0,1,1
14861,പ്രവൃത്തി,0,0,1,1
14862,colaboró,0,0,1,1
9665,webbvyn,0,0,1,1
9664,αναφέρονται,0,0,1,1
9662,drömde,0,0,1,1
3188,eccome.,1,1,0,1
3177,visivamente,1,1,0,1
3178,esigenze,1,1,0,1
3181,motivazione,1,1,0,1
3182,collegate.,1,1,0,1
3183,"avviso,",1,1,0,1
3185,ignori,1,1,0,1
3187,emulati,1,1,0,1
3189,arboreti,1,1,0,1
3208,"crescita,",1,1,0,1
3195,l'email.,1,1,0,1
3198,incentrato,1,1,0,1
3200,pagina.,1,1,0,1
3201,differiscono,1,1,0,1
3202,arrabbiare,1,1,0,1
3203,zoofilia,1,1,0,1
3204,l'africa,1,1,0,1
3176,disponibili.,1,1,0,1
3174,rimarranno,1,1,0,1
3171,trasclusione,1,1,0,1
3166,multistrato,1,1,0,1
3142,zamolli.,1,1,0,1
3143,Jefferson,1,1,0,1
3144,civile.,1,1,0,1
3146,alvinn,1,1,0,1
3147,approfondito,1,1,0,1
3148,​​più,1,1,0,1
3150,"all'articolo,",1,1,0,1
3152,vedono,1,1,0,1
3153,scusandosi.,1,1,0,1
3154,dall'iwa,1,1,0,1
3156,colonie,1,1,0,1
3160,dottrina,1,1,0,1
3161,qual'è,1,1,0,1
3163,sostenne,1,1,0,1
3165,agito.,1,1,0,1
3207,graduale,1,1,0,1
3209,biodiversità.,1,1,0,1
3275,guadagno,1,1,0,1
3259,equilibrio,1,1,0,1
3245,diffuse.,1,1,0,1
3246,candidarsi,1,1,0,1
3247,fossero,1,1,0,1
3252,incontrarti,1,1,0,1
3253,dall'attività,1,1,0,1
3255,generatrice,1,1,0,1
3258,"estetici,",1,1,0,1
3261,circostanze.,1,1,0,1
3210,esaltano,1,1,0,1
3262,tratto,1,1,0,1
3263,stallman.,1,1,0,1
3264,problematiche,1,1,0,1
3265,olandese.,1,1,0,1
3266,raccolga,1,1,0,1
3269,attribuzione,1,1,0,1
3271,esistiti,1,1,0,1
3244,imita,1,1,0,1
3243,aggiornabile,1,1,0,1
3242,"arrivato,",1,1,0,1
3241,debolmente,1,1,0,1
3212,"categorie,",1,1,0,1
3213,all'area,1,1,0,1
3217,destino,1,1,0,1
3218,utilità,1,1,0,1
3219,nero,1,1,0,1
3220,renderti,1,1,0,1
3221,ultravioletta,1,1,0,1
3222,offerti,1,1,0,1
3225,pensieri,1,1,0,1
3228,fattorizzazione,1,1,0,1
3232,"ortografiche,",1,1,0,1
3233,dell'accuratezza,1,1,0,1
3234,sarai,1,1,0,1
3237,l'ampia,1,1,0,1
3239,dettagliare,1,1,0,1
3141,andrebbe,1,1,0,1
3140,dall'economista,1,1,0,1
3137,prosciuga,1,1,0,1
3037,fiacco.,1,1,0,1
3026,"""notizie",1,1,0,1
3027,oscenità,1,1,0,1
3029,sospettava,1,1,0,1
3031,Carr,1,1,0,1
3032,voragine,1,1,0,1
3035,warring.,1,1,0,1
3036,pesantemente,1,1,0,1
3042,locomozione,1,1,0,1
3136,soffrire,1,1,0,1
3043,certezza,1,1,0,1
3044,adattare,1,1,0,1
3048,bibliotecari,1,1,0,1
3051,persistono,1,1,0,1
3053,partecipano,1,1,0,1
3056,concordano,1,1,0,1
3058,California,1,1,0,1
3025,buco,1,1,0,1
3024,obiettività,1,1,0,1
3022,it.wikipedia.org.,1,1,0,1
3021,sviluppano,1,1,0,1
2996,"archiviare,",1,1,0,1
2997,cambiano,1,1,0,1
3001,acquisì,1,1,0,1
3002,digitare,1,1,0,1
3003,deceduto.,1,1,0,1
3004,all'assistenza,1,1,0,1
3005,fase.,1,1,0,1
3006,microfono,1,1,0,1
3007,sull'obiettività,1,1,0,1
3009,f.,1,1,0,1
3011,operazioni.,1,1,0,1
3012,reagiscono,1,1,0,1
3015,dell'innata,1,1,0,1
3016,sanitario,1,1,0,1
3019,espressi,1,1,0,1
3060,asturiana,1,1,0,1
3062,dell'algoritmo,1,1,0,1
3065,auc.,1,1,0,1
3109,frammentari,1,1,0,1
3112,sr.,1,1,0,1
3114,indecente,1,1,0,1
3115,ricercatrice,1,1,0,1
3116,tentato,1,1,0,1
3119,d'attualità».,1,1,0,1
3120,"sì,",1,1,0,1
3121,e/del,1,1,0,1
3122,cipolle,1,1,0,1
3123,aggiustare,1,1,0,1
3125,elogi,1,1,0,1
3126,un'importante,1,1,0,1
3128,campionato,1,1,0,1
3130,oggi.,1,1,0,1
3133,complessivo,1,1,0,1
3135,disciplinate,1,1,0,1
3110,generati,1,1,0,1
3106,visitare,1,1,0,1
3066,interno.,1,1,0,1
3104,probabilisticamente,1,1,0,1
3069,"particolare,",1,1,0,1
3072,toto,1,1,0,1
3073,Maometto.,1,1,0,1
3075,"google,",1,1,0,1
3076,soglia.,1,1,0,1
3081,vederla,1,1,0,1
3082,mantello,1,1,0,1
3084,microonde,1,1,0,1
3085,ambizioso,1,1,0,1
3087,Lo,1,1,0,1
3089,giudicare,1,1,0,1
3090,realizzata,1,1,0,1
3093,terminale,1,1,0,1
3098,razionale,1,1,0,1
3102,sideriano,1,1,0,1
3274,obiettivo.,1,1,0,1
3277,libreria,1,1,0,1
3597,geologiche,1,1,0,1
3497,"sparsa,",1,1,0,1
3483,acquisita,1,1,0,1
3487,democrazia.,1,1,0,1
3488,punizione,1,1,0,1
3489,razza,1,1,0,1
3490,USA,1,1,0,1
3493,appartiene,1,1,0,1
3494,titolo,1,1,0,1
3499,raccontato,1,1,0,1
3515,adeani,1,1,0,1
3501,nati,1,1,0,1
3502,conferiscono,1,1,0,1
3503,dell'avventore,1,1,0,1
3504,"automatica,",1,1,0,1
3507,compresi.,1,1,0,1
3508,seduto,1,1,0,1
3509,mutuata,1,1,0,1
3482,divideva,1,1,0,1
3480,deduceva,1,1,0,1
3479,merito.,1,1,0,1
3478,estendere,1,1,0,1
3452,"youtube,",1,1,0,1
3453,adattabili,1,1,0,1
3454,riutilizzarlo,1,1,0,1
3455,l'infrastruttura,1,1,0,1
3456,timida,1,1,0,1
3457,trattate,1,1,0,1
3458,raggiunge,1,1,0,1
3461,a.C.,1,1,0,1
3463,Sverker,1,1,0,1
3464,appaiono,1,1,0,1
3465,negative.,1,1,0,1
3466,"lineare,",1,1,0,1
3471,uichipèdia,1,1,0,1
3472,trovo,1,1,0,1
3473,abbonamenti,1,1,0,1
3514,innata,1,1,0,1
3517,polemiche,1,1,0,1
3278,regolare,1,1,0,1
3575,aggiornarsi,1,1,0,1
3564,dall'IA,1,1,0,1
3565,decisione.,1,1,0,1
3567,irresponsabile.,1,1,0,1
3568,semplificata,1,1,0,1
3570,detriti,1,1,0,1
3572,vandalizzato,1,1,0,1
3574,morso,1,1,0,1
3577,addestrando,1,1,0,1
3518,bancaria,1,1,0,1
3582,scheda,1,1,0,1
3584,dannosa,1,1,0,1
3589,visualeditor.,1,1,0,1
3591,mostravano,1,1,0,1
3592,"intellettuale,",1,1,0,1
3593,definibile,1,1,0,1
3594,consultare,1,1,0,1
3561,spese,1,1,0,1
3558,quell'anno.,1,1,0,1
3557,ottenute,1,1,0,1
3554,biologiche,1,1,0,1
3519,ossigenazione,1,1,0,1
3521,mobile.,1,1,0,1
3522,"rispondere,",1,1,0,1
3523,l'esatto,1,1,0,1
3524,professoressa,1,1,0,1
3525,ghiacciai.,1,1,0,1
3527,pittura,1,1,0,1
3528,acquistano,1,1,0,1
3534,l'agricoltura.,1,1,0,1
3538,'gli,1,1,0,1
3540,operatori,1,1,0,1
3545,precede,1,1,0,1
3548,Obama,1,1,0,1
3549,tropici,1,1,0,1
3552,tosh.,1,1,0,1
3451,l'estensione,1,1,0,1
3450,milioni.,1,1,0,1
3448,risponde,1,1,0,1
3351,"settembre,",1,1,0,1
3330,traccia,1,1,0,1
3333,"Johansson [sv],",1,1,0,1
3334,"""buoni""",1,1,0,1
3337,autosufficiente,1,1,0,1
3340,sostituzione,1,1,0,1
3345,"convergenti,",1,1,0,1
3346,aristotele,1,1,0,1
3358,possiede,1,1,0,1
3445,addotte,1,1,0,1
3359,zolle,1,1,0,1
3361,Windows,1,1,0,1
3362,inferenza.,1,1,0,1
3363,tentare,1,1,0,1
3364,resta,1,1,0,1
3366,anomali.,1,1,0,1
3367,wikiquette.,1,1,0,1
3329,Gorman,1,1,0,1
3327,paziente,1,1,0,1
3323,amsterdam.,1,1,0,1
3322,tracce,1,1,0,1
3287,loghi,1,1,0,1
3292,esclusività,1,1,0,1
3293,piccole.,1,1,0,1
3297,motorie,1,1,0,1
3299,adeguati,1,1,0,1
3300,individuali,1,1,0,1
3301,equamente,1,1,0,1
3302,"frettolosamente,",1,1,0,1
3303,rispettano,1,1,0,1
3304,proveniva,1,1,0,1
3308,"fondata,",1,1,0,1
3311,dimostrata,1,1,0,1
3312,maschili,1,1,0,1
3314,attraggono,1,1,0,1
3315,future.,1,1,0,1
3368,"polari,",1,1,0,1
3373,"gusci,",1,1,0,1
3376,pomeridiane.,1,1,0,1
3409,primo.,1,1,0,1
3411,"argomenti,",1,1,0,1
3412,formale.,1,1,0,1
3419,menti,1,1,0,1
3420,dell'obiettivo,1,1,0,1
3421,matematicamente,1,1,0,1
3426,"simulazione,",1,1,0,1
3427,aggiornate,1,1,0,1
3428,l'ecosistema.,1,1,0,1
3430,dall'indicizzazione,1,1,0,1
3431,"piano"".",1,1,0,1
3432,Burn,1,1,0,1
3435,pre-assegnate,1,1,0,1
3437,mysql.,1,1,0,1
3442,netti,1,1,0,1
3444,nell'aria,1,1,0,1
3410,intitolata,1,1,0,1
3408,rigorosamente,1,1,0,1
3377,metamorfosate.,1,1,0,1
3403,bandire,1,1,0,1
3378,paragonabile,1,1,0,1
3380,difensori,1,1,0,1
3381,educatamente.,1,1,0,1
3382,simbolico,1,1,0,1
3383,rimasero,1,1,0,1
3387,omogenei.,1,1,0,1
3388,malefatta,1,1,0,1
3389,verificabili,1,1,0,1
3393,vicedirettore,1,1,0,1
3394,fornirebbe,1,1,0,1
3395,contributi.,1,1,0,1
3396,importanza.,1,1,0,1
3400,comparato,1,1,0,1
3401,monumento,1,1,0,1
3402,cellulare,1,1,0,1
2995,liberta',1,1,0,1
2994,tuttora,1,1,0,1
2993,biografici,1,1,0,1
2588,fnr.,1,1,0,1
2574,ribasso,1,1,0,1
2576,difettoso.,1,1,0,1
2577,limitato.,1,1,0,1
2578,archeani,1,1,0,1
2582,«dati,1,1,0,1
2583,organizzati,1,1,0,1
2584,telefonata,1,1,0,1
2589,fondamentalmente,1,1,0,1
2602,"invalidate,",1,1,0,1
2591,ridistribuirli,1,1,0,1
2592,assegnando,1,1,0,1
2593,reinvenzione,1,1,0,1
2594,telefoni,1,1,0,1
2596,noiosa.,1,1,0,1
2597,gfdl.,1,1,0,1
2598,sistemazione,1,1,0,1
2572,distinti,1,1,0,1
2571,parlante.,1,1,0,1
2569,campiona,1,1,0,1
2565,mostrare,1,1,0,1
2540,collegati.,1,1,0,1
2543,"programmi,",1,1,0,1
2544,altrove,1,1,0,1
2547,estinsero.,1,1,0,1
2549,frutta,1,1,0,1
2551,University,1,1,0,1
2553,raddoppio,1,1,0,1
2557,divieti,1,1,0,1
2558,genetico),1,1,0,1
2559,interagiscono,1,1,0,1
2560,culla,1,1,0,1
2561,titano,1,1,0,1
2562,geologici,1,1,0,1
2563,susan,1,1,0,1
2564,"seigenthaler,",1,1,0,1
2600,incoraggia,1,1,0,1
2604,specializzazione,1,1,0,1
2990,eucarioti,1,1,0,1
2670,boccone,1,1,0,1
2649,priorità.,1,1,0,1
2652,"premiazione,",1,1,0,1
2653,nascono,1,1,0,1
2654,finlandese,1,1,0,1
2656,lumaca.,1,1,0,1
2659,frantumata,1,1,0,1
2664,dell'esercito,1,1,0,1
2671,biotica,1,1,0,1
2607,l'intervallo,1,1,0,1
2674,Journalism,1,1,0,1
2675,enormemente,1,1,0,1
2676,aggiuntivi,1,1,0,1
2678,crosta,1,1,0,1
2679,[chiarimento,1,1,0,1
2680,potesse,1,1,0,1
2681,spedizioni,1,1,0,1
2648,americana.,1,1,0,1
2647,uragani,1,1,0,1
2646,qrpedia,1,1,0,1
2641,necessario.,1,1,0,1
2609,spam.,1,1,0,1
2611,desiderati.,1,1,0,1
2612,distolse,1,1,0,1
2615,/peˈdia/,1,1,0,1
2617,distribuiti,1,1,0,1
2619,wikivoyage.,1,1,0,1
2620,responsabilità”.,1,1,0,1
2621,lighting,1,1,0,1
2622,Manning,1,1,0,1
2623,impiegassero,1,1,0,1
2624,enciclopedici.,1,1,0,1
2625,richiedeva,1,1,0,1
2628,dichiarazioni,1,1,0,1
2631,andati,1,1,0,1
2639,mensili,1,1,0,1
2538,grafici.,1,1,0,1
2536,immaginaria.,1,1,0,1
2529,Ciao,1,1,0,1
2441,etico,1,1,0,1
2433,suggerendo,1,1,0,1
2434,mirati,1,1,0,1
2436,Wordsworth,1,1,0,1
2437,sparsi,1,1,0,1
2438,vulcanico,1,1,0,1
2439,aiutare.,1,1,0,1
2440,verificatosi.,1,1,0,1
2442,specializzato,1,1,0,1
2527,etimologicamente,1,1,0,1
2443,dottrine,1,1,0,1
2444,approssimativamente.,1,1,0,1
2445,rivisti,1,1,0,1
2447,autoreplicante,1,1,0,1
2448,cancerosi.,1,1,0,1
2449,Library,1,1,0,1
2450,attualità.,1,1,0,1
2432,contare,1,1,0,1
2429,affrontati.,1,1,0,1
2427,affidabilità.,1,1,0,1
2426,Adaptive,1,1,0,1
2396,identificabili.,1,1,0,1
2398,restrittiva,1,1,0,1
2399,bisogna,1,1,0,1
2401,neri.,1,1,0,1
2402,incarnati,1,1,0,1
2405,scorrono,1,1,0,1
2406,intromettono.,1,1,0,1
2409,nostre,1,1,0,1
2411,geolocalizzazione,1,1,0,1
2414,multilineare,1,1,0,1
2415,finale,1,1,0,1
2420,affine,1,1,0,1
2423,accompagnato,1,1,0,1
2424,remunerati,1,1,0,1
2425,licenziatari,1,1,0,1
2451,dell'umanità,1,1,0,1
2452,bambini.,1,1,0,1
2454,docenti,1,1,0,1
2496,l'autoapprendimento,1,1,0,1
2499,appare,1,1,0,1
2501,l'argomento,1,1,0,1
2502,iniziarono,1,1,0,1
2503,rivolto,1,1,0,1
2504,"fotosintesi,",1,1,0,1
2506,internet.,1,1,0,1
2508,td-gammon,1,1,0,1
2510,quanti,1,1,0,1
2511,"Marte,",1,1,0,1
2512,rimodellarle,1,1,0,1
2514,magnetico.,1,1,0,1
2518,"irrilevante,",1,1,0,1
2521,l'adattamento,1,1,0,1
2522,elica,1,1,0,1
2523,introdurre,1,1,0,1
2498,insegnare,1,1,0,1
2495,giovanni,1,1,0,1
2459,prepuberale,1,1,0,1
2494,marea.,1,1,0,1
2467,nell'incidente,1,1,0,1
2468,[che,1,1,0,1
2469,alimentato,1,1,0,1
2471,cartella,1,1,0,1
2476,robuste,1,1,0,1
2480,"automatici,",1,1,0,1
2482,anomali,1,1,0,1
2483,schiantato,1,1,0,1
2485,favoriscono,1,1,0,1
2486,tolosa,1,1,0,1
2487,avviata,1,1,0,1
2488,interrotto,1,1,0,1
2489,"persona,",1,1,0,1
2492,spera.,1,1,0,1
2493,eroe,1,1,0,1
2684,dell'analisi,1,1,0,1
2692,dall'ultima,1,1,0,1
2693,domini.,1,1,0,1
2894,studente.,1,1,0,1
2886,soddisfacente.,1,1,0,1
2887,legale,1,1,0,1
2889,giudiziarie.,1,1,0,1
2890,idrocarburi,1,1,0,1
2891,organiche,1,1,0,1
2892,"Society,",1,1,0,1
2893,espressamente,1,1,0,1
2896,rivisto,1,1,0,1
2851,necessaria.,1,1,0,1
2897,invasi,1,1,0,1
2899,pietra,1,1,0,1
2900,{onionspotatoes}⇒{burger}{\displaystyle,1,1,0,1
2903,ecoregione,1,1,0,1
2906,mossi,1,1,0,1
2907,concorrenza,1,1,0,1
2908,interessato.,1,1,0,1
2884,vernice,1,1,0,1
2882,citino,1,1,0,1
2881,-page,1,1,0,1
2880,ligure,1,1,0,1
2853,aggiunte,1,1,0,1
2857,frega,1,1,0,1
2858,regolata,1,1,0,1
2860,amica,1,1,0,1
2861,ormai,1,1,0,1
2862,pregiudizievoli,1,1,0,1
2863,/ˈviki/,1,1,0,1
2865,"risposta,",1,1,0,1
2867,matrici,1,1,0,1
2869,newsweek,1,1,0,1
2870,paradossi,1,1,0,1
2874,sentirai,1,1,0,1
2876,"dollari,",1,1,0,1
2878,karcher.,1,1,0,1
2879,coscienziosi,1,1,0,1
2909,Möller,1,1,0,1
2911,fukushima.,1,1,0,1
2913,all'uscita,1,1,0,1
2944,ristampe,1,1,0,1
2950,attivista,1,1,0,1
2952,ecc,1,1,0,1
2956,esperienza.,1,1,0,1
2957,reportage,1,1,0,1
2961,osservare.,1,1,0,1
2964,stimare,1,1,0,1
2967,dipenda,1,1,0,1
2968,«…rappresenta,1,1,0,1
2970,Eraclito,1,1,0,1
2974,russo.,1,1,0,1
2979,all-inclusive,1,1,0,1
2981,"straordinario,",1,1,0,1
2984,credo.,1,1,0,1
2986,l'azione,1,1,0,1
2988,"affondare,",1,1,0,1
2948,un'interrogazione,1,1,0,1
2943,rosenblatt,1,1,0,1
2914,disponibilità,1,1,0,1
2942,navigazione,1,1,0,1
2915,"divulgati,",1,1,0,1
2918,prescindere,1,1,0,1
2920,primitivi,1,1,0,1
2921,eseguite,1,1,0,1
2922,cullare,1,1,0,1
2924,campagna,1,1,0,1
2925,perde,1,1,0,1
2926,coreano,1,1,0,1
2927,a.,1,1,0,1
2929,obiettivi.,1,1,0,1
2930,coordinare,1,1,0,1
2931,svolto.,1,1,0,1
2932,avremmo,1,1,0,1
2935,anormale,1,1,0,1
2936,finiscono,1,1,0,1
2852,sufficienza,1,1,0,1
2845,"meta-wiki,",1,1,0,1
2694,Lasciami,1,1,0,1
2746,partnership,1,1,0,1
2732,nupedia.com,1,1,0,1
2733,all'evoluzione,1,1,0,1
2734,necessarie.,1,1,0,1
2736,"collaboratore,",1,1,0,1
2740,dell'identità,1,1,0,1
2743,sull'attuale,1,1,0,1
2745,proprietà.,1,1,0,1
2747,saggistica,1,1,0,1
2844,variare,1,1,0,1
2748,[i],1,1,0,1
2749,prevenuti,1,1,0,1
2750,"arrestata,",1,1,0,1
2752,piedi.,1,1,0,1
2759,ucraino,1,1,0,1
2760,segnali.,1,1,0,1
2764,fiorire,1,1,0,1
2731,specifica.,1,1,0,1
2730,percepiti,1,1,0,1
2728,ricorreva,1,1,0,1
2727,passiva,1,1,0,1
2695,svolgeva,1,1,0,1
2696,"storici,",1,1,0,1
2698,stupefacente,1,1,0,1
2700,coniò,1,1,0,1
2707,wikipress,1,1,0,1
2709,"verità,",1,1,0,1
2711,l'artificiale,1,1,0,1
2714,temi,1,1,0,1
2716,extrasolari:,1,1,0,1
2717,apparizioni,1,1,0,1
2718,organizzano,1,1,0,1
2719,coesistevano,1,1,0,1
2720,necessita,1,1,0,1
2724,l'esatta,1,1,0,1
2726,corteggiatori,1,1,0,1
2766,svegliato,1,1,0,1
2770,all'ultimo,1,1,0,1
2771,networks.,1,1,0,1
2804,multicellulari.,1,1,0,1
2809,femmine,1,1,0,1
2813,immangiabile,1,1,0,1
2817,gofai,1,1,0,1
2818,immagazzinano,1,1,0,1
2819,definitivo,1,1,0,1
2820,sull'influenza,1,1,0,1
2821,compilazione,1,1,0,1
2823,lucio,1,1,0,1
2826,reciprocamente,1,1,0,1
2830,lavanderia.,1,1,0,1
2831,inviato.,1,1,0,1
2832,cadavere,1,1,0,1
2839,spugne,1,1,0,1
2840,richiese,1,1,0,1
2841,riscontrabili,1,1,0,1
2806,contenuto.,1,1,0,1
2803,nomi.,1,1,0,1
2773,latitudine,1,1,0,1
2802,dell'aumento,1,1,0,1
2774,moto,1,1,0,1
2775,applicano,1,1,0,1
2777,cellulari.,1,1,0,1
2781,apporto,1,1,0,1
2782,espansioni,1,1,0,1
2783,transazioni.,1,1,0,1
2785,etiche,1,1,0,1
2788,corrispondere,1,1,0,1
2792,veridicità,1,1,0,1
2794,"learning,",1,1,0,1
2795,​​su,1,1,0,1
2796,selvatiche,1,1,0,1
2797,dell'intervento,1,1,0,1
2798,Kimmel,1,1,0,1
2800,includeva,1,1,0,1
3596,valutata,1,1,0,1
3599,tossici,1,1,0,1
2387,farebbe.,1,1,0,1
4450,sociali,1,1,0,1
4435,trasformarle,1,1,0,1
4440,dell'encyclopædia,1,1,0,1
4442,«curare,1,1,0,1
4445,cambiare.,1,1,0,1
4446,retribuita,1,1,0,1
4447,classe.,1,1,0,1
4448,legata,1,1,0,1
4451,ingegneri,1,1,0,1
4467,divenendo,1,1,0,1
4456,metano.,1,1,0,1
4457,un'etichetta,1,1,0,1
4458,romancio,1,1,0,1
4459,"l'altro,",1,1,0,1
4463,riprodursi.,1,1,0,1
4464,costituisca,1,1,0,1
4465,Sarebbe,1,1,0,1
4431,influenzano,1,1,0,1
4430,rivista.,1,1,0,1
4429,l'acquisizione,1,1,0,1
4427,collar,1,1,0,1
4398,all'editor,1,1,0,1
4401,dall'autore,1,1,0,1
4402,interconnessi.,1,1,0,1
4403,politici.,1,1,0,1
4404,biologico.,1,1,0,1
4409,giappone.,1,1,0,1
4411,d'uso,1,1,0,1
4413,trans.,1,1,0,1
4414,schizzi,1,1,0,1
4415,asiatica.,1,1,0,1
4417,atmosferiche,1,1,0,1
4419,dicotomia,1,1,0,1
4420,tutto.,1,1,0,1
4422,"rari,",1,1,0,1
4426,audace,1,1,0,1
4466,maschile,1,1,0,1
4468,"l'esame,",1,1,0,1
4559,gratuito.,1,1,0,1
4540,ricoperto,1,1,0,1
4526,"scientifico,",1,1,0,1
4527,"assemblata,",1,1,0,1
4532,provate,1,1,0,1
4534,sii,1,1,0,1
4535,corrispondente.,1,1,0,1
4537,stub.,1,1,0,1
4538,"input,",1,1,0,1
4541,entusiasmanti,1,1,0,1
4473,"use,",1,1,0,1
4545,"Lih,",1,1,0,1
4547,verificata,1,1,0,1
4548,ottanta,1,1,0,1
4549,culminare.,1,1,0,1
4550,facenti,1,1,0,1
4551,correggerli.,1,1,0,1
4553,additandole,1,1,0,1
4525,setta,1,1,0,1
4515,concentrarsi,1,1,0,1
4513,l'interrogativo,1,1,0,1
4512,mammiferi,1,1,0,1
4475,cosiddetta,1,1,0,1
4476,bordi,1,1,0,1
4478,«[wikipedia],1,1,0,1
4480,indipendenza,1,1,0,1
4483,trasferito,1,1,0,1
4484,automatizzata.,1,1,0,1
4485,rivelano,1,1,0,1
4486,aziendali,1,1,0,1
4490,affronti,1,1,0,1
4491,Larry,1,1,0,1
4499,disturbo.se,1,1,0,1
4504,mano.,1,1,0,1
4508,dvd.,1,1,0,1
4509,dichiararono,1,1,0,1
4511,"passato,",1,1,0,1
4396,biblioteconomia,1,1,0,1
4395,affronta,1,1,0,1
4394,acquifere,1,1,0,1
4283,spaziali.,1,1,0,1
4272,Nilsson,1,1,0,1
4273,validazione,1,1,0,1
4275,Oxford,1,1,0,1
4276,"costruita,",1,1,0,1
4278,dall'assunzione,1,1,0,1
4279,L'anarchia,1,1,0,1
4280,divine.,1,1,0,1
4284,generalizzato,1,1,0,1
4387,bagno,1,1,0,1
4288,focalizzato,1,1,0,1
4289,discusso,1,1,0,1
4294,effettivo,1,1,0,1
4295,automatiche.,1,1,0,1
4297,svegliata,1,1,0,1
4302,sysop,1,1,0,1
4303,aspetti,1,1,0,1
4271,temporanei,1,1,0,1
4268,"cura,",1,1,0,1
4267,riconosciuti,1,1,0,1
4266,settentrionale.,1,1,0,1
4234,condotte,1,1,0,1
4240,superficiali.,1,1,0,1
4241,dell'italiano,1,1,0,1
4242,vederlo,1,1,0,1
4243,all'infanzia.,1,1,0,1
4244,Croazia,1,1,0,1
4245,goliardiche,1,1,0,1
4249,recenti.,1,1,0,1
4253,eterotrofi,1,1,0,1
4254,all'ottimizzazione,1,1,0,1
4256,l’apprendimento,1,1,0,1
4259,sottogruppi,1,1,0,1
4260,caduto,1,1,0,1
4261,l'altitudine.,1,1,0,1
4265,carneo,1,1,0,1
4304,minimi,1,1,0,1
4305,separa,1,1,0,1
4306,catalogo,1,1,0,1
4355,aggiornare,1,1,0,1
4358,opt-in,1,1,0,1
4359,fecero,1,1,0,1
4362,predispone,1,1,0,1
4363,"anomalo,",1,1,0,1
4365,lanciati,1,1,0,1
4366,giudizio.,1,1,0,1
4371,intendeva,1,1,0,1
4373,intenzionale era,1,1,0,1
4375,competere,1,1,0,1
4376,ricombinati,1,1,0,1
4377,sollevano,1,1,0,1
4380,implicite,1,1,0,1
4381,consumare,1,1,0,1
4382,costituzionali,1,1,0,1
4385,farebbe,1,1,0,1
4357,eccitiamo,1,1,0,1
4353,votato,1,1,0,1
4307,l'articolo.,1,1,0,1
4352,lui».,1,1,0,1
4308,"Uniti,",1,1,0,1
4309,copyright.,1,1,0,1
4312,"Microsystems,",1,1,0,1
4315,sbagliata,1,1,0,1
4325,dov'eravamo.,1,1,0,1
4329,rivendichi,1,1,0,1
4330,volto,1,1,0,1
4331,vincere,1,1,0,1
4334,"fattorie,",1,1,0,1
4335,ricompense,1,1,0,1
4337,"integrali,",1,1,0,1
4341,all'aumento,1,1,0,1
4344,dell'estinzione,1,1,0,1
4348,risparmiato,1,1,0,1
4349,raccomandazioni,1,1,0,1
4555,lacuna,1,1,0,1
4563,alterare,1,1,0,1
3601,abusi,1,1,0,1
4768,doppio,1,1,0,1
4758,"benvenuto"".",1,1,0,1
4762,partecipare,1,1,0,1
4763,sfera,1,1,0,1
4764,rimuoveremmo.,1,1,0,1
4765,"pagina,",1,1,0,1
4766,separano,1,1,0,1
4767,presocratica,1,1,0,1
4769,finanziata,1,1,0,1
4789,biologica.,1,1,0,1
4778,ampiamente.,1,1,0,1
4780,esistano,1,1,0,1
4781,copriva,1,1,0,1
4783,prigionieri,1,1,0,1
4784,assistere,1,1,0,1
4785,gestire,1,1,0,1
4787,licenziante,1,1,0,1
4756,"percento""",1,1,0,1
4755,specialistico,1,1,0,1
4750,sottostanti,1,1,0,1
4749,e-book,1,1,0,1
4723,reciproche,1,1,0,1
4724,andata,1,1,0,1
4725,Berkman,1,1,0,1
4726,aggiungere,1,1,0,1
4727,l'atto,1,1,0,1
4728,anomalo,1,1,0,1
4732,cooperazione,1,1,0,1
4733,garanzie,1,1,0,1
4736,deflusso,1,1,0,1
4737,"reddit,",1,1,0,1
4741,informativo,1,1,0,1
4744,giovani,1,1,0,1
4746,avviando,1,1,0,1
4747,all'Africa,1,1,0,1
4748,notizia,1,1,0,1
4788,inferiore.,1,1,0,1
4790,negoziabile,1,1,0,1
4564,predetto,1,1,0,1
4845,gilda,1,1,0,1
4834,mediche,1,1,0,1
4835,configurazioni,1,1,0,1
4839,"anomalie,",1,1,0,1
4841,sottorappresentati,1,1,0,1
4842,lunghi,1,1,0,1
4843,ottimizzano,1,1,0,1
4844,Stephen,1,1,0,1
4848,ugo,1,1,0,1
4792,illustrazioni,1,1,0,1
4850,Google.,1,1,0,1
4851,neanche,1,1,0,1
4855,dell'accademico,1,1,0,1
4856,lamentandosi,1,1,0,1
4857,distorte,1,1,0,1
4859,giunto,1,1,0,1
4860,spettroscopia,1,1,0,1
4831,immagazzinata,1,1,0,1
4830,"posizione,",1,1,0,1
4829,atmosferica,1,1,0,1
4827,primordiale.,1,1,0,1
4795,permesso,1,1,0,1
4796,avvolge,1,1,0,1
4799,romagnolo.,1,1,0,1
4801,k-svd.,1,1,0,1
4802,accorgano,1,1,0,1
4803,portoghese.,1,1,0,1
4804,autoapprendere,1,1,0,1
4811,sull'uso,1,1,0,1
4812,dichiarando,1,1,0,1
4813,stimolando,1,1,0,1
4816,sbocco,1,1,0,1
4821,all'ora,1,1,0,1
4822,escludeva,1,1,0,1
4825,ha miliardi,1,1,0,1
4826,adeguatamente,1,1,0,1
4722,riconducibili,1,1,0,1
4719,volutamente,1,1,0,1
4714,all'energia,1,1,0,1
4615,l'unità,1,1,0,1
4605,dizionario.,1,1,0,1
4608,secondario,1,1,0,1
4609,banche,1,1,0,1
4610,chilometri,1,1,0,1
4612,avviene,1,1,0,1
4613,periodo.,1,1,0,1
4614,rintracciato.,1,1,0,1
4618,darwin.,1,1,0,1
4711,lombardo.,1,1,0,1
4619,astronomi,1,1,0,1
4621,consigliate,1,1,0,1
4623,denominate,1,1,0,1
4625,"sconcertata,",1,1,0,1
4633,rendeva,1,1,0,1
4637,epoca,1,1,0,1
4638,provocate,1,1,0,1
4603,visti.,1,1,0,1
4601,eurocentriche,1,1,0,1
4600,dell'editor,1,1,0,1
4599,egiziano,1,1,0,1
4567,professionale,1,1,0,1
4568,ordinato,1,1,0,1
4569,disambiguazione,1,1,0,1
4570,fornite,1,1,0,1
4572,saltare,1,1,0,1
4574,reddito.,1,1,0,1
4575,controtendenza,1,1,0,1
4577,frammentario,1,1,0,1
4578,tecnologia.,1,1,0,1
4579,bacini,1,1,0,1
4580,portabilità,1,1,0,1
4584,vedi.,1,1,0,1
4589,celebra,1,1,0,1
4593,commedia,1,1,0,1
4598,dell'influenza,1,1,0,1
4639,accessi,1,1,0,1
4640,confonde,1,1,0,1
4641,motivato,1,1,0,1
4683,"alto,",1,1,0,1
4686,"'60,",1,1,0,1
4688,all'analisi,1,1,0,1
4692,vicinanze,1,1,0,1
4693,dietro,1,1,0,1
4695,"momento,",1,1,0,1
4696,comica,1,1,0,1
4697,dell'html,1,1,0,1
4698,identificato,1,1,0,1
4699,fantastiche,1,1,0,1
4700,sopravvive,1,1,0,1
4701,/ˌwɪki-/,1,1,0,1
4703,dessi,1,1,0,1
4705,tradotta,1,1,0,1
4706,neve,1,1,0,1
4710,ruoli,1,1,0,1
4685,molecola,1,1,0,1
4680,stimata,1,1,0,1
4643,resti,1,1,0,1
4679,avverte,1,1,0,1
4644,dell'episodio,1,1,0,1
4645,come.,1,1,0,1
4653,connessioni,1,1,0,1
4656,studiati,1,1,0,1
4661,"dall'addestramento,",1,1,0,1
4662,temporaneamente,1,1,0,1
4663,geomorfologia,1,1,0,1
4666,"modi,",1,1,0,1
4667,Città,1,1,0,1
4669,coesione,1,1,0,1
4671,k-fold,1,1,0,1
4672,irrilevante.,1,1,0,1
4673,documentario,1,1,0,1
4676,raggiungendo,1,1,0,1
4677,Bush,1,1,0,1
4233,ricostruire,1,1,0,1
4232,sottoposti,1,1,0,1
4231,"settimana,",1,1,0,1
3822,dichiara,1,1,0,1
3809,sbagliato».,1,1,0,1
3810,congiunzioni,1,1,0,1
3815,"iniziativa,",1,1,0,1
3817,preoccupazioni.,1,1,0,1
3818,saturno,1,1,0,1
3820,appositi,1,1,0,1
3821,geografiche.,1,1,0,1
3824,presa,1,1,0,1
3838,sovvenzione,1,1,0,1
3828,ottimizzazione.,1,1,0,1
3830,seguente,1,1,0,1
3831,un'idea,1,1,0,1
3833,sull'elaborazione,1,1,0,1
3834,familiare,1,1,0,1
3835,pertinenti,1,1,0,1
3836,"gfdl,",1,1,0,1
3808,"placozoi,",1,1,0,1
3805,"vandalismo,",1,1,0,1
3802,disaccordi,1,1,0,1
3801,giuria,1,1,0,1
3769,l'esito,1,1,0,1
3772,didattiche,1,1,0,1
3774,visive,1,1,0,1
3776,"pubblicitario,",1,1,0,1
3780,simboleggiare,1,1,0,1
3782,"formazione,",1,1,0,1
3783,d'informazione,1,1,0,1
3784,l'utilità,1,1,0,1
3787,assistenza,1,1,0,1
3788,vietano,1,1,0,1
3792,artisti,1,1,0,1
3793,sfruttamento,1,1,0,1
3794,mezza,1,1,0,1
3796,ionizzati,1,1,0,1
3800,italiane,1,1,0,1
3837,crescerli,1,1,0,1
3839,paradosso,1,1,0,1
4226,valorizzazione,1,1,0,1
3886,interessa.,1,1,0,1
3876,salato.,1,1,0,1
3877,estetica.,1,1,0,1
3879,opposte,1,1,0,1
3882,dirigono,1,1,0,1
3883,opportunista,1,1,0,1
3884,letargico,1,1,0,1
3885,autoguidata,1,1,0,1
3887,indossavo,1,1,0,1
3840,"esame,",1,1,0,1
3894,nudi.,1,1,0,1
3897,diventeranno,1,1,0,1
3898,manufatti.,1,1,0,1
3899,stanchi,1,1,0,1
3903,elia,1,1,0,1
3904,irregolare».,1,1,0,1
3905,idee.,1,1,0,1
3874,ambientata,1,1,0,1
3873,spaccatura,1,1,0,1
3872,contattato,1,1,0,1
3871,biografie.,1,1,0,1
3841,comportamentale,1,1,0,1
3842,corrente.,1,1,0,1
3846,violare,1,1,0,1
3847,rimodellata,1,1,0,1
3848,l'età,1,1,0,1
3849,sosteneva,1,1,0,1
3852,sistemici.,1,1,0,1
3855,mitigazione,1,1,0,1
3856,necessaria],1,1,0,1
3861,ossia,1,1,0,1
3863,microbi,1,1,0,1
3864,"iniziare,",1,1,0,1
3865,ulteriormente,1,1,0,1
3867,attive.,1,1,0,1
3869,commercio,1,1,0,1
3764,"litosfera,",1,1,0,1
3760,istruisce,1,1,0,1
3759,semplificare,1,1,0,1
3662,segnalazioni,1,1,0,1
3647,dominavano,1,1,0,1
3655,nomina,1,1,0,1
3656,bioinformatica,1,1,0,1
3657,tabulati,1,1,0,1
3658,cameriera,1,1,0,1
3659,procede.,1,1,0,1
3661,"loro,",1,1,0,1
3663,essa.,1,1,0,1
3757,"""separati"",",1,1,0,1
3667,addio,1,1,0,1
3668,suddivisione,1,1,0,1
3669,comprensivo,1,1,0,1
3670,desiderati,1,1,0,1
3671,"acqueo,",1,1,0,1
3672,lettori.,1,1,0,1
3674,manipolano,1,1,0,1
3645,"animali,",1,1,0,1
3643,nato,1,1,0,1
3641,oltre milioni.,1,1,0,1
3640,use.,1,1,0,1
3603,caotici,1,1,0,1
3604,automatizzata,1,1,0,1
3611,cessazione,1,1,0,1
3613,testano,1,1,0,1
3617,virtuali,1,1,0,1
3620,derivati.,1,1,0,1
3621,diminuzione,1,1,0,1
3623,applicativo,1,1,0,1
3624,"induttiva,",1,1,0,1
3625,confutò,1,1,0,1
3626,proteste,1,1,0,1
3628,interrelato.,1,1,0,1
3629,accettato,1,1,0,1
3632,University.,1,1,0,1
3633,gradualmente.,1,1,0,1
3675,dure,1,1,0,1
3676,palesemente,1,1,0,1
3680,denominatori.,1,1,0,1
3723,contributo,1,1,0,1
3727,cliente,1,1,0,1
3728,maschi.,1,1,0,1
3731,cognizione,1,1,0,1
3734,incline,1,1,0,1
3735,limitate.,1,1,0,1
3736,lodando,1,1,0,1
3737,parodiati,1,1,0,1
3738,distinzioni,1,1,0,1
3740,discendenza,1,1,0,1
3741,disomogenea.,1,1,0,1
3742,processa,1,1,0,1
3749,dell'idrosfera.,1,1,0,1
3750,vapore.,1,1,0,1
3754,Clarke,1,1,0,1
3755,Molte,1,1,0,1
3726,cyberspazio,1,1,0,1
3722,rilevare.,1,1,0,1
3682,lingua.»,1,1,0,1
3717,salata.,1,1,0,1
3683,cronaca,1,1,0,1
3684,implementare,1,1,0,1
3685,italia,1,1,0,1
3686,minore,1,1,0,1
3690,bellissimo.,1,1,0,1
3691,codificata,1,1,0,1
3695,all'Università,1,1,0,1
3699,apertamente,1,1,0,1
3701,l'identificazione.,1,1,0,1
3702,l'arte,1,1,0,1
3705,[ˌwiːkiˈpiːdiə],1,1,0,1
3707,meccanismi,1,1,0,1
3710,menzionarlo.,1,1,0,1
3713,microscopici,1,1,0,1
3714,riutilizzo,1,1,0,1
3907,"indipendenti,",1,1,0,1
3911,nell'etichettare,1,1,0,1
3913,grande.,1,1,0,1
4128,televisiva,1,1,0,1
4116,non-lineari,1,1,0,1
4118,libere,1,1,0,1
4119,Narcissus,1,1,0,1
4121,uniformandosi,1,1,0,1
4122,edicole.,1,1,0,1
4124,dominati,1,1,0,1
4125,discreta,1,1,0,1
4130,possedere,1,1,0,1
4070,supermercato,1,1,0,1
4131,consolidate,1,1,0,1
4133,discipline.,1,1,0,1
4134,titoli,1,1,0,1
4136,crudi,1,1,0,1
4137,il.,1,1,0,1
4139,"fluente,",1,1,0,1
4140,fantastici,1,1,0,1
4115,/wikiˈpidja/,1,1,0,1
4113,[il],1,1,0,1
4112,emozioniamo,1,1,0,1
4109,verificarsi,1,1,0,1
4073,incertezza,1,1,0,1
4075,dipendono,1,1,0,1
4078,Wales.,1,1,0,1
4080,rigoroso,1,1,0,1
4081,razzismo,1,1,0,1
4082,permetteva,1,1,0,1
4086,atlantico,1,1,0,1
4094,nudità,1,1,0,1
4096,successive,1,1,0,1
4097,Agli,1,1,0,1
4098,nell'altra.,1,1,0,1
4101,"argomento,",1,1,0,1
4102,catalana,1,1,0,1
4103,corrente,1,1,0,1
4105,differenti.,1,1,0,1
4144,umorismo,1,1,0,1
4146,classificandosi,1,1,0,1
4147,supposta,1,1,0,1
4185,saggi,1,1,0,1
4192,drastici,1,1,0,1
4196,scelto,1,1,0,1
4197,sparsa.,1,1,0,1
4198,comun,1,1,0,1
4199,virtuale,1,1,0,1
4204,pubblicarle».,1,1,0,1
4206,stabilite,1,1,0,1
4209,visitano,1,1,0,1
4210,l'opportunità,1,1,0,1
4211,didattici,1,1,0,1
4214,carbonio,1,1,0,1
4217,etichetta,1,1,0,1
4218,l'addestramento.,1,1,0,1
4220,Ashburn,1,1,0,1
4221,località,1,1,0,1
4190,presenziare,1,1,0,1
4183,notevole.,1,1,0,1
4150,ristretto,1,1,0,1
4180,idealmente,1,1,0,1
4152,abbandonata,1,1,0,1
4153,l'offerta,1,1,0,1
4155,'nah.,1,1,0,1
4156,stabili,1,1,0,1
4157,originarie.,1,1,0,1
4158,selezionate,1,1,0,1
4159,autoconfermati,1,1,0,1
4160,rimani,1,1,0,1
4162,tradizionale.,1,1,0,1
4163,allora.,1,1,0,1
4166,contorto,1,1,0,1
4172,[citazione,1,1,0,1
4173,intensifica,1,1,0,1
4174,appropriati,1,1,0,1
4175,pericolo,1,1,0,1
4072,"pesci,",1,1,0,1
4067,ridistribuirlo,1,1,0,1
3914,presidenziali,1,1,0,1
3968,miscuglio,1,1,0,1
3953,molto.,1,1,0,1
3954,lineari,1,1,0,1
3955,l'importanza,1,1,0,1
3960,preferenze,1,1,0,1
3962,"""in",1,1,0,1
3966,comportamentali,1,1,0,1
3967,"imprecise,",1,1,0,1
3969,specificare,1,1,0,1
4066,semi-supervisionate,1,1,0,1
3971,«chi,1,1,0,1
3976,nell'uso,1,1,0,1
3977,orgogliose,1,1,0,1
3979,lavorando,1,1,0,1
3983,elettriche,1,1,0,1
3984,incontro.,1,1,0,1
3987,scese,1,1,0,1
3947,compaiono,1,1,0,1
3945,Jay,1,1,0,1
3944,"scienziato,",1,1,0,1
3942,muovono,1,1,0,1
3918,"'70,",1,1,0,1
3919,l'url,1,1,0,1
3923,trascendentalismo,1,1,0,1
3924,dovute,1,1,0,1
3925,notevolmente,1,1,0,1
3926,femminile.,1,1,0,1
3927,"Singapore,",1,1,0,1
3928,cominciò,1,1,0,1
3930,anticamente,1,1,0,1
3933,norvegese,1,1,0,1
3934,fare?,1,1,0,1
3935,superprotezione,1,1,0,1
3938,assumerti,1,1,0,1
3939,gelide,1,1,0,1
3941,capace,1,1,0,1
3988,Hinton.,1,1,0,1
3993,necessari.,1,1,0,1
3997,dell'uno,1,1,0,1
4042,"meno,",1,1,0,1
4045,bioinformatica.,1,1,0,1
4046,un'ora.,1,1,0,1
4047,possibilmente,1,1,0,1
4049,certi,1,1,0,1
4050,sbagliati,1,1,0,1
4051,diffuso,1,1,0,1
4052,funzionamento,1,1,0,1
4054,brossura,1,1,0,1
4055,"consultato,",1,1,0,1
4056,distinti.,1,1,0,1
4057,macedonia,1,1,0,1
4058,settentrionali,1,1,0,1
4060,webos.,1,1,0,1
4061,ulteriore,1,1,0,1
4063,diversi.,1,1,0,1
4043,click.,1,1,0,1
4041,simulare,1,1,0,1
4001,imparerà,1,1,0,1
4040,equipaggio,1,1,0,1
4002,matrice.,1,1,0,1
4006,tre.,1,1,0,1
4007,umanistici.,1,1,0,1
4008,sospeso,1,1,0,1
4009,riuscendo,1,1,0,1
4013,Harvard,1,1,0,1
4015,Scientology,1,1,0,1
4016,"vada,",1,1,0,1
4018,ottimali,1,1,0,1
4019,originarie,1,1,0,1
4020,aperte,1,1,0,1
4021,tettoniche.,1,1,0,1
4022,un'affermazione,1,1,0,1
4023,divisi,1,1,0,1
4032,cartaceo,1,1,0,1
2394,condizionale,1,1,0,1
2386,raccomandazione.,1,1,0,1
4862,informativi.,1,1,0,1
846,necessaria,1,1,0,1
835,l'accademia,1,1,0,1
837,riassunte,1,1,0,1
838,facessimo,1,1,0,1
839,militare,1,1,0,1
841,faziosi,1,1,0,1
844,sostenibile.,1,1,0,1
845,nell'ai,1,1,0,1
847,"fluviale,",1,1,0,1
861,abitualmente,1,1,0,1
848,autorevoli,1,1,0,1
849,celesti,1,1,0,1
850,combinano,1,1,0,1
852,Vanderbilt,1,1,0,1
853,affidati,1,1,0,1
856,laboratori.,1,1,0,1
858,scusarsi.,1,1,0,1
831,sostituita,1,1,0,1
830,legate,1,1,0,1
827,dannazione,1,1,0,1
826,l'inclusione,1,1,0,1
799,diagnostica,1,1,0,1
803,connessa,1,1,0,1
805,facoltà,1,1,0,1
806,finanziato,1,1,0,1
807,suggerì,1,1,0,1
808,andando.,1,1,0,1
809,"telegiornale,",1,1,0,1
810,veneto,1,1,0,1
812,"conflitto,",1,1,0,1
816,individuare,1,1,0,1
817,indagini,1,1,0,1
818,parola?,1,1,0,1
821,nate,1,1,0,1
822,distribuzione.,1,1,0,1
825,vorresti,1,1,0,1
860,dall'esplosione,1,1,0,1
863,complotto.,1,1,0,1
931,rafforzando,1,1,0,1
910,lavori.,1,1,0,1
900,recente.,1,1,0,1
901,"modificabile,",1,1,0,1
903,petizione,1,1,0,1
904,plastico,1,1,0,1
905,ordinato.,1,1,0,1
907,segnaposto,1,1,0,1
908,denominatori,1,1,0,1
914,raddoppiando,1,1,0,1
864,iscriviti,1,1,0,1
915,superavano,1,1,0,1
916,affermò,1,1,0,1
917,"inanimati,",1,1,0,1
919,"web,",1,1,0,1
921,trasformativo,1,1,0,1
922,neoproterozoica,1,1,0,1
924,attesi.,1,1,0,1
895,visualizzato,1,1,0,1
894,jōichi,1,1,0,1
893,cosiddette,1,1,0,1
892,subatomiche.,1,1,0,1
865,"l'albedo,",1,1,0,1
866,c.,1,1,0,1
869,l'amor,1,1,0,1
873,conclusa,1,1,0,1
876,foglie.,1,1,0,1
878,pubblici,1,1,0,1
881,rimanga,1,1,0,1
882,test.,1,1,0,1
883,isole,1,1,0,1
884,anomalie.,1,1,0,1
886,risorsa,1,1,0,1
887,guerra.,1,1,0,1
889,favorendo,1,1,0,1
890,dell'erosione.,1,1,0,1
891,Galactica.,1,1,0,1
798,stigmergica.,1,1,0,1
796,drammatico,1,1,0,1
794,crescenti,1,1,0,1
694,impegnati,1,1,0,1
678,wiki-,1,1,0,1
681,"maggio,",1,1,0,1
682,impatto.,1,1,0,1
684,troppe,1,1,0,1
685,diffamazione,1,1,0,1
686,puzzle,1,1,0,1
690,"lettore,",1,1,0,1
696,oscillando,1,1,0,1
793,esaminati,1,1,0,1
699,proprietaria,1,1,0,1
707,"sistematicamente,",1,1,0,1
708,dinamico.,1,1,0,1
711,artistico,1,1,0,1
713,considerare,1,1,0,1
715,terzi,1,1,0,1
720,veniva,1,1,0,1
677,fondate,1,1,0,1
676,proteina,1,1,0,1
675,cartacea.,1,1,0,1
674,l'ingegnerizzazione,1,1,0,1
641,giornalismo,1,1,0,1
643,perfettamente,1,1,0,1
644,riconoscibile,1,1,0,1
646,asturiano,1,1,0,1
647,accademico,1,1,0,1
648,"risposte,",1,1,0,1
651,abitata,1,1,0,1
652,nuovamente.,1,1,0,1
653,iniziata,1,1,0,1
659,tecnologica,1,1,0,1
663,dell'elemento,1,1,0,1
666,avversario,1,1,0,1
667,sotterranea,1,1,0,1
672,cosmologici,1,1,0,1
673,imparentati,1,1,0,1
721,"spagna,",1,1,0,1
723,intenzionalmente.,1,1,0,1
725,seguirono.,1,1,0,1
761,rendono,1,1,0,1
766,sopravvivere,1,1,0,1
768,eccessivo,1,1,0,1
773,Narcisse,1,1,0,1
774,d'insieme,1,1,0,1
775,"parti,",1,1,0,1
777,soprannaturale.,1,1,0,1
778,legati,1,1,0,1
779,depositate,1,1,0,1
780,citava,1,1,0,1
782,costituenti,1,1,0,1
783,continua.,1,1,0,1
787,"aperto,",1,1,0,1
788,bassi,1,1,0,1
789,at&t,1,1,0,1
791,diagnostico,1,1,0,1
765,Narciso,1,1,0,1
760,biografie,1,1,0,1
728,oggettivo,1,1,0,1
758,Freedom,1,1,0,1
729,compilata,1,1,0,1
730,consulente,1,1,0,1
731,positivamente,1,1,0,1
732,patogeni,1,1,0,1
734,indonesiano,1,1,0,1
737,coperta,1,1,0,1
738,abbandono,1,1,0,1
740,affidata,1,1,0,1
741,provò,1,1,0,1
743,ampi,1,1,0,1
744,venisse,1,1,0,1
746,duplica,1,1,0,1
753,"vocale,",1,1,0,1
754,caricate,1,1,0,1
756,eliminazione,1,1,0,1
930,metrica,1,1,0,1
933,chiusi,1,1,0,1
1225,wc.,1,1,0,1
1131,proteggere,1,1,0,1
1118,finanziaria.,1,1,0,1
1120,sperare,1,1,0,1
1121,all'accuratezza.,1,1,0,1
1122,regni.,1,1,0,1
1123,calore.,1,1,0,1
1126,raccolto,1,1,0,1
1127,segreto.,1,1,0,1
1136,insindacabile,1,1,0,1
1153,generalizzazioni,1,1,0,1
1137,i.,1,1,0,1
1138,geografica,1,1,0,1
1139,"affidabili,",1,1,0,1
1143,android.,1,1,0,1
1147,tonnellate,1,1,0,1
1148,immediatamente.,1,1,0,1
1151,coinvolti.,1,1,0,1
1117,successiva,1,1,0,1
1116,bonifica,1,1,0,1
1115,economici,1,1,0,1
1113,migrata,1,1,0,1
1077,prestazione,1,1,0,1
1078,"anticipo,",1,1,0,1
1081,spammer,1,1,0,1
1087,conferenza,1,1,0,1
1089,underfitting.,1,1,0,1
1090,attendibili,1,1,0,1
1092,oversight,1,1,0,1
1096,[ˌwɪkiˈpiːdiə],1,1,0,1
1098,incontrerò,1,1,0,1
1100,accademici.,1,1,0,1
1101,sconsigliata.,1,1,0,1
1104,trasparenza ...,1,1,0,1
1105,commutazione,1,1,0,1
1107,giapponese.,1,1,0,1
1109,"leggi,",1,1,0,1
1152,[s],1,1,0,1
1154,napoletano,1,1,0,1
935,descrivevano,1,1,0,1
1204,razzista,1,1,0,1
1193,immunitari,1,1,0,1
1196,dettagliate,1,1,0,1
1197,esperienze,1,1,0,1
1198,un'ascia,1,1,0,1
1199,pronunce,1,1,0,1
1201,specie.,1,1,0,1
1203,tenta,1,1,0,1
1205,quotidiana.,1,1,0,1
1157,pronunciarsi,1,1,0,1
1206,inondazione,1,1,0,1
1210,qui.,1,1,0,1
1215,pressione,1,1,0,1
1216,degassamento,1,1,0,1
1217,caratterizzata,1,1,0,1
1218,specialistici.,1,1,0,1
1221,chiarire,1,1,0,1
1191,{burger},1,1,0,1
1190,presta,1,1,0,1
1187,diminuito,1,1,0,1
1185,preceduta,1,1,0,1
1158,iniziative,1,1,0,1
1167,wikipedia.org.,1,1,0,1
1168,preoccupazione.,1,1,0,1
1169,semi-formale,1,1,0,1
1171,luoghi,1,1,0,1
1172,preferibile,1,1,0,1
1173,provarono,1,1,0,1
1175,turbato,1,1,0,1
1176,scarsa,1,1,0,1
1177,competenza,1,1,0,1
1179,ereditabili.,1,1,0,1
1180,frattura,1,1,0,1
1181,motivi,1,1,0,1
1182,presuppone,1,1,0,1
1183,connotazioni,1,1,0,1
1076,supercontinente.,1,1,0,1
1075,spinto,1,1,0,1
1070,attivo.,1,1,0,1
984,"veri,",1,1,0,1
972,riapparse.,1,1,0,1
976,confinata,1,1,0,1
977,discovery.,1,1,0,1
979,articolazione.,1,1,0,1
980,contenute,1,1,0,1
981,emisferi,1,1,0,1
982,.quindi,1,1,0,1
985,l'intervista,1,1,0,1
1069,fuorilegge,1,1,0,1
986,(iwf),1,1,0,1
987,[d]non,1,1,0,1
988,"meraviglioso,",1,1,0,1
989,dell'oggetto,1,1,0,1
990,cicloni,1,1,0,1
992,appresi,1,1,0,1
993,eliopausa.,1,1,0,1
968,"finanziamento,",1,1,0,1
967,qualifica,1,1,0,1
965,cenere,1,1,0,1
964,affatto.,1,1,0,1
937,quantitativo,1,1,0,1
938,"multi-agente,",1,1,0,1
939,confermati,1,1,0,1
940,aggiudica,1,1,0,1
944,dall'interazione,1,1,0,1
946,pertanto,1,1,0,1
947,informatica.,1,1,0,1
948,bilanciamento,1,1,0,1
950,falliranno,1,1,0,1
953,avvale,1,1,0,1
955,"automatico,",1,1,0,1
956,libero.,1,1,0,1
957,gestori,1,1,0,1
959,parodiato,1,1,0,1
960,milionesima,1,1,0,1
996,convenienti,1,1,0,1
998,verrebbe,1,1,0,1
999,ambiente.,1,1,0,1
1034,alleviare,1,1,0,1
1036,geotecnica,1,1,0,1
1037,gerarchici.,1,1,0,1
1039,malattie,1,1,0,1
1042,perfezione.,1,1,0,1
1043,preistoria,1,1,0,1
1049,romantico.,1,1,0,1
1050,negativamente,1,1,0,1
1051,Lincoln,1,1,0,1
1053,l'elenco,1,1,0,1
1055,​​un,1,1,0,1
1056,XX,1,1,0,1
1060,similarità,1,1,0,1
1062,selezionato,1,1,0,1
1063,"fattori,",1,1,0,1
1067,visivo,1,1,0,1
1035,anarchismo,1,1,0,1
1032,ladina,1,1,0,1
1001,sedimentaria,1,1,0,1
1031,codificatori,1,1,0,1
1002,concesse,1,1,0,1
1004,stessa.,1,1,0,1
1005,spostata,1,1,0,1
1006,separata,1,1,0,1
1008,"l'ottimizzazione,",1,1,0,1
1009,trasversale,1,1,0,1
1011,dell'albero,1,1,0,1
1012,gestita,1,1,0,1
1018,"University,",1,1,0,1
1020,carina,1,1,0,1
1021,nell'economista,1,1,0,1
1024,teoretici,1,1,0,1
1025,tutte.,1,1,0,1
1028,ritagliata,1,1,0,1
1029,deforestazione,1,1,0,1
637,sull'economia,1,1,0,1
636,noioso,1,1,0,1
635,sradicare,1,1,0,1
240,servizio.,1,1,0,1
229,approvati,1,1,0,1
232,"giochi,",1,1,0,1
233,integrate,1,1,0,1
234,testato,1,1,0,1
235,spontaneamente,1,1,0,1
238,l'utente,1,1,0,1
239,sull'esecuzione,1,1,0,1
241,dell'accorciamento,1,1,0,1
263,desiderato,1,1,0,1
244,bozza,1,1,0,1
246,sull'album,1,1,0,1
248,neutrale.,1,1,0,1
252,indipendenti.,1,1,0,1
253,Amendment,1,1,0,1
256,foglie,1,1,0,1
261,intorno,1,1,0,1
228,dell'anno,1,1,0,1
227,convinzione,1,1,0,1
223,confusi,1,1,0,1
220,dell'efficacia,1,1,0,1
184,professionali,1,1,0,1
190,supporta,1,1,0,1
193,rinunciato,1,1,0,1
195,raffica,1,1,0,1
196,aperti,1,1,0,1
197,percento.,1,1,0,1
204,confidenza,1,1,0,1
207,patrimonio,1,1,0,1
208,ripetuta,1,1,0,1
209,progressi,1,1,0,1
210,errati,1,1,0,1
212,solari,1,1,0,1
213,gradualmente,1,1,0,1
218,l'adaline,1,1,0,1
219,negando,1,1,0,1
262,venissero,1,1,0,1
264,tenere,1,1,0,1
634,dammi,1,1,0,1
307,l'attribuzione,1,1,0,1
295,maturazione,1,1,0,1
298,dall'informatica,1,1,0,1
299,esecutivo,1,1,0,1
300,congresso,1,1,0,1
302,derivanti,1,1,0,1
305,pornografico,1,1,0,1
306,nell'articolo,1,1,0,1
309,stupendi,1,1,0,1
265,dinamo,1,1,0,1
310,professione,1,1,0,1
311,costruendo,1,1,0,1
313,conterrà,1,1,0,1
314,"osservabili,",1,1,0,1
318,provato,1,1,0,1
319,'grazie,1,1,0,1
320,indipendenti,1,1,0,1
294,"avviato,",1,1,0,1
292,Andrew,1,1,0,1
290,asturiana.,1,1,0,1
289,organizzato,1,1,0,1
266,all'uso,1,1,0,1
267,"Pakistan,",1,1,0,1
268,dilettante.,1,1,0,1
269,"leggere,",1,1,0,1
270,brevi,1,1,0,1
271,sistematici,1,1,0,1
272,taggava,1,1,0,1
274,Vinod,1,1,0,1
275,israeliano,1,1,0,1
276,np-hard,1,1,0,1
280,l'esposizione,1,1,0,1
281,diretta,1,1,0,1
282,palomar,1,1,0,1
283,linguaggi,1,1,0,1
285,steward,1,1,0,1
183,disegni,1,1,0,1
180,specchi,1,1,0,1
175,intrinseche,1,1,0,1
57,interessi.,1,1,0,1
41,dolly,1,1,0,1
43,chiarito,1,1,0,1
46,erbacce.,1,1,0,1
48,apprezzamento,1,1,0,1
49,comprino,1,1,0,1
51,blair.»,1,1,0,1
55,"sapere""",1,1,0,1
73,connettività,1,1,0,1
173,candidato.,1,1,0,1
77,dettaglio.,1,1,0,1
79,impari,1,1,0,1
83,realizzazione,1,1,0,1
86,rotta,1,1,0,1
87,riformati,1,1,0,1
88,Institute,1,1,0,1
91,danneggiare,1,1,0,1
40,dicembre [aggiornamento],1,1,0,1
39,gira,1,1,0,1
38,raccogliessero,1,1,0,1
36,anglosassone,1,1,0,1
5,proporre,1,1,0,1
6,seymour,1,1,0,1
7,dannoso,1,1,0,1
10,"offensive,",1,1,0,1
12,installato,1,1,0,1
13,commentatori,1,1,0,1
14,gassoso,1,1,0,1
15,osceni,1,1,0,1
17,provvidenza,1,1,0,1
22,maggioritarie.,1,1,0,1
23,costituivano,1,1,0,1
25,brandchannel.com,1,1,0,1
27,tecnologici,1,1,0,1
28,darà,1,1,0,1
32,lago.,1,1,0,1
92,nell'università,1,1,0,1
96,investigativo,1,1,0,1
97,insegnamento,1,1,0,1
125,regimi,1,1,0,1
132,estesi,1,1,0,1
135,induttivi.,1,1,0,1
137,introdotti.,1,1,0,1
138,"mari,",1,1,0,1
143,religioni,1,1,0,1
144,inevitabile,1,1,0,1
152,sembrerà,1,1,0,1
153,occasioni.,1,1,0,1
154,nasce,1,1,0,1
155,Internet.,1,1,0,1
164,labirintiche,1,1,0,1
165,ampiezza,1,1,0,1
167,"inutili,",1,1,0,1
168,divergono,1,1,0,1
169,spagnola,1,1,0,1
131,statiche,1,1,0,1
123,lievi,1,1,0,1
98,usino,1,1,0,1
120,ritenuto,1,1,0,1
100,"Facebook,",1,1,0,1
101,parità,1,1,0,1
102,"educato,",1,1,0,1
103,amici.,1,1,0,1
104,barzellette,1,1,0,1
105,illegale,1,1,0,1
106,cancellare,1,1,0,1
107,"superficiali,",1,1,0,1
108,modificabile.,1,1,0,1
109,quo.,1,1,0,1
110,parlare.,1,1,0,1
111,"genere,",1,1,0,1
112,assegnare,1,1,0,1
116,l'evento,1,1,0,1
118,atmosfere,1,1,0,1
321,veste,1,1,0,1
323,noioso.,1,1,0,1
324,sorgono,1,1,0,1
550,confermato,1,1,0,1
529,britannico,1,1,0,1
535,raccoglie,1,1,0,1
537,malattie.,1,1,0,1
538,scrisse,1,1,0,1
541,dall'hawaiano,1,1,0,1
543,"profonde,",1,1,0,1
547,metri.,1,1,0,1
553,studi.,1,1,0,1
489,svolta,1,1,0,1
556,trovata,1,1,0,1
559,generalizzati,1,1,0,1
560,"""osare",1,1,0,1
561,"l'idrologia,",1,1,0,1
562,definisca,1,1,0,1
563,imparare.,1,1,0,1
564,esterni,1,1,0,1
526,riguardante,1,1,0,1
525,l'esame,1,1,0,1
519,oceanica,1,1,0,1
518,fei-fei,1,1,0,1
491,immagine.,1,1,0,1
494,lit.,1,1,0,1
497,dell'ora,1,1,0,1
498,imprevisti,1,1,0,1
499,dell'omonimo,1,1,0,1
500,attuò,1,1,0,1
501,giudiziari.,1,1,0,1
504,curati.,1,1,0,1
505,scaricano,1,1,0,1
506,"ufficiale,",1,1,0,1
512,caratterizzare,1,1,0,1
514,l'assistenza,1,1,0,1
515,sacra,1,1,0,1
516,dell'opinione,1,1,0,1
517,oa,1,1,0,1
565,rotazione.,1,1,0,1
568,gorilla.,1,1,0,1
570,controparti,1,1,0,1
610,avevo,1,1,0,1
613,lanci,1,1,0,1
615,walsh.,1,1,0,1
616,"documentation,",1,1,0,1
617,colpevoli,1,1,0,1
618,annunciata,1,1,0,1
620,"tedesca,",1,1,0,1
622,informare,1,1,0,1
625,diagnosticare,1,1,0,1
627,coperture,1,1,0,1
628,riproduzione,1,1,0,1
629,nostra,1,1,0,1
630,innescato,1,1,0,1
631,sull'idea,1,1,0,1
632,dell'Oxford,1,1,0,1
633,manualmente,1,1,0,1
612,manutenzione,1,1,0,1
607,dedicati,1,1,0,1
571,dell'ozono,1,1,0,1
606,profitti.,1,1,0,1
573,l'intento,1,1,0,1
577,disinformazione.,1,1,0,1
579,dell'agricoltura,1,1,0,1
580,"umana,",1,1,0,1
581,disc,1,1,0,1
582,Elizabeth,1,1,0,1
583,superficiali».,1,1,0,1
588,collaboratori.,1,1,0,1
592,archiviate,1,1,0,1
593,piangi,1,1,0,1
597,"progresso,",1,1,0,1
598,esempi/attività,1,1,0,1
601,personalizzazione,1,1,0,1
603,fluida.,1,1,0,1
605,dimensionalità,1,1,0,1
490,Walsh,1,1,0,1
488,ognuno,1,1,0,1
325,dinamici,1,1,0,1
381,"liquida,",1,1,0,1
363,vandalizzano,1,1,0,1
364,calcola,1,1,0,1
370,libbre,1,1,0,1
373,prevalente,1,1,0,1
376,controllarle,1,1,0,1
377,risoluzione.,1,1,0,1
379,umida,1,1,0,1
382,sull'equilibrio,1,1,0,1
486,trovarsi,1,1,0,1
383,pacifico,1,1,0,1
385,periodicamente,1,1,0,1
391,costituirsi,1,1,0,1
394,crowdsourcing ...,1,1,0,1
399,concentri,1,1,0,1
400,"Wikimedia,",1,1,0,1
402,dimostrato».,1,1,0,1
360,asturie,1,1,0,1
359,fregare,1,1,0,1
358,importarmene,1,1,0,1
357,Linneo,1,1,0,1
327,fuso,1,1,0,1
328,pronunciarlo,1,1,0,1
331,all'istante,1,1,0,1
333,lamenta,1,1,0,1
334,formatisi,1,1,0,1
336,arbitrale.,1,1,0,1
339,stabilito,1,1,0,1
340,pioniere,1,1,0,1
342,osservabile,1,1,0,1
344,turistiche.,1,1,0,1
346,inconsistenze,1,1,0,1
347,contribuirvi,1,1,0,1
350,www.wikipedia.com,1,1,0,1
354,osservati,1,1,0,1
356,"fatto,",1,1,0,1
403,amava,1,1,0,1
406,stabilisce,1,1,0,1
410,ospita,1,1,0,1
451,compreso,1,1,0,1
458,"ambienti,",1,1,0,1
459,modificassero,1,1,0,1
460,interni.,1,1,0,1
463,pornografiche,1,1,0,1
464,giocato,1,1,0,1
467,inammissibili.,1,1,0,1
469,l'esplosione,1,1,0,1
471,"sistemici,",1,1,0,1
472,interessanti,1,1,0,1
473,l'avere,1,1,0,1
477,l'internet,1,1,0,1
480,consentirà,1,1,0,1
481,fissa.,1,1,0,1
483,l'atteggiamento,1,1,0,1
484,cominciamo.,1,1,0,1
456,tribunali,1,1,0,1
449,agenti,1,1,0,1
411,generato,1,1,0,1
447,economica.,1,1,0,1
413,bias-variance,1,1,0,1
416,sensori.,1,1,0,1
418,wapedia.,1,1,0,1
419,fermò,1,1,0,1
421,esponenziale.,1,1,0,1
423,rilevante,1,1,0,1
425,intenzioni,1,1,0,1
428,self-organization.,1,1,0,1
429,guidando,1,1,0,1
430,spingendo,1,1,0,1
435,"progetto,",1,1,0,1
438,l'entità,1,1,0,1
439,attributi,1,1,0,1
440,"lineari,",1,1,0,1
445,"desiderato,",1,1,0,1
1222,argini.,1,1,0,1
1226,divenuta,1,1,0,1
2385,evolutiva,1,1,0,1
1990,commerciali.,1,1,0,1
1977,genico,1,1,0,1
1978,waray.,1,1,0,1
1980,limitare,1,1,0,1
1981,vecchio,1,1,0,1
1983,generazione.,1,1,0,1
1984,"beh,",1,1,0,1
1988,riconosce,1,1,0,1
1993,investiti.,1,1,0,1
2006,fittizio,1,1,0,1
1994,sciocco,1,1,0,1
1995,avvocato,1,1,0,1
1996,dimostrazione,1,1,0,1
2000,consultati,1,1,0,1
2001,biotopo.,1,1,0,1
2002,diversificata.,1,1,0,1
2003,"network,",1,1,0,1
1976,riferimento.,1,1,0,1
1970,l'elemento,1,1,0,1
1967,campo.,1,1,0,1
1964,linguistiche.,1,1,0,1
1935,associati,1,1,0,1
1938,uomo/natura,1,1,0,1
1941,"sviluppati,",1,1,0,1
1943,lunedì,1,1,0,1
1945,"mercato,",1,1,0,1
1946,pianeti.,1,1,0,1
1948,tornado,1,1,0,1
1949,microsistema,1,1,0,1
1950,intendono,1,1,0,1
1951,moderate.,1,1,0,1
1953,"materiali,",1,1,0,1
1955,esperimenti,1,1,0,1
1959,responsabilità.,1,1,0,1
1961,allevarli,1,1,0,1
1963,scienza.,1,1,0,1
2004,tirare,1,1,0,1
2008,acquisire,1,1,0,1
2078,"menzionati,",1,1,0,1
2056,analfabeta,1,1,0,1
2046,coinvolte.,1,1,0,1
2047,wik-ih-pee-dee-ə,1,1,0,1
2050,svolti,1,1,0,1
2051,lavorativo,1,1,0,1
2052,Roy,1,1,0,1
2053,notando,1,1,0,1
2055,completezza,1,1,0,1
2059,germania,1,1,0,1
2009,dell'ambiente.,1,1,0,1
2060,installate,1,1,0,1
2062,un'enfasi,1,1,0,1
2063,dell'auto-replicazione,1,1,0,1
2064,antivandalismo,1,1,0,1
2065,soldi?,1,1,0,1
2067,orbitale.,1,1,0,1
2070,esercizio,1,1,0,1
2045,avidità,1,1,0,1
2044,rimozione,1,1,0,1
2043,minuzie.,1,1,0,1
2042,quasi milioni,1,1,0,1
2010,rocce,1,1,0,1
2014,ottimizzare,1,1,0,1
2015,sotterraneo,1,1,0,1
2016,deliberata,1,1,0,1
2021,persone ...,1,1,0,1
2022,anno.,1,1,0,1
2024,appartenevano,1,1,0,1
2025,impegnato.,1,1,0,1
2028,Graham,1,1,0,1
2029,all'ufficio,1,1,0,1
2032,Unito.,1,1,0,1
2035,civile,1,1,0,1
2037,barnstar,1,1,0,1
2039,risposto,1,1,0,1
2040,assieme,1,1,0,1
1934,paesaggio,1,1,0,1
1930,cosiddetti,1,1,0,1
1927,l'occhio.,1,1,0,1
1838,onorato,1,1,0,1
1824,l'intervento,1,1,0,1
1825,"ricerca,",1,1,0,1
1827,"uniti,",1,1,0,1
1830,dell'ottimizzazione,1,1,0,1
1833,rapido.,1,1,0,1
1835,possedeva,1,1,0,1
1837,terreno.,1,1,0,1
1839,offuscare,1,1,0,1
1925,inesistente,1,1,0,1
1842,meridionali.,1,1,0,1
1843,comportarsi,1,1,0,1
1844,tessuti.,1,1,0,1
1845,scalpore,1,1,0,1
1848,'a,1,1,0,1
1851,"parole,",1,1,0,1
1853,conseguono,1,1,0,1
1823,aveva.,1,1,0,1
1822,iniziato.,1,1,0,1
1820,prestabiliti,1,1,0,1
1819,divario,1,1,0,1
1793,pamphlet,1,1,0,1
1795,"scientifici,",1,1,0,1
1797,dell'involucro,1,1,0,1
1800,software.,1,1,0,1
1802,divulgato.,1,1,0,1
1803,antisociale,1,1,0,1
1804,lasciata,1,1,0,1
1806,omogeneizzando,1,1,0,1
1808,all'inizio.,1,1,0,1
1810,proprio.,1,1,0,1
1811,"studenti,",1,1,0,1
1812,divorare,1,1,0,1
1815,scimmia,1,1,0,1
1817,secondario.,1,1,0,1
1818,spazio.,1,1,0,1
1855,salvare,1,1,0,1
1856,miliardo,1,1,0,1
1857,parassiti,1,1,0,1
1892,ere,1,1,0,1
1897,drenaggio,1,1,0,1
1900,singolare,1,1,0,1
1902,dell'AI/CS,1,1,0,1
1903,Scotland,1,1,0,1
1904,Per,1,1,0,1
1905,rinacque,1,1,0,1
1908,sbaglia.,1,1,0,1
1909,adattano,1,1,0,1
1910,incredibili,1,1,0,1
1911,"artificiale,",1,1,0,1
1913,"netto,",1,1,0,1
1916,vandalizzata,1,1,0,1
1917,consegnati,1,1,0,1
1921,esterni.,1,1,0,1
1924,francoprovenzale,1,1,0,1
1893,potente,1,1,0,1
1889,disgrazia,1,1,0,1
1858,luciano,1,1,0,1
1888,ripristini,1,1,0,1
1863,'ringraziandoti,1,1,0,1
1864,/wikipeˈdia/,1,1,0,1
1865,averne,1,1,0,1
1866,deliberatamente,1,1,0,1
1867,"l'inquinamento,",1,1,0,1
1869,.se,1,1,0,1
1870,condannato,1,1,0,1
1871,rivendicazione,1,1,0,1
1872,modificarlo,1,1,0,1
1876,ciò.,1,1,0,1
1877,trionfa,1,1,0,1
1878,foundation.,1,1,0,1
1882,"dall'adattamento,",1,1,0,1
1883,pensano,1,1,0,1
1885,assoluto,1,1,0,1
2071,arrabbiarsi,1,1,0,1
2080,fatte.,1,1,0,1
1227,un'adeguata,1,1,0,1
2290,"d'arte,",1,1,0,1
2280,vogliono,1,1,0,1
2281,abbondante.,1,1,0,1
2282,tensoriali,1,1,0,1
2285,firma,1,1,0,1
2286,modulo,1,1,0,1
2287,"hg,",1,1,0,1
2288,congiunto,1,1,0,1
2291,dell'etica,1,1,0,1
2302,raccomanda,1,1,0,1
2292,euro,1,1,0,1
2293,if-else,1,1,0,1
2295,inverte,1,1,0,1
2296,ecologici,1,1,0,1
2297,potrà,1,1,0,1
2298,\}},1,1,0,1
2300,prettamente,1,1,0,1
2279,greca,1,1,0,1
2273,"televisione,",1,1,0,1
2271,vigili,1,1,0,1
2268,iPhone,1,1,0,1
2244,oggettiva.,1,1,0,1
2246,personalizzati,1,1,0,1
2247,detto.,1,1,0,1
2248,dag.,1,1,0,1
2249,misto,1,1,0,1
2252,endoreici,1,1,0,1
2253,aule,1,1,0,1
2254,nuvole,1,1,0,1
2256,associata.,1,1,0,1
2257,sconosciute.,1,1,0,1
2259,sospetti,1,1,0,1
2261,dinosauri,1,1,0,1
2262,concedere,1,1,0,1
2263,applicate,1,1,0,1
2266,quarantadue,1,1,0,1
2301,specializzati,1,1,0,1
2304,suolo,1,1,0,1
2086,modellazione.,1,1,0,1
2365,spontaneamente.,1,1,0,1
2357,correttamente.,1,1,0,1
2358,signore,1,1,0,1
2359,influenzato,1,1,0,1
2360,catch-.,1,1,0,1
2361,"nevosi,",1,1,0,1
2362,denotando,1,1,0,1
2364,alimenta,1,1,0,1
2366,adesso.,1,1,0,1
2307,l'esplorazione,1,1,0,1
2368,induttivamente,1,1,0,1
2370,agiscono,1,1,0,1
2371,pagamento.,1,1,0,1
2372,produttori,1,1,0,1
2373,salvati,1,1,0,1
2383,presunti,1,1,0,1
2384,nazionalità,1,1,0,1
2354,scorrimento,1,1,0,1
2351,BBC,1,1,0,1
2349,polacco,1,1,0,1
2347,renderizzate,1,1,0,1
2308,dell'indisponibilità,1,1,0,1
2315,codificati,1,1,0,1
2316,riportata,1,1,0,1
2317,dallo,1,1,0,1
2320,Fondazione.,1,1,0,1
2322,lui»,1,1,0,1
2328,''sportello,1,1,0,1
2330,discutere.,1,1,0,1
2335,principessa,1,1,0,1
2336,moderatori,1,1,0,1
2337,transazioni,1,1,0,1
2340,inteso,1,1,0,1
2342,tnr.,1,1,0,1
2344,salmi,1,1,0,1
2345,all'abilità,1,1,0,1
2242,competenza.,1,1,0,1
2241,autorizzati,1,1,0,1
2240,volgare.,1,1,0,1
2140,stabiliscono,1,1,0,1
2118,cavallo,1,1,0,1
2120,classici,1,1,0,1
2124,reati,1,1,0,1
2126,anch'essi,1,1,0,1
2127,"sottoutilizzata,",1,1,0,1
2129,"si,",1,1,0,1
2135,tradizionali.»,1,1,0,1
2142,«il,1,1,0,1
2238,dell'ulteriore,1,1,0,1
2144,ideologici,1,1,0,1
2145,sostegno,1,1,0,1
2147,incompleto,1,1,0,1
2149,dichiarazione,1,1,0,1
2150,"maturazione,",1,1,0,1
2151,referee,1,1,0,1
2152,garantendo,1,1,0,1
2117,Bloomberg,1,1,0,1
2115,"notte,",1,1,0,1
2114,"storia,",1,1,0,1
2111,l'apprendimento.,1,1,0,1
2087,finire,1,1,0,1
2089,crocker.,1,1,0,1
2092,restando,1,1,0,1
2093,ambiguità.,1,1,0,1
2094,manipoli,1,1,0,1
2095,programmato,1,1,0,1
2097,tardo,1,1,0,1
2098,carbonica,1,1,0,1
2102,ricaverà,1,1,0,1
2103,sfondo,1,1,0,1
2104,mantenga,1,1,0,1
2106,lavorava,1,1,0,1
2108,sicuramente,1,1,0,1
2109,comscore.,1,1,0,1
2110,fuoriuscite,1,1,0,1
2153,inadatte,1,1,0,1
2155,"nell'ambiente,",1,1,0,1
2159,lacune,1,1,0,1
2201,discutibilmente,1,1,0,1
2207,dell'assassinio,1,1,0,1
2213,distribuibile.,1,1,0,1
2214,analitico,1,1,0,1
2218,contrarsi,1,1,0,1
2220,sull'arte,1,1,0,1
2224,"dell'atmosfera,",1,1,0,1
2225,all'accuratezza,1,1,0,1
2227,sbalzi,1,1,0,1
2228,l'imitazione,1,1,0,1
2229,conservavano,1,1,0,1
2230,acquatico,1,1,0,1
2231,dell'editing,1,1,0,1
2233,antiche,1,1,0,1
2234,en.m.wikipedia.org,1,1,0,1
2236,pregiudizi.,1,1,0,1
2203,avvertimento,1,1,0,1
2199,avvento,1,1,0,1
2160,rumorosamente,1,1,0,1
2198,mammifero,1,1,0,1
2161,vuoi.,1,1,0,1
2166,"dizionario,",1,1,0,1
2171,Colbert,1,1,0,1
2173,addosso,1,1,0,1
2174,compensi,1,1,0,1
2175,partecipazione.,1,1,0,1
2177,"attività,",1,1,0,1
2179,Time,1,1,0,1
2183,"civiltà,",1,1,0,1
2184,Marian,1,1,0,1
2187,malevole,1,1,0,1
2188,marmellate,1,1,0,1
2191,"conteggio,",1,1,0,1
2192,California.,1,1,0,1
2197,d'Aral,1,1,0,1
1792,"velocità,",1,1,0,1
1788,"foundation,",1,1,0,1
1786,fonte.,1,1,0,1
1413,"""wikipedia",1,1,0,1
1402,decentralizzando,1,1,0,1
1403,l'ossigeno,1,1,0,1
1404,analitiche,1,1,0,1
1405,valide,1,1,0,1
1407,ordinari.,1,1,0,1
1408,piemontese,1,1,0,1
1410,riconosciute.,1,1,0,1
1414,visualizzazione,1,1,0,1
1426,iniziale.,1,1,0,1
1417,È,1,1,0,1
1418,aggressivo,1,1,0,1
1419,Gardner.,1,1,0,1
1421,operativa.,1,1,0,1
1422,dell'altitudine.,1,1,0,1
1423,contestualizzazione,1,1,0,1
1424,moderare,1,1,0,1
1401,professionisti,1,1,0,1
1400,l'uscita,1,1,0,1
1399,Hai,1,1,0,1
1398,"indipendente,",1,1,0,1
1371,rilascia,1,1,0,1
1372,un'esplosione,1,1,0,1
1373,richiamate,1,1,0,1
1375,indicano,1,1,0,1
1376,affermazione.,1,1,0,1
1380,partite,1,1,0,1
1381,.stiamo,1,1,0,1
1382,all'intrattenimento.,1,1,0,1
1384,multipli,1,1,0,1
1386,mappa,1,1,0,1
1387,adeguate,1,1,0,1
1389,rafforzare,1,1,0,1
1393,extracellulare,1,1,0,1
1394,tracciata,1,1,0,1
1397,succedono,1,1,0,1
1425,razziste,1,1,0,1
1427,rimase,1,1,0,1
1783,blocco,1,1,0,1
1478,aggregatore,1,1,0,1
1466,intense,1,1,0,1
1470,liquido,1,1,0,1
1471,adeguata,1,1,0,1
1473,utilizzi,1,1,0,1
1474,introdotte,1,1,0,1
1475,digeriscono,1,1,0,1
1477,economiche.,1,1,0,1
1480,declino.,1,1,0,1
1431,Unito,1,1,0,1
1483,contrappone,1,1,0,1
1485,profondità.,1,1,0,1
1486,Barack,1,1,0,1
1488,confrontando,1,1,0,1
1489,rivedere,1,1,0,1
1491,],1,1,0,1
1492,faceva,1,1,0,1
1464,dell'osso,1,1,0,1
1463,linden,1,1,0,1
1461,almanacchi,1,1,0,1
1460,primarie,1,1,0,1
1432,convenzionale/designazione,1,1,0,1
1436,iterativa,1,1,0,1
1437,esatto,1,1,0,1
1438,giornali,1,1,0,1
1440,stabilendo,1,1,0,1
1441,First,1,1,0,1
1442,vernice.,1,1,0,1
1446,vitale,1,1,0,1
1449,orientamenti,1,1,0,1
1450,entrambe,1,1,0,1
1452,redattrici,1,1,0,1
1455,l'università,1,1,0,1
1456,ambito,1,1,0,1
1458,carta.,1,1,0,1
1459,sovvenzioni,1,1,0,1
1367,discostati,1,1,0,1
1365,sardo,1,1,0,1
1364,"Ming,",1,1,0,1
1281,rituali,1,1,0,1
1258,en.mobile.wikipedia.org,1,1,0,1
1263,consegnano,1,1,0,1
1265,sbilanciata,1,1,0,1
1267,primordiale,1,1,0,1
1269,burocratica,1,1,0,1
1270,volontariamente,1,1,0,1
1276,demografico,1,1,0,1
1282,legali,1,1,0,1
1363,"definita,",1,1,0,1
1285,essi,1,1,0,1
1286,sessismo,1,1,0,1
1287,attrezzato,1,1,0,1
1291,validità,1,1,0,1
1294,giugno],1,1,0,1
1301,nascano,1,1,0,1
1302,circondano,1,1,0,1
1257,caffè.,1,1,0,1
1255,mancano,1,1,0,1
1253,svolgimento,1,1,0,1
1252,"fisica,",1,1,0,1
1228,rivederti,1,1,0,1
1230,marion.,1,1,0,1
1231,affermati,1,1,0,1
1232,diagrammi,1,1,0,1
1236,coperto,1,1,0,1
1238,casuali,1,1,0,1
1240,"processo,",1,1,0,1
1241,sollevate,1,1,0,1
1242,segnalati,1,1,0,1
1243,asteroide,1,1,0,1
1247,parametri,1,1,0,1
1248,soap,1,1,0,1
1249,collegare,1,1,0,1
1250,comportare,1,1,0,1
1251,specificità,1,1,0,1
1304,d'acqua?,1,1,0,1
1305,influenzando,1,1,0,1
1306,preferenze.,1,1,0,1
1335,sottoadattato,1,1,0,1
1337,Apache,1,1,0,1
1338,danno,1,1,0,1
1340,misure,1,1,0,1
1341,canepari,1,1,0,1
1342,"liquido,",1,1,0,1
1346,sole.,1,1,0,1
1348,persiano,1,1,0,1
1349,l'individuazione,1,1,0,1
1350,intrusi,1,1,0,1
1352,abilità,1,1,0,1
1354,pedone,1,1,0,1
1356,sensoriali,1,1,0,1
1357,coscienza,1,1,0,1
1358,attribuendoli,1,1,0,1
1360,distacco,1,1,0,1
1336,"Samuel,",1,1,0,1
1334,ricevitore,1,1,0,1
1307,comparire,1,1,0,1
1330,muscoli,1,1,0,1
1309,folla,1,1,0,1
1310,riscontrato,1,1,0,1
1312,"feedback,",1,1,0,1
1313,Capo,1,1,0,1
1314,edite,1,1,0,1
1315,ottimistico,1,1,0,1
1316,celebrata,1,1,0,1
1317,nasa,1,1,0,1
1318,"output,",1,1,0,1
1321,rinnovabile,1,1,0,1
1322,possesso,1,1,0,1
1324,temperate.,1,1,0,1
1325,zeri.,1,1,0,1
1326,eoni,1,1,0,1
1329,artisti.,1,1,0,1
1493,distribuiscono,1,1,0,1
1494,equatoriali,1,1,0,1
1497,contribuzione,1,1,0,1
1700,g.,1,1,0,1
1690,interpellati,1,1,0,1
1691,cautele,1,1,0,1
1692,Ubuntu.,1,1,0,1
1693,milione.,1,1,0,1
1694,Weinberger.,1,1,0,1
1696,neutroni,1,1,0,1
1698,sentimenti,1,1,0,1
1703,nominato,1,1,0,1
1642,hawaiano,1,1,0,1
1704,coinvolto,1,1,0,1
1705,frammentazione,1,1,0,1
1706,oh.,1,1,0,1
1707,pericoli,1,1,0,1
1708,Yale,1,1,0,1
1709,divisa,1,1,0,1
1710,l'allenamento.,1,1,0,1
1689,sinergie,1,1,0,1
1684,riscoperta,1,1,0,1
1680,it.wiki,1,1,0,1
1679,l'interno,1,1,0,1
1646,memoriam,1,1,0,1
1647,stabilizza,1,1,0,1
1648,risponda,1,1,0,1
1650,vitalista,1,1,0,1
1651,trascendentalista,1,1,0,1
1654,decidibile.,1,1,0,1
1660,acculturato…,1,1,0,1
1661,probazioni,1,1,0,1
1664,rese,1,1,0,1
1665,adattivi,1,1,0,1
1667,donazioni.,1,1,0,1
1669,dall'inserimento,1,1,0,1
1670,Bradley,1,1,0,1
1671,dall'intelligenza,1,1,0,1
1672,divenute,1,1,0,1
1711,conferma,1,1,0,1
1712,sostenendo,1,1,0,1
1713,nell'esaurimento,1,1,0,1
1753,I.,1,1,0,1
1755,"venerdì,",1,1,0,1
1756,plausi,1,1,0,1
1757,reperibile,1,1,0,1
1759,statistici.,1,1,0,1
1761,stesura,1,1,0,1
1762,legislativo,1,1,0,1
1764,incroci,1,1,0,1
1766,"utenti,",1,1,0,1
1769,nuda.,1,1,0,1
1773,possedevano,1,1,0,1
1774,"Lincoln,",1,1,0,1
1775,erroneamente,1,1,0,1
1776,molta,1,1,0,1
1777,porzioni,1,1,0,1
1782,dissimili.,1,1,0,1
1754,franche-comté,1,1,0,1
1749,"torrente,",1,1,0,1
1715,"dall'organizzazione,",1,1,0,1
1747,oggetti.,1,1,0,1
1716,edifici,1,1,0,1
1718,l'aveva,1,1,0,1
1721,continui,1,1,0,1
1722,sfruttare,1,1,0,1
1724,nell'enciclopedia,1,1,0,1
1726,iscritti,1,1,0,1
1732,fratelli,1,1,0,1
1736,dovesse,1,1,0,1
1738,pangea,1,1,0,1
1740,suscettibilità,1,1,0,1
1741,preoccupare.,1,1,0,1
1742,formativo,1,1,0,1
1743,elaborarlo,1,1,0,1
1744,"""meno",1,1,0,1
1745,robotica,1,1,0,1
1643,coordinamento,1,1,0,1
1640,visibili.,1,1,0,1
1501,causare,1,1,0,1
1550,alimentati,1,1,0,1
1536,sollevati,1,1,0,1
1538,corridoio,1,1,0,1
1540,un'eccezione,1,1,0,1
1543,supporti,1,1,0,1
1547,capisco,1,1,0,1
1548,giornaliere,1,1,0,1
1549,l'efficienza,1,1,0,1
1551,"ultravioletta,",1,1,0,1
1639,speciali,1,1,0,1
1552,evidente,1,1,0,1
1558,no-profit,1,1,0,1
1559,tradotti,1,1,0,1
1560,scolpita,1,1,0,1
1562,farei,1,1,0,1
1563,creativa.,1,1,0,1
1564,infinite.,1,1,0,1
1535,Al,1,1,0,1
1533,inesattezze,1,1,0,1
1532,meraviglia,1,1,0,1
1531,collettiva,1,1,0,1
1502,Dai.,1,1,0,1
1503,fastidio,1,1,0,1
1506,"impegnato,",1,1,0,1
1509,triplicate,1,1,0,1
1511,storica.,1,1,0,1
1515,sopravvivenza,1,1,0,1
1516,classico,1,1,0,1
1518,qr,1,1,0,1
1519,interruzioni,1,1,0,1
1521,pensate,1,1,0,1
1522,dovessi,1,1,0,1
1523,"agosto,",1,1,0,1
1525,un'email,1,1,0,1
1526,Preoccupazioni,1,1,0,1
1530,notificare,1,1,0,1
1565,"algoritmici,",1,1,0,1
1567,l'editing.,1,1,0,1
1568,all'estinzione,1,1,0,1
1609,aggiornando,1,1,0,1
1612,indipendente,1,1,0,1
1614,"aperta,",1,1,0,1
1615,compromesso,1,1,0,1
1617,dell'elaborazione,1,1,0,1
1618,rimanesse,1,1,0,1
1619,celesti.,1,1,0,1
1621,impostare,1,1,0,1
1623,trattava,1,1,0,1
1626,fitness,1,1,0,1
1627,foscolo,1,1,0,1
1630,significava,1,1,0,1
1632,regni,1,1,0,1
1633,- milioni,1,1,0,1
1636,mancanti,1,1,0,1
1638,porti,1,1,0,1
1610,interplanetario,1,1,0,1
1606,riempiono,1,1,0,1
1572,cambiamenti.,1,1,0,1
1601,autonomi,1,1,0,1
1573,misura.,1,1,0,1
1574,vicenda,1,1,0,1
1575,enciclopedici,1,1,0,1
1576,"negoziazione,",1,1,0,1
1579,"addestramento,",1,1,0,1
1581,tengono,1,1,0,1
1582,sintetico.,1,1,0,1
1583,unito.,1,1,0,1
1587,"approccio,",1,1,0,1
1588,disgrazia.,1,1,0,1
1589,[dalla,1,1,0,1
1590,[oltre].,1,1,0,1
1594,rifiorire,1,1,0,1
1597,wikibooks.,1,1,0,1
1599,l'alto,1,1,0,1
4861,solitudine.,1,1,0,1
4865,scuole.,1,1,0,1
9661,निकाल,0,0,1,1
8231,mappare,1,1,0,1
8217,"scuoti,",1,1,0,1
8218,/ˌwɪkɪˈpiːdiə/,1,1,0,1
8221,Sono,1,1,0,1
8222,rientrano,1,1,0,1
8225,"vedi,",1,1,0,1
8226,gettato,1,1,0,1
8227,"dati,",1,1,0,1
8233,redistribuiti,1,1,0,1
8252,negoziazione,1,1,0,1
8235,aderisce,1,1,0,1
8236,ricreare,1,1,0,1
8237,prende,1,1,0,1
8238,timori,1,1,0,1
8240,volumi,1,1,0,1
8241,estreme,1,1,0,1
8247,Forum,1,1,0,1
8215,nell'accuratezza,1,1,0,1
8210,britannici.,1,1,0,1
8209,banali,1,1,0,1
8208,«pochi,1,1,0,1
8185,violento,1,1,0,1
8187,decidere,1,1,0,1
8188,sull'utilizzo,1,1,0,1
8189,derivano,1,1,0,1
8190,"epico,",1,1,0,1
8191,ritardo,1,1,0,1
8192,molestie.,1,1,0,1
8193,violassero,1,1,0,1
8195,paniere,1,1,0,1
8199,vantaggio,1,1,0,1
8201,apparisse,1,1,0,1
8202,calo.,1,1,0,1
8203,multidimensionali,1,1,0,1
8204,posizionamenti,1,1,0,1
8205,vorresti.,1,1,0,1
8251,Today,1,1,0,1
8253,un'istanza,1,1,0,1
8337,scapito,1,1,0,1
8320,posta,1,1,0,1
8299,circa milioni,1,1,0,1
8305,contiene.,1,1,0,1
8308,l'incentivo,1,1,0,1
8309,sostenuti,1,1,0,1
8311,deformazione,1,1,0,1
8314,sentimento,1,1,0,1
8319,britannici,1,1,0,1
8322,nell'ultimo,1,1,0,1
8254,fiducia,1,1,0,1
8324,«…per,1,1,0,1
8325,neurali.,1,1,0,1
8326,girava,1,1,0,1
8328,Jaffe,1,1,0,1
8330,privilegiate,1,1,0,1
8331,formasse,1,1,0,1
8333,popolarità.,1,1,0,1
8296,ricevendo,1,1,0,1
8295,all'ecosistema.,1,1,0,1
8292,albori,1,1,0,1
8288,interconnessi,1,1,0,1
8255,commerciali,1,1,0,1
8256,pornografici.,1,1,0,1
8257,giurisprudenza,1,1,0,1
8260,premiano,1,1,0,1
8261,mioglobina,1,1,0,1
8262,\}\rightarrow,1,1,0,1
8263,tagliato,1,1,0,1
8266,obbligatoria,1,1,0,1
8270,vendita.,1,1,0,1
8274,interesse.,1,1,0,1
8279,ore.,1,1,0,1
8282,"articolo,",1,1,0,1
8284,dell'orologio,1,1,0,1
8286,l'oceanografia.,1,1,0,1
8287,strutturale,1,1,0,1
8184,attuali.,1,1,0,1
8183,neutralità,1,1,0,1
8182,Britannica,1,1,0,1
8066,obbedisce,1,1,0,1
8055,promossa,1,1,0,1
8057,Battlestar,1,1,0,1
8058,concorrente,1,1,0,1
8059,prolissa,1,1,0,1
8060,ricorrenze,1,1,0,1
8064,ecc..,1,1,0,1
8065,sicurezza,1,1,0,1
8068,integrato,1,1,0,1
8181,rendendola,1,1,0,1
8070,Rumelhart,1,1,0,1
8071,macinare,1,1,0,1
8076,comunità ...,1,1,0,1
8077,semplificato,1,1,0,1
8078,retropropagato,1,1,0,1
8083,derivato,1,1,0,1
8086,l'avvento,1,1,0,1
8052,l'apertura,1,1,0,1
8051,faith-based,1,1,0,1
8049,abile,1,1,0,1
8048,emiliano,1,1,0,1
8024,novità,1,1,0,1
8025,guadagnare,1,1,0,1
8026,illustrati,1,1,0,1
8027,l'accusa,1,1,0,1
8033,copertura.,1,1,0,1
8034,apparsa,1,1,0,1
8035,calcificato,1,1,0,1
8036,stare,1,1,0,1
8037,biblioteca?,1,1,0,1
8038,migrano,1,1,0,1
8039,cancellazione,1,1,0,1
8040,"Shirky,",1,1,0,1
8045,rispettivo,1,1,0,1
8046,liquida.,1,1,0,1
8047,mediche.,1,1,0,1
8090,sostantivi,1,1,0,1
8091,dell'approccio,1,1,0,1
8092,l'Harvard's,1,1,0,1
8136,rimosso.,1,1,0,1
8139,vivente,1,1,0,1
8142,difficilmente,1,1,0,1
8144,desiderato.,1,1,0,1
8147,visioni,1,1,0,1
8149,"anomali,",1,1,0,1
8156,frequenza,1,1,0,1
8159,gratuitamente.,1,1,0,1
8162,puntando,1,1,0,1
8163,latitudinale,1,1,0,1
8164,ornamenti,1,1,0,1
8167,determinazione,1,1,0,1
8174,scoperto.,1,1,0,1
8176,conserva,1,1,0,1
8177,un'era,1,1,0,1
8179,difendere,1,1,0,1
8138,migratrici,1,1,0,1
8135,generalizzabili.,1,1,0,1
8094,Review,1,1,0,1
8134,arrivati.,1,1,0,1
8095,l'ufficio,1,1,0,1
8096,accuratezza.,1,1,0,1
8099,dozzina,1,1,0,1
8100,venire,1,1,0,1
8106,favore?,1,1,0,1
8107,provenire,1,1,0,1
8114,vegetale.,1,1,0,1
8115,ricoprono,1,1,0,1
8116,ecologi,1,1,0,1
8118,carriera.»,1,1,0,1
8119,giocando,1,1,0,1
8127,termicamente,1,1,0,1
8130,lunare,1,1,0,1
8131,l'annata.,1,1,0,1
8133,volontario,1,1,0,1
8335,vietato,1,1,0,1
8339,e/o,1,1,0,1
8630,ripariale.,1,1,0,1
8533,controverso.,1,1,0,1
8523,nervoso,1,1,0,1
8524,organi,1,1,0,1
8526,approfondimento,1,1,0,1
8527,legge.,1,1,0,1
8529,nascoste,1,1,0,1
8530,scrivono.,1,1,0,1
8531,ricordartelo.,1,1,0,1
8534,orbita.,1,1,0,1
8554,letti,1,1,0,1
8535,limitano,1,1,0,1
8538,svariati,1,1,0,1
8540,sottoterra,1,1,0,1
8542,"maher,",1,1,0,1
8545,sposarmi,1,1,0,1
8548,l'inventore,1,1,0,1
8550,vera,1,1,0,1
8522,bersaglio,1,1,0,1
8521,inviate,1,1,0,1
8518,progettato,1,1,0,1
8517,strati.,1,1,0,1
8496,dinamica.,1,1,0,1
8498,rosso.,1,1,0,1
8500,curata,1,1,0,1
8502,"nazionali,",1,1,0,1
8503,fungono,1,1,0,1
8505,localizzato,1,1,0,1
8506,manti,1,1,0,1
8507,discretamente,1,1,0,1
8508,principale:,1,1,0,1
8509,urbane,1,1,0,1
8510,elencati,1,1,0,1
8511,tranne,1,1,0,1
8512,accuratamente,1,1,0,1
8515,dibattute,1,1,0,1
8516,continuata,1,1,0,1
8553,intrusione,1,1,0,1
8556,influenzare,1,1,0,1
8341,registrano,1,1,0,1
8606,automatizzato,1,1,0,1
8595,neri,1,1,0,1
8596,vero.,1,1,0,1
8598,viaggiano,1,1,0,1
8600,compilate,1,1,0,1
8601,sostituendo,1,1,0,1
8602,l'incorporazione,1,1,0,1
8605,esibito,1,1,0,1
8614,Pragmatic,1,1,0,1
8557,amministrative,1,1,0,1
8617,connessionismo,1,1,0,1
8618,"controllo,",1,1,0,1
8619,mancare,1,1,0,1
8620,pronte,1,1,0,1
8625,protisti,1,1,0,1
8626,vivente.,1,1,0,1
8628,conduca,1,1,0,1
8594,come',1,1,0,1
8592,dell'interazione,1,1,0,1
8590,dell'interpretazione,1,1,0,1
8589,violato.,1,1,0,1
8558,poeta,1,1,0,1
8559,tirati,1,1,0,1
8563,mostrati,1,1,0,1
8565,l'aumentare,1,1,0,1
8566,'l.a.,1,1,0,1
8568,culturale,1,1,0,1
8569,anatomia,1,1,0,1
8571,manipolazione,1,1,0,1
8573,abbandonato,1,1,0,1
8575,sottili,1,1,0,1
8576,incisa,1,1,0,1
8578,influenza.,1,1,0,1
8579,indicherebbe,1,1,0,1
8585,notiziari.,1,1,0,1
8586,sostenitori.,1,1,0,1
8495,sostituiranno,1,1,0,1
8494,famosa,1,1,0,1
8485,microecosistema.,1,1,0,1
8390,preoccupante,1,1,0,1
8379,chiusura,1,1,0,1
8380,annullamento,1,1,0,1
8382,l'episodio.,1,1,0,1
8384,rifiuti,1,1,0,1
8385,labs-research,1,1,0,1
8387,venduta,1,1,0,1
8388,etichettato,1,1,0,1
8391,un'intera,1,1,0,1
8484,competitivo,1,1,0,1
8393,studio.,1,1,0,1
8395,condivisibile,1,1,0,1
8400,riscrivono,1,1,0,1
8403,stessi.,1,1,0,1
8407,condiviso,1,1,0,1
8408,appartenga,1,1,0,1
8409,C'era,1,1,0,1
8378,topologia,1,1,0,1
8377,l'Atlantic,1,1,0,1
8373,l'enciclopedia.,1,1,0,1
8372,"anni,",1,1,0,1
8342,un'improbabile,1,1,0,1
8345,dell'autorità,1,1,0,1
8347,premuto,1,1,0,1
8348,alterna,1,1,0,1
8349,dall'intervento,1,1,0,1
8352,maturi.,1,1,0,1
8353,nell'intervallo,1,1,0,1
8355,cervelli,1,1,0,1
8358,aggregato,1,1,0,1
8359,enciclopedico,1,1,0,1
8363,espressioni,1,1,0,1
8366,passi,1,1,0,1
8369,accettabile,1,1,0,1
8370,colture,1,1,0,1
8371,ricchi,1,1,0,1
8410,ordinari,1,1,0,1
8411,"l'acqua,",1,1,0,1
8412,Delhi,1,1,0,1
8449,menzione,1,1,0,1
8455,coinciso,1,1,0,1
8456,informali,1,1,0,1
8458,afflitti,1,1,0,1
8460,attendibilità,1,1,0,1
8461,quest'area,1,1,0,1
8463,"zoo,",1,1,0,1
8467,un'unità,1,1,0,1
8469,oscene,1,1,0,1
8470,dell'enciclopedia.,1,1,0,1
8474,conosciuti,1,1,0,1
8479,alterano,1,1,0,1
8480,separatamente,1,1,0,1
8481,"orizzontale,",1,1,0,1
8482,costituire,1,1,0,1
8483,permissivo,1,1,0,1
8450,comprendere.,1,1,0,1
8448,minerali,1,1,0,1
8415,fondatori,1,1,0,1
8445,voto»,1,1,0,1
8417,disponibile.,1,1,0,1
8418,sottolinea,1,1,0,1
8419,omesse,1,1,0,1
8420,siccome,1,1,0,1
8422,distribuendo,1,1,0,1
8424,cailliau,1,1,0,1
8427,"problemi,",1,1,0,1
8428,sensazione,1,1,0,1
8430,estremi.,1,1,0,1
8431,all'ultima,1,1,0,1
8432,sufficiente,1,1,0,1
8438,colloca,1,1,0,1
8439,proliferare,1,1,0,1
8441,all'utilizzo,1,1,0,1
8443,protetti,1,1,0,1
8022,semantica,1,1,0,1
8021,parlargli.,1,1,0,1
8020,wikiwikiweb,1,1,0,1
7606,errate,1,1,0,1
7595,all'affrontare,1,1,0,1
7596,filosofica,1,1,0,1
7597,modalità.,1,1,0,1
7598,pienamente,1,1,0,1
7600,vuote,1,1,0,1
7602,"origini,",1,1,0,1
7604,danneggiato,1,1,0,1
7607,deformativi,1,1,0,1
7625,fissione,1,1,0,1
7608,supplementari,1,1,0,1
7610,"Brown,",1,1,0,1
7612,predittivo,1,1,0,1
7614,connessione.,1,1,0,1
7617,indicativo,1,1,0,1
7621,riassunto,1,1,0,1
7623,avvicinano,1,1,0,1
7594,abitabile,1,1,0,1
7593,difetto,1,1,0,1
7592,wiki.,1,1,0,1
7588,compilativa,1,1,0,1
7559,simboli,1,1,0,1
7562,tracciamento,1,1,0,1
7565,condanni,1,1,0,1
7571,all'altro,1,1,0,1
7573,oscura,1,1,0,1
7574,ramo,1,1,0,1
7577,"acceso,",1,1,0,1
7578,dialetti,1,1,0,1
7579,farsi,1,1,0,1
7580,compromette,1,1,0,1
7583,comparativo,1,1,0,1
7584,approfondite,1,1,0,1
7585,"accademica,",1,1,0,1
7586,sanitaria.,1,1,0,1
7587,geofisiologico,1,1,0,1
7624,edizioni.,1,1,0,1
7626,permettimi,1,1,0,1
8019,intimidatorio.,1,1,0,1
7671,nord-est,1,1,0,1
7656,perdere,1,1,0,1
7657,proliferazione,1,1,0,1
7658,genitori,1,1,0,1
7659,differendo,1,1,0,1
7661,animati,1,1,0,1
7667,ambientali,1,1,0,1
7668,[il,1,1,0,1
7672,massima,1,1,0,1
7627,valutazione.,1,1,0,1
7673,gemello,1,1,0,1
7674,planetario.,1,1,0,1
7680,l'editor,1,1,0,1
7681,ricevi,1,1,0,1
7683,regolarizzazione,1,1,0,1
7686,"Phone,",1,1,0,1
7691,un'esperienza,1,1,0,1
7654,costruito,1,1,0,1
7653,enciclopedico.,1,1,0,1
7652,che],1,1,0,1
7651,sbalorditivo,1,1,0,1
7630,trattati.,1,1,0,1
7631,"un'enciclopedia"".",1,1,0,1
7633,Colbert.,1,1,0,1
7634,riusciti,1,1,0,1
7636,procrastinazione[nota],1,1,0,1
7637,promuovere,1,1,0,1
7638,dall'aggiunta,1,1,0,1
7639,follow-up,1,1,0,1
7642,irrealizzabile,1,1,0,1
7643,"ottenere,",1,1,0,1
7645,'e,1,1,0,1
7646,vedano,1,1,0,1
7647,implementazioni,1,1,0,1
7648,riorganizzate,1,1,0,1
7649,friulano,1,1,0,1
7555,visitatore,1,1,0,1
7553,potere,1,1,0,1
7552,nessuna,1,1,0,1
7445,fissavano,1,1,0,1
7434,sposato,1,1,0,1
7435,scoprì,1,1,0,1
7437,Klein,1,1,0,1
7439,ghiacciata.,1,1,0,1
7440,cumulativamente,1,1,0,1
7443,mancasse,1,1,0,1
7444,l',1,1,0,1
7447,determinarne,1,1,0,1
7551,caccia,1,1,0,1
7450,pubblicate.,1,1,0,1
7451,formata.,1,1,0,1
7456,anti-consenso,1,1,0,1
7458,insufficienza,1,1,0,1
7460,aiutarti.,1,1,0,1
7471,economiche,1,1,0,1
7476,IV,1,1,0,1
7432,collaborare,1,1,0,1
7427,complicati,1,1,0,1
7426,algoritmiche,1,1,0,1
7425,espliciti.,1,1,0,1
7400,affidabile.,1,1,0,1
7401,"neurali,",1,1,0,1
7404,costituiti,1,1,0,1
7406,sollevare,1,1,0,1
7407,"Manning,",1,1,0,1
7408,"trimestre,",1,1,0,1
7411,matematica.,1,1,0,1
7412,giocare,1,1,0,1
7414,mistero.,1,1,0,1
7416,focalizza,1,1,0,1
7420,esisteva,1,1,0,1
7421,«sebbene,1,1,0,1
7422,costituite,1,1,0,1
7423,spadolini,1,1,0,1
7424,condizioni.,1,1,0,1
7477,visitato,1,1,0,1
7478,[aggiornamento].,1,1,0,1
7479,ondulatoria,1,1,0,1
7509,"mediawiki,",1,1,0,1
7513,deformate,1,1,0,1
7520,senses,1,1,0,1
7524,rinforzo.,1,1,0,1
7525,"complessiva,",1,1,0,1
7529,sottolineò,1,1,0,1
7530,degne,1,1,0,1
7531,collisione,1,1,0,1
7533,"nota,",1,1,0,1
7534,pubblicava,1,1,0,1
7537,"bomis,",1,1,0,1
7539,citizendium.,1,1,0,1
7541,Quando,1,1,0,1
7545,sospettato,1,1,0,1
7546,"bot,",1,1,0,1
7549,sosta,1,1,0,1
7511,indicarne,1,1,0,1
7507,"funzione,",1,1,0,1
7480,"Heilman,",1,1,0,1
7505,"immangiabile,",1,1,0,1
7481,affrontano,1,1,0,1
7482,"prestazioni,",1,1,0,1
7483,minuscolo,1,1,0,1
7484,conclude,1,1,0,1
7485,"perché,",1,1,0,1
7486,tettoniche,1,1,0,1
7487,sottorappresentata.,1,1,0,1
7489,eccetto,1,1,0,1
7491,retribuzione,1,1,0,1
7493,sostituisce,1,1,0,1
7496,rivoluzione,1,1,0,1
7498,facevano,1,1,0,1
7501,impiego,1,1,0,1
7503,endemiche,1,1,0,1
7504,"telefonata,",1,1,0,1
7693,minaccioso.,1,1,0,1
7694,consapevolezza,1,1,0,1
7695,settentrionale,1,1,0,1
7916,Mark,1,1,0,1
7903,quell'aspetto,1,1,0,1
7904,spicco,1,1,0,1
7905,qualificano,1,1,0,1
7910,apprezzati,1,1,0,1
7911,evitato,1,1,0,1
7912,tecnologico,1,1,0,1
7913,passività,1,1,0,1
7918,convenzionali,1,1,0,1
7863,presentano,1,1,0,1
7919,avvicinò,1,1,0,1
7920,religiose,1,1,0,1
7923,subisce,1,1,0,1
7924,News,1,1,0,1
7928,rompersi.,1,1,0,1
7929,circolazione,1,1,0,1
7931,modellati,1,1,0,1
7900,l'imitazione.,1,1,0,1
7898,distorti,1,1,0,1
7897,otterrai,1,1,0,1
7896,nell'entroterra,1,1,0,1
7867,illeggibile.,1,1,0,1
7868,rimuovendo,1,1,0,1
7869,dell'organizzazione,1,1,0,1
7870,"d'origine,",1,1,0,1
7871,intensificare,1,1,0,1
7872,detengono,1,1,0,1
7879,decisi,1,1,0,1
7882,"comete,",1,1,0,1
7883,svezia,1,1,0,1
7888,vandali,1,1,0,1
7890,evidenti,1,1,0,1
7891,Cancer,1,1,0,1
7892,rilevano,1,1,0,1
7893,iniziando,1,1,0,1
7894,sciame,1,1,0,1
7935,"selvatici,",1,1,0,1
7936,nell'emisfero,1,1,0,1
7937,dell'abbattimento,1,1,0,1
7973,nostri,1,1,0,1
7976,conquista,1,1,0,1
7978,decoro,1,1,0,1
7979,gestito,1,1,0,1
7982,management,1,1,0,1
7987,ricostruzione,1,1,0,1
7988,riorganizzato,1,1,0,1
7990,evidenti.,1,1,0,1
7992,"soldi,",1,1,0,1
7998,presupposti,1,1,0,1
7999,rifiuta,1,1,0,1
8002,coincidere,1,1,0,1
8011,accordo,1,1,0,1
8012,ritorna,1,1,0,1
8014,gravità.,1,1,0,1
8016,minima,1,1,0,1
7974,distribuzioni,1,1,0,1
7972,"stagni,",1,1,0,1
7938,qualora,1,1,0,1
7970,lamentarmi,1,1,0,1
7939,"laccoliti,",1,1,0,1
7940,partendo,1,1,0,1
7941,tecniche.,1,1,0,1
7942,«a,1,1,0,1
7947,posti,1,1,0,1
7948,cancellazionismo,1,1,0,1
7949,licenziati,1,1,0,1
7953,contenga,1,1,0,1
7954,"Excel,",1,1,0,1
7958,esaminate,1,1,0,1
7960,circolano,1,1,0,1
7965,livelli.,1,1,0,1
7966,segnalate,1,1,0,1
7967,approssimativa,1,1,0,1
7969,"genetico,",1,1,0,1
7865,sociologico-culturale,1,1,0,1
7859,u.s.,1,1,0,1
7697,aggiornata,1,1,0,1
7755,acconsente,1,1,0,1
7733,primato,1,1,0,1
7735,invia,1,1,0,1
7736,possedute,1,1,0,1
7737,dell'incidente,1,1,0,1
7739,vietare,1,1,0,1
7746,disgregazione,1,1,0,1
7753,sperimentato,1,1,0,1
7759,tribunale.,1,1,0,1
7855,guidata,1,1,0,1
7760,bellissima.,1,1,0,1
7761,distintiva,1,1,0,1
7763,digestiva,1,1,0,1
7764,Chelsea,1,1,0,1
7765,meritano,1,1,0,1
7768,separazione,1,1,0,1
7770,«uno,1,1,0,1
7730,nera,1,1,0,1
7729,front-end,1,1,0,1
7728,Puoi,1,1,0,1
7727,stagionale,1,1,0,1
7701,scuoti,1,1,0,1
7703,"pipa,",1,1,0,1
7704,baie,1,1,0,1
7705,"visualizzazione,",1,1,0,1
7707,morte,1,1,0,1
7709,etichetta.,1,1,0,1
7710,sinapsi,1,1,0,1
7712,aggiungendovi,1,1,0,1
7715,E,1,1,0,1
7718,ripetute,1,1,0,1
7719,eravamo.,1,1,0,1
7722,consolidati,1,1,0,1
7723,rappresentare.,1,1,0,1
7725,trasformano.,1,1,0,1
7726,Sun,1,1,0,1
7771,incrementato,1,1,0,1
7773,fredda,1,1,0,1
7774,d'ufficio,1,1,0,1
7809,notorietà.,1,1,0,1
7812,"cablata,",1,1,0,1
7813,significherebbe,1,1,0,1
7816,nebulosa,1,1,0,1
7818,storie,1,1,0,1
7821,metterne,1,1,0,1
7822,compact,1,1,0,1
7823,probabilistiche,1,1,0,1
7831,impone,1,1,0,1
7832,precedente.,1,1,0,1
7835,"pratica,",1,1,0,1
7839,Google,1,1,0,1
7842,"lamentarti,",1,1,0,1
7843,sufficienti,1,1,0,1
7853,esponendo,1,1,0,1
7854,dell'Inghilterra.,1,1,0,1
7811,(tipicamente,1,1,0,1
7808,riguardano,1,1,0,1
7777,americani.,1,1,0,1
7805,cellulare?,1,1,0,1
7779,webmasters,1,1,0,1
7780,stupita,1,1,0,1
7784,missione.,1,1,0,1
7785,dell'estrazione,1,1,0,1
7787,partecipativa,1,1,0,1
7788,«quando,1,1,0,1
7791,"nichel,",1,1,0,1
7792,polare,1,1,0,1
7794,iterazione,1,1,0,1
7796,condensazione,1,1,0,1
7797,dall'oceano,1,1,0,1
7800,quattromila,1,1,0,1
7801,scambiano,1,1,0,1
7802,compongano,1,1,0,1
7803,papert,1,1,0,1
8629,temporali,1,1,0,1
8632,compone,1,1,0,1
7398,pazienti,1,1,0,1
9351,lasting,0,0,1,1
9341,οικονομία,0,0,1,1
9342,sinemaya,0,0,1,1
9343,координационным,0,0,1,1
9345,seyahatlerini,0,0,1,1
9346,सेबुआनो,0,0,1,1
9348,målet,0,0,1,1
9349,ಟಿ,0,0,1,1
9352,subjectives,0,0,1,1
9370,വരുത്തുക,0,0,1,1
9353,رؤيتك,0,0,1,1
9355,ошеломленным,0,0,1,1
9360,spisestuen,0,0,1,1
9361,alınmaz,0,0,1,1
9362,माइक्रो,0,0,1,1
9366,resultando,0,0,1,1
9367,sauvages,0,0,1,1
9340,قادرا,0,0,1,1
9339,bid,0,0,1,1
9337,supportée,0,0,1,1
9334,criterion,0,0,1,1
9313,«отделения,0,0,1,1
9314,debatidos,0,0,1,1
9315,acompanha,0,0,1,1
9316,освещения,0,0,1,1
9318,вопроса,0,0,1,1
9319,പ്രവർത്തിക്കുന്നത്,0,0,1,1
9320,مجهول,0,0,1,1
9323,actors,0,0,1,1
9325,വർദ്ധച്ചുകൊണ്ടിരിക്കുന്ന,0,0,1,1
9326,περιλαμβάνουν,0,0,1,1
9327,verschil,0,0,1,1
9328,دكتوراه,0,0,1,1
9331,indexation,0,0,1,1
9332,licensen,0,0,1,1
9333,añadir,0,0,1,1
9369,sverker,0,0,1,1
9371,കീഴ്‌വഴക്കവും,0,0,1,1
9422,प्रतिक्रिया,0,0,1,1
9410,pekala,0,0,1,1
9400,émoussé,0,0,1,1
9401,ஆரம்பிக்கலாம்,0,0,1,1
9402,cheers,0,0,1,1
9405,هنري,0,0,1,1
9406,hepsi,0,0,1,1
9407,الأمير,0,0,1,1
9409,imprima,0,0,1,1
9411,онлайнобращение,0,0,1,1
9373,prouviez,0,0,1,1
9412,väl,0,0,1,1
9414,patiently,0,0,1,1
9415,மொத்தக்,0,0,1,1
9416,mantle,0,0,1,1
9417,tournent,0,0,1,1
9418,soportes,0,0,1,1
9420,العالمية,0,0,1,1
9399,fi,0,0,1,1
9395,വാരാന്ത്യ,0,0,1,1
9394,arwid,0,0,1,1
9393,அன்றிரவு,0,0,1,1
9374,разослано,0,0,1,1
9376,rigtige,0,0,1,1
9377,tausend,0,0,1,1
9378,eklenebilmesine,0,0,1,1
9379,islandés,0,0,1,1
9380,தோட்டத்தில்,0,0,1,1
9381,ஒருவகை,0,0,1,1
9382,பட்டியல்,0,0,1,1
9384,बीस,0,0,1,1
9386,brits,0,0,1,1
9387,üyelik,0,0,1,1
9388,fear,0,0,1,1
9390,vergadering,0,0,1,1
9391,வித்தியாசமாகக்,0,0,1,1
9392,cunt,0,0,1,1
9312,nankín,0,0,1,1
9311,"
सिंहला",0,0,1,1
9309,κάνατε,0,0,1,1
9232,ocasionales,0,0,1,1
9223,veranderde,0,0,1,1
9224,wikikoden,0,0,1,1
9226,சாப்பாட்டு,0,0,1,1
9228,vivent,0,0,1,1
9229,"ഒരു
വീട്ടമ്മ",0,0,1,1
9230,evaluate,0,0,1,1
9231,classent,0,0,1,1
9233,перевод,0,0,1,1
9308,canınızı,0,0,1,1
9234,administratörsval,0,0,1,1
9235,ಆಯ್ಕೆಗಳ,0,0,1,1
9236,ಇಳಿಸಿದರೆ,0,0,1,1
9240,observa,0,0,1,1
9241,വിജ്ഞാന,0,0,1,1
9242,apropriado,0,0,1,1
9244,действие,0,0,1,1
9222,verkeert,0,0,1,1
9221,hoes,0,0,1,1
9220,passaram,0,0,1,1
9219,ومستدامًا,0,0,1,1
9199,sidetoside,0,0,1,1
9200,categorización,0,0,1,1
9201,conflicto,0,0,1,1
9202,للحواسيب,0,0,1,1
9203,ediyordum,0,0,1,1
9204,بلودجيت,0,0,1,1
9205,evner,0,0,1,1
9207,stärka,0,0,1,1
9208,épouse,0,0,1,1
9209,narzissmus,0,0,1,1
9210,وشخص,0,0,1,1
9213,классе,0,0,1,1
9214,αναφορές,0,0,1,1
9215,givet,0,0,1,1
9216,зверски,0,0,1,1
9247,casarme,0,0,1,1
9248,маме,0,0,1,1
9249,ആയിരിക്കുമെന്ന്,0,0,1,1
9281,labyrinthine,0,0,1,1
9283,répréhensibles,0,0,1,1
9284,تعقب,0,0,1,1
9285,வாக்கியத்தைப்,0,0,1,1
9287,undesirable,0,0,1,1
9288,себе,0,0,1,1
9289,общество,0,0,1,1
9290,नोट,0,0,1,1
9294,необходимости,0,0,1,1
9295,employees,0,0,1,1
9296,cliquear,0,0,1,1
9297,കിടക്കുകയാണ്,0,0,1,1
9300,ವರ್ತಿಸಿದ,0,0,1,1
9302,الشريحة,0,0,1,1
9306,heyecanlanıyoruz,0,0,1,1
9307,പുറത്തുവന്ന്,0,0,1,1
9282,aprendi,0,0,1,1
9277,izleyebilirler,0,0,1,1
9251,ದಾಟುತ್ತೀರಿ,0,0,1,1
9276,nisan,0,0,1,1
9252,corrió,0,0,1,1
9253,تفكير,0,0,1,1
9254,ಮಾಡುತ್ತೇನೆ,0,0,1,1
9256,основателей,0,0,1,1
9257,ботами,0,0,1,1
9258,تكشف,0,0,1,1
9259,abschied,0,0,1,1
9261,oradan,0,0,1,1
9264,ഉള്ളൂവെന്നും,0,0,1,1
9265,çabası,0,0,1,1
9267,énumère,0,0,1,1
9269,kategoriserades,0,0,1,1
9271,χρησιμοποιηθούν,0,0,1,1
9272,κάστρο,0,0,1,1
9273,reader,0,0,1,1
9421,slutningen,0,0,1,1
9423,sürümünde,0,0,1,1
8635,avrebbero,1,1,0,1
9592,prestação,0,0,1,1
9581,suggérait,0,0,1,1
9582,ಮಟ್ಟಿಗೆ,0,0,1,1
9583,серьёзно,0,0,1,1
9585,முயற்சிக்கு,0,0,1,1
9586,والنقاشات,0,0,1,1
9587,utgivare,0,0,1,1
9589,الكيميائية،,0,0,1,1
9593,simple •,0,0,1,1
9606,числе,0,0,1,1
9594,momentos,0,0,1,1
9596,günüyse,0,0,1,1
9597,neredeydik,0,0,1,1
9600,knight,0,0,1,1
9601,çeyrekte,0,0,1,1
9602,concluyó,0,0,1,1
9603,υποθέστε,0,0,1,1
9577,humoristiques,0,0,1,1
9576,theme,0,0,1,1
9575,zamanlarda,0,0,1,1
9574,exprimée,0,0,1,1
9548,الأمريكية,0,0,1,1
9552,végétales,0,0,1,1
9553,ouvrir,0,0,1,1
9559,«нейтральной,0,0,1,1
9560,बोलिये।,0,0,1,1
9561,yazıyı,0,0,1,1
9563,സാധ്യമാ‍വുകയുള്ളൂ,0,0,1,1
9564,நபர்களாக,0,0,1,1
9565,multas,0,0,1,1
9566,campus,0,0,1,1
9567,हटाने,0,0,1,1
9568,അസൈൻമെന്റുകൾ,0,0,1,1
9570,periódico—,0,0,1,1
9571,प्रबल,0,0,1,1
9573,nederlandstalige,0,0,1,1
9605,«введите,0,0,1,1
9609,distinctif,0,0,1,1
9424,уровней,0,0,1,1
9650,forlader,0,0,1,1
9642,censureringar,0,0,1,1
9643,vitalist,0,0,1,1
9644,kamu,0,0,1,1
9646,делал,0,0,1,1
9647,eukaryotes,0,0,1,1
9648,cavalgando,0,0,1,1
9649,désacralisé,0,0,1,1
9651,burnu,0,0,1,1
9610,बचना।,0,0,1,1
9652,நிபுணர்களால்,0,0,1,1
9653,documented,0,0,1,1
9654,വേരുകൾ,0,0,1,1
9655,التباطؤ,0,0,1,1
9656,broadly,0,0,1,1
9657,сожалению,0,0,1,1
9659,സൂര്യനിൽ,0,0,1,1
9641,station,0,0,1,1
9639,വ്യാപിച്ചു,0,0,1,1
9638,представителя,0,0,1,1
9637,konkurrens,0,0,1,1
9611,നെഗറ്റീവും,0,0,1,1
9613,gerou,0,0,1,1
9615,الاعتذار,0,0,1,1
9616,rik,0,0,1,1
9620,stimme,0,0,1,1
9621,നിലനിൽക്കുന്നത്,0,0,1,1
9622,بهذه,0,0,1,1
9625,matando,0,0,1,1
9626,irregular​,0,0,1,1
9629,queries,0,0,1,1
9630,ಕ್ರಿಯೆ,0,0,1,1
9632,ಸಂಭಾಷಣೆಯನ್ನು,0,0,1,1
9634,defendem,0,0,1,1
9635,εγωιστική,0,0,1,1
9636,celestial,0,0,1,1
9547,domestiques,0,0,1,1
9546,நாளும்,0,0,1,1
9544,इंटरेक्टिव,0,0,1,1
9467,smukkeste,0,0,1,1
9457,preparese,0,0,1,1
9458,கூட்டாகத்,0,0,1,1
9459,नरसिंह,0,0,1,1
9460,quick,0,0,1,1
9462,contestadas,0,0,1,1
9463,benämnda,0,0,1,1
9464,الشعبية,0,0,1,1
9468,പ്രശ്നമുള്ള,0,0,1,1
9543,lagstiftningen,0,0,1,1
9471,ಹೇಳುವುದು,0,0,1,1
9472,toplamda,0,0,1,1
9473,நிமிடத்தில்,0,0,1,1
9475,misbruik,0,0,1,1
9476,interestingness,0,0,1,1
9477,μπερδευτείτε,0,0,1,1
9478,சுற்றி,0,0,1,1
9455,pflanzen,0,0,1,1
9454,engaging,0,0,1,1
9451,нормальный,0,0,1,1
9450,"
पोलिश",0,0,1,1
9425,وسيمًا,0,0,1,1
9427,yayımladığı,0,0,1,1
9428,expressou,0,0,1,1
9430,неудач,0,0,1,1
9431,notified,0,0,1,1
9432,زاوية,0,0,1,1
9433,മൂർച്ചയുള്ളവയെ,0,0,1,1
9436,fakta,0,0,1,1
9438,gemeenschap,0,0,1,1
9439,öğrenin,0,0,1,1
9442,vagonla,0,0,1,1
9444,أمام,0,0,1,1
9445,ಹತ್ತು,0,0,1,1
9447,id •,0,0,1,1
9448,presenterats,0,0,1,1
9481,ஆச்சரியமாகக்,0,0,1,1
9482,بماذا,0,0,1,1
9483,irc,0,0,1,1
9515,ನೀನೇನು,0,0,1,1
9519,അരികിലിരുന്നു,0,0,1,1
9521,മാറ്റിനിർത്തി,0,0,1,1
9522,ಸಾಲವನ್ನು,0,0,1,1
9523,hayan,0,0,1,1
9525,अवरुद्ध,0,0,1,1
9527,översättning,0,0,1,1
9528,финансирование,0,0,1,1
9529,постоянно,0,0,1,1
9531, ومؤسسة,0,0,1,1
9532,физической,0,0,1,1
9534,bekendste,0,0,1,1
9537,nagedacht,0,0,1,1
9539,обработка,0,0,1,1
9540,посчитает,0,0,1,1
9541,ödevi,0,0,1,1
9518,உணர்த்தியது,0,0,1,1
9514,αγαπημένη,0,0,1,1
9486,ಹೇಳಲಾರೆ,0,0,1,1
9512,dilim,0,0,1,1
9488,immanente,0,0,1,1
9489,glace,0,0,1,1
9491,علاوة,0,0,1,1
9492,носители,0,0,1,1
9495,laissant,0,0,1,1
9496,prompts,0,0,1,1
9497,ಸಂದಿಗ್ಧತೆ,0,0,1,1
9502,veteranos,0,0,1,1
9503,fondations,0,0,1,1
9504,هذا؟,0,0,1,1
9505,leicht,0,0,1,1
9506,timen,0,0,1,1
9507,"w
कैटलन",0,0,1,1
9509,അമ്പരന്നു,0,0,1,1
9510,പിടിക്കാത്തതിനാൽ,0,0,1,1
9198,уловкой,0,0,1,1
9195,mätningar,0,0,1,1
9194,அழுத்தவும்,0,0,1,1
8850,dirompente.,1,1,0,1
8835,lasciati,1,1,0,1
8838,ceduto,1,1,0,1
8839,occitano.,1,1,0,1
8840,cessano,1,1,0,1
8841,dipinti.,1,1,0,1
8847,preventivo,1,1,0,1
8848,letargiche,1,1,0,1
8852,innumerevoli,1,1,0,1
8865,esservi,1,1,0,1
8853,librerie.,1,1,0,1
8854,gay,1,1,0,1
8855,impegnarsi,1,1,0,1
8856,d'informazione.,1,1,0,1
8857,annegamento,1,1,0,1
8859,misurati,1,1,0,1
8860,eseguendo,1,1,0,1
8834,fissando,1,1,0,1
8830,basi,1,1,0,1
8829,all'algoritmo,1,1,0,1
8828,caratteristico,1,1,0,1
8800,limitarsi,1,1,0,1
8801,nell'information,1,1,0,1
8803,mero,1,1,0,1
8808,appreso,1,1,0,1
8809,dimostra,1,1,0,1
8814,davanzali,1,1,0,1
8815,anti-elitaria,1,1,0,1
8817,affermavano,1,1,0,1
8818,convalida,1,1,0,1
8819,effettuare,1,1,0,1
8820,"grandioso,",1,1,0,1
8822,california.,1,1,0,1
8824,percezione,1,1,0,1
8826,indesiderate.,1,1,0,1
8827,cosmici,1,1,0,1
8861,affondare,1,1,0,1
8866,aumentata,1,1,0,1
9190,interdit,0,0,1,1
8918,l'hanno,1,1,0,1
8904,metabolismo,1,1,0,1
8905,leggero,1,1,0,1
8906,universo,1,1,0,1
8907,lontano,1,1,0,1
8909,pensato,1,1,0,1
8913,pazzo.,1,1,0,1
8914,sullo,1,1,0,1
8922,"primarie,",1,1,0,1
8867,sull'approccio,1,1,0,1
8924,glaciazione,1,1,0,1
8926,entrati,1,1,0,1
8927,vocabolari,1,1,0,1
8929,emozione.,1,1,0,1
8932,"depositata,",1,1,0,1
8933,avviso,1,1,0,1
8934,​​da,1,1,0,1
8903,raggiunto milioni,1,1,0,1
8902,caa.,1,1,0,1
8900,privilegi,1,1,0,1
8898,supercontinente,1,1,0,1
8868,erbacce,1,1,0,1
8870,Association,1,1,0,1
8872,sollecitazione,1,1,0,1
8879,meteore.,1,1,0,1
8880,"relazioni,",1,1,0,1
8883,"premio,",1,1,0,1
8886,dimensioni.,1,1,0,1
8887,Abraham,1,1,0,1
8888,"UV,",1,1,0,1
8889,widrow.,1,1,0,1
8891,esplora,1,1,0,1
8892,migrato,1,1,0,1
8893,vocali,1,1,0,1
8895,apporta,1,1,0,1
8897,"webcomic,",1,1,0,1
8799,rivali,1,1,0,1
8798,anidride,1,1,0,1
8797,riprenditi,1,1,0,1
8682,noi',1,1,0,1
8671,luminosità,1,1,0,1
8674,inaffidabile,1,1,0,1
8675,discernere,1,1,0,1
8676,ricoperta,1,1,0,1
8678,"terrestre,",1,1,0,1
8679,"oggi,",1,1,0,1
8681,"metabolismo,",1,1,0,1
8683,"difetti,",1,1,0,1
8796,Qual'è,1,1,0,1
8685,"""intelligente""",1,1,0,1
8686,epoche,1,1,0,1
8687,"politico,",1,1,0,1
8692,concentrazione,1,1,0,1
8694,'70,1,1,0,1
8697,modalità,1,1,0,1
8700,incrociare,1,1,0,1
8669,alanturing,1,1,0,1
8668,sopra,1,1,0,1
8667,meraviglioso,1,1,0,1
8664,dall'inclinazione,1,1,0,1
8636,segue.,1,1,0,1
8639,clustering.,1,1,0,1
8641,"biblioteche,",1,1,0,1
8642,riunione.,1,1,0,1
8643,convalidata,1,1,0,1
8644,crusca,1,1,0,1
8645,filosofiche,1,1,0,1
8646,proteiche,1,1,0,1
8647,affamato,1,1,0,1
8649,adottano,1,1,0,1
8652,esplicito,1,1,0,1
8653,scrub,1,1,0,1
8655,prestare,1,1,0,1
8656,la.,1,1,0,1
8657,adattata,1,1,0,1
8701,vittoriano.,1,1,0,1
8705,circonda,1,1,0,1
8711,entrambe.,1,1,0,1
8756,culturali.,1,1,0,1
8758,rafforzato,1,1,0,1
8760,fumetto,1,1,0,1
8762,stilistici,1,1,0,1
8765,dell'opera,1,1,0,1
8766,feci,1,1,0,1
8768,esplicite.,1,1,0,1
8771,URL.,1,1,0,1
8773,gne.,1,1,0,1
8775,benefici,1,1,0,1
8777,estensioni,1,1,0,1
8778,urtò,1,1,0,1
8780,masturbazione,1,1,0,1
8782,completi,1,1,0,1
8788,l'associazione,1,1,0,1
8791,aviari,1,1,0,1
8757,riconoscibili,1,1,0,1
8755,barre,1,1,0,1
8715,"oviedo,",1,1,0,1
8753,sguardo,1,1,0,1
8717,disegno,1,1,0,1
8718,"dell'informazione,",1,1,0,1
8722,inserimenti,1,1,0,1
8726,protettive,1,1,0,1
8727,computazionalmente,1,1,0,1
8730,combinata,1,1,0,1
8733,avviare,1,1,0,1
8735,alternativa.,1,1,0,1
8737,utilizzarle,1,1,0,1
8739,politica.,1,1,0,1
8740,sull'oscenità.,1,1,0,1
8741,annullata,1,1,0,1
8742,applicativi,1,1,0,1
8746,spaventoso.,1,1,0,1
8747,riservato,1,1,0,1
8935,web»,1,1,0,1
8938,un'influenza,1,1,0,1
8944,"contenuti,",1,1,0,1
9126,préparée,0,0,1,1
9117,démarches,0,0,1,1
9118,hæve,0,0,1,1
9119,högervinkling,0,0,1,1
9120,കഴിക്കുന്നതിനെക്കുറിച്ച്,0,0,1,1
9121,prérogatives,0,0,1,1
9123,подкасты,0,0,1,1
9125,kore,0,0,1,1
9127,enhancements,0,0,1,1
9076,dà,1,1,0,1
9129,और।,0,0,1,1
9130,apareció,0,0,1,1
9131,நர்சிஸ்,0,0,1,1
9132,അതിനുപകരം,0,0,1,1
9135,puzzled,0,0,1,1
9136,concurreert,0,0,1,1
9137,limitamse,0,0,1,1
9116,biggest,0,0,1,1
9115,பைத்தியம்,0,0,1,1
9108,отклику,0,0,1,1
9107,donnant,0,0,1,1
9083,இடம்பெற,0,0,1,1
9084,ceasing,0,0,1,1
9086,astonishing,0,0,1,1
9087,ಮಾಣಿಕ್ಯ,0,0,1,1
9088,enmobilewikipediaorg,0,0,1,1
9089,respondeu,0,0,1,1
9090,இன்,0,0,1,1
9091,والبولندية,0,0,1,1
9095,décernés,0,0,1,1
9097,«nuestra,0,0,1,1
9098,witty,0,0,1,1
9099,ಹೊಡೆದಿದ್ದೀರಿ,0,0,1,1
9101,வரையறை,0,0,1,1
9102,അമ്മേ,0,0,1,1
9103,foundation”,0,0,1,1
9138,повторения,0,0,1,1
9139,المال,0,0,1,1
9140,ವಿಶೇಷವಾಗಿ,0,0,1,1
9167,ചോദിക്കുമ്പോൾ,0,0,1,1
9169,acento,0,0,1,1
9173,однополых,0,0,1,1
9174,limiting,0,0,1,1
9176,polyvalente,0,0,1,1
9177,studerar,0,0,1,1
9178,construct,0,0,1,1
9179,பொருத்தமானதாக,0,0,1,1
9181,vendus,0,0,1,1
9182,مخاوف,0,0,1,1
9183,الحلزون,0,0,1,1
9184,அனுப்பி,0,0,1,1
9185,ಸಂತೋಷವಾಗಿದೆ,0,0,1,1
9186,ஹவாய்,0,0,1,1
9187,superou,0,0,1,1
9189,vorschläge,0,0,1,1
9168,विद्वानों,0,0,1,1
9165,சொல்வதைச்,0,0,1,1
9141,behaviour,0,0,1,1
9163,وwikipediaorg,0,0,1,1
9142,lionel,0,0,1,1
9143,runs,0,0,1,1
9144,ഇവിടെയെത്തി,0,0,1,1
9145,yaşardı,0,0,1,1
9146,exercise,0,0,1,1
9147,esams,0,0,1,1
9150,cancerous,0,0,1,1
9151,bercezvous,0,0,1,1
9152,configurations,0,0,1,1
9153,energidryck,0,0,1,1
9154,χαρούμε,0,0,1,1
9158,യാന്ത്രികമായാണ്,0,0,1,1
9159,नियमों,0,0,1,1
9160,தூக்கத்தில்,0,0,1,1
9162,возможного,0,0,1,1
9082,colecciones,0,0,1,1
9073,statunitense,1,1,0,1
8945,biologica,1,1,0,1
8989,impossibili,1,1,0,1
8974,triplice,1,1,0,1
8976,particolarità,1,1,0,1
8977,attrae,1,1,0,1
8979,assetato,1,1,0,1
8983,assurde.,1,1,0,1
8985,Mercurio,1,1,0,1
8987,l'esperienza.,1,1,0,1
8990,commentare,1,1,0,1
9071,telegiornale,1,1,0,1
8991,carattere,1,1,0,1
8996,interstellare,1,1,0,1
8998,totale.,1,1,0,1
9001,collaborano,1,1,0,1
9002,aumentato,1,1,0,1
9005,fatto.,1,1,0,1
9007,inserzionisti,1,1,0,1
8973,progresso,1,1,0,1
8972,risolvere.,1,1,0,1
8971,blogger,1,1,0,1
8970,schianto.,1,1,0,1
8947,dell'altoparlante,1,1,0,1
8950,biforcazione,1,1,0,1
8951,sottorappresentati.,1,1,0,1
8952,scopi».,1,1,0,1
8953,mappando,1,1,0,1
8954,Grazie,1,1,0,1
8955,frammentati,1,1,0,1
8957,Apple.,1,1,0,1
8959,immagini.,1,1,0,1
8962,cicli,1,1,0,1
8963,coppia,1,1,0,1
8964,Ho,1,1,0,1
8966,vìchi,1,1,0,1
8968,nascita.,1,1,0,1
8969,esposta,1,1,0,1
9011,traduzioni,1,1,0,1
9012,campioni.,1,1,0,1
9013,prestigiose,1,1,0,1
9041,rapido,1,1,0,1
9044,rosso,1,1,0,1
9045,servite,1,1,0,1
9046,solida.,1,1,0,1
9049,sopravvissute,1,1,0,1
9052,preparazione,1,1,0,1
9054,avanzamenti,1,1,0,1
9055,strizzarono,1,1,0,1
9057,interessano,1,1,0,1
9061,cittadini,1,1,0,1
9062,controverse.,1,1,0,1
9063,costituiscano,1,1,0,1
9064,demografia,1,1,0,1
9067,statico,1,1,0,1
9068,addestrarlo,1,1,0,1
9070,causando,1,1,0,1
9043,sviluppatosi,1,1,0,1
9038,indicatori,1,1,0,1
9014,sovrastante.,1,1,0,1
9037,"false"".",1,1,0,1
9015,definite.,1,1,0,1
9016,campionamento,1,1,0,1
9017,panorama.,1,1,0,1
9019,gpu,1,1,0,1
9020,algoritmicamente,1,1,0,1
9022,intenzionalmente,1,1,0,1
9023,"importa,",1,1,0,1
9024,"commerciali,",1,1,0,1
9025,sesto.,1,1,0,1
9026,verificata.,1,1,0,1
9029,spingendone,1,1,0,1
9030,accadrà,1,1,0,1
9031,reiterato.,1,1,0,1
9032,ringraziamento,1,1,0,1
9035,terrestri.,1,1,0,1
7399,numerico,1,1,0,1
7397,vitali,1,1,0,1
4869,"significativo,",1,1,0,1
5727,"Quanrill,",1,1,0,1
5715,dottorato,1,1,0,1
5718,"corso,",1,1,0,1
5719,lati,1,1,0,1
5723,soltanto,1,1,0,1
5724,"pazienti,",1,1,0,1
5725,dall'ambiente,1,1,0,1
5726,cortesemente.,1,1,0,1
5729,quell'articolo,1,1,0,1
5740,indicizza,1,1,0,1
5730,sfida,1,1,0,1
5732,avvicinarsi,1,1,0,1
5733,venti,1,1,0,1
5734,calcolare,1,1,0,1
5735,affinché,1,1,0,1
5736,circa miliardi,1,1,0,1
5737,l'offerta.,1,1,0,1
5714,esperti.,1,1,0,1
5713,storiche.,1,1,0,1
5708,retrieval.,1,1,0,1
5706,modellizzare,1,1,0,1
5674,registrato,1,1,0,1
5675,coesistettero,1,1,0,1
5677,consuma,1,1,0,1
5679,passaggi,1,1,0,1
5680,facciano,1,1,0,1
5683,volume,1,1,0,1
5684,reindirizzamento,1,1,0,1
5685,co-fondatore.,1,1,0,1
5687,lato.,1,1,0,1
5689,semi-protetto,1,1,0,1
5695,"soprattutto,",1,1,0,1
5697,l'equità,1,1,0,1
5699,interazione,1,1,0,1
5703,basare,1,1,0,1
5704,opposte.,1,1,0,1
5738,ripristino/ripristino,1,1,0,1
5743,combinandosi,1,1,0,1
5822,sconcertata,1,1,0,1
5804,speranza,1,1,0,1
5790,moralità.,1,1,0,1
5791,nell'editorialista,1,1,0,1
5794,somma,1,1,0,1
5796,sanitarie,1,1,0,1
5797,cancellato,1,1,0,1
5798,"negativo,",1,1,0,1
5800,tromba,1,1,0,1
5806,fredde.,1,1,0,1
5745,traduttore,1,1,0,1
5807,divergenti,1,1,0,1
5808,utile.,1,1,0,1
5809,{onionspotatoes},1,1,0,1
5812,attualità,1,1,0,1
5816,"ridistribuzione,",1,1,0,1
5818,africana,1,1,0,1
5820,"serra,",1,1,0,1
5789,maschio,1,1,0,1
5785,Yaacov,1,1,0,1
5784,"superiori,",1,1,0,1
5782,parlarne.,1,1,0,1
5748,impostate,1,1,0,1
5751,dichiarò,1,1,0,1
5753,mimesi,1,1,0,1
5756,modificarlo.,1,1,0,1
5760,avanzati,1,1,0,1
5763,pagato,1,1,0,1
5764,dell'ecologia,1,1,0,1
5766,manifestazione,1,1,0,1
5767,wikipediano,1,1,0,1
5772,"te,",1,1,0,1
5773,rivelarsi,1,1,0,1
5775,relazione,1,1,0,1
5778,giornalieri.,1,1,0,1
5779,"classificazione,",1,1,0,1
5781,tradeoff,1,1,0,1
5673,assenza,1,1,0,1
5667,dedicate,1,1,0,1
5666,riparati.,1,1,0,1
5557,oscura.,1,1,0,1
5547,atomici,1,1,0,1
5548,riproduzione.,1,1,0,1
5550,cedette,1,1,0,1
5552,accademica.,1,1,0,1
5553,progettando.,1,1,0,1
5554,connessionisti,1,1,0,1
5555,necessario],1,1,0,1
5559,tecnologie,1,1,0,1
5664,assegnati,1,1,0,1
5561,commenta,1,1,0,1
5565,uichipedìa,1,1,0,1
5566,provenga,1,1,0,1
5568,sfoggio».,1,1,0,1
5569,trofica,1,1,0,1
5570,sconcertante,1,1,0,1
5572,conosciute.,1,1,0,1
5546,risentirebbe,1,1,0,1
5544,dato.,1,1,0,1
5543,integra,1,1,0,1
5542,scorso.,1,1,0,1
5516,nah.,1,1,0,1
5517,implementazione,1,1,0,1
5519,boyd,1,1,0,1
5521,rendendo,1,1,0,1
5523,posizioni.,1,1,0,1
5525,accolto,1,1,0,1
5526,democratici,1,1,0,1
5528,vive,1,1,0,1
5530,subentrando,1,1,0,1
5532,"sempre,",1,1,0,1
5534,nominano,1,1,0,1
5535,improvvisi,1,1,0,1
5537,estinzioni,1,1,0,1
5538,divina,1,1,0,1
5539,microcorrenti,1,1,0,1
5574,glaciale.,1,1,0,1
5575,aereo,1,1,0,1
5576,sabato.,1,1,0,1
5620,apportato,1,1,0,1
5622,formata,1,1,0,1
5627,all'equatore,1,1,0,1
5632,acquista,1,1,0,1
5633,ingressi,1,1,0,1
5638,l'induzione,1,1,0,1
5639,massimizzare,1,1,0,1
5642,«l'enciclopedia,1,1,0,1
5646,accumulato,1,1,0,1
5647,visualizzare,1,1,0,1
5649,"scientifica,",1,1,0,1
5650,diapositive,1,1,0,1
5653,cancellazioni,1,1,0,1
5654,esso.,1,1,0,1
5660,parodie,1,1,0,1
5663,aggiorna,1,1,0,1
5621,.[necessita,1,1,0,1
5618,d'altra,1,1,0,1
5578,privilegio,1,1,0,1
5617,tradizioni,1,1,0,1
5582,pianificare,1,1,0,1
5586,chicago,1,1,0,1
5587,scadente,1,1,0,1
5588,sconcertati,1,1,0,1
5593,diminuite,1,1,0,1
5596,.× chilogrammi,1,1,0,1
5598,rivedono,1,1,0,1
5599,geografici,1,1,0,1
5600,categorizzati.,1,1,0,1
5601,arrivata,1,1,0,1
5602,l'uno,1,1,0,1
5606,prevedeva,1,1,0,1
5612,crescere,1,1,0,1
5613,specificatamente,1,1,0,1
5615,comprenda,1,1,0,1
5821,rispettare,1,1,0,1
5823,applausi,1,1,0,1
6148,meteoriti,1,1,0,1
6038,sims,1,1,0,1
6029,venuti,1,1,0,1
6031,npov.,1,1,0,1
6032,assicurano,1,1,0,1
6033,attivita',1,1,0,1
6034,indesiderabili.,1,1,0,1
6036,funzionando,1,1,0,1
6037,predittiva,1,1,0,1
6039,continente,1,1,0,1
6061,pluricellulari.,1,1,0,1
6045,stabilita,1,1,0,1
6047,obiettivi:,1,1,0,1
6049,"bene,",1,1,0,1
6054,studiati.,1,1,0,1
6055,all'epoca,1,1,0,1
6056,compatibile,1,1,0,1
6058,Nicholas,1,1,0,1
6028,cattura-.,1,1,0,1
6027,illegale.,1,1,0,1
6026,volontà.,1,1,0,1
6024,notorietà,1,1,0,1
5991,insegnanti,1,1,0,1
5992,dell'istruzione,1,1,0,1
5996,inserita,1,1,0,1
5997,l'IA,1,1,0,1
5998,prefisso,1,1,0,1
5999,omissioni,1,1,0,1
6001,periodi,1,1,0,1
6005,"ranch,",1,1,0,1
6007,riesci,1,1,0,1
6016,provocativo,1,1,0,1
6018,considerandolo,1,1,0,1
6019,ortografia,1,1,0,1
6020,"Seigenthaler,",1,1,0,1
6021,tale.,1,1,0,1
6022,distinguerlo,1,1,0,1
6060,tolleranza,1,1,0,1
6062,pezzi,1,1,0,1
5830,dell'esperimento,1,1,0,1
6122,"l'omissione,",1,1,0,1
6108,edit-a-thon,1,1,0,1
6111,francesi,1,1,0,1
6115,"diversi,",1,1,0,1
6116,sull'uragano,1,1,0,1
6117,istituti,1,1,0,1
6119,l'essere,1,1,0,1
6120,mediano,1,1,0,1
6124,interpretazioni.,1,1,0,1
6064,"pregiudizi,",1,1,0,1
6127,tecnologicamente,1,1,0,1
6131,digitalizzati,1,1,0,1
6138,linguistico,1,1,0,1
6139,dannosi.,1,1,0,1
6141,"assumerti,",1,1,0,1
6142,sessista.,1,1,0,1
6144,termici,1,1,0,1
6106,correlate,1,1,0,1
6103,Stai,1,1,0,1
6102,maschile.,1,1,0,1
6099,l'eliminazione,1,1,0,1
6069,patrocinio,1,1,0,1
6070,parlamentare,1,1,0,1
6073,termoalina,1,1,0,1
6075,corrispondenti.,1,1,0,1
6076,accadeva,1,1,0,1
6078,lancio,1,1,0,1
6079,Big,1,1,0,1
6084,innaturale,1,1,0,1
6086,visti,1,1,0,1
6088,ingiustamente,1,1,0,1
6091,pulito,1,1,0,1
6094,possiedono,1,1,0,1
6096,discutibili,1,1,0,1
6097,condotti,1,1,0,1
6098,esprimono,1,1,0,1
5989,"passati,",1,1,0,1
5988,selezioni,1,1,0,1
5983,esecutiva,1,1,0,1
5887,etnie,1,1,0,1
5875,"online,",1,1,0,1
5876,"Khosla,",1,1,0,1
5877,"stampate,",1,1,0,1
5878,provino,1,1,0,1
5880,sorta,1,1,0,1
5881,elettorale,1,1,0,1
5884,"polinomiale,",1,1,0,1
5888,"computer,",1,1,0,1
5982,berkeley,1,1,0,1
5889,comunicazione,1,1,0,1
5892,tentate,1,1,0,1
5895,dinamiche,1,1,0,1
5896,equatoriale,1,1,0,1
5897,scopi,1,1,0,1
5899,offensivi,1,1,0,1
5901,"sposarmi,",1,1,0,1
5873,"batoliti,",1,1,0,1
5870,conforme.,1,1,0,1
5865,marzo [aggiornamento],1,1,0,1
5860,pronome,1,1,0,1
5831,ripariale,1,1,0,1
5834,complesse.,1,1,0,1
5836,consentiti,1,1,0,1
5837,carlo,1,1,0,1
5840,"Rothenburg,",1,1,0,1
5841,"mining,",1,1,0,1
5842,partecipanti,1,1,0,1
5844,Gardner,1,1,0,1
5845,itō,1,1,0,1
5846,scienze.,1,1,0,1
5854,qui?,1,1,0,1
5856,offra,1,1,0,1
5857,sottile,1,1,0,1
5858,"disco,",1,1,0,1
5859,dell'app,1,1,0,1
5902,anomale,1,1,0,1
5905,registrazione,1,1,0,1
5906,visuale,1,1,0,1
5950,accade,1,1,0,1
5954,l'irregolarità,1,1,0,1
5956,"electronica,",1,1,0,1
5959,termine.,1,1,0,1
5960,"gradevoli,",1,1,0,1
5961,indiana,1,1,0,1
5963,cristallizzano,1,1,0,1
5964,mdp.,1,1,0,1
5965,diminuendo,1,1,0,1
5966,soprannominata,1,1,0,1
5968,leggibili,1,1,0,1
5969,bianche,1,1,0,1
5971,simulata.,1,1,0,1
5979,biomedica.,1,1,0,1
5980,propriamente,1,1,0,1
5981,nell'atmosfera.,1,1,0,1
5951,mensile,1,1,0,1
5949,caldi,1,1,0,1
5907,presiede,1,1,0,1
5948,controproducenti,1,1,0,1
5909,ricercatore,1,1,0,1
5911,raffigura,1,1,0,1
5912,sopravvissuta».,1,1,0,1
5913,risparmiare,1,1,0,1
5922,dell'editoria,1,1,0,1
5923,gerarchia,1,1,0,1
5925,Theory,1,1,0,1
5927,tanti,1,1,0,1
5929,secondaria.,1,1,0,1
5930,industriali,1,1,0,1
5931,curva,1,1,0,1
5938,collegate,1,1,0,1
5941,sovrappone,1,1,0,1
5944,calibratura,1,1,0,1
5946,avvenuto,1,1,0,1
5515,leggessero,1,1,0,1
5514,superiori,1,1,0,1
5513,quotidianamente,1,1,0,1
5091,cumulativo,1,1,0,1
5072,presocratici,1,1,0,1
5073,biologia.,1,1,0,1
5074,gpl.,1,1,0,1
5075,denominatore,1,1,0,1
5080,all'enorme,1,1,0,1
5085,assunzione,1,1,0,1
5089,renda,1,1,0,1
5095,aiutano,1,1,0,1
5110,cercava,1,1,0,1
5096,didascalia,1,1,0,1
5098,citabili,1,1,0,1
5100,impraticabile,1,1,0,1
5102,prendo,1,1,0,1
5103,responsabili,1,1,0,1
5105,Sopra,1,1,0,1
5108,"golfi,",1,1,0,1
5071,altrimenti,1,1,0,1
5070,dall'ambiente.,1,1,0,1
5069,sezionate,1,1,0,1
5068,nell'ottobre,1,1,0,1
5035,specifiche,1,1,0,1
5038,serbo,1,1,0,1
5039,diventando,1,1,0,1
5044,contributore,1,1,0,1
5046,fabbricati,1,1,0,1
5048,scientifiche.,1,1,0,1
5050,Filippine.,1,1,0,1
5052,association.,1,1,0,1
5053,rigoroso.,1,1,0,1
5054,vivere.,1,1,0,1
5055,espliciti,1,1,0,1
5060,profilo,1,1,0,1
5061,bias-varianza,1,1,0,1
5065,consultata,1,1,0,1
5067,costretto,1,1,0,1
5109,l'identità,1,1,0,1
5114,pubblicità.,1,1,0,1
5512,dell'illuminismo,1,1,0,1
5184,trattazione,1,1,0,1
5166,Columbia,1,1,0,1
5170,futuri,1,1,0,1
5171,violi,1,1,0,1
5172,un'auto,1,1,0,1
5173,domestici,1,1,0,1
5180,macchina.,1,1,0,1
5181,arriva,1,1,0,1
5185,mossa,1,1,0,1
5115,incorporati,1,1,0,1
5186,dell'indipendenza,1,1,0,1
5187,videogiochi,1,1,0,1
5188,observatory,1,1,0,1
5189,trattiene,1,1,0,1
5195,stupefacente.,1,1,0,1
5197,sub-nazionali,1,1,0,1
5201,inclusismo.,1,1,0,1
5163,antiche.,1,1,0,1
5158,collabora,1,1,0,1
5157,intervallo.,1,1,0,1
5153,disturbarti.,1,1,0,1
5116,"acquatica,",1,1,0,1
5122,realizzabili.,1,1,0,1
5127,optato,1,1,0,1
5132,ripetutamente,1,1,0,1
5134,Marion.,1,1,0,1
5136,/wikiˈpɛdja/,1,1,0,1
5137,dall'ottenere,1,1,0,1
5139,collaboratore,1,1,0,1
5141,supporto.,1,1,0,1
5142,digitalizzando,1,1,0,1
5145,"decisionale,",1,1,0,1
5146,cartoni,1,1,0,1
5149,interventi,1,1,0,1
5150,dell'ai,1,1,0,1
5151,"Narcisa,",1,1,0,1
5029,ritenute,1,1,0,1
5027,provengano,1,1,0,1
5026,"eccezioni,",1,1,0,1
4943,inviato,1,1,0,1
4922,cunningham.,1,1,0,1
4929,rilicenziare,1,1,0,1
4931,vaghezza,1,1,0,1
4932,ribellione,1,1,0,1
4939,nell'identificare,1,1,0,1
4940,appiattindo,1,1,0,1
4942,altoparlanti,1,1,0,1
4945,dietista,1,1,0,1
5024,azoto,1,1,0,1
4951,racchiuderne,1,1,0,1
4954,sottomarina,1,1,0,1
4955,scrittrici,1,1,0,1
4956,compito.,1,1,0,1
4957,scorsa,1,1,0,1
4961,fedele,1,1,0,1
4963,raddoppiate,1,1,0,1
4919,preferendo,1,1,0,1
4918,persistenti,1,1,0,1
4917,metri,1,1,0,1
4914,informatico,1,1,0,1
4871,finanziare,1,1,0,1
4874,l'umanità,1,1,0,1
4875,variegata,1,1,0,1
4886,mammiferi.,1,1,0,1
4889,poté,1,1,0,1
4890,stesse.,1,1,0,1
4895,iniziamo.,1,1,0,1
4900,cambiò,1,1,0,1
4901,fornitore,1,1,0,1
4905,«per,1,1,0,1
4906,essersi,1,1,0,1
4907,libri.,1,1,0,1
4908,Heller,1,1,0,1
4910,"artificiali,",1,1,0,1
4912,appropriato.,1,1,0,1
4964,"natura,",1,1,0,1
4965,associate.,1,1,0,1
4967,staccati,1,1,0,1
4997,vichipedìa,1,1,0,1
5003,k-,1,1,0,1
5006,caso.,1,1,0,1
5007,riuscire,1,1,0,1
5010,contava,1,1,0,1
5011,pratiche.,1,1,0,1
5012,probabilistica.,1,1,0,1
5013,Cosa,1,1,0,1
5014,"battuta,",1,1,0,1
5016,antepongono,1,1,0,1
5017,inconsci,1,1,0,1
5019,"operazioni,",1,1,0,1
5020,POS,1,1,0,1
5021,Venere,1,1,0,1
5022,ambiguità,1,1,0,1
5023,tradotte,1,1,0,1
4998,vediamo.,1,1,0,1
4995,subtropicale.,1,1,0,1
4968,l'emozione,1,1,0,1
4993,dominato,1,1,0,1
4969,ispirazione,1,1,0,1
4971,vista.,1,1,0,1
4972,conferisce,1,1,0,1
4973,ottico,1,1,0,1
4974,arcipelaghi,1,1,0,1
4975,consistono,1,1,0,1
4976,interattive,1,1,0,1
4981,dell'edit,1,1,0,1
4983,tettonica,1,1,0,1
4985,"sfide,",1,1,0,1
4986,"effettivo,",1,1,0,1
4987,appiattito,1,1,0,1
4988,L'amoralità,1,1,0,1
4991,grandemente,1,1,0,1
4992,replicato,1,1,0,1
5202,restanti,1,1,0,1
5205,dilemma.,1,1,0,1
5206,posizionate,1,1,0,1
5411,"obiettivo,",1,1,0,1
5393,"geografia,",1,1,0,1
5395,generatrici,1,1,0,1
5398,scomposizione,1,1,0,1
5401,idrogeno,1,1,0,1
5402,percentuale.,1,1,0,1
5405,sostituirà,1,1,0,1
5406,all'induzione,1,1,0,1
5415,dinamiche.,1,1,0,1
5353,valida,1,1,0,1
5418,celebrate,1,1,0,1
5420,femminili.,1,1,0,1
5421,contemporaneamente,1,1,0,1
5423,sintomi.,1,1,0,1
5425,frode,1,1,0,1
5428,pubblicabili,1,1,0,1
5429,concerto,1,1,0,1
5392,addestra,1,1,0,1
5390,attenua,1,1,0,1
5389,tempi,1,1,0,1
5383,avviato,1,1,0,1
5355,giudici,1,1,0,1
5356,soddisfano,1,1,0,1
5357,Canada,1,1,0,1
5360,ascoltando.,1,1,0,1
5362,conclusione,1,1,0,1
5363,lottato,1,1,0,1
5366,Guardian,1,1,0,1
5367,primitive.,1,1,0,1
5368,attive,1,1,0,1
5370,riprogrammazione,1,1,0,1
5371,disposizione.,1,1,0,1
5373,"cui,",1,1,0,1
5375,interessate,1,1,0,1
5377,fruitori,1,1,0,1
5382,amata,1,1,0,1
5432,rating,1,1,0,1
5434,affrontando,1,1,0,1
5435,tarantino.,1,1,0,1
5473,valutazioni,1,1,0,1
5475,efficiente.,1,1,0,1
5476,unicellulari,1,1,0,1
5480,istituzionale,1,1,0,1
5481,migliorarne,1,1,0,1
5482,menzionati,1,1,0,1
5485,prodotte,1,1,0,1
5489,caffè,1,1,0,1
5491,retropropagazione.,1,1,0,1
5493,includa,1,1,0,1
5494,prigionieri.,1,1,0,1
5495,virgolette,1,1,0,1
5497,africani,1,1,0,1
5504,"gratuito,",1,1,0,1
5508,speranza.»,1,1,0,1
5511,autorizza,1,1,0,1
5474,utilizzatori,1,1,0,1
5472,fondi,1,1,0,1
5437,Tang,1,1,0,1
5471,straordinariamente,1,1,0,1
5439,circuito,1,1,0,1
5440,espresse,1,1,0,1
5441,"fantastico,",1,1,0,1
5444,ricordano,1,1,0,1
5445,guidare,1,1,0,1
5451,dell'attivazione.,1,1,0,1
5452,altro.,1,1,0,1
5453,priorità ...,1,1,0,1
5457,pubblicano,1,1,0,1
5459,mitigare,1,1,0,1
5462,protocollo,1,1,0,1
5464,millimetro.,1,1,0,1
5466,"interdisciplinare,",1,1,0,1
5468,usarli,1,1,0,1
5469,coinvolgono,1,1,0,1
5354,federali,1,1,0,1
5349,sbatté,1,1,0,1
5209,riceveva,1,1,0,1
5258,attraversa,1,1,0,1
5249,"europa,",1,1,0,1
5250,di milioni,1,1,0,1
5252,dall'inglese,1,1,0,1
5254,riepilogo,1,1,0,1
5255,modificarli,1,1,0,1
5256,ripetitive,1,1,0,1
5257,ripreso,1,1,0,1
5266,sorgere,1,1,0,1
5346,calore,1,1,0,1
5268,presentato,1,1,0,1
5270,gole,1,1,0,1
5271,spiritosi,1,1,0,1
5274,l'interfaccia,1,1,0,1
5275,accurata,1,1,0,1
5276,cominciarono,1,1,0,1
5277,auto.,1,1,0,1
5247,"rettili,",1,1,0,1
5245,dall'origine,1,1,0,1
5244,mobilità.,1,1,0,1
5241,finirà,1,1,0,1
5210,termica.,1,1,0,1
5212,attribuite,1,1,0,1
5213,inglese –,1,1,0,1
5216,dell'orbita,1,1,0,1
5217,studiare,1,1,0,1
5219,data.,1,1,0,1
5220,discesa,1,1,0,1
5223,classismo.,1,1,0,1
5225,eppure,1,1,0,1
5226,promessa,1,1,0,1
5228,specifica,1,1,0,1
5229,"Virginia,",1,1,0,1
5234,"università,",1,1,0,1
5237,"umide,",1,1,0,1
5240,cumulativa.,1,1,0,1
5278,j.,1,1,0,1
5280,variante,1,1,0,1
5284,IRS,1,1,0,1
5318,identificarsi,1,1,0,1
5320,pappas,1,1,0,1
5324,alfabeti,1,1,0,1
5325,letterarie,1,1,0,1
5326,ufficialmente,1,1,0,1
5330,indovinare,1,1,0,1
5332,spostato,1,1,0,1
5333,sottocampo,1,1,0,1
5335,invisibili,1,1,0,1
5337,stagnante,1,1,0,1
5338,vieta,1,1,0,1
5339,osservato.,1,1,0,1
5340,credenziali,1,1,0,1
5342,contestano,1,1,0,1
5343,climatica.,1,1,0,1
5344,"montuose,",1,1,0,1
5319,libre.,1,1,0,1
5316,consigliando,1,1,0,1
5286,definiti,1,1,0,1
5315,rimosse,1,1,0,1
5289,rilascio,1,1,0,1
5292,momenti,1,1,0,1
5293,"concentrate,",1,1,0,1
5294,google.,1,1,0,1
5296,raffreddato,1,1,0,1
5298,sostituiranno.,1,1,0,1
5301,devastazione.,1,1,0,1
5302,inserisco,1,1,0,1
5303,sparsa,1,1,0,1
5307,crowdsourcing.,1,1,0,1
5308,stretto,1,1,0,1
5309,strada,1,1,0,1
5312,dighe,1,1,0,1
5313,"lavoro,",1,1,0,1
5314,accedono,1,1,0,1
6145,attivamente,1,1,0,1
6149,anni.,1,1,0,1
7396,esse.,1,1,0,1
6985,millennio,1,1,0,1
6973,"aprile,",1,1,0,1
6975,curare,1,1,0,1
6977,permanenti,1,1,0,1
6978,cresciute,1,1,0,1
6980,tattiche,1,1,0,1
6981,Benvenuto.,1,1,0,1
6984,imparando,1,1,0,1
6986,ripristinate,1,1,0,1
6999,appartenere,1,1,0,1
6987,dall'anonimato,1,1,0,1
6989,strette,1,1,0,1
6990,caotico,1,1,0,1
6992,Starò,1,1,0,1
6993,nell'hardware,1,1,0,1
6994,ozono.,1,1,0,1
6995,focalizzate,1,1,0,1
6972,Chaos,1,1,0,1
6971,obiezioni,1,1,0,1
6970,trasportando,1,1,0,1
6968,dell'attuale,1,1,0,1
6937,computazione,1,1,0,1
6938,rintracciabili,1,1,0,1
6939,prodotti.,1,1,0,1
6940,«l'atteggiamento,1,1,0,1
6945,catena,1,1,0,1
6946,immunitario,1,1,0,1
6948,"supervisionati,",1,1,0,1
6952,attiva,1,1,0,1
6953,blocchi,1,1,0,1
6954,alghe.,1,1,0,1
6956,farneticante,1,1,0,1
6957,"incerto,",1,1,0,1
6962,imparano,1,1,0,1
6963,binario,1,1,0,1
6964,accontentarsi.,1,1,0,1
6996,imparziale,1,1,0,1
7000,"anderson,",1,1,0,1
7081,comparabili,1,1,0,1
7058,fornendo,1,1,0,1
7046,spallanzani,1,1,0,1
7047,nucleare,1,1,0,1
7050,supportata,1,1,0,1
7051,pecora,1,1,0,1
7052,consigliata.,1,1,0,1
7054,accuse,1,1,0,1
7055,"seduto,",1,1,0,1
7059,"test,",1,1,0,1
7001,eseguiti,1,1,0,1
7064,dell'asse,1,1,0,1
7065,giunsero,1,1,0,1
7066,sistematica,1,1,0,1
7069,presume,1,1,0,1
7070,l'integrità,1,1,0,1
7075,importare,1,1,0,1
7077,realizzato,1,1,0,1
7045,cambia,1,1,0,1
7042,benvenuto.,1,1,0,1
7041,docente,1,1,0,1
7040,inattività.,1,1,0,1
7003,addirittura,1,1,0,1
7006,nell'analisi,1,1,0,1
7009,sanitari,1,1,0,1
7010,autorevoli.,1,1,0,1
7011,uscite,1,1,0,1
7012,l'accumulazione,1,1,0,1
7014,education.,1,1,0,1
7015,medicinali,1,1,0,1
7018,religioso,1,1,0,1
7020,pazientemente,1,1,0,1
7028,stagionali,1,1,0,1
7030,Joseph,1,1,0,1
7033,dell'East,1,1,0,1
7035,[p]forse,1,1,0,1
7039,"selvaggia,",1,1,0,1
6935,accoppiata,1,1,0,1
6933,idrici,1,1,0,1
6932,M.,1,1,0,1
6857,trasferimento,1,1,0,1
6844,anticipa,1,1,0,1
6847,forniscano,1,1,0,1
6850,ospitata,1,1,0,1
6853,stella,1,1,0,1
6854,sede,1,1,0,1
6855,pesca,1,1,0,1
6856,testo.,1,1,0,1
6859,anonimo,1,1,0,1
6929,computazionali,1,1,0,1
6862,hamburger.,1,1,0,1
6863,uichipìdia,1,1,0,1
6865,italiano.,1,1,0,1
6867,desiderabili,1,1,0,1
6869,magazine[senza fonte].,1,1,0,1
6870,massimizzano,1,1,0,1
6873,etano,1,1,0,1
6841,pari.,1,1,0,1
6840,aiutarlo,1,1,0,1
6839,Minnesota,1,1,0,1
6838,Facebook,1,1,0,1
6808,ruscelli,1,1,0,1
6813,preferenza,1,1,0,1
6814,crediti,1,1,0,1
6815,parliamo,1,1,0,1
6816,"geografici,",1,1,0,1
6818,giardini,1,1,0,1
6819,chiamano,1,1,0,1
6820,"eiaculazione,",1,1,0,1
6825,esimo,1,1,0,1
6829,"dall'uomo,",1,1,0,1
6831,dell'American,1,1,0,1
6832,oh.sei,1,1,0,1
6834,riempiranno,1,1,0,1
6836,simbolico/basato,1,1,0,1
6837,ottimale,1,1,0,1
6874,violazione,1,1,0,1
6875,scoppi,1,1,0,1
6877,d'autore,1,1,0,1
6904,descriverle,1,1,0,1
6908,"neutrale,",1,1,0,1
6909,teoriche,1,1,0,1
6911,indirizza,1,1,0,1
6912,gabriel.,1,1,0,1
6913,aspettare,1,1,0,1
6914,dell'attività,1,1,0,1
6916,palmari,1,1,0,1
6917,lamentele,1,1,0,1
6918,antisociale.,1,1,0,1
6919,​​o,1,1,0,1
6924,funge,1,1,0,1
6925,sofferto,1,1,0,1
6926,polari,1,1,0,1
6927,statunitensi,1,1,0,1
6928,subspaziale,1,1,0,1
6907,un'impostazione,1,1,0,1
6903,polvere,1,1,0,1
6879,lineari.,1,1,0,1
6902,consultazione.,1,1,0,1
6883,troverebbe,1,1,0,1
6885,molteplici,1,1,0,1
6886,sessi.,1,1,0,1
6888,"sole,",1,1,0,1
6889,meta-wiki,1,1,0,1
6890,bucato.,1,1,0,1
6891,perfette,1,1,0,1
6893,wikinotizie,1,1,0,1
6894,depositano,1,1,0,1
6896,partecipando,1,1,0,1
6897,migliorata,1,1,0,1
6898,seguendo,1,1,0,1
6899,palla,1,1,0,1
6900,citazione,1,1,0,1
6901,esaminata,1,1,0,1
7078,circondate,1,1,0,1
7083,wireless.,1,1,0,1
6152,formati,1,1,0,1
7295,"""stiamo",1,1,0,1
7274,campionata,1,1,0,1
7277,realistico,1,1,0,1
7281,redistribuzione,1,1,0,1
7282,collegano,1,1,0,1
7283,risalire,1,1,0,1
7286,applicata,1,1,0,1
7289,fonemi,1,1,0,1
7300,piani.,1,1,0,1
7314,idrografico.,1,1,0,1
7301,espansione,1,1,0,1
7302,istruiti,1,1,0,1
7304,euristica,1,1,0,1
7305,raccolte,1,1,0,1
7306,cresta.,1,1,0,1
7310,criminale,1,1,0,1
7311,matto.,1,1,0,1
7273,"conoscerti,",1,1,0,1
7271,collisione.,1,1,0,1
7269,pretendenti,1,1,0,1
7268,sovrastante,1,1,0,1
7244,disastri,1,1,0,1
7248,l'ordine,1,1,0,1
7249,"accurati,",1,1,0,1
7251,eucariotiche,1,1,0,1
7253,informazioni'',1,1,0,1
7254,inedite,1,1,0,1
7255,​​elastiche.,1,1,0,1
7257,durano,1,1,0,1
7258,distribuisce,1,1,0,1
7259,esistenza.,1,1,0,1
7260,grafiche,1,1,0,1
7262,animalia.,1,1,0,1
7264,ovvio,1,1,0,1
7266,"salute,",1,1,0,1
7267,polacchi.,1,1,0,1
7313,visiva,1,1,0,1
7315,Thomas,1,1,0,1
7085,smettila,1,1,0,1
7372,supermercati.,1,1,0,1
7355,stilistiche.,1,1,0,1
7357,sphinxsystem,1,1,0,1
7358,"qualificati,",1,1,0,1
7363,cancellano,1,1,0,1
7367,rispondono,1,1,0,1
7369,"spicole,",1,1,0,1
7371,generata,1,1,0,1
7376,numero.,1,1,0,1
7317,maremoto,1,1,0,1
7377,"""non",1,1,0,1
7380,segnato,1,1,0,1
7382,desidera,1,1,0,1
7385,dell'animazione,1,1,0,1
7387,consenta,1,1,0,1
7389,interglaciali,1,1,0,1
7394,colmare.,1,1,0,1
7354,documentata,1,1,0,1
7353,ridimensionamento,1,1,0,1
7352,intervallo,1,1,0,1
7349,linguisticamente,1,1,0,1
7323,"favore,",1,1,0,1
7324,atteggiamenti,1,1,0,1
7327,adottato.,1,1,0,1
7328,collaboratori.»,1,1,0,1
7329,produttivi,1,1,0,1
7331,dell'economia,1,1,0,1
7333,volontari.,1,1,0,1
7338,"legali,",1,1,0,1
7341,accumulavano,1,1,0,1
7342,dell'abuso,1,1,0,1
7343,agricola,1,1,0,1
7344,irregolare,1,1,0,1
7345,marchi,1,1,0,1
7347,concentrando,1,1,0,1
7348,corridoi,1,1,0,1
7242,metro,1,1,0,1
7241,addosso.,1,1,0,1
7239,prenderai,1,1,0,1
7136,marmellate.,1,1,0,1
7124,importantirilevamento,1,1,0,1
7126,scaturisce,1,1,0,1
7127,redattori.,1,1,0,1
7128,.la,1,1,0,1
7129,accusata,1,1,0,1
7131,"aziendali,",1,1,0,1
7135,"[vago],",1,1,0,1
7139,kennedy.,1,1,0,1
7238,redazionale,1,1,0,1
7140,"pubblicata,",1,1,0,1
7144,enfasi,1,1,0,1
7145,prelevarne,1,1,0,1
7147,ecologicamente,1,1,0,1
7148,pene,1,1,0,1
7151,settimanali,1,1,0,1
7152,citiamo,1,1,0,1
7123,corretto,1,1,0,1
7121,"l'opposto,",1,1,0,1
7119,reinvenzioni,1,1,0,1
7118,sorprendente.,1,1,0,1
7087,districa,1,1,0,1
7088,domanda:,1,1,0,1
7091,rendersi,1,1,0,1
7092,dell'effettivo,1,1,0,1
7093,probabilistici.,1,1,0,1
7094,tipografica,1,1,0,1
7096,trasformazioni,1,1,0,1
7097,"pubblicità,",1,1,0,1
7098,giornaliero,1,1,0,1
7101,sottoporsi,1,1,0,1
7106,pornografici,1,1,0,1
7107,dispongono,1,1,0,1
7108,l'erogazione,1,1,0,1
7111,priva,1,1,0,1
7116,nacque,1,1,0,1
7154,attualmente.,1,1,0,1
7156,"giardino,",1,1,0,1
7158,l'espresso,1,1,0,1
7200,internazionale.,1,1,0,1
7207,ecosistemi,1,1,0,1
7208,avanzato,1,1,0,1
7210,avvertimenti.,1,1,0,1
7214,stabili.,1,1,0,1
7215,Twitter,1,1,0,1
7219,cifra,1,1,0,1
7220,"risolto,",1,1,0,1
7223,un'applicazione,1,1,0,1
7224,l'incidente,1,1,0,1
7225,documentati,1,1,0,1
7226,lato,1,1,0,1
7227,assunzioni,1,1,0,1
7230,wafer,1,1,0,1
7231,necessita',1,1,0,1
7233,salutarti.,1,1,0,1
7204,"piante,",1,1,0,1
7198,attività.,1,1,0,1
7159,musica.,1,1,0,1
7197,James,1,1,0,1
7163,micro-cluster,1,1,0,1
7164,impegnato,1,1,0,1
7168,survey.,1,1,0,1
7170,decentralizza,1,1,0,1
7171,pornoattrici,1,1,0,1
7173,costruiti,1,1,0,1
7174,scoraggiando,1,1,0,1
7176,trilioni,1,1,0,1
7177,falsità.,1,1,0,1
7179,denotare,1,1,0,1
7180,buoni,1,1,0,1
7182,dipendente.,1,1,0,1
7185,falde,1,1,0,1
7193,grafico.,1,1,0,1
7194,ritirato,1,1,0,1
6804,"domanda,",1,1,0,1
6803,togliere,1,1,0,1
6800,riteneva,1,1,0,1
6394,università,1,1,0,1
6375,inondare,1,1,0,1
6377,pareti,1,1,0,1
6380,"attivo,",1,1,0,1
6384,l'opposto,1,1,0,1
6386,prevedono,1,1,0,1
6392,controversi.,1,1,0,1
6393,collagene,1,1,0,1
6395,botanici,1,1,0,1
6416,l'agricoltura,1,1,0,1
6397,ucciso,1,1,0,1
6398,diventati,1,1,0,1
6403,bravi,1,1,0,1
6404,contenuta,1,1,0,1
6408,"censurata""",1,1,0,1
6411,carenti.,1,1,0,1
6413,l'egemonia,1,1,0,1
6374,avvisato,1,1,0,1
6372,Arthur,1,1,0,1
6370,sposati,1,1,0,1
6368,ardesia,1,1,0,1
6337,ricercati,1,1,0,1
6341,fermo,1,1,0,1
6342,misurare,1,1,0,1
6346,revisioni.,1,1,0,1
6347,Clay,1,1,0,1
6348,aperti.,1,1,0,1
6350,avvieranno,1,1,0,1
6351,"d'accordo,",1,1,0,1
6353,consigli,1,1,0,1
6356,solido,1,1,0,1
6360,verificabile.,1,1,0,1
6361,spostano,1,1,0,1
6362,modificati.,1,1,0,1
6365,avvertiti,1,1,0,1
6367,scherzo,1,1,0,1
6414,secondi,1,1,0,1
6417,accogliere,1,1,0,1
6797,idrico,1,1,0,1
6464,d'arte,1,1,0,1
6451,crescente.,1,1,0,1
6452,partecipata,1,1,0,1
6458,approvano,1,1,0,1
6460,associano,1,1,0,1
6461,diventasse,1,1,0,1
6462,sostanziali,1,1,0,1
6463,compattezza,1,1,0,1
6465,"tradizionali,",1,1,0,1
6420,decentralizzato,1,1,0,1
6466,ristrette,1,1,0,1
6469,geomagnetico.,1,1,0,1
6470,funzionano,1,1,0,1
6471,comportamentale.,1,1,0,1
6474,macroecosistema,1,1,0,1
6476,anglicizzanti,1,1,0,1
6478,astratte,1,1,0,1
6450,volevamo,1,1,0,1
6449,topica,1,1,0,1
6448,sistemi.,1,1,0,1
6447,d'autore.,1,1,0,1
6421,euristico,1,1,0,1
6422,mezzo.,1,1,0,1
6423,evolutivi.,1,1,0,1
6424,contributori.,1,1,0,1
6425,grandioso,1,1,0,1
6427,Asia.,1,1,0,1
6428,wik-ee-,1,1,0,1
6431,sperimentano,1,1,0,1
6434,genotipi,1,1,0,1
6437,ficcanaso,1,1,0,1
6438,linearità,1,1,0,1
6439,collaboratrici,1,1,0,1
6440,mixozoi,1,1,0,1
6445,"coinvolgente,",1,1,0,1
6446,ritardato.,1,1,0,1
6335,Springer,1,1,0,1
6332,l'autorizzazione,1,1,0,1
6331,diresse,1,1,0,1
6208,Hopfield,1,1,0,1
6196,selvatici,1,1,0,1
6197,Sanger.,1,1,0,1
6200,go-to,1,1,0,1
6202,progettare,1,1,0,1
6203,dell'azienda,1,1,0,1
6205,combinato,1,1,0,1
6206,un'entità,1,1,0,1
6209,ignee,1,1,0,1
6329,dobbiamo,1,1,0,1
6214,magari,1,1,0,1
6215,l'allevamento,1,1,0,1
6216,manske.,1,1,0,1
6218,Edward,1,1,0,1
6224,antica,1,1,0,1
6225,c-.,1,1,0,1
6227,«le,1,1,0,1
6192,indebito,1,1,0,1
6190,immettono,1,1,0,1
6189,danah,1,1,0,1
6188,oggettiva,1,1,0,1
6153,migrazione,1,1,0,1
6154,direttrice,1,1,0,1
6157,glicoproteine,1,1,0,1
6159,prodotti,1,1,0,1
6160,assai,1,1,0,1
6164,inferenze,1,1,0,1
6169,cancellate,1,1,0,1
6172,l'enorme,1,1,0,1
6173,autrice,1,1,0,1
6177,intenzionale,1,1,0,1
6178,consentissero,1,1,0,1
6179,opt-out,1,1,0,1
6181,accreditati,1,1,0,1
6184,controllare,1,1,0,1
6185,marx.,1,1,0,1
6228,acquatici,1,1,0,1
6231,resisti,1,1,0,1
6233,ebbe,1,1,0,1
6285,l'aria.,1,1,0,1
6291,condivide,1,1,0,1
6292,approssimazione,1,1,0,1
6295,chiara.,1,1,0,1
6296,"voglio,",1,1,0,1
6297,consapevoli,1,1,0,1
6300,televisione,1,1,0,1
6301,beneficiato,1,1,0,1
6312,comprendono,1,1,0,1
6313,transizione,1,1,0,1
6317,"protetto,",1,1,0,1
6319,pulita,1,1,0,1
6323,revisori,1,1,0,1
6324,richiedere,1,1,0,1
6326,distorsione,1,1,0,1
6327,fossili,1,1,0,1
6286,artico.,1,1,0,1
6284,migliorato,1,1,0,1
6234,=||was||,1,1,0,1
6283,epico,1,1,0,1
6239,antielitarismo.,1,1,0,1
6244,desktop,1,1,0,1
6245,decimi,1,1,0,1
6249,focale,1,1,0,1
6250,petrolio.,1,1,0,1
6251,centralizzato.,1,1,0,1
6255,restringere,1,1,0,1
6262,meraviglie,1,1,0,1
6265,trovati,1,1,0,1
6266,fonda,1,1,0,1
6267,promozione,1,1,0,1
6270,eucarioti.,1,1,0,1
6273,ribattendo,1,1,0,1
6276,metti,1,1,0,1
6282,rileva,1,1,0,1
6479,precipitazioni.,1,1,0,1
6480,incolti,1,1,0,1
6483,dell'agenzia,1,1,0,1
6710,seguenti,1,1,0,1
6698,mari,1,1,0,1
6699,disperse,1,1,0,1
6700,vento,1,1,0,1
6703,​​generale,1,1,0,1
6704,ossa,1,1,0,1
6708,emersi,1,1,0,1
6709,...,1,1,0,1
6712,decina,1,1,0,1
6648,ufficiale.,1,1,0,1
6713,Encyclopædia,1,1,0,1
6715,eccezionali,1,1,0,1
6716,appoggia,1,1,0,1
6717,popolazioni,1,1,0,1
6719,straordinario.,1,1,0,1
6720,spiegazioni.,1,1,0,1
6721,occupava,1,1,0,1
6697,disgregati,1,1,0,1
6695,"geografica,",1,1,0,1
6693,donne.,1,1,0,1
6690,recentemente,1,1,0,1
6660,biologi.,1,1,0,1
6662,schierarsi.,1,1,0,1
6663,matrimoni,1,1,0,1
6665,crescerà,1,1,0,1
6667,sull'edizione,1,1,0,1
6669,all'inserimento,1,1,0,1
6670,legame,1,1,0,1
6672,l'occhio,1,1,0,1
6673,idrologico.,1,1,0,1
6676,contrariamente,1,1,0,1
6680,un'azienda,1,1,0,1
6682,scientifici.,1,1,0,1
6684,dall'unione,1,1,0,1
6686,introdotti,1,1,0,1
6687,quello.,1,1,0,1
6725,elevare,1,1,0,1
6726,britanniche,1,1,0,1
6730,Virginia.,1,1,0,1
6763,significato».,1,1,0,1
6765,dell'mdp,1,1,0,1
6769,negoziare,1,1,0,1
6773,presentandole,1,1,0,1
6774,soggette,1,1,0,1
6776,soffrono,1,1,0,1
6778,spigoli.,1,1,0,1
6779,l'ingiunzione,1,1,0,1
6783,suddivise,1,1,0,1
6784,elenchi,1,1,0,1
6785,riverseranno,1,1,0,1
6786,cool.,1,1,0,1
6787,utenti ...,1,1,0,1
6788,denominata,1,1,0,1
6791,altoparlante,1,1,0,1
6795, milioni.,1,1,0,1
6764,"sistema,",1,1,0,1
6761,organizzazione,1,1,0,1
6731,correlata,1,1,0,1
6759,nell'atmosfera,1,1,0,1
6732,introduction,1,1,0,1
6734,fiumi.,1,1,0,1
6736,"Rosenzweig,",1,1,0,1
6738,limitazioni,1,1,0,1
6739,sfrutta,1,1,0,1
6740,grandezza,1,1,0,1
6741,fiacca,1,1,0,1
6742,implicito.,1,1,0,1
6745,reagisce,1,1,0,1
6748,controlla,1,1,0,1
6751,attribuito,1,1,0,1
6752,lavora,1,1,0,1
6753,diviso,1,1,0,1
6754,linz,1,1,0,1
6757,estatiche,1,1,0,1
6654,nell'Atlantico,1,1,0,1
6647,presuppongono,1,1,0,1
6486,ittico,1,1,0,1
6549,essenziale,1,1,0,1
6534,ricordarti,1,1,0,1
6539,trattamento,1,1,0,1
6541,Array,1,1,0,1
6542,esporsi,1,1,0,1
6543,l'hardware,1,1,0,1
6545,eccezioni.,1,1,0,1
6548,convenzioni,1,1,0,1
6552,caporedattore,1,1,0,1
6644,sproporzionatamente,1,1,0,1
6553,sviluppo.,1,1,0,1
6554,archiviare,1,1,0,1
6561,confronti,1,1,0,1
6562,bot.,1,1,0,1
6564,affermate,1,1,0,1
6566,"fermò,",1,1,0,1
6574,piacimento.,1,1,0,1
6528,succinta,1,1,0,1
6527,rifiutare,1,1,0,1
6526,scesa,1,1,0,1
6524,spensierata,1,1,0,1
6487,richiederanno,1,1,0,1
6489,promozionali,1,1,0,1
6490,esibire,1,1,0,1
6493,lamentasse,1,1,0,1
6499,concludendo,1,1,0,1
6502,latitudine.,1,1,0,1
6503,un'iniziativa,1,1,0,1
6506,curati,1,1,0,1
6509,mercato.,1,1,0,1
6511,sequenziamento,1,1,0,1
6512,trasduzione,1,1,0,1
6513,giù.,1,1,0,1
6515,meritavano.,1,1,0,1
6518,assorbe,1,1,0,1
6521,sull'argomento.,1,1,0,1
6575,situato,1,1,0,1
6578,strade,1,1,0,1
6582,conseguente,1,1,0,1
6616,interconnesso,1,1,0,1
6622,sintomi,1,1,0,1
6623,stampati,1,1,0,1
6626,elaborare.,1,1,0,1
6628,bontà,1,1,0,1
6629,ultima,1,1,0,1
6630,irrilevanti,1,1,0,1
6632,"lottato,",1,1,0,1
6633,computazione.,1,1,0,1
6634,posizioni,1,1,0,1
6635,predittivi,1,1,0,1
6637,"stagione,",1,1,0,1
6638,ecosistema.,1,1,0,1
6639,italianizzate,1,1,0,1
6640,rimasti,1,1,0,1
6641,avere.,1,1,0,1
6618,regolamentazione,1,1,0,1
6614,molecolare,1,1,0,1
6583,eccessiva,1,1,0,1
6613,l'occhiolino.,1,1,0,1
6585,sun-times,1,1,0,1
6587,distinzione,1,1,0,1
6591,fattoria,1,1,0,1
6592,proveniente,1,1,0,1
6593,all'enciclopedia,1,1,0,1
6595,'impegnato,1,1,0,1
6598,televisivo,1,1,0,1
6599,piangesse,1,1,0,1
6603,scartare,1,1,0,1
6604,"facebook,",1,1,0,1
6605,"valide,",1,1,0,1
6606,"generalità,",1,1,0,1
6608,'stanco,1,1,0,1
6609,"Giove,",1,1,0,1
6610,commentati,1,1,0,1
17408,medya,0,0,1,1
17410,slutade,0,0,1,1
17411,maladies,0,0,1,1
27740,കാര്യങ്ങളിലും,0,0,1,1
27728,المعرفية،,0,0,1,1
27729,விக்கிப்பீடியாஓர்க்,0,0,1,1
27732,fängelser,0,0,1,1
27733,spännande,0,0,1,1
27736,الحادث,0,0,1,1
27737,peaked,0,0,1,1
27738,amüsanteste,0,0,1,1
27744,autopromoción»​,0,0,1,1
27761,préoccupations,0,0,1,1
27745,«wikipedistas»,0,0,1,1
27746,étrangère,0,0,1,1
27747,pensamiento,0,0,1,1
27748,αλεύρι,0,0,1,1
27752,studier,0,0,1,1
27758,courants,0,0,1,1
27759,membres,0,0,1,1
27727,அன்றிலிருந்து,0,0,1,1
27724,funkelnden,0,0,1,1
27723,ordagrant,0,0,1,1
27722,grupparbetet,0,0,1,1
27702,lyfta,0,0,1,1
27703,ಹೆಜ್ಜೆ,0,0,1,1
27704,жарко,0,0,1,1
27705,veranderd,0,0,1,1
27706,παζλ,0,0,1,1
27708,മാന്ത്രികജീവികളായിരുന്നു,0,0,1,1
27709,automatique »,0,0,1,1
27711,اتصالاً,0,0,1,1
27714,söylediğinizi,0,0,1,1
27715,забираете,0,0,1,1
27716,ಮಗುವಿಗೆ,0,0,1,1
27717,kolaylıkla,0,0,1,1
27718,voordeel,0,0,1,1
27719,आपराधिक,0,0,1,1
27720,காண,0,0,1,1
27760,помоги,0,0,1,1
27762,منطقة,0,0,1,1
27811,talip,0,0,1,1
27800,பெயரும்,0,0,1,1
27791,arbetar,0,0,1,1
27792,anklagats,0,0,1,1
27793,подобного,0,0,1,1
27795,ಅರ್ಥವೇನೆಂದು,0,0,1,1
27797,involved,0,0,1,1
27798,francepresse,0,0,1,1
27799,मैच,0,0,1,1
27801,судейская,0,0,1,1
27765,размещены,0,0,1,1
27802,verdadero,0,0,1,1
27803,أصدقاء,0,0,1,1
27804,приводит,0,0,1,1
27805,generalizados,0,0,1,1
27806,страны,0,0,1,1
27808,classificação,0,0,1,1
27809,smartphones,0,0,1,1
27789,skarpe,0,0,1,1
27788,നിയമങ്ങൾ,0,0,1,1
27786,eventueel,0,0,1,1
27785,oude,0,0,1,1
27766,всемирная,0,0,1,1
27768,ನಾಳೆಗಾಗಿ,0,0,1,1
27769,slower,0,0,1,1
27771,plausible,0,0,1,1
27772,ஆண்டுகள்,0,0,1,1
27774,совершённое,0,0,1,1
27776,messager,0,0,1,1
27777,அர்த்தங்கள்,0,0,1,1
27778,raciste,0,0,1,1
27779,erfahren,0,0,1,1
27780,vonden,0,0,1,1
27781,उपहार,0,0,1,1
27782,mucha,0,0,1,1
27783,εγκέφαλό,0,0,1,1
27784,сладкого,0,0,1,1
27701,belpictogram,0,0,1,1
27700,βαρετό,0,0,1,1
27699,отклонениям,0,0,1,1
27625,redaktionell,0,0,1,1
27617,"
सोरानी",0,0,1,1
27619,klassiske,0,0,1,1
27620,restricted,0,0,1,1
27621,ഉപയോഗിക്കാം,0,0,1,1
27622,basicamente,0,0,1,1
27623,ആണിക്കല്ലായി,0,0,1,1
27624,ακόλουθοι,0,0,1,1
27626,bloqué,0,0,1,1
27697,الأنواع,0,0,1,1
27630,உள்ள,0,0,1,1
27631,filters,0,0,1,1
27632,karısı,0,0,1,1
27634,दोहराए।,0,0,1,1
27636,lustres,0,0,1,1
27639,telefonsamtal,0,0,1,1
27641,ആസ്പദമാക്കി,0,0,1,1
27614,സന്നദ്ധരായവരെ,0,0,1,1
27613,तुरंत,0,0,1,1
27612,valresultaten,0,0,1,1
27611,appréhender,0,0,1,1
27586,τονισμό,0,0,1,1
27587,kwijt,0,0,1,1
27589,überwältigt,0,0,1,1
27590,bord,0,0,1,1
27591,اللازم,0,0,1,1
27594,ofensivas,0,0,1,1
27598,computertijdschrift,0,0,1,1
27599,контентомкомм,0,0,1,1
27600,οποιεσδήποτε,0,0,1,1
27601,jerarquía,0,0,1,1
27603,endowment,0,0,1,1
27604,التكرار,0,0,1,1
27606,réglé,0,0,1,1
27608,fertig,0,0,1,1
27609,weeks,0,0,1,1
27642,تملي,0,0,1,1
27643,kennisgevingen,0,0,1,1
27644,reprinted,0,0,1,1
27675,parents,0,0,1,1
27678,enkla,0,0,1,1
27680,εγγραφείτε,0,0,1,1
27681,ശരിയാക്കിയിട്ടുണ്ടോ,0,0,1,1
27682,отрасли,0,0,1,1
27683,mimesis,0,0,1,1
27684,خطا,0,0,1,1
27685,aktivera,0,0,1,1
27686,simplificadas,0,0,1,1
27687,toegankelijk,0,0,1,1
27691,தேர்வில்,0,0,1,1
27692,катализатор,0,0,1,1
27693,задание,0,0,1,1
27694,ترتبط,0,0,1,1
27695,اتخذتها,0,0,1,1
27696,поддерживались,0,0,1,1
27677,tarif,0,0,1,1
27671,இலவச,0,0,1,1
27646,derhen,0,0,1,1
27669,boisson,0,0,1,1
27647,расстраиваться,0,0,1,1
27648,செய்தார்கள்,0,0,1,1
27650,ವಾಕ್ಯದಲ್ಲಿ,0,0,1,1
27651,génie,0,0,1,1
27652,زرع,0,0,1,1
27653,സമസ്ത,0,0,1,1
27654,fingern,0,0,1,1
27655,tolerance,0,0,1,1
27656,secrètement,0,0,1,1
27659,farm,0,0,1,1
27660,rencontré,0,0,1,1
27662,respetar,0,0,1,1
27663,push,0,0,1,1
27665,திரைப்படங்களுக்குச்,0,0,1,1
27667,incorrectes,0,0,1,1
27810,बने,0,0,1,1
27812,classificados,0,0,1,1
28061,översättningen,0,0,1,1
27978,شكل,0,0,1,1
27968,آرون,0,0,1,1
27970,सांस्कृतिक,0,0,1,1
27971,«todo,0,0,1,1
27973,relatada,0,0,1,1
27975,чаще,0,0,1,1
27976,ബുദ്ധിശൂന്യമോ,0,0,1,1
27977,جوزيف,0,0,1,1
27983,casheservrar,0,0,1,1
27997,sinks,0,0,1,1
27984,estrechamente,0,0,1,1
27988,متواضعة,0,0,1,1
27990,stad,0,0,1,1
27991,mencionan,0,0,1,1
27992,تتجسد,0,0,1,1
27993,അടിച്ചേൽപ്പിക്കാൻ,0,0,1,1
27994,destinés,0,0,1,1
27967,försumbara,0,0,1,1
27965,взяла,0,0,1,1
27964,nonfree,0,0,1,1
27963,derrière,0,0,1,1
27942,valet,0,0,1,1
27943,പേരുടെ,0,0,1,1
27944,учителя,0,0,1,1
27945,misterioso,0,0,1,1
27946,matematikbog,0,0,1,1
27947,gewaltig,0,0,1,1
27948,என்பதில்,0,0,1,1
27949,اعتذر,0,0,1,1
27950,كارلوس,0,0,1,1
27954,ಹೋಗುತ್ತೀರಿ,0,0,1,1
27956,uhr,0,0,1,1
27957,projeye,0,0,1,1
27958,отполированный,0,0,1,1
27959,மறைக்க,0,0,1,1
27962,இரகசியமாக,0,0,1,1
27996,प्रतिपादित,0,0,1,1
27998,وجودة,0,0,1,1
27813,« un,0,0,1,1
28038,مذهولًا,0,0,1,1
28027,kopieren,0,0,1,1
28028,ചേർത്തുകൊള്ളണം,0,0,1,1
28029,comportementaux,0,0,1,1
28030,പഠിക്കുന്നുണ്ടെങ്കിൽ‌,0,0,1,1
28033,للحظة,0,0,1,1
28034,ദീർഘനേരം,0,0,1,1
28037,englobando,0,0,1,1
28040,غالبية,0,0,1,1
27999,ёсики,0,0,1,1
28042,написанное,0,0,1,1
28043,πηγαίνουμε,0,0,1,1
28045,traducidos,0,0,1,1
28047,revisar,0,0,1,1
28054,വിവരിക്കുന്നുള്ളൂ,0,0,1,1
28055,accessdatum,0,0,1,1
28056,vandalizadoras,0,0,1,1
28026, بريتانيكا,0,0,1,1
28025,αγαπώ,0,0,1,1
28024,yapmamıştım,0,0,1,1
28023,dressed,0,0,1,1
28001,تكتب,0,0,1,1
28003,قبولًا,0,0,1,1
28006,vacant,0,0,1,1
28007,tercer,0,0,1,1
28008,föremål,0,0,1,1
28009,otte,0,0,1,1
28011,അടിസ്ഥാനമാക്കിയാണ്,0,0,1,1
28012,الانقسام,0,0,1,1
28013,പറഞ്ഞതായി,0,0,1,1
28014,naturalité,0,0,1,1
28017,deadnames,0,0,1,1
28019,الآيس,0,0,1,1
28020,descobertas,0,0,1,1
28021,термины,0,0,1,1
28022,ipadresser,0,0,1,1
27940,pertinente,0,0,1,1
27938,presidencial,0,0,1,1
27937,ಕಾರ್ಯನಿರತರಾಗಿದ್ದಾರೆ,0,0,1,1
27851,നിർവ്വാഹകർ,0,0,1,1
27843,pretendientes,0,0,1,1
27844,insultantes,0,0,1,1
27845,பார்த்ததிலிருந்து,0,0,1,1
27846,ingeniero,0,0,1,1
27847,وحذف,0,0,1,1
27849,κανένα,0,0,1,1
27850,الجامعة,0,0,1,1
27852,கண்டுபிடிப்பின்படி,0,0,1,1
27936,அடித்தீர்கள்,0,0,1,1
27854,accepteret,0,0,1,1
27855,ಕಾಯಲು,0,0,1,1
27857,मोडल,0,0,1,1
27858,журналом,0,0,1,1
27861,مليارات,0,0,1,1
27862,சுவைக்கும்,0,0,1,1
27865,d’extrapoler,0,0,1,1
27842,wirtschaft,0,0,1,1
27839,"
dinamarquês",0,0,1,1
27838,grandissante,0,0,1,1
27836,بالمشاهدة,0,0,1,1
27814,sidde,0,0,1,1
27815,verkade,0,0,1,1
27816,yaptım,0,0,1,1
27817,surutilisé,0,0,1,1
27818,dilden,0,0,1,1
27819,உனக்கு,0,0,1,1
27820,l’intervention,0,0,1,1
27822,figaro,0,0,1,1
27823,guider,0,0,1,1
27824,κύριας,0,0,1,1
27825,किस्मत,0,0,1,1
27827,översättningar,0,0,1,1
27829,bachelet,0,0,1,1
27831,noncompliant,0,0,1,1
27835,olağan,0,0,1,1
27866,சார்பற்றது,0,0,1,1
27868,telefónica,0,0,1,1
27869,intelligence »,0,0,1,1
27904,dilemenin,0,0,1,1
27913,сложно,0,0,1,1
27914,വിവിധഘട്ടങ്ങളെ,0,0,1,1
27915,aboutir,0,0,1,1
27916,الاختلافات,0,0,1,1
27919,nude,0,0,1,1
27920,onaylanmamış,0,0,1,1
27921,högtalarikon,0,0,1,1
27923,കൃഷിയെപറ്റിയുള്ള,0,0,1,1
27924,mathehausaufgaben,0,0,1,1
27925,farkında,0,0,1,1
27930,mensualmente,0,0,1,1
27931,rubi,0,0,1,1
27932,emnet,0,0,1,1
27933,veda,0,0,1,1
27934,മാതൃകയിലുള്ള,0,0,1,1
27909,സമ്മതിച്ചാൽ,0,0,1,1
27902,iguales,0,0,1,1
27871,«лучшую,0,0,1,1
27900,സമ്പൂർണ്ണലേഖനം,0,0,1,1
27872,multitudinaria,0,0,1,1
27873,conoces,0,0,1,1
27874,production ,0,0,1,1
27877,konsumerar,0,0,1,1
27881,mattebok,0,0,1,1
27882,croyaitil,0,0,1,1
27883,taxas,0,0,1,1
27884,сходных,0,0,1,1
27887,ಅಭಿನಂದಿಸುವ,0,0,1,1
27888,drogs,0,0,1,1
27890,suciedad,0,0,1,1
27893,γεωμετρία,0,0,1,1
27894,satisfação,0,0,1,1
27898,заявлении,0,0,1,1
27899,erasmusprijs,0,0,1,1
27585,intentionally,0,0,1,1
27584,பயனரோ,0,0,1,1
27583,പോലീസോ,0,0,1,1
27260,température,0,0,1,1
27248,ko •,0,0,1,1
27250,intéressante,0,0,1,1
27253,besonders,0,0,1,1
27254,signo,0,0,1,1
27255,ατρόμητη,0,0,1,1
27257,знаменитой,0,0,1,1
27259,indecent,0,0,1,1
27261,importara,0,0,1,1
27281,चुपके,0,0,1,1
27262,колокольчика,0,0,1,1
27267,défendent,0,0,1,1
27271,haklıydın,0,0,1,1
27274,ಅತೃಪ್ತಿಯನ್ನು,0,0,1,1
27275,запутать,0,0,1,1
27276,невероятно,0,0,1,1
27277,προχώρα,0,0,1,1
27247,canton,0,0,1,1
27246,балансирующие,0,0,1,1
27245,utförs,0,0,1,1
27244,editó,0,0,1,1
27219,sinnet,0,0,1,1
27220,compreensíveis,0,0,1,1
27223,interesan,0,0,1,1
27227,avråder,0,0,1,1
27228,generando,0,0,1,1
27231,കരയരുതെന്ന്,0,0,1,1
27232,publicerade,0,0,1,1
27233,repasse,0,0,1,1
27235,språkliga,0,0,1,1
27237,wikizine,0,0,1,1
27238,ikisinde,0,0,1,1
27239,beğenmeyi,0,0,1,1
27241,kfoldcrossvalidation,0,0,1,1
27242,विवाद,0,0,1,1
27243,« reconnaître,0,0,1,1
27278,adabı,0,0,1,1
27285,വിജ്ഞാനശകലങ്ങൾ,0,0,1,1
27581,ശൈലിയും,0,0,1,1
27321,researcher,0,0,1,1
27312,ಭಾವಿಸಿದ್ದಳು,0,0,1,1
27314,gérant,0,0,1,1
27315,determining,0,0,1,1
27316,introduzida,0,0,1,1
27317,reappeared,0,0,1,1
27318,onderkend,0,0,1,1
27320,stunningly,0,0,1,1
27322,yaptığınızı,0,0,1,1
27286,clubic,0,0,1,1
27324,καθόταν,0,0,1,1
27325,வழியாகப்,0,0,1,1
27327,länkning,0,0,1,1
27331,பாருங்கள்,0,0,1,1
27334,руководствам,0,0,1,1
27335,даниэлем,0,0,1,1
27336,പെരുമഴയാവുകയാണ്,0,0,1,1
27311,kıkırdıyordu,0,0,1,1
27310,spurgt,0,0,1,1
27309,ιδεολογιών,0,0,1,1
27307,الكامل,0,0,1,1
27287,جذرية,0,0,1,1
27288,விளைவிக்கும்,0,0,1,1
27289,பாதுகாக்கப்பட்டுள்ளன,0,0,1,1
27290,ficava,0,0,1,1
27291,நேசிக்கிறேன்,0,0,1,1
27292,forskere,0,0,1,1
27296,ಪ್ರಯಾಣಿಸಿತು,0,0,1,1
27297,تملك,0,0,1,1
27298,arayana,0,0,1,1
27300,intimement,0,0,1,1
27301,lançamento,0,0,1,1
27302,engaged,0,0,1,1
27303,organizados,0,0,1,1
27305,χαρείτε,0,0,1,1
27306,jederzeit,0,0,1,1
27218,डबल,0,0,1,1
27215,ilginç,0,0,1,1
27213,sedento,0,0,1,1
27144,விஷயத்தைச்,0,0,1,1
27130,tendrá,0,0,1,1
27131,നാം,0,0,1,1
27132,goldgoldenem,0,0,1,1
27133,existé,0,0,1,1
27138,предметов,0,0,1,1
27139,честно,0,0,1,1
27141,hierarkisk,0,0,1,1
27145,ചോദിക്കുക,0,0,1,1
27212,மென்மையாகவும்,0,0,1,1
27146,процент,0,0,1,1
27148,حاسوبياً,0,0,1,1
27150,yapıyorsun,0,0,1,1
27151,intelligens,0,0,1,1
27152,escuchaste,0,0,1,1
27153,खुलापन,0,0,1,1
27154,concernés,0,0,1,1
27129,haiti,0,0,1,1
27127,beslutsgång,0,0,1,1
27126,dessin,0,0,1,1
27125,डिलीट,0,0,1,1
27099,пожаловаться,0,0,1,1
27100,നിർത്തിയെന്നത്,0,0,1,1
27104,कील,0,0,1,1
27105,डेल्ही,0,0,1,1
27107,μακριά,0,0,1,1
27110,dağıtım,0,0,1,1
27111,verbose,0,0,1,1
27113,formateras,0,0,1,1
27114,graphies,0,0,1,1
27115,wahrscheinlich,0,0,1,1
27118,paradoxa,0,0,1,1
27120,croissant,0,0,1,1
27121,περισσότερα,0,0,1,1
27123,سلبية,0,0,1,1
27124,முரண்பாடு,0,0,1,1
27155,министерств,0,0,1,1
27156,последняя,0,0,1,1
27158,fint,0,0,1,1
27185,डिजीटल,0,0,1,1
27189,получение,0,0,1,1
27190,स्वीकृतियों,0,0,1,1
27191,weggaf,0,0,1,1
27192,confirma,0,0,1,1
27193,ಡೆಲ್ಹಿಯಲ್ಲಿ,0,0,1,1
27196,комитеты,0,0,1,1
27200,ಸರಿಯಾಗಿದ್ದೇನೆ,0,0,1,1
27202,doldurma,0,0,1,1
27203,lowhanging,0,0,1,1
27204,αδιάφοροt,0,0,1,1
27207,impulsando,0,0,1,1
27208,koncepten,0,0,1,1
27209,entendo,0,0,1,1
27210,сентябре,0,0,1,1
27211,dotée,0,0,1,1
27188,waarvan,0,0,1,1
27184,opt,0,0,1,1
27159,ترجمة,0,0,1,1
27182,nerdy,0,0,1,1
27160,görünecek,0,0,1,1
27161,ഭക്ഷണമായിരുന്നു,0,0,1,1
27162,निंदन,0,0,1,1
27163,ανεβάζετε,0,0,1,1
27164,തന്നെയാണ്,0,0,1,1
27165,изумрудов,0,0,1,1
27166,coincé,0,0,1,1
27169,semanario,0,0,1,1
27172,mata,0,0,1,1
27174,अत्याचारपूर्ण,0,0,1,1
27175,anlayabileceği,0,0,1,1
27177,переживает,0,0,1,1
27178,afbryde,0,0,1,1
27179,कार्यकारी,0,0,1,1
27180,качаетесь,0,0,1,1
27337,തടയാറുണ്ട്,0,0,1,1
27338,påbörjade,0,0,1,1
27339,anzutreten,0,0,1,1
27511,mond,0,0,1,1
27502,ലേഖനത്തിനും,0,0,1,1
27503,عمليات,0,0,1,1
27504,монографиями,0,0,1,1
27505,വിരലുകളിൽ,0,0,1,1
27507,gerektiği,0,0,1,1
27508,adoraria,0,0,1,1
27509,wikipediaversioner,0,0,1,1
27512,dispone,0,0,1,1
27466,civilisé,0,0,1,1
27513,ಶೆಲ್ನ,0,0,1,1
27514,race,0,0,1,1
27515,ochtend,0,0,1,1
27517,construcción»,0,0,1,1
27518,எடுத்தால்,0,0,1,1
27519,petição,0,0,1,1
27520,comparación,0,0,1,1
27499,porn,0,0,1,1
27498,وغيرت,0,0,1,1
27495,durak,0,0,1,1
27492,databasen,0,0,1,1
27470,turc,0,0,1,1
27471,ഇല്ലായിരുന്നു,0,0,1,1
27472,чьюлибо,0,0,1,1
27473,tediosas,0,0,1,1
27474,ബഹുപദമായിരിക്കണോ,0,0,1,1
27475,மரியனை,0,0,1,1
27476,narsisa,0,0,1,1
27477,tr •,0,0,1,1
27478,kopyalamaya,0,0,1,1
27481,mejorar,0,0,1,1
27485,répondant,0,0,1,1
27486,வருகிறது,0,0,1,1
27487,दिनप्रतिदिन,0,0,1,1
27488,تعيينك,0,0,1,1
27491,desbloqueada,0,0,1,1
27522,instaladas,0,0,1,1
27523,ಚೆನ್ನಾಗಿರುತ್ತೇನೆ,0,0,1,1
27524,okulda,0,0,1,1
27556,പ്രേരിപ്പിക്കുന്നതെന്താണ്,0,0,1,1
27558,revenue,0,0,1,1
27559,затоплен,0,0,1,1
27560,പാസ്‌വേഡ്,0,0,1,1
27561,magasin,0,0,1,1
27562,comprometido,0,0,1,1
27563,stimulustriggered,0,0,1,1
27564,«быть,0,0,1,1
27566,അതിനുമുമ്പും,0,0,1,1
27568,पत्रकारों,0,0,1,1
27570,reutilizar,0,0,1,1
27571,réponses,0,0,1,1
27574,antissociais,0,0,1,1
27576,مولاي,0,0,1,1
27578,ನೋಡುತ್ತಿರುವಿರಿ,0,0,1,1
27579,منهجية,0,0,1,1
27557,புரியவில்லை,0,0,1,1
27553,ഒരുക്കിയ,0,0,1,1
27526,έρθει,0,0,1,1
27552,chronicle,0,0,1,1
27527,लेंग्वेज,0,0,1,1
27528,الماكرو،,0,0,1,1
27529,analyserade,0,0,1,1
27531,ഹെല്ലർ,0,0,1,1
27532,atıp,0,0,1,1
27534,uppmärksammat,0,0,1,1
27535,synnerhet,0,0,1,1
27537,gisteren,0,0,1,1
27538,tills,0,0,1,1
27540,copiaron,0,0,1,1
27544,terugkomen,0,0,1,1
27545,πες,0,0,1,1
27546,«bibliotecarios»,0,0,1,1
27548,confidence,0,0,1,1
27550,ಓದುತ್ತಿದ್ದೇನೆ,0,0,1,1
27467,contrebande,0,0,1,1
27465,الادعاءات,0,0,1,1
27340,hakkını,0,0,1,1
27387,ചതുപ്പുനിലത്തിന്,0,0,1,1
27377,தாருங்கள்,0,0,1,1
27378,बुनियादी,0,0,1,1
27379,تثبت,0,0,1,1
27383,encontrase,0,0,1,1
27384,parecía,0,0,1,1
27385,compraria,0,0,1,1
27386,bataklığın,0,0,1,1
27388,ഉണ്ടായിരുന്നെങ്കിൽ,0,0,1,1
27463,плагиат,0,0,1,1
27390,implications,0,0,1,1
27391,anoche,0,0,1,1
27392,« nature,0,0,1,1
27393,தொகுப்பானது,0,0,1,1
27397,τραπεζαρία,0,0,1,1
27399,ಗೆಳತಿ,0,0,1,1
27402,mentionnent,0,0,1,1
27374,ಮಾಡಲಿದ್ದೀರಿ,0,0,1,1
27373,ക്രിയാപദം,0,0,1,1
27370,telefonunu,0,0,1,1
27367,dull,0,0,1,1
27342,nominated,0,0,1,1
27344,ನೋಡಲು,0,0,1,1
27345,nouns,0,0,1,1
27346,ಉಪಯುಕ್ತ,0,0,1,1
27349,செய்யலாம்,0,0,1,1
27351,ഉപയോഗിച്ച,0,0,1,1
27352,τρομερή,0,0,1,1
27356,பார்ப்பேன்,0,0,1,1
27358,reçeli,0,0,1,1
27359,الجمهور,0,0,1,1
27360,।flummoxed,0,0,1,1
27361,ಕ್ಯಾಸಲ್,0,0,1,1
27362,വിക്കിപീഡിയർക്കോ,0,0,1,1
27363,consideradas,0,0,1,1
27365,сумасшедшие»,0,0,1,1
27403,—aunque,0,0,1,1
27404,geográfica,0,0,1,1
27405,vergisst,0,0,1,1
27432,سبب,0,0,1,1
27436,televisão,0,0,1,1
27437,മൊത്തത്തിൽ,0,0,1,1
27438,uspiselig,0,0,1,1
27439,caractérisait,0,0,1,1
27440,ξεχνάει,0,0,1,1
27446,generel,0,0,1,1
27449,informative,0,0,1,1
27451,intersidéral,0,0,1,1
27452,datamining,0,0,1,1
27453,draaide,0,0,1,1
27454,стадии,0,0,1,1
27457,onani,0,0,1,1
27458,consistem,0,0,1,1
27459,absurdas,0,0,1,1
27460,εμείς,0,0,1,1
27433,ألذ,0,0,1,1
27431,pouvoirs,0,0,1,1
27409,മധ്യമാ‍ർഗത്തിനേ,0,0,1,1
27429,processeurs,0,0,1,1
27410,substitui,0,0,1,1
27411,législatives,0,0,1,1
27414,türk,0,0,1,1
27415,وتساءلوا,0,0,1,1
27416,συγχωρείς,0,0,1,1
27417,opencollaborative,0,0,1,1
27418,λείπει,0,0,1,1
27419,основных,0,0,1,1
27420,данного,0,0,1,1
27422,одному,0,0,1,1
27423,lærer,0,0,1,1
27424,connus,0,0,1,1
27425,medlemmarna,0,0,1,1
27426,подъездной,0,0,1,1
27427,skillnad,0,0,1,1
28058,profondément,0,0,1,1
28062,soldats,0,0,1,1
27090,obtuvo,0,0,1,1
28703,टैग,0,0,1,1
28695,குறைவாகவும்,0,0,1,1
28696,तुम्हे,0,0,1,1
28697,академик,0,0,1,1
28699,corrijan,0,0,1,1
28700,emulados,0,0,1,1
28701,xviiie siècles,0,0,1,1
28702,differing,0,0,1,1
28707,событиях,0,0,1,1
28735,premiada,0,0,1,1
28708,ابق,0,0,1,1
28709,പരസ്യപ്രചരണമോ,0,0,1,1
28713,читателям,0,0,1,1
28714,செய்யவே,0,0,1,1
28716,exceeds,0,0,1,1
28725,बदले,0,0,1,1
28730,طاولة,0,0,1,1
28691,അസൈൻമെന്റുകളിൽ,0,0,1,1
28690,vaknade,0,0,1,1
28688,ведомств,0,0,1,1
28687,παρά,0,0,1,1
28656,μπορούσαν,0,0,1,1
28658,focalicen,0,0,1,1
28659,necrológicas,0,0,1,1
28660,meinungen,0,0,1,1
28662,वास्तविक,0,0,1,1
28666,പങ്കു,0,0,1,1
28668,priority,0,0,1,1
28670,വിറ്റതെന്ന്,0,0,1,1
28671,classificatie,0,0,1,1
28673,zomer,0,0,1,1
28676,brandit,0,0,1,1
28677,bereikbaar,0,0,1,1
28678,elinde,0,0,1,1
28681,overreported,0,0,1,1
28684,tilladelse,0,0,1,1
28731,evidentes,0,0,1,1
28739,الموسوعتين,0,0,1,1
28797,fungere,0,0,1,1
28781,الممر,0,0,1,1
28769,राजस्व,0,0,1,1
28771,رسم,0,0,1,1
28773,grüße,0,0,1,1
28774,verzamelen,0,0,1,1
28775,« featured,0,0,1,1
28776,documentary,0,0,1,1
28778,expressar,0,0,1,1
28782,anglocêntrica,0,0,1,1
28740,سعيدًا,0,0,1,1
28783,فرنسا,0,0,1,1
28785,preferência,0,0,1,1
28787,terminará,0,0,1,1
28788,एल,0,0,1,1
28789,അസ്വസ്ഥമാകരുത്,0,0,1,1
28791,organismes,0,0,1,1
28794,सुवे,0,0,1,1
28768,censuráveis,0,0,1,1
28767,நினைக்கிறீர்கள்,0,0,1,1
28765,ನಕಲಿ,0,0,1,1
28764,microbes,0,0,1,1
28741,സ്പീക്കർ,0,0,1,1
28742,ಹೊಂದಿದ್ದರೆ,0,0,1,1
28744,behövs,0,0,1,1
28745,aradan,0,0,1,1
28747,stripfiguren,0,0,1,1
28748,euskera,0,0,1,1
28750,ಹಾಸ್ಯವನ್ನು,0,0,1,1
28751,manuscrits,0,0,1,1
28752,كافحت,0,0,1,1
28753,экзамене,0,0,1,1
28756,nämnt,0,0,1,1
28759,എല്ലാവരോടും,0,0,1,1
28761,posent,0,0,1,1
28762,ಗಂಭೀರವಾಗಿ,0,0,1,1
28763,οκτώ,0,0,1,1
28652,நண்பர்களாக,0,0,1,1
28650,saknar,0,0,1,1
28649,oviedo,0,0,1,1
28573,ಸಂಭಾಷಣೆಯ,0,0,1,1
28563,teniendo,0,0,1,1
28564,ನಿಖರವಾಗಿ,0,0,1,1
28565,provoquant,0,0,1,1
28566,yaşanırsa,0,0,1,1
28568,citem,0,0,1,1
28570,hap,0,0,1,1
28571,لاستخدامها,0,0,1,1
28575,«„википедия“ —,0,0,1,1
28648,peticiones,0,0,1,1
28576,சொல்லுக்கு,0,0,1,1
28577,semestermånader,0,0,1,1
28580,"
अन्तरभाषिक",0,0,1,1
28583,உயரிய,0,0,1,1
28585,முன்னேறியது,0,0,1,1
28587,इंडेक्सिंग।,0,0,1,1
28588,kosteloos,0,0,1,1
28561,débuts,0,0,1,1
28560,sophistiqués,0,0,1,1
28559,outlaw,0,0,1,1
28558,galerie,0,0,1,1
28536,ಪ್ರಶ್ನೆಗೆ,0,0,1,1
28537,അത്യാധുനികമാണ്,0,0,1,1
28538,brugbarheden,0,0,1,1
28540,écrivit,0,0,1,1
28542,bilden,0,0,1,1
28544,ändrat,0,0,1,1
28547,الإجابة,0,0,1,1
28548,jedes,0,0,1,1
28549,நிரல்,0,0,1,1
28550,പോലെയുള്ള,0,0,1,1
28551,soyons,0,0,1,1
28552,estricto,0,0,1,1
28553,நடந்த,0,0,1,1
28554,studenters,0,0,1,1
28556,başlayacak,0,0,1,1
28589,snegleeksempel,0,0,1,1
28590,kanalen,0,0,1,1
28592,ന്യൂപീഡിയ,0,0,1,1
28620,نصًا,0,0,1,1
28625,ρωτήσω,0,0,1,1
28626,fehlverhalten,0,0,1,1
28629,efterladt,0,0,1,1
28630,традиционных,0,0,1,1
28631,உள்ளடக்கங்களையும்,0,0,1,1
28632,जरूरतों,0,0,1,1
28635,incluía,0,0,1,1
28636,tardive,0,0,1,1
28637,pænt,0,0,1,1
28638,erkläre,0,0,1,1
28639,avancerade,0,0,1,1
28641,وطريقة,0,0,1,1
28642,هكذا,0,0,1,1
28643,பொருளாதாரம்,0,0,1,1
28644,ലഭിക്കുന്ന,0,0,1,1
28623,контексте,0,0,1,1
28619,yaşamınızda,0,0,1,1
28595,венгерские,0,0,1,1
28615,abogaba,0,0,1,1
28596,réveillé,0,0,1,1
28597,émilie,0,0,1,1
28598,anónimo,0,0,1,1
28599,valg,0,0,1,1
28600,ahí,0,0,1,1
28601,காட்டப்படும்,0,0,1,1
28603,replied,0,0,1,1
28604,uitsluitend,0,0,1,1
28606,zinkt,0,0,1,1
28607,разделения,0,0,1,1
28608,ദ്യോഗിക,0,0,1,1
28610,litt,0,0,1,1
28611,sunmuştur,0,0,1,1
28613,பயணித்தது,0,0,1,1
28614,നല്ലവനാണോ,0,0,1,1
28796,αιώνες,0,0,1,1
28798,ரொட்டியுடன்,0,0,1,1
28064,இவற்றின்,0,0,1,1
28952,λυπημένη,0,0,1,1
28941,exigidos,0,0,1,1
28942,ചെയ്തതിന്,0,0,1,1
28944,செய்துவிட்டதாகவும்,0,0,1,1
28945,tightening,0,0,1,1
28949,demokratiske,0,0,1,1
28950,zukam,0,0,1,1
28951,இதனைப்,0,0,1,1
28955,créateur ,0,0,1,1
28969,ವಯಸ್ಸಿನ,0,0,1,1
28957,യൂണികോഡ്,0,0,1,1
28960,जनरल,0,0,1,1
28961,இருந்தாள்,0,0,1,1
28962,professionella,0,0,1,1
28963,الخطط,0,0,1,1
28966,இடம்பெறலாம்,0,0,1,1
28967,llegar,0,0,1,1
28939,تستطيع,0,0,1,1
28938,geological,0,0,1,1
28937,ஸ்லாஷ்டாட்,0,0,1,1
28936,tendríamos,0,0,1,1
28909,redistribución,0,0,1,1
28911,şehirdeki,0,0,1,1
28913,amerikaanse,0,0,1,1
28914,versuchen,0,0,1,1
28916,stuur,0,0,1,1
28917,dwaze,0,0,1,1
28918,meridional,0,0,1,1
28920,hielt,0,0,1,1
28923,fouille,0,0,1,1
28926,सुनाया,0,0,1,1
28928,délicate,0,0,1,1
28929,തരത്തിലാണുള്ളത്,0,0,1,1
28930,നടത്തുവാൻ,0,0,1,1
28932,förstår,0,0,1,1
28933,رابطًا,0,0,1,1
28968,beschreef,0,0,1,1
28971,changeux,0,0,1,1
28800,facteur,0,0,1,1
29020,يرتدي,0,0,1,1
29008,स्थानान्तरण,0,0,1,1
29009,vänstermarginal,0,0,1,1
29010,şişman,0,0,1,1
29011,médiathèques,0,0,1,1
29015,goalseeking,0,0,1,1
29016,hará,0,0,1,1
29019,respetarla,0,0,1,1
29025,prenumerera,0,0,1,1
28973,comboio,0,0,1,1
29026,incomuns,0,0,1,1
29028,इलेक्ट्रोनिका,0,0,1,1
29030,ಫ್ರೆಂಚ್,0,0,1,1
29034,evolvement,0,0,1,1
29035,tryckfriheten,0,0,1,1
29036,контакты,0,0,1,1
29037,الطلاب,0,0,1,1
29002,объекта,0,0,1,1
29001,biaisé,0,0,1,1
29000,لسلوك,0,0,1,1
28999,desculpando,0,0,1,1
28975,έστειλε,0,0,1,1
28976,séparée,0,0,1,1
28978,десятке,0,0,1,1
28980,there’s,0,0,1,1
28981,érasme,0,0,1,1
28986,bernard,0,0,1,1
28987,sortuda,0,0,1,1
28988,aldıkları,0,0,1,1
28989,личных,0,0,1,1
28991,vindicates,0,0,1,1
28992,neglen,0,0,1,1
28993,consulting,0,0,1,1
28994,ஒருங்கிணைப்பர்,0,0,1,1
28996,ಪದವೆಂದರೆ,0,0,1,1
28997,применений,0,0,1,1
28908,يرتكب,0,0,1,1
28905,adaptado,0,0,1,1
28903,edelsteinen,0,0,1,1
28838,മറന്നതിനാൽ,0,0,1,1
28827,ходим,0,0,1,1
28828,والدينية,0,0,1,1
28829,избирательной,0,0,1,1
28831,സാങ്കേതികവിദ്യയിൽ,0,0,1,1
28835,mover,0,0,1,1
28836,réflexion,0,0,1,1
28837,sosyal,0,0,1,1
28839,बहुस्तरीय,0,0,1,1
28902,vi •,0,0,1,1
28840,motsvarar,0,0,1,1
28841,voices,0,0,1,1
28842,triumphing,0,0,1,1
28843,സിനിമകൾക്കായി,0,0,1,1
28844,stormachtig,0,0,1,1
28846,écouter,0,0,1,1
28847,അനുവാദം,0,0,1,1
28826,والتعليق,0,0,1,1
28824,γεννηθεί,0,0,1,1
28823,yaparak,0,0,1,1
28822,വിളിക്കാം,0,0,1,1
28801,ποτήρι,0,0,1,1
28805,அனைவரையும்,0,0,1,1
28806,écologique »,0,0,1,1
28807,sofa,0,0,1,1
28808,inanamıyorum,0,0,1,1
28809,ഉപവിഭാഗമാണ്,0,0,1,1
28810,participam,0,0,1,1
28812,importasse,0,0,1,1
28813,ದೂರು,0,0,1,1
28814,مرصعة,0,0,1,1
28815,numerical,0,0,1,1
28818,людьми»,0,0,1,1
28819,இணையத்தில்,0,0,1,1
28820,подвержены,0,0,1,1
28821,altos,0,0,1,1
28848,डिस्कशन,0,0,1,1
28849,hazırlanan,0,0,1,1
28850,начинается,0,0,1,1
28876,ಅವನನ್ನು,0,0,1,1
28881,добровольцев»,0,0,1,1
28883,tsurko,0,0,1,1
28884,séparable,0,0,1,1
28885,besteden,0,0,1,1
28886,нидерландов,0,0,1,1
28887,ಒತ್ತುವ,0,0,1,1
28890,"l
किसी",0,0,1,1
28892,കാര്യങ്ങളെല്ലാം,0,0,1,1
28893,humanidad,0,0,1,1
28894,listed,0,0,1,1
28896,ridende,0,0,1,1
28897,وحشيًا,0,0,1,1
28898,indsætte,0,0,1,1
28899,άρεσαν,0,0,1,1
28901,seviyede,0,0,1,1
28878,யோ,0,0,1,1
28875,énumérées,0,0,1,1
28852,операционные,0,0,1,1
28873,exceptional,0,0,1,1
28853,цитировано,0,0,1,1
28855,catchsituatie,0,0,1,1
28856,kevin,0,0,1,1
28857,मुस्कुरा,0,0,1,1
28858,abertos,0,0,1,1
28859,zamandan,0,0,1,1
28860,memnun,0,0,1,1
28861,ohyou,0,0,1,1
28863,demandant,0,0,1,1
28864,recognition،,0,0,1,1
28865,tillåta,0,0,1,1
28866,ഉപയോക്താവിന്,0,0,1,1
28867,ಫೋನ್‌ನಲ್ಲಿ,0,0,1,1
28870,ಮಾರ್ಗ,0,0,1,1
28871,وضع,0,0,1,1
28535,impossível,0,0,1,1
28534,प्रश्नों,0,0,1,1
28533,അവലംബം,0,0,1,1
28226,dosyaları,0,0,1,1
28214,البلدان,0,0,1,1
28216,kende,0,0,1,1
28217,vary,0,0,1,1
28219,infantiles,0,0,1,1
28221,admiratifs,0,0,1,1
28223,d’intentionnalités,0,0,1,1
28225,constructivos,0,0,1,1
28228,varlıklardı,0,0,1,1
28241,accumulation,0,0,1,1
28229,أجرى,0,0,1,1
28232,incidents,0,0,1,1
28233,funcionando,0,0,1,1
28235,ಪದ್ಧತಿಗಳಿಂದ,0,0,1,1
28237,ಭಾಷಿಕರು,0,0,1,1
28238,യഥാർത്ഥ,0,0,1,1
28239,muhtemelen,0,0,1,1
28212,prachtige,0,0,1,1
28211,إداريي,0,0,1,1
28210,رغم,0,0,1,1
28209,ödmjuk,0,0,1,1
28187,crean,0,0,1,1
28188,commons —,0,0,1,1
28189,brydde,0,0,1,1
28191,ചങ്ങാതിമാർ‌ക്ക്,0,0,1,1
28192,மகத்தான,0,0,1,1
28193,trazia,0,0,1,1
28195,техники,0,0,1,1
28197,चेतावनी,0,0,1,1
28198,പോലെ,0,0,1,1
28200,mandiberg,0,0,1,1
28201,சேர்க்கப்பட்டதும்,0,0,1,1
28204,totalité,0,0,1,1
28206,feed,0,0,1,1
28207,страницей,0,0,1,1
28208,connexion,0,0,1,1
28240,intervenant,0,0,1,1
28242,sequência,0,0,1,1
28531,ലേഖനങ്ങളെഴുതാനും,0,0,1,1
28280,സൃഷ്ടിക്കപ്പെട്ടിരിക്കുന്ന,0,0,1,1
28271,yapılması,0,0,1,1
28272,безумие,0,0,1,1
28273,"
piemontês",0,0,1,1
28274,जानने,0,0,1,1
28275,texts,0,0,1,1
28276,rubí,0,0,1,1
28277,bâtiments,0,0,1,1
28281,английские,0,0,1,1
28243,skönheten,0,0,1,1
28284,وبين موسوعة,0,0,1,1
28286,ನಾರ್ಸಿಸಿಸಮ್,0,0,1,1
28287,australiskt,0,0,1,1
28288,اللغات،,0,0,1,1
28289,cavalgada,0,0,1,1
28290,slovaque,0,0,1,1
28291,acompanhar,0,0,1,1
28270,ബാങ്കിങ്,0,0,1,1
28268,попадете,0,0,1,1
28267,masiva»,0,0,1,1
28266,measurement,0,0,1,1
28244,hero,0,0,1,1
28245,ειδήσεις,0,0,1,1
28246,يحتوي,0,0,1,1
28247,அண்ணளவாக,0,0,1,1
28248,uyuşuk,0,0,1,1
28249,المعادي,0,0,1,1
28251,ചിന്തിക്കട്ടെ,0,0,1,1
28252,ложной,0,0,1,1
28254,പ്രപഞ്ചത്തിലെ,0,0,1,1
28256,retrace,0,0,1,1
28259,الهاتف,0,0,1,1
28261,collecte,0,0,1,1
28262,прокат,0,0,1,1
28264,είτε,0,0,1,1
28265,éducatif,0,0,1,1
28185,farinha,0,0,1,1
28182,построить,0,0,1,1
28180,folkrepubliken,0,0,1,1
28101,paralelo»,0,0,1,1
28092,acalmese,0,0,1,1
28093,bloquer,0,0,1,1
28094,träffas,0,0,1,1
28095,грустная,0,0,1,1
28097,φολιδωτή,0,0,1,1
28098,ನಿಲ್ಲಿಸಬಹುದೇ,0,0,1,1
28099,üzerindeki,0,0,1,1
28102,veriyorum,0,0,1,1
28179,finaste,0,0,1,1
28104,കഴിക്കുന്നതിനേക്കാൾ,0,0,1,1
28106,anlaman,0,0,1,1
28109,கட்டுரையொன்றில்,0,0,1,1
28110,olabilirdim,0,0,1,1
28111,gidemezsiniz,0,0,1,1
28112,çuvalladım,0,0,1,1
28113,അഞ്ച്,0,0,1,1
28090,വിഭാഗങ്ങളായ്,0,0,1,1
28089,ro •,0,0,1,1
28088,കൊടുക്കാൻ,0,0,1,1
28087,സ്രോതസ്സുകളുടെ,0,0,1,1
28065,хлебом,0,0,1,1
28066,تتصدر,0,0,1,1
28067,ಕೇಳಬಹುದು,0,0,1,1
28068,உதவும்,0,0,1,1
28070,siga,0,0,1,1
28072,लें,0,0,1,1
28073,apontam,0,0,1,1
28074,startede,0,0,1,1
28075,privileged,0,0,1,1
28076,nonprobabilistic,0,0,1,1
28078,ಬಂದಾಗ,0,0,1,1
28079,alcanzaron,0,0,1,1
28083,hierarchy,0,0,1,1
28085,الإداريون,0,0,1,1
28086,пользователь,0,0,1,1
28116,أهتم,0,0,1,1
28118,casuais,0,0,1,1
28120,argumentou,0,0,1,1
28149,تعافى,0,0,1,1
28153,возможны,0,0,1,1
28154,يضم,0,0,1,1
28155,перемещён,0,0,1,1
28157,bezoek,0,0,1,1
28158,заблокировать,0,0,1,1
28161,zeiden,0,0,1,1
28162,falantes,0,0,1,1
28166,отклонила,0,0,1,1
28170,ഇതൊരു,0,0,1,1
28171,एव्रीथिंग,0,0,1,1
28173,கூட்டுப்,0,0,1,1
28174,liberal,0,0,1,1
28175,ಮಾಲ್‌ನಲ್ಲಿ,0,0,1,1
28177,glimlachen,0,0,1,1
28178,ανακρίβεια,0,0,1,1
28152,anlamları,0,0,1,1
28148,பழக்கவழக்கங்கள்,0,0,1,1
28121,velden,0,0,1,1
28147,præcision,0,0,1,1
28123,подписки,0,0,1,1
28124,கண்ணாடியில்,0,0,1,1
28125,தெரிவிக்க,0,0,1,1
28130,विकिज़नानी,0,0,1,1
28131,minoritaire,0,0,1,1
28132,distinctly,0,0,1,1
28133,пожелать,0,0,1,1
28134,inbördeskriget,0,0,1,1
28136,"
croata",0,0,1,1
28139,máquina,0,0,1,1
28141,pegue,0,0,1,1
28143,соль,0,0,1,1
28144,بتعديل,0,0,1,1
28145,പുരുഷന്മാർ,0,0,1,1
28146,equivalent,0,0,1,1
28295,पेशकश,0,0,1,1
28296,والصينية،,0,0,1,1
28301,artikelversion,0,0,1,1
28464,ഓടി,0,0,1,1
28456,χαμογελάσει,0,0,1,1
28458,minuscule,0,0,1,1
28459,റിച്ചാർഡ്,0,0,1,1
28460,macrolinguagem,0,0,1,1
28461,هما,0,0,1,1
28462,χαρούμενος,0,0,1,1
28463,وضميرًا,0,0,1,1
28465,പരിഹാരത്തിനുപകരം,0,0,1,1
28418,frankreich,0,0,1,1
28466,agradables,0,0,1,1
28467,guardaredes,0,0,1,1
28468,ನಂಬಲಾಗದ,0,0,1,1
28469,ameaças,0,0,1,1
28470,الاقتباسات،,0,0,1,1
28472,wurzelwörter,0,0,1,1
28475,slightly,0,0,1,1
28453,интеллектуальным,0,0,1,1
28450,sudamérica,0,0,1,1
28448,सीखा,0,0,1,1
28447,deems,0,0,1,1
28422,filtrera,0,0,1,1
28425,نوعا,0,0,1,1
28426,descentralizada,0,0,1,1
28427,britisk,0,0,1,1
28428,интерфейсы,0,0,1,1
28430,boede,0,0,1,1
28432,entretanto,0,0,1,1
28433,சுதந்திரம்,0,0,1,1
28434,inconsistencia,0,0,1,1
28435,ağlayarak,0,0,1,1
28438,avoid,0,0,1,1
28441,والسلج,0,0,1,1
28443,nauw,0,0,1,1
28444,പറയാനാകുമോ,0,0,1,1
28446,"
बुल्गारियाई",0,0,1,1
28478,ζεστό,0,0,1,1
28479,traversing,0,0,1,1
28480,عاديًا,0,0,1,1
28508,remind,0,0,1,1
28510,தேவதையாக,0,0,1,1
28511,هدية,0,0,1,1
28512,vayamos,0,0,1,1
28513,alternates,0,0,1,1
28514,несколькими,0,0,1,1
28518,റഫറൻസ്,0,0,1,1
28520,comedic,0,0,1,1
28521,affirmait,0,0,1,1
28522,يجعلها,0,0,1,1
28524,feces,0,0,1,1
28526,μνηστήρες,0,0,1,1
28527,unverifiable,0,0,1,1
28528,मानसिक,0,0,1,1
28529,exercício,0,0,1,1
28530,inblandning,0,0,1,1
28509,lebender,0,0,1,1
28505,tornadoes,0,0,1,1
28481,animó,0,0,1,1
28504,πλούτη,0,0,1,1
28483,அவரை,0,0,1,1
28484,നോക്കിയ,0,0,1,1
28487,misinformation,0,0,1,1
28488,المعرفة،,0,0,1,1
28489,πορεία,0,0,1,1
28490,जाएगा।,0,0,1,1
28492,sıcak,0,0,1,1
28493,falto,0,0,1,1
28494,ಸೆಕೆಂಡಿಗೆ,0,0,1,1
28496,വിനീതവും,0,0,1,1
28497,«verificabilidad»​,0,0,1,1
28498,utges,0,0,1,1
28499,estranhos,0,0,1,1
28501,kalınarak,0,0,1,1
28502,veteraner,0,0,1,1
28421,stavefejl,0,0,1,1
28417,californie,0,0,1,1
28302,inégalités,0,0,1,1
28346,actionnaire,0,0,1,1
28329,objectif,0,0,1,1
28330,ifadeyi,0,0,1,1
28331,ಎಲ್ಲ,0,0,1,1
28335,antivandal,0,0,1,1
28336,reacts,0,0,1,1
28340,batholiths,0,0,1,1
28345,bloqueando,0,0,1,1
28347,பொதுவில்,0,0,1,1
28413,lesma,0,0,1,1
28348,dier,0,0,1,1
28349,डिलीवरी,0,0,1,1
28350,baas,0,0,1,1
28352,homogeneizando,0,0,1,1
28353,aldı,0,0,1,1
28354,spiegelbild,0,0,1,1
28355,случаю,0,0,1,1
28328,लेटेस्ट,0,0,1,1
28326,टायलर,0,0,1,1
28325,mangelhaft,0,0,1,1
28324,بمقياس,0,0,1,1
28304,taber,0,0,1,1
28305,उल्लंघन,0,0,1,1
28306,supportemoi,0,0,1,1
28309,സ്വപ്ന,0,0,1,1
28310,"
लिथुआनियाई",0,0,1,1
28311,சாதாரண,0,0,1,1
28312,corrija,0,0,1,1
28313,vendría,0,0,1,1
28316,bulunabilir,0,0,1,1
28317,nærheden,0,0,1,1
28318,dağıtılmasına,0,0,1,1
28320,दुबारा,0,0,1,1
28321,स्लाइस,0,0,1,1
28322,atmospheres,0,0,1,1
28323,storslået,0,0,1,1
28356,отчасти,0,0,1,1
28359,honestly,0,0,1,1
28360,इनका,0,0,1,1
28387,горничные,0,0,1,1
28392,informal,0,0,1,1
28395,मिलनी,0,0,1,1
28396,ποιες,0,0,1,1
28397,norwegian,0,0,1,1
28398,borta,0,0,1,1
28402,militent,0,0,1,1
28403,администраторам,0,0,1,1
28404,ಕಲಿಯುತ್ತಿದ್ದರೆ,0,0,1,1
28405,boğulma,0,0,1,1
28406,gebrauch,0,0,1,1
28407,criminal,0,0,1,1
28408,disseminálo,0,0,1,1
28410,giggles,0,0,1,1
28411,السجناء,0,0,1,1
28412,ಸುಂದರವಾಗಿದ್ದಾಳೆಂದು,0,0,1,1
28388,lecture,0,0,1,1
28386,सात,0,0,1,1
28361,ищем,0,0,1,1
28385,ആവർത്തിക്കണം,0,0,1,1
28363,χειρότερα,0,0,1,1
28365,പരീക്ഷയിൽ,0,0,1,1
28366,voici,0,0,1,1
28367,يونجل,0,0,1,1
28369,sıklıkla,0,0,1,1
28370,bekijken,0,0,1,1
28371,réservée,0,0,1,1
28372,ಸಿಲುಕಿಕೊಂಡಿದ್ದೀರಿ,0,0,1,1
28376,уэйлса,0,0,1,1
28377,excesiva,0,0,1,1
28378,ಕೆಲವೇ,0,0,1,1
28379,приехал,0,0,1,1
28380,πρότασή,0,0,1,1
28383,விக்கிமீடியா,0,0,1,1
28384,وربما,0,0,1,1
27093,столовую,0,0,1,1
27087,likheter,0,0,1,1
29041,uncommon,0,0,1,1
25821,fedorenta,0,0,1,1
25813,"
checheno",0,0,1,1
25814,έπαιρνα,0,0,1,1
25815,marionetter,0,0,1,1
25816,karmaşa,0,0,1,1
25817,ಒಂದನ್ನು,0,0,1,1
25818,km,0,0,1,1
25819,negou,0,0,1,1
25822,الستينيات,0,0,1,1
25838,collagen,0,0,1,1
25823,ठोक,0,0,1,1
25824,befordrad,0,0,1,1
25826,deverão,0,0,1,1
25827,badly,0,0,1,1
25830,सर्व,0,0,1,1
25831,मीठा,0,0,1,1
25832,beweisen,0,0,1,1
25812,പോവുന്നത്,0,0,1,1
25808,لوحي,0,0,1,1
25807,plena,0,0,1,1
25805,meningsverschillen,0,0,1,1
25782,kleidern,0,0,1,1
25784,സൗന്ദര്യമല്ലാതെ,0,0,1,1
25785,kasteel,0,0,1,1
25786,træder,0,0,1,1
25788,havlu,0,0,1,1
25789,lus,0,0,1,1
25790,força,0,0,1,1
25794,كلمتك,0,0,1,1
25796,découlant,0,0,1,1
25797,присутствовать,0,0,1,1
25799,picarde,0,0,1,1
25800,schwierigkeiten,0,0,1,1
25801,ссылаясь,0,0,1,1
25802,controversée,0,0,1,1
25803,userinterface,0,0,1,1
25834,выше,0,0,1,1
25839,تحولت,0,0,1,1
25898,violates,0,0,1,1
25884,оценка,0,0,1,1
25876,ഉറപ്പുണ്ട്,0,0,1,1
25877,nysade,0,0,1,1
25878,സ്വീകരിക്കുക,0,0,1,1
25879,sugiriendo,0,0,1,1
25881,hänt,0,0,1,1
25882,onderzoeken,0,0,1,1
25883,നിലനിൽക്കുന്നതായി,0,0,1,1
25886,appelant,0,0,1,1
25840,أوائل,0,0,1,1
25887,pantalla,0,0,1,1
25888,tentativa,0,0,1,1
25890,inexperientes,0,0,1,1
25891,vivaient,0,0,1,1
25892,രണ്ടെണ്ണം,0,0,1,1
25895,existia,0,0,1,1
25896,acceptée,0,0,1,1
25873,magiques,0,0,1,1
25872,найдете,0,0,1,1
25871,sveriges,0,0,1,1
25868,vertrekken,0,0,1,1
25842,возражаете,0,0,1,1
25843,bitmiş,0,0,1,1
25844,പുതുക്കാറുണ്ട്,0,0,1,1
25847,ಕೊಡುಗೆಗಳನ್ನು,0,0,1,1
25849,പേജില്,0,0,1,1
25850,продолжился,0,0,1,1
25851,பெறப்பட்டது,0,0,1,1
25854,произведённых,0,0,1,1
25855,للاستخدام,0,0,1,1
25856,моего,0,0,1,1
25858,uger,0,0,1,1
25859,music,0,0,1,1
25860,giacomo,0,0,1,1
25863,destinados,0,0,1,1
25864,equidad,0,0,1,1
25781,luidspreker,0,0,1,1
25780,periodicidad,0,0,1,1
25779,kochten,0,0,1,1
25707,antigas,0,0,1,1
25697,cumplimiento,0,0,1,1
25698,தேவதூதருடன்,0,0,1,1
25700,"
पाश्चात्य",0,0,1,1
25701,individualiste,0,0,1,1
25702,ağlamaya,0,0,1,1
25704,suggesties,0,0,1,1
25705,électricité,0,0,1,1
25709,relate,0,0,1,1
25778,refletir,0,0,1,1
25710,लागत,0,0,1,1
25712,والخبز,0,0,1,1
25716,güney,0,0,1,1
25718,உட்பட,0,0,1,1
25719,folga,0,0,1,1
25720,فجأة,0,0,1,1
25721,внешностью,0,0,1,1
25696,последних,0,0,1,1
25693,день»,0,0,1,1
25692,ilícita,0,0,1,1
25691,fejltagelse,0,0,1,1
25671,kans,0,0,1,1
25672,sloot,0,0,1,1
25673,участником,0,0,1,1
25674,pratiques »,0,0,1,1
25675,leihen,0,0,1,1
25676,पासवर्ड,0,0,1,1
25677,வெளியிடப்பட்டு,0,0,1,1
25678,भाषी,0,0,1,1
25679,hjørnet,0,0,1,1
25680,"
फ़ैरोई",0,0,1,1
25682,определенному,0,0,1,1
25686,haciéndolo,0,0,1,1
25687,днем,0,0,1,1
25688,physics—the,0,0,1,1
25690,mettant,0,0,1,1
25723,स्वाभाविक,0,0,1,1
25724,plagued,0,0,1,1
25725,abonneren,0,0,1,1
25759,offrent,0,0,1,1
25761,அருகில்,0,0,1,1
25763,നൽ‌കും,0,0,1,1
25764,സ്വപ്നമാണെന്നും,0,0,1,1
25765,различных,0,0,1,1
25766,صنف,0,0,1,1
25767,española,0,0,1,1
25768,المنطقي,0,0,1,1
25769,deformed,0,0,1,1
25770,discutezen,0,0,1,1
25771,والجزء,0,0,1,1
25772,outnumbered,0,0,1,1
25773,விடுமுறை,0,0,1,1
25775,stewardship,0,0,1,1
25776,avsaknad,0,0,1,1
25777,bero,0,0,1,1
25760,ограничений,0,0,1,1
25757,capacidade,0,0,1,1
25729,acheté,0,0,1,1
25755,истинность»,0,0,1,1
25730,للتكرار,0,0,1,1
25731,bøger,0,0,1,1
25732,español—​,0,0,1,1
25734,कैदियों,0,0,1,1
25735,tiny,0,0,1,1
25736,συνεργατικά,0,0,1,1
25738,बाढ़,0,0,1,1
25739,çıkarmaktadır,0,0,1,1
25740,частично,0,0,1,1
25741,«invirtió,0,0,1,1
25744,geométricos,0,0,1,1
25746,энциклопедию,0,0,1,1
25747,याचिका,0,0,1,1
25750,ganhando,0,0,1,1
25753,capitalistas,0,0,1,1
25897,والثروات,0,0,1,1
25899,ಕಾಣಬಹುದು,0,0,1,1
26142,രണ്ടാമത്തെ,0,0,1,1
26068,özensizlik,0,0,1,1
26057,gekregen,0,0,1,1
26058,tapiz,0,0,1,1
26059,valued,0,0,1,1
26060,ммм,0,0,1,1
26061,जाएगी।,0,0,1,1
26063,إطار,0,0,1,1
26065,राष्ट्रीय,0,0,1,1
26069,μάθηση,0,0,1,1
26083,existieron,0,0,1,1
26071,mediafiler,0,0,1,1
26072,നിർമ്മാണം,0,0,1,1
26073,consertar,0,0,1,1
26074,vormen,0,0,1,1
26077,انتحالًا,0,0,1,1
26078,വസ്തുതകളും,0,0,1,1
26080,şans,0,0,1,1
26056,постановка,0,0,1,1
26050,ಹೇಗಿದ್ದೀರಿ,0,0,1,1
26049,fond,0,0,1,1
26047,fluvial,0,0,1,1
26023,பதிலாகத்,0,0,1,1
26024,denunció,0,0,1,1
26025,വരുമ്പൊൾ,0,0,1,1
26026,universitet,0,0,1,1
26029,голоса,0,0,1,1
26030,improvement,0,0,1,1
26031,штата,0,0,1,1
26032,दिलाया,0,0,1,1
26033,perceived,0,0,1,1
26034,κάθεστε,0,0,1,1
26035,பகுதியில்,0,0,1,1
26036,eerdere,0,0,1,1
26037,neutres,0,0,1,1
26041,estadounidense,0,0,1,1
26043,dizerme,0,0,1,1
26082,വീഡിയോയ്ക്ക്,0,0,1,1
26087,प्रविष्टियाँ,0,0,1,1
25900,estatísticos,0,0,1,1
26130,सामना,0,0,1,1
26119,«быстро»,0,0,1,1
26120,ресторан,0,0,1,1
26121,colloquial,0,0,1,1
26124,الحيرة,0,0,1,1
26127,automatisation,0,0,1,1
26128,игру»,0,0,1,1
26129,daterad,0,0,1,1
26131,plata,0,0,1,1
26088,placeret,0,0,1,1
26132,disruptivas,0,0,1,1
26133,лично,0,0,1,1
26134,obterá,0,0,1,1
26136,television—how,0,0,1,1
26137,столетия,0,0,1,1
26138,terörist,0,0,1,1
26139,ആന,0,0,1,1
26118,mencionado,0,0,1,1
26117,vedalaşmadan,0,0,1,1
26113,androidenheter,0,0,1,1
26112,petrolífero,0,0,1,1
26089,различна,0,0,1,1
26092,practica,0,0,1,1
26094,marcher,0,0,1,1
26096,вела,0,0,1,1
26097,находилась,0,0,1,1
26098,çalış,0,0,1,1
26099,ಜೋಚ್,0,0,1,1
26100,прошедших,0,0,1,1
26102,വളർച്ച,0,0,1,1
26104,необходимых,0,0,1,1
26105,düşünmüyorum,0,0,1,1
26106,நபருக்கு,0,0,1,1
26107,kanala,0,0,1,1
26108,تكاليف,0,0,1,1
26109,ಚೂಪಾದವು,0,0,1,1
26022,الرطبة,0,0,1,1
26020,நிறுத்த,0,0,1,1
26017,mediaservices,0,0,1,1
25943,ई,0,0,1,1
25930,человеческий,0,0,1,1
25934,стрессовых,0,0,1,1
25936,الوصمي,0,0,1,1
25937,മാതൃകകളെ,0,0,1,1
25939,temperatures,0,0,1,1
25940,δημοφιλούς,0,0,1,1
25942,ജീവനുള്ളവളായിരുന്നുവെന്ന്,0,0,1,1
25944,تقاس,0,0,1,1
26015,harina,0,0,1,1
25945,citable,0,0,1,1
25946,kullanılan,0,0,1,1
25947,பற்றிய,0,0,1,1
25948,neerzet,0,0,1,1
25949,navigateur,0,0,1,1
25950,الضخمة,0,0,1,1
25952,αμερική,0,0,1,1
25928,ساعدني,0,0,1,1
25926,étranger,0,0,1,1
25924,استخدامًا،,0,0,1,1
25920,வெளியே,0,0,1,1
25901,proche,0,0,1,1
25902,balcón,0,0,1,1
25903,оценочный,0,0,1,1
25904,toma,0,0,1,1
25905,வெற்றியடையவில்லை,0,0,1,1
25906,دورية,0,0,1,1
25907,laugh,0,0,1,1
25909,histories,0,0,1,1
25912,платьев,0,0,1,1
25913,adını,0,0,1,1
25914,विरले,0,0,1,1
25916,klädd,0,0,1,1
25917,kafasını,0,0,1,1
25918,efficiently,0,0,1,1
25919,permitiendo,0,0,1,1
25954,ederek,0,0,1,1
25956,pride,0,0,1,1
25957,smakend,0,0,1,1
25987,undergone,0,0,1,1
25990,överdriva,0,0,1,1
25992,bölümü,0,0,1,1
25994,betrouwbaar,0,0,1,1
25995,financiación,0,0,1,1
25998,شاركت,0,0,1,1
25999,borró,0,0,1,1
26001,impidiendo,0,0,1,1
26004,mg •,0,0,1,1
26006,culturelles,0,0,1,1
26007,ಡ್ರೈವಾಲ್,0,0,1,1
26009,tyvärr,0,0,1,1
26010,forestil,0,0,1,1
26012,vergissen,0,0,1,1
26013,വാരാന്ത്യത്തിലും,0,0,1,1
26014,sudcoréen,0,0,1,1
25989,çalışmıyorsa,0,0,1,1
25985,измерения,0,0,1,1
25958,सेवा,0,0,1,1
25984,анализ,0,0,1,1
25959,முதன்மைச்,0,0,1,1
25961,acreditada,0,0,1,1
25962,ewigkeiten,0,0,1,1
25966,വിവരിക്കാൻ,0,0,1,1
25967,localizado,0,0,1,1
25968,википедисты,0,0,1,1
25971,брайдл,0,0,1,1
25972,sølvbrød,0,0,1,1
25973,lächelten,0,0,1,1
25975,"
अन्यथा",0,0,1,1
25976,personuppgifter,0,0,1,1
25978,påbörja,0,0,1,1
25979,системным,0,0,1,1
25980,«потрясающе,0,0,1,1
25983,wikilibros,0,0,1,1
25669,حيوان,0,0,1,1
25667,मिली,0,0,1,1
25664,telespectadores,0,0,1,1
25352,вошли,0,0,1,1
25339,ಸಂಖ್ಯೆಯನ್ನು,0,0,1,1
25340,நன்றாகப்,0,0,1,1
25344,güvenilebilirliği,0,0,1,1
25347,enfades,0,0,1,1
25348,தொகுப்பாளர்களால்,0,0,1,1
25349,warnings,0,0,1,1
25350,worse,0,0,1,1
25354,النيكل؛,0,0,1,1
25366,apprécie,0,0,1,1
25355,cuídate,0,0,1,1
25357,ಭ್ರಮನಿರಸನಗೊಂಡಿದ್ದೇನೆ,0,0,1,1
25359,adicionais,0,0,1,1
25360,partitions,0,0,1,1
25361,sonraları,0,0,1,1
25362,irgendwie,0,0,1,1
25363,ನೋಡುತ್ತಿದ್ದರು,0,0,1,1
25338,विकिन्यूज,0,0,1,1
25336,ракушка,0,0,1,1
25334,நேரத்திலிருந்து,0,0,1,1
25332,используемый,0,0,1,1
25307,μπερδεμένοι,0,0,1,1
25309,ಮುಕ್ತರಾಗಿದ್ದೀರಾ,0,0,1,1
25311,griffith,0,0,1,1
25312,форма,0,0,1,1
25313,consigo,0,0,1,1
25317,يلجأ,0,0,1,1
25318,directe,0,0,1,1
25319,licensors,0,0,1,1
25320,расстроены,0,0,1,1
25321,कर।,0,0,1,1
25322,améliorait,0,0,1,1
25325,matchen,0,0,1,1
25326,ken,0,0,1,1
25329,പതിപ്പുകളിൽ,0,0,1,1
25330,ತೊಂದರೆಯಿಲ್ಲ,0,0,1,1
25364,redirection,0,0,1,1
25368,drin,0,0,1,1
25663,  cdrom,0,0,1,1
25418,"​
sin",0,0,1,1
25406,opposing,0,0,1,1
25407,urbaine,0,0,1,1
25408,nossos,0,0,1,1
25409,alimentés,0,0,1,1
25410,ഗ്ലാസ്,0,0,1,1
25411,ಉತ್ತಮವಾಗಿದೆ,0,0,1,1
25413,orsaken,0,0,1,1
25420,السيدات,0,0,1,1
25369,العشاء,0,0,1,1
25422,doktoranders,0,0,1,1
25424,الطفولة،,0,0,1,1
25426,pixelgrootte,0,0,1,1
25427,"
चेक",0,0,1,1
25428,गैरविकी,0,0,1,1
25429,मॉम,0,0,1,1
25431,ലേഖനങ്ങൾക്ക്‌,0,0,1,1
25402,καναπέ,0,0,1,1
25401,тех,0,0,1,1
25400,ಚಿಂತೆಯಿಲ್ಲ,0,0,1,1
25399,കടത്തി,0,0,1,1
25370,ವಿಷಯದಲ್ಲಿ,0,0,1,1
25372,nesta,0,0,1,1
25373,verwendeten,0,0,1,1
25375,schrijfsters,0,0,1,1
25376,yönergesi,0,0,1,1
25377,conçue,0,0,1,1
25384,capturar,0,0,1,1
25386,ചെറുതും,0,0,1,1
25387,medfølgende,0,0,1,1
25388,disagreements,0,0,1,1
25393,ряд,0,0,1,1
25394,ickehierarkisk,0,0,1,1
25396,reparler,0,0,1,1
25397,haveria,0,0,1,1
25398,распределённом,0,0,1,1
25305,يقارب,0,0,1,1
25304,لتخريب,0,0,1,1
25303,lettres,0,0,1,1
25223,ಕೆಟ್ಟದಾಗಿದೆ,0,0,1,1
25214,diepbedroefd,0,0,1,1
25215,sporen,0,0,1,1
25218,осуществляют,0,0,1,1
25219,transactions,0,0,1,1
25220,முயற்சியானது,0,0,1,1
25221,convergentes,0,0,1,1
25222,സഞ്ചരിച്ചിരുന്ന,0,0,1,1
25224,சம்பவங்கள்,0,0,1,1
25302,образовательном,0,0,1,1
25225,artistic,0,0,1,1
25226,предпочли,0,0,1,1
25227,extending,0,0,1,1
25228,والإجراءات,0,0,1,1
25229,bölgeden,0,0,1,1
25230,ಸಮಸ್ಯೆಯಾಗಿದೆ,0,0,1,1
25231,пересадки,0,0,1,1
25212,artikelförfattarna,0,0,1,1
25210,åldrar,0,0,1,1
25209,secuencias,0,0,1,1
25208,woordgroepen,0,0,1,1
25178,llegada,0,0,1,1
25181,مشروب,0,0,1,1
25183,ശ്വസിക്കാൻ,0,0,1,1
25186,ചോദ്യത്തിന്,0,0,1,1
25187,nutzlos,0,0,1,1
25191,prédéterminées,0,0,1,1
25194,തിരുത്തുകൾ,0,0,1,1
25196,minut,0,0,1,1
25197,الاجتماعي,0,0,1,1
25198,efetuou,0,0,1,1
25199,jean,0,0,1,1
25200,asombrosa,0,0,1,1
25202,старому,0,0,1,1
25204,allvarliga,0,0,1,1
25205,län,0,0,1,1
25232,disasters,0,0,1,1
25239,princess,0,0,1,1
25242,திட்டங்கள்,0,0,1,1
25275,"
मैसिडोनियाई",0,0,1,1
25277,functionality,0,0,1,1
25278,«страница,0,0,1,1
25279,जावानी,0,0,1,1
25280,هيلر,0,0,1,1
25285,crearles,0,0,1,1
25287,mapping,0,0,1,1
25288,interesaron,0,0,1,1
25290,açıktır,0,0,1,1
25291,"
काशुबियाई",0,0,1,1
25292,dactylographié,0,0,1,1
25294,அடைய,0,0,1,1
25295,hogere,0,0,1,1
25298,अंग्रजी,0,0,1,1
25299,παρακολούθηση,0,0,1,1
25300,സമയമില്ല,0,0,1,1
25276,ചിത്രീകരണവും,0,0,1,1
25274,freut,0,0,1,1
25243, ,0,0,1,1
25273,sustained,0,0,1,1
25244,vio,0,0,1,1
25245,protest,0,0,1,1
25247,attorney,0,0,1,1
25248,ഇക്കാര്യത്തിലും,0,0,1,1
25252,fui,0,0,1,1
25254,oroar,0,0,1,1
25255,मिस्सा,0,0,1,1
25256,فيولا,0,0,1,1
25257,ميدياويكي،,0,0,1,1
25260,компьютерным,0,0,1,1
25262,navegador,0,0,1,1
25263,typologie,0,0,1,1
25267,годы,0,0,1,1
25269,തടയുന്നില്ല,0,0,1,1
25270,coordinación,0,0,1,1
25432,ಚಲನಚಿತ್ರಗಳನ್ನು,0,0,1,1
25433,abnormal,0,0,1,1
25434,surgiu,0,0,1,1
25592,ieder,0,0,1,1
25580,заказ,0,0,1,1
25582,nãowiki,0,0,1,1
25585,ಗಣಿತ,0,0,1,1
25586,ജോർജ്ജ്,0,0,1,1
25589,disruptively,0,0,1,1
25590,serbian,0,0,1,1
25591,неполными,0,0,1,1
25593,принципах,0,0,1,1
25549,puppets,0,0,1,1
25594,théoriques,0,0,1,1
25596,вызывают,0,0,1,1
25598,zugeben,0,0,1,1
25599,elegantes,0,0,1,1
25601,सके।,0,0,1,1
25602,deltar,0,0,1,1
25603,يشغل,0,0,1,1
25579,trompent,0,0,1,1
25576,reviewer,0,0,1,1
25575,behalve,0,0,1,1
25574,сообщества —,0,0,1,1
25552,wapsidor,0,0,1,1
25554,concierto,0,0,1,1
25556,അംഗീകരിക്കാൻ,0,0,1,1
25557,setze,0,0,1,1
25558,écosystémiques ,0,0,1,1
25560,നിർത്താൻ,0,0,1,1
25561,zil,0,0,1,1
25562,പറയുന്നതായും,0,0,1,1
25563,taïwan,0,0,1,1
25565,ಕಡೆಗೆ,0,0,1,1
25566,emblématique,0,0,1,1
25569,крутятся,0,0,1,1
25570,zevkti,0,0,1,1
25571,معنا,0,0,1,1
25572,δουλεύει,0,0,1,1
25604,darme,0,0,1,1
25605,motsvarigheter,0,0,1,1
25607,والآراء,0,0,1,1
25632,téléphonique,0,0,1,1
25636,സമയങ്ങളിൽ,0,0,1,1
25637,wikcionario,0,0,1,1
25638,denir,0,0,1,1
25639,oficiales,0,0,1,1
25640,didier,0,0,1,1
25642,prompted,0,0,1,1
25644,fazem,0,0,1,1
25645,இணையத்தொடர்பையும்,0,0,1,1
25646,desigualdades,0,0,1,1
25648,accessas,0,0,1,1
25654,പ്രത്യേകം,0,0,1,1
25655,تسأله,0,0,1,1
25657,поколение,0,0,1,1
25660,olmana,0,0,1,1
25661,alcanzase,0,0,1,1
25635,zangado,0,0,1,1
25631,tolka,0,0,1,1
25609,информацию,0,0,1,1
25630,ಮುಗಿಸಲಿ,0,0,1,1
25610,probablemente,0,0,1,1
25611,selectie,0,0,1,1
25612,bevæge,0,0,1,1
25614,سن,0,0,1,1
25615,revelam,0,0,1,1
25617,tomado,0,0,1,1
25618,சுவாரஸ்யமான,0,0,1,1
25620,doneerde,0,0,1,1
25621,overleden,0,0,1,1
25622,освещении,0,0,1,1
25623,sløv,0,0,1,1
25625,recettes,0,0,1,1
25626,يُنصح,0,0,1,1
25627,udbrød,0,0,1,1
25629,infiniment,0,0,1,1
25550,vía,0,0,1,1
25548,klottraren,0,0,1,1
25438,хороший,0,0,1,1
25478,والانتقادات,0,0,1,1
25464,какуюлибо,0,0,1,1
25465,manifestant,0,0,1,1
25466,يصفون,0,0,1,1
25467,ಪ್ರೀತಿಸುತ್ತೀರಿ,0,0,1,1
25471,skapades,0,0,1,1
25472,vandal,0,0,1,1
25475,étudiés,0,0,1,1
25482,emne,0,0,1,1
25547,γεύση,0,0,1,1
25483,tenías,0,0,1,1
25484,embotado,0,0,1,1
25488,итогов,0,0,1,1
25489,captar,0,0,1,1
25490,occur,0,0,1,1
25491,peinture,0,0,1,1
25492,benden,0,0,1,1
25462,புரிந்துகொண்டிருந்தால்,0,0,1,1
25461,للحديث,0,0,1,1
25460,editarlos,0,0,1,1
25459,trophic,0,0,1,1
25439,بمراجعة,0,0,1,1
25440,пойду,0,0,1,1
25441,لديهما,0,0,1,1
25443,competitor,0,0,1,1
25445,nose,0,0,1,1
25446,рейтинге,0,0,1,1
25448,soil,0,0,1,1
25449,κάθισε,0,0,1,1
25451,உட்பட்டுவரும்,0,0,1,1
25452,régionales,0,0,1,1
25453,isimde,0,0,1,1
25454,независимо,0,0,1,1
25456,πχ,0,0,1,1
25457,jurk,0,0,1,1
25458,slut,0,0,1,1
25493,கூறுகிறது,0,0,1,1
25494,gevoel,0,0,1,1
25495,apresentarei,0,0,1,1
25520,experiences,0,0,1,1
25522,factorization,0,0,1,1
25524,içeceği,0,0,1,1
25526,تشعر,0,0,1,1
25527,बाधित,0,0,1,1
25528,ಸಭ್ಯವಾಗಿರಲು,0,0,1,1
25531,buurt,0,0,1,1
25532,مزيف,0,0,1,1
25534,contribuciones,0,0,1,1
25536,விதிமுறைகள்,0,0,1,1
25537,flickvän,0,0,1,1
25538,വ്യത്യസ്തമാവും,0,0,1,1
25539,circuler,0,0,1,1
25542,ஒன்றும்,0,0,1,1
25545,thermohaline,0,0,1,1
25546,excluíu,0,0,1,1
25521,amuse,0,0,1,1
25519,tratamento,0,0,1,1
25496,ഓയെപ്പോലെയാണ്,0,0,1,1
25518,жаловаться,0,0,1,1
25498,—cuando,0,0,1,1
25499,ಮೃದುವಾದ,0,0,1,1
25500,συνηθισμένη,0,0,1,1
25504,ಸವಾರಿಯ,0,0,1,1
25505,centralizam,0,0,1,1
25507,വിറ്റതായി,0,0,1,1
25508,फेसबुक,0,0,1,1
25509,விட்டால்,0,0,1,1
25510,violant,0,0,1,1
25511,затраты,0,0,1,1
25512,أرسل,0,0,1,1
25513,αντίχειρες,0,0,1,1
25514,uitgebalanceerde,0,0,1,1
25516,speakers,0,0,1,1
25517,рой,0,0,1,1
26140,ändras,0,0,1,1
26143,ಮನುಷ್ಯನಿಗೆ,0,0,1,1
27086,терминами,0,0,1,1
26796,privacidad,0,0,1,1
26788,konuklar,0,0,1,1
26789,ursprungliga,0,0,1,1
26790,tagits,0,0,1,1
26792,എന്നതിനെക്കുറിച്ചും,0,0,1,1
26793,padronizado,0,0,1,1
26794,വിലയിരുത്തൽ,0,0,1,1
26795,filiations,0,0,1,1
26797,metne,0,0,1,1
26811,разрешающими,0,0,1,1
26798,اختصار,0,0,1,1
26799,preguiçosos,0,0,1,1
26800,frankrig,0,0,1,1
26801,كجزء,0,0,1,1
26804,lekkers,0,0,1,1
26805,ஆச்சரியப்பட்டாள்,0,0,1,1
26806,atingiu,0,0,1,1
26784,direta,0,0,1,1
26783,विकिपुस्तक,0,0,1,1
26782,उठाने,0,0,1,1
26779,अनुमति।,0,0,1,1
26753,artiklen,0,0,1,1
26755,достичь,0,0,1,1
26756,प्राप्ति,0,0,1,1
26758,கேட்கிறீர்கள்,0,0,1,1
26759,wiederholung,0,0,1,1
26764,വിടുകയാണെന്ന്,0,0,1,1
26765,ಉಲ್ಲೇಖಿಸಬೇಡಿ,0,0,1,1
26767,करमुक्त,0,0,1,1
26768,animistes,0,0,1,1
26769,ಹೆಸರನ್ನು,0,0,1,1
26771,μπριτάννικα,0,0,1,1
26773,kızmışım,0,0,1,1
26775,ädelstenar,0,0,1,1
26776,beeldmateriaal,0,0,1,1
26778,photography,0,0,1,1
26810,ನಿಷ್ಪ್ರಯೋಜಕವಾಗಿದ್ದರಿಂದ,0,0,1,1
26812,المقالة،,0,0,1,1
26870,अमेरिकन्स,0,0,1,1
26857,rechazada,0,0,1,1
26848,wiktionnaire,0,0,1,1
26850,équipés,0,0,1,1
26851,güzellerdi,0,0,1,1
26852,حار,0,0,1,1
26853,"നിഷ്പക്ഷത
ഉറപ്പാക്കുന്നു",0,0,1,1
26854,redigerade,0,0,1,1
26855,christianisme,0,0,1,1
26858,loosely,0,0,1,1
26814,английского,0,0,1,1
26859,infieren,0,0,1,1
26860,taraškievica,0,0,1,1
26861,noemde,0,0,1,1
26863,studerende,0,0,1,1
26864,sözcüğü,0,0,1,1
26865,ശരിയാണെന്ന്,0,0,1,1
26867,redigeringssammanfattningar,0,0,1,1
26846,flahault,0,0,1,1
26845,syftar,0,0,1,1
26844,eqiad,0,0,1,1
26843,alpha,0,0,1,1
26815,gösterilmez,0,0,1,1
26816,дискриминантный,0,0,1,1
26820,i»,0,0,1,1
26821,رئيس,0,0,1,1
26822,juridiquement,0,0,1,1
26823,spredt,0,0,1,1
26826,ಪ್ರಾರಂಭಿಸಲು,0,0,1,1
26827,hør,0,0,1,1
26829,தெரிந்த,0,0,1,1
26830,prego,0,0,1,1
26832,உலகம்,0,0,1,1
26833,συμπεριλαμβανομένης,0,0,1,1
26834,opdoen,0,0,1,1
26835,lenguajes,0,0,1,1
26840,gustado,0,0,1,1
26752,моменткогда,0,0,1,1
26751,വച്ച്,0,0,1,1
26750,പറ്റുന്നതിൽ,0,0,1,1
26675,ഉദാ‍ഹരണത്തിന്,0,0,1,1
26666,الطعن,0,0,1,1
26667,خطأ,0,0,1,1
26668,percatara,0,0,1,1
26669,escritor,0,0,1,1
26671,كلها,0,0,1,1
26672,अन्यभाषाओं,0,0,1,1
26673,gerçekleşir,0,0,1,1
26677,hire,0,0,1,1
26749,ಕರೆದೊಯ್ಯುತ್ತೇನೆ,0,0,1,1
26678,θετικό,0,0,1,1
26679,imprimée,0,0,1,1
26680,animées,0,0,1,1
26681,afstemninger,0,0,1,1
26682,hoch,0,0,1,1
26685,infallsvinklar,0,0,1,1
26686,nederlandse,0,0,1,1
26665,bilda,0,0,1,1
26660,पांच,0,0,1,1
26659,tommelfingre,0,0,1,1
26658,языках,0,0,1,1
26629,εκπληρώνουν,0,0,1,1
26632,рад,0,0,1,1
26633,prinsen,0,0,1,1
26634,فسوف,0,0,1,1
26640,எச்சரிப்பதற்காகவும்,0,0,1,1
26641,تعلمون,0,0,1,1
26644,കാണില്ലെന്ന്,0,0,1,1
26646,américaines,0,0,1,1
26648,belirtmek,0,0,1,1
26649,adequadas,0,0,1,1
26650,haberleri,0,0,1,1
26653,ranges,0,0,1,1
26654,"
hindi",0,0,1,1
26655,بتصميم,0,0,1,1
26657,والفيتنامية,0,0,1,1
26687,teneinde,0,0,1,1
26688,मानने,0,0,1,1
26692,atribuíram,0,0,1,1
26726,உணவகம்,0,0,1,1
26730,نشطة,0,0,1,1
26731,fahre,0,0,1,1
26732,fluidos,0,0,1,1
26733,கிகில்ஸ்,0,0,1,1
26734,ಸುಂದರವಾಗಿದ್ದರು,0,0,1,1
26735,ഡ്രൈവ്വേയിൽ,0,0,1,1
26736,പേരുകേട്ടതാണ്,0,0,1,1
26738,persist,0,0,1,1
26739,økonomien,0,0,1,1
26740,xixe,0,0,1,1
26741,tanımlamalardan,0,0,1,1
26744,комик,0,0,1,1
26745,tectoniques,0,0,1,1
26746,നിർവ്വചിക്കുന്നു,0,0,1,1
26747,பெற்றுள்ளேன்,0,0,1,1
26729,gefängnissen,0,0,1,1
26723,garantia,0,0,1,1
26693,luister,0,0,1,1
26722,httpwwwwikipediade,0,0,1,1
26694,sacolejou,0,0,1,1
26695,atravesó,0,0,1,1
26698,возражаешь,0,0,1,1
26699,salió,0,0,1,1
26701,fantastik,0,0,1,1
26702,hvert,0,0,1,1
26704,ഉയർത്തുകയും,0,0,1,1
26705,μίλησε,0,0,1,1
26711,формируемого,0,0,1,1
26712,विशेषाधिकार,0,0,1,1
26715,asturiëprijs,0,0,1,1
26716,microwave,0,0,1,1
26718,अन्तर्राष्ट्रीय,0,0,1,1
26720,souberem,0,0,1,1
26721,técnica,0,0,1,1
26869,மற்றவர்,0,0,1,1
26871,नशा,0,0,1,1
26145,അറിവുള്ള,0,0,1,1
27015,നൽകിയ,0,0,1,1
27004,yakalamadığını,0,0,1,1
27005,französische,0,0,1,1
27010,κοχύλι,0,0,1,1
27011,أفاد,0,0,1,1
27012,unhappy,0,0,1,1
27013,amène,0,0,1,1
27014,φέρεσαι,0,0,1,1
27016,​​உங்கள்,0,0,1,1
27030,नंबर्स,0,0,1,1
27017,flippede,0,0,1,1
27018,aniversário,0,0,1,1
27022,—no,0,0,1,1
27024,confined,0,0,1,1
27026,ലഭിച്ചത്,0,0,1,1
27027,вносимые,0,0,1,1
27028,şaşırdım,0,0,1,1
27002,overskuelighed,0,0,1,1
27000,«wiki,0,0,1,1
26999,ಮೂವರು,0,0,1,1
26998,волновалась,0,0,1,1
26981,إيجابيًا,0,0,1,1
26982,escargot,0,0,1,1
26983,വിക്കിസമൂഹമെന്നും,0,0,1,1
26984,ಬರಾಕ್,0,0,1,1
26985,പലതുള്ളി,0,0,1,1
26986,حديقتهم,0,0,1,1
26987,പേരും,0,0,1,1
26988,optimize,0,0,1,1
26989,escudo,0,0,1,1
26990,nãoespecialistas,0,0,1,1
26991,campos,0,0,1,1
26994,perspective,0,0,1,1
26995,அடைந்தது,0,0,1,1
26996,wochen,0,0,1,1
26997,ಕೋಪಗೊಂಡಿದೆ,0,0,1,1
27029,मुद्दे,0,0,1,1
27033,கட்டமைப்பும்,0,0,1,1
26873,mantuvo,0,0,1,1
27073,tagit,0,0,1,1
27064,مناسبًا,0,0,1,1
27065,एईजेसब्रांड,0,0,1,1
27066,promouvoir,0,0,1,1
27068,എന്തൊരു,0,0,1,1
27069,shut,0,0,1,1
27070,एली,0,0,1,1
27071,besorgen,0,0,1,1
27074,وجهت,0,0,1,1
27034,wikimedia ,0,0,1,1
27075,എല്ലാവർക്കും,0,0,1,1
27076,أقلل,0,0,1,1
27077,kökenleri,0,0,1,1
27078,yiyebileceğim,0,0,1,1
27079,بقي,0,0,1,1
27082,wikiexpertsus,0,0,1,1
27083,بل,0,0,1,1
27062,पोस्ट,0,0,1,1
27060,മാതൃ,0,0,1,1
27057,ursäkt,0,0,1,1
27056,नीतियां।,0,0,1,1
27035,حرفيًا,0,0,1,1
27036,proporcionarle,0,0,1,1
27037,gekauft,0,0,1,1
27039,värden,0,0,1,1
27041,haag,0,0,1,1
27042,பெறும்,0,0,1,1
27043,तीनों,0,0,1,1
27045,chegarem,0,0,1,1
27046,கலிஃபோர்னியாவில்,0,0,1,1
27047,पक्षपातहीन,0,0,1,1
27049,beschikken,0,0,1,1
27050,المحتمل,0,0,1,1
27051,പോകുകയാണെങ്കിൽ,0,0,1,1
27052,estimate,0,0,1,1
27053,floride,0,0,1,1
26980,skapar,0,0,1,1
26978,tillgängligt,0,0,1,1
26977,izlerken,0,0,1,1
26906,функция,0,0,1,1
26899,täckte,0,0,1,1
26900,"control ·
sustainability ·
പാഴ്വസ്തു",0,0,1,1
26901,erkennen,0,0,1,1
26902,miembro»,0,0,1,1
26903,nonsexual,0,0,1,1
26904,"
cazaque",0,0,1,1
26905,ebartikel,0,0,1,1
26908,führen,0,0,1,1
26976,участие,0,0,1,1
26910,uyurken,0,0,1,1
26911,befördert,0,0,1,1
26913,bètawetenschapper,0,0,1,1
26914,principios,0,0,1,1
26915,भयावह,0,0,1,1
26916,yapmasına,0,0,1,1
26918,yazının,0,0,1,1
26898,definitief,0,0,1,1
26897,ikisinin,0,0,1,1
26896,begrijpen,0,0,1,1
26895,estompe,0,0,1,1
26874,tirou,0,0,1,1
26875,लेखेजोखे,0,0,1,1
26876,വിശദീകരിക്കുക,0,0,1,1
26877,années »,0,0,1,1
26878,ನಡವಳಿಕೆ,0,0,1,1
26880,एटरीब्यूशनशेयर,0,0,1,1
26884,luck,0,0,1,1
26885,सोसाइटी,0,0,1,1
26886,оценкам,0,0,1,1
26887,enkäten,0,0,1,1
26888,ಫಿಕ್ಸ್‌ನಲ್ಲಿದ್ದೀರಿ,0,0,1,1
26889,pacific,0,0,1,1
26891,заставило,0,0,1,1
26893,låna,0,0,1,1
26894,technological,0,0,1,1
26919,കണ്ടുമുട്ടുന്നു,0,0,1,1
26920,मेनवल,0,0,1,1
26921,edip,0,0,1,1
26951,lanzamiento,0,0,1,1
26955,रखा।,0,0,1,1
26956,saxão,0,0,1,1
26957,أقسام,0,0,1,1
26958,"हैं।
",0,0,1,1
26960,ahogando,0,0,1,1
26961,hypertext,0,0,1,1
26962,edin,0,0,1,1
26963,leeftijd,0,0,1,1
26964,ലോകമെമ്പാടും,0,0,1,1
26965,oneens,0,0,1,1
26968,ഉപയോഗിച്ചിരുന്നു,0,0,1,1
26970,βρείτε,0,0,1,1
26971,ஆதாயம்,0,0,1,1
26973,الحادثة،,0,0,1,1
26974,gedag,0,0,1,1
26952,نقاش,0,0,1,1
26950,constantemente,0,0,1,1
26923,πόδια,0,0,1,1
26949,ചോദ്യങ്ങളിൽ,0,0,1,1
26925,मणिपुरी,0,0,1,1
26926,anlamadıysa,0,0,1,1
26929,‘கணினிச்,0,0,1,1
26931,ಯಶಸ್ವಿಯಾದರೆ,0,0,1,1
26932,விஷயங்களை,0,0,1,1
26934,islands,0,0,1,1
26936,köpcentret,0,0,1,1
26937,hadean,0,0,1,1
26938,prehistory,0,0,1,1
26939,flummoxte,0,0,1,1
26942,ആശയസംഘട്ടനങ്ങൾ,0,0,1,1
26944,പിന്നിലുണ്ടെങ്കിലേ,0,0,1,1
26945,देर,0,0,1,1
26946,tillåter,0,0,1,1
26947,ಗುದ್ದಾಟ,0,0,1,1
26627,சிமிட்டினர்,0,0,1,1
26625,அழுகிற,0,0,1,1
26624,convertir,0,0,1,1
26317,gezocht,0,0,1,1
26308,собираемся,0,0,1,1
26311,dividido,0,0,1,1
26312,افترض,0,0,1,1
26313,بدء,0,0,1,1
26314,handlade,0,0,1,1
26315,dagligdags,0,0,1,1
26316,существами,0,0,1,1
26318,ചെയ്യുന്നതിനെക്കുറിച്ച്,0,0,1,1
26329,руководством,0,0,1,1
26319,bouleverser,0,0,1,1
26320,ψεύτικο,0,0,1,1
26321,tvivel,0,0,1,1
26323,graphique,0,0,1,1
26324,salads,0,0,1,1
26325,leerproblemen,0,0,1,1
26327,അടിക്കുന്നു,0,0,1,1
26306,பன்மொழி,0,0,1,1
26305,diamants,0,0,1,1
26303,difundiendo,0,0,1,1
26302,प्रेक्षण,0,0,1,1
26275,téléphoniques,0,0,1,1
26276,reminds,0,0,1,1
26277,ഭാഷാപരമായ,0,0,1,1
26279,beperkte,0,0,1,1
26280,நகரும்,0,0,1,1
26281,صحتها،,0,0,1,1
26284,கொடுத்த,0,0,1,1
26285,جيدا,0,0,1,1
26288,mediantid,0,0,1,1
26290,കാഴ്ച്ചപ്പാട്,0,0,1,1
26291,yolculuğunuza,0,0,1,1
26293,gulfs,0,0,1,1
26297,طلبت,0,0,1,1
26298,ಅಷ್ಟೇನೂ,0,0,1,1
26301,feuchtgebiet,0,0,1,1
26328,ഇപയോഗിക്കുന്നത്,0,0,1,1
26330,نبرة,0,0,1,1
26619,ആകർഷകവും,0,0,1,1
26367,tillämpa,0,0,1,1
26357,έφερα,0,0,1,1
26359,tidskriftsartiklar,0,0,1,1
26360,disco,0,0,1,1
26361,aning,0,0,1,1
26363,ഉണ്ടാക്കുമെന്ന്,0,0,1,1
26364,delicados,0,0,1,1
26366,ധനികനും,0,0,1,1
26368,குழப்பமடைந்தால்,0,0,1,1
26331,glitrende,0,0,1,1
26371,करेंगी,0,0,1,1
26373,βαθιά,0,0,1,1
26374,بتشجيع,0,0,1,1
26375,engagement,0,0,1,1
26380,பாரம்பரியக்,0,0,1,1
26382,ro,0,0,1,1
26384,ثري,0,0,1,1
26356,énormes,0,0,1,1
26355,propostas,0,0,1,1
26354,sponges,0,0,1,1
26353,impresión,0,0,1,1
26332,beyazdır,0,0,1,1
26333,yeterlilik,0,0,1,1
26334,صراحة,0,0,1,1
26335,aiit’s,0,0,1,1
26337,aka,0,0,1,1
26339,ഗൂണാങ്കങ്ങളിൽ,0,0,1,1
26341,exponentially,0,0,1,1
26342,accepte,0,0,1,1
26344,"
अस्तूरियाई",0,0,1,1
26345,alojado,0,0,1,1
26346,παγκόσμια,0,0,1,1
26347,förutsättningar,0,0,1,1
26350,коммерческое,0,0,1,1
26351,ιανουάριο,0,0,1,1
26352,manglende,0,0,1,1
26274,convenues,0,0,1,1
26273,regimes,0,0,1,1
26272,utvecklingen,0,0,1,1
26189,olvida,0,0,1,1
26175,γλύφους,0,0,1,1
26176,написание,0,0,1,1
26177,böcker,0,0,1,1
26183,സത്യം,0,0,1,1
26184,നിയമിക്കുന്നത്,0,0,1,1
26186,proporción,0,0,1,1
26187,demás,0,0,1,1
26193,stopped,0,0,1,1
26271,погружение,0,0,1,1
26195,zamanım,0,0,1,1
26196,programında,0,0,1,1
26197,gratuitamente,0,0,1,1
26199,andas,0,0,1,1
26200,specialevenemang,0,0,1,1
26203,forked,0,0,1,1
26204,nauwelijks,0,0,1,1
26173,blik,0,0,1,1
26172,ridge,0,0,1,1
26169,medir,0,0,1,1
26168,மனச்சார்பு,0,0,1,1
26146,situé,0,0,1,1
26147,медлительный,0,0,1,1
26148,விதைகளை,0,0,1,1
26150,τραπεζιού,0,0,1,1
26152,കരച്ചിലും,0,0,1,1
26153,girdilerin,0,0,1,1
26154,سارت,0,0,1,1
26155,mandar,0,0,1,1
26157,смотрела,0,0,1,1
26158,مقابل,0,0,1,1
26160,garantir,0,0,1,1
26161,ಕಣ್ಣೀರಿಗೆ,0,0,1,1
26163,ووصلت,0,0,1,1
26166,മാച്ചു,0,0,1,1
26167,സംസാരിക്കാം,0,0,1,1
26205,blijken,0,0,1,1
26206,afi ˌwɪkiˈpiːdiə,0,0,1,1
26207,wishes,0,0,1,1
26238,зрения»,0,0,1,1
26241,البعض،,0,0,1,1
26242,ಮಾರ್ಗದಲ್ಲಿ,0,0,1,1
26245,berühmten,0,0,1,1
26247,immédiates,0,0,1,1
26249,δίνω,0,0,1,1
26250,धैर्य,0,0,1,1
26251,attacker,0,0,1,1
26259,boon,0,0,1,1
26263,قارات,0,0,1,1
26264,staarde,0,0,1,1
26265,لتحرير,0,0,1,1
26266,hormiga,0,0,1,1
26267,mecanismo,0,0,1,1
26268,extend,0,0,1,1
26269,extinción,0,0,1,1
26240,reliance,0,0,1,1
26236,متى,0,0,1,1
26209,intellectuelles,0,0,1,1
26235,യന്ത്രത്തെ,0,0,1,1
26210,ಸೂಕ್ತವಾಗಿದೆ,0,0,1,1
26211,belediging,0,0,1,1
26213,attribuent,0,0,1,1
26216,loudest,0,0,1,1
26218,visions,0,0,1,1
26219,vinkling,0,0,1,1
26220,наличием,0,0,1,1
26221,pensamentos,0,0,1,1
26223,telaffuzu,0,0,1,1
26224,राष्ट्रपति,0,0,1,1
26226,inräknade,0,0,1,1
26228,sætter,0,0,1,1
26230,regarda,0,0,1,1
26233,​​med,0,0,1,1
26234,வாருங்கள்,0,0,1,1
26385,skruvat,0,0,1,1
26386,ഓർമ്മിപ്പിക്കാൻ,0,0,1,1
26387,ओमेगाविकि,0,0,1,1
26549,нарциссизм,0,0,1,1
26535,« sociotechnique »,0,0,1,1
26538,ഞങ്ങളുമായി,0,0,1,1
26539,blunt,0,0,1,1
26543,stock,0,0,1,1
26544,n’oppose,0,0,1,1
26545,فهل,0,0,1,1
26547,câncer,0,0,1,1
26551,അങ്ങനെയായിരിക്കും,0,0,1,1
26502,rendueles,0,0,1,1
26553,presenterat,0,0,1,1
26554,suivante,0,0,1,1
26555,smagseksempel,0,0,1,1
26557,acusamna,0,0,1,1
26561,इलाज,0,0,1,1
26562,ημερομηνία,0,0,1,1
26564,brandt,0,0,1,1
26533,længe,0,0,1,1
26531,നടത്തുവാനും,0,0,1,1
26530,actualisée,0,0,1,1
26528,malheureusement,0,0,1,1
26504,സാക്ഷാത്കരിക്കപ്പെട്ടാൽ,0,0,1,1
26506,supervivencia,0,0,1,1
26507,ಪಕ್ಷಿಗಳಂತೆ,0,0,1,1
26508,المربى,0,0,1,1
26509,கொண்டிருந்தீர்கள்,0,0,1,1
26510,"
सार्डिनियाई",0,0,1,1
26511,ആശയക്കുഴപ്പമുണ്ടായാൽ,0,0,1,1
26513,வைத்திருப்பது,0,0,1,1
26516,opposé,0,0,1,1
26517,biélorusse,0,0,1,1
26518,prit,0,0,1,1
26519,ಎಲ್ಲವು,0,0,1,1
26520,clasificados,0,0,1,1
26522,அவதூறான,0,0,1,1
26523,conseguirás,0,0,1,1
26565,ஆச்சரியம்,0,0,1,1
26568,आत्महत्या,0,0,1,1
26569,¿pueden,0,0,1,1
26592,indivíduos,0,0,1,1
26597,placerade,0,0,1,1
26599,எங்கே,0,0,1,1
26600,чьих,0,0,1,1
26603,ubicación,0,0,1,1
26604,ऑफिस,0,0,1,1
26605,மாற்றமடையும்,0,0,1,1
26608,ಹಳೆಯ,0,0,1,1
26609,enlever,0,0,1,1
26610,brev,0,0,1,1
26611,yansımasına,0,0,1,1
26612,immense,0,0,1,1
26613,lance,0,0,1,1
26616,susningal,0,0,1,1
26617,popüler,0,0,1,1
26618,steam,0,0,1,1
26596,deceased,0,0,1,1
26591,सुसाइड,0,0,1,1
26570,softwareinterface,0,0,1,1
26590,friedman,0,0,1,1
26571,ದ,0,0,1,1
26572,synes,0,0,1,1
26573,oplossing,0,0,1,1
26574,الطاقة,0,0,1,1
26575,videoya,0,0,1,1
26576,തെറ്റിദ്ധരിച്ചതായി,0,0,1,1
26577,incompatíveis,0,0,1,1
26579,ordered,0,0,1,1
26580,ydmyg,0,0,1,1
26582,க்குச்,0,0,1,1
26583,visités,0,0,1,1
26585,பள்ளியில்,0,0,1,1
26587,execute,0,0,1,1
26588,बोक्माल,0,0,1,1
26589,விக்கிப்பீடியாவினது,0,0,1,1
26503,ವಾರಾಂತ್ಯದ,0,0,1,1
26500,licenseനാൽ,0,0,1,1
26388,हल्का,0,0,1,1
26428,hangi,0,0,1,1
26417,കാഴ്ചപ്പാടുകളെ,0,0,1,1
26420,chiffre,0,0,1,1
26421,hervatten,0,0,1,1
26422,βοηθήσει,0,0,1,1
26424,statement,0,0,1,1
26426,٬٬,0,0,1,1
26427,aseguraría,0,0,1,1
26429,απολυτο,0,0,1,1
26496,δολάρια,0,0,1,1
26430,entraram,0,0,1,1
26431,δροσερό,0,0,1,1
26434,التوالي،,0,0,1,1
26435,wikimediaprojekten,0,0,1,1
26436,isteğinde,0,0,1,1
26437,hataları,0,0,1,1
26439,globalmente,0,0,1,1
26416,உபயோகிக்கப்படுகின்றது,0,0,1,1
26415,предотвращения,0,0,1,1
26414,البيانات،,0,0,1,1
26413,godzijdank,0,0,1,1
26391,perfil,0,0,1,1
26393,vienne,0,0,1,1
26395,ಟೆಲಿಗ್ರಾಮ್,0,0,1,1
26396,décrivant,0,0,1,1
26397,stagne,0,0,1,1
26401,ತೆಗೆದುಕೊಳ್ಳಬೇಕೆಂದು,0,0,1,1
26402,ευγενικός,0,0,1,1
26403,ಕೇಳುವುದು,0,0,1,1
26404,പുഞ്ചിരി,0,0,1,1
26405,rankad,0,0,1,1
26406,tíbet,0,0,1,1
26407,dışarıdayken,0,0,1,1
26408,"
estoniano",0,0,1,1
26411,sayfasını,0,0,1,1
26412,carona,0,0,1,1
26441,doulhe,0,0,1,1
26442,glæde,0,0,1,1
26444,ഗുണമേന്മയ്ക്കു,0,0,1,1
26471,திகைத்துப்,0,0,1,1
26473,бейзингстоке,0,0,1,1
26474,संदर्भित,0,0,1,1
26476,लगेगा,0,0,1,1
26477,காப்புரிமை,0,0,1,1
26479,conventionally,0,0,1,1
26480,ônibus,0,0,1,1
26484,amazed,0,0,1,1
26485,يجادل,0,0,1,1
26486,alimentado,0,0,1,1
26487,சொல்லவும்,0,0,1,1
26490,എല്ലായ്‌പ്പോഴും,0,0,1,1
26491,exhaustivo,0,0,1,1
26492,quitaría,0,0,1,1
26494,പ്രവർത്തനങ്ങളിലൂടെ,0,0,1,1
26495,दोहराएंगे,0,0,1,1
26472,ഗുണാങ്കങ്ങൾ,0,0,1,1
26470,воспроизведение,0,0,1,1
26445,kleidungssinn,0,0,1,1
26469,vues,0,0,1,1
26447,embarcar,0,0,1,1
26448,цитируются,0,0,1,1
26450,तुम।,0,0,1,1
26451,വരുത്തുവാൻ,0,0,1,1
26453,corporativas,0,0,1,1
26454,ladda,0,0,1,1
26457,tummarna,0,0,1,1
26458,sohbette,0,0,1,1
26460,ക്ഷമയോടെ,0,0,1,1
26461,abendessen,0,0,1,1
26463,tillhandahålls,0,0,1,1
26464,फरवरी,0,0,1,1
26466,plantera,0,0,1,1
26467,سيطرة,0,0,1,1
26468,kinesisk,0,0,1,1
29038,العادات,0,0,1,1
29043,connotations,0,0,1,1
25176,पठन,0,0,1,1
31659,ടെസ്റ്റു,0,0,1,1
31647,vagn,0,0,1,1
31650,തണുപ്പാണ്,0,0,1,1
31653,ചെയ്യുകയായിരുന്നു,0,0,1,1
31654,plagiat,0,0,1,1
31655,trading,0,0,1,1
31656,tradução,0,0,1,1
31657,ergebnis,0,0,1,1
31661,നേതാക്കന്മാരുടെ,0,0,1,1
31673,إنسايدر,0,0,1,1
31662,δρόμο,0,0,1,1
31664,revolución,0,0,1,1
31665,онлайнсотрудничества,0,0,1,1
31666,tête,0,0,1,1
31667,udvalgt,0,0,1,1
31669,பேசலாம்,0,0,1,1
31670,количества,0,0,1,1
31646,« aujourd,0,0,1,1
31645,initialement,0,0,1,1
31643,нобелевский,0,0,1,1
31641,كمقالات,0,0,1,1
31619,evlenme,0,0,1,1
31620,προχωρήσεις,0,0,1,1
31621,intimidating,0,0,1,1
31622,reescrevem,0,0,1,1
31624,سر,0,0,1,1
31626,നിർമാതാവും,0,0,1,1
31628,அமைந்துள்ளது,0,0,1,1
31629,ഭൗതികപ്രതിഭാസങ്ങളും,0,0,1,1
31630,guldbröd,0,0,1,1
31631,unrelated,0,0,1,1
31632,kvantitativ,0,0,1,1
31635,voeten,0,0,1,1
31636,commenting,0,0,1,1
31639,undersøgelse,0,0,1,1
31640,منخفضة,0,0,1,1
31671,clef,0,0,1,1
31674,areas—automatic,0,0,1,1
31731,ഞങ്ങളോട്,0,0,1,1
31715,ಸೈನ್ಯದ,0,0,1,1
31703,filtrering,0,0,1,1
31704,مراجعات,0,0,1,1
31707,ಕಲಿಯಿರಿ,0,0,1,1
31708,costumamos,0,0,1,1
31709,extracellular,0,0,1,1
31713,entschuldige,0,0,1,1
31714,confondre,0,0,1,1
31717,ύπνο,0,0,1,1
31675,юнлэ,0,0,1,1
31718,contrariée,0,0,1,1
31719,വേണ്ടത്,0,0,1,1
31720,الخادمات,0,0,1,1
31722,اليابانية،,0,0,1,1
31724,mãos,0,0,1,1
31725,നടത്തുന്നത്,0,0,1,1
31728,എങ്ങനെയുണ്ട്,0,0,1,1
31702,reflejarse,0,0,1,1
31701,φροντίζετε,0,0,1,1
31700,habillé,0,0,1,1
31699,தனித்து,0,0,1,1
31676,baseadas,0,0,1,1
31677,φτιαγμένες,0,0,1,1
31680,होमवर्क,0,0,1,1
31681,ίση,0,0,1,1
31684,clarified,0,0,1,1
31685,viola,0,0,1,1
31686,spelen,0,0,1,1
31687,требованиям,0,0,1,1
31688,zweimal,0,0,1,1
31689,responsibility”,0,0,1,1
31692,manifestes,0,0,1,1
31693,ستريت,0,0,1,1
31694,ponctuellement,0,0,1,1
31696,தவறாக,0,0,1,1
31698,зеландии,0,0,1,1
31618,maind,0,0,1,1
31617,großartig,0,0,1,1
31612,الخاطئة,0,0,1,1
31539,любую,0,0,1,1
31527,underartiklar,0,0,1,1
31530,opensourcesoftware,0,0,1,1
31531,crossvalidation,0,0,1,1
31532,december update,0,0,1,1
31533,الحال؟,0,0,1,1
31536,​​enkele,0,0,1,1
31537,وتلحن,0,0,1,1
31540,lagra,0,0,1,1
31611,tips,0,0,1,1
31541,aprobado,0,0,1,1
31542,zinken,0,0,1,1
31546,matéria,0,0,1,1
31547,ειδήσεων,0,0,1,1
31548,title,0,0,1,1
31549,ഉപയോഗത്തിനും,0,0,1,1
31553,worstelde,0,0,1,1
31526,pesadamente,0,0,1,1
31525,സന്തോഷമായിരിക്കാനും,0,0,1,1
31524,märkbart,0,0,1,1
31523,vast,0,0,1,1
31497,أخطط,0,0,1,1
31500,μεταφορά,0,0,1,1
31501,görüşler,0,0,1,1
31502,simulationbased,0,0,1,1
31503,ريفيو,0,0,1,1
31507,ಚತುರನಾಗಿರುತ್ತೇನೆ,0,0,1,1
31509,behulp,0,0,1,1
31510,വിക്കിസമൂഹത്തിന്റെ,0,0,1,1
31511,séparation,0,0,1,1
31512,نسخة,0,0,1,1
31514,डाला,0,0,1,1
31516,होना।,0,0,1,1
31518,சிரிக்கத்,0,0,1,1
31520,yapmamız,0,0,1,1
31521,educacional,0,0,1,1
31554,сидишь,0,0,1,1
31555,compliquée,0,0,1,1
31558,அதைக்,0,0,1,1
31588,распространение,0,0,1,1
31590,ಇಂಗ್ಲಿಷ್‌ನಲ್ಲಿ,0,0,1,1
31591,échappent,0,0,1,1
31592,deyim,0,0,1,1
31594,"
सैटरलैण्ड",0,0,1,1
31595,являющейся,0,0,1,1
31597,recovery,0,0,1,1
31598,visiblement,0,0,1,1
31599,partisanes »,0,0,1,1
31600,المجهولين،,0,0,1,1
31601,kenne,0,0,1,1
31603,«циркуляре,0,0,1,1
31604,reputadas,0,0,1,1
31606,ancestry,0,0,1,1
31608,знания,0,0,1,1
31609,والجدال,0,0,1,1
31589,jackson,0,0,1,1
31587,llamadas,0,0,1,1
31559,gülümseyerek,0,0,1,1
31584,singapur,0,0,1,1
31562,മൂല്യം,0,0,1,1
31563,கொண்டிருப்பதுடன்,0,0,1,1
31564,clou,0,0,1,1
31565,ഒഴിവാക്കുന്നു,0,0,1,1
31566,حسناً,0,0,1,1
31567,والاستفادة,0,0,1,1
31568,alcanzaba,0,0,1,1
31569,kanunlarına,0,0,1,1
31570,செல்வேன்,0,0,1,1
31574,fr •,0,0,1,1
31575,sætningsnummer,0,0,1,1
31576,жёстки,0,0,1,1
31578,डेनियल,0,0,1,1
31579,förstöra,0,0,1,1
31582,combinatoire,0,0,1,1
31729,തണുത്തത്,0,0,1,1
31733,ಸಂಭವಿಸಿದ,0,0,1,1
31965,fusão,0,0,1,1
31887,lösenord,0,0,1,1
31877,producerar,0,0,1,1
31878,söyledim,0,0,1,1
31880,முடிந்துவிடும்,0,0,1,1
31882,bidrage,0,0,1,1
31884,anonymes,0,0,1,1
31885,утонченным,0,0,1,1
31886,—al,0,0,1,1
31889,الانهيار,0,0,1,1
31904,inconsistência,0,0,1,1
31890,leraar,0,0,1,1
31891,sucesivos,0,0,1,1
31892,эксперименты,0,0,1,1
31896,ನಿದ್ರೆಯಲ್ಲಿ,0,0,1,1
31897,civiques,0,0,1,1
31898,കാണിക്കാൻ,0,0,1,1
31901,australie,0,0,1,1
31875,coin,0,0,1,1
31874,विवादों,0,0,1,1
31872,lægger,0,0,1,1
31870,fotnoter,0,0,1,1
31849,situada,0,0,1,1
31850,آرثر,0,0,1,1
31851,samarbetsprojekt,0,0,1,1
31852,ergs,0,0,1,1
31853,χαμογελούν,0,0,1,1
31855,ആവാറുണ്ട്,0,0,1,1
31856,विफलताओं,0,0,1,1
31857,interrogação,0,0,1,1
31859,colores,0,0,1,1
31860,проведено,0,0,1,1
31862,αξιόπιστης,0,0,1,1
31863,preferring,0,0,1,1
31865,hypothétique,0,0,1,1
31866,тематическому,0,0,1,1
31869,tekrarı,0,0,1,1
31903,उपस्थिति,0,0,1,1
31906,hoşçakal,0,0,1,1
31734,لتتعلم,0,0,1,1
31951,kapatılmasını,0,0,1,1
31939,மற்றவர்களிடம்,0,0,1,1
31940,цифрах,0,0,1,1
31941,dagblad,0,0,1,1
31942,bursts,0,0,1,1
31945,verlaat,0,0,1,1
31948,بعدي,0,0,1,1
31949,ಫ್ಲಮ್ಮೋಕ್ಸ್ಡ್,0,0,1,1
31952,நடந்துகொண்டது,0,0,1,1
31907,தாயைப்,0,0,1,1
31955,നടുവിലാണ്,0,0,1,1
31956,« sibérien »,0,0,1,1
31957,خورازميات,0,0,1,1
31959,ಕಳೆದುಕೊಂಡಿದ್ದೇನೆ,0,0,1,1
31960,inversement,0,0,1,1
31961,διαφορετικές,0,0,1,1
31963,végétal,0,0,1,1
31936,termes,0,0,1,1
31933,crust,0,0,1,1
31931,ووالدتها,0,0,1,1
31929,continuam,0,0,1,1
31910,путешествие,0,0,1,1
31911,الأولى،,0,0,1,1
31912,descrevendo,0,0,1,1
31913,ಇತರರಿಗೆ,0,0,1,1
31915,sousbranches ,0,0,1,1
31916,allmänhetens,0,0,1,1
31918,estornudó,0,0,1,1
31920,dame,0,0,1,1
31921,كونغرس,0,0,1,1
31922,klarer,0,0,1,1
31923,amoreel,0,0,1,1
31924,ಕೇಳಿದ್ದೇವೆ,0,0,1,1
31926,zorunluğu,0,0,1,1
31927,blur,0,0,1,1
31928,deshecho,0,0,1,1
31848,αναφέρετε,0,0,1,1
31847,durabilité,0,0,1,1
31845,greed,0,0,1,1
31776,hydrology,0,0,1,1
31763,protegida,0,0,1,1
31765,amar,0,0,1,1
31766,ടോഫൽ,0,0,1,1
31767,للتخلص,0,0,1,1
31769,diyorum,0,0,1,1
31770,boş,0,0,1,1
31773,learnt,0,0,1,1
31777,syllabi,0,0,1,1
31844,désormais,0,0,1,1
31778,coordenados,0,0,1,1
31779,synke,0,0,1,1
31780,ignoreallrules,0,0,1,1
31781,χρειάζεστε,0,0,1,1
31782,reverrais,0,0,1,1
31784,congress—the,0,0,1,1
31785,dérive,0,0,1,1
31761,reclama,0,0,1,1
31759,ecologically,0,0,1,1
31758,merit,0,0,1,1
31757,буквально,0,0,1,1
31735,العلوم,0,0,1,1
31737,تسمية,0,0,1,1
31738,ramené,0,0,1,1
31739,sahibi,0,0,1,1
31740,त्रुटियों,0,0,1,1
31742,esbozo,0,0,1,1
31743,vardag,0,0,1,1
31745,уме,0,0,1,1
31746,संपर्क,0,0,1,1
31747,proactifs,0,0,1,1
31749,contestarte,0,0,1,1
31750,عمومًا،,0,0,1,1
31753,ಹೆಣಗಾಡುತ್ತಿದ್ದ,0,0,1,1
31754,указывают,0,0,1,1
31756,قبول,0,0,1,1
31786,федеральный,0,0,1,1
31788,grafia,0,0,1,1
31790,aussi ,0,0,1,1
31811,sözlerim,0,0,1,1
31814,«астероид,0,0,1,1
31820,பாடல்களில்,0,0,1,1
31822,новой,0,0,1,1
31824,empirique,0,0,1,1
31828,என்சைக்ளோபீடியாவிலிருந்து,0,0,1,1
31832,വരെ,0,0,1,1
31834,സഹിക്കൂ,0,0,1,1
31835,wijzigingen,0,0,1,1
31836,modtog,0,0,1,1
31837,ಎಸ್‌ಎಂಎಸ್,0,0,1,1
31838,ನೋಡಿದಾಗ,0,0,1,1
31840,تفكر,0,0,1,1
31841,सम्नाक्ष,0,0,1,1
31842,ax,0,0,1,1
31843,catholiques,0,0,1,1
31813,استفهام,0,0,1,1
31810,diacrítico,0,0,1,1
31791,consacrés,0,0,1,1
31809,wijzigen,0,0,1,1
31792,marrons,0,0,1,1
31793,ஏற்றுக்கொள்ள,0,0,1,1
31794,ನಾರ್ಸಿಸಿಯ,0,0,1,1
31795,uintelligent,0,0,1,1
31796,te •,0,0,1,1
31797,சொல்கிறாரோ,0,0,1,1
31798,periods,0,0,1,1
31799,—libro,0,0,1,1
31800,الغسيل,0,0,1,1
31802,nagel,0,0,1,1
31803,assassination,0,0,1,1
31804,ലഭിക്കില്ല,0,0,1,1
31805,nooit,0,0,1,1
31806,ലേർണിങ്machine,0,0,1,1
31808,أمس,0,0,1,1
31496,begik,0,0,1,1
31495,репутацией,0,0,1,1
31493,പശ്ചാത്തലത്തിൽ,0,0,1,1
31174,удивит,0,0,1,1
31166,åbent,0,0,1,1
31167,بقراءة,0,0,1,1
31168,afterward,0,0,1,1
31169,taxonomía,0,0,1,1
31170,parciales,0,0,1,1
31171,kandidatexamen,0,0,1,1
31172,encyclopedia،,0,0,1,1
31176,rein,0,0,1,1
31193,перебил,0,0,1,1
31181,написанный,0,0,1,1
31182,conventional,0,0,1,1
31184,тонет,0,0,1,1
31186,സമ്പൂർണവുമായ,0,0,1,1
31187,escuches,0,0,1,1
31189,मैरियन,0,0,1,1
31190,расширений,0,0,1,1
31164,λειτουργίας,0,0,1,1
31163,croyances,0,0,1,1
31162,ஒன்றாகும்,0,0,1,1
31161,ropa,0,0,1,1
31136,എഴുതിവെക്കുന്നതും,0,0,1,1
31137,kalmeer,0,0,1,1
31138,personally,0,0,1,1
31139,تقطع,0,0,1,1
31140,woordenboek,0,0,1,1
31145,изменяющими,0,0,1,1
31146,definição,0,0,1,1
31148,ചോദ്യങ്ങൾക്ക്,0,0,1,1
31150,പഠിക്കും,0,0,1,1
31152,erinnern,0,0,1,1
31156,geléias,0,0,1,1
31157,αδύνατη,0,0,1,1
31158,reden,0,0,1,1
31159,téléchargéesae,0,0,1,1
31160,üstteki,0,0,1,1
31191,допустил,0,0,1,1
31194,lades,0,0,1,1
31492,récuse,0,0,1,1
31232,ആഗ്രഹിക്കുന്ന,0,0,1,1
31223,ശരിയായി,0,0,1,1
31225,reconheceu,0,0,1,1
31226,война,0,0,1,1
31227,donzelas,0,0,1,1
31229,extensive,0,0,1,1
31230,resorted,0,0,1,1
31231,förutsättning,0,0,1,1
31233,reinforcing,0,0,1,1
31195,relacionadas,0,0,1,1
31235,أهلاً,0,0,1,1
31236,بثبات,0,0,1,1
31238,documentação,0,0,1,1
31239,réparations,0,0,1,1
31240,விக்கிபீடியாவின்,0,0,1,1
31242,وإزالة,0,0,1,1
31243,ομπάμα,0,0,1,1
31222,attributable,0,0,1,1
31221,clearance,0,0,1,1
31218,respectiva,0,0,1,1
31217,introduit,0,0,1,1
31197,étroites,0,0,1,1
31198,—o,0,0,1,1
31199,skrevet,0,0,1,1
31200,teveel,0,0,1,1
31202,υποστηρίζεται,0,0,1,1
31203,മഹാരാഷ്ട്രയും,0,0,1,1
31204,contribuant,0,0,1,1
31206,ridande,0,0,1,1
31207,друзьям,0,0,1,1
31209,некоего,0,0,1,1
31212,överanvändt,0,0,1,1
31213,establishes,0,0,1,1
31214,கிளாசிக்கல்,0,0,1,1
31215,διάφορα,0,0,1,1
31216,respectent,0,0,1,1
31134,hüzünlü,0,0,1,1
31133,கொண்டிருந்தது,0,0,1,1
31130,"
luxemburguês",0,0,1,1
31044,tt •,0,0,1,1
31034,нравятся,0,0,1,1
31035,väljs,0,0,1,1
31037,restriktioner,0,0,1,1
31039,naturligtvis,0,0,1,1
31040,നടക്കുന്നത്,0,0,1,1
31042,солдатам,0,0,1,1
31043,жила,0,0,1,1
31045,apestosa,0,0,1,1
31129,rectitud,0,0,1,1
31046,dagelijkse,0,0,1,1
31050,gini,0,0,1,1
31051,किसने,0,0,1,1
31052,sire,0,0,1,1
31054,ഗുണമേന്മയുള്ള,0,0,1,1
31055,évolué,0,0,1,1
31056,цитируемых,0,0,1,1
31032,escándalos,0,0,1,1
31031,dévie,0,0,1,1
31030,seite,0,0,1,1
31028,«βικιπαίδεια»,0,0,1,1
31005,møder,0,0,1,1
31006,физикохимических,0,0,1,1
31008,agradecerles,0,0,1,1
31009,privilege,0,0,1,1
31011,utilization,0,0,1,1
31013,«читать,0,0,1,1
31015,нужным,0,0,1,1
31016,فهم,0,0,1,1
31017,parlak,0,0,1,1
31018,стороны —,0,0,1,1
31021,നിന്നുള്ള,0,0,1,1
31022,kurallar,0,0,1,1
31023,ildelugtende,0,0,1,1
31025,ಬಿರುಗಾಳಿಯ,0,0,1,1
31027,califórnia,0,0,1,1
31057,возможную,0,0,1,1
31060,மணி,0,0,1,1
31061,أحدًا,0,0,1,1
31089,survive,0,0,1,1
31092,لمعلومات,0,0,1,1
31093,conservées,0,0,1,1
31094,cassés,0,0,1,1
31103,yı,0,0,1,1
31104,നയിക്കും,0,0,1,1
31106,εύκολα,0,0,1,1
31108,"
साधारण",0,0,1,1
31110,നായ,0,0,1,1
31112,склонны,0,0,1,1
31113,exposition,0,0,1,1
31114,ಹೆಂಗಸರ,0,0,1,1
31116,poca,0,0,1,1
31123,upptäcka,0,0,1,1
31125,limitada,0,0,1,1
31128,μεγαλύτερη,0,0,1,1
31090,прощание,0,0,1,1
31088,ögonblicket,0,0,1,1
31063,вернуться,0,0,1,1
31085,இக்கட்டுரைகளில்,0,0,1,1
31065,applying,0,0,1,1
31068,textual,0,0,1,1
31069,trataron,0,0,1,1
31070,എവിടെയായിരുന്നു,0,0,1,1
31071,skiljer,0,0,1,1
31072,japanse,0,0,1,1
31073,forgets,0,0,1,1
31074,سرا,0,0,1,1
31075,"
चैचन",0,0,1,1
31076,അദ്ദേഹത്തിന്റെ,0,0,1,1
31077,prohibieron,0,0,1,1
31079,फ्रेंको,0,0,1,1
31081,oil,0,0,1,1
31083,tecavüz,0,0,1,1
31084,comprenez,0,0,1,1
31244,"
कज़ाख़",0,0,1,1
31245,ಕಾಣುತ್ತಿದ್ದರು,0,0,1,1
31246,طفلي,0,0,1,1
31411,لزيارة,0,0,1,1
31399,professors,0,0,1,1
31400,domme,0,0,1,1
31403,perú,0,0,1,1
31404,imkansız,0,0,1,1
31408,व्याकरण,0,0,1,1
31409,mobilisent,0,0,1,1
31410,نستخدم,0,0,1,1
31413,sürümleri,0,0,1,1
31369,மென்பொருளில்,0,0,1,1
31416,debía,0,0,1,1
31419,தாழ்மையானவர்,0,0,1,1
31420,necessary,0,0,1,1
31422,данной,0,0,1,1
31425,سأستخدمه,0,0,1,1
31427,realworld,0,0,1,1
31428,iii»,0,0,1,1
31397,resúmenes,0,0,1,1
31396,recusado,0,0,1,1
31394,verzoeken,0,0,1,1
31393,புத்தகமாகத்,0,0,1,1
31372,bureaucratic,0,0,1,1
31374,مقترحين,0,0,1,1
31375,സങ്കേതത്തിൽ,0,0,1,1
31376,புகழ்பெற்றதுமாகும்,0,0,1,1
31377,opportunités,0,0,1,1
31382,fünf,0,0,1,1
31383,समानता,0,0,1,1
31384,baktığında,0,0,1,1
31385,سريعة,0,0,1,1
31386,design,0,0,1,1
31387,जड़ें,0,0,1,1
31388,сервере,0,0,1,1
31389,कानूनों,0,0,1,1
31390,vänta,0,0,1,1
31391,юнеско,0,0,1,1
31429,stinkt,0,0,1,1
31430,марта,0,0,1,1
31433,mijlpaal,0,0,1,1
31463,decisionmaking,0,0,1,1
31465,sitej,0,0,1,1
31470,slaap,0,0,1,1
31471,تصنيفها،,0,0,1,1
31473,स्कॉलरपीडिया,0,0,1,1
31474,وتعتمد,0,0,1,1
31475,ситуации,0,0,1,1
31478,കൊണ്ടിരുന്ന,0,0,1,1
31479,διακόπτει,0,0,1,1
31481,अति,0,0,1,1
31482,trouverez,0,0,1,1
31484,كوم,0,0,1,1
31485,സംരക്ഷിക്കാൻ,0,0,1,1
31487,lagts,0,0,1,1
31489,infinito,0,0,1,1
31490,en •,0,0,1,1
31464,большому,0,0,1,1
31462,redistributions,0,0,1,1
31436,കണക്കാക്കുന്നത്,0,0,1,1
31460,boende,0,0,1,1
31441,chinois ,0,0,1,1
31442,கேள்வி,0,0,1,1
31445,வேலையுடன்,0,0,1,1
31446,tons,0,0,1,1
31447,nynorsk,0,0,1,1
31448,mènent,0,0,1,1
31449,kanada,0,0,1,1
31451,anteriores,0,0,1,1
31452,സ്വപ്നമായിരുന്നു,0,0,1,1
31454,وذهب,0,0,1,1
31455,ñiquipedia,0,0,1,1
31456,alweer,0,0,1,1
31457,garoto,0,0,1,1
31458,spectre,0,0,1,1
31459,процесс,0,0,1,1
31371,وتحمل,0,0,1,1
31368,правильной,0,0,1,1
31247,anställa,0,0,1,1
31288,spills,0,0,1,1
31280,मनोरंजक,0,0,1,1
31281,பதவி,0,0,1,1
31282,ബന്ധിപ്പിക്കുന്നു,0,0,1,1
31283,tocante,0,0,1,1
31284,parlamentar,0,0,1,1
31286,भरा,0,0,1,1
31287,viam,0,0,1,1
31289,¿tienes,0,0,1,1
31367,japonés,0,0,1,1
31292,adressée,0,0,1,1
31293,rir,0,0,1,1
31294,sümüklüböcek,0,0,1,1
31296,அருமையாக,0,0,1,1
31297,ملاك,0,0,1,1
31298,horrific,0,0,1,1
31300,ಪ್ರವಾಸಿಗನು,0,0,1,1
31277,وإيلي,0,0,1,1
31276,النوع,0,0,1,1
31275,جنو,0,0,1,1
31274,humorista,0,0,1,1
31248,instantanément,0,0,1,1
31251,நடவடிக்கையின்,0,0,1,1
31253,ændrede,0,0,1,1
31254,ಎರಡನೆಯ,0,0,1,1
31255,riktiga,0,0,1,1
31256,ensinadas,0,0,1,1
31257,exhibit,0,0,1,1
31260,والوسائط,0,0,1,1
31261,анонсирована,0,0,1,1
31263,olduğun,0,0,1,1
31265,proje,0,0,1,1
31268,tiempo—,0,0,1,1
31269,friare,0,0,1,1
31271,souhaitez,0,0,1,1
31272,ಟ್ರಿಕಿ,0,0,1,1
31301,صموئيل،,0,0,1,1
31302,schmecken,0,0,1,1
31304,सुनते,0,0,1,1
31340,épurée,0,0,1,1
31343,ediyorsun,0,0,1,1
31345,netter,0,0,1,1
31346,आँसुओं,0,0,1,1
31347,كاليفورنيا,0,0,1,1
31349,revertidas,0,0,1,1
31351,respondem,0,0,1,1
31352,monobook,0,0,1,1
31353,छह,0,0,1,1
31354,udc,0,0,1,1
31355,आधुनिक,0,0,1,1
31356,ondervertegenwoordigd,0,0,1,1
31357,contracción,0,0,1,1
31360,കൊട്ടാരത്തിൽ,0,0,1,1
31362,स्वाहा,0,0,1,1
31365,pasan,0,0,1,1
31341,kindle,0,0,1,1
31339,alleviate,0,0,1,1
31305,предположим,0,0,1,1
31338,عاشت,0,0,1,1
31308,μάθουμε,0,0,1,1
31310,happened,0,0,1,1
31311,നേരിട്ട്,0,0,1,1
31313,décourager,0,0,1,1
31314,talihlerin,0,0,1,1
31315,телефон,0,0,1,1
31316,எதிர்,0,0,1,1
31320,mailinglist,0,0,1,1
31323,مستويين,0,0,1,1
31324,находитесь,0,0,1,1
31325,ஐபி,0,0,1,1
31326,версию,0,0,1,1
31329,threefold,0,0,1,1
31331,responding,0,0,1,1
31333,franska,0,0,1,1
31964,അല്ലയോ,0,0,1,1
31966,ಅಸಾಧಾರಣವಾದ,0,0,1,1
31002,еженедельник,0,0,1,1
32631,needing,0,0,1,1
32624,groupes,0,0,1,1
32625,текста,0,0,1,1
32626,चयनित,0,0,1,1
32627,ഇസ്രായേൽപാലസ്തീൻ,0,0,1,1
32628,independientes,0,0,1,1
32629,vraagteken,0,0,1,1
32630,städer,0,0,1,1
32635,escasa,0,0,1,1
32648,vivante,0,0,1,1
32636,dominique,0,0,1,1
32637,dropped,0,0,1,1
32638,goostman,0,0,1,1
32639,gränssnitt,0,0,1,1
32642,franskt,0,0,1,1
32643,compenser »,0,0,1,1
32644,challenge,0,0,1,1
32623,bristerna,0,0,1,1
32622,بالنقر,0,0,1,1
32621,للعربية,0,0,1,1
32619,finlandés,0,0,1,1
32596,rechtsboven,0,0,1,1
32597,testament,0,0,1,1
32599,hösten,0,0,1,1
32600,panela,0,0,1,1
32601,टेम्पलेट्स,0,0,1,1
32602,forskningsgrene,0,0,1,1
32607,ஆய்வொன்று,0,0,1,1
32608,helped,0,0,1,1
32609,energetic,0,0,1,1
32610,കൊണ്ട്,0,0,1,1
32613,اصطناعي,0,0,1,1
32615,selfsustaining,0,0,1,1
32616,ಅರ್ಥಗಳ,0,0,1,1
32617,divisão,0,0,1,1
32618,renewable,0,0,1,1
32645,suavizando,0,0,1,1
32650,ഗ്രന്ഥങ്ങളെയും,0,0,1,1
32706,iyiydim,0,0,1,1
32693,λατινική,0,0,1,1
32680,отправиться,0,0,1,1
32681,"
फ़्रियुलियाई",0,0,1,1
32682,αμερόληπτη,0,0,1,1
32683,داعى,0,0,1,1
32685,tritt,0,0,1,1
32689,التسويف,0,0,1,1
32690,basit,0,0,1,1
32695,contextualization,0,0,1,1
32652,rijksdienst,0,0,1,1
32696,aarzelend,0,0,1,1
32697,‎ˌwɪkiˈpidiə‏,0,0,1,1
32699,rebanada,0,0,1,1
32700,сетевая,0,0,1,1
32702,görüşemedik,0,0,1,1
32703,chrétien,0,0,1,1
32704,مهلا,0,0,1,1
32679,вобрал,0,0,1,1
32678,ತ್ರೈಮಾಸಿಕದಲ್ಲಿ,0,0,1,1
32676,moldavequoi ,0,0,1,1
32674,trouxe,0,0,1,1
32654,rannte,0,0,1,1
32655,lanzó,0,0,1,1
32658,wijd,0,0,1,1
32659,gegeven,0,0,1,1
32660,لوح,0,0,1,1
32661,рассказал,0,0,1,1
32662,развитии,0,0,1,1
32663,ошибку,0,0,1,1
32665,hi •,0,0,1,1
32666,lächeln,0,0,1,1
32667,yazdım,0,0,1,1
32669,tropperne,0,0,1,1
32671,परिप्रेक्ष्य,0,0,1,1
32672,ಪ್ರಯತ್ನಕ್ಕೆ,0,0,1,1
32673,ಅವನಿಗೆ,0,0,1,1
32595,desearle,0,0,1,1
32594,γλώσσα,0,0,1,1
32593,продолжай,0,0,1,1
32512,ولو,0,0,1,1
32502,പോകുന്നുവെന്നത്,0,0,1,1
32503,நண்பரிடம்,0,0,1,1
32504,ζητήσει,0,0,1,1
32507,ersättning,0,0,1,1
32508,വീട്ടിലെത്തിയപ്പോൾ,0,0,1,1
32509,τελειώσω,0,0,1,1
32511,மற்றொன்று,0,0,1,1
32517,занимался,0,0,1,1
32592,exhibir,0,0,1,1
32518,रुके,0,0,1,1
32519,asustado,0,0,1,1
32524,unter,0,0,1,1
32525,نعود,0,0,1,1
32528,molten,0,0,1,1
32529,rappelezvous,0,0,1,1
32532,المسكينة,0,0,1,1
32501,sofrem,0,0,1,1
32500,hydrocarbon,0,0,1,1
32499,يحرره،,0,0,1,1
32498,dags,0,0,1,1
32476,combining,0,0,1,1
32478,защитной,0,0,1,1
32479,париже,0,0,1,1
32480,ತೊಂದರೆಯಿಲ್ಲದ,0,0,1,1
32484,उम्मीद,0,0,1,1
32485,ಕರೆದೊಯ್ಯಿರಿ,0,0,1,1
32486,القانونية،,0,0,1,1
32487,anlamadım,0,0,1,1
32488,blanket,0,0,1,1
32489,elefantes,0,0,1,1
32490,légitime,0,0,1,1
32491,الرحلة,0,0,1,1
32492,servrar,0,0,1,1
32494,விக்கிப்பீடியாவை,0,0,1,1
32495,görülebilir,0,0,1,1
32533,കൃത്രിമ,0,0,1,1
32534,yanına,0,0,1,1
32536,ويتم,0,0,1,1
32570,eleitoral,0,0,1,1
32572,வகையை,0,0,1,1
32574,identity,0,0,1,1
32576,φτιάξετε,0,0,1,1
32578,придумана,0,0,1,1
32579,लूंगा।,0,0,1,1
32580,salataları,0,0,1,1
32581,mueve,0,0,1,1
32582,universellement,0,0,1,1
32583,diciéndome,0,0,1,1
32584,astounding,0,0,1,1
32585,கற்றல்,0,0,1,1
32587,temores,0,0,1,1
32588,plage,0,0,1,1
32589,ρωτήσει,0,0,1,1
32590,conozcas,0,0,1,1
32571,anneyi,0,0,1,1
32569,tilskynder,0,0,1,1
32537,συνεχίσουμε,0,0,1,1
32568,wikitrust,0,0,1,1
32538,ಗೊಂದಲಕ್ಕೀಡಾಗಿದ್ದೇನೆ,0,0,1,1
32539,حصل,0,0,1,1
32543,βελτιώστε,0,0,1,1
32545,kaartsysteem,0,0,1,1
32548,consciousness,0,0,1,1
32549,നിർമ്മിക്കുവാനുള്ള,0,0,1,1
32550,ആൾ,0,0,1,1
32554,alembert,0,0,1,1
32555,ഇന്റർനെറ്റിൽ,0,0,1,1
32557,failing,0,0,1,1
32558,εγκυκλοπαίδειες,0,0,1,1
32563,foutjes,0,0,1,1
32564,வலியுறுத்துவது,0,0,1,1
32565,குறைவாகக்,0,0,1,1
32566,benziyorsun,0,0,1,1
32705,رفضتهم,0,0,1,1
32707,anthropomorphisme »,0,0,1,1
31967,repetitiva,0,0,1,1
32863,للقاء,0,0,1,1
32848,benaderen,0,0,1,1
32849,പരമാവധി,0,0,1,1
32854,överraskat,0,0,1,1
32855,ουρανός,0,0,1,1
32856,அங்கேயே,0,0,1,1
32861,பிரமிக்க,0,0,1,1
32862,exclusivement,0,0,1,1
32864,товарного,0,0,1,1
32875,wikipub,0,0,1,1
32865,nica en,0,0,1,1
32866,जेन्नी,0,0,1,1
32867,soy,0,0,1,1
32868,varav,0,0,1,1
32869,mulher,0,0,1,1
32870,aanrijden,0,0,1,1
32872,какихлибо,0,0,1,1
32844,türban,0,0,1,1
32843,absoluta,0,0,1,1
32842,"
इण्डोनेशियाई",0,0,1,1
32841,ചെയ്യപ്പെട്ടു,0,0,1,1
32819,سترى,0,0,1,1
32820,கட்டமைப்பு”க்கு,0,0,1,1
32821,βιβλία,0,0,1,1
32822,مسؤولين,0,0,1,1
32823,« google »,0,0,1,1
32824,importants,0,0,1,1
32828,oyla,0,0,1,1
32830,இல்லாமலேயே,0,0,1,1
32831,ತಾಯಿಯಾಗಲು,0,0,1,1
32833,география,0,0,1,1
32834,iteration,0,0,1,1
32836,நாளில்,0,0,1,1
32837,deselegante,0,0,1,1
32839,сомнительными,0,0,1,1
32840,συνέντευξη,0,0,1,1
32874,تتسكع,0,0,1,1
32876,പ്രശ്നമില്ല,0,0,1,1
32708,«páginas,0,0,1,1
32927,behoud,0,0,1,1
32914,வெளிப்படையான,0,0,1,1
32915,efeito,0,0,1,1
32916,τηλέφωνό,0,0,1,1
32921,kapitalismen,0,0,1,1
32924,desconcierto,0,0,1,1
32925,deserved,0,0,1,1
32926,житомирской,0,0,1,1
32928,húngaro,0,0,1,1
32883,والعينات,0,0,1,1
32929,dosyalar,0,0,1,1
32931,energiebeispiel,0,0,1,1
32932,anlat,0,0,1,1
32934,triviais,0,0,1,1
32937,referenser,0,0,1,1
32939,"
अरागोनियाई",0,0,1,1
32940,ശൈശവാവസ്ഥയിലാണ്,0,0,1,1
32913,வடிவியல்,0,0,1,1
32911,കൃത്യതയെ,0,0,1,1
32910,vahşet,0,0,1,1
32909,للإجماع,0,0,1,1
32884,ಮಾಡಬೇಕೆಂಬುದನ್ನು,0,0,1,1
32887,αναρωτιόμουν,0,0,1,1
32889,ನೋಡುತ್ತಿದ್ದಾಗ,0,0,1,1
32892,"
tajique",0,0,1,1
32895,controversé,0,0,1,1
32896,одед,0,0,1,1
32897,സഞ്ചി,0,0,1,1
32898,ممكنة,0,0,1,1
32899,sözcüğünden,0,0,1,1
32900,предоставлен,0,0,1,1
32902,கலைக்களஞ்சியத்தை,0,0,1,1
32905,counts,0,0,1,1
32906,கொண்டாட,0,0,1,1
32907,immune,0,0,1,1
32908,யாரும்,0,0,1,1
32818,—familiar,0,0,1,1
32816,ассоциации,0,0,1,1
32815,நெடு,0,0,1,1
32744,källförteckningens,0,0,1,1
32735,wealth,0,0,1,1
32737,envoyezvous,0,0,1,1
32738,основным,0,0,1,1
32739,dotées,0,0,1,1
32741,breeding,0,0,1,1
32742,decade,0,0,1,1
32743,goût,0,0,1,1
32745,erronées,0,0,1,1
32814,заданий,0,0,1,1
32746,இதில்,0,0,1,1
32749,determinar,0,0,1,1
32751,мировой,0,0,1,1
32752,winzigen,0,0,1,1
32753,ура,0,0,1,1
32755,semillas,0,0,1,1
32756,δάκρυά,0,0,1,1
32733,ordem,0,0,1,1
32732,дорожки,0,0,1,1
32731,padronizações,0,0,1,1
32730,απαραίτητοι,0,0,1,1
32709,metadados,0,0,1,1
32710,معاداة,0,0,1,1
32711,vackra,0,0,1,1
32712,информацию»,0,0,1,1
32713,ಒಳಗೊಂಡಂತೆ,0,0,1,1
32714,house,0,0,1,1
32715,éclosion,0,0,1,1
32716,சேனலான,0,0,1,1
32719,voortbestaan,0,0,1,1
32721,भड़काने,0,0,1,1
32722,yiyeceklerden,0,0,1,1
32725,उदास,0,0,1,1
32727,премии,0,0,1,1
32728,l’animisme,0,0,1,1
32729,تمثيلا,0,0,1,1
32757,ഇക്കാരണം,0,0,1,1
32758,verdrink,0,0,1,1
32760,manche,0,0,1,1
32789,« durabilité »,0,0,1,1
32791,théorique…,0,0,1,1
32792,ಬೃಹತ್,0,0,1,1
32794,мужчине,0,0,1,1
32795,ಕೊನೆಯಲ್ಲಿ,0,0,1,1
32796,dormía,0,0,1,1
32798,പത്ത്,0,0,1,1
32799,உத்தியோகபூர்வ,0,0,1,1
32801,yansır,0,0,1,1
32804,ഒന്നുമല്ല,0,0,1,1
32805,فوجئت,0,0,1,1
32808,ertrinke,0,0,1,1
32809,abouti,0,0,1,1
32810,فيها،,0,0,1,1
32812,jerga,0,0,1,1
32813,अस्थिर,0,0,1,1
32790,couche,0,0,1,1
32788,فرنسية,0,0,1,1
32762,contacted,0,0,1,1
32786,данная,0,0,1,1
32763,«антиэлитарность»,0,0,1,1
32764,patentlerle,0,0,1,1
32767,linked,0,0,1,1
32769,kommunikation,0,0,1,1
32770,χαιρετισμοί,0,0,1,1
32772,wikipediaappar,0,0,1,1
32774,uppdatera,0,0,1,1
32776,ചേർക്കാനോ,0,0,1,1
32777,नॉनफिक्शन,0,0,1,1
32778,ال,0,0,1,1
32779,tested,0,0,1,1
32780,raises,0,0,1,1
32781,helpful,0,0,1,1
32782,encantadora,0,0,1,1
32784,ಸಮಯದಿಂದ,0,0,1,1
32475,βασικές,0,0,1,1
32474,exigindo,0,0,1,1
32473,संवेदनशील,0,0,1,1
32125,அதற்கான,0,0,1,1
32114,ocasionalmente,0,0,1,1
32115,زمن,0,0,1,1
32116,zoekresultaten,0,0,1,1
32118,korku,0,0,1,1
32120,olanların,0,0,1,1
32123,escribe,0,0,1,1
32124,telaffuz,0,0,1,1
32126,डॉलर,0,0,1,1
32140,blicke,0,0,1,1
32130,zij,0,0,1,1
32131,katkıların,0,0,1,1
32132,கிளாஸ்,0,0,1,1
32134,ആക്കി,0,0,1,1
32136,comedian,0,0,1,1
32137,olamazsın,0,0,1,1
32138,δυσκολία,0,0,1,1
32113,şerefe,0,0,1,1
32112,yanılıyorsun,0,0,1,1
32111,полномочия,0,0,1,1
32110,registro,0,0,1,1
32085,informationen,0,0,1,1
32087,distu,0,0,1,1
32089,kitabınızı,0,0,1,1
32092,വിഷയത്തെപ്പറ്റി,0,0,1,1
32093,winkelcentrum,0,0,1,1
32094,слубице,0,0,1,1
32095,duits,0,0,1,1
32101,придерживаясь,0,0,1,1
32102,"

",0,0,1,1
32103,हतोत्साहित,0,0,1,1
32104,شائعة,0,0,1,1
32105,урегулирования,0,0,1,1
32106,примите,0,0,1,1
32108,ağlıyorsun,0,0,1,1
32109,unimportant,0,0,1,1
32139,séparent,0,0,1,1
32141,renaissance,0,0,1,1
32472,reprendre,0,0,1,1
32183,daring,0,0,1,1
32174,sevdiğini,0,0,1,1
32175,olursa,0,0,1,1
32176,devia,0,0,1,1
32177,हंसना,0,0,1,1
32178,concours,0,0,1,1
32180,renginde,0,0,1,1
32182,وسيأتي,0,0,1,1
32184,bulunma,0,0,1,1
32143,сну,0,0,1,1
32185,സിനിമ,0,0,1,1
32186,frança,0,0,1,1
32188,вялого,0,0,1,1
32192,censeurs,0,0,1,1
32193,chegar,0,0,1,1
32194,luchó,0,0,1,1
32196,métiers,0,0,1,1
32173,двенадцатитомное,0,0,1,1
32172,الغيرالمسجليين،,0,0,1,1
32171,intersektionalitet,0,0,1,1
32170,உள்ளடக்கங்களும்,0,0,1,1
32145,hardly,0,0,1,1
32146,dès,0,0,1,1
32147,período,0,0,1,1
32148,recognizable,0,0,1,1
32150,αποφθεγμάτων,0,0,1,1
32152,ഗ്രന്ഥങ്ങളും,0,0,1,1
32153,dijeron,0,0,1,1
32154,definiciones,0,0,1,1
32155,которому,0,0,1,1
32156,फ़्लैमिश,0,0,1,1
32159,demenin,0,0,1,1
32162,библиотека,0,0,1,1
32165,energydrink,0,0,1,1
32166,breed,0,0,1,1
32168,പിടിച്ചുനിൽക്കാമോ,0,0,1,1
32083,متنوع،,0,0,1,1
32080,أسمع,0,0,1,1
32079,μηbrainer,0,0,1,1
32006,плачешь,0,0,1,1
31996,ठहराते,0,0,1,1
31998,ásia,0,0,1,1
31999,superar,0,0,1,1
32000,upptäckts,0,0,1,1
32001,نشر,0,0,1,1
32003,abertas,0,0,1,1
32005,бьет,0,0,1,1
32007,entra,0,0,1,1
32078,​​beetje,0,0,1,1
32008,സ്റ്റോപ്പ്,0,0,1,1
32009,продала,0,0,1,1
32011,idéologies,0,0,1,1
32012,മുതലുള്ള,0,0,1,1
32015,parlait,0,0,1,1
32017,पता।,0,0,1,1
32018,ಕೆಳಕ್ಕೆ,0,0,1,1
31995,econômicas,0,0,1,1
31993,dictadores,0,0,1,1
31992,strikeslip,0,0,1,1
31991,amérindiens,0,0,1,1
31970,gränsen,0,0,1,1
31971,оскорбительное,0,0,1,1
31972,typografisk,0,0,1,1
31973,έχουν,0,0,1,1
31974,fécond,0,0,1,1
31975,لشبكات,0,0,1,1
31976,anónimos,0,0,1,1
31977,¿verdad,0,0,1,1
31978,استضافة,0,0,1,1
31982,βλέπετε,0,0,1,1
31983,basins,0,0,1,1
31984,provider,0,0,1,1
31986,уроните,0,0,1,1
31987,üzülmeyin,0,0,1,1
31989,strikta,0,0,1,1
32019,ρωτάω,0,0,1,1
32024,ευχάριστο,0,0,1,1
32026,മൂർച്ചയുള്ള,0,0,1,1
32053,adoro,0,0,1,1
32056,вопросам,0,0,1,1
32058,bibliotek,0,0,1,1
32059,bevisar,0,0,1,1
32060,hopefully,0,0,1,1
32061,magiska,0,0,1,1
32062,tokio,0,0,1,1
32066,ಹೇಳುವಂತೆ,0,0,1,1
32067,ledigt,0,0,1,1
32068,ലഭിക്കാത്ത,0,0,1,1
32070,സാർവത്രികമായി,0,0,1,1
32071,τρομερά,0,0,1,1
32072,acusações,0,0,1,1
32073,право,0,0,1,1
32076,தடுக்கவும்,0,0,1,1
32077,l’esquisse,0,0,1,1
32055,sanger​,0,0,1,1
32051,गूगल्स,0,0,1,1
32028,agricultural,0,0,1,1
32050,المستخدمون,0,0,1,1
32029,നുഴഞ്ഞുകയറിയിട്ടുണ്ടായേക്കാവുന്ന,0,0,1,1
32030,getroffen,0,0,1,1
32031,claude,0,0,1,1
32032,disculpas,0,0,1,1
32033,ಅಲ್ಲಿರುವ,0,0,1,1
32035,ഇന്റർപീഡിയ,0,0,1,1
32036,högskolestudier,0,0,1,1
32038,ومؤسس,0,0,1,1
32039,alimentador,0,0,1,1
32040,proposition,0,0,1,1
32041,combinação,0,0,1,1
32043,discouraged,0,0,1,1
32046,anomalous,0,0,1,1
32047,എന്നിവ,0,0,1,1
32049,åtanke,0,0,1,1
32197,உதவிக்குறிப்பை,0,0,1,1
32199,broma,0,0,1,1
32200,совместного,0,0,1,1
32395,fiesta,0,0,1,1
32375,утром,0,0,1,1
32376,circling,0,0,1,1
32377,varsin,0,0,1,1
32383,следующих,0,0,1,1
32387,подготовка,0,0,1,1
32390,fark,0,0,1,1
32394,establece,0,0,1,1
32397,പ്രാവർത്തികമാക്കാനുള്ള,0,0,1,1
32336,omissions,0,0,1,1
32398,सिम्बल,0,0,1,1
32400,பலவிதமான,0,0,1,1
32402,reborn,0,0,1,1
32404,பேச்சுப்பக்கத்தைப்,0,0,1,1
32406,മോശമാണ്,0,0,1,1
32407,izleme,0,0,1,1
32408,करेगा,0,0,1,1
32373,वैश्विक,0,0,1,1
32372,майкл,0,0,1,1
32371,ಗೆದ್ದಿದೆ,0,0,1,1
32370,theories,0,0,1,1
32342,biomedical,0,0,1,1
32344,zamanın,0,0,1,1
32346,выпущено,0,0,1,1
32350,indépendant,0,0,1,1
32351,χρονικό,0,0,1,1
32352,mets,0,0,1,1
32353,trafik,0,0,1,1
32354,rapporterats,0,0,1,1
32355,latinska,0,0,1,1
32357,gülümsüyor,0,0,1,1
32358,മാർഗ്ഗമാണ്,0,0,1,1
32359,πέρα,0,0,1,1
32360,accueille,0,0,1,1
32363,വസ്തുക്കളുടെ,0,0,1,1
32366,одну,0,0,1,1
32410,ठंडी,0,0,1,1
32411,китая,0,0,1,1
32412,используя,0,0,1,1
32442,നിർബന്ധമില്ല,0,0,1,1
32447,ഭാഗമാണ്,0,0,1,1
32448,παγωτό,0,0,1,1
32451,மூலமே,0,0,1,1
32452,autoorganisé,0,0,1,1
32453,soudainement,0,0,1,1
32455,tane,0,0,1,1
32456,التعتيم,0,0,1,1
32459,ಸ್ಥಗಿತಗೊಳಿಸಿ,0,0,1,1
32460,والسياسية,0,0,1,1
32461,التعليمية,0,0,1,1
32462,narcissen,0,0,1,1
32467,സമ്പദ്‌വ്യവസ്ഥ,0,0,1,1
32468,ചേരാത്തതുമായ,0,0,1,1
32469,ವಿನಂತಿಗಳನ್ನು,0,0,1,1
32471,allèrent,0,0,1,1
32446,trykket,0,0,1,1
32441,maddesinin,0,0,1,1
32418,ஒருவரைச்,0,0,1,1
32440,многоязычная,0,0,1,1
32419,стилистических,0,0,1,1
32420,ಸಿಗದಿದ್ದಾಗ,0,0,1,1
32422,abriter,0,0,1,1
32423,ನಗುತ್ತಾ,0,0,1,1
32424,intelectualmente,0,0,1,1
32425,இரு,0,0,1,1
32428,computes,0,0,1,1
32429,articlep,0,0,1,1
32430,indonésie,0,0,1,1
32431,ஒபாமாவுக்கு,0,0,1,1
32432,présentation,0,0,1,1
32433,октябрь,0,0,1,1
32434,പൂരകസംവിധാനമായി,0,0,1,1
32435,أعداد,0,0,1,1
32439,गंभीर,0,0,1,1
32337,tolereras,0,0,1,1
32335,κούκλα,0,0,1,1
32201,இக்கொள்கைகளிலும்,0,0,1,1
32253,τέρι,0,0,1,1
32236,occupée…,0,0,1,1
32238,έξυπνων,0,0,1,1
32239,confusión,0,0,1,1
32241,zusammenhang,0,0,1,1
32243,pointant,0,0,1,1
32244,nyheterna,0,0,1,1
32247,voûte,0,0,1,1
32254,lingüística,0,0,1,1
32333,தோற்றங்களைக்,0,0,1,1
32255,lämnat,0,0,1,1
32260,reinventions,0,0,1,1
32261,granskade,0,0,1,1
32262,wovon,0,0,1,1
32263,previsões,0,0,1,1
32264,adopción,0,0,1,1
32266,तथा,0,0,1,1
32235,olmasın,0,0,1,1
32233,அதோடு,0,0,1,1
32232,slice,0,0,1,1
32230,jardín,0,0,1,1
32203,പോർച്ചുഗീസ്,0,0,1,1
32204,يقال,0,0,1,1
32206,कक्षा,0,0,1,1
32207,اهتمامك,0,0,1,1
32209,аналитически,0,0,1,1
32213,ಹಿಟ್ಟು,0,0,1,1
32215,uppdateras,0,0,1,1
32218,بقليل,0,0,1,1
32220,entdeckung,0,0,1,1
32222,हमारी,0,0,1,1
32223,weinberger en,0,0,1,1
32225,സുപ്രധാനനേട്ടവും,0,0,1,1
32227,ocultados,0,0,1,1
32228,продавались,0,0,1,1
32229,fırtınalı,0,0,1,1
32267,فحص,0,0,1,1
32268,tohumları,0,0,1,1
32269,opsummeringer,0,0,1,1
32307,subsanadas,0,0,1,1
32309,قائلا,0,0,1,1
32310,الانتقادات,0,0,1,1
32312,"
चीनी",0,0,1,1
32314,المعاملات,0,0,1,1
32318,dvdдиск,0,0,1,1
32320,perdiendo,0,0,1,1
32322,подчинённых,0,0,1,1
32323,تتضمن,0,0,1,1
32324,smelly,0,0,1,1
32325,«fuentes,0,0,1,1
32326,προβλήματα,0,0,1,1
32327,verhalten,0,0,1,1
32328,ತದನಂತರ,0,0,1,1
32331,уравновешенный,0,0,1,1
32332,charges,0,0,1,1
32308,μπαράκ,0,0,1,1
32306,restoran,0,0,1,1
32270,editar»,0,0,1,1
32304,arrojó,0,0,1,1
32271,ownership,0,0,1,1
32275,genoegen,0,0,1,1
32276,περιμένει,0,0,1,1
32277,manquant,0,0,1,1
32280,fødder,0,0,1,1
32281,comply,0,0,1,1
32285,ನಿಷ್ಠುರ,0,0,1,1
32287,vikipedileri,0,0,1,1
32289,ಆವಿಷ್ಕಾರ,0,0,1,1
32292,cognitive,0,0,1,1
32293,échappé,0,0,1,1
32296,ستالمان,0,0,1,1
32297,चलो।,0,0,1,1
32298,gigaoctets,0,0,1,1
32303,walmart,0,0,1,1
31003,umgangssprachlich,0,0,1,1
31000,தொகுக்கப்படும்,0,0,1,1
29044,smilede,0,0,1,1
29677,சலுகைகள்,0,0,1,1
29668,ವಿಶ್ವವಿದ್ಯಾನಿಲಯಕ್ಕೆ,0,0,1,1
29670,overemphasis,0,0,1,1
29671,вандалов,0,0,1,1
29672,nua,0,0,1,1
29673,parodi,0,0,1,1
29674,مستقل,0,0,1,1
29675,automates,0,0,1,1
29678,wikipediabron,0,0,1,1
29695,பிரிட்டானிக்காவின்,0,0,1,1
29679,نذهب,0,0,1,1
29682,identifiquen,0,0,1,1
29684,കളയുന്നു,0,0,1,1
29689,अनावश्यक,0,0,1,1
29691,inclusief,0,0,1,1
29692,olmadı,0,0,1,1
29693,froid,0,0,1,1
29667,verrait,0,0,1,1
29666,निषिद्ध,0,0,1,1
29663,zalimce,0,0,1,1
29662,sumaban,0,0,1,1
29640,finalmente,0,0,1,1
29642,grundat,0,0,1,1
29643,ಬ್ರೆಡ್ನಿಂದ,0,0,1,1
29644,gevangenissen,0,0,1,1
29646,kullanılıyordu,0,0,1,1
29647,selbst,0,0,1,1
29648,غداء,0,0,1,1
29649,инструкции,0,0,1,1
29650,विशेषाधिकृत,0,0,1,1
29651,ओपनसोलारिस,0,0,1,1
29654,управления,0,0,1,1
29656,udtaler,0,0,1,1
29657,salyangoz,0,0,1,1
29658,åtta,0,0,1,1
29661,ansvarlige,0,0,1,1
29694,hurtige,0,0,1,1
29697,हालांकि,0,0,1,1
29764,forfremmet,0,0,1,1
29749,empiriques,0,0,1,1
29738,സെപ്റ്റംബർ,0,0,1,1
29739,gözlerimi,0,0,1,1
29741,sürekli,0,0,1,1
29742,ஆரம்பிக்கப்பட்டது,0,0,1,1
29743,богатств,0,0,1,1
29747,disait,0,0,1,1
29748,مختلف,0,0,1,1
29750,инцидент,0,0,1,1
29698,udenfor,0,0,1,1
29753,mecaniste,0,0,1,1
29756,вещь,0,0,1,1
29758,dördü,0,0,1,1
29759,παντρευτεί,0,0,1,1
29760,εκθέτει,0,0,1,1
29761,മനസാണ്,0,0,1,1
29762,clavo,0,0,1,1
29737,metoderna,0,0,1,1
29736,«wikiality»,0,0,1,1
29735,recrutar,0,0,1,1
29731,wunderbar,0,0,1,1
29699,saxe,0,0,1,1
29701,emphasizing,0,0,1,1
29702,cadeau,0,0,1,1
29703,assertion,0,0,1,1
29704,предмету,0,0,1,1
29707,ಪದಗಳಿಗಿಂತ,0,0,1,1
29708,значительное,0,0,1,1
29709,ωθεί,0,0,1,1
29713,ρυθμός,0,0,1,1
29715,गुड़िया,0,0,1,1
29718,borrado,0,0,1,1
29722,ट्रस्ट,0,0,1,1
29725,eisenberg,0,0,1,1
29728,मानते,0,0,1,1
29730,fondent,0,0,1,1
29638,pounds,0,0,1,1
29636,उत्कृष्टविरोधी,0,0,1,1
29635,معيبة,0,0,1,1
29565,valioso,0,0,1,1
29548,grammar,0,0,1,1
29551,δική,0,0,1,1
29552,изменчивое,0,0,1,1
29553,يعد,0,0,1,1
29555,небеса,0,0,1,1
29561,enfrenta,0,0,1,1
29562,klänningen,0,0,1,1
29567,humana,0,0,1,1
29634,atingir,0,0,1,1
29569,интервью,0,0,1,1
29570,kæmpe,0,0,1,1
29572,vandalizmle,0,0,1,1
29575,ഏകഗ്രഹമാണ്,0,0,1,1
29576,ஏற்கவும்,0,0,1,1
29578,συμμετέχοντες,0,0,1,1
29579,τηλέφωνο,0,0,1,1
29546,décident,0,0,1,1
29545,выражается,0,0,1,1
29544,αργού,0,0,1,1
29543,несчастный,0,0,1,1
29520,equation,0,0,1,1
29521,रॉक,0,0,1,1
29523,utilisezvous,0,0,1,1
29525,efetivada,0,0,1,1
29526,kända,0,0,1,1
29527,διάστημα,0,0,1,1
29529,contundente,0,0,1,1
29532,hilfe,0,0,1,1
29533,മനസ്സിലായി,0,0,1,1
29535,சுவாசிக்க,0,0,1,1
29536,kloonwebsites,0,0,1,1
29539,judaïque,0,0,1,1
29540,anlama,0,0,1,1
29541,étonnante,0,0,1,1
29542,bilmiyorsunuz,0,0,1,1
29580,топологий,0,0,1,1
29582,संदर्भ,0,0,1,1
29585,beroepsschrijvers,0,0,1,1
29614,maruz,0,0,1,1
29616,circulando,0,0,1,1
29617,விருப்பமான,0,0,1,1
29618,participative,0,0,1,1
29620,consultado,0,0,1,1
29621,أخافت,0,0,1,1
29623,இழக்கப்பட்ட,0,0,1,1
29624,неестественно,0,0,1,1
29626,ederseniz,0,0,1,1
29627,تغذية,0,0,1,1
29628,المنازعات,0,0,1,1
29629,उत्प्रेरक,0,0,1,1
29630,العلمي،,0,0,1,1
29631,mote,0,0,1,1
29632,حوادث,0,0,1,1
29633,teceu,0,0,1,1
29615,covering,0,0,1,1
29612,κατασκευασμένη,0,0,1,1
29586,b,0,0,1,1
29611,geschäft,0,0,1,1
29587,conozco,0,0,1,1
29588,لطريقة,0,0,1,1
29590,വിശക്കുന്നു,0,0,1,1
29591,contribution »,0,0,1,1
29592,saladas,0,0,1,1
29594,இருந்திருக்கிறேன்,0,0,1,1
29595,exnihilo,0,0,1,1
29598,reject,0,0,1,1
29599,yapabilirler,0,0,1,1
29600,सक्षम,0,0,1,1
29601,wikieditáveis,0,0,1,1
29603,டிப்,0,0,1,1
29606,lissés,0,0,1,1
29608,opgestart,0,0,1,1
29609,l’intégrité,0,0,1,1
29763,wortelwoorden,0,0,1,1
29765,vertus,0,0,1,1
29998,सुविधाओं,0,0,1,1
29925, علمية,0,0,1,1
29917,yazarı,0,0,1,1
29919, mo,0,0,1,1
29920,entretenimiento,0,0,1,1
29921,സാമ്യതയുള്ളവയെ,0,0,1,1
29922,त्वरित,0,0,1,1
29923,خدمة,0,0,1,1
29924,  imagesk,0,0,1,1
29926,datats,0,0,1,1
29938,automatiques,0,0,1,1
29927,பட்சத்தில்,0,0,1,1
29928,difamación,0,0,1,1
29929,беспокоюсь,0,0,1,1
29930,مرعوب,0,0,1,1
29932,администрированию,0,0,1,1
29933,காரணமாகும்,0,0,1,1
29935,initiéec,0,0,1,1
29915,‘இறங்கு,0,0,1,1
29914,скажете,0,0,1,1
29911,مبني,0,0,1,1
29910,எனக்குப்,0,0,1,1
29885,actuación,0,0,1,1
29887,മുകളിലുള്ള,0,0,1,1
29890,μαντέψουν,0,0,1,1
29891,علي,0,0,1,1
29892,refuse,0,0,1,1
29893,chinois,0,0,1,1
29896,करेगी,0,0,1,1
29897,بعمق,0,0,1,1
29898,"
वू",0,0,1,1
29900,suggéré,0,0,1,1
29901,ayrıntıya,0,0,1,1
29903,اليومي,0,0,1,1
29905,वर्चुअल,0,0,1,1
29907,"വിക്കി
",0,0,1,1
29909,afbalancerede,0,0,1,1
29936,yılında,0,0,1,1
29939,interprétés,0,0,1,1
29766,ಅವರಲ್ಲಿ,0,0,1,1
29983,perfekte,0,0,1,1
29972,रीस्टोर,0,0,1,1
29973,mordida,0,0,1,1
29975,concentrated,0,0,1,1
29976,surpreender,0,0,1,1
29980,igneous,0,0,1,1
29981,ശ്രദ്ധിക്കുക,0,0,1,1
29982,arrastrar,0,0,1,1
29984,للقوات,0,0,1,1
29940,وأيضًا,0,0,1,1
29985,توداي,0,0,1,1
29986,llevas,0,0,1,1
29987,framtida,0,0,1,1
29990,birisinin,0,0,1,1
29992,தினசரி,0,0,1,1
29993,radikalt,0,0,1,1
29994,risken,0,0,1,1
29970,அவற்றை,0,0,1,1
29969,antártida,0,0,1,1
29966,comprobar,0,0,1,1
29965,बधाई,0,0,1,1
29942,arrêter,0,0,1,1
29944,duimen,0,0,1,1
29947,koyamadığım,0,0,1,1
29949,معلموا,0,0,1,1
29950,поддельному,0,0,1,1
29952,«trabajadores,0,0,1,1
29953,elizabeth,0,0,1,1
29955,créationniste,0,0,1,1
29956,utilizados,0,0,1,1
29957,vänsterpolitisk,0,0,1,1
29958,مستقلة,0,0,1,1
29959,дилемма,0,0,1,1
29960,المستخدمة,0,0,1,1
29961,تشكل,0,0,1,1
29963,calidad​,0,0,1,1
29884,desastrosas,0,0,1,1
29882,بالمحادثة,0,0,1,1
29881,bright,0,0,1,1
29817,bleiben,0,0,1,1
29809,обучаться,0,0,1,1
29811,отправлять,0,0,1,1
29812,मिलते,0,0,1,1
29813,belirterek,0,0,1,1
29814,minst,0,0,1,1
29815,проверить,0,0,1,1
29816,διαφορετικούς,0,0,1,1
29818,выражая,0,0,1,1
29880,ഉടൻ,0,0,1,1
29819,heiß,0,0,1,1
29820,واجب,0,0,1,1
29821,allgemeine,0,0,1,1
29825,recommandations,0,0,1,1
29826,refleja,0,0,1,1
29827,लूरी,0,0,1,1
29828,بمقابلتك,0,0,1,1
29803,entités,0,0,1,1
29801,porções,0,0,1,1
29798,ವಿವರಿಸಲು,0,0,1,1
29791,pede,0,0,1,1
29767,emocionante,0,0,1,1
29768,fóruns,0,0,1,1
29770,ಹುಚ್ಚನಾಗಿದ್ದೇನೆ,0,0,1,1
29772,presently,0,0,1,1
29774,സ്ഥാനമാണ്,0,0,1,1
29776,расследования,0,0,1,1
29777,разрешён,0,0,1,1
29778,hawaiianske,0,0,1,1
29779,médiatisées,0,0,1,1
29780,vitaliste,0,0,1,1
29781,religies,0,0,1,1
29783,correções,0,0,1,1
29785,ದೊಡ್ಡವಳು,0,0,1,1
29786,زعم,0,0,1,1
29790,ಕೋನವಾಗಿದೆ,0,0,1,1
29829,toevallig,0,0,1,1
29830,متجهة,0,0,1,1
29831,intrusions,0,0,1,1
29856,sorgulanabilir,0,0,1,1
29858,تحتاج,0,0,1,1
29859,المحظوظ,0,0,1,1
29860,onwards,0,0,1,1
29861,ಖಚಿತವಾಗಿದೆ,0,0,1,1
29862,vitesse,0,0,1,1
29865,வழங்குகின்றன,0,0,1,1
29866,ವಿಷಯವನ್ನು,0,0,1,1
29867,berömmet,0,0,1,1
29869,proprietary,0,0,1,1
29870,obsession,0,0,1,1
29871,obtaining,0,0,1,1
29873,consultationsmodifications,0,0,1,1
29877,vogvimageoptionsin,0,0,1,1
29878,veckor,0,0,1,1
29879,शिक्षा,0,0,1,1
29857,behandlede,0,0,1,1
29855,contraditórias,0,0,1,1
29832,റെസ്റ്റോറന്റാണിത്,0,0,1,1
29854,droite,0,0,1,1
29833,venant,0,0,1,1
29834,наблюдения»,0,0,1,1
29837,meter,0,0,1,1
29838,interplanetary,0,0,1,1
29839,الأوساخ,0,0,1,1
29840,grafías,0,0,1,1
29841,prácticas,0,0,1,1
29842,personificação,0,0,1,1
29843,aktuella,0,0,1,1
29844,perfecta,0,0,1,1
29845,contém,0,0,1,1
29847,builtin,0,0,1,1
29848,verändert,0,0,1,1
29852,merken,0,0,1,1
29853,पकड़,0,0,1,1
29519,കാണിക്കുന്ന,0,0,1,1
29517,lokala,0,0,1,1
29516,lesson,0,0,1,1
29201,βλέπεις,0,0,1,1
29191,proportionnellement,0,0,1,1
29192,लम्बे,0,0,1,1
29193,"
बश्किर",0,0,1,1
29194,palais,0,0,1,1
29195,المواد,0,0,1,1
29196,établit,0,0,1,1
29198,ayaklarımı,0,0,1,1
29202,eylem,0,0,1,1
29222,musées,0,0,1,1
29203,oldum,0,0,1,1
29210,directement,0,0,1,1
29211,compréhension,0,0,1,1
29213,உயர்வு,0,0,1,1
29215,pierda,0,0,1,1
29216,കൂടുതലുള്ളതും,0,0,1,1
29218,pas »,0,0,1,1
29189,soruyorsunuz,0,0,1,1
29187,المساء,0,0,1,1
29186,فالزوجة,0,0,1,1
29185,dönmüş,0,0,1,1
29155,ಮುಳುಗಿಸುತ್ತದೆ,0,0,1,1
29157,സുഹൃത്തിനെ,0,0,1,1
29159,impureza,0,0,1,1
29164,entero,0,0,1,1
29168,തങ്ങൾക്ക്,0,0,1,1
29169,മുഖത്തേക്ക്,0,0,1,1
29171,fa •,0,0,1,1
29173,planètes,0,0,1,1
29174,चाइना,0,0,1,1
29175,sencillo,0,0,1,1
29177,അമർത്തിക്കൊണ്ട്,0,0,1,1
29179,اللحم,0,0,1,1
29181,اكتسبت,0,0,1,1
29183,زفافي,0,0,1,1
29184,administrar,0,0,1,1
29220,medlingsärenden,0,0,1,1
29223,poids,0,0,1,1
29515,fotografering,0,0,1,1
29257,konsultera,0,0,1,1
29250,പുഞ്ചിരിയായിരുന്നു,0,0,1,1
29251,insistant,0,0,1,1
29252,"
finlandês",0,0,1,1
29253,linjeorganisationens,0,0,1,1
29254,ಸೆಲ್,0,0,1,1
29255,свободных,0,0,1,1
29256,предприняты,0,0,1,1
29258,dominerande,0,0,1,1
29227,الصراع,0,0,1,1
29260,بكونها,0,0,1,1
29261,editoras,0,0,1,1
29262,regroupées,0,0,1,1
29264,запрашиваемых,0,0,1,1
29267,geschehen,0,0,1,1
29271,afternoon,0,0,1,1
29272,തിരുത്തലുകളും,0,0,1,1
29248,árabe,0,0,1,1
29247,سكور,0,0,1,1
29246,поощряет,0,0,1,1
29245,tillstånd,0,0,1,1
29228,ışıltılı,0,0,1,1
29229,المطبقة,0,0,1,1
29231,editável,0,0,1,1
29232,άμαξας,0,0,1,1
29233,feks,0,0,1,1
29234,sevdiğin,0,0,1,1
29235,ensaísticos,0,0,1,1
29236,thick,0,0,1,1
29237,ചരിത്രവും,0,0,1,1
29238,filósofo,0,0,1,1
29239,gebiet,0,0,1,1
29240,çıkaracak,0,0,1,1
29241,neatly,0,0,1,1
29242,എടുക്കരുത്,0,0,1,1
29244,durée,0,0,1,1
29154,யூடியூபில்,0,0,1,1
29153,l’accent,0,0,1,1
29151,hébergeur,0,0,1,1
29081,важную,0,0,1,1
29071,εγχειρίδια,0,0,1,1
29072,ilgilenmiyorum,0,0,1,1
29074,itentreprenören,0,0,1,1
29076,winked,0,0,1,1
29077,κλήση,0,0,1,1
29078,നിങ്ങൾക്കാവശ്യമുള്ളതെന്തും,0,0,1,1
29080,éloigner,0,0,1,1
29082,voted,0,0,1,1
29150,signalent,0,0,1,1
29085,famílias,0,0,1,1
29086,ledig,0,0,1,1
29089,gemenskapen,0,0,1,1
29090,bite,0,0,1,1
29091,έμοιαζε,0,0,1,1
29092,खिलाफ,0,0,1,1
29093,المدينة,0,0,1,1
29070,பெயர்ச்சொல்லாக,0,0,1,1
29069,المضي,0,0,1,1
29068,προγράμματα,0,0,1,1
29066,bemeducado,0,0,1,1
29045,بالملابس,0,0,1,1
29047,mentalement,0,0,1,1
29049,currency,0,0,1,1
29050,поездки,0,0,1,1
29051,mentionné,0,0,1,1
29053,пообещал,0,0,1,1
29054,variances,0,0,1,1
29055,convirtiéndose,0,0,1,1
29056,വളർത്താൻ,0,0,1,1
29057,ഭാഗ്യം,0,0,1,1
29058,ಪೋರ್ಟಲ್,0,0,1,1
29061,particulier ,0,0,1,1
29062,opgezet,0,0,1,1
29063,gekruist,0,0,1,1
29065,monument,0,0,1,1
29094,minutes »,0,0,1,1
29096,fréquentesac,0,0,1,1
29099,ännu,0,0,1,1
29125,أطلقت,0,0,1,1
29131,olmayı,0,0,1,1
29132,granskar,0,0,1,1
29134,accusation,0,0,1,1
29135,الجرس,0,0,1,1
29138,çevrimiçi,0,0,1,1
29139,sterker,0,0,1,1
29140,நேசித்தாள்,0,0,1,1
29141,transclusion,0,0,1,1
29142,arctic,0,0,1,1
29143,piloté,0,0,1,1
29144,relationer,0,0,1,1
29145,chamador,0,0,1,1
29146,aral,0,0,1,1
29147,cerveaumachine ,0,0,1,1
29148,görmediğinizde,0,0,1,1
29129,marx,0,0,1,1
29124,النيويورك,0,0,1,1
29100,injunction,0,0,1,1
29123,falava,0,0,1,1
29102,അർ‌ത്ഥമാക്കുന്നു,0,0,1,1
29103,pular,0,0,1,1
29104,التصدي,0,0,1,1
29105,nahezu,0,0,1,1
29106,dejlige,0,0,1,1
29108,живём,0,0,1,1
29109,долгое,0,0,1,1
29111,tvekande,0,0,1,1
29114,உப்பு,0,0,1,1
29115,उपसमुच्चय,0,0,1,1
29116,ആദ്യത്തേത്,0,0,1,1
29117,செய்வதைத்,0,0,1,1
29118,включаемых,0,0,1,1
29120,ಬೆರಳುಗಳು,0,0,1,1
29121,renvoie,0,0,1,1
29275,loadbalancing,0,0,1,1
29277,‘பேச்சுப்,0,0,1,1
29278,argument,0,0,1,1
29437,beweringen,0,0,1,1
29424,просмотракомм,0,0,1,1
29425,läsbarhet,0,0,1,1
29426,uafhængig,0,0,1,1
29427,ഉദ്ധരിച്ചാണ്,0,0,1,1
29428,ενήργησα,0,0,1,1
29430,förstör,0,0,1,1
29436,വരുന്ന,0,0,1,1
29440,perdeu,0,0,1,1
29393,foule,0,0,1,1
29441,skarpa,0,0,1,1
29442,إصدار,0,0,1,1
29443,महिला,0,0,1,1
29444,بالحيرة,0,0,1,1
29445,дисках,0,0,1,1
29447,london,0,0,1,1
29448,feasibility,0,0,1,1
29421,сделана,0,0,1,1
29420,произведён,0,0,1,1
29417,большинстве,0,0,1,1
29416,bulunan,0,0,1,1
29395,вялой,0,0,1,1
29397,அதிகமான,0,0,1,1
29398,großen,0,0,1,1
29400,görande,0,0,1,1
29402,πολύτιμους,0,0,1,1
29404,« portail »réf,0,0,1,1
29405,gizlice,0,0,1,1
29406,sabırla,0,0,1,1
29407,слышите,0,0,1,1
29408,"
min",0,0,1,1
29409,adapt,0,0,1,1
29410,العربية,0,0,1,1
29411,ಬರುವುದಿಲ್ಲ,0,0,1,1
29413,rot,0,0,1,1
29414,اعتمادًا,0,0,1,1
29450,ಎಲ್ಲಿದೆ,0,0,1,1
29452,omitted,0,0,1,1
29454,servicio,0,0,1,1
29487,maddesinden,0,0,1,1
29489,fraud,0,0,1,1
29490,schlägt,0,0,1,1
29491,επινοήθηκε,0,0,1,1
29492,touriste,0,0,1,1
29494,geboden,0,0,1,1
29497,anges,0,0,1,1
29499,grau,0,0,1,1
29501,विकिमिडिया,0,0,1,1
29502,похожим,0,0,1,1
29507,desconcertantemente,0,0,1,1
29508,soussol,0,0,1,1
29509,confundes,0,0,1,1
29510,бриллиантами,0,0,1,1
29511,ರಹಸ್ಯವನ್ನು,0,0,1,1
29512,däremot,0,0,1,1
29488,заниматься,0,0,1,1
29486,inédites,0,0,1,1
29458,νοιαζόταν,0,0,1,1
29484,δώσετε,0,0,1,1
29462,drukner,0,0,1,1
29464,balkongen,0,0,1,1
29465,रूपों,0,0,1,1
29469,ചെയ്യുന്നതെന്ന്,0,0,1,1
29470,فاندربيلت،,0,0,1,1
29471,ഉണ്ടാവാം,0,0,1,1
29473,expertgenererat,0,0,1,1
29474,infelizmente,0,0,1,1
29475,—mediante,0,0,1,1
29477,specialistische,0,0,1,1
29478,εχεις,0,0,1,1
29479,"दिया।
विकिपीडिया",0,0,1,1
29480,agraciada,0,0,1,1
29481,энергией,0,0,1,1
29483,görüşleriniz,0,0,1,1
29394,familie,0,0,1,1
29392,proposant,0,0,1,1
29282,autorrevisores,0,0,1,1
29324,κέντρο,0,0,1,1
29315,roger,0,0,1,1
29318,britse,0,0,1,1
29319,italie »m,0,0,1,1
29320,மாணவர்களுக்கான,0,0,1,1
29321,versionshantering,0,0,1,1
29322,partagée,0,0,1,1
29323,troisième,0,0,1,1
29325,réussite,0,0,1,1
29391,ഡച്ച്,0,0,1,1
29326,സഹോദരിയേ,0,0,1,1
29327,hazreti,0,0,1,1
29328,вскоре,0,0,1,1
29330,ورفع,0,0,1,1
29332,hyldede,0,0,1,1
29334,fylla,0,0,1,1
29336,التوفل,0,0,1,1
29313,gecultiveerd,0,0,1,1
29310,الاحتجاجات,0,0,1,1
29308,προσλάβουμε,0,0,1,1
29304,hoparlör,0,0,1,1
29283,decentralized,0,0,1,1
29284,تطبقه,0,0,1,1
29287,بالكسل,0,0,1,1
29288,youif,0,0,1,1
29290,​​als,0,0,1,1
29291,overzicht,0,0,1,1
29293,مجلس,0,0,1,1
29294,evolutionary,0,0,1,1
29295,गूंगा,0,0,1,1
29296,تواجه,0,0,1,1
29298,serbie,0,0,1,1
29299,അലസമോ,0,0,1,1
29300,கணிப்பதில்,0,0,1,1
29301,практику»,0,0,1,1
29302,adéquation,0,0,1,1
29338,разработки,0,0,1,1
29339,نشاطاً،,0,0,1,1
29341,என்பதற்கு,0,0,1,1
29366,в переводе,0,0,1,1
29372,convenciones,0,0,1,1
29373,donatorer,0,0,1,1
29374,பங்களிப்பாளர்களையும்,0,0,1,1
29375,ഇടയിൽ,0,0,1,1
29376,பார்த்தபோது,0,0,1,1
29377,gerechtigd,0,0,1,1
29378,πρόταση,0,0,1,1
29379,sonar,0,0,1,1
29380,являясь,0,0,1,1
29382,யோசனை,0,0,1,1
29383,instalaciones,0,0,1,1
29384,kaynaklarını,0,0,1,1
29385,vérifiabilité,0,0,1,1
29389,näsa,0,0,1,1
29390,создававшихся,0,0,1,1
29370,izliyorsunuz,0,0,1,1
29365,başkalarına,0,0,1,1
29344,धोने,0,0,1,1
29364,comêlo,0,0,1,1
29346,താക്കീതു,0,0,1,1
29347,മറാഠി,0,0,1,1
29348,sökningen,0,0,1,1
29349,தொகுக்கப்படக்,0,0,1,1
29350,eleita,0,0,1,1
29351,öğretmen,0,0,1,1
29352,للاستفادة,0,0,1,1
29355,decorum,0,0,1,1
29356,автобус,0,0,1,1
29357,aptalca,0,0,1,1
29358,கடுமையாக,0,0,1,1
29360,переписывают,0,0,1,1
29361,återgivningsrätt,0,0,1,1
29362,любая,0,0,1,1
29363,tiers,0,0,1,1
29995,ರವಾನಿಸಬಹುದು,0,0,1,1
29999,الذاتية,0,0,1,1
30998,польского,0,0,1,1
30693,conjuntos,0,0,1,1
30682,protegido,0,0,1,1
30684,préadolescente,0,0,1,1
30685,ഏക,0,0,1,1
30686,السهل,0,0,1,1
30688,verdere,0,0,1,1
30689,estates,0,0,1,1
30691,реальных,0,0,1,1
30694,stämmer,0,0,1,1
30709,passede,0,0,1,1
30698,விக்கிப்பீடியாவுக்கு,0,0,1,1
30699,doter,0,0,1,1
30701,тадичем,0,0,1,1
30704,النقاد,0,0,1,1
30705,impressa,0,0,1,1
30706,പെടുന്ന,0,0,1,1
30707,ചെറുപെട്ടികളിൽ,0,0,1,1
30681,mau,0,0,1,1
30678,समय।,0,0,1,1
30677,ونأمل,0,0,1,1
30676,probabilístico,0,0,1,1
30658,descrever,0,0,1,1
30660,identificação,0,0,1,1
30661,kırptı,0,0,1,1
30662,πάρουν,0,0,1,1
30663,ünlü,0,0,1,1
30664,nomeados,0,0,1,1
30665,إنك,0,0,1,1
30666,genommen,0,0,1,1
30667,amplia,0,0,1,1
30668,рост,0,0,1,1
30670,தோற்றமளிக்கிறீர்கள்,0,0,1,1
30671,испанской,0,0,1,1
30672,اسمحوا,0,0,1,1
30674,semibeskyttet,0,0,1,1
30675,الشرفة,0,0,1,1
30708,αυξηθεί,0,0,1,1
30710,वेरिएबल्स,0,0,1,1
30775,تحديث،,0,0,1,1
30761,betegne,0,0,1,1
30748,japonês,0,0,1,1
30749,இருந்ததுடன்,0,0,1,1
30752,твоя,0,0,1,1
30753,resultados​,0,0,1,1
30757,становиться,0,0,1,1
30758,подтверждает,0,0,1,1
30759,sederna,0,0,1,1
30762,paralelos,0,0,1,1
30713,खो,0,0,1,1
30763,reservado,0,0,1,1
30765,gekopieerde,0,0,1,1
30766,программы,0,0,1,1
30768,اجتماعية،,0,0,1,1
30769,tårer,0,0,1,1
30770,medtaget,0,0,1,1
30771,buysa,0,0,1,1
30747,ஆகியோரால்,0,0,1,1
30746,അസന്തുഷ്ടിയും,0,0,1,1
30743,الكهولة,0,0,1,1
30738,baserat,0,0,1,1
30714,positief,0,0,1,1
30715,loop,0,0,1,1
30717,aspire,0,0,1,1
30718,«рандеву,0,0,1,1
30719,crazy,0,0,1,1
30720,encuentra,0,0,1,1
30722,dilema,0,0,1,1
30723,optin,0,0,1,1
30724,تطلق,0,0,1,1
30725,chevrontexaco,0,0,1,1
30727,மூன்றாம்,0,0,1,1
30730,захвачена,0,0,1,1
30731,применить,0,0,1,1
30732,hörde,0,0,1,1
30736,jobs,0,0,1,1
30657,வெளிப்படுத்தினேன்,0,0,1,1
30654,بنظرة,0,0,1,1
30653,exemplares,0,0,1,1
30563,structurantes,0,0,1,1
30550,digital»,0,0,1,1
30551,opfundet,0,0,1,1
30553,significativos,0,0,1,1
30555,evermore,0,0,1,1
30559,έλλειψη,0,0,1,1
30560,lb •,0,0,1,1
30561,നിർഭാഗ്യവശാൽ,0,0,1,1
30564,lavar,0,0,1,1
30649,tappar,0,0,1,1
30565,ru •,0,0,1,1
30567,bilgisayara,0,0,1,1
30568,chémoinformatique ,0,0,1,1
30572,forestation,0,0,1,1
30573,seje,0,0,1,1
30575,بتأثيره،,0,0,1,1
30577,ósseo,0,0,1,1
30549,nãoficção,0,0,1,1
30546,حدث,0,0,1,1
30545,exception,0,0,1,1
30544,வைத்து,0,0,1,1
30516,французский,0,0,1,1
30518,förklara,0,0,1,1
30520,précieuses,0,0,1,1
30521,ευχαριστήσετε,0,0,1,1
30522,uppnå,0,0,1,1
30525,assaulting,0,0,1,1
30526,الفستان,0,0,1,1
30529,اعتن,0,0,1,1
30530,réglementant,0,0,1,1
30532,fluentes,0,0,1,1
30533,εκατομμύριο,0,0,1,1
30534,işiniz,0,0,1,1
30537,μυρωδιά,0,0,1,1
30539,contratálo,0,0,1,1
30541,مقدما,0,0,1,1
30581,förre,0,0,1,1
30585,incité,0,0,1,1
30587,फर्स्ट,0,0,1,1
30619,ವೀಡಿಯೊಗೆ,0,0,1,1
30623,expertförfattad,0,0,1,1
30625,приходят,0,0,1,1
30629,abriljunio,0,0,1,1
30630,prestarme,0,0,1,1
30631,tilgå,0,0,1,1
30632,поездку,0,0,1,1
30633,السلوك,0,0,1,1
30636,autoritário,0,0,1,1
30637,kararının,0,0,1,1
30639,знаку,0,0,1,1
30640,آخذك,0,0,1,1
30641,التراكم,0,0,1,1
30644,фотографиями,0,0,1,1
30645,wikipediaskribenterna,0,0,1,1
30648,textbook,0,0,1,1
30622,dönüşüyor,0,0,1,1
30618,группу,0,0,1,1
30589,decrease,0,0,1,1
30617,revistos,0,0,1,1
30596,gaaf,0,0,1,1
30597,مستاء,0,0,1,1
30598,« naître »,0,0,1,1
30599,ಸಭೆಯ,0,0,1,1
30600,இதிலுள்ள,0,0,1,1
30601,"
latim",0,0,1,1
30602,നിങ്ങളെത്തന്നെ,0,0,1,1
30603,независимости»,0,0,1,1
30605,otroligt,0,0,1,1
30606,biblique,0,0,1,1
30607,подходам,0,0,1,1
30608,കണ്ടെത്തൽ,0,0,1,1
30609,अनुमान,0,0,1,1
30613,ψάχνουμε,0,0,1,1
30615,associée,0,0,1,1
30774,opportunistic,0,0,1,1
30776,فأحب,0,0,1,1
30002,tætskrevne,0,0,1,1
30919,состоящих,0,0,1,1
30912,higherlevel,0,0,1,1
30913,لأقول,0,0,1,1
30914,northeast,0,0,1,1
30915,ontzagwekkende,0,0,1,1
30916,bağımsız,0,0,1,1
30917,ஆனது,0,0,1,1
30918,inclining,0,0,1,1
30920,fera,0,0,1,1
30941,recuperó,0,0,1,1
30925,होनी,0,0,1,1
30926,dessein,0,0,1,1
30927,редактирование,0,0,1,1
30928,എടുത്തു,0,0,1,1
30929,çalışıyordu,0,0,1,1
30932,curta,0,0,1,1
30933,ಎಲ್ಲವನ್ನೂ,0,0,1,1
30911,эмоциях,0,0,1,1
30910,ajudaria,0,0,1,1
30909,natuur,0,0,1,1
30908,πατάτες,0,0,1,1
30890,elogios,0,0,1,1
30891,utomstående,0,0,1,1
30892,планах,0,0,1,1
30893,backpropagated,0,0,1,1
30894,скорее,0,0,1,1
30895,والإيطالية,0,0,1,1
30897,कॉपीलेफ्ट,0,0,1,1
30898,ಪ್ರತಿಕ್ರಿಯೆಯೊಂದಿಗೆ,0,0,1,1
30900,tenu,0,0,1,1
30901,असंगतियों,0,0,1,1
30902,çocuk,0,0,1,1
30903,philippines,0,0,1,1
30905,questionada,0,0,1,1
30906,särskilda,0,0,1,1
30907,بزيارة,0,0,1,1
30939,партнёрства,0,0,1,1
30942,имеющих,0,0,1,1
30777,поставьте,0,0,1,1
30987,molecular,0,0,1,1
30976,घोषित,0,0,1,1
30977,rumano,0,0,1,1
30978,vittighed,0,0,1,1
30981,mediawiki —,0,0,1,1
30982,«unos,0,0,1,1
30983,صعبًا,0,0,1,1
30984,وكذلك,0,0,1,1
30988,intensives,0,0,1,1
30946,வரலாற்றைக்,0,0,1,1
30989,estilísticas,0,0,1,1
30990,കാണപ്പെടുന്നത്,0,0,1,1
30991,parou,0,0,1,1
30992,تذكره,0,0,1,1
30993,genişti,0,0,1,1
30994,justifiée,0,0,1,1
30997,domination,0,0,1,1
30974,högtalaren,0,0,1,1
30973,hemel,0,0,1,1
30972,blois,0,0,1,1
30971,acontecido,0,0,1,1
30947,ужасный,0,0,1,1
30948,преуспевать,0,0,1,1
30949,hébergent,0,0,1,1
30951,disposent,0,0,1,1
30952,independencias,0,0,1,1
30953,πρακτική,0,0,1,1
30955,lexicografische,0,0,1,1
30956,gördüğünde,0,0,1,1
30957,wikiwoordenboek,0,0,1,1
30959,geophysiological,0,0,1,1
30960,வளர்ந்தது,0,0,1,1
30962,நுழைந்தால்,0,0,1,1
30964,പേരിന്റെ,0,0,1,1
30968,объектов,0,0,1,1
30969,продвижения,0,0,1,1
30889,புத்தகத்தைப்,0,0,1,1
30887,περίπτωσή,0,0,1,1
30886,consideramse,0,0,1,1
30817,reconstruction,0,0,1,1
30804,إستوحت,0,0,1,1
30805,tjek,0,0,1,1
30808,gravitation,0,0,1,1
30809,വിഭാഗത്തിൽ,0,0,1,1
30810,обоим,0,0,1,1
30812,пытаются,0,0,1,1
30813,forstå,0,0,1,1
30819,klassiska,0,0,1,1
30885,meramente,0,0,1,1
30820,എന്നതുകൊണ്ട്,0,0,1,1
30821,система,0,0,1,1
30822,onderbreken,0,0,1,1
30824,ಹಿಸಿದಂತೆ,0,0,1,1
30825,asturies,0,0,1,1
30826,முகவரிகளினால்,0,0,1,1
30827,acelerado,0,0,1,1
30802,producen,0,0,1,1
30801,исследованиями,0,0,1,1
30800,föreställer,0,0,1,1
30799,ionized,0,0,1,1
30778,girişi,0,0,1,1
30780,explicitement,0,0,1,1
30781,ಬೆರಳುಗಳ,0,0,1,1
30783,ಉತ್ಸುಕರಾಗಿದ್ದೇವೆ,0,0,1,1
30784,പരിഹരിക്കപ്പെടുമെന്നാണ്,0,0,1,1
30785,panciera,0,0,1,1
30787,exposición,0,0,1,1
30789,أتفق,0,0,1,1
30791,genres,0,0,1,1
30792,стиль,0,0,1,1
30793,attribué,0,0,1,1
30794,¿podrías,0,0,1,1
30795,உள்ளீர்கள்,0,0,1,1
30796,logrado,0,0,1,1
30798,herói,0,0,1,1
30828,omitidas,0,0,1,1
30829,wert,0,0,1,1
30831,attenuates,0,0,1,1
30859,förblir,0,0,1,1
30862,ಅಳಲು,0,0,1,1
30863,bataklıkta,0,0,1,1
30867,auffordert,0,0,1,1
30869,أدرك,0,0,1,1
30870,مرخص,0,0,1,1
30871,akilleshäl,0,0,1,1
30873,സ്കൂളിനെ,0,0,1,1
30874,adamları,0,0,1,1
30875,enciende,0,0,1,1
30877,المكتبة؟,0,0,1,1
30878,capacidad,0,0,1,1
30879,θαλασσωσα,0,0,1,1
30880,microecosystem,0,0,1,1
30881,ಮರೆತುಬಿಡುತ್ತಾರೆ,0,0,1,1
30882,wordsworth,0,0,1,1
30861,discutiu,0,0,1,1
30858,править —,0,0,1,1
30832,മാനസികമായി,0,0,1,1
30857,cumpliesen,0,0,1,1
30833,temario,0,0,1,1
30834,ಹುಡುಗರನ್ನು,0,0,1,1
30835,முகத்தில்,0,0,1,1
30838,threats,0,0,1,1
30841,invested,0,0,1,1
30843,πότε,0,0,1,1
30844,solle,0,0,1,1
30846,कदम,0,0,1,1
30848,"
minangkabau",0,0,1,1
30849,accompagné,0,0,1,1
30851,വാങ്ങില്ല,0,0,1,1
30852,поддерживающей,0,0,1,1
30853,sientes,0,0,1,1
30855,нарцисе,0,0,1,1
30856,excluded,0,0,1,1
30515,المجالات,0,0,1,1
30514,"
उदमुर्त",0,0,1,1
30512,улиток,0,0,1,1
30184,invoerdata,0,0,1,1
30170,startades,0,0,1,1
30171,pluripotency,0,0,1,1
30172,nds •,0,0,1,1
30178,específica,0,0,1,1
30179,категории,0,0,1,1
30182,ഐ,0,0,1,1
30183,deixe,0,0,1,1
30185,experiências,0,0,1,1
30200,modsatte,0,0,1,1
30187,librei,0,0,1,1
30188,arkadaşımı,0,0,1,1
30189,എടുത്താൽ,0,0,1,1
30190,forståelig,0,0,1,1
30191,frem,0,0,1,1
30194,mapa,0,0,1,1
30196,goudbrood,0,0,1,1
30169,nutshell,0,0,1,1
30167,prémio,0,0,1,1
30166,maximale,0,0,1,1
30165,fetzer,0,0,1,1
30136,συνδυασμό,0,0,1,1
30137,சாப்பிடும்,0,0,1,1
30138,tente,0,0,1,1
30139,невозможную,0,0,1,1
30143,créative,0,0,1,1
30144,للتطوير,0,0,1,1
30145,fördjupade,0,0,1,1
30146,عينات,0,0,1,1
30148,ഒന്നോ,0,0,1,1
30152,nickel,0,0,1,1
30155,çalışır,0,0,1,1
30158,распространению,0,0,1,1
30159,amatörernas,0,0,1,1
30161,треть,0,0,1,1
30162,предлагаемой,0,0,1,1
30197,இணையத்தள,0,0,1,1
30202,φέτα,0,0,1,1
30510,emphasis,0,0,1,1
30245,autocensuró,0,0,1,1
30236,एजेंसियों,0,0,1,1
30237,корпораций,0,0,1,1
30238,maids,0,0,1,1
30239,அதே,0,0,1,1
30240,"
माल्टी",0,0,1,1
30242,salvar,0,0,1,1
30243,universitario,0,0,1,1
30246,journalistiques,0,0,1,1
30203,δέξου,0,0,1,1
30247,gelassen,0,0,1,1
30248,deltagarportalerna,0,0,1,1
30249,uge,0,0,1,1
30250,τάση,0,0,1,1
30251,ασημί,0,0,1,1
30252,منتديات,0,0,1,1
30253,dağıtılması,0,0,1,1
30235,atentos,0,0,1,1
30234,بالإنترنت,0,0,1,1
30232,prévaut,0,0,1,1
30231,துரதிர்ஷ்டவசமாக,0,0,1,1
30204,പരിശീലിപ്പിക്കുക,0,0,1,1
30205,lagged,0,0,1,1
30206,lifeforms,0,0,1,1
30207,simgesi,0,0,1,1
30208,பாதுகாப்பு,0,0,1,1
30209,absolut,0,0,1,1
30210,processen,0,0,1,1
30211,γυναίκα,0,0,1,1
30216,alemanha,0,0,1,1
30220,قليلة,0,0,1,1
30223,förändras,0,0,1,1
30226,adjusts,0,0,1,1
30228,yapabilirim,0,0,1,1
30229,സൃഷ്ടിക്കും,0,0,1,1
30230,പിടിച്ചില്ലെങ്കിൽ‌,0,0,1,1
30134,xvi,0,0,1,1
30133,funktion,0,0,1,1
30131,विचारविमर्श,0,0,1,1
30049,उन्हने,0,0,1,1
30033,custos,0,0,1,1
30036,paralela,0,0,1,1
30038,συντάκτες,0,0,1,1
30041,ತಮಾಷೆಯ,0,0,1,1
30042,kostte,0,0,1,1
30044,verificáveis,0,0,1,1
30045,наука,0,0,1,1
30050,priority ,0,0,1,1
30130,ಕರೆಯಲ್ಲಿ,0,0,1,1
30051,conjectured,0,0,1,1
30053,probabilities,0,0,1,1
30055,நல்லவர்களாக,0,0,1,1
30057,hayali,0,0,1,1
30062,gjord,0,0,1,1
30063,ಪಾಸ್‌ವರ್ಡ್,0,0,1,1
30064,animaux ,0,0,1,1
30032,morges,0,0,1,1
30031,utiliseriez,0,0,1,1
30025,отзыв,0,0,1,1
30023,സുന്ദരിയാണെന്ന്,0,0,1,1
30003,veria,0,0,1,1
30005,ناقدة,0,0,1,1
30006,υγρότοπου,0,0,1,1
30007,délicates,0,0,1,1
30010,—alrededor,0,0,1,1
30011,பிழைத்திருத்தத்திற்கு,0,0,1,1
30012,nacional,0,0,1,1
30013,विशेषताएं,0,0,1,1
30014,suppressions,0,0,1,1
30015,அமெரிக்காவில்,0,0,1,1
30016,reemplazada,0,0,1,1
30017,മറുപടി,0,0,1,1
30019,particles,0,0,1,1
30020,outcomes,0,0,1,1
30022,शैक्षणिक,0,0,1,1
30065,поживаешь,0,0,1,1
30066,வளர்ச்சிக்கு,0,0,1,1
30067,contestados,0,0,1,1
30103,ശ്രമിക്കുന്നു,0,0,1,1
30106,يفي,0,0,1,1
30107,"
वोरो",0,0,1,1
30108,gebruikersbijdragen,0,0,1,1
30110,നടത്തേണ്ടതുണ്ടെന്നും,0,0,1,1
30112,വിശേഷിപ്പിക്കുന്നുഅഭിപ്രായസ്വാതന്ത്ര്യം,0,0,1,1
30113,യന്ത്രപഠനമാണ്,0,0,1,1
30114,leave,0,0,1,1
30116,அவர்களில்,0,0,1,1
30119,tembel,0,0,1,1
30121,dilemas,0,0,1,1
30122,postgresql,0,0,1,1
30123,tecnológico,0,0,1,1
30124,дедуктивное,0,0,1,1
30126,posteriori,0,0,1,1
30129,вебсайтов,0,0,1,1
30104,daneben,0,0,1,1
30101,ഉത്സാഹം,0,0,1,1
30068,clássicas,0,0,1,1
30100,авторское,0,0,1,1
30069,loyal,0,0,1,1
30072,censorship,0,0,1,1
30073,проверены,0,0,1,1
30074,показали,0,0,1,1
30076,inspiration,0,0,1,1
30078,solicitan,0,0,1,1
30084,censur,0,0,1,1
30086,fry,0,0,1,1
30087,بكتابة,0,0,1,1
30090,വീഡിയോയിലെ,0,0,1,1
30092,पहुंचते,0,0,1,1
30094,exceptions—most,0,0,1,1
30095,disons,0,0,1,1
30097,asegúrate,0,0,1,1
30098,ഫെബ്രുവരിയിൽ‍,0,0,1,1
30254,yüzüme,0,0,1,1
30255,wilde,0,0,1,1
30257,பிப்ரவரியில்,0,0,1,1
30430,подумайте,0,0,1,1
30415,البيتزا,0,0,1,1
30418,உட்கார்ந்திருப்பதைப்,0,0,1,1
30420,γάμο,0,0,1,1
30421,delante,0,0,1,1
30424,kunskaper,0,0,1,1
30425,äktenskap,0,0,1,1
30429,compete,0,0,1,1
30431,lacunes,0,0,1,1
30385,femme ,0,0,1,1
30432,والذكية,0,0,1,1
30434,olsaydın,0,0,1,1
30436,markant,0,0,1,1
30439,klänningarna,0,0,1,1
30440,ವಿವರಿಸಿ,0,0,1,1
30441,ക്ഷീണിതനാണോ,0,0,1,1
30442,companhia,0,0,1,1
30414,إعجابًا,0,0,1,1
30413,أية,0,0,1,1
30410,reflexo,0,0,1,1
30409,ಬೇಡವೆಂದು,0,0,1,1
30388,rumpelte,0,0,1,1
30389,ಮಹಿಳೆ,0,0,1,1
30390,सूप,0,0,1,1
30391,eklenmesi,0,0,1,1
30392,kapıdan,0,0,1,1
30393,involving,0,0,1,1
30395,minutiae,0,0,1,1
30396,പരസ്പരവിരുദ്ധമായ,0,0,1,1
30397,последующим,0,0,1,1
30398,ornamentation,0,0,1,1
30399,lachend,0,0,1,1
30400,« éviter,0,0,1,1
30401,tuin,0,0,1,1
30406,visent,0,0,1,1
30407,قدمي,0,0,1,1
30445,coupled,0,0,1,1
30446,compuesta,0,0,1,1
30447,—usuarios,0,0,1,1
30482,olhou,0,0,1,1
30484,başlatabilirler,0,0,1,1
30486,προτού,0,0,1,1
30488,locura,0,0,1,1
30489,endemic,0,0,1,1
30490,säkerhetstjänst,0,0,1,1
30492,fizeram,0,0,1,1
30496,recognizing,0,0,1,1
30498,хранения,0,0,1,1
30499,محررو,0,0,1,1
30500,supervisionar,0,0,1,1
30502,നിഷ്കളങ്കമായി,0,0,1,1
30503,அழுவதைப்,0,0,1,1
30504,gamle,0,0,1,1
30505,escucha,0,0,1,1
30508,вежливым,0,0,1,1
30483,ох,0,0,1,1
30481,ടെലിഗ്രാം,0,0,1,1
30452,tardaba,0,0,1,1
30479,bundan,0,0,1,1
30455,പ്രശ്നത്തിന്റേയും,0,0,1,1
30456,വിക്കിപീഡിയൻ,0,0,1,1
30458,रेस्तरां,0,0,1,1
30460,refrendados,0,0,1,1
30461,απαντήσω,0,0,1,1
30462,encendido,0,0,1,1
30465,तारास्कीविका,0,0,1,1
30467,albedo,0,0,1,1
30468,améliorations,0,0,1,1
30470,monday,0,0,1,1
30471,fineste,0,0,1,1
30473,ನಲ್ಲಿದ್ದೇನೆ,0,0,1,1
30476,أضع,0,0,1,1
30477,riktat,0,0,1,1
30478,ഐസ്ക്രീമുകളുടെ,0,0,1,1
30386,förtal,0,0,1,1
30383,minnettarım,0,0,1,1
30261,langages,0,0,1,1
30307,ಪರೀಕ್ಷೆ,0,0,1,1
30297,ήχο,0,0,1,1
30298,मामलों,0,0,1,1
30300,മെയിൽ,0,0,1,1
30301,സന്നദ്ധനാണ്,0,0,1,1
30302,skall,0,0,1,1
30303,مخالف,0,0,1,1
30305,നൽകുകയും,0,0,1,1
30308,எல்லோருக்கும்,0,0,1,1
30382,protests,0,0,1,1
30309,περίμενε,0,0,1,1
30310,посещаемых,0,0,1,1
30311,утверждение,0,0,1,1
30312,مخزنة,0,0,1,1
30314,மூலத்தைப்,0,0,1,1
30315,encyclopédien,0,0,1,1
30317,voeden,0,0,1,1
30295,φυλακισμένοι,0,0,1,1
30294,فهناك,0,0,1,1
30292,слышать,0,0,1,1
30291,piltangenter,0,0,1,1
30263,répète,0,0,1,1
30264,adhere,0,0,1,1
30265,പരിഹാരത്തിലായിരിക്കുമ്പോൾ,0,0,1,1
30269,estime,0,0,1,1
30272,उर्दू,0,0,1,1
30273,inheritable,0,0,1,1
30274,получилось,0,0,1,1
30275,يقتصر,0,0,1,1
30279,forçait,0,0,1,1
30281,absolument,0,0,1,1
30283,toptijdschriften,0,0,1,1
30284,വൃത്തികെട്ടതും,0,0,1,1
30285,maravilhada,0,0,1,1
30286,താരതമ്യേന,0,0,1,1
30289,വാഹന,0,0,1,1
30318,fornece,0,0,1,1
30319,ஸ்டால்மன்,0,0,1,1
30320,doctrines,0,0,1,1
30352,sitez,0,0,1,1
30358,databas,0,0,1,1
30364,камнями,0,0,1,1
30366,لاستخدام,0,0,1,1
30367,decide,0,0,1,1
30368,இதயத்திற்கு,0,0,1,1
30371,புளூமாக்ஸிற்குப்,0,0,1,1
30372,de •,0,0,1,1
30373,vandalizing,0,0,1,1
30374,δανείσετε,0,0,1,1
30375,உணர்கிறேன்,0,0,1,1
30377,propianota,0,0,1,1
30378,τείνει,0,0,1,1
30379,പുരുഷന്മാരെ,0,0,1,1
30380,सौ,0,0,1,1
30381,لنبدأ,0,0,1,1
30355,திட்டமாக,0,0,1,1
30351,dileme,0,0,1,1
30321,phpвикидвижке,0,0,1,1
30347,экспертами,0,0,1,1
30324,கடனைப்,0,0,1,1
30325,വെബ്സൈറ്റ്,0,0,1,1
30326,ووسيم,0,0,1,1
30330,n’héritent,0,0,1,1
30331,muddled,0,0,1,1
30332,weird,0,0,1,1
30334,basarak,0,0,1,1
30335,trust,0,0,1,1
30338,unrecognized,0,0,1,1
30339,ஹெல்லரால்,0,0,1,1
30340,sürdürmeye,0,0,1,1
30341,erişime,0,0,1,1
30343,towns,0,0,1,1
30345,ولاحقًا,0,0,1,1
30346,μόλις,0,0,1,1
25177,septième,0,0,1,1
25175,तिमाही,0,0,1,1
17413,crowdsourcing ,0,0,1,1
19955,treffpunkt,0,0,1,1
19942,ಒಳ್ಳೆಯವರಾಗಿದ್ದರು,0,0,1,1
19943,latitudinal,0,0,1,1
19945,travels,0,0,1,1
19946,ಒಪ್ಪುವುದು,0,0,1,1
19948,cirkler,0,0,1,1
19949,बेनाम,0,0,1,1
19953,नॉर्वेजियाई,0,0,1,1
19956,ಸಮತೋಲಿತ,0,0,1,1
19973,νωθρός,0,0,1,1
19958,combinou,0,0,1,1
19959,رائعا،,0,0,1,1
19961,proclamé,0,0,1,1
19966,எவ்வாறு,0,0,1,1
19967,galet,0,0,1,1
19970,boğuluyorum,0,0,1,1
19971,കൂടിക്കാഴ്ചയ്ക്ക്,0,0,1,1
19941,construire,0,0,1,1
19938,научным,0,0,1,1
19937,நுபீடியாவும்,0,0,1,1
19936,dichotomy,0,0,1,1
19914,ειδήμονες,0,0,1,1
19915,തടയുവാനായി,0,0,1,1
19916,regardait,0,0,1,1
19920,«lo,0,0,1,1
19922,पंजाबी,0,0,1,1
19923,интернетэнциклопедия,0,0,1,1
19924,نقل,0,0,1,1
19928,சோகமாகவோ,0,0,1,1
19929,uitdrukkelijk,0,0,1,1
19930,βιασμού,0,0,1,1
19931,социальной,0,0,1,1
19932,لتشمل,0,0,1,1
19933,ಕೋನದಲ್ಲಿ,0,0,1,1
19934,нейтральная,0,0,1,1
19935,wikipediaträff,0,0,1,1
19972,« communauté »,0,0,1,1
19974,преодолении,0,0,1,1
20026,felter,0,0,1,1
20010,mariée,0,0,1,1
20002,критику,0,0,1,1
20003,escritores,0,0,1,1
20005,pipa—by,0,0,1,1
20006,apresentados,0,0,1,1
20007,ஒன்றுசேர்ந்து,0,0,1,1
20008,tomos—,0,0,1,1
20009,bouleversé,0,0,1,1
20013,"rely
heavily",0,0,1,1
19975,lineales,0,0,1,1
20014,processadas,0,0,1,1
20015,specifiek,0,0,1,1
20016,"
विनैरे",0,0,1,1
20017,متعارضين,0,0,1,1
20019,franchi,0,0,1,1
20021,esfuerzos,0,0,1,1
20024,انتقاد,0,0,1,1
20001,​​aos,0,0,1,1
20000,historiquement,0,0,1,1
19998,convention,0,0,1,1
19994,விக்கிப்பீடியாவும்,0,0,1,1
19976,dinin,0,0,1,1
19977,arbetslivserfarenhet,0,0,1,1
19979,закончить,0,0,1,1
19980,δικαιοδοσίας,0,0,1,1
19981,लिखता,0,0,1,1
19982,الرغبة,0,0,1,1
19983,statisticians,0,0,1,1
19984,easiest,0,0,1,1
19985,estupro,0,0,1,1
19986,productive,0,0,1,1
19987,voel,0,0,1,1
19988,процессу,0,0,1,1
19989,истина»,0,0,1,1
19992,взглянуть,0,0,1,1
19993,terres,0,0,1,1
19913,بوميس،,0,0,1,1
19912,¿tiene,0,0,1,1
19911,സംഭവിക്കാം,0,0,1,1
19844,illustrera,0,0,1,1
19835,ущерб,0,0,1,1
19836,mjölstädarna,0,0,1,1
19837,والعالم،,0,0,1,1
19838,ಹೋಗುತ್ತೇವೆ,0,0,1,1
19841,സമ്പർക്കം,0,0,1,1
19842,bedrijven,0,0,1,1
19843,verrichten,0,0,1,1
19845,πνιγμό,0,0,1,1
19909,"
एस्टोनीयाई",0,0,1,1
19846,valorize,0,0,1,1
19847,şeklim,0,0,1,1
19849,सहन,0,0,1,1
19850,ആയിരക്കണക്കിനു,0,0,1,1
19851,değildi,0,0,1,1
19852,tanınıyor,0,0,1,1
19854,συναρπαστικό,0,0,1,1
19834,quantify,0,0,1,1
19832,afrika,0,0,1,1
19830,столкнулся,0,0,1,1
19828,entscheidungen,0,0,1,1
19809,antwoorden,0,0,1,1
19810,называемые,0,0,1,1
19811,बाद।,0,0,1,1
19812,пародий,0,0,1,1
19813,occurrences,0,0,1,1
19816,реализованная,0,0,1,1
19817,lichte,0,0,1,1
19818,älskade,0,0,1,1
19819,موثوقة,0,0,1,1
19820,شديد,0,0,1,1
19822,വെള്ളിയാഴ്ചയാണെങ്കിൽ,0,0,1,1
19823,испечь,0,0,1,1
19824,ಅನ್ವಯವಾಗುವ,0,0,1,1
19825,syriska,0,0,1,1
19827,miré,0,0,1,1
19856,opkijken,0,0,1,1
19857,constantly,0,0,1,1
19858,नकली,0,0,1,1
19886,ಹುಡುಕುತ್ತಿದ್ದೇವೆ,0,0,1,1
19889,золотым,0,0,1,1
19890,publicarse,0,0,1,1
19891,detectados,0,0,1,1
19893,старых,0,0,1,1
19894,கேட்காதபோது,0,0,1,1
19895,оптимизации,0,0,1,1
19896,läsas,0,0,1,1
19898,заносят,0,0,1,1
19901,colaboran,0,0,1,1
19902,редактора,0,0,1,1
19904,противоположностью,0,0,1,1
19905,preguntado,0,0,1,1
19906,عفوا؟,0,0,1,1
19907,oneself,0,0,1,1
19908,सइबरआर्ट्स,0,0,1,1
19888,pés,0,0,1,1
19882,импактфактор,0,0,1,1
19859,defines,0,0,1,1
19881,планет»,0,0,1,1
19860,ಸಮಸ್ಯೆಗಿಂತ,0,0,1,1
19862,تمتد,0,0,1,1
19863,εξέπληξε,0,0,1,1
19864,kinderpornografie,0,0,1,1
19865,ಬಯಸುವಿರಾ,0,0,1,1
19866,utformat,0,0,1,1
19867,ومعظم,0,0,1,1
19870,πληκτρολογήστε,0,0,1,1
19871,الربح,0,0,1,1
19872,المدهشة,0,0,1,1
19873,damos,0,0,1,1
19874,பயன்படுத்துவதன்,0,0,1,1
19878,visera,0,0,1,1
19879,vaters,0,0,1,1
19880,സ്വാഭാവികമായി,0,0,1,1
20025,vikipedisine,0,0,1,1
20029,sufrido,0,0,1,1
20272,göklerin,0,0,1,1
20193,olduğunda,0,0,1,1
20184,ஆவார்,0,0,1,1
20185,pologne,0,0,1,1
20186,تطوّر,0,0,1,1
20187,പ്രശസ്തി,0,0,1,1
20188,godaste,0,0,1,1
20190,нажали,0,0,1,1
20192,doradas,0,0,1,1
20195,executados,0,0,1,1
20212,anzurufen,0,0,1,1
20196,मैनर्स,0,0,1,1
20197,neuroscience,0,0,1,1
20199,motstridiga,0,0,1,1
20200,ಶುಕ್ರವಾರವಾಗಿದ್ದರೆ,0,0,1,1
20202,ಅಭ್ಯಾಸವನ್ನು,0,0,1,1
20207,ഒറിയ,0,0,1,1
20209,ഭാ‍ഷകളിലെ,0,0,1,1
20183,aangenaam,0,0,1,1
20182,intragável,0,0,1,1
20181,അവതരിപ്പിക്കുമ്പോൾ,0,0,1,1
20180,உறுதிப்படுத்தப்படுகின்றன,0,0,1,1
20158,अनुभाग,0,0,1,1
20160,fitted,0,0,1,1
20162,dependence,0,0,1,1
20164,"
जर्मन",0,0,1,1
20165,umulig,0,0,1,1
20166,فرد,0,0,1,1
20167,relatado,0,0,1,1
20169,ξαφνιασμένος,0,0,1,1
20170,κουδούνι,0,0,1,1
20171,generalizar,0,0,1,1
20172,सूत्रपात,0,0,1,1
20173,bardakçı’nın,0,0,1,1
20175,"
म्यान्मारी",0,0,1,1
20176,περιγραφής,0,0,1,1
20177,особенных,0,0,1,1
20211,vallely,0,0,1,1
20213,skrivit,0,0,1,1
20030,visualiseringsverktyg,0,0,1,1
20257,driveway,0,0,1,1
20245,kæpheste,0,0,1,1
20247,τάξη,0,0,1,1
20248,parenthèses,0,0,1,1
20249,ligeglad,0,0,1,1
20250,ಕೆಟ್ಟದು,0,0,1,1
20252,கவனிப்பதில்லை,0,0,1,1
20254,отсутствующим,0,0,1,1
20258,debattörer,0,0,1,1
20214,consiguió,0,0,1,1
20262,кислоту —,0,0,1,1
20264,നമ്മുടെ,0,0,1,1
20266,vaud,0,0,1,1
20267,éclairer,0,0,1,1
20268,snowball,0,0,1,1
20269,rundgång,0,0,1,1
20270,voeren,0,0,1,1
20244,globala,0,0,1,1
20241,deletionism,0,0,1,1
20240,söyleyebilirim,0,0,1,1
20239,düster,0,0,1,1
20216,conocidas,0,0,1,1
20217,डार्टमाउथ,0,0,1,1
20218,دلهي,0,0,1,1
20219,fließender,0,0,1,1
20221,"
फ़ारसी",0,0,1,1
20226,محررون,0,0,1,1
20227,आर्टिकल,0,0,1,1
20228,معرفي,0,0,1,1
20229,nutzen,0,0,1,1
20230,அரைப்,0,0,1,1
20232,متردد,0,0,1,1
20233,ಪ್ರಯಾಣವನ್ನು,0,0,1,1
20235,корневые,0,0,1,1
20236,bevatten,0,0,1,1
20238,« neutralité,0,0,1,1
20156,ಕಾಮೆಂಟ್‌ಗಳ,0,0,1,1
20152,proíbe,0,0,1,1
20150,—tal,0,0,1,1
20075,atordoado,0,0,1,1
20066,pudiendo,0,0,1,1
20067,bırakmamı,0,0,1,1
20068,géomagnétiqueréf,0,0,1,1
20069,apesar,0,0,1,1
20070,"
telugu",0,0,1,1
20072,விஷயத்தில்,0,0,1,1
20073,nachzudenken,0,0,1,1
20076,கலைக்களஞ்சியங்களைப்,0,0,1,1
20147,planerar,0,0,1,1
20077,amérique,0,0,1,1
20078,lisanslama,0,0,1,1
20079,overrasker,0,0,1,1
20080,raderingspolicy,0,0,1,1
20082,उज्ज्वल,0,0,1,1
20084,"
अल्बानियाई",0,0,1,1
20085,விரும்புவீர்கள்,0,0,1,1
20062,separately,0,0,1,1
20061,للزواج,0,0,1,1
20058,للدلالة,0,0,1,1
20057,oftare,0,0,1,1
20031,കുഴഞ്ഞുമറിഞ്ഞ,0,0,1,1
20032,visitante,0,0,1,1
20036,accélérer,0,0,1,1
20037,passing,0,0,1,1
20039,अभिधान,0,0,1,1
20041,نسخ,0,0,1,1
20042,வழங்கப்போகிறேன்,0,0,1,1
20046,varelser,0,0,1,1
20048,ಕೊಳಕು,0,0,1,1
20050,contraste,0,0,1,1
20052,நர்சிசாவும்,0,0,1,1
20053,தகுதியானவள்,0,0,1,1
20054,ഭൂമി,0,0,1,1
20055,mande,0,0,1,1
20056,kontrolleras,0,0,1,1
20086,suddas,0,0,1,1
20087,souvenezvous,0,0,1,1
20088,koymayı,0,0,1,1
20121,bildiğim,0,0,1,1
20126,"





o
n
i
o
n
s

p
o
t
a
t
o
e
s


⇒


b
u
r
g
e
r




displaystyle",0,0,1,1
20128,androidbased,0,0,1,1
20129,utility,0,0,1,1
20130,impulsó,0,0,1,1
20131,അതിശയകരമാംവിധം,0,0,1,1
20132,confiança,0,0,1,1
20133,erbij,0,0,1,1
20136,nan,0,0,1,1
20137,تقليدًا,0,0,1,1
20139,പഴയ,0,0,1,1
20141,funcionalidades,0,0,1,1
20143,rencontrez,0,0,1,1
20144,daquele,0,0,1,1
20145,stap,0,0,1,1
20146,quaisquer,0,0,1,1
20125,السؤال,0,0,1,1
20120,использована,0,0,1,1
20089,ഭാര്യയായിരിക്കേണ്ട,0,0,1,1
20118,ഇരിക്കുന്നതായും,0,0,1,1
20091,நினைக்கிறாய்,0,0,1,1
20092,incorporate,0,0,1,1
20093,विरोधाभासी,0,0,1,1
20095,продолжим,0,0,1,1
20099,kød,0,0,1,1
20101,ഇക്കാലത്ത്,0,0,1,1
20102,ಬಣ್ಣದ್ದಾಗಿತ್ತು,0,0,1,1
20104,दान,0,0,1,1
20105,أجل,0,0,1,1
20107,gaming,0,0,1,1
20108,bewijst,0,0,1,1
20111,வைக்கிறேன்,0,0,1,1
20115,ബുദ്ധിശൂന്യതയാണെന്നാണ്,0,0,1,1
20116,आगंतुक,0,0,1,1
20117,ansigt,0,0,1,1
19807,conversar,0,0,1,1
19806,സ്ത്രീ,0,0,1,1
19805,المشاركون,0,0,1,1
19501,yavaştır,0,0,1,1
19488,сославшись,0,0,1,1
19491,erzählte,0,0,1,1
19492,usergenerated,0,0,1,1
19493,documentering,0,0,1,1
19495,بعلامة,0,0,1,1
19496,uniform,0,0,1,1
19500,запущенная,0,0,1,1
19502,ಇದುವರೆಗೆ,0,0,1,1
19518,растерянной,0,0,1,1
19503,resmi,0,0,1,1
19504,envis,0,0,1,1
19505,guldbrød,0,0,1,1
19507,الحظر,0,0,1,1
19509,labs,0,0,1,1
19512,asiáticas,0,0,1,1
19513,zorundasın,0,0,1,1
19485,skydda,0,0,1,1
19483,सर्वाधिक,0,0,1,1
19481,उपडोमेन,0,0,1,1
19479,സൗകര്യമുണ്ട്,0,0,1,1
19455,beroende,0,0,1,1
19456,opdagelse,0,0,1,1
19457,næse,0,0,1,1
19459,intègrent,0,0,1,1
19461,отражении,0,0,1,1
19463,ಹಂತವನ್ನು,0,0,1,1
19466,incompetent,0,0,1,1
19468,ഭക്ഷണങ്ങൾ,0,0,1,1
19469,प्राथमिकता,0,0,1,1
19472,признал,0,0,1,1
19473,felicitaties,0,0,1,1
19474,вкуса,0,0,1,1
19475,ഗംഭീരവുമായ,0,0,1,1
19476,ustedes,0,0,1,1
19477,extraheren,0,0,1,1
19517,interwikis,0,0,1,1
19521,சைர்,0,0,1,1
19804,δεύτερο,0,0,1,1
19562,ijsje,0,0,1,1
19553,ಬದಲಾಯಿಸಿದಳು,0,0,1,1
19554,பயன்படுத்தப்பட்டது,0,0,1,1
19555,afastase,0,0,1,1
19556,nouvel,0,0,1,1
19557,nullius,0,0,1,1
19558,ошибок,0,0,1,1
19561,الرئيس,0,0,1,1
19563,dondurmaya,0,0,1,1
19522,വിക്കിപീഡിയയിലുണ്ടാകാറുണ്ട്,0,0,1,1
19564,dr,0,0,1,1
19565,clasificado,0,0,1,1
19566,حاولت,0,0,1,1
19567,دروسي,0,0,1,1
19568,inseridas,0,0,1,1
19569,ஆண்டுகளாக,0,0,1,1
19571,tendent,0,0,1,1
19551,reflejo,0,0,1,1
19550,يتقاضون,0,0,1,1
19549,anunciaram,0,0,1,1
19548,സൂപ്പിലോ,0,0,1,1
19523,brion,0,0,1,1
19525,retirar,0,0,1,1
19526,نطقك,0,0,1,1
19529,वास्तुकला,0,0,1,1
19530,targeted,0,0,1,1
19532,girdi,0,0,1,1
19534,معالجة,0,0,1,1
19535,സമതുലിതമായ,0,0,1,1
19536,missnöje,0,0,1,1
19539,gestern,0,0,1,1
19540,concebida,0,0,1,1
19542,doy,0,0,1,1
19544,лишена,0,0,1,1
19545,sorular,0,0,1,1
19546,حياتها,0,0,1,1
19454,ευγενική,0,0,1,1
19453,عنك؟,0,0,1,1
19452,pişirmeme,0,0,1,1
19374,sexist,0,0,1,1
19362,ಬ್ರೆಡ್ನೊಂದಿಗೆ,0,0,1,1
19363,meteorite,0,0,1,1
19366,mi‑,0,0,1,1
19367,сведений,0,0,1,1
19368,gedik,0,0,1,1
19370,appointment,0,0,1,1
19372,ज़ेड,0,0,1,1
19375,wpartikel,0,0,1,1
19451,domestic,0,0,1,1
19376,moléculas,0,0,1,1
19378,ദ്രുത,0,0,1,1
19379,விட்டுவிட்டால்,0,0,1,1
19381,tenir,0,0,1,1
19382,lanceret,0,0,1,1
19383,aceite,0,0,1,1
19393,законах,0,0,1,1
19361,recurso,0,0,1,1
19360,скрыты,0,0,1,1
19359,ಸೈನಿಕರಿಗೆ,0,0,1,1
19358,desejar,0,0,1,1
19332,injokes,0,0,1,1
19333,captured,0,0,1,1
19334,¿sabrías,0,0,1,1
19335,an ,0,0,1,1
19337,işin,0,0,1,1
19339,présenté,0,0,1,1
19340,अनगिनत,0,0,1,1
19343,انطلقت,0,0,1,1
19345,"
सिलीसियाई",0,0,1,1
19346,മിനിറ്റുകൾക്കുള്ളിൽ,0,0,1,1
19347,يعانون,0,0,1,1
19348,докладах,0,0,1,1
19351,नरसी,0,0,1,1
19356,pleasant,0,0,1,1
19357,موجودة,0,0,1,1
19395,segredo,0,0,1,1
19396,kullanabilirler,0,0,1,1
19397,مهذبًا,0,0,1,1
19427,bidragydere,0,0,1,1
19429,hémisphère,0,0,1,1
19432,മഹായുദ്ധസമയത്ത്,0,0,1,1
19433,बोलियों,0,0,1,1
19434,wasser,0,0,1,1
19437,மாணிக்கங்களில்,0,0,1,1
19439,മുന്നോട്ടുപോകുന്നത്,0,0,1,1
19440,कब,0,0,1,1
19442,πρόσφατα,0,0,1,1
19443,favoriet,0,0,1,1
19445,veamos,0,0,1,1
19446,dvdwikimediaorg,0,0,1,1
19447,многих,0,0,1,1
19448,grupparbeten,0,0,1,1
19449,experiments,0,0,1,1
19450,educativo,0,0,1,1
19428,himmel,0,0,1,1
19425,الممارسة,0,0,1,1
19398,sony,0,0,1,1
19424,διαδικτυακή,0,0,1,1
19399,kafaları,0,0,1,1
19400,förhållanden,0,0,1,1
19401,diversiteit,0,0,1,1
19403,दुविधा,0,0,1,1
19404,ಬಂದಿತು,0,0,1,1
19406,подойди,0,0,1,1
19409,मां,0,0,1,1
19410,ചോദ്യചിഹ്നത്തിലൂടെയും,0,0,1,1
19411,expression »,0,0,1,1
19412,مستحيلًا,0,0,1,1
19414,എന്തുപറയുന്നു,0,0,1,1
19419,specificity,0,0,1,1
19420,escuchar,0,0,1,1
19422,supposons,0,0,1,1
19423,kültürel,0,0,1,1
19573,إعلانات،,0,0,1,1
19574,हित,0,0,1,1
19577,столом,0,0,1,1
19740,prouver,0,0,1,1
19727,தன்மையாலும்,0,0,1,1
19728,cinquième,0,0,1,1
19731,nupedias,0,0,1,1
19732,ತಿಂಗಳುಗಳವರೆಗೆ,0,0,1,1
19733,poleret,0,0,1,1
19736,structuur,0,0,1,1
19737,प्राधिकारी,0,0,1,1
19741,honnêtement,0,0,1,1
19692,strikser,0,0,1,1
19743,തിരുത്തലുകളോട്,0,0,1,1
19745,bedekken,0,0,1,1
19748,promoted,0,0,1,1
19749,investigador,0,0,1,1
19751,visitou,0,0,1,1
19752,αντιμετωπίζονται,0,0,1,1
19754,ihtiyacınız,0,0,1,1
19725,ஆணியை,0,0,1,1
19724,ming,0,0,1,1
19723,thorough,0,0,1,1
19722,archipelagos,0,0,1,1
19696,мгновенно,0,0,1,1
19697,zur,0,0,1,1
19698,ونحتاج,0,0,1,1
19702,википедия —,0,0,1,1
19703,razão,0,0,1,1
19704,edelim,0,0,1,1
19706,जानी,0,0,1,1
19707,யோங்களே,0,0,1,1
19709,disposez,0,0,1,1
19711,"
हिब्रू",0,0,1,1
19714,buscan,0,0,1,1
19716,digitala,0,0,1,1
19717,रफ्तार,0,0,1,1
19718,forskaren,0,0,1,1
19719,مغرورًا,0,0,1,1
19757,वाशिंगटन,0,0,1,1
19759,pixels,0,0,1,1
19760,എഡിറ്റർമാർ,0,0,1,1
19783,ответ»,0,0,1,1
19786,stupéfait,0,0,1,1
19787,സംഭാഷണവും,0,0,1,1
19788,afastandose,0,0,1,1
19790,पहने,0,0,1,1
19791,flavio,0,0,1,1
19792,collègues,0,0,1,1
19793,единственном,0,0,1,1
19794,اقتراحك,0,0,1,1
19795,onéreusement,0,0,1,1
19796,σήμα,0,0,1,1
19798,rejecting,0,0,1,1
19799,construída,0,0,1,1
19800,escritura,0,0,1,1
19801,диалекты,0,0,1,1
19803,εκλεπτυσμένη,0,0,1,1
19784,"
डैनिश",0,0,1,1
19781,हटाया,0,0,1,1
19761,മന്ദത,0,0,1,1
19780,viktig,0,0,1,1
19762,ошибаетесь,0,0,1,1
19764,"
बुगिनी",0,0,1,1
19765,cümleye,0,0,1,1
19766,atribuição,0,0,1,1
19767,palacio,0,0,1,1
19769,زيادة,0,0,1,1
19771,ஆறாவது,0,0,1,1
19772,saw,0,0,1,1
19773,παραδέχεστε,0,0,1,1
19774,introducen,0,0,1,1
19775,للكتب,0,0,1,1
19776,النموذج,0,0,1,1
19777,иной,0,0,1,1
19778,выпуск,0,0,1,1
19779,रीडायरेक्शन,0,0,1,1
19695,உண்மையான,0,0,1,1
19690,killer—a,0,0,1,1
19578,continuent,0,0,1,1
19612,basisgroeten,0,0,1,1
19603,söyleyebileceğinizden,0,0,1,1
19605,जुलती,0,0,1,1
19607,காக்கப்படுகின்றன,0,0,1,1
19608,அதிர்ஷ்டத்தின்,0,0,1,1
19609,предложено,0,0,1,1
19610,intrinsic,0,0,1,1
19611,вялыми,0,0,1,1
19613,permitting,0,0,1,1
19687,ഇന്നലെ,0,0,1,1
19615,tonfalls,0,0,1,1
19617,ಯೋಚಿಸಲು,0,0,1,1
19618,evlendikten,0,0,1,1
19620,trials,0,0,1,1
19621,militär,0,0,1,1
19626,βεβαιωθείτε,0,0,1,1
19627,restringidas,0,0,1,1
19602,одет,0,0,1,1
19601,лицензированная,0,0,1,1
19600,males,0,0,1,1
19599,gördüğünüzü,0,0,1,1
19579,науке,0,0,1,1
19580,foulée,0,0,1,1
19582,പദ്ധതിയിടുന്നു,0,0,1,1
19583,actuele,0,0,1,1
19584,специалистами,0,0,1,1
19585,реляционную,0,0,1,1
19586,yeah,0,0,1,1
19588,forstår,0,0,1,1
19589,സംരക്ഷിക്കേണ്ട,0,0,1,1
19591,أثبتت,0,0,1,1
19592,ಕೇಳುತ್ತಿದೆ,0,0,1,1
19593,точек,0,0,1,1
19595,industrializados,0,0,1,1
19596,небольшую,0,0,1,1
19597,географических,0,0,1,1
19628,маленький,0,0,1,1
19629,kaydı,0,0,1,1
19631,συγχαρητήρια,0,0,1,1
19656,d’extrapolation,0,0,1,1
19660,permaneció,0,0,1,1
19661,சுவேவ்,0,0,1,1
19662,voluntarily,0,0,1,1
19665,previa,0,0,1,1
19666,культуре,0,0,1,1
19668,ഒരൊറ്റ,0,0,1,1
19669,அறிவும்,0,0,1,1
19673,encontrarás,0,0,1,1
19674,stumt,0,0,1,1
19675,danois,0,0,1,1
19676,примечательно,0,0,1,1
19679,descobrem,0,0,1,1
19680,വിക്കിപീഡിയയ്ക്ക്,0,0,1,1
19682,barrage,0,0,1,1
19685,сломался,0,0,1,1
19659,сбывается,0,0,1,1
19655,ഐക്കൺ,0,0,1,1
19633,webbpubliceringssystem,0,0,1,1
19654,மைஸ்பேஸ்,0,0,1,1
19634,trompez,0,0,1,1
19635,تبكي؟,0,0,1,1
19636,أنا؟,0,0,1,1
19637,ml •,0,0,1,1
19638,بالمقارنة،,0,0,1,1
19640,युद्ध,0,0,1,1
19641,hardnekkiger,0,0,1,1
19643,या।,0,0,1,1
19644,valde,0,0,1,1
19645,arreglado,0,0,1,1
19646,conservatrice,0,0,1,1
19647,स्वामित्व,0,0,1,1
19648,treatment,0,0,1,1
19650,nanotechnologies,0,0,1,1
19653,qualify,0,0,1,1
20271,—dirigidas,0,0,1,1
20275,रुकें।,0,0,1,1
19328,يحالف,0,0,1,1
20944,கொள்கை,0,0,1,1
20935,ಗೊಂದಲಕ್ಕೊಳಗಾಗಿದ್ದರೆ,0,0,1,1
20936,общее,0,0,1,1
20937,tomando,0,0,1,1
20939,lektier,0,0,1,1
20940,clouds,0,0,1,1
20942,വിവരണ,0,0,1,1
20943,ഉപയോഗിക്കരുത്,0,0,1,1
20945,успеха,0,0,1,1
20961,القراء،,0,0,1,1
20946,متفاجئة,0,0,1,1
20950,"
नेपाली",0,0,1,1
20952,рыцаря,0,0,1,1
20953,адекватному,0,0,1,1
20954,geautomatiseerde,0,0,1,1
20957,royaumeuni,0,0,1,1
20958,положительных,0,0,1,1
20933,starka,0,0,1,1
20932,emerged,0,0,1,1
20931,ccbysanl,0,0,1,1
20930,vackraste,0,0,1,1
20911,തത്ത്വത്തിലാണ്,0,0,1,1
20912,développées,0,0,1,1
20913,использовали,0,0,1,1
20914,وفهرسة,0,0,1,1
20915,taux,0,0,1,1
20916,гдето,0,0,1,1
20917,осуществляет,0,0,1,1
20918,cuides,0,0,1,1
20919,للولايات,0,0,1,1
20921,теста,0,0,1,1
20922,ರವಾನಿಸಬಹುದೇ,0,0,1,1
20924,mk •,0,0,1,1
20927,remoção,0,0,1,1
20928,título,0,0,1,1
20929,أدخلت,0,0,1,1
20959,விடைபெற்று,0,0,1,1
20963,basisinstructies,0,0,1,1
21020,dimwitted,0,0,1,1
21004,bedraagt,0,0,1,1
20991,totalités,0,0,1,1
20993,المتدلية,0,0,1,1
20994,தொடங்கியது,0,0,1,1
20995,лечатся,0,0,1,1
20996,religious,0,0,1,1
20997,மாட்டீர்கள்,0,0,1,1
21000,обеспечению,0,0,1,1
21005,stupid,0,0,1,1
20964,झटके,0,0,1,1
21006,تحديداً,0,0,1,1
21007,heterotrophic,0,0,1,1
21009,издательство,0,0,1,1
21011,ஏதோ,0,0,1,1
21012,vienes,0,0,1,1
21014,fatores,0,0,1,1
21015,homogénéité,0,0,1,1
20990,पुरुषों,0,0,1,1
20988,authorities,0,0,1,1
20987,rival,0,0,1,1
20985,officielt,0,0,1,1
20965,refere,0,0,1,1
20966,onlardan,0,0,1,1
20968,factchallenged,0,0,1,1
20969,mythologies,0,0,1,1
20970,συνέχεια,0,0,1,1
20971,"
बोस्नियाई",0,0,1,1
20972,ಮೊದಲನೆಯದನ್ನು,0,0,1,1
20974,mükemmele,0,0,1,1
20975,удивлена,0,0,1,1
20977,birth,0,0,1,1
20979,ವಾಸಿಸುತ್ತಿದ್ದಳು,0,0,1,1
20980,şaşırttığında,0,0,1,1
20981,γειά,0,0,1,1
20983,έκδοση,0,0,1,1
20984,πλυντήριο,0,0,1,1
20910,تصبح,0,0,1,1
20909,επιτύχει,0,0,1,1
20908,सिटिज़नडियम,0,0,1,1
20813,arkadaş,0,0,1,1
20800,bedömningen,0,0,1,1
20801,sustainability,0,0,1,1
20802,απίστευτα,0,0,1,1
20804,people”,0,0,1,1
20807,बनायें,0,0,1,1
20810,finder,0,0,1,1
20812,ಬೆಳೆಯುತ್ತಾಳೆ,0,0,1,1
20815,மக்களுக்கு,0,0,1,1
20905,estructuras,0,0,1,1
20816,koffie,0,0,1,1
20821,ritter,0,0,1,1
20822,tabiki,0,0,1,1
20824,concurrent,0,0,1,1
20825,gehirn,0,0,1,1
20826,ಕುಳಿತಿದ್ದ,0,0,1,1
20829,आधिकारिक,0,0,1,1
20799,admiración,0,0,1,1
20797,indonesian,0,0,1,1
20796,​​​​,0,0,1,1
20795,ಶಾಲೆಯಿಂದ,0,0,1,1
20767,साक्षात्कार,0,0,1,1
20769,إل,0,0,1,1
20770,нужна,0,0,1,1
20771,undécimo,0,0,1,1
20773,vandalizados,0,0,1,1
20778,وسأل,0,0,1,1
20779,yemekte,0,0,1,1
20785,ചാനലിലേക്ക്,0,0,1,1
20786,tröskeln,0,0,1,1
20787,ಸ್ವಾತಂತ್ರ್ಯವಿಲ್ಲ,0,0,1,1
20789,concludeerde,0,0,1,1
20790,aics,0,0,1,1
20791,أكتوبر,0,0,1,1
20792,kalmasını,0,0,1,1
20794,أخفيه,0,0,1,1
20830,ergo,0,0,1,1
20832,സൂക്ഷിച്ച്,0,0,1,1
20833,repetiam,0,0,1,1
20869,"
असमिया",0,0,1,1
20872,സ്യൂട്ടർമാർ,0,0,1,1
20873,ஆரம்பித்து,0,0,1,1
20874,redistribuer,0,0,1,1
20875,kennenzulernen,0,0,1,1
20876,ಲಾಂಡ್ರಿಗೆ,0,0,1,1
20877,bereiken,0,0,1,1
20878,കാര്യത്തെക്കുറിച്ച്,0,0,1,1
20879,niks,0,0,1,1
20880,ανόητο,0,0,1,1
20888,nutteloos,0,0,1,1
20890,πραγματική,0,0,1,1
20894,welldefined,0,0,1,1
20896,αστεροειδών,0,0,1,1
20897,argumentaram,0,0,1,1
20903,refereed,0,0,1,1
20870,administrateurs,0,0,1,1
20868,പരിഹാരത്തിലാണെന്ന്,0,0,1,1
20834,nl,0,0,1,1
20865,licorne,0,0,1,1
20835,подарок,0,0,1,1
20836,f,0,0,1,1
20837,отношения,0,0,1,1
20841,wikienciclopédias,0,0,1,1
20842,اجمع,0,0,1,1
20849,какието,0,0,1,1
20850,oturuyor,0,0,1,1
20851,लगाना,0,0,1,1
20854,describió,0,0,1,1
20855,இருவர்,0,0,1,1
20856,hushålls,0,0,1,1
20861,buradan,0,0,1,1
20862,save,0,0,1,1
20863,discurso,0,0,1,1
20864,miraban,0,0,1,1
21019,berlim,0,0,1,1
21021,interchange,0,0,1,1
20276,rápido»​,0,0,1,1
21198,തമിഴ്,0,0,1,1
21186,പറ്റുമോ,0,0,1,1
21187,mains,0,0,1,1
21190,നന്നാക്കുന്നതിലൂടെ,0,0,1,1
21191,instrucciones,0,0,1,1
21192,பெரிதுபடுத்த,0,0,1,1
21194,aplicações,0,0,1,1
21196,ಮೂಲವೆಂದರೆ,0,0,1,1
21199,¿de,0,0,1,1
21211,removal,0,0,1,1
21200,buys,0,0,1,1
21201,éclairé,0,0,1,1
21203,चीयर्स,0,0,1,1
21204,புரியாத,0,0,1,1
21205,webbrowsere,0,0,1,1
21208,artiste,0,0,1,1
21209,озаглавленный,0,0,1,1
21185,होगी,0,0,1,1
21184,идея,0,0,1,1
21183,تعاونية,0,0,1,1
21181,arduamente,0,0,1,1
21155,ഒരാളുടെ,0,0,1,1
21159,പുലർത്തുക,0,0,1,1
21161,continuarmos,0,0,1,1
21163,கண்காணிப்பு,0,0,1,1
21165,fechamento,0,0,1,1
21167,स्मृति,0,0,1,1
21169,umarım,0,0,1,1
21170,തന്നെയില്ല,0,0,1,1
21172,branden,0,0,1,1
21173,കൂട്ടായ,0,0,1,1
21174,soumises,0,0,1,1
21175,कक्ष,0,0,1,1
21176,للمجتمع،,0,0,1,1
21178,δοκίμιό,0,0,1,1
21180,profundo,0,0,1,1
21210,sorulduğunda,0,0,1,1
21213,रेवोलुशन,0,0,1,1
21022,الإداريون،,0,0,1,1
21256,υψηλότερης,0,0,1,1
21244,certainly,0,0,1,1
21245,sunuş,0,0,1,1
21246,adquirimos,0,0,1,1
21248,കാര്യനിർവ്വാഹർക്കുണ്ട്,0,0,1,1
21250,abonnere,0,0,1,1
21251,nachricht,0,0,1,1
21254,நிறுத்தினோம்,0,0,1,1
21258,titres,0,0,1,1
21214,nueva,0,0,1,1
21259,limitó,0,0,1,1
21260,ವಾಸ್ತವವಾಗಿ,0,0,1,1
21261,இருந்ததைப்,0,0,1,1
21262,querría,0,0,1,1
21263,القرصنة,0,0,1,1
21264,möjliggör,0,0,1,1
21265,dieux,0,0,1,1
21241,ಬೆಲ್,0,0,1,1
21240,kökü,0,0,1,1
21239,одолжить,0,0,1,1
21238,भावना,0,0,1,1
21216,doncellas,0,0,1,1
21218,—número,0,0,1,1
21220,осознать,0,0,1,1
21221,തിരുത്താൻ,0,0,1,1
21222,مفتوحًا,0,0,1,1
21223,× kilograms,0,0,1,1
21224,allmänt,0,0,1,1
21228,നൈറ്റിനെയോ,0,0,1,1
21230,αποχαιρετήσει,0,0,1,1
21231,кэшем,0,0,1,1
21233,نقلاً,0,0,1,1
21234,सम्मानित,0,0,1,1
21235,வழிமுறைகளைப்,0,0,1,1
21236,العرض,0,0,1,1
21237,स्पार्कली,0,0,1,1
21154,επιθετικό,0,0,1,1
21151,സാധ്യമല്ല,0,0,1,1
21148,equator,0,0,1,1
21072,piecemeal,0,0,1,1
21062,« valeur »,0,0,1,1
21063,போகலாம்,0,0,1,1
21064,ಲೈಬ್ರರಿ,0,0,1,1
21065,redigerar,0,0,1,1
21067,έρχεστε,0,0,1,1
21069,настоянию,0,0,1,1
21071,छोटा,0,0,1,1
21073,കണ്ടിട്ടുള്ളതിൽ,0,0,1,1
21145,கருத்துக்,0,0,1,1
21076,союзе,0,0,1,1
21077,توزيع,0,0,1,1
21078,γενικά,0,0,1,1
21080,تسوية,0,0,1,1
21081,hubo,0,0,1,1
21083,alleged,0,0,1,1
21087,"
रोमानियाई",0,0,1,1
21060,solicitado,0,0,1,1
21059,ടൂറിസ്റ്റിലോ,0,0,1,1
21055,linking,0,0,1,1
21053,sentó,0,0,1,1
21023,tabağımda,0,0,1,1
21025,ಸಂತೋಷದಿಂದ,0,0,1,1
21027,devese,0,0,1,1
21028,начале,0,0,1,1
21030,ஆதாரம்,0,0,1,1
21035,ayuda,0,0,1,1
21036,bestempeld,0,0,1,1
21037,radera,0,0,1,1
21038,medido,0,0,1,1
21040,ஓர்,0,0,1,1
21042,intensive,0,0,1,1
21044,bekle,0,0,1,1
21045,मॉडल,0,0,1,1
21046,présents,0,0,1,1
21052,fotosafari,0,0,1,1
21088,vrolijken,0,0,1,1
21092,végétale,0,0,1,1
21093,obs,0,0,1,1
21120,شروط,0,0,1,1
21123,redistribuição,0,0,1,1
21126,கூட்டாக்க,0,0,1,1
21127,opgevangen,0,0,1,1
21129,nearperfect,0,0,1,1
21130,பட்டியலூடாக,0,0,1,1
21131,continuaba,0,0,1,1
21132,ആഗ്രഹിക്കുകയും,0,0,1,1
21135,aspects,0,0,1,1
21136,tourne,0,0,1,1
21138,læse,0,0,1,1
21139,trokken,0,0,1,1
21140,يفعله,0,0,1,1
21141,gelächelt,0,0,1,1
21142,policy—which,0,0,1,1
21143,रोजमर्रा,0,0,1,1
21122,spontanément,0,0,1,1
21118,elever,0,0,1,1
21094,fundado,0,0,1,1
21116,detalles,0,0,1,1
21095,الشهير,0,0,1,1
21096,inclusionismo,0,0,1,1
21097,делаю,0,0,1,1
21098,गुजर,0,0,1,1
21100,கலைக்களஞ்சிய,0,0,1,1
21101,تتلقى,0,0,1,1
21102,frokosten,0,0,1,1
21103,மகளைப்,0,0,1,1
21105,النظر،,0,0,1,1
21107,johansson sv,0,0,1,1
21108,contest,0,0,1,1
21109,controverses,0,0,1,1
21110,глобальной,0,0,1,1
21111,ಪ್ರಯಾಣದ,0,0,1,1
21115,अवलोकित,0,0,1,1
20766,أضاف,0,0,1,1
20765,поступок,0,0,1,1
20761,programmers,0,0,1,1
20448,حدد,0,0,1,1
20436,suchen,0,0,1,1
20437,repair,0,0,1,1
20440,ಏನಾಗುತ್ತದೆ,0,0,1,1
20441,boyfriend,0,0,1,1
20442,kluge,0,0,1,1
20443,संज्ञा,0,0,1,1
20447,വാക്കിന്,0,0,1,1
20450,metodudur,0,0,1,1
20465,instantáneo,0,0,1,1
20453,hydrogen,0,0,1,1
20454,viejo,0,0,1,1
20456,multilíngue,0,0,1,1
20457,ويكيبيديا؟,0,0,1,1
20459,yoludur,0,0,1,1
20462,έρχεται,0,0,1,1
20463,hatten,0,0,1,1
20435,добровольного,0,0,1,1
20433,मिलन,0,0,1,1
20432,rendered,0,0,1,1
20427,تسحب,0,0,1,1
20399,nadenken,0,0,1,1
20402,σταματήσαμε,0,0,1,1
20403,taraflarına,0,0,1,1
20404,maskiner,0,0,1,1
20407,ευρύ,0,0,1,1
20410,கொண்டிருந்தாள்,0,0,1,1
20411,خرج,0,0,1,1
20412,कहीं,0,0,1,1
20413,aired,0,0,1,1
20414,ನಿಲ್ಲಿಸಿದ್ದೇವೆ,0,0,1,1
20415,complete,0,0,1,1
20416,bedecken,0,0,1,1
20417,tappat,0,0,1,1
20418,"है।
कुछ",0,0,1,1
20420,press,0,0,1,1
20464,høfligt,0,0,1,1
20467,forment,0,0,1,1
20760,कूद,0,0,1,1
20514,modificações,0,0,1,1
20501,verwende,0,0,1,1
20503,χτυπάτε,0,0,1,1
20507,omfattas,0,0,1,1
20508,udøver,0,0,1,1
20509,قضمة,0,0,1,1
20511,tears,0,0,1,1
20512,قليلا,0,0,1,1
20515,தடுக்கப்படுவதோடு,0,0,1,1
20469,"
इसी",0,0,1,1
20517,değiştirme,0,0,1,1
20518,svensk,0,0,1,1
20520,captaste,0,0,1,1
20521,قدمت,0,0,1,1
20522,анонимного,0,0,1,1
20524,encyclopedia»,0,0,1,1
20525,предполагающих,0,0,1,1
20499,इंटरविकी,0,0,1,1
20498,kvalitestsbrister,0,0,1,1
20496,αντιφατικούς,0,0,1,1
20494,cambiado,0,0,1,1
20470,minimiza,0,0,1,1
20475,interglacial,0,0,1,1
20476,dialectique ,0,0,1,1
20477,caja,0,0,1,1
20478,sigues,0,0,1,1
20479,consequently,0,0,1,1
20480,भत्ते,0,0,1,1
20483,localidades,0,0,1,1
20484,ಆಳವಾಗಿ,0,0,1,1
20486,ಮದುವೆಯಾದ,0,0,1,1
20487,உள்ளதாகத்,0,0,1,1
20488,subatomic,0,0,1,1
20489,dadian,0,0,1,1
20490,ओबामा,0,0,1,1
20492,masiva,0,0,1,1
20398,बालकनी,0,0,1,1
20396,पड़े,0,0,1,1
20395,لدراسة,0,0,1,1
20322,legibilidade,0,0,1,1
20314,closer,0,0,1,1
20315,ಮೇಲಿನ,0,0,1,1
20316,தகவல்களை,0,0,1,1
20318,университет,0,0,1,1
20319,ഒട്ടും,0,0,1,1
20320,bilindiğinden,0,0,1,1
20321,ಶಕ್ತಿಯ,0,0,1,1
20323,rédigées,0,0,1,1
20393,kaybettim,0,0,1,1
20327,продвижение,0,0,1,1
20328,kız,0,0,1,1
20330,corresponsales,0,0,1,1
20332,serez,0,0,1,1
20335,تراكمت,0,0,1,1
20336,viagem,0,0,1,1
20338,desciclopédia,0,0,1,1
20313,ആയിട്ടും,0,0,1,1
20312,flicka,0,0,1,1
20311,πιάτο,0,0,1,1
20310,concordando,0,0,1,1
20277,ангел,0,0,1,1
20281,contribuyentes»,0,0,1,1
20282,ссылку,0,0,1,1
20283,அரண்மனையில்,0,0,1,1
20284,امتحان,0,0,1,1
20285,وتطوير,0,0,1,1
20289,എഴുതുന്നു,0,0,1,1
20291,accordait,0,0,1,1
20292,अनियन,0,0,1,1
20293,et •,0,0,1,1
20294,അവരിലൊരാളായി,0,0,1,1
20296,acredito,0,0,1,1
20297,நினைக்கலாம்,0,0,1,1
20300,dernière,0,0,1,1
20305,incentiva,0,0,1,1
20339,برنامجه،,0,0,1,1
20340,பேச்சுவழக்கு,0,0,1,1
20341,espagnole,0,0,1,1
20369,تنسى,0,0,1,1
20375,beğen,0,0,1,1
20376,وهناك,0,0,1,1
20377,رحلتهم,0,0,1,1
20378,مركبة,0,0,1,1
20379,neerleggen,0,0,1,1
20381,durmiendo,0,0,1,1
20383,полагается,0,0,1,1
20384,الاغتصاب,0,0,1,1
20385,çalışmanız,0,0,1,1
20386,helft,0,0,1,1
20387,choix,0,0,1,1
20388,принца,0,0,1,1
20390,especifica,0,0,1,1
20391,ipadressen,0,0,1,1
20392,дочерью,0,0,1,1
20370,пиццы,0,0,1,1
20365,günümüz,0,0,1,1
20342,trabajó,0,0,1,1
20364,parity,0,0,1,1
20343,iluminação,0,0,1,1
20344,पूछता,0,0,1,1
20345,cloche,0,0,1,1
20346,événement,0,0,1,1
20348,disregard,0,0,1,1
20349,değiştirmekte,0,0,1,1
20350,ಮಾಡುವಂತೆ,0,0,1,1
20354,s’est,0,0,1,1
20355,εθελοντές,0,0,1,1
20356,بنحو,0,0,1,1
20357,ತರಗತಿಯಲ್ಲಿ,0,0,1,1
20359,kennst,0,0,1,1
20361,ചതുപ്പുനിലത്ത്,0,0,1,1
20362,திட்டத்தை,0,0,1,1
20363,tarihinde,0,0,1,1
20526,направляемых,0,0,1,1
20527,olun,0,0,1,1
20528,ಸಹೋದರಿ,0,0,1,1
20691,сбалансированные,0,0,1,1
20677,ಜೋಸೆಫ್,0,0,1,1
20679,gezicht,0,0,1,1
20682,tómate,0,0,1,1
20684,implementación,0,0,1,1
20685,живая,0,0,1,1
20686,unutma,0,0,1,1
20687,ഒന്നിച്ച്,0,0,1,1
20696,parçasıdır,0,0,1,1
20645,neigen,0,0,1,1
20698,autocorregirse,0,0,1,1
20699,واجمع,0,0,1,1
20700,άρα,0,0,1,1
20701,syntactic,0,0,1,1
20702,тяжелый,0,0,1,1
20703,insa,0,0,1,1
20704,teknik,0,0,1,1
20674,sv •,0,0,1,1
20673,wijdde,0,0,1,1
20671,подкреплением,0,0,1,1
20670,اللاحق,0,0,1,1
20648,yapmamanı,0,0,1,1
20649,mirándola,0,0,1,1
20650,peaking,0,0,1,1
20654,ojo,0,0,1,1
20655,оценки,0,0,1,1
20656,prioridad,0,0,1,1
20657,κοίταξα,0,0,1,1
20659,conduct,0,0,1,1
20660,zihinde,0,0,1,1
20661,رفض,0,0,1,1
20662,nachdem,0,0,1,1
20663,juge,0,0,1,1
20664,parentes,0,0,1,1
20666,eronder,0,0,1,1
20668,κλαις,0,0,1,1
20705,متاحًا,0,0,1,1
20706,लेन,0,0,1,1
20707,нужен,0,0,1,1
20736,അവളെ,0,0,1,1
20739,n’était,0,0,1,1
20740,divergent,0,0,1,1
20741,الذكاء,0,0,1,1
20742,genoemde,0,0,1,1
20743,ഹായ്,0,0,1,1
20744,ഹൃദയത്തിലേക്ക്,0,0,1,1
20748,author,0,0,1,1
20749,हिसाब,0,0,1,1
20750,தெரிவிப்பதன்,0,0,1,1
20751,visualisera,0,0,1,1
20754,മീറ്റിംഗിനും,0,0,1,1
20755,iniciada,0,0,1,1
20756,புதியகட்டுரை,0,0,1,1
20758,इमारतों,0,0,1,1
20759,وبكلمات,0,0,1,1
20737,getirdim,0,0,1,1
20735,stötande,0,0,1,1
20709,pensantes,0,0,1,1
20734,incomegenerating,0,0,1,1
20711,ಮನಸ್ಸು,0,0,1,1
20712,русск»,0,0,1,1
20714,salienta,0,0,1,1
20716,தொகுக்கும்,0,0,1,1
20717,pornografía,0,0,1,1
20718,agerade,0,0,1,1
20719,death,0,0,1,1
20720,χαρακτηριστικά,0,0,1,1
20721,décider,0,0,1,1
20722,besproken,0,0,1,1
20723,pessoalmente,0,0,1,1
20724,внесением,0,0,1,1
20725,பாதுகாக்கப்படுகின்றன,0,0,1,1
20727,appar,0,0,1,1
20729,köpte,0,0,1,1
20647,hoşgeldin,0,0,1,1
20643,ediciones​,0,0,1,1
20529,ಸಂಗತಿಗಳು,0,0,1,1
20563,تحاول,0,0,1,1
20555,« dépassé,0,0,1,1
20557,വാശി,0,0,1,1
20558,gebrauchen,0,0,1,1
20559,irgendeine,0,0,1,1
20560,verwirren,0,0,1,1
20561,pommes,0,0,1,1
20562,oído,0,0,1,1
20564,μαριάν,0,0,1,1
20641,латинские,0,0,1,1
20567,geïntensiveerd,0,0,1,1
20570,ആയിരുന്നോ,0,0,1,1
20572,весело»,0,0,1,1
20573,ഉറപ്പാക്കപ്പെടുന്നത്‌,0,0,1,1
20574,politiques ,0,0,1,1
20575,anticonsensus,0,0,1,1
20576,ممكن,0,0,1,1
20554,ഉപയോഗപ്രദവുമായ,0,0,1,1
20553,el •,0,0,1,1
20551,അഡ്മിന്മാർ,0,0,1,1
20546,gain,0,0,1,1
20530,argumentó,0,0,1,1
20532,प्रसारण,0,0,1,1
20533,जाऊँगा,0,0,1,1
20534,لكنك,0,0,1,1
20535,μαθηματικά,0,0,1,1
20536,determined,0,0,1,1
20537,poursuivre,0,0,1,1
20538,ಲೋಟ,0,0,1,1
20539,നാർസിസയെക്കുറിച്ചും,0,0,1,1
20540,പ്രശ്നങ്ങളൊന്നും,0,0,1,1
20541,balanserade,0,0,1,1
20542,rätta,0,0,1,1
20543,europe »,0,0,1,1
20544,такова,0,0,1,1
20545,gelmesidir,0,0,1,1
20577,enhance,0,0,1,1
20578,vec •,0,0,1,1
20580,encontrará,0,0,1,1
20606,ஊடகமாகவும்,0,0,1,1
20612,संसदीय,0,0,1,1
20613,اصطدمت,0,0,1,1
20614,पैसे,0,0,1,1
20617,udgav,0,0,1,1
20618,sûrement,0,0,1,1
20620,صغيرًا,0,0,1,1
20622,மகிழ்ச்சியற்றதையும்,0,0,1,1
20623,merk,0,0,1,1
20625,stalled,0,0,1,1
20628,അർത്ഥങ്ങൾ,0,0,1,1
20631,विकिआ,0,0,1,1
20632,αναπνεύσω,0,0,1,1
20635,dillerde,0,0,1,1
20636,dört,0,0,1,1
20639,தகவல்களைக்,0,0,1,1
20607,contratado,0,0,1,1
20605,simulan,0,0,1,1
20581,olsaydı,0,0,1,1
20604,battre,0,0,1,1
20582,prohibit,0,0,1,1
20583,λέγοντας,0,0,1,1
20585,métawiki,0,0,1,1
20587,emphase,0,0,1,1
20588,البناء,0,0,1,1
20589,переводные,0,0,1,1
20591,albümüdür,0,0,1,1
20592,معضلة,0,0,1,1
20593,reeditado,0,0,1,1
20594,பட்டினி,0,0,1,1
20596,ˌwɪkiˈpiːdiə,0,0,1,1
20597,evaluating,0,0,1,1
20598,മറികടന്നു,0,0,1,1
20600,sırrı,0,0,1,1
20601,goldman,0,0,1,1
19329,olmuştu,0,0,1,1
19327,opérationnelle,0,0,1,1
21269,усердной,0,0,1,1
18057,لاحقا,0,0,1,1
18046,വഴിക്കുള്ള,0,0,1,1
18048,téléverser,0,0,1,1
18049,أعرفها,0,0,1,1
18050,ತಿನ್ನಲಾಗದ,0,0,1,1
18054,supermarkets,0,0,1,1
18055,പരിഹരിക്കുന്നു,0,0,1,1
18056,bloquées,0,0,1,1
18058,σταμάτησε,0,0,1,1
18072,ക്ലസ്റ്ററിംഗ്,0,0,1,1
18061,entran,0,0,1,1
18062,pending,0,0,1,1
18064,sulak,0,0,1,1
18065,لوفلاند,0,0,1,1
18066,samkör,0,0,1,1
18067,opmaak,0,0,1,1
18068,courts,0,0,1,1
18044,wenigen,0,0,1,1
18043,அப்பட்டமான,0,0,1,1
18042,റഫർ,0,0,1,1
18041,contraria,0,0,1,1
18021,удивительной,0,0,1,1
18023,latín,0,0,1,1
18024,प्रेरणा,0,0,1,1
18025,وثلاثة,0,0,1,1
18026,faltas,0,0,1,1
18027,religions,0,0,1,1
18029,accorder,0,0,1,1
18030,تصويره,0,0,1,1
18031,davam,0,0,1,1
18032,¿me,0,0,1,1
18033,bulamadığın,0,0,1,1
18034,παράδοξη,0,0,1,1
18036,تنظر,0,0,1,1
18037,açıda,0,0,1,1
18039,communauté »,0,0,1,1
18071,составления,0,0,1,1
18074,aangepast,0,0,1,1
18127,नार्सिसस,0,0,1,1
18112,frappez,0,0,1,1
18101,"
सर्बोक्रोएशियाई",0,0,1,1
18102,വിജയിച്ചാൽ,0,0,1,1
18104,مرت,0,0,1,1
18107,«викимедиару»,0,0,1,1
18109,realizaram,0,0,1,1
18110,suscribirse,0,0,1,1
18111,ينبغي,0,0,1,1
18113,فتى,0,0,1,1
18075,cohesiveness,0,0,1,1
18114,കുട്ടികൾ,0,0,1,1
18116,«ссылки,0,0,1,1
18118,والإندونيسية,0,0,1,1
18119,ipadress,0,0,1,1
18120,частичная,0,0,1,1
18122,publicerats,0,0,1,1
18124,للغد؟,0,0,1,1
18100,passes,0,0,1,1
18099,italianos,0,0,1,1
18098,colocando,0,0,1,1
18097,ευχαριστήσω,0,0,1,1
18076,düşünüyorsun,0,0,1,1
18077,hagamos,0,0,1,1
18078,marmeladen,0,0,1,1
18080,δευτερόλεπτο,0,0,1,1
18081,മാലാഖയാണ്,0,0,1,1
18082,lendo,0,0,1,1
18084,fingrene,0,0,1,1
18085,objectivity,0,0,1,1
18087,groseramente,0,0,1,1
18088,keeping,0,0,1,1
18090,postings,0,0,1,1
18091,mönster,0,0,1,1
18093,engelinin,0,0,1,1
18095,referenciados,0,0,1,1
18096,bewildered,0,0,1,1
18020,कैलीफ़ोर्निया,0,0,1,1
18019,टुडे,0,0,1,1
18018,ಒಬ್ಬರ,0,0,1,1
17939,giechelde,0,0,1,1
17927,durduğunda,0,0,1,1
17928, millions d,0,0,1,1
17930,equivocarse,0,0,1,1
17931,الهوية,0,0,1,1
17934,அனுபவங்களைத்,0,0,1,1
17936,mera,0,0,1,1
17937,juegos,0,0,1,1
17940,representaban,0,0,1,1
18017,caída,0,0,1,1
17941,சொல்லான,0,0,1,1
17945,कहे,0,0,1,1
17946,டாலர்களை,0,0,1,1
17947,beş,0,0,1,1
17949,शायरियां,0,0,1,1
17950,"
polonêspolaco",0,0,1,1
17953,arbitraire,0,0,1,1
17925,உற்சாகப்படுத்த,0,0,1,1
17923,ventes,0,0,1,1
17921,ερωτηματικό,0,0,1,1
17918,perguntaram,0,0,1,1
17891,ഡ്രിങ്ക്,0,0,1,1
17892,confrontés,0,0,1,1
17893,paylaşılmaktadır,0,0,1,1
17894,coordonner,0,0,1,1
17896,അസ്വസ്ഥനാകുന്നത്,0,0,1,1
17897,personnesai,0,0,1,1
17898,cunhado,0,0,1,1
17899,earliest,0,0,1,1
17900,pete,0,0,1,1
17901,الفكرية,0,0,1,1
17902,utrolige,0,0,1,1
17903,ಸಮಯಕ್ಕೆ,0,0,1,1
17911,ജീവിതം,0,0,1,1
17912,kurallarında,0,0,1,1
17913,لمستخدمها,0,0,1,1
17960,கேட்கிறார்கள்,0,0,1,1
17961,смотрел,0,0,1,1
17962,düğmesini,0,0,1,1
17990,identifies,0,0,1,1
17996,bevara,0,0,1,1
17997,slogan ,0,0,1,1
17998,población,0,0,1,1
17999,"
coreano",0,0,1,1
18001,കർത്തവ്യം,0,0,1,1
18002,veracidade,0,0,1,1
18005,കാര്യ,0,0,1,1
18006,concluait,0,0,1,1
18007,التعليقات,0,0,1,1
18009,ആവശ്യമില്ലെങ്കിൽ,0,0,1,1
18010,ചോദിക്കുന്നുണ്ടെങ്കിൽ,0,0,1,1
18012,agreed,0,0,1,1
18014,réutilisations,0,0,1,1
18015,felicitar,0,0,1,1
18016,nécessite,0,0,1,1
17995,onafhankelijk,0,0,1,1
17988,ಯೋಚಿಸೋಣ,0,0,1,1
17963,σκεφτείτε,0,0,1,1
17986,brittiska,0,0,1,1
17964,جامعيًا,0,0,1,1
17966,കേൾക്കുക,0,0,1,1
17967,"
ucraniano",0,0,1,1
17968,നിരസിച്ചു,0,0,1,1
17969,собираюсь,0,0,1,1
17970,gøres,0,0,1,1
17973,दिनों,0,0,1,1
17976,സൂചിപ്പിക്കുന്ന,0,0,1,1
17977,difamálos,0,0,1,1
17978,corollaire,0,0,1,1
17979,τακτικά,0,0,1,1
17980,запустил,0,0,1,1
17982,historians,0,0,1,1
17983,industrielle,0,0,1,1
17984,متخصصين،,0,0,1,1
18125,estabeleceu,0,0,1,1
18128,بإمكانك,0,0,1,1
18364,vaticano,0,0,1,1
18289,colocó,0,0,1,1
18281,inmensa,0,0,1,1
18283,பிடித்தது,0,0,1,1
18284,ತಿಳಿದಿದೆಯೇ,0,0,1,1
18285,وتمت,0,0,1,1
18286,geestdriftige,0,0,1,1
18287,söylüyordun,0,0,1,1
18288,النظرية,0,0,1,1
18290,drömmamma,0,0,1,1
18307,الرسوم,0,0,1,1
18291,varanda,0,0,1,1
18297,fruit—topics,0,0,1,1
18298,maatschappij,0,0,1,1
18299,உருவாக்கியவரோ,0,0,1,1
18300,«рандеву»,0,0,1,1
18302,अध्यायों,0,0,1,1
18305,esclusa,0,0,1,1
18279,skyldes,0,0,1,1
18277,صباح,0,0,1,1
18275,أسابيع,0,0,1,1
18274,machte,0,0,1,1
18255,"
तमिल",0,0,1,1
18256,देशी,0,0,1,1
18257,βάλτε,0,0,1,1
18258,avsiktlig,0,0,1,1
18260,अज़रबैजानी,0,0,1,1
18264,„википедию“»,0,0,1,1
18265,отображать,0,0,1,1
18266,ontmoet,0,0,1,1
18267,salud,0,0,1,1
18268,criba,0,0,1,1
18269,خاصةً,0,0,1,1
18270,geluid,0,0,1,1
18271,स्वयंसेवक,0,0,1,1
18272,फ़रवरी,0,0,1,1
18273,cameron,0,0,1,1
18306,dilinde,0,0,1,1
18308,yanar,0,0,1,1
18129,ഉള്ളവരായിരിക്കും,0,0,1,1
18348,erfolgreich,0,0,1,1
18337,οτιδήποτε,0,0,1,1
18338,combiné,0,0,1,1
18340,sechs,0,0,1,1
18341,deveríamos,0,0,1,1
18342,εσυ,0,0,1,1
18345,distribute,0,0,1,1
18346,разговорная,0,0,1,1
18349,سجل,0,0,1,1
18309,sökning,0,0,1,1
18351,göstermektedir,0,0,1,1
18352,ಧನಾತ್ಮಕ,0,0,1,1
18355,nitrogen,0,0,1,1
18356,especiais,0,0,1,1
18357,dépassées,0,0,1,1
18358,nobody,0,0,1,1
18359,μπαλκόνι,0,0,1,1
18336,« marques »,0,0,1,1
18335,recommends,0,0,1,1
18332,беспорядке,0,0,1,1
18331,istersen,0,0,1,1
18310,counterpart,0,0,1,1
18312,alimentar,0,0,1,1
18313,разумность,0,0,1,1
18315,forklare,0,0,1,1
18316,llanto,0,0,1,1
18317,informationskälla,0,0,1,1
18319,angleterre,0,0,1,1
18320,killed,0,0,1,1
18324,قواعده,0,0,1,1
18325,frø,0,0,1,1
18326,auffahrt,0,0,1,1
18327,ثاني,0,0,1,1
18328,വെള്ളം,0,0,1,1
18329,wifi,0,0,1,1
18330,commencer,0,0,1,1
18254,गिलास,0,0,1,1
18251,копилефтлицензиями,0,0,1,1
18248,опубликовавшими,0,0,1,1
18170,ஈரநிலத்தின்,0,0,1,1
18162,opendoor,0,0,1,1
18163,comunistas,0,0,1,1
18164,stoppade,0,0,1,1
18165,teman,0,0,1,1
18166,hoffentlich,0,0,1,1
18167,manuales,0,0,1,1
18169,preguntarte,0,0,1,1
18171,cortésmente,0,0,1,1
18246,introduire,0,0,1,1
18174,ca •,0,0,1,1
18175,наверное,0,0,1,1
18176,ಟಕ್ಕೆ,0,0,1,1
18178,apprentissage »,0,0,1,1
18179,ಬಳಿ,0,0,1,1
18181,criálos,0,0,1,1
18184,ನೀನು,0,0,1,1
18160,интернетакомм,0,0,1,1
18159,ടി,0,0,1,1
18157,personalized,0,0,1,1
18155,പരാമർശിക്കരുത്,0,0,1,1
18130,relaties,0,0,1,1
18133,innecesarios,0,0,1,1
18135,плохое,0,0,1,1
18137,இம்முறைமையின்,0,0,1,1
18138,hunden,0,0,1,1
18139,يدين,0,0,1,1
18140,seslerin,0,0,1,1
18144,роли,0,0,1,1
18146,متوسط,0,0,1,1
18148,மூளையைச்,0,0,1,1
18150,പഠിക്കുന്ന,0,0,1,1
18151,പാദത്തിൽ,0,0,1,1
18152,हेल्लो,0,0,1,1
18153,ഭാഷകൾ,0,0,1,1
18154,tanıyorsunuz,0,0,1,1
18185,инструмент,0,0,1,1
18186,പ്രപഞ്ചത്തെയും,0,0,1,1
18187,biografen,0,0,1,1
18214,« naturels »,0,0,1,1
18220,conforme,0,0,1,1
18221,எட்டப்படுகிறது,0,0,1,1
18222,успех,0,0,1,1
18224,ജോസഫ്,0,0,1,1
18225,referenceværk,0,0,1,1
18226,efectúan,0,0,1,1
18227,لجعل,0,0,1,1
18229,എക്സ്ക്യൂസ്,0,0,1,1
18232,internetentreprenören,0,0,1,1
18235,persona​,0,0,1,1
18238,غدا,0,0,1,1
18239,ശാന്തമാക്കുക,0,0,1,1
18242,primitive,0,0,1,1
18243,είδατε,0,0,1,1
18244,фурор,0,0,1,1
18218,προσπαθούσε,0,0,1,1
18213,défauts,0,0,1,1
18188,planning,0,0,1,1
18212,geklickt,0,0,1,1
18189,logiquement,0,0,1,1
18191,птицы,0,0,1,1
18192,ಭಾಗವೆಂದರೆ,0,0,1,1
18194,счастливым,0,0,1,1
18197,fantastiques,0,0,1,1
18199,reprises,0,0,1,1
18200,министром,0,0,1,1
18201,διοικούνται,0,0,1,1
18203,wikiprincipen,0,0,1,1
18204,uppslukad,0,0,1,1
18205,sétimo,0,0,1,1
18206,والدتي,0,0,1,1
18208,inclui,0,0,1,1
18209,refereras,0,0,1,1
18211,संकेत,0,0,1,1
17889,blog,0,0,1,1
17888,ಅವ್ಯವಸ್ಥೆಯಲ್ಲಿದ್ದೇನೆ,0,0,1,1
17886,exposer,0,0,1,1
17571,reír,0,0,1,1
17561,дампа,0,0,1,1
17563,katılımcılar,0,0,1,1
17564,desacreditarlo,0,0,1,1
17566,konversation,0,0,1,1
17567,ದಾಸಿಯರು,0,0,1,1
17568,no—,0,0,1,1
17569,salz,0,0,1,1
17574,समस्याएं,0,0,1,1
17587,вторичный,0,0,1,1
17575,έκπληκτος,0,0,1,1
17576,تصعيد,0,0,1,1
17577,« en,0,0,1,1
17578,capture,0,0,1,1
17582,يتلاعب,0,0,1,1
17583,ಹೊಳಪುಳ್ಳವನಾಗಿದ್ದಾನೆ,0,0,1,1
17584,ക്ഷീണവും,0,0,1,1
17557,கொடுங்கள்,0,0,1,1
17556,βρώσιμο,0,0,1,1
17555,cero,0,0,1,1
17552,trouwjurk,0,0,1,1
17529,മാതൃവെബ്സൈറ്റിനെയും,0,0,1,1
17530,ഇടുന്നു,0,0,1,1
17531,पकड़ते,0,0,1,1
17532,mencionou,0,0,1,1
17535,sítio,0,0,1,1
17537,fing,0,0,1,1
17538,مثلك,0,0,1,1
17539,ವ್ಯವಹಾರವು,0,0,1,1
17540,تجميعها,0,0,1,1
17541,présentées,0,0,1,1
17542,realizing,0,0,1,1
17546,derecede,0,0,1,1
17547,استئناف,0,0,1,1
17549,verbeter,0,0,1,1
17551,надёжность,0,0,1,1
17585,описал,0,0,1,1
17588,فلنطعمك,0,0,1,1
17885,நோக்கற்ற,0,0,1,1
17630,bezighouden,0,0,1,1
17619,जानकारीपूर्ण,0,0,1,1
17621,συνάντησης,0,0,1,1
17622,föreslår,0,0,1,1
17624,klaarmaken,0,0,1,1
17627,kontrollera,0,0,1,1
17628,dinosaurs,0,0,1,1
17629,preciosas,0,0,1,1
17632,dramatica,0,0,1,1
17590,അവസ്ഥയിലായിരിക്കുക,0,0,1,1
17635,slarvar,0,0,1,1
17636,பேண,0,0,1,1
17637,"
जॉर्जियाई",0,0,1,1
17638,भागों,0,0,1,1
17639,airspace,0,0,1,1
17640,stakes,0,0,1,1
17641,afirmações,0,0,1,1
17616,valuation,0,0,1,1
17615,pestaña,0,0,1,1
17614,lícita,0,0,1,1
17613,« vous »,0,0,1,1
17591,opmuntring,0,0,1,1
17593,ομιλητές,0,0,1,1
17594,inteiramente,0,0,1,1
17596,சரியில்லை,0,0,1,1
17597,இருந்தபோதிலும்,0,0,1,1
17598,moderering,0,0,1,1
17600,bandet,0,0,1,1
17602,நபர்,0,0,1,1
17603,свете,0,0,1,1
17604,kaïkavien,0,0,1,1
17605,പരിഭ്രാന്തരായി,0,0,1,1
17606,startet,0,0,1,1
17607,dorées,0,0,1,1
17608,ನೆಚ್ಚಿನದು,0,0,1,1
17610,whereby,0,0,1,1
17527,ತಂಪಾಗಿರಲು,0,0,1,1
17526,«кто,0,0,1,1
17523,சலிப்பாக,0,0,1,1
17452,agreeable,0,0,1,1
17440,άκρη,0,0,1,1
17441,comentarios,0,0,1,1
17443,достоинств,0,0,1,1
17444,ಸಹಾಯಕ್ಕಾಗಿ,0,0,1,1
17445,characterizing,0,0,1,1
17446,माइक्रोसोफ्ट,0,0,1,1
17451,وswedish،,0,0,1,1
17453,отслеживать,0,0,1,1
17521,concentration,0,0,1,1
17454,തുടരുന്നതിന്,0,0,1,1
17457,wikee,0,0,1,1
17458,تماما,0,0,1,1
17459,തുടരുകയാണെങ്കിൽ,0,0,1,1
17460,schlimmes,0,0,1,1
17461,spetsig,0,0,1,1
17463,yapmaya,0,0,1,1
17439,succinctes,0,0,1,1
17438,बोरिस,0,0,1,1
17437,évolutions,0,0,1,1
17436,естественнонаучной,0,0,1,1
17414,ಸಂತೋಷವಾಗಿರಲು,0,0,1,1
17415,fortsætte,0,0,1,1
17416,نافياً,0,0,1,1
17418,नामक,0,0,1,1
17419,tillträde,0,0,1,1
17421,следы,0,0,1,1
17424,ರೀತಿಯ,0,0,1,1
17425,फाउन्डिंग,0,0,1,1
17427,extérieures,0,0,1,1
17428,बगीचे,0,0,1,1
17430,للنوم,0,0,1,1
17431,divisée,0,0,1,1
17432,установило,0,0,1,1
17433,പ്രൊജക്റ്റിനു,0,0,1,1
17435,ಮುಳುಗಬಹುದು,0,0,1,1
17464,متكررة,0,0,1,1
17465,groß,0,0,1,1
17466,écriture…,0,0,1,1
17493,pesquisando,0,0,1,1
17495,gebe,0,0,1,1
17496,காணமுடியும்,0,0,1,1
17498,söylüyorsun,0,0,1,1
17500,അർത്ഥമെന്താണെന്ന്,0,0,1,1
17505,وسائل,0,0,1,1
17507,gebeurtenissen,0,0,1,1
17508,whereas,0,0,1,1
17509,principios​,0,0,1,1
17510,tang,0,0,1,1
17511,துல்லியமின்மை,0,0,1,1
17513,autrui,0,0,1,1
17514,programmering,0,0,1,1
17515,geoinformation,0,0,1,1
17516,ministre,0,0,1,1
17517,anlayabilirsiniz,0,0,1,1
17494,fru,0,0,1,1
17492,försiktighet,0,0,1,1
17468,индуктивного,0,0,1,1
17491,« apprendre »,0,0,1,1
17469,اقتباس,0,0,1,1
17471,raisonnable,0,0,1,1
17472,эпохи,0,0,1,1
17473,ಹೊಂದಿದ್ದರು,0,0,1,1
17475,بالقرب,0,0,1,1
17477,söyleme,0,0,1,1
17478,nützliche,0,0,1,1
17480,vim,0,0,1,1
17481,corrección,0,0,1,1
17482,relativas,0,0,1,1
17483,суд,0,0,1,1
17485,mismo—​​,0,0,1,1
17487,nie,0,0,1,1
17489,தந்திரமான,0,0,1,1
17490,semiformal,0,0,1,1
17642,réelles,0,0,1,1
17643,செய்யப்பட்டன,0,0,1,1
17644,redigido,0,0,1,1
17811,τρώω,0,0,1,1
17798,തടസ്സപ്പെടുത്തുന്നു,0,0,1,1
17800,векторы,0,0,1,1
17801,interglaciaires,0,0,1,1
17802,afirmam,0,0,1,1
17805,avancée,0,0,1,1
17806,uppträdde,0,0,1,1
17809,അതിലെ,0,0,1,1
17812,"
टारण्टीनो",0,0,1,1
17767,obeying,0,0,1,1
17817,récente,0,0,1,1
17818,controversy,0,0,1,1
17820,ತಟ್ಟೆಯಲ್ಲಿ,0,0,1,1
17823,माफी,0,0,1,1
17824,δουλεύετε,0,0,1,1
17825,അവൾക്കറിയാമോ,0,0,1,1
17826,savait,0,0,1,1
17797,açıkla,0,0,1,1
17795,geheimen,0,0,1,1
17791,വിഷയങ്ങളിലുള്ള,0,0,1,1
17789,стратегию,0,0,1,1
17769,பரிந்துரை,0,0,1,1
17770,വിളിച്ചു,0,0,1,1
17771,anfang,0,0,1,1
17774,implementaciones,0,0,1,1
17775,குறியீட்டு,0,0,1,1
17777,eklemeler,0,0,1,1
17778,അവബോധം,0,0,1,1
17779,tamamlanmayacağı,0,0,1,1
17782,திருமண,0,0,1,1
17783,annenin,0,0,1,1
17784,ettiğinizden,0,0,1,1
17785,обобщением,0,0,1,1
17786,ಮಾಡುತ್ತದೆ,0,0,1,1
17787,இல்லாது,0,0,1,1
17788,regardless,0,0,1,1
17827,intentan,0,0,1,1
17829,сшил,0,0,1,1
17831,காப்புரிமைத்,0,0,1,1
17861,ആവശ്യപ്പെടാത്തപ്പോൾ,0,0,1,1
17864,stavningen,0,0,1,1
17865,anns,0,0,1,1
17866,ஒழுங்கமைவுப்,0,0,1,1
17867,fate,0,0,1,1
17868,ചുവടെയുള്ള,0,0,1,1
17869,सामान्य।,0,0,1,1
17870,ചെയ്തത്,0,0,1,1
17872,podían,0,0,1,1
17874,damaging,0,0,1,1
17877,ശ്രദ്ധിക്കൂ,0,0,1,1
17878,неприятной,0,0,1,1
17879,matematiska,0,0,1,1
17881,frustration,0,0,1,1
17883,canadá,0,0,1,1
17884,مينج,0,0,1,1
17863,прошу,0,0,1,1
17860,—«bibliotecarios»—,0,0,1,1
17833,нейронных,0,0,1,1
17859,maya,0,0,1,1
17834,"
कॉर्निश",0,0,1,1
17838,bloodthirsty,0,0,1,1
17840,alayım,0,0,1,1
17841,சிந்திக்க,0,0,1,1
17842,zhminnan •,0,0,1,1
17843,persistaient,0,0,1,1
17845,तार्किक,0,0,1,1
17848,greenwich,0,0,1,1
17849,ಎಂಬುದರಂತೆ,0,0,1,1
17850,سجلت,0,0,1,1
17851,abuso,0,0,1,1
17853,observadores,0,0,1,1
17854,vikidia,0,0,1,1
17856,greek,0,0,1,1
17858,divulgada,0,0,1,1
17768,مطلوبة,0,0,1,1
17765,لطيفين,0,0,1,1
17645,famoso»,0,0,1,1
17687,physicien,0,0,1,1
17677,कॉमस्कोर,0,0,1,1
17678,посвящённые,0,0,1,1
17680,rusa—,0,0,1,1
17682,ಹೊಂದಿರಬೇಕು,0,0,1,1
17683,skrive,0,0,1,1
17685,മെലിസയും,0,0,1,1
17686,cirkelen,0,0,1,1
17688,certifiquese,0,0,1,1
17764,ثانية,0,0,1,1
17689,remark,0,0,1,1
17693,reverta,0,0,1,1
17694,théologicopolitique,0,0,1,1
17696,diep,0,0,1,1
17697,männen,0,0,1,1
17698,واسترجاعها،,0,0,1,1
17699,physicians,0,0,1,1
17675,لنصبح,0,0,1,1
17674,aprendan,0,0,1,1
17673,permettrait,0,0,1,1
17672,vandals,0,0,1,1
17646,остального,0,0,1,1
17647,κλπ,0,0,1,1
17648,моей,0,0,1,1
17651,dezenas,0,0,1,1
17654,сделала,0,0,1,1
17657,ഗൗരവമായി,0,0,1,1
17658,просить,0,0,1,1
17659,समितियां,0,0,1,1
17662,विवरण,0,0,1,1
17663,даю,0,0,1,1
17664,gobbling,0,0,1,1
17665,gewesen,0,0,1,1
17667,ciberespaço,0,0,1,1
17668,voir ,0,0,1,1
17671,bevorderd,0,0,1,1
17700,deeply,0,0,1,1
17702,культу»,0,0,1,1
17704,дополнение,0,0,1,1
17733,ಅಸಮಾಧಾನಗೊಳ್ಳದಂತೆ,0,0,1,1
17738,وقف,0,0,1,1
17740,языком,0,0,1,1
17744,ζητήσουν,0,0,1,1
17746,ilimitado,0,0,1,1
17747,esprits,0,0,1,1
17748,நாய்,0,0,1,1
17749,सहसंस्थापक,0,0,1,1
17750,βγήκε,0,0,1,1
17751,твоих,0,0,1,1
17752,பொதேரி’,0,0,1,1
17755,rétribution,0,0,1,1
17757,activation,0,0,1,1
17758,αγωνίστηκε,0,0,1,1
17761,താല്പര്യമില്ല,0,0,1,1
17763,وانفتاحًا,0,0,1,1
17734,μη,0,0,1,1
17732,œuvres,0,0,1,1
17707,побежала,0,0,1,1
17730,annenize,0,0,1,1
17708,huang,0,0,1,1
17709,scoren,0,0,1,1
17710,പങ്ക്,0,0,1,1
17712,draaiende,0,0,1,1
17713,முடிவை,0,0,1,1
17715,statistiek,0,0,1,1
17716,waterways,0,0,1,1
17718,türlü,0,0,1,1
17720,планирую,0,0,1,1
17721,ಭಾವಿಸುವ,0,0,1,1
17722,yasalara,0,0,1,1
17723,satirique,0,0,1,1
17725,gags,0,0,1,1
17726,univers »,0,0,1,1
17727,целиком,0,0,1,1
18363,ആയിരം,0,0,1,1
18365,reemplazados,0,0,1,1
19326,कॉपीराईट,0,0,1,1
19005,cravejada,0,0,1,1
18995,davrandığının,0,0,1,1
18996,discrimination,0,0,1,1
18997,géométrie,0,0,1,1
18998,മെയ്,0,0,1,1
19001,games,0,0,1,1
19002,يقترح,0,0,1,1
19004,kenmerkend,0,0,1,1
19006,uyar,0,0,1,1
19021,dorpje,0,0,1,1
19008,வெளியேற,0,0,1,1
19009,ζωντανό,0,0,1,1
19010,naturalistes,0,0,1,1
19011,efectuada,0,0,1,1
19015,ലോക,0,0,1,1
19017,pesos,0,0,1,1
19019,സ്റ്റം‌പൻ‌ഡസിനുപകരം,0,0,1,1
18994,ஒலி,0,0,1,1
18993,turkije,0,0,1,1
18992,martin,0,0,1,1
18991,шекмана,0,0,1,1
18964,धमकी,0,0,1,1
18966,செய்நிரல்கள்’,0,0,1,1
18967,tankerne,0,0,1,1
18968,rodríguez,0,0,1,1
18972,ആശ്വസിപ്പിക്കാൻ,0,0,1,1
18975,kartoffeln,0,0,1,1
18977,ತರುತ್ತೇನೆ,0,0,1,1
18978,உருவாக்கினார்,0,0,1,1
18980,ಮೇಲಿನಿಂದ,0,0,1,1
18982,يستحوذ,0,0,1,1
18984,φρικιαστικά,0,0,1,1
18985,mængde,0,0,1,1
18986,الوقت،,0,0,1,1
18989,desværre,0,0,1,1
18990,beresheet,0,0,1,1
19020,îlesréf,0,0,1,1
19023,suajili,0,0,1,1
19076,ലേഖനങ്ങളുടേയും,0,0,1,1
19064,maskinöversatts,0,0,1,1
19054,введена,0,0,1,1
19057,ಇದರ,0,0,1,1
19058,bibliotekarien,0,0,1,1
19060,quest,0,0,1,1
19061,ofrecerme,0,0,1,1
19062,parodian,0,0,1,1
19063,الفعل,0,0,1,1
19065,обновлённый,0,0,1,1
19024,rubinen,0,0,1,1
19066,​​kolayca,0,0,1,1
19067,niettemin,0,0,1,1
19068,foradalei,0,0,1,1
19069,indicators,0,0,1,1
19070,bijdraagt,0,0,1,1
19071,necessário,0,0,1,1
19074,stoten,0,0,1,1
19053,γραφής,0,0,1,1
19051,einzigen,0,0,1,1
19049,voudrais,0,0,1,1
19046,ഭാഗ്യവാനാണെന്ന്,0,0,1,1
19025,péjorative,0,0,1,1
19026,المجتمع،,0,0,1,1
19028,இலாப,0,0,1,1
19029,года —,0,0,1,1
19030,грамматика,0,0,1,1
19032,détournées,0,0,1,1
19033,imposé,0,0,1,1
19034,enciclopédicamente,0,0,1,1
19037,koninkrijk,0,0,1,1
19038,ignora,0,0,1,1
19039,கூட்டு,0,0,1,1
19040,någonsin,0,0,1,1
19042,επισκευή,0,0,1,1
19043,camino,0,0,1,1
19044,spring,0,0,1,1
18963,exemplifierar,0,0,1,1
18962,وبدون,0,0,1,1
18960,பெறுகிறேன்,0,0,1,1
18890,prétentieux,0,0,1,1
18880,åsikter,0,0,1,1
18881,എന്നല്ല,0,0,1,1
18882,удивительного,0,0,1,1
18883,stödja,0,0,1,1
18884,معروف,0,0,1,1
18885,hemisphere,0,0,1,1
18887,पैमाने,0,0,1,1
18891,डाउन,0,0,1,1
18959,squares,0,0,1,1
18892,  lecteurs,0,0,1,1
18893,اختلافات,0,0,1,1
18895,parabéns,0,0,1,1
18897,noyade,0,0,1,1
18898,tries,0,0,1,1
18899,പോർട്ടൽ,0,0,1,1
18900,μερικοί,0,0,1,1
18879,efectos,0,0,1,1
18878,runoff,0,0,1,1
18876,konuşabilir,0,0,1,1
18875,modificables,0,0,1,1
18849,robes,0,0,1,1
18850,шекманом,0,0,1,1
18854,offrira,0,0,1,1
18855,pms •,0,0,1,1
18856,данными,0,0,1,1
18858,citam,0,0,1,1
18859,ускоряющийся,0,0,1,1
18861,ഹിച്ചാലും,0,0,1,1
18862,argumentava,0,0,1,1
18864,مكرسة,0,0,1,1
18866,silberbrot,0,0,1,1
18869,ತಿನ್ನು,0,0,1,1
18870,habilidade,0,0,1,1
18871,gidiyorsa,0,0,1,1
18874,constituyeron,0,0,1,1
18901,desenhos,0,0,1,1
18902,ವಿರೋಧಾತ್ಮಕ,0,0,1,1
18904,أراه,0,0,1,1
18933,विकिपीडीयन्स,0,0,1,1
18937,внутреннего,0,0,1,1
18938,opslagruimte,0,0,1,1
18940,rahatsızlık,0,0,1,1
18941,«мне,0,0,1,1
18942,διέσχισαν,0,0,1,1
18945,californien,0,0,1,1
18946,meningen,0,0,1,1
18947,stoppen,0,0,1,1
18948,vejret,0,0,1,1
18953,قائلاً،,0,0,1,1
18954,தட்டச்சு,0,0,1,1
18955,nachmittags,0,0,1,1
18956,преобразования,0,0,1,1
18957,والآخر,0,0,1,1
18958,الأغاني,0,0,1,1
18935,annesinin,0,0,1,1
18932,подверженных,0,0,1,1
18905,italienne,0,0,1,1
18931,contradictorias,0,0,1,1
18906,palads,0,0,1,1
18907,olduktan,0,0,1,1
18908,типа,0,0,1,1
18910,cuidas,0,0,1,1
18912,अणुओं,0,0,1,1
18913,verilen,0,0,1,1
18914,personnalité,0,0,1,1
18917,ümmete,0,0,1,1
18918,ശ്രമിക്കുമ്പോൾ,0,0,1,1
18920,अडिग,0,0,1,1
18921,wikipediaspecific,0,0,1,1
18922,शाम,0,0,1,1
18924,многими,0,0,1,1
18928,måneden,0,0,1,1
18930,grattis,0,0,1,1
19075,целью,0,0,1,1
19077,journalisme,0,0,1,1
18366,கிடைத்தால்,0,0,1,1
19244,ребенку,0,0,1,1
19225,onderwerpen,0,0,1,1
19232,والنزاعات,0,0,1,1
19234,φορέματα,0,0,1,1
19237,interpretive,0,0,1,1
19238,eenvoudige,0,0,1,1
19240,استشهدت,0,0,1,1
19242,никаких,0,0,1,1
19252,സംസാരിക്കുന്ന,0,0,1,1
19267,проведённое,0,0,1,1
19254,bronnen,0,0,1,1
19258,логистическому,0,0,1,1
19259,эпично,0,0,1,1
19260,идею,0,0,1,1
19262,ಗೋಲ್ಡನ್,0,0,1,1
19263,وتعترف,0,0,1,1
19264,successives,0,0,1,1
19224,marchó,0,0,1,1
19221,formation,0,0,1,1
19220,exército,0,0,1,1
19219,aventures,0,0,1,1
19197,aumenten,0,0,1,1
19198,आंद्रे,0,0,1,1
19199,oprettet,0,0,1,1
19200,لثلاثة,0,0,1,1
19202,slö,0,0,1,1
19203,"
letão",0,0,1,1
19205,connections,0,0,1,1
19206,इंक,0,0,1,1
19207,palavrasraiz,0,0,1,1
19208,distinguant,0,0,1,1
19209,விவரிக்கும்,0,0,1,1
19210,gittiler,0,0,1,1
19212,mistaken,0,0,1,1
19216,ಹಳ್ಳಿಯಲ್ಲಿ,0,0,1,1
19218,уэйлсом,0,0,1,1
19266,ತಿನ್ನುವ,0,0,1,1
19269,إلا,0,0,1,1
19078,sixthmostused,0,0,1,1
19309,رموز,0,0,1,1
19298,växla,0,0,1,1
19299,التطبيقات,0,0,1,1
19300,sq •,0,0,1,1
19301,பிரஞ்சு,0,0,1,1
19306,συλλογή,0,0,1,1
19307,define,0,0,1,1
19308,kører,0,0,1,1
19310,مكثفة،,0,0,1,1
19271,skolarbete,0,0,1,1
19311,للعينة,0,0,1,1
19314,happens,0,0,1,1
19318,ظل,0,0,1,1
19319,könnten,0,0,1,1
19321,fared,0,0,1,1
19322,frikostigt,0,0,1,1
19324,autoencoders,0,0,1,1
19297,everyday,0,0,1,1
19296,grundtanken,0,0,1,1
19295,doté,0,0,1,1
19294,സ്ത്രീകൾക്ക്,0,0,1,1
19272,λεωφορείο,0,0,1,1
19273,ακολουθούν,0,0,1,1
19275,पहुँचायी,0,0,1,1
19277,முன்னிறுத்தப்பட்டது,0,0,1,1
19278,culminate,0,0,1,1
19280,l’inverse,0,0,1,1
19281,explícitamente,0,0,1,1
19282,fitzerald,0,0,1,1
19283,അറിയാമെങ്കിൽ,0,0,1,1
19285,ഇന്നുള്ള,0,0,1,1
19286,അതിശയകരമായിരിക്കും,0,0,1,1
19287,stewards,0,0,1,1
19289,напоминает,0,0,1,1
19290,மகளின்,0,0,1,1
19293,rigorosos,0,0,1,1
19195,രേഖീയസമവാക്യമായിരിക്കണോ,0,0,1,1
19194,évoluent,0,0,1,1
19192,forming,0,0,1,1
19124,ακούσω,0,0,1,1
19116,وشك,0,0,1,1
19118,newly,0,0,1,1
19119,σταματήσω,0,0,1,1
19120,kısık,0,0,1,1
19121,rad,0,0,1,1
19122,verme,0,0,1,1
19123,souriant,0,0,1,1
19125,മാതൃകയുടെ,0,0,1,1
19191,s’accroissait,0,0,1,1
19126,രചയിതാവില്ല,0,0,1,1
19127,καταλαβαίνω,0,0,1,1
19131,tonlamayı,0,0,1,1
19132,voluntariamente,0,0,1,1
19133,வந்ததும்,0,0,1,1
19135,авторства,0,0,1,1
19136,إهانة,0,0,1,1
19115,بمحتوى,0,0,1,1
19114,correu,0,0,1,1
19113,للتنفس,0,0,1,1
19110,viable,0,0,1,1
19079,вперемешку,0,0,1,1
19080,terk,0,0,1,1
19081,geliyordu,0,0,1,1
19082,ooooo,0,0,1,1
19088,våra,0,0,1,1
19089,diyelim,0,0,1,1
19091,narret,0,0,1,1
19094,കഷ്ണം,0,0,1,1
19098,adéquat,0,0,1,1
19099,lese,0,0,1,1
19100,ബുദ്ധിമുട്ടായിരുന്നു,0,0,1,1
19101,tjugonde,0,0,1,1
19102,owing,0,0,1,1
19103,maitrise,0,0,1,1
19107,வெளியிடப்படும்,0,0,1,1
19138,¿tengo,0,0,1,1
19140,pedaço,0,0,1,1
19141,முயற்சிகள்,0,0,1,1
19170,अचरज,0,0,1,1
19172,ofensivos,0,0,1,1
19173,aangetroffen,0,0,1,1
19175,ಸರಿಯಾಗಿದೆ,0,0,1,1
19176,niña,0,0,1,1
19178,विरोधाभास,0,0,1,1
19179,أحببت,0,0,1,1
19180,ضغطت,0,0,1,1
19181,cuire,0,0,1,1
19182,ಪ್ರಿಯತಮೆಯು,0,0,1,1
19185,нозека,0,0,1,1
19186,agência,0,0,1,1
19187,декабрь,0,0,1,1
19188,spiegelbeeld,0,0,1,1
19189,английская —,0,0,1,1
19190,alfred,0,0,1,1
19171,opgemerkt,0,0,1,1
19169,ಫಿಕ್ಸ್‌ನಲ್ಲಿ,0,0,1,1
19144,മറ്റേയാൾ,0,0,1,1
19167,ನೀಡೋಣ,0,0,1,1
19147,samarbejde,0,0,1,1
19149,främsta,0,0,1,1
19150,évoquant,0,0,1,1
19152,مساء,0,0,1,1
19153,विक्षनरी,0,0,1,1
19154,وأحكام,0,0,1,1
19155,originales,0,0,1,1
19156,androidenheder,0,0,1,1
19158,λατινικές,0,0,1,1
19159,занимала,0,0,1,1
19162,merely,0,0,1,1
19163,επιμεληθεί,0,0,1,1
19164,strukturerat,0,0,1,1
19165,vatten,0,0,1,1
19166,ക്ലിക്കുചെയ്യുന്നത്,0,0,1,1
18848,περνούσε,0,0,1,1
18847,प्रकरण,0,0,1,1
18846,абстрактного,0,0,1,1
18518,действии,0,0,1,1
18507,نزاع,0,0,1,1
18509,വിവരങ്ങളലൂടെ,0,0,1,1
18510,ಪ್ರಶ್ನೆ,0,0,1,1
18512,editado,0,0,1,1
18513,ederiz,0,0,1,1
18514,ستستخدمها,0,0,1,1
18517,гипотетическую,0,0,1,1
18519,hazard,0,0,1,1
18532,orsaker,0,0,1,1
18520,كثيرين,0,0,1,1
18523,തിരക്കിലായിരുന്നതിനാൽ,0,0,1,1
18524,inşa,0,0,1,1
18525,മൂക്കും,0,0,1,1
18526,воплощение,0,0,1,1
18527,сильны,0,0,1,1
18528,producers,0,0,1,1
18506,upptäckt,0,0,1,1
18505,usálo,0,0,1,1
18504,ടെസ്റ്റിലെ,0,0,1,1
18501,camel,0,0,1,1
18482,källa behövs,0,0,1,1
18484,fato,0,0,1,1
18485,ഭാഷകളും,0,0,1,1
18486,улыбаясь,0,0,1,1
18487,sucediendo,0,0,1,1
18489,தரப்பும்,0,0,1,1
18490,outgassing,0,0,1,1
18492,lua,0,0,1,1
18493,seçimler,0,0,1,1
18494,superieur,0,0,1,1
18495,castelhana,0,0,1,1
18496,ಉದಾಹರಣೆಗಳನ್ನು,0,0,1,1
18497,apologizing,0,0,1,1
18499,لتهنئة,0,0,1,1
18500,предыдущей,0,0,1,1
18529,свободным,0,0,1,1
18533,licenciada,0,0,1,1
18845,считать,0,0,1,1
18579,separation,0,0,1,1
18566,للقواعد,0,0,1,1
18567,efendim,0,0,1,1
18568,konusunda,0,0,1,1
18572,വിക്കിപീഡിയരേയും,0,0,1,1
18574,homossexual,0,0,1,1
18576,поднять,0,0,1,1
18578,klassische,0,0,1,1
18582,ബുഷ്,0,0,1,1
18534,الجميل,0,0,1,1
18583,"
सिन्धी",0,0,1,1
18584,dieciséis,0,0,1,1
18585,والاختلاف,0,0,1,1
18586,இருந்திருந்தால்,0,0,1,1
18589,ведётся,0,0,1,1
18590,«η,0,0,1,1
18591,afviste,0,0,1,1
18565,കാണുന്നില്ലെങ്കിൽ,0,0,1,1
18564,delicioso,0,0,1,1
18563,أندريا,0,0,1,1
18560,описано,0,0,1,1
18536,ηλεκτρονική,0,0,1,1
18537,yaklaşan,0,0,1,1
18538,ನೋಡುವಾಗ,0,0,1,1
18540,conséquent,0,0,1,1
18541,proliferate,0,0,1,1
18544,അനുബദ്ധ,0,0,1,1
18547,aanstootgevend,0,0,1,1
18548,universités,0,0,1,1
18549,residentes,0,0,1,1
18550,diecisiete,0,0,1,1
18553,tremendos,0,0,1,1
18554,يد,0,0,1,1
18555,организацию»,0,0,1,1
18556,சொற்களின்,0,0,1,1
18557,préparé,0,0,1,1
18481,பிடித்துக்,0,0,1,1
18477,rechten,0,0,1,1
18476,اقترح,0,0,1,1
18404,genererat,0,0,1,1
18395,fonctionne,0,0,1,1
18396,convenait,0,0,1,1
18398,mundo—​​,0,0,1,1
18399,साइटने,0,0,1,1
18400,« liberal »,0,0,1,1
18401,plagiering,0,0,1,1
18402,официально,0,0,1,1
18405,കഠിനമായ,0,0,1,1
18475,कोक,0,0,1,1
18406,koning,0,0,1,1
18407,fiables»,0,0,1,1
18411,ಕೋಪಗೊಂಡಿದ್ದೇನೆ,0,0,1,1
18412,остановка,0,0,1,1
18413,funciones—,0,0,1,1
18417,«написание,0,0,1,1
18420,« est,0,0,1,1
18392,familière,0,0,1,1
18391,ആർട്ടിഫിഷ്യൽ,0,0,1,1
18390,வருக,0,0,1,1
18389,pollueurpayeur,0,0,1,1
18368,colegial,0,0,1,1
18369,غمرني,0,0,1,1
18370,« actif »,0,0,1,1
18371,сэром,0,0,1,1
18373,işlerin,0,0,1,1
18374,الحلو,0,0,1,1
18376,консультируются»,0,0,1,1
18378,kunniga,0,0,1,1
18379,initiating,0,0,1,1
18381,உணர்த்தியுள்ளது,0,0,1,1
18382,pisa,0,0,1,1
18383,अहंकारी,0,0,1,1
18384,ασημένιο,0,0,1,1
18385,acrescentou,0,0,1,1
18387,явный,0,0,1,1
18421,volatil,0,0,1,1
18422,significatif,0,0,1,1
18424,memex,0,0,1,1
18452,влиятельных,0,0,1,1
18454,ज़रूर,0,0,1,1
18455,perdí,0,0,1,1
18456,surveiller,0,0,1,1
18459,определении,0,0,1,1
18463,бора,0,0,1,1
18464,സംഭവിക്കാത്ത,0,0,1,1
18465,konservativa,0,0,1,1
18466,notoriété,0,0,1,1
18467,dilerim,0,0,1,1
18469,provet,0,0,1,1
18470,സംബന്ധിച്ചുണ്ടായ,0,0,1,1
18471,произносится,0,0,1,1
18472,ongeluk,0,0,1,1
18473,habría,0,0,1,1
18474,shakespeare,0,0,1,1
18453,allvarligt,0,0,1,1
18451,ಏಕೈಕ,0,0,1,1
18426,красоты,0,0,1,1
18450,oversvømmelse,0,0,1,1
18427,hädelse,0,0,1,1
18428,declines,0,0,1,1
18430,بامتلاك,0,0,1,1
18431,fühlen,0,0,1,1
18434,acumulado,0,0,1,1
18437,clases,0,0,1,1
18439,eliminador,0,0,1,1
18440,cerveau,0,0,1,1
18441,يصنع,0,0,1,1
18442,kendileri,0,0,1,1
18443,gewonnen,0,0,1,1
18444,എന്നതുപോലെയല്ല,0,0,1,1
18447,നിയമസംഹിതയോ,0,0,1,1
18448,मरम्मत,0,0,1,1
18449,tapisseries,0,0,1,1
18594,millimètreréf,0,0,1,1
18595,innate,0,0,1,1
18597,फीचर्ड,0,0,1,1
18770,اليكم,0,0,1,1
18759,صديقتك,0,0,1,1
18760,ونرجسية,0,0,1,1
18764,visite,0,0,1,1
18766,ആയിരുന്നെങ്കിൽ,0,0,1,1
18767,verkeerd,0,0,1,1
18768,öğreneceğiz,0,0,1,1
18769,внести,0,0,1,1
18771,കുട്ടിക്ക്,0,0,1,1
18727,туристической,0,0,1,1
18772,الصلة,0,0,1,1
18775,حلت,0,0,1,1
18776,மறுநாள்,0,0,1,1
18777,kvartalet,0,0,1,1
18778,انتحال,0,0,1,1
18780,ദിവസവും,0,0,1,1
18782,نول,0,0,1,1
18758,серьёзный,0,0,1,1
18757,velocidad,0,0,1,1
18755,​​persoon,0,0,1,1
18754,gevaar,0,0,1,1
18732,معاملة,0,0,1,1
18733,publicitaire,0,0,1,1
18734,நாசீசஸின்,0,0,1,1
18735,ഗ്രാമത്തിൽ,0,0,1,1
18736,அடையச்,0,0,1,1
18737,administrative,0,0,1,1
18738,reparera,0,0,1,1
18740,square,0,0,1,1
18742,donaties,0,0,1,1
18744,പതാകവാഹക‍,0,0,1,1
18745,घटनाएं,0,0,1,1
18749,pourrez,0,0,1,1
18750,bulundukları,0,0,1,1
18752,onehalf,0,0,1,1
18753,обнаружен,0,0,1,1
18784,ബഹിരാകാശം,0,0,1,1
18786,başlayalım,0,0,1,1
18787,planetary,0,0,1,1
18814,ಮಾಡಬೇಕಾಗಿದೆ,0,0,1,1
18817,மணமான,0,0,1,1
18818,assisté,0,0,1,1
18821,demography,0,0,1,1
18822,ψήσω,0,0,1,1
18823,குழந்தைக்கோ,0,0,1,1
18825,sömnen,0,0,1,1
18826,بمقدار,0,0,1,1
18828,തെളിവുകളുണ്ടാകണം,0,0,1,1
18829,കരയുന്ന,0,0,1,1
18830,δηλώσει,0,0,1,1
18831,العودة,0,0,1,1
18836,unexpected,0,0,1,1
18839,mètres,0,0,1,1
18841,ಒಳ್ಳೆಯವರಂತೆ,0,0,1,1
18842,d’accident,0,0,1,1
18815,brödbröd,0,0,1,1
18813,яркие,0,0,1,1
18789,вебпорталом,0,0,1,1
18811,téléspectateurs,0,0,1,1
18790,befinner,0,0,1,1
18792,levebröd,0,0,1,1
18794,إداريو,0,0,1,1
18795,naviguer,0,0,1,1
18796,almorzar,0,0,1,1
18798,مقابلة,0,0,1,1
18799,soruyorsa,0,0,1,1
18800,commonso,0,0,1,1
18802,ഡാറ്റാ,0,0,1,1
18803,истинность,0,0,1,1
18806,ഗൂഗിളിലേക്ക്,0,0,1,1
18807,patent,0,0,1,1
18808,குறுங்கட்டுரையாகவே,0,0,1,1
18809,surgir,0,0,1,1
18810,मिले,0,0,1,1
18728,ಆವರಿಸಿಕೊಳ್ಳಬಹುದೇ,0,0,1,1
18725,ചെയ്തിരിക്കുന്ന,0,0,1,1
18599,φοβερού,0,0,1,1
18647,filling,0,0,1,1
18633,çevreleyen,0,0,1,1
18634,desconcertar,0,0,1,1
18635,സവിശേഷതയാണ്,0,0,1,1
18643,ആരംഭിക്കുന്നതിനുള്ള,0,0,1,1
18644,λόγια,0,0,1,1
18645,täcker,0,0,1,1
18646,felicitaciones,0,0,1,1
18648,ಪಡೆಯುವುದಿಲ್ಲ,0,0,1,1
18724,استقرارا,0,0,1,1
18649,تحياتي,0,0,1,1
18650,سمعته,0,0,1,1
18651,பொருள்படும்,0,0,1,1
18655,retirer,0,0,1,1
18656,производстве,0,0,1,1
18657,جالسين,0,0,1,1
18662,secretive,0,0,1,1
18632,நத்தை,0,0,1,1
18630,detecting,0,0,1,1
18629,φράσεων,0,0,1,1
18628,محق,0,0,1,1
18600,düşünmeme,0,0,1,1
18603,medicinal,0,0,1,1
18604,secondes,0,0,1,1
18606,freezing,0,0,1,1
18608,chercheuse,0,0,1,1
18609,മടുപ്പില്ല,0,0,1,1
18611,vorbei,0,0,1,1
18615,austriaca,0,0,1,1
18616,apariencias,0,0,1,1
18618,coopération,0,0,1,1
18620,ಮಾಡಲಿಲ್ಲ,0,0,1,1
18621,நுழைந்தார்கள்,0,0,1,1
18623,означающей,0,0,1,1
18626,planétaires,0,0,1,1
18627,andamán,0,0,1,1
18663,ഏതുസമയത്തും,0,0,1,1
18664,ziyarete,0,0,1,1
18669,सईनपोस्ट,0,0,1,1
18697,पूछें।,0,0,1,1
18699,tårar,0,0,1,1
18700,للمناقشة,0,0,1,1
18702,pisar,0,0,1,1
18706,ഇൻപുട്ടുകൾ,0,0,1,1
18707,machine »,0,0,1,1
18708,excessivamente,0,0,1,1
18711,nontrivial,0,0,1,1
18713,zwaaiden,0,0,1,1
18714,betraktades,0,0,1,1
18715,ونميل,0,0,1,1
18716,ಆಟವನ್ನು,0,0,1,1
18717,ಹೆಬ್ಬೆರಳು,0,0,1,1
18718,kämpfte,0,0,1,1
18719,ലഭിക്കുന്നതിന്,0,0,1,1
18722,اللذيذ,0,0,1,1
18698,ಬಳಸುವುದು,0,0,1,1
18696,மேற்பார்வையின்,0,0,1,1
18670,सुझाव।,0,0,1,1
18694,encyclopédiet,0,0,1,1
18671,consulté »,0,0,1,1
18672,القدرة,0,0,1,1
18674,χρυσός,0,0,1,1
18675,مربع,0,0,1,1
18678,எடுத்துக்காட்டாக,0,0,1,1
18679,disminuyendo,0,0,1,1
18680,நிறுவனத்திற்குச்,0,0,1,1
18682,caractérise »,0,0,1,1
18683,யூ,0,0,1,1
18684,ستنجح,0,0,1,1
18686,derive,0,0,1,1
18687,созданы,0,0,1,1
18690,gætter,0,0,1,1
18692,actif,0,0,1,1
18693,പരുഷമായി,0,0,1,1
21267,υποδηλώνει,0,0,1,1
21272,चली,0,0,1,1
25172,കടിയെടുത്തു,0,0,1,1
23814,sahne,0,0,1,1
23806,أسقطت,0,0,1,1
23807,ശൈലികളെയും,0,0,1,1
23808,போன்றவர்,0,0,1,1
23809,व्यवधान,0,0,1,1
23811,составляла,0,0,1,1
23812,красотой,0,0,1,1
23813,tilbud,0,0,1,1
23815,géologiques,0,0,1,1
23832,ಇದಕ್ಕೆ,0,0,1,1
23816,parmaklarımda,0,0,1,1
23817,våtmark,0,0,1,1
23820,банку,0,0,1,1
23823,förutsätts,0,0,1,1
23824,இயக்கத்துக்கு,0,0,1,1
23825,எல்லாவற்றிற்கும்,0,0,1,1
23826,لقاء,0,0,1,1
23805,enbomis,0,0,1,1
23804,பயன்படுத்திக்,0,0,1,1
23803,valuing,0,0,1,1
23801,lenen,0,0,1,1
23777,γνωστή,0,0,1,1
23778,недостоверная,0,0,1,1
23783,opère,0,0,1,1
23785,കണക്കാക്കാം,0,0,1,1
23786,എന്നും,0,0,1,1
23787,textonly,0,0,1,1
23788,voulezvous,0,0,1,1
23789,സന്നദ്ധ,0,0,1,1
23790,bulmuştur,0,0,1,1
23792,написания,0,0,1,1
23794,ರಹಸ್ಯವಾಗಿ,0,0,1,1
23796,objectivement,0,0,1,1
23798,contribuem,0,0,1,1
23799,grandir,0,0,1,1
23800,لجنة,0,0,1,1
23831,vanlig,0,0,1,1
23833,കണ്ണാടിയിലോ,0,0,1,1
23902,συχνά,0,0,1,1
23881,finite,0,0,1,1
23867,hoaxen,0,0,1,1
23868,നിസ്സാരനായിരിക്കാം,0,0,1,1
23869,മനുഷ്യർക്കിടയിൽ,0,0,1,1
23870,getrouwd,0,0,1,1
23872,preocupaba,0,0,1,1
23876,замуж,0,0,1,1
23878,بالأحجار,0,0,1,1
23882,alimenter,0,0,1,1
23834,diyorlarsa,0,0,1,1
23886,"
वेब",0,0,1,1
23887,englischen,0,0,1,1
23888,violado,0,0,1,1
23890,„ахиллесовой,0,0,1,1
23897,françois,0,0,1,1
23898,şatodan,0,0,1,1
23899,surprise,0,0,1,1
23866,rudely,0,0,1,1
23863,தொடர்பான,0,0,1,1
23862,calm,0,0,1,1
23860,wikipediaresurser,0,0,1,1
23837,الجيش,0,0,1,1
23840,идут,0,0,1,1
23841,സ്വർണ്ണമായും,0,0,1,1
23842,"
silesiano",0,0,1,1
23845,против,0,0,1,1
23849,القلب,0,0,1,1
23851,opslagcapaciteit,0,0,1,1
23852,almacén,0,0,1,1
23853,പോകുന്നുവെങ്കിൽ,0,0,1,1
23854,derude,0,0,1,1
23855,الصينية,0,0,1,1
23856,pájaro,0,0,1,1
23857,φωνής,0,0,1,1
23858,featureartikler,0,0,1,1
23859,astéroïde,0,0,1,1
23776,يتمكن,0,0,1,1
23774,ಪಡುತ್ತಿದ್ದೆ,0,0,1,1
23773,വിവരിക്കുന്നതിനാലാണ്,0,0,1,1
23705,ഓഫറുകൾ,0,0,1,1
23694,оригинальные,0,0,1,1
23696,valenciana,0,0,1,1
23697,låst,0,0,1,1
23700,بإجمالي,0,0,1,1
23701,refletem,0,0,1,1
23702,ഫോണിൽ,0,0,1,1
23704,كومنز,0,0,1,1
23706,نسوا,0,0,1,1
23771,ситуация,0,0,1,1
23707,gekümmert,0,0,1,1
23708,parvint,0,0,1,1
23709,ಹಸಿವಿನಿಂದ,0,0,1,1
23710,ದೀರ್ಘಕಾಲ,0,0,1,1
23711,lección,0,0,1,1
23712,முறையே,0,0,1,1
23713,consultations,0,0,1,1
23693,dehaene,0,0,1,1
23690,തേടുകയാണ്,0,0,1,1
23689,fjortonde,0,0,1,1
23688,connectionist,0,0,1,1
23662,adaptable,0,0,1,1
23664,recep,0,0,1,1
23665,исследованиях,0,0,1,1
23666,tes,0,0,1,1
23668,организатор,0,0,1,1
23671,ಉದಾಹರಣೆಗಳಂತೆ,0,0,1,1
23674,जाए।,0,0,1,1
23676,адресу,0,0,1,1
23678,transcendentalism,0,0,1,1
23680,δροσερές,0,0,1,1
23681,finalité,0,0,1,1
23682,എടുക്കുന്നതുപോലെ,0,0,1,1
23685,устаю,0,0,1,1
23686,ساعات,0,0,1,1
23687,fueran,0,0,1,1
23714,കണ്ണുനീരിന്,0,0,1,1
23715,profunda,0,0,1,1
23716,gérés,0,0,1,1
23746,cinste,0,0,1,1
23748,traditionellt,0,0,1,1
23749,gibt,0,0,1,1
23751,arbetssättet,0,0,1,1
23752,تخريبًا,0,0,1,1
23753,കോമൺസ്,0,0,1,1
23754,kretsar,0,0,1,1
23755,promueven,0,0,1,1
23756,വീട്ടിലെത്തിയതായും,0,0,1,1
23758,बिनालाभार्जन,0,0,1,1
23759,visualizar,0,0,1,1
23761,neutralt,0,0,1,1
23762,forfait,0,0,1,1
23765,infinie,0,0,1,1
23768,voldtægtshændelser,0,0,1,1
23769,cine,0,0,1,1
23747,beklemesini,0,0,1,1
23744,غيرت,0,0,1,1
23717,изобретений,0,0,1,1
23741,кэша,0,0,1,1
23718,ब्रांडचैनलकॉम,0,0,1,1
23719,philosophicalcontent,0,0,1,1
23722,общественном,0,0,1,1
23723,കൊണ്ടുവരട്ടെ,0,0,1,1
23724,группе,0,0,1,1
23725,doméstico,0,0,1,1
23726,limités,0,0,1,1
23727,отношении,0,0,1,1
23729,കാമ്പ്,0,0,1,1
23730,ಹಹ್,0,0,1,1
23731,биография,0,0,1,1
23732,sexton,0,0,1,1
23733,المظهر,0,0,1,1
23734,privilegiadas,0,0,1,1
23736,σέρνουν,0,0,1,1
23901,extraordinaire,0,0,1,1
23903,vereiste,0,0,1,1
24154,découvrir,0,0,1,1
24086,விரும்புவதாகக்,0,0,1,1
24074,transcendantalisme,0,0,1,1
24075,macht,0,0,1,1
24077,utilisait,0,0,1,1
24078,wäsche,0,0,1,1
24079,இணையக்,0,0,1,1
24080,demostrarse,0,0,1,1
24082,пропустить,0,0,1,1
24087,commandement,0,0,1,1
24098,تحديد,0,0,1,1
24088,lustigen,0,0,1,1
24090,وgerman،,0,0,1,1
24091,ಪಡೆದಾಗ,0,0,1,1
24093,நண்பனைப்,0,0,1,1
24094,hopelijk,0,0,1,1
24095,diversidad,0,0,1,1
24096,штате,0,0,1,1
24073,διασχίζετε,0,0,1,1
24072,flow,0,0,1,1
24070,encoding,0,0,1,1
24069,asemejen,0,0,1,1
24045,rituais,0,0,1,1
24048,വച്ചിരുന്നു,0,0,1,1
24049,protestataire,0,0,1,1
24052,derslerimi,0,0,1,1
24053,തോന്നാൻ,0,0,1,1
24056,വളരെയധികമില്ല,0,0,1,1
24058,cultureel,0,0,1,1
24059,சகோதரத்,0,0,1,1
24060,anarchy,0,0,1,1
24061,necesidades,0,0,1,1
24063,actuelles,0,0,1,1
24065,பிரிந்து,0,0,1,1
24066,primario,0,0,1,1
24067,फ्यूचर,0,0,1,1
24068,குறைவான,0,0,1,1
24097,تخريب,0,0,1,1
24099,historietas,0,0,1,1
23904,بالمائة،,0,0,1,1
24136,yayımlanan,0,0,1,1
24127,multidimensional,0,0,1,1
24129,alınmış,0,0,1,1
24130,wikifika,0,0,1,1
24132,"
sérvio",0,0,1,1
24133,hizmetlileri,0,0,1,1
24134,എഴുതപ്പെടുന്ന,0,0,1,1
24135,القمر،,0,0,1,1
24137,reconhecido,0,0,1,1
24100,தொடங்கப்,0,0,1,1
24140,​​அவர்,0,0,1,1
24142,неразумным,0,0,1,1
24144,condensing,0,0,1,1
24146,aurez,0,0,1,1
24147,geloven,0,0,1,1
24150,ganz,0,0,1,1
24152,swallow,0,0,1,1
24126,raconte,0,0,1,1
24124,darnos,0,0,1,1
24123,ಇಬ್ಬರೂ,0,0,1,1
24122,കേൾക്കാതെ,0,0,1,1
24101,énormément,0,0,1,1
24102,instrui,0,0,1,1
24103,ನಿಜವಾದ,0,0,1,1
24104,young,0,0,1,1
24105,atomic,0,0,1,1
24106,വജ്രങ്ങളിലും,0,0,1,1
24107,ಪ್ರಾರಂಭಿಸಲಿದ್ದರೆ,0,0,1,1
24108,formler,0,0,1,1
24110,kızgınım,0,0,1,1
24113,ejakulation,0,0,1,1
24115,sakligt,0,0,1,1
24117,വിവരണം,0,0,1,1
24118,നോക്കട്ടെ,0,0,1,1
24120,knappe,0,0,1,1
24121,digesting,0,0,1,1
24044,وجبة,0,0,1,1
24043,ഇൻപുട്ടിൽ,0,0,1,1
24042,çalışabilir,0,0,1,1
23961,كائنات,0,0,1,1
23947,soffa,0,0,1,1
23948,таинственное,0,0,1,1
23949,சிவப்பு,0,0,1,1
23950,acción,0,0,1,1
23954,programmeur,0,0,1,1
23955,ಅರ್ಥಮಾಡಿಕೊಳ್ಳದಿದ್ದರೆ,0,0,1,1
23959,heyecan,0,0,1,1
23963,wellordered,0,0,1,1
24041,subkultur,0,0,1,1
23964,personas​​,0,0,1,1
23965,അവസാനിച്ചിട്ടില്ല,0,0,1,1
23966,lykønske,0,0,1,1
23967,select,0,0,1,1
23968,variant,0,0,1,1
23970,relecture,0,0,1,1
23971,كذباً,0,0,1,1
23943,afijo,0,0,1,1
23942,विज्ञापनों,0,0,1,1
23937,th •,0,0,1,1
23933,வியப்படைந்தாள்,0,0,1,1
23906,संज्ञाओं,0,0,1,1
23909,toevoegen,0,0,1,1
23910,girilerek,0,0,1,1
23914,berufserfahrung,0,0,1,1
23915,besöka,0,0,1,1
23916,supprimée,0,0,1,1
23917,causou,0,0,1,1
23918,indicarles,0,0,1,1
23919,votes,0,0,1,1
23922,tab,0,0,1,1
23923,überhäuft,0,0,1,1
23924,élaboré,0,0,1,1
23926,nåd,0,0,1,1
23930,oluşturma,0,0,1,1
23931,krävas,0,0,1,1
23973,regelmatig,0,0,1,1
23974,koruyabilir,0,0,1,1
23978,måneder,0,0,1,1
24010,ಹುಡುಕಾಟದಲ್ಲಿ,0,0,1,1
24014,ಹೆಚ್ಚಿಸಿ,0,0,1,1
24018,நடவு,0,0,1,1
24019,cahiers,0,0,1,1
24020,signing,0,0,1,1
24021,έβγαλα,0,0,1,1
24023,составление,0,0,1,1
24024,لحل,0,0,1,1
24025,ederler,0,0,1,1
24027,കർണ്ണാടകയും,0,0,1,1
24028,प्रशंसात्मक,0,0,1,1
24029,ചെയ്യാനും,0,0,1,1
24031,കണ്ടിട്ടില്ലെന്നാണ്,0,0,1,1
24033,autopromocionales,0,0,1,1
24034,lita,0,0,1,1
24039,உட்கார்ந்திருந்த,0,0,1,1
24013,грубо,0,0,1,1
24009,plate,0,0,1,1
23979,μύτη,0,0,1,1
24008,independentlyrun,0,0,1,1
23981,hemligt,0,0,1,1
23983,ihtiyacım,0,0,1,1
23984,असाधारण,0,0,1,1
23985,وتوزيع,0,0,1,1
23986,suivantes,0,0,1,1
23987,seriously,0,0,1,1
23988,нанесён,0,0,1,1
23992,wish,0,0,1,1
23995,paseo,0,0,1,1
23997,உரிமத்திற்கு,0,0,1,1
23998,வந்திருந்தார்,0,0,1,1
23999,أنهم,0,0,1,1
24004,drukne,0,0,1,1
24005,जयादा,0,0,1,1
24007,помедленнее,0,0,1,1
23661,artificiel ,0,0,1,1
23660,ಖಚಿತವಿಲ್ಲ,0,0,1,1
23659,aardiger,0,0,1,1
23347,vorschlag,0,0,1,1
23338,κρατήσετε,0,0,1,1
23339,பங்களிப்பாளர்களுக்கு,0,0,1,1
23340,gåva,0,0,1,1
23342,autorisé,0,0,1,1
23343,"w
अज़रबैजानी",0,0,1,1
23345,താൽ‌പ്പര്യമുണ്ടെങ്കിൽ‌,0,0,1,1
23346,ಬುದ್ಧಿವಂತಿಕೆಯು,0,0,1,1
23348,citerade,0,0,1,1
23362,يواجه,0,0,1,1
23349,أسرة,0,0,1,1
23351,catedral,0,0,1,1
23352,وشرح,0,0,1,1
23353,riesigen,0,0,1,1
23354,செல்வங்களுக்கு,0,0,1,1
23356,വാക്യത്തിന്റെ,0,0,1,1
23357,சொற்களில்,0,0,1,1
23337,medication,0,0,1,1
23336,cablegate,0,0,1,1
23335,connectée,0,0,1,1
23332,नाक,0,0,1,1
23307,மிகப்பெரும்,0,0,1,1
23308,ಚಿನ್ನವನ್ನು,0,0,1,1
23309,واللغات,0,0,1,1
23312,प्रॉजेक्ट्स,0,0,1,1
23313,exploitent,0,0,1,1
23314,रीतिरिवाजों,0,0,1,1
23315,जानना,0,0,1,1
23318,eclat,0,0,1,1
23319,नाय्नोर्स्क,0,0,1,1
23320,doublé ,0,0,1,1
23321,യന്ത്രത്തിൻറെ,0,0,1,1
23323,dahil,0,0,1,1
23324,kommentarfeltet,0,0,1,1
23328,देंगे,0,0,1,1
23329,docka,0,0,1,1
23360,virtuellement,0,0,1,1
23365,wegen,0,0,1,1
23658,അവബോധത്തോടെ,0,0,1,1
23407,авторитетность,0,0,1,1
23395,लगाते,0,0,1,1
23396,salée,0,0,1,1
23397,geprägt,0,0,1,1
23402,propensas,0,0,1,1
23403,ثابتة,0,0,1,1
23404,σοβαρή,0,0,1,1
23405,ஏனைய,0,0,1,1
23408,sakinleşin,0,0,1,1
23366,willemalexander,0,0,1,1
23409,выпустила,0,0,1,1
23410,arrête,0,0,1,1
23412,الخصوص،,0,0,1,1
23413,aceptación,0,0,1,1
23414,escolar,0,0,1,1
23416,​​geräusch,0,0,1,1
23417,«сообщество»,0,0,1,1
23394,ಅದೃಷ್ಟವಂತ,0,0,1,1
23392,സഹായിക്കാമോ,0,0,1,1
23391,άποψης,0,0,1,1
23390,antissocial,0,0,1,1
23368,abarcar,0,0,1,1
23371,ısırık,0,0,1,1
23372,especificando,0,0,1,1
23373,vrijgave,0,0,1,1
23374,immatériel ,0,0,1,1
23375,ведущие,0,0,1,1
23377,कार्यक्षमता,0,0,1,1
23379,distribuídas,0,0,1,1
23380,المنشأة,0,0,1,1
23382,folder,0,0,1,1
23383,visitor,0,0,1,1
23384,девушка,0,0,1,1
23386,snarare,0,0,1,1
23387,ഓളം,0,0,1,1
23389,scientist,0,0,1,1
23305,balkondan,0,0,1,1
23303,wikiprojects,0,0,1,1
23302,portals,0,0,1,1
23231,viva,0,0,1,1
23221,disminuido,0,0,1,1
23222,bce,0,0,1,1
23224,எளிதில்,0,0,1,1
23225,‘பேச்சுப்பக்கம்’,0,0,1,1
23226,gönüllülerin,0,0,1,1
23227,بوضوح,0,0,1,1
23230,elite,0,0,1,1
23232,ατόμου,0,0,1,1
23300,«anónima»,0,0,1,1
23233,comparaisons,0,0,1,1
23234,patruljerer,0,0,1,1
23236,للمنزل؟,0,0,1,1
23237,ಹತ್ತಿದಳು,0,0,1,1
23238,erstaunliches,0,0,1,1
23240,bildiğin,0,0,1,1
23241,sanningsenlig,0,0,1,1
23220,ಕಲಿಯಲಿದ್ದೇವೆ,0,0,1,1
23217,brusca,0,0,1,1
23216,färdigheter,0,0,1,1
23215,إذ,0,0,1,1
23193,annuaire,0,0,1,1
23194,trait,0,0,1,1
23195,κάπως,0,0,1,1
23196,öğrenelim,0,0,1,1
23197,basisconcept,0,0,1,1
23198,desperté,0,0,1,1
23199,dammit,0,0,1,1
23200,توش،,0,0,1,1
23202,obscenities,0,0,1,1
23204,لطيفًا,0,0,1,1
23207,സ്ഥാപനമാണ്,0,0,1,1
23208,владеющей,0,0,1,1
23209,уровне,0,0,1,1
23211,المستقل,0,0,1,1
23212,நுபீடியாவிற்கான,0,0,1,1
23245,comentando,0,0,1,1
23246,bekendmaken,0,0,1,1
23248,diras,0,0,1,1
23276,aprendido,0,0,1,1
23279,dialogueur,0,0,1,1
23280,denen,0,0,1,1
23282,acompanhamento,0,0,1,1
23285,выглядишь,0,0,1,1
23286,പരീക്ഷിച്ചുനോക്കാൻ,0,0,1,1
23287,இயங்கத்,0,0,1,1
23288,പ്രവചിക്കുന്ന,0,0,1,1
23289,bütün,0,0,1,1
23290,baikecom,0,0,1,1
23291,højttalerikon,0,0,1,1
23292,التغطية,0,0,1,1
23293,monitorados,0,0,1,1
23295,வினைச்சொல்லாக,0,0,1,1
23298,بدوا,0,0,1,1
23299,മറികടന്നുവെന്നും,0,0,1,1
23278,rapporterade,0,0,1,1
23275,حقيقي,0,0,1,1
23249,പുതുമുഖങ്ങൾക്ക്,0,0,1,1
23273,ಆಟದ,0,0,1,1
23251,डूबना,0,0,1,1
23253,стоило,0,0,1,1
23254,مفتوح,0,0,1,1
23255,प्रति,0,0,1,1
23257,autónoma,0,0,1,1
23258,territorio,0,0,1,1
23259,developing,0,0,1,1
23260,riguroso,0,0,1,1
23263,economie,0,0,1,1
23264,propuestos,0,0,1,1
23265,kerel,0,0,1,1
23267,compléter,0,0,1,1
23270,demographic,0,0,1,1
23271,இணைப்பை,0,0,1,1
23272,l’intégralité,0,0,1,1
23418,американской,0,0,1,1
23419,cadaver,0,0,1,1
23420,contraire ,0,0,1,1
23579,multinacionales,0,0,1,1
23570,பார்வை,0,0,1,1
23572,editathons,0,0,1,1
23573,தங்கமாகவும்,0,0,1,1
23574,yazarlarının,0,0,1,1
23575,αγγλική,0,0,1,1
23576,العزيز,0,0,1,1
23577,sodass,0,0,1,1
23580,συνειδητοποιήσω,0,0,1,1
23540,çılgın,0,0,1,1
23581,जीते।,0,0,1,1
23582,passende,0,0,1,1
23583,ಉದ್ಯೋಗವನ್ನು,0,0,1,1
23584,contacto,0,0,1,1
23586,pnb •,0,0,1,1
23588,oposto,0,0,1,1
23593,divisant,0,0,1,1
23568,estender,0,0,1,1
23564,डायरेक्टर,0,0,1,1
23563,هاتفك,0,0,1,1
23561,coffee,0,0,1,1
23544,avbryta,0,0,1,1
23545,உற்சாகமான,0,0,1,1
23546,вкусно,0,0,1,1
23547,"
पीड्मॉण्टी",0,0,1,1
23548,managers,0,0,1,1
23549,änderte,0,0,1,1
23550,காத்திருப்பு,0,0,1,1
23551,l’interprétabilité,0,0,1,1
23552,kazandı,0,0,1,1
23553,negras,0,0,1,1
23554,usaría,0,0,1,1
23556,aportar,0,0,1,1
23557,​​het,0,0,1,1
23558,yazdıklarının,0,0,1,1
23559,एस,0,0,1,1
23594,sexta,0,0,1,1
23595,llamaron,0,0,1,1
23597,réunie,0,0,1,1
23625,hybrides,0,0,1,1
23631,incohérences,0,0,1,1
23632,иракскую,0,0,1,1
23633,coréenne,0,0,1,1
23634,"jpdk
",0,0,1,1
23636,ಒಬ್ಬರನ್ನೊಬ್ಬರು,0,0,1,1
23638,unes,0,0,1,1
23639,genomsnitt,0,0,1,1
23640,أربع,0,0,1,1
23642,индексации,0,0,1,1
23644,adelantarse,0,0,1,1
23647,‘சியாகோமோ,0,0,1,1
23648,erosion,0,0,1,1
23649,venez,0,0,1,1
23651,opcional,0,0,1,1
23655,συναντήσει,0,0,1,1
23630,autoconfirmed,0,0,1,1
23624,coloniale,0,0,1,1
23598,ഘട്ടമാണിത്,0,0,1,1
23621,olanı,0,0,1,1
23599,arz •,0,0,1,1
23600,marianne,0,0,1,1
23601,finest,0,0,1,1
23604,ಪ್ರಶ್ನಾರ್ಥಕ,0,0,1,1
23606,صديقان,0,0,1,1
23608,encyclonl,0,0,1,1
23609,dédié,0,0,1,1
23611,forth,0,0,1,1
23612,ur •,0,0,1,1
23613,acıktım,0,0,1,1
23614,الأوربية,0,0,1,1
23615,जबरदस्त,0,0,1,1
23617,некоторыми,0,0,1,1
23618,какимто,0,0,1,1
23620,visiteur,0,0,1,1
23542,мышей,0,0,1,1
23539,പണമുണ്ടെന്ന്,0,0,1,1
23422,ಹಾದುಹೋಗಬಹುದು,0,0,1,1
23462,chics,0,0,1,1
23451,casser,0,0,1,1
23452,wensen,0,0,1,1
23454,acceptere,0,0,1,1
23455,definitive,0,0,1,1
23457,जी,0,0,1,1
23459,avdelning,0,0,1,1
23460,suivre »,0,0,1,1
23463,നേരത്തെ,0,0,1,1
23538,പക്ഷപാതിത്വം,0,0,1,1
23469,amazon,0,0,1,1
23471,fréquentation,0,0,1,1
23472,bitirmeme,0,0,1,1
23473,άδεια,0,0,1,1
23475,izing,0,0,1,1
23477,intención,0,0,1,1
23478,изданы,0,0,1,1
23450,மூலமாக,0,0,1,1
23448,ದೂರುವುದು,0,0,1,1
23447,leider,0,0,1,1
23446,вводится,0,0,1,1
23423,« passage,0,0,1,1
23425,inletts,0,0,1,1
23426,செல்வம்,0,0,1,1
23428,microsystems,0,0,1,1
23429,ar •,0,0,1,1
23430,magnetic,0,0,1,1
23432,έσπασε,0,0,1,1
23433,streefde,0,0,1,1
23434,താൽ‌പ്പര്യപ്പെടുന്നെങ്കിൽ‌,0,0,1,1
23435,zorlandı,0,0,1,1
23437,തിരുത്താനും,0,0,1,1
23438,risos,0,0,1,1
23439,учётных,0,0,1,1
23442,pancarte,0,0,1,1
23443,skikke,0,0,1,1
23479,gwh,0,0,1,1
23481,accélérée,0,0,1,1
23482,proved,0,0,1,1
23510,atteinte,0,0,1,1
23512,—en,0,0,1,1
23514,instructs,0,0,1,1
23516,doublingtime,0,0,1,1
23519,ഭാഗമായി,0,0,1,1
23520,estúpido,0,0,1,1
23521,cream,0,0,1,1
23524,എങ്ങനെയെങ്കിലും,0,0,1,1
23525,занимает,0,0,1,1
23526,högt,0,0,1,1
23528,perfectionnement,0,0,1,1
23531,descoberta,0,0,1,1
23533,amérindiennes,0,0,1,1
23534,regrouper,0,0,1,1
23536,وسأكون,0,0,1,1
23537,aumentarem,0,0,1,1
23511,തീരുമാനമാണെന്നും,0,0,1,1
23509,способов,0,0,1,1
23484,ağlamayı,0,0,1,1
23508,freuen,0,0,1,1
23485,proceeds,0,0,1,1
23487,cuja,0,0,1,1
23489,promise,0,0,1,1
23490,கலைக்களஞ்சியம்,0,0,1,1
23492,ಫಿಕ್ಸ್‌ನಲ್ಲಿದ್ದಾಗ,0,0,1,1
23493,woche,0,0,1,1
23494,طفل,0,0,1,1
23496,ودفعت,0,0,1,1
23498,constate,0,0,1,1
23499,meldden,0,0,1,1
23501,تجمع,0,0,1,1
23503,améliorez,0,0,1,1
23504,ومختلفة,0,0,1,1
23505,verreweg,0,0,1,1
23507,liberar,0,0,1,1
24153,учётом,0,0,1,1
24155,расходятся,0,0,1,1
23190,zamandı,0,0,1,1
24846,« utilisateur »l,0,0,1,1
24832,συμπλήρωμα,0,0,1,1
24834,έσπασαν,0,0,1,1
24836,variadíssimos,0,0,1,1
24837,stavet,0,0,1,1
24838,حادثة,0,0,1,1
24842,propone,0,0,1,1
24845,питтсбурга,0,0,1,1
24850,raul,0,0,1,1
24862,bordmanerer,0,0,1,1
24851,είμαστε,0,0,1,1
24853,licences,0,0,1,1
24854,польском,0,0,1,1
24856,discussions etc,0,0,1,1
24857,मेलिस्सा,0,0,1,1
24858,ytterligare,0,0,1,1
24859,plötsligt,0,0,1,1
24831,публикация,0,0,1,1
24830,प्राधिकरण,0,0,1,1
24829,страницам,0,0,1,1
24827,tamir,0,0,1,1
24806,smuts,0,0,1,1
24807,ഇന്ത്യാ,0,0,1,1
24809,trouvent,0,0,1,1
24811,güisquipedia,0,0,1,1
24812,banned,0,0,1,1
24813,eyaleti,0,0,1,1
24815,لاحقة،,0,0,1,1
24817,confusas,0,0,1,1
24819,ಮನೋರಂಜನಾ,0,0,1,1
24820,مجتمعية,0,0,1,1
24821,bénéfice,0,0,1,1
24822,kontinuerligt,0,0,1,1
24823,vulgariser,0,0,1,1
24824,βικειπαιδιας,0,0,1,1
24825,tänk,0,0,1,1
24860,onthouden,0,0,1,1
24863,товарный,0,0,1,1
24921,ومفتقدًا,0,0,1,1
24908,കാര്യനിർവ്വാഹകരെ,0,0,1,1
24897,regelmæssigt,0,0,1,1
24898,франко,0,0,1,1
24900,മാറുന്നു,0,0,1,1
24901,specifieke,0,0,1,1
24902,implementará,0,0,1,1
24906,அம்மாவுக்குத்,0,0,1,1
24907,genèse,0,0,1,1
24910,வேண்டியதெல்லாம்,0,0,1,1
24864,fremstille,0,0,1,1
24911,يكتبه,0,0,1,1
24912,സമൂഹത്തിന്,0,0,1,1
24913,notoires,0,0,1,1
24914,сбитым,0,0,1,1
24915,आलसी,0,0,1,1
24917,suitable,0,0,1,1
24919,அதேபோல்,0,0,1,1
24896,августе,0,0,1,1
24895,​​από,0,0,1,1
24889,göreceli,0,0,1,1
24888,συμφωνήσω,0,0,1,1
24865,கடந்துவிட்டீர்கள்,0,0,1,1
24866,mangez,0,0,1,1
24867,वेंडरबिल्ट,0,0,1,1
24869,urging,0,0,1,1
24870,परे,0,0,1,1
24871,நினைத்தாள்,0,0,1,1
24872,existiam,0,0,1,1
24876,heurísticas,0,0,1,1
24877,piensas,0,0,1,1
24879,acheter,0,0,1,1
24882,डालना।,0,0,1,1
24883,potatis,0,0,1,1
24884,ಪರಿಣಾಮವನ್ನು,0,0,1,1
24885,മാസങ്ങളോ,0,0,1,1
24887,تفهمًا,0,0,1,1
24805,ಅವುಗಳ,0,0,1,1
24804,الجانب,0,0,1,1
24803,trampar,0,0,1,1
24717,dehşet,0,0,1,1
24707,варианта,0,0,1,1
24708,suitors,0,0,1,1
24710,underbart,0,0,1,1
24712,ucraniano,0,0,1,1
24713,accepteres,0,0,1,1
24714,unie,0,0,1,1
24716,абоненту,0,0,1,1
24718,nature‏,0,0,1,1
24802,يحدق,0,0,1,1
24719,δεδομένου,0,0,1,1
24721,traditioner,0,0,1,1
24722,réductible,0,0,1,1
24726,കേട്ടിരിക്കാം,0,0,1,1
24729,batido,0,0,1,1
24730,рок,0,0,1,1
24731,deren,0,0,1,1
24705,മനസ്സിലായില്ല,0,0,1,1
24704,ومثقف,0,0,1,1
24703,dildeki,0,0,1,1
24702,ceden,0,0,1,1
24678,vont,0,0,1,1
24679,malodorante,0,0,1,1
24681,الحلوة,0,0,1,1
24682,другого,0,0,1,1
24683,வெள்ளம்,0,0,1,1
24684,impulsado,0,0,1,1
24685,vraie,0,0,1,1
24686,liebes,0,0,1,1
24687,ಪಂದ್ಯವನ್ನು,0,0,1,1
24689,solzhenitsyn,0,0,1,1
24693,spitz,0,0,1,1
24694,பெயர்கள்,0,0,1,1
24695,للناس,0,0,1,1
24697,brevetage,0,0,1,1
24700,engraved,0,0,1,1
24732,commentators,0,0,1,1
24733,marquées,0,0,1,1
24736,பொருட்படுத்தவில்லை,0,0,1,1
24774,mestre,0,0,1,1
24777,купить,0,0,1,1
24779,स्पॉट,0,0,1,1
24781,उंगलियां,0,0,1,1
24782,cumplan,0,0,1,1
24783,adoptó,0,0,1,1
24784,появилось,0,0,1,1
24785,μείνε,0,0,1,1
24786,siyasi,0,0,1,1
24787,движок,0,0,1,1
24788,"
ज़ीलैण्डी",0,0,1,1
24795,gesamte,0,0,1,1
24796,"
पूर्वी",0,0,1,1
24799,வாழ்க்கையிலும்,0,0,1,1
24800,prominent,0,0,1,1
24801,observada,0,0,1,1
24775,jacopo,0,0,1,1
24773,owe,0,0,1,1
24737,originalartiklar,0,0,1,1
24770,integrando,0,0,1,1
24738,വിരോധാഭാസം,0,0,1,1
24739,പോകുക,0,0,1,1
24744,γνώμη,0,0,1,1
24748,turkiets,0,0,1,1
24749,بمعلومات,0,0,1,1
24751,имеющая,0,0,1,1
24753,definir,0,0,1,1
24754,الأَشغال,0,0,1,1
24758,strengthened,0,0,1,1
24759,للموسوعة,0,0,1,1
24762,وجمل,0,0,1,1
24764,बिल्टइन,0,0,1,1
24765,नवीन,0,0,1,1
24768,المستخدم،,0,0,1,1
24769,ejaculation,0,0,1,1
24920,regulamentações,0,0,1,1
24922,ausgefallene,0,0,1,1
24156,تتخطى,0,0,1,1
25098,кассовые,0,0,1,1
25082,estagnação,0,0,1,1
25083,ಕೊರತೆಯನ್ನು,0,0,1,1
25085,അവലംബങ്ങളുംഉരുൾപൊട്ടൽ,0,0,1,1
25087,kafanı,0,0,1,1
25091,ருசிக்கும்,0,0,1,1
25095,demektir,0,0,1,1
25096,educativas,0,0,1,1
25099,colaborou,0,0,1,1
25113,panel,0,0,1,1
25100,صالح,0,0,1,1
25101,نمط,0,0,1,1
25105,salvo,0,0,1,1
25106,​​sneetje,0,0,1,1
25107,bevarade,0,0,1,1
25108,resten,0,0,1,1
25109,"
bósnio",0,0,1,1
25081,человеку,0,0,1,1
25080,açsın,0,0,1,1
25079,ковариацией,0,0,1,1
25076,असहमति,0,0,1,1
25048,நியூயார்க்கைச்,0,0,1,1
25051,hulpmiddelen,0,0,1,1
25054,للمجتمع,0,0,1,1
25056,prachtig,0,0,1,1
25058,абзацев,0,0,1,1
25061,halftruth,0,0,1,1
25062,annoncer,0,0,1,1
25065,sådant,0,0,1,1
25066,എല്ലിക്കും,0,0,1,1
25067,salarié,0,0,1,1
25068,വിലകൾക്ക്,0,0,1,1
25070,"
लाडिनो",0,0,1,1
25072,describía,0,0,1,1
25074,antigüedad,0,0,1,1
25075,”the,0,0,1,1
25111,certos,0,0,1,1
25115,paso,0,0,1,1
24924,meningsfulla,0,0,1,1
25157,ομαλής,0,0,1,1
25145,क्रियोल,0,0,1,1
25147,isim,0,0,1,1
25149,wanted,0,0,1,1
25151,penses,0,0,1,1
25152,truthfulness,0,0,1,1
25153,l’occident,0,0,1,1
25154,borttaget,0,0,1,1
25159,webbtrafik,0,0,1,1
25117,مشيرة,0,0,1,1
25160,suscripción,0,0,1,1
25161,சொற்றொடராக,0,0,1,1
25162,ಹೇಳಿದ್ದೇನೆಂದರೆ,0,0,1,1
25164,محفوظات,0,0,1,1
25167,வங்கி,0,0,1,1
25168,sebebiyet,0,0,1,1
25170,ഉണ്ടാവുക,0,0,1,1
25144,ರತ್ನಗಳು,0,0,1,1
25143,ലക്ഷത്തിൽ,0,0,1,1
25142,உருவாக்கினர்,0,0,1,1
25139,yemeye,0,0,1,1
25118,søgningen,0,0,1,1
25120,joplin,0,0,1,1
25121,வந்த,0,0,1,1
25122,hackernoon,0,0,1,1
25123,தலையில்,0,0,1,1
25126,incríveis,0,0,1,1
25128,denunciado,0,0,1,1
25129,வெறித்தனமாக,0,0,1,1
25130,беспокойтесь»,0,0,1,1
25132,تتعلق,0,0,1,1
25133,эпизод,0,0,1,1
25134,സംവിധാനമാണ്‌,0,0,1,1
25135,aner,0,0,1,1
25136,dupla,0,0,1,1
25137,mercis,0,0,1,1
25046,infeasible,0,0,1,1
25045,പരിശീലനം,0,0,1,1
25042,estimado,0,0,1,1
24971,web ,0,0,1,1
24958,अंतरों,0,0,1,1
24959,atendidos,0,0,1,1
24960,بوجود,0,0,1,1
24963,databasserver,0,0,1,1
24964,चिह्न,0,0,1,1
24967,l’invention,0,0,1,1
24969,σχετική,0,0,1,1
24972,பிரச்சனை,0,0,1,1
25041,സമ്മാനം,0,0,1,1
24976,அழ,0,0,1,1
24977,попал,0,0,1,1
24978,constaté,0,0,1,1
24979,centradas,0,0,1,1
24980,vådområde,0,0,1,1
24982,σκεφτώ,0,0,1,1
24984,لتصنيف,0,0,1,1
24956,canales,0,0,1,1
24955,usaria,0,0,1,1
24954,கண்,0,0,1,1
24953,haarlem,0,0,1,1
24925,تتعرض,0,0,1,1
24926,typographic,0,0,1,1
24927,passerait,0,0,1,1
24930,natur,0,0,1,1
24931,തടയുന്നു,0,0,1,1
24933,താൽപ്പര്യമില്ലെങ്കിൽ,0,0,1,1
24935,aufzupassen,0,0,1,1
24936,pensait,0,0,1,1
24937,innovations,0,0,1,1
24938,பழக்கவழக்கங்களால்,0,0,1,1
24941,സമർപ്പിക്കപ്പെട്ടിരിക്കുന്നു,0,0,1,1
24947,التلاعب,0,0,1,1
24949,levande,0,0,1,1
24951,​​dem,0,0,1,1
24952,வேளையில்,0,0,1,1
24985,sapiens,0,0,1,1
24986,hesitando,0,0,1,1
24987,simbólicos,0,0,1,1
25015,wereldoorlog,0,0,1,1
25018,അല്പം,0,0,1,1
25025,πνίγω,0,0,1,1
25026,எழுதப்படுகின்றன,0,0,1,1
25027,മലയാളത്തിലാണ്,0,0,1,1
25028,paraît,0,0,1,1
25029,rencontre,0,0,1,1
25030,l’âge,0,0,1,1
25031,заморожен,0,0,1,1
25032,помогать,0,0,1,1
25035,desarrolla,0,0,1,1
25036,വിവരങ്ങളിലൂടെ,0,0,1,1
25037,πέντε,0,0,1,1
25038,luchadores,0,0,1,1
25039,गम,0,0,1,1
25040,alternativt,0,0,1,1
25017,மெருகூட்டப்பட்டவராகவும்,0,0,1,1
25014,മുന്നിൽ,0,0,1,1
24989,ஆண்கள்,0,0,1,1
25013,ومعظمها,0,0,1,1
24990,financière,0,0,1,1
24992,കടം,0,0,1,1
24995,estáveis,0,0,1,1
24996,இழுத்து,0,0,1,1
24997,шумиха,0,0,1,1
24998,yttrandefrihet,0,0,1,1
24999,الالتزام,0,0,1,1
25000,fallecimiento,0,0,1,1
25001,ತಿಳಿದಿರುವ,0,0,1,1
25003,оставили,0,0,1,1
25004,दुखी,0,0,1,1
25005,waarbij,0,0,1,1
25009,karaktäriseras,0,0,1,1
25011,intonatie,0,0,1,1
25012,förväntade,0,0,1,1
24677,utiliza,0,0,1,1
24676,augustin,0,0,1,1
24674,distributing,0,0,1,1
24318,യുദ്ധത്തിൽ,0,0,1,1
24306,grades,0,0,1,1
24307,inception,0,0,1,1
24312,coreia,0,0,1,1
24313,umkreisen,0,0,1,1
24314,प्रासंगिक,0,0,1,1
24315,cites,0,0,1,1
24316,finnish,0,0,1,1
24319,ஏறினாள்,0,0,1,1
24341,diffèrent,0,0,1,1
24321,désinformation,0,0,1,1
24322,углу,0,0,1,1
24325,qualitéh,0,0,1,1
24326,drawings,0,0,1,1
24329,перевода,0,0,1,1
24334,japonaise,0,0,1,1
24335,τρελαθεί,0,0,1,1
24305,şeyden,0,0,1,1
24303,deductieve,0,0,1,1
24302,ചെയ്തതുമായ,0,0,1,1
24300,selfie,0,0,1,1
24279,ಮೊಂಡಾದದ್ದನ್ನು,0,0,1,1
24280,താഴെയുമാണ്,0,0,1,1
24281,dækker,0,0,1,1
24283,تثار,0,0,1,1
24285,ಉತ್ತರಿಸಬಹುದು,0,0,1,1
24286,المتحدثون,0,0,1,1
24287,bottar,0,0,1,1
24288,salladerna,0,0,1,1
24289,réalisable,0,0,1,1
24291,accomplish,0,0,1,1
24293,vendue,0,0,1,1
24296,άκουσα,0,0,1,1
24297,figuram,0,0,1,1
24298,centrar,0,0,1,1
24299,devenus,0,0,1,1
24337,représentent,0,0,1,1
24342,antecedência,0,0,1,1
24672,konuşmayla,0,0,1,1
24387,exceptionally,0,0,1,1
24374,passés,0,0,1,1
24375,ನಿಧಾನಗೊಳಿಸುತ್ತದೆ,0,0,1,1
24376,κομμάτι,0,0,1,1
24381,geleerd,0,0,1,1
24382,évidente,0,0,1,1
24383,ವಾಕ್ಯ,0,0,1,1
24385,distinctifs,0,0,1,1
24388,warren,0,0,1,1
24343,дорабатывали,0,0,1,1
24389,منزعج,0,0,1,1
24390,ಸಂಗತಿಯಿದೆ,0,0,1,1
24391,positif,0,0,1,1
24392,siembra,0,0,1,1
24393,öğrencilerin,0,0,1,1
24396,ومشاريع,0,0,1,1
24397,पब्लिक,0,0,1,1
24373,kokulu,0,0,1,1
24372,masanın,0,0,1,1
24371,граффити,0,0,1,1
24370,богатство,0,0,1,1
24344,olhada,0,0,1,1
24345,magnétique,0,0,1,1
24346,ineffektivt,0,0,1,1
24349,requisito,0,0,1,1
24350,നിയന്ത്രിക്കുന്നത്,0,0,1,1
24352,collégiale,0,0,1,1
24354,ليدعم,0,0,1,1
24359,ocorrem,0,0,1,1
24361,बीजों,0,0,1,1
24362,hindra,0,0,1,1
24364,africano,0,0,1,1
24365,στιλβωμένος,0,0,1,1
24367,சொந்தமான,0,0,1,1
24368,تصرفت,0,0,1,1
24369,развитие,0,0,1,1
24278,представляют,0,0,1,1
24277,ഫോണ്ട്,0,0,1,1
24276,விட்டு,0,0,1,1
24194,அனைவருக்கும்,0,0,1,1
24186,σούπα,0,0,1,1
24187,materializó,0,0,1,1
24188,comparar,0,0,1,1
24189,addresses,0,0,1,1
24190,suggérant,0,0,1,1
24191,wetlands,0,0,1,1
24193,ρωτήσεις,0,0,1,1
24195,موظفين,0,0,1,1
24275,finaliste,0,0,1,1
24196,مايو,0,0,1,1
24198,υπήρχε,0,0,1,1
24200,важной,0,0,1,1
24201,rojo,0,0,1,1
24205,músico,0,0,1,1
24208,έρχονται,0,0,1,1
24210,suspects,0,0,1,1
24185,corridors,0,0,1,1
24184,residências,0,0,1,1
24183,இதுபோன்ற,0,0,1,1
24180,seid,0,0,1,1
24157,dawikipediaorg,0,0,1,1
24158,المصدر,0,0,1,1
24159,câmara,0,0,1,1
24161,radiophoniques,0,0,1,1
24162,discussieforum,0,0,1,1
24164,പോകുന്നുവെന്ന്,0,0,1,1
24165,ടെറൻസും,0,0,1,1
24166,சந்திப்பேன்,0,0,1,1
24167,цифровой,0,0,1,1
24169,terminal,0,0,1,1
24170,combine,0,0,1,1
24172,geomorphology,0,0,1,1
24174,déposé,0,0,1,1
24175,изменяют,0,0,1,1
24179,библиотеки»,0,0,1,1
24213,ക്ലസ്റ്ററിംഗിലൂടെ,0,0,1,1
24215,பிரமாதத்திற்கு,0,0,1,1
24216,kontroversiell,0,0,1,1
24247,contrôles,0,0,1,1
24249,affiliated,0,0,1,1
24250,zusterproject,0,0,1,1
24251,مقالًا,0,0,1,1
24254,stance,0,0,1,1
24257,amacıyla,0,0,1,1
24258,skrevs,0,0,1,1
24259,الاسم,0,0,1,1
24260,نبحث,0,0,1,1
24265,εβδομάδα,0,0,1,1
24267,встречаюсь,0,0,1,1
24268,தேவையற்ற,0,0,1,1
24269,publicering,0,0,1,1
24270,återge,0,0,1,1
24271,широкую,0,0,1,1
24274,λεξικού,0,0,1,1
24248,फर्जी,0,0,1,1
24246,أكله,0,0,1,1
24218,сасаи,0,0,1,1
24245,stabilise,0,0,1,1
24220,"
albanês",0,0,1,1
24221,argentine,0,0,1,1
24222,patates,0,0,1,1
24223,«wikipedian,0,0,1,1
24227,ജോലിയുണ്ട്,0,0,1,1
24229,—correcciones,0,0,1,1
24231,instantáneamente,0,0,1,1
24232,μαθηματικό,0,0,1,1
24233,çıkardın,0,0,1,1
24237,தொடர்பில்,0,0,1,1
24238,quieras,0,0,1,1
24239,kontrollerar,0,0,1,1
24241,أزمة,0,0,1,1
24242,verbazingwekkends,0,0,1,1
24243,gutaussehender,0,0,1,1
24398,telefonopkald,0,0,1,1
24400,spins,0,0,1,1
24402,ಸಂತೋಷಪಡುತ್ತೇನೆ,0,0,1,1
24588,தம்முள்,0,0,1,1
24570,sorvete,0,0,1,1
24571,समविष्टि,0,0,1,1
24574,похожи,0,0,1,1
24577,എന്നതു,0,0,1,1
24581,ಕಿರುನಗೆ,0,0,1,1
24584,ഇതിഹാസം,0,0,1,1
24587,германии,0,0,1,1
24589,vogel,0,0,1,1
24536,пальчиках,0,0,1,1
24591,alumnos,0,0,1,1
24592,cumprem,0,0,1,1
24596,engellendi,0,0,1,1
24602,récurrentes,0,0,1,1
24603,sortit,0,0,1,1
24606,ചെയ്യുന്നതായി,0,0,1,1
24607,"
भोजपुरी",0,0,1,1
24569,gagné,0,0,1,1
24568,ನಮಸ್ಕಾರ,0,0,1,1
24566,функционал,0,0,1,1
24564,poderosa,0,0,1,1
24541,ഉൾ‍ക്കൊള്ളുന്നു,0,0,1,1
24542,திரும்புவார்,0,0,1,1
24543,benutzt,0,0,1,1
24544,moedertaalsprekers,0,0,1,1
24545,inc —,0,0,1,1
24546,skapande,0,0,1,1
24547,trumps,0,0,1,1
24549,algoritmische,0,0,1,1
24551,автоматизация,0,0,1,1
24554,समझाता,0,0,1,1
24555,определенно,0,0,1,1
24557,grundtankarna,0,0,1,1
24558,إسرائيلية,0,0,1,1
24562,skiva,0,0,1,1
24563,federais,0,0,1,1
24609,सीखना,0,0,1,1
24610,ಮಾತನಾಡುತ್ತಿದ್ದರು,0,0,1,1
24611,വായനക്കാരന്റെ,0,0,1,1
24647,yemeği,0,0,1,1
24649,soruyu,0,0,1,1
24650,conditionnant,0,0,1,1
24651,« nécessaire »,0,0,1,1
24653,rodord,0,0,1,1
24658,അവളുമായി,0,0,1,1
24659,désignant,0,0,1,1
24660,wapediamobi,0,0,1,1
24661,കോളിൽ,0,0,1,1
24663,सफलतापूर्वक,0,0,1,1
24666,ക്രൂരമായിരുന്നു,0,0,1,1
24667,لصحيفة,0,0,1,1
24668,ತಯಾರಿಸಲಾಗುತ್ತದೆ,0,0,1,1
24669,विघटनकारी,0,0,1,1
24670,naïvement,0,0,1,1
24671,определённым,0,0,1,1
24648,gardens,0,0,1,1
24646,ಇಲ್ಲದಿದ್ದರೆ,0,0,1,1
24612,χρησιμοποιούμε,0,0,1,1
24645,adamın,0,0,1,1
24615,europeisk,0,0,1,1
24616,funktionen,0,0,1,1
24622,exclure,0,0,1,1
24623,amie,0,0,1,1
24624,लाइब्रेरी,0,0,1,1
24625,ημέρα,0,0,1,1
24627,india,0,0,1,1
24628,notada,0,0,1,1
24630,verheiratet,0,0,1,1
24631,μαγικά,0,0,1,1
24634,hittat,0,0,1,1
24636,للأبحاث,0,0,1,1
24638,എന്തുകൊണ്ടെന്ന്,0,0,1,1
24641,pseudovetenskap,0,0,1,1
24642,направляются,0,0,1,1
24538,réalités,0,0,1,1
24535,மாதங்கள்,0,0,1,1
24403,سيمونس,0,0,1,1
24449,erfgoed,0,0,1,1
24434,وعدم,0,0,1,1
24436,contribuye,0,0,1,1
24437,paradigmático,0,0,1,1
24441,kæmpede,0,0,1,1
24442,സ്വേവ്,0,0,1,1
24444,медалью,0,0,1,1
24448,gemiddelde,0,0,1,1
24453,cumhuriyeti,0,0,1,1
24534,يهتم,0,0,1,1
24455,ഉണ്ടായില്ല,0,0,1,1
24456,принесу,0,0,1,1
24460,lyse,0,0,1,1
24462,прощения,0,0,1,1
24465,auxiliar,0,0,1,1
24466,دعم,0,0,1,1
24468,quarter,0,0,1,1
24432,получала,0,0,1,1
24429,kronolojik,0,0,1,1
24428,للطريقة,0,0,1,1
24426,aktiviteten,0,0,1,1
24405,مشاهدي,0,0,1,1
24406,içerikli,0,0,1,1
24407,forced,0,0,1,1
24408,odds,0,0,1,1
24409,परिष्कृत।,0,0,1,1
24410,cedido,0,0,1,1
24412,onaylanmış,0,0,1,1
24413,webcomic,0,0,1,1
24414,செய்முறைப்படி,0,0,1,1
24415,பிரச்சினையை,0,0,1,1
24416,தளையறு,0,0,1,1
24417,அழுகிறார்கள்,0,0,1,1
24418,propress,0,0,1,1
24420,fragmented,0,0,1,1
24422,المسؤولين,0,0,1,1
24472,सत्ता,0,0,1,1
24473,"
याकूत",0,0,1,1
24475,لتشجيع,0,0,1,1
24508,просьбу,0,0,1,1
24511,திட்டமிட்டுள்ளேன்,0,0,1,1
24513,desafortunadamente,0,0,1,1
24515,schat,0,0,1,1
24516,التنغيم,0,0,1,1
24518,shirky,0,0,1,1
24520,phenomenon,0,0,1,1
24521,മനുഷ്യനാണ്,0,0,1,1
24522,eliminado,0,0,1,1
24523,disponível,0,0,1,1
24524,കൃത്യമായൊരു,0,0,1,1
24526,ತಿಳಿದಿದ್ದರೆ,0,0,1,1
24527,കുഴപ്പമുണ്ടോ,0,0,1,1
24529,ومرحبا,0,0,1,1
24532,beweegt,0,0,1,1
24533,dönük,0,0,1,1
24510,கிடைக்கும்படியான,0,0,1,1
24507,viessem,0,0,1,1
24476,bénéficient,0,0,1,1
24506,താമസിച്ചിരുന്നു,0,0,1,1
24477,переплётом,0,0,1,1
24484,inclure,0,0,1,1
24485,bundestag,0,0,1,1
24486,grine,0,0,1,1
24487,подписаться,0,0,1,1
24490,عمومًا,0,0,1,1
24491,فمثلا,0,0,1,1
24492,mücadele,0,0,1,1
24496,കാണാത്തപ്പോൾ‌,0,0,1,1
24497,معينة،,0,0,1,1
24498,المقاومة,0,0,1,1
24500,владимир,0,0,1,1
24501,فظة,0,0,1,1
24504,mínimo,0,0,1,1
24505,frecuencia,0,0,1,1
23192,التفكير,0,0,1,1
23189,மனித,0,0,1,1
21273,தூதர்,0,0,1,1
21927,relaterede,0,0,1,1
21916,ньюйорке,0,0,1,1
21918,grubudur,0,0,1,1
21921,ned,0,0,1,1
21922,wetenschappers,0,0,1,1
21923,schneckenbeispiel,0,0,1,1
21925,pick,0,0,1,1
21926,aparecían,0,0,1,1
21928,amerikalının,0,0,1,1
21946,ಪರಿಪೂರ್ಣವಾದ,0,0,1,1
21932,بالضبط,0,0,1,1
21935,d’interprétabilité,0,0,1,1
21937,அலெக்சா,0,0,1,1
21939,يدور,0,0,1,1
21940,inhoudelijke,0,0,1,1
21941,участник,0,0,1,1
21942,опубликовал,0,0,1,1
21915,implicações,0,0,1,1
21912,έλλη,0,0,1,1
21911,coexisted,0,0,1,1
21908,والنص,0,0,1,1
21878,kött,0,0,1,1
21881,использующие,0,0,1,1
21883,sevimlisin,0,0,1,1
21884,பெண்,0,0,1,1
21885,إطلاقه,0,0,1,1
21887,destacan,0,0,1,1
21890,ಕನಸನ್ನು,0,0,1,1
21893,шутку,0,0,1,1
21894,preferiría,0,0,1,1
21896,amatör,0,0,1,1
21897,cartésienne,0,0,1,1
21898,إنترنت,0,0,1,1
21899,anfragen,0,0,1,1
21901,соответствующий,0,0,1,1
21903,mezcla,0,0,1,1
21945,—de,0,0,1,1
21947,bewegt,0,0,1,1
21998,المجتمع,0,0,1,1
21987,geheimnis,0,0,1,1
21976,singular,0,0,1,1
21977,தாண்டின,0,0,1,1
21980,സ്വതന്ത്രവിജ്ഞാനകോശമായി,0,0,1,1
21982,आता,0,0,1,1
21983,spéciale,0,0,1,1
21985,പറയിപെറ്റ,0,0,1,1
21986,الإعلام,0,0,1,1
21988,kafasına,0,0,1,1
21948,"
आइसलैण्डी",0,0,1,1
21989,قصري,0,0,1,1
21990,derecho,0,0,1,1
21991,«сообщество…,0,0,1,1
21992,مدير,0,0,1,1
21993,посмотрели,0,0,1,1
21994,leeft,0,0,1,1
21996,क्लिफ्फोर्ड,0,0,1,1
21974,ന്യൂപീഡിയയെ,0,0,1,1
21970,ಮೂಲಭೂತ,0,0,1,1
21969,നല്കുന്ന,0,0,1,1
21968,кругу,0,0,1,1
21949,umursamıyorsun,0,0,1,1
21951,vele,0,0,1,1
21952,posts,0,0,1,1
21953,பெறுகிறார்கள்,0,0,1,1
21954,hazineni,0,0,1,1
21955,agradáveis,0,0,1,1
21957,—contracción,0,0,1,1
21958,actuaciones,0,0,1,1
21959,gigantesques,0,0,1,1
21961,investigaciones,0,0,1,1
21962,hayranlarının,0,0,1,1
21963,identifying,0,0,1,1
21964,അനുസരിച്ച്,0,0,1,1
21965,ποιότητα,0,0,1,1
21967,hervat,0,0,1,1
21877,являлось,0,0,1,1
21876,संकेतबद्ध,0,0,1,1
21875,översvämning,0,0,1,1
21805,വിജയിച്ചു,0,0,1,1
21792,versionerna,0,0,1,1
21796,ಅಡ್ಡಿಪಡಿಸುವುದು,0,0,1,1
21798,prestigiosas,0,0,1,1
21799,espejo,0,0,1,1
21800,çıktı,0,0,1,1
21801,ведомства,0,0,1,1
21802,شئ,0,0,1,1
21806,walls,0,0,1,1
21873,teoría,0,0,1,1
21807,apprendra,0,0,1,1
21809,சொற்றொடரையும்,0,0,1,1
21811,engajar,0,0,1,1
21812,acenaram,0,0,1,1
21813,sujeta,0,0,1,1
21814,​​ontmoetingsplaats,0,0,1,1
21815,பார்த்தான்,0,0,1,1
21790,പോകാനുള്ള,0,0,1,1
21789,wikifiera,0,0,1,1
21788,நேர்காணலில்,0,0,1,1
21786,personalizar,0,0,1,1
21767,विधि,0,0,1,1
21768,நேரமில்லை,0,0,1,1
21769,нейтральной,0,0,1,1
21770,பதிக்கப்பட்டிருந்தது,0,0,1,1
21771,connotation,0,0,1,1
21773,переведённые,0,0,1,1
21774,நலமாக,0,0,1,1
21776,ബുദ്ധിശൂന്യമാണെന്ന്,0,0,1,1
21777,тегами,0,0,1,1
21778,antik,0,0,1,1
21779,σαλιγκαριών,0,0,1,1
21780,velozpedia,0,0,1,1
21781,ettiğin,0,0,1,1
21782,ವಹಿಸಲಿಲ್ಲ,0,0,1,1
21784,فحسب،,0,0,1,1
21816,forsøger,0,0,1,1
21818,свадебном,0,0,1,1
21819,süslenmişti,0,0,1,1
21843,réparé,0,0,1,1
21847,bois,0,0,1,1
21849,brugernavne,0,0,1,1
21850,извинения,0,0,1,1
21852,injuste,0,0,1,1
21853,വെക്കാനുള്ള,0,0,1,1
21855,नौकरानियों।,0,0,1,1
21858,beundrende,0,0,1,1
21861,intégrale,0,0,1,1
21863,संबंधित,0,0,1,1
21864,γραμματοσειρά,0,0,1,1
21865,விரும்பத்தகாத,0,0,1,1
21867,neutraliteten,0,0,1,1
21869,annesine,0,0,1,1
21871,χάος,0,0,1,1
21872,സിദ്ധാന്ത,0,0,1,1
21846,behandlas,0,0,1,1
21842,माध्यमिक,0,0,1,1
21821,ಕೋಣೆಗೆ,0,0,1,1
21839,ενημερώστε,0,0,1,1
21822,diversified,0,0,1,1
21823,varsågod,0,0,1,1
21824,உங்களால்,0,0,1,1
21825,குழப்பிவிட்டேன்,0,0,1,1
21826,കാര്യം,0,0,1,1
21827,செய்வதாகவும்,0,0,1,1
21828,टैब्स,0,0,1,1
21829,snygga,0,0,1,1
21831,deformation,0,0,1,1
21832,انخفضت,0,0,1,1
21833,പിടിക്കുക,0,0,1,1
21835,സൈന്യം,0,0,1,1
21836,industrialisés,0,0,1,1
21837,dépositaire,0,0,1,1
21838,حاليًا,0,0,1,1
21997,വസ്തുതകൾ,0,0,1,1
21999,schrijfstijl,0,0,1,1
22230,parodiler,0,0,1,1
22161,ficaram,0,0,1,1
22147,изменяется,0,0,1,1
22148,ആഴത്തിൽ,0,0,1,1
22151,ativistas,0,0,1,1
22152,росту,0,0,1,1
22154,प्रदान,0,0,1,1
22155,отношениях,0,0,1,1
22158,sugieren,0,0,1,1
22162,തിരുത്തുന്നു,0,0,1,1
22175,d’enseignement ,0,0,1,1
22163,médicos,0,0,1,1
22164,отведу,0,0,1,1
22165,supports,0,0,1,1
22166,الإتمامِ,0,0,1,1
22168,wikipedia”,0,0,1,1
22171,сайте,0,0,1,1
22172,estímulo,0,0,1,1
22143,авторы,0,0,1,1
22140,celebrates,0,0,1,1
22139,susceptibility,0,0,1,1
22138,dialetos,0,0,1,1
22118,साथसाथ,0,0,1,1
22120,ஒரேயளவினதாய்,0,0,1,1
22121,मुख,0,0,1,1
22122,"
विकिमीडिया",0,0,1,1
22123,δείξει,0,0,1,1
22125,برقية,0,0,1,1
22126,பயனற்றது,0,0,1,1
22127,принимаю,0,0,1,1
22129,manifold,0,0,1,1
22130,मानक,0,0,1,1
22132,rattachés,0,0,1,1
22133,transparency ,0,0,1,1
22134,near,0,0,1,1
22135,yazın,0,0,1,1
22137,bence,0,0,1,1
22173,разработанную,0,0,1,1
22178,threatening,0,0,1,1
22000,αμηχανία,0,0,1,1
22218,പൂർവ്വസ്ഥിതിയിലായി,0,0,1,1
22210,partenariat,0,0,1,1
22211,ഒന്ന്,0,0,1,1
22212,πάρεις,0,0,1,1
22213,proprietär,0,0,1,1
22215,खूबसूरती,0,0,1,1
22216,ಪ್ರಸ್ತಾಪವನ್ನು,0,0,1,1
22217,ரூபி,0,0,1,1
22219,imparcialidad,0,0,1,1
22179,besetzt,0,0,1,1
22220,الألعاب,0,0,1,1
22221,indepth,0,0,1,1
22222,ദൂരവ്യാപകമായി,0,0,1,1
22223,κόκκινο,0,0,1,1
22224,амстердаме,0,0,1,1
22225,bahsetmişken,0,0,1,1
22228,എല്ലാവരേയും,0,0,1,1
22209,اسمح,0,0,1,1
22208,guy,0,0,1,1
22207,gefangen,0,0,1,1
22205,supervise,0,0,1,1
22181,तूफानी,0,0,1,1
22186,diseñar,0,0,1,1
22187,остановилась,0,0,1,1
22188,udvise,0,0,1,1
22190,brief,0,0,1,1
22191,civility,0,0,1,1
22193,ಕೋನವಾಗಿದ್ದು,0,0,1,1
22196,üzgünsün,0,0,1,1
22197,meritstatus,0,0,1,1
22198,schnellen,0,0,1,1
22199,കാലിഫോർണിയയിൽ,0,0,1,1
22200,représentativité,0,0,1,1
22202,llamado,0,0,1,1
22203,bekijkt,0,0,1,1
22204,популярность,0,0,1,1
22115,വിഷമിപ്പിക്കരുതെന്ന്,0,0,1,1
22114,formulation,0,0,1,1
22113,pratique ,0,0,1,1
22038,underholdende,0,0,1,1
22030,assertions,0,0,1,1
22031,regularities,0,0,1,1
22032,शहरों,0,0,1,1
22033,raden,0,0,1,1
22034,പരീക്ഷ,0,0,1,1
22036,marié,0,0,1,1
22037,плюрипотентности,0,0,1,1
22040,أعلن,0,0,1,1
22112,telaffuzumu,0,0,1,1
22041,ˌwɪkiˈpiːdiə —,0,0,1,1
22042,தயங்குகிறது,0,0,1,1
22044,cierto,0,0,1,1
22045,وكنت,0,0,1,1
22047,அதிலிருந்து,0,0,1,1
22050,rönt,0,0,1,1
22051,имея,0,0,1,1
22029,nefes,0,0,1,1
22028,வருத்தப்படுகிறார்,0,0,1,1
22025,وول,0,0,1,1
22024,ടൈപ്പുചെയ്യുക,0,0,1,1
22003,​​कि,0,0,1,1
22005,voorstel,0,0,1,1
22006,—u,0,0,1,1
22007,текстового,0,0,1,1
22008,museum,0,0,1,1
22010,eğilimindedir,0,0,1,1
22011,sattığını,0,0,1,1
22014,rijk,0,0,1,1
22015,perplexed,0,0,1,1
22016,നട്ടുപിടിപ്പിക്കാൻ,0,0,1,1
22018,práticas,0,0,1,1
22019,पकड़ा।,0,0,1,1
22021,सिफोलिली,0,0,1,1
22022,coração,0,0,1,1
22023,insats,0,0,1,1
22053,manuais,0,0,1,1
22054,crop,0,0,1,1
22058,légitimes,0,0,1,1
22084,σωστό,0,0,1,1
22091,avsluta,0,0,1,1
22092,ouais,0,0,1,1
22093,tillsvidare,0,0,1,1
22096,शाब्दिक,0,0,1,1
22097,സിനിമകളിലേക്ക്,0,0,1,1
22098,الثروات,0,0,1,1
22101,daardoor,0,0,1,1
22102,driver,0,0,1,1
22103,глубоко,0,0,1,1
22104,ദേഷ്യപ്പെടുന്നു,0,0,1,1
22105,комментируя,0,0,1,1
22107,bahçelerinde,0,0,1,1
22108,скорости,0,0,1,1
22109,بلغات,0,0,1,1
22110,രൂപവും,0,0,1,1
22086,hellen,0,0,1,1
22083,പിറ്റേന്ന്,0,0,1,1
22062,encima,0,0,1,1
22082,curation,0,0,1,1
22063,ചേർക്കുന്നതും,0,0,1,1
22064,выходных»,0,0,1,1
22065,tilted,0,0,1,1
22066,للحظة؟,0,0,1,1
22067,утопление,0,0,1,1
22070,crenças,0,0,1,1
22071,tranen,0,0,1,1
22072,hosts,0,0,1,1
22073,الرابع,0,0,1,1
22074,utestängas,0,0,1,1
22076,അസാധാരണമായി,0,0,1,1
22078,женихи,0,0,1,1
22079,يخبرني,0,0,1,1
22080,ഭൂരിപക്ഷം,0,0,1,1
22081,palast,0,0,1,1
21765,aparecem,0,0,1,1
21764,besleyelim,0,0,1,1
21763,манске,0,0,1,1
21431,wikiprogramvara,0,0,1,1
21420,புளூமாக்ஸாக,0,0,1,1
21422,معقولة,0,0,1,1
21424,إضافيًا,0,0,1,1
21425,பரிசீலித்து,0,0,1,1
21428,سؤالك,0,0,1,1
21429,الأسبوع؟,0,0,1,1
21430,أخيرًا،,0,0,1,1
21432,മാതൃകകളിൽ,0,0,1,1
21451,laboratories,0,0,1,1
21433,ಮಾಡಬಲ್ಲೆ,0,0,1,1
21438,unbeschreiblich,0,0,1,1
21441,هنا؟,0,0,1,1
21442,откликов,0,0,1,1
21446,ऑक्सफ़ोर्ड,0,0,1,1
21447,verkeerde,0,0,1,1
21448,ಟೋಫ್ಲ್,0,0,1,1
21419,kingdom,0,0,1,1
21418,lineares,0,0,1,1
21417,медленном,0,0,1,1
21415,olmuştur,0,0,1,1
21393,لمعرفة,0,0,1,1
21395,голодаю,0,0,1,1
21396,kunskap,0,0,1,1
21398,இருப்பதைக்,0,0,1,1
21399,requeria,0,0,1,1
21400,سيفوليلي,0,0,1,1
21403,“vikipedi,0,0,1,1
21404,objektif,0,0,1,1
21405,borrar,0,0,1,1
21406,لتزايد,0,0,1,1
21407,verricht,0,0,1,1
21411,ljudet,0,0,1,1
21412,ಶಾಲೆಯಲ್ಲಿ,0,0,1,1
21413,എവിടെയെങ്കിലും,0,0,1,1
21414,γρήγορους,0,0,1,1
21450,വിവരങ്ങൾtest,0,0,1,1
21454,aklınızda,0,0,1,1
21762,θυελλώδη,0,0,1,1
21498,சிறப்புக்கட்டுரைத்,0,0,1,1
21483,фантастические,0,0,1,1
21485,контринтуитивную,0,0,1,1
21486,فريق,0,0,1,1
21487,hence,0,0,1,1
21488,вкратце,0,0,1,1
21490,ಬೆಳೆಸಲು,0,0,1,1
21492,الشكوك,0,0,1,1
21500,лишь,0,0,1,1
21455,இறங்கினீர்கள்,0,0,1,1
21504,அழுக்கு,0,0,1,1
21505,الاطلاق,0,0,1,1
21507,carbon,0,0,1,1
21508,എഞ്ചിനിയർ,0,0,1,1
21510,artículos»,0,0,1,1
21511,большим,0,0,1,1
21513,kullanabileceğinizi,0,0,1,1
21482,independentemente,0,0,1,1
21479,പോലെയാണിവർ,0,0,1,1
21476,σιγουρευτείτε,0,0,1,1
21475,ανακάλυψη,0,0,1,1
21456,காலை,0,0,1,1
21457,masasına,0,0,1,1
21458,sayede,0,0,1,1
21459,flotte,0,0,1,1
21460,ತಪ್ಪಿಸುವುದು,0,0,1,1
21461,​​till,0,0,1,1
21462,நிறுத்தம்,0,0,1,1
21463,yunglo,0,0,1,1
21465,democráticamente,0,0,1,1
21466,ಉಡುಪಿನಲ್ಲಿ,0,0,1,1
21467,ഡൽഹിയിൽ,0,0,1,1
21468,تشابك,0,0,1,1
21470,«activas»,0,0,1,1
21471,armén,0,0,1,1
21474,hiermee,0,0,1,1
21391,еду,0,0,1,1
21389,farväl,0,0,1,1
21386,révèlent,0,0,1,1
21312,கொண்டன,0,0,1,1
21302,ಹೊಂದುವ,0,0,1,1
21303,அவருக்கு,0,0,1,1
21304,biliyorsanız,0,0,1,1
21306,poorer,0,0,1,1
21307,proponía,0,0,1,1
21308,representantes,0,0,1,1
21310,синонимами,0,0,1,1
21313,childcare,0,0,1,1
21383,اثني,0,0,1,1
21314,பதிலளிக்க,0,0,1,1
21316,interfaces,0,0,1,1
21317,confusions,0,0,1,1
21318,ಕಷ್ಟವಾಯಿತು,0,0,1,1
21319,своё,0,0,1,1
21320,നല്കുന്നതുമായ,0,0,1,1
21321,делают,0,0,1,1
21300,auktoritetsbristen,0,0,1,1
21297,inger,0,0,1,1
21296,administratör,0,0,1,1
21295,grafo,0,0,1,1
21274,behagelig,0,0,1,1
21275,sardenberg,0,0,1,1
21277,πολιτική,0,0,1,1
21279,ആവശ്യമാണെന്ന്,0,0,1,1
21280,आशंका,0,0,1,1
21281,चौथी,0,0,1,1
21282,организации,0,0,1,1
21283,construit,0,0,1,1
21285,ställer,0,0,1,1
21286,dragging,0,0,1,1
21288,viewing,0,0,1,1
21290,úteis,0,0,1,1
21291,കാണുന്ന,0,0,1,1
21293,pétrole,0,0,1,1
21294,"
गिलाकी",0,0,1,1
21322,knowing,0,0,1,1
21323,مصحح,0,0,1,1
21325,لذلك؟,0,0,1,1
21360,पकड़ना,0,0,1,1
21363,autonomous,0,0,1,1
21365,ressembles,0,0,1,1
21368,الميزات,0,0,1,1
21369,bardak,0,0,1,1
21370,editörler,0,0,1,1
21371,ಮಾಡೋಣ,0,0,1,1
21372,minde,0,0,1,1
21374,ரியோக்காசு,0,0,1,1
21375,circulação,0,0,1,1
21376,solicitada,0,0,1,1
21377,കൊണ്ടിരിക്കുന്നു,0,0,1,1
21378,നിങ്ങൾക്കറിയാമെങ്കിൽ,0,0,1,1
21379,വിഷമമുണ്ടെന്ന്,0,0,1,1
21381,पड़ता।,0,0,1,1
21382,dropping,0,0,1,1
21362,skylldes,0,0,1,1
21357,planın,0,0,1,1
21328,കൂടുതലും,0,0,1,1
21356,wachtwoord,0,0,1,1
21329,познакомиться,0,0,1,1
21330,ಅಕ್ಷರಶಃ,0,0,1,1
21331,ഇഷ്ടപ്പെടുകയും,0,0,1,1
21332,positiv,0,0,1,1
21335,нас,0,0,1,1
21336,സന്തോഷ,0,0,1,1
21337,универсальной,0,0,1,1
21339,varia,0,0,1,1
21340,vald,0,0,1,1
21341,ലേഖകരും,0,0,1,1
21343,suponha,0,0,1,1
21345,morality,0,0,1,1
21347,interativa,0,0,1,1
21351,deltagande,0,0,1,1
21353,nécessitant,0,0,1,1
21514,संदेशवाहक,0,0,1,1
21515,बीबीसी,0,0,1,1
21516,trouvant,0,0,1,1
21679,spelkonsoler,0,0,1,1
21672,الجنود,0,0,1,1
21673,diyorsunuz,0,0,1,1
21674,axis,0,0,1,1
21675,instancias,0,0,1,1
21676,kunsttalen,0,0,1,1
21677,മേഖലകളുണ്ട്,0,0,1,1
21678,expresado,0,0,1,1
21682,sustantivo,0,0,1,1
21633,مبدأ,0,0,1,1
21683,spitzer,0,0,1,1
21684,«тупой»,0,0,1,1
21685,ledere,0,0,1,1
21688,गूढ़,0,0,1,1
21690,thmostvisited,0,0,1,1
21691,adaptée,0,0,1,1
21694,schrecklichen,0,0,1,1
21671,ägna,0,0,1,1
21670,للوصول,0,0,1,1
21669,soulevée,0,0,1,1
21668,kede,0,0,1,1
21637,desencorajada,0,0,1,1
21638,webportaal,0,0,1,1
21639,galeries,0,0,1,1
21640,reliées,0,0,1,1
21641,разрешение,0,0,1,1
21646,τυχερό,0,0,1,1
21647,parlons,0,0,1,1
21648,நாளைக்கு,0,0,1,1
21649,independente,0,0,1,1
21651,tnr,0,0,1,1
21655,പൊതുജനങ്ങൾക്കെല്ലാം,0,0,1,1
21656,நடுநிலைமை,0,0,1,1
21657,ദയാലുവാണ്,0,0,1,1
21664,constitutionnels,0,0,1,1
21666,contextualização,0,0,1,1
21695,noticia,0,0,1,1
21698,organisationen,0,0,1,1
21701,വസ്ത്രത്തിൽ,0,0,1,1
21729,lethargic,0,0,1,1
21733,clicks,0,0,1,1
21735,സംശയമില്ലാത്ത,0,0,1,1
21740,கருத்தை,0,0,1,1
21741,sprang,0,0,1,1
21742,جاءت,0,0,1,1
21744,lebensmitteln,0,0,1,1
21745,സ്വീകരിക്കാം,0,0,1,1
21748,siguieron,0,0,1,1
21749,onderzoekers,0,0,1,1
21750,tereddüt,0,0,1,1
21752,wikipediaskribenter,0,0,1,1
21753,نشرت,0,0,1,1
21754,counting,0,0,1,1
21755,duyarım,0,0,1,1
21758,mimics,0,0,1,1
21732,grundaren,0,0,1,1
21728,laureada,0,0,1,1
21702,exacto,0,0,1,1
21726,ರೀತಿಗೆ,0,0,1,1
21704,anime,0,0,1,1
21706,alex,0,0,1,1
21707,værre,0,0,1,1
21709,привилегированных,0,0,1,1
21710,suspicions,0,0,1,1
21711,llegan,0,0,1,1
21713,γίνουμε,0,0,1,1
21715,മലയാളത്തില്,0,0,1,1
21717,ρουμπίνι,0,0,1,1
21720,mesela,0,0,1,1
21721,проявляется,0,0,1,1
21722,докажете,0,0,1,1
21723,traditionally,0,0,1,1
21724,consultaient,0,0,1,1
21725,يشتبه,0,0,1,1
21636,मज़ाक,0,0,1,1
21632,получив,0,0,1,1
21518,நுபீடியாவை,0,0,1,1
21556,отблагодарить,0,0,1,1
21545,هاتفي,0,0,1,1
21546,специального,0,0,1,1
21547,olvides,0,0,1,1
21548,ದೂರವಾಣಿ,0,0,1,1
21552,έδωσε,0,0,1,1
21553,представленного,0,0,1,1
21555,seguridad,0,0,1,1
21558,görkemli,0,0,1,1
21630,questionou,0,0,1,1
21559,pornographically,0,0,1,1
21561,liabilities,0,0,1,1
21562,recourir,0,0,1,1
21564,stürmisches,0,0,1,1
21569,अनुवाद,0,0,1,1
21574,ज़ोर,0,0,1,1
21575,राय।,0,0,1,1
21544,экспоненциально,0,0,1,1
21541,доминирующей,0,0,1,1
21540,मीटिंग,0,0,1,1
21539,—por,0,0,1,1
21519,genus,0,0,1,1
21520,ранней,0,0,1,1
21521,sahte,0,0,1,1
21522,μμ,0,0,1,1
21523,διάρκεια,0,0,1,1
21525,высшая,0,0,1,1
21528,हेलर,0,0,1,1
21529,onları,0,0,1,1
21530,ತುಂಬಿಸಲು,0,0,1,1
21531,выборки,0,0,1,1
21533,मैली,0,0,1,1
21534,anatomy,0,0,1,1
21535,estaria,0,0,1,1
21536,hingekommen,0,0,1,1
21538,appearances,0,0,1,1
21576,spekulerede,0,0,1,1
21579,دقة,0,0,1,1
21580,സ്രോതസ്സ്,0,0,1,1
21606,«объект,0,0,1,1
21609,geçiyor,0,0,1,1
21610,ultimate,0,0,1,1
21611,fourthhighest,0,0,1,1
21613,ഡിസന്റ്,0,0,1,1
21614,ಹೇಳುತ್ತದೆ,0,0,1,1
21615,опубликовали,0,0,1,1
21616,samesex,0,0,1,1
21617,dust,0,0,1,1
21618,vergessen,0,0,1,1
21619,ಸುದ್ದಿಯಲ್ಲಿ,0,0,1,1
21621,статуса»,0,0,1,1
21622,يرام,0,0,1,1
21624,ദുരുദ്ദേശ്യത്തോടുകൂടി,0,0,1,1
21625,fördel,0,0,1,1
21629,someten,0,0,1,1
21607,போவது,0,0,1,1
21605,esquina,0,0,1,1
21581,конкретным,0,0,1,1
21604,«активизируйте,0,0,1,1
21582,weakly,0,0,1,1
21585,translator,0,0,1,1
21586,waardeer,0,0,1,1
21587,اختصاص،,0,0,1,1
21589,хорошего,0,0,1,1
21590,traiter,0,0,1,1
21593,upprepning,0,0,1,1
21594,interwikilänkar,0,0,1,1
21595,версиями,0,0,1,1
21596,yazılmalıdır,0,0,1,1
21597,sjunker,0,0,1,1
21598,الصباح,0,0,1,1
21600,frivillig,0,0,1,1
21601,എസ്എംഎസ്,0,0,1,1
21603,femininas,0,0,1,1
22229,conflicting,0,0,1,1
22233,ashton,0,0,1,1
23188,enrichir,0,0,1,1
22857,அறியப்பட்ட,0,0,1,1
22846,ಆಶ್ಚರ್ಯವಾದರೆ,0,0,1,1
22849,vilseledande,0,0,1,1
22850,открытое,0,0,1,1
22851,питером,0,0,1,1
22853,золотом,0,0,1,1
22854,dukke,0,0,1,1
22856,vivía,0,0,1,1
22859,मेजबान,0,0,1,1
22873,ágil,0,0,1,1
22860,ഉപേക്ഷിച്ചാൽ,0,0,1,1
22862,പ്രശ്‌നമായിരുന്നു,0,0,1,1
22865,داخل,0,0,1,1
22867,высокий,0,0,1,1
22868,يخطئ,0,0,1,1
22870,சந்தித்ததில்,0,0,1,1
22871,mötesplats,0,0,1,1
22844,semejanza,0,0,1,1
22842,wikipetan,0,0,1,1
22839,ética,0,0,1,1
22838,capturing,0,0,1,1
22813,важнее,0,0,1,1
22814,телефонного,0,0,1,1
22815,importar,0,0,1,1
22818,சந்திக்கப்,0,0,1,1
22820,मार,0,0,1,1
22821,adamların,0,0,1,1
22823,വലിച്ചിടുന്നതോ,0,0,1,1
22824,पीडिया,0,0,1,1
22825,реализуют,0,0,1,1
22826,ತಿನ್ನಬಹುದಾದ,0,0,1,1
22827,controversés,0,0,1,1
22828,termes ,0,0,1,1
22829,vakgebied,0,0,1,1
22830,genotipo,0,0,1,1
22833,controversas,0,0,1,1
22872,dankeschöns,0,0,1,1
22875,организациями,0,0,1,1
22936,ثقافة,0,0,1,1
22919,vandt,0,0,1,1
22911,mobility,0,0,1,1
22913,λογισμικό,0,0,1,1
22914,മണിക്കൂറിലും,0,0,1,1
22915,souciait,0,0,1,1
22916,skrivstuga,0,0,1,1
22917,tomaras,0,0,1,1
22918,microclusters,0,0,1,1
22922,muttersprachler,0,0,1,1
22877,installations,0,0,1,1
22923,вирджиния,0,0,1,1
22926,πλούτος,0,0,1,1
22927,تسميتها,0,0,1,1
22928,escrevem,0,0,1,1
22929,apoiados,0,0,1,1
22932,успокойся,0,0,1,1
22933,ederken,0,0,1,1
22910,décennies,0,0,1,1
22907,πήγε,0,0,1,1
22906,проверку,0,0,1,1
22903,lindos,0,0,1,1
22878,охвату,0,0,1,1
22881,fracos,0,0,1,1
22883,χρόνια,0,0,1,1
22884,övergett,0,0,1,1
22886,permanecessem,0,0,1,1
22887,d’être,0,0,1,1
22888,يضربني,0,0,1,1
22891,wikipediaartikelen,0,0,1,1
22892,aplicado,0,0,1,1
22893,редактируется,0,0,1,1
22894,kaynaklı,0,0,1,1
22895,ನೋಡಬೇಡಿ,0,0,1,1
22898,grundas,0,0,1,1
22899,സഞ്ചരിച്ചു,0,0,1,1
22902,تستخدم,0,0,1,1
22811,задал,0,0,1,1
22808,puppe,0,0,1,1
22807,посещаемость,0,0,1,1
22732,ನಿಯೋಜನೆಗಳೊಂದಿಗೆ,0,0,1,1
22722,кластеры,0,0,1,1
22723,fremstilles,0,0,1,1
22725,भूतपूर्व,0,0,1,1
22726,медицине,0,0,1,1
22727,குறிப்பிடத்தக்க,0,0,1,1
22729,предполагает,0,0,1,1
22730,പ്രശ്‌നമില്ല,0,0,1,1
22735,kong,0,0,1,1
22806,tillfällig,0,0,1,1
22736,delegados,0,0,1,1
22737,læser,0,0,1,1
22740,creditadas,0,0,1,1
22741,suscribirte,0,0,1,1
22743,ಮಾಡಬಾರದು,0,0,1,1
22744,भगवान,0,0,1,1
22745,sendos,0,0,1,1
22721,ругательства,0,0,1,1
22720,vinculado,0,0,1,1
22719,விடைபெற,0,0,1,1
22717,بكم,0,0,1,1
22697,tırnağa,0,0,1,1
22699,പരാജയങ്ങൾക്ക്,0,0,1,1
22701,dresse,0,0,1,1
22702,"​
larry",0,0,1,1
22703,albert,0,0,1,1
22704,specify,0,0,1,1
22705,പടയാളികളും,0,0,1,1
22708,വ്യക്തിയാണെന്നും,0,0,1,1
22709,blokere,0,0,1,1
22711,şaka,0,0,1,1
22712,faithful,0,0,1,1
22713,மீறல்,0,0,1,1
22714,évoquer,0,0,1,1
22715,بمرور,0,0,1,1
22716,തികഞ്ഞ,0,0,1,1
22748,علاجاته,0,0,1,1
22749,ramen,0,0,1,1
22750,polido,0,0,1,1
22779,quadrinhos,0,0,1,1
22783,actuales,0,0,1,1
22784,المضحك,0,0,1,1
22787,ലഭിച്ചോ,0,0,1,1
22788,தேடு,0,0,1,1
22789,smaka,0,0,1,1
22790,ತಲೆಗೆ,0,0,1,1
22792,négliger,0,0,1,1
22793,portales,0,0,1,1
22794,kanalıma,0,0,1,1
22795,தயாரிக்கப்படுகின்றன,0,0,1,1
22797,parametrar,0,0,1,1
22799,والمناقشة,0,0,1,1
22802,нейросетях,0,0,1,1
22803,консультируются,0,0,1,1
22805,внезапно,0,0,1,1
22781,compactamiento,0,0,1,1
22778,duymak,0,0,1,1
22753,— «природа» —,0,0,1,1
22777,பொருத்தவரை,0,0,1,1
22754,prêter,0,0,1,1
22755,введите,0,0,1,1
22756,frivilligt,0,0,1,1
22757,والتعليمات,0,0,1,1
22758,сюда,0,0,1,1
22761,réalisation,0,0,1,1
22762,polished,0,0,1,1
22763,перейти,0,0,1,1
22766,«творческого,0,0,1,1
22768,боролась,0,0,1,1
22769,forfærdelse,0,0,1,1
22772,deberíamos,0,0,1,1
22773,implied,0,0,1,1
22774,omröstningar,0,0,1,1
22775,bulunmamaktadır,0,0,1,1
22934,வீடியோவை,0,0,1,1
22937,codes,0,0,1,1
22236,dissidents,0,0,1,1
23115,zullen,0,0,1,1
23097,вошло,0,0,1,1
23098,സംരംഭമാണ്,0,0,1,1
23100,അമ്മയെക്കുറിച്ച്,0,0,1,1
23104,προέλευση,0,0,1,1
23107,efecto,0,0,1,1
23108,gereken,0,0,1,1
23114,desinformar,0,0,1,1
23117,decía,0,0,1,1
23130,émeraudes,0,0,1,1
23118,жаловался,0,0,1,1
23120,വ്യവസ്ഥിതിയാണ്,0,0,1,1
23121,aprendiendo,0,0,1,1
23123,தொடருங்கள்,0,0,1,1
23124,overhovedet,0,0,1,1
23126,subspace,0,0,1,1
23127,struktur,0,0,1,1
23096,недостоверной,0,0,1,1
23095,أتزوجك,0,0,1,1
23093,बिस्तर,0,0,1,1
23092,security”,0,0,1,1
23069,قهوتك,0,0,1,1
23070,ಆಶ್ಚರ್ಯಪಟ್ಟರು,0,0,1,1
23071,معانيها,0,0,1,1
23074,വരികയാണ്,0,0,1,1
23075,uk •,0,0,1,1
23076,dens,0,0,1,1
23077,العقل,0,0,1,1
23078,ತೋರುತ್ತೇವೆ,0,0,1,1
23080,ड्रिंक,0,0,1,1
23083,грандиозная,0,0,1,1
23084,لنا,0,0,1,1
23085,bretonne,0,0,1,1
23086,مدى,0,0,1,1
23087,நகலெடுக்க,0,0,1,1
23088,weggeschickt,0,0,1,1
23128,basmadıysanız,0,0,1,1
23133,ಡಾಲರ್,0,0,1,1
22938,марка,0,0,1,1
23170,волшебными,0,0,1,1
23161,പുനരാരംഭിക്കുകയും,0,0,1,1
23162,классифицировать,0,0,1,1
23164,النباتات,0,0,1,1
23165,refinado,0,0,1,1
23166,harvardsystemet,0,0,1,1
23168,moda,0,0,1,1
23169,br •,0,0,1,1
23171,ˌwɪki,0,0,1,1
23135,offres,0,0,1,1
23175,alcançado,0,0,1,1
23176,taskspecific,0,0,1,1
23177,başlangıçtan,0,0,1,1
23180,usaj,0,0,1,1
23182,уловки,0,0,1,1
23183,தனி,0,0,1,1
23187,reconocía,0,0,1,1
23160,amerikanerne,0,0,1,1
23159,nesse,0,0,1,1
23158,നടപ്പിലാക്കാമെന്ന,0,0,1,1
23157,hollanda,0,0,1,1
23136,egyptian,0,0,1,1
23138,"ജീവശാസ്ത്രം ·
രസതന്ത്രം ·
environmental",0,0,1,1
23140,agreement,0,0,1,1
23141,"
नाम",0,0,1,1
23144,augustus,0,0,1,1
23145,sujetos,0,0,1,1
23147,lived,0,0,1,1
23148,sedimentary,0,0,1,1
23150,antworten,0,0,1,1
23151,adeus,0,0,1,1
23152,behandlade,0,0,1,1
23153,guise,0,0,1,1
23154,onglets,0,0,1,1
23155,faisons,0,0,1,1
23156,wikipedia»,0,0,1,1
23068,реакций,0,0,1,1
23064,grym,0,0,1,1
23063,qualifie,0,0,1,1
22984,peːdɪa,0,0,1,1
22973,человеческой,0,0,1,1
22974,herhaling,0,0,1,1
22976,inapropiadas,0,0,1,1
22978,desconcertaron,0,0,1,1
22979,karıştırmak,0,0,1,1
22981,heraclitus,0,0,1,1
22983,compararam,0,0,1,1
22985,söylediğin,0,0,1,1
23061,εγκωμιάζουν,0,0,1,1
22986,génome,0,0,1,1
22988,ചായ്‌വ്,0,0,1,1
22990,användargenererat,0,0,1,1
22991,disiez,0,0,1,1
22994,antielitismo,0,0,1,1
22995,gemensamma,0,0,1,1
22997,பீடியா,0,0,1,1
22972,expériences,0,0,1,1
22970,servisleri,0,0,1,1
22969,schönsten,0,0,1,1
22965,riddare,0,0,1,1
22939,விரும்புவதன்,0,0,1,1
22940,annotera,0,0,1,1
22941,cut,0,0,1,1
22944,स्टोरी,0,0,1,1
22945,empreinte,0,0,1,1
22947,രുചിയുടെ,0,0,1,1
22948,الفوضى,0,0,1,1
22949,компетентным,0,0,1,1
22950,கண்டுபிடிப்பு,0,0,1,1
22953,pareces,0,0,1,1
22955,phd,0,0,1,1
22959,“illegal,0,0,1,1
22960,kramme,0,0,1,1
22963,dirección,0,0,1,1
22964,прикладных,0,0,1,1
22998,wifetobe,0,0,1,1
23000,entera,0,0,1,1
23003,തയ്യാറാക്കുന്നത്,0,0,1,1
23034,hanımların,0,0,1,1
23036,trouvé,0,0,1,1
23037,stinkende,0,0,1,1
23038,बलात्कार,0,0,1,1
23040,pareciam,0,0,1,1
23041,verificación​,0,0,1,1
23043,discuta,0,0,1,1
23046,بلاد,0,0,1,1
23047,melpiger,0,0,1,1
23051,traînes,0,0,1,1
23055,വാക്കുകൾക്കപ്പുറത്ത്,0,0,1,1
23056,इंगित,0,0,1,1
23057,edilmiştir,0,0,1,1
23058,विकिपीडियाने,0,0,1,1
23059,acessíveis,0,0,1,1
23060,geroepen,0,0,1,1
23035,club,0,0,1,1
23033,webbtjänsten,0,0,1,1
23004,membre,0,0,1,1
23032,обращает,0,0,1,1
23007,чудовищный,0,0,1,1
23009,стимулом англ,0,0,1,1
23011,உள்ளதோடு,0,0,1,1
23012,somado,0,0,1,1
23013,negligenciáveis,0,0,1,1
23014,indican,0,0,1,1
23016,terfi,0,0,1,1
23017,assumption,0,0,1,1
23020,ذهبوا,0,0,1,1
23021,ഏതു,0,0,1,1
23022,ಕೋಪಗೊಂಡಿದ್ದೀರಿ,0,0,1,1
23024,gillar,0,0,1,1
23026,velocipedia,0,0,1,1
23030,perdon,0,0,1,1
23031,تيمز،,0,0,1,1
22695,المتضاربين،,0,0,1,1
22693,وابنتها,0,0,1,1
22692,பயன்பாட்டுக்கு,0,0,1,1
22399,المحددة,0,0,1,1
22389,cruzas,0,0,1,1
22390,« éducation »,0,0,1,1
22391,போலவும்,0,0,1,1
22395,initiate,0,0,1,1
22396,relegada,0,0,1,1
22397,habitants,0,0,1,1
22398,نظرك,0,0,1,1
22400,कृत्य,0,0,1,1
22411,wealthy,0,0,1,1
22401,раскритиковано,0,0,1,1
22402,edemezsin,0,0,1,1
22404,hunnit,0,0,1,1
22405,traduzidos,0,0,1,1
22406,ilegível,0,0,1,1
22407,contemplados,0,0,1,1
22408,δώρο,0,0,1,1
22388,rendezvoussmartwort,0,0,1,1
22387,ошибаются,0,0,1,1
22384,chegado,0,0,1,1
22383,ವೀಡಿಯೊ,0,0,1,1
22363,réduit,0,0,1,1
22364,relatif,0,0,1,1
22365,ಬ್ಯಾಂಕ್‌ಗೆ,0,0,1,1
22366,ನಿರ್ಧಾರವಾಗಿದೆ,0,0,1,1
22367,begränsades,0,0,1,1
22368,react,0,0,1,1
22369,واستضافة,0,0,1,1
22370,telefoneren,0,0,1,1
22373,pekat,0,0,1,1
22375,dramatic,0,0,1,1
22376,höfliche,0,0,1,1
22377,tänt,0,0,1,1
22378,ஒழுங்கமைக்கப்பட்டிருக்கும்,0,0,1,1
22380,கடைப்பிடிக்கப்படுகிறது,0,0,1,1
22382,കഴിക്കേണ്ടതുണ്ട്,0,0,1,1
22410,korsade,0,0,1,1
22413,விளைவைப்,0,0,1,1
22691,deseo,0,0,1,1
22455,richer,0,0,1,1
22446,duitse,0,0,1,1
22447,catalogue,0,0,1,1
22449,dénonce,0,0,1,1
22450,afgewezen,0,0,1,1
22451,haría,0,0,1,1
22452,самый,0,0,1,1
22454,хорошей,0,0,1,1
22456,اعتبارا,0,0,1,1
22414,ücretsiz,0,0,1,1
22459,സൈനികർക്ക്,0,0,1,1
22460,انظرويكيبيدياترجمة,0,0,1,1
22463,предмета,0,0,1,1
22464,عنها,0,0,1,1
22466,turísticas,0,0,1,1
22467,heleboel,0,0,1,1
22468,introduite,0,0,1,1
22445,indonesio,0,0,1,1
22444,ब्लॉक,0,0,1,1
22443,subtiele,0,0,1,1
22442,شكرك,0,0,1,1
22415,suscite,0,0,1,1
22417,घोषणा,0,0,1,1
22423,chapitre,0,0,1,1
22424,φυτέψω,0,0,1,1
22427,вижу,0,0,1,1
22429,semaines,0,0,1,1
22431,indique,0,0,1,1
22432,തോന്നിയെന്നിരിക്കട്ടെ,0,0,1,1
22433,تقل,0,0,1,1
22434,pourcentages,0,0,1,1
22435,अलेक्सा,0,0,1,1
22437,relations,0,0,1,1
22438,χρησιμοποιήθηκε,0,0,1,1
22439,connotaciones,0,0,1,1
22440,plagieringar,0,0,1,1
22361,செயலை,0,0,1,1
22360,പ്രവർത്തിച്ചാണ്,0,0,1,1
22359,ಸೈನ್ಯವು,0,0,1,1
22272,sistémica,0,0,1,1
22263,സഹായിക്കാനായി,0,0,1,1
22265,പരീക്ഷിക്കുക,0,0,1,1
22266,ключевыми,0,0,1,1
22267,العلوي,0,0,1,1
22269,extensa »,0,0,1,1
22270,consideremos,0,0,1,1
22271,قفل,0,0,1,1
22273,τεράστιου,0,0,1,1
22358,vision‏,0,0,1,1
22274,مؤقتًا,0,0,1,1
22277,begrip,0,0,1,1
22278,ಇಷ್ಟಪಟ್ಟಿದ್ದೀರಿ,0,0,1,1
22279,nätcommunities,0,0,1,1
22280,заключенные,0,0,1,1
22282,inseriu,0,0,1,1
22283,gevonden,0,0,1,1
22262,quería,0,0,1,1
22259,результата,0,0,1,1
22258,വിശാലവും,0,0,1,1
22256,வேகமாக,0,0,1,1
22237,aplicar,0,0,1,1
22238,zijd,0,0,1,1
22241,beispielsweise,0,0,1,1
22242,بجامعة,0,0,1,1
22243,δάσκαλος,0,0,1,1
22244,skeletor,0,0,1,1
22245,hâlen,0,0,1,1
22246,படுக்கையில்,0,0,1,1
22247,ستجده,0,0,1,1
22249,प्रविष्टियां,0,0,1,1
22250,derefter,0,0,1,1
22251,formateret,0,0,1,1
22252,szl •,0,0,1,1
22254,konsensussökande,0,0,1,1
22255,எசுப்பானிய,0,0,1,1
22285,പോകുന്നതാണ്,0,0,1,1
22286,أداة,0,0,1,1
22287,regularization,0,0,1,1
22325,നടത്തുന്നതിൽ,0,0,1,1
22331,bilmelisin,0,0,1,1
22332,poliert,0,0,1,1
22335,polite,0,0,1,1
22336,icono,0,0,1,1
22338,adında,0,0,1,1
22339,स्थानीय,0,0,1,1
22341,dividir,0,0,1,1
22342,yapıyorum,0,0,1,1
22343,klonen,0,0,1,1
22345,വസ്തുക്കളെ,0,0,1,1
22346,പ്രവർത്തകരെ,0,0,1,1
22347,موقعا,0,0,1,1
22351,none,0,0,1,1
22352,പരിശീലിക്കാനുള്ള,0,0,1,1
22357,geolocation,0,0,1,1
22327,comporte,0,0,1,1
22321,udnytte,0,0,1,1
22288,rediseñó,0,0,1,1
22320,boyunca,0,0,1,1
22289,möchtest,0,0,1,1
22294,demeç,0,0,1,1
22296,cuadro,0,0,1,1
22298,ദൈവത്തെപ്പോലെ,0,0,1,1
22299,personligen,0,0,1,1
22300,garanderen,0,0,1,1
22303,massive,0,0,1,1
22305,ostenten,0,0,1,1
22306,prefixo,0,0,1,1
22307,ಕಣ್ಣು,0,0,1,1
22308,ತೆಗೆದುಕೊಂಡಿದ್ದೇನೆ,0,0,1,1
22310,paresseux,0,0,1,1
22313,топология,0,0,1,1
22314,sparas,0,0,1,1
22317,"
मलय",0,0,1,1
22469,включают,0,0,1,1
22471,barnet,0,0,1,1
22472,avènement,0,0,1,1
22629,efforcer,0,0,1,1
22621,"
tártaro",0,0,1,1
22622,succèdent,0,0,1,1
22624,ಖಾತ್ರಿಯಿಲ್ಲ,0,0,1,1
22625,överraskar,0,0,1,1
22626,hábitos,0,0,1,1
22627,denominan,0,0,1,1
22628,utvecklad,0,0,1,1
22630,placed,0,0,1,1
22587,feliciteren,0,0,1,1
22631,articler,0,0,1,1
22633,mogelijk,0,0,1,1
22634,hundirse,0,0,1,1
22635,வழங்கி,0,0,1,1
22636,கொள்வாள்,0,0,1,1
22637,incubator,0,0,1,1
22638,മായ്ച്ചുകളയുന്നതും,0,0,1,1
22620,roles,0,0,1,1
22619,fokuseret,0,0,1,1
22617,ಅಭಿನಂದನೆಗಳು,0,0,1,1
22616,فتتلقى,0,0,1,1
22589,maximum,0,0,1,1
22590,வெளியிடுவதாகவே,0,0,1,1
22592,detektere,0,0,1,1
22593,ಸಾಧ್ಯವಾಗದಿದ್ದರೆ,0,0,1,1
22595,sheets,0,0,1,1
22597,dvds,0,0,1,1
22600,reversores,0,0,1,1
22602,introduisit,0,0,1,1
22605,« significative,0,0,1,1
22607,καλοσύνης,0,0,1,1
22609,géants,0,0,1,1
22610,التذكاري؛,0,0,1,1
22612,आंकडा,0,0,1,1
22613,கண்டது,0,0,1,1
22614,ಹಣವನ್ನು,0,0,1,1
22639,पृष्ट,0,0,1,1
22640,triplicado,0,0,1,1
22641,consistera,0,0,1,1
22664,sostuvo,0,0,1,1
22667,repérer ,0,0,1,1
22668,следующее,0,0,1,1
22669,sorundan,0,0,1,1
22670,icat,0,0,1,1
22671,صحة,0,0,1,1
22672,സമ്പ്രദായത്തെ,0,0,1,1
22673,getirebilir,0,0,1,1
22675,kvantiteten,0,0,1,1
22676,rike,0,0,1,1
22679,ಕೋಷ್ಟಕಕ್ಕೆ,0,0,1,1
22681,bekräftar,0,0,1,1
22683,fortement,0,0,1,1
22686,representam,0,0,1,1
22688,teria,0,0,1,1
22690,позицией,0,0,1,1
22665,petit »,0,0,1,1
22663,massornas,0,0,1,1
22642,"
bhasa",0,0,1,1
22662,volontairement,0,0,1,1
22643,победил,0,0,1,1
22644,aufregendes,0,0,1,1
22646,conservé,0,0,1,1
22647,partidos,0,0,1,1
22648,mechanismref,0,0,1,1
22649,γνωστό,0,0,1,1
22650,ಜ್ಯಾಮಿತಿ,0,0,1,1
22651,correcta,0,0,1,1
22652,solucionar,0,0,1,1
22653,أليكسا،,0,0,1,1
22654,actives,0,0,1,1
22655,الكتب,0,0,1,1
22656,inferred,0,0,1,1
22659,rigen,0,0,1,1
22660,klibinde,0,0,1,1
22588,zh •,0,0,1,1
22585,alentar,0,0,1,1
22474,skat,0,0,1,1
22511,sänka,0,0,1,1
22502,посвящённой,0,0,1,1
22503,interaccionar,0,0,1,1
22504,conservador,0,0,1,1
22505,சென்றார்கள்,0,0,1,1
22506,internautas,0,0,1,1
22507,synvinkel,0,0,1,1
22508,canadiennes,0,0,1,1
22513,ತಾಯಿಯಾಗಿದ್ದು,0,0,1,1
22584,bate,0,0,1,1
22514,ursprünge,0,0,1,1
22515,birgitta,0,0,1,1
22517,biliyor,0,0,1,1
22518,ಪಡೆಯುತ್ತಾರೆ,0,0,1,1
22519,generalized,0,0,1,1
22520,вставлять,0,0,1,1
22522,hurtigt,0,0,1,1
22501,هائل,0,0,1,1
22499,finalités,0,0,1,1
22498,automatiquement,0,0,1,1
22497,banks,0,0,1,1
22475,nonliving,0,0,1,1
22478,основанием,0,0,1,1
22479,sonriendo,0,0,1,1
22481,pouca,0,0,1,1
22482,തിരുത്തുന്നതിനും,0,0,1,1
22483,fortfahren,0,0,1,1
22484,வெளியேறினேன்,0,0,1,1
22486,नोब्रेनर,0,0,1,1
22487,zorunluluğu,0,0,1,1
22488,egentliga,0,0,1,1
22491,gesicht,0,0,1,1
22492,traduit,0,0,1,1
22494,ухожу,0,0,1,1
22495,diferenciar,0,0,1,1
22496,merveilleux,0,0,1,1
22523,शिक्षक,0,0,1,1
22525,центральных,0,0,1,1
22526,relational,0,0,1,1
22560,минимизировать,0,0,1,1
22562,мессенджер,0,0,1,1
22563,ശാഖയായ,0,0,1,1
22565,बनायी,0,0,1,1
22566,വെയിൽ‌സ്,0,0,1,1
22573,சஞ்சிகை,0,0,1,1
22574,natt,0,0,1,1
22575,choro,0,0,1,1
22576,betjänar,0,0,1,1
22577,sauvegardes,0,0,1,1
22578,sûre,0,0,1,1
22579,—cada,0,0,1,1
22580,مراجعته,0,0,1,1
22581,obscenity,0,0,1,1
22582,நிரூபிக்காவிட்டால்,0,0,1,1
22583,एनसिक्लोपेडिया,0,0,1,1
22561,நம்பமுடியாத,0,0,1,1
22556,summary,0,0,1,1
22528,subsidiaria,0,0,1,1
22555,multimídias,0,0,1,1
22529,पैसों,0,0,1,1
22532,руководителя,0,0,1,1
22533,soruyorsun,0,0,1,1
22534,ಆಶ್ಚರ್ಯಚಕಿತರಾಗಲು,0,0,1,1
22536,travelling,0,0,1,1
22537,étroitement,0,0,1,1
22538,ставить,0,0,1,1
22539,இதற்கு,0,0,1,1
22541,deductief,0,0,1,1
22542,جودة,0,0,1,1
22545,exportar,0,0,1,1
22546,vetting,0,0,1,1
22548,indecisa,0,0,1,1
22549,ciencia,0,0,1,1
22553,خطأي,0,0,1,1
52751,century,0,0,1,1
