,Word,where,Count_ita,Count_other,Total_count
4793,de,2,4,3493,3497
7920,di,1,3492,0,3492
0,,2,272,2678,2950
5408,a,2,985,1685,2670
1609,la,2,1323,1216,2539
5274,e,2,1844,410,2254
7130,in,2,1269,946,2215
2489,un,2,1343,596,1939
6448,wikipedia,2,870,792,1662
8384,the,2,13,1608,1621
5761,che,1,1608,0,1608
5907,en,2,1,1534,1535
9035,il,2,1196,112,1308
3974,è,1,1302,0,1302
42939,que,0,0,1294,1294
5572,l,2,827,438,1265
230,i,2,537,637,1174
4106,of,2,12,1126,1138
7125,le,2,635,472,1107
3017,o,2,497,502,999
3493,per,2,959,15,974
1441,da,2,565,316,881
5237,una,2,690,187,877
6799,and,2,7,846,853
29548,du,0,0,814,814
3422,non,2,745,25,770
1589,to,2,1,754,755
7693,se,2,312,410,722
309,sono,2,611,1,612
5869,et,2,1,587,588
5071,del,2,454,114,568
15616,के,0,0,563,563
4267,come,2,544,14,558
4831,is,2,1,552,553
1662,ha,2,486,49,535
5424,con,2,407,125,532
51167,je,0,0,507,507
8506,d,2,106,383,489
39816,à,0,0,481,481
9631,della,1,480,0,480
5189,si,2,306,172,478
6949,att,2,1,438,439
34182,y,0,0,429,429
7355,wikipédia,2,1,422,423
33793,det,0,0,423,423
49938,that,0,0,408,408
29254,por,0,0,408,408
18211,des,0,0,406,406
49835,में,0,0,396,396
1488,su,2,289,104,393
15216,les,0,0,389,389
1799,el,2,2,386,388
26211,och,0,0,387,387
13168,в,0,0,386,386
1425,no,2,40,346,386
9431,you,2,3,363,366
7066,più,1,364,0,364
21642,as,0,0,356,356
4208,for,2,3,353,356
46288,है,0,0,344,344
17191,para,0,0,337,337
40467,est,0,0,330,330
28019,som,0,0,329,329
905,dell,2,326,1,327
30043,और,0,0,313,313
16374,em,0,0,313,313
17636,at,0,0,308,308
41563,kan,0,0,303,303
21302,في,0,0,301,301
49496,une,0,0,299,299
52357,и,0,0,298,298
9405,es,2,8,290,298
8291,gli,1,296,0,296
51316,er,0,0,295,295
42760,να,0,0,292,292
41733,är,0,0,285,285
1240,lo,2,173,110,283
27644,het,0,0,282,282
9293,s,2,7,265,272
7284,dei,1,272,0,272
27288,vous,0,0,271,271
3303,apprendimento,1,271,0,271
8587,questo,1,267,0,267
19923,på,0,0,265,265
6329,nel,1,263,0,263
50925,um,0,0,263,263
35516,एक,0,0,262,262
47901,was,0,0,260,260
49272,من,0,0,259,259
4173,al,2,231,28,259
5545,on,2,2,256,258
33339,om,0,0,258,258
6102,wikimedia,2,115,141,256
47390,como,0,0,253,253
24938,você,0,0,252,252
8818,essere,1,252,0,252
27844,को,0,0,251,251
26119,ou,0,0,247,247
20642,،,0,0,247,247
27212,dans,0,0,246,246
14440,har,0,0,245,245
39517,कि,0,0,244,244
35814,een,0,0,244,244
8658,te,2,60,183,243
605,delle,1,243,0,243
8395,nature,2,24,218,242
27567,sie,0,0,240,240
52538,से,0,0,233,233
3102,anche,1,228,0,228
40777,हैं,0,0,228,228
27863,los,0,0,223,223
1572,articoli,1,223,0,223
7656,qui,2,46,174,220
22270,par,0,0,217,217
4755,van,2,1,212,213
9144,learning,2,31,181,212
3037,all,2,140,72,212
331,it,2,6,205,211
7249,alla,2,189,22,211
17808,ನೀವು,0,0,211,211
13337,bir,0,0,210,210
48565,ve,0,0,209,209
10867,are,0,0,209,209
8606,parte,2,158,50,208
7864,me,2,35,169,204
7298,ad,2,200,4,204
7566,ne,2,67,137,204
25343,av,0,0,204,204
34274,jag,0,0,203,203
5041,puoi,1,201,0,201
5390,do,2,3,196,199
2966,enciclopedia,2,152,47,199
26623,ik,0,0,198,198
20481,jeg,0,0,197,197
50146,आप,0,0,197,197
18833,og,0,0,197,197
6662,or,2,1,196,197
8906,ma,2,187,10,197
14415,και,0,0,196,196
32932,den,0,0,195,195
38323,uma,0,0,195,195
121,w,2,6,188,194
12812,by,0,0,193,193
19839,dat,0,0,192,192
14839,ich,0,0,192,192
21052,med,0,0,191,191
38485,não,0,0,190,190
7030,natura,2,184,5,189
18852,की,0,0,188,188
6920,era,2,138,48,186
4257,web,2,98,88,186
35286,நீங்கள்,0,0,183,183
35840, ·,0,0,182,182
25726,है।,0,0,179,179
20184,что,0,0,176,176
7994,cui,1,174,0,174
1706,dire,2,120,54,174
34913,लिए,0,0,173,173
7764,nella,1,172,0,172
52501,το,0,0,171,171
5147,an,2,2,169,171
46419,with,0,0,171,171
1414,narcisa,2,41,129,170
36242,pas,0,0,170,170
3616,sua,2,114,56,170
42890,أن,0,0,169,169
32112,не,0,0,167,167
34486,pour,0,0,167,167
14433,för,0,0,166,166
19631,can,0,0,165,165
2147,stato,1,165,0,165
28298,विकिपीडिया,0,0,165,165
3428,é,2,1,162,163
14745,ನಾನು,0,0,162,162
12226,dig,0,0,161,161
8735,tra,1,161,0,161
38260,का,0,0,157,157
14373,я,0,0,156,156
475,ti,2,146,10,156
6170,significa,2,96,59,155
34167,så,0,0,155,155
9614,quando,2,125,30,155
19894,على,0,0,155,155
1602,oh,2,47,108,155
47314,вы,0,0,153,153
5652,from,2,1,150,151
44240,var,0,0,151,151
37786,यह,0,0,150,150
36115,நான்,0,0,150,150
43053,be,0,0,149,149
44829,на,0,0,149,149
41365,नहीं,0,0,149,149
51926,und,0,0,149,149
39066,articles,0,0,148,148
18131,inte,0,0,148,148
37082,ಮತ್ತು,0,0,147,147
11096,sur,0,0,146,146
41287,have,0,0,145,145
7227,die,2,1,144,145
8497,loro,1,143,0,143
27263,las,0,0,142,142
7893,ai,2,80,61,141
30183,mais,0,0,141,141
7595,automatico,1,140,0,140
4864,dati,1,140,0,140
2534,data,2,34,105,139
6301,com,2,1,137,138
19333,ഒരു,0,0,138,138
1678,ce,2,3,135,138
3756,uno,2,120,17,137
5889,​,2,6,130,136
22238,ويكيبيديا,0,0,136,136
4659,così,1,136,0,136
3449,so,2,18,118,136
7439,wiki,2,61,74,135
7330,parola,1,134,0,134
4403,this,2,1,133,134
8341,hanno,1,134,0,134
4009,modo,2,122,11,133
2160,quindi,1,133,0,133
44119,das,0,0,132,132
2382,esempio,1,132,0,132
1299,degli,1,132,0,132
8348,wales,2,45,86,131
4372,os,2,1,130,131
21107,eller,0,0,131,131
29164,это,0,0,131,131
3208,mi,2,102,26,128
604,c,2,60,68,128
646,molto,1,128,0,128
11672,son,0,0,127,127
22767,till,0,0,127,127
9472,machine,2,25,102,127
33858,bu,0,0,127,127
5553,dalla,1,125,0,125
5933,internet,2,50,75,125
37513,als,0,0,125,125
20377,είναι,0,0,125,125
546,dal,1,125,0,125
37147,ஒரு,0,0,123,123
6785,inglese,1,122,0,122
51750,पर,0,0,121,121
23562,നിങ്ങൾ,0,0,121,121
35561,which,0,0,121,121
522,tu,2,53,67,120
38751,मैं,0,0,120,120
38594,που,0,0,119,119
40649,ikke,0,0,118,118
51332,plus,0,0,117,117
47762,niet,0,0,117,117
35802,sobre,0,0,116,116
4630,t,2,6,110,116
44258,ഞാൻ,0,0,116,116
3633,numero,1,114,0,114
2607,suo,1,113,0,113
32707,eu,0,0,112,112
24918,na,0,0,112,112
1949,solo,2,89,22,111
3691,hai,1,111,0,111
5469,qualcuno,1,110,0,110
13200,not,0,0,110,110
11161,has,0,0,110,110
3859,articolo,1,109,0,109
7166,sulla,1,107,0,107
294,stata,1,107,0,107
1670,video,2,43,64,107
33255,op,0,0,107,107
28484,για,0,0,107,107
3434,questa,1,106,0,106
8988,altri,1,106,0,106
28599,ist,0,0,106,106
754,ho,2,104,1,105
12976,der,0,0,103,103
46338,está,0,0,102,102
51572,ಎಂದು,0,0,102,102
10265,comme,0,0,102,102
19799,как,0,0,101,101
1585,sei,2,92,9,101
45830,с,0,0,101,101
8170,può,1,100,0,100
45938,zu,0,0,100,100
19268,au,0,0,100,100
7481,possono,1,100,0,100
14897,δεν,0,0,100,100
4916,due,2,88,12,100
48680,ser,0,0,99,99
544,foundation,2,23,74,97
46634,nicht,0,0,96,96
46727,किया,0,0,96,96
33201,ما,0,0,96,96
10059,कर,0,0,95,95
26577,என்று,0,0,95,95
9576,perché,1,94,0,94
31012,हैं।,0,0,93,93
2700, ,2,9,84,93
7252,alcuni,1,93,0,93
5023,software,2,46,47,93
28545,ότι,0,0,92,92
2184,utenti,1,92,0,92
3157,secondo,1,92,0,92
13057,mig,0,0,91,91
45773,sont,0,0,91,91
4091,sul,2,90,1,91
2928,sanger,2,36,55,91
27779,over,0,0,90,90
8832,catch,2,9,80,89
31541,википедии,0,0,89,89
9447,alle,2,68,21,89
4502,nupedia,2,35,54,89
26002,also,0,0,88,88
3758,sia,1,88,0,88
3489,tutto,1,88,0,88
32089,നിങ്ങൾക്ക്,0,0,88,88
4455,stati,1,88,0,88
7954,tutti,1,88,0,88
16573,ett,0,0,88,88
6982,nell,1,87,0,87
2837,progetto,1,87,0,87
2366,article,2,4,83,87
8019,fatto,1,86,0,86
6740,cosa,2,84,2,86
44974,لا,0,0,86,86
28055,सकते,0,0,85,85
5327,uso,2,57,28,85
42917,been,0,0,84,84
8585,n,2,1,83,84
2053,nei,1,83,0,83
9351,frase,2,51,32,83
51414,σε,0,0,83,83
5586,vita,1,82,0,82
6149,terry,2,21,61,82
1419,jimmy,2,30,52,82
27891,إلى,0,0,82,82
20325,dass,0,0,81,81
19855,met,0,0,81,81
4409,fare,1,81,0,81
52125,men,0,0,80,80
38430,avec,0,0,80,80
24786,pode,0,0,80,80
27846,أو,0,0,79,79
44672,entre,0,0,79,79
23156,til,0,0,79,79
29967,ord,0,0,78,78
41622,هذا,0,0,78,78
7480,altre,1,78,0,78
27650,σας,0,0,78,78
11121,или,0,0,77,77
23291,some,0,0,77,77
15529,artículos,0,0,77,77
4302,lavoro,1,77,0,77
25878,artigos,0,0,77,77
12542,más,0,0,77,77
49506,if,0,0,77,77
572,senza,1,76,0,76
29738,other,0,0,76,76
3693,sistema,2,62,14,76
8047,base,2,56,20,76
5856,tempo,2,60,16,76
38331,such,0,0,76,76
39490,são,0,0,75,75
37687,zijn,0,0,75,75
619,online,2,44,31,75
6449,comunità,1,75,0,75
23255,από,0,0,75,75
2595,altro,1,75,0,75
4920,m,2,3,72,75
5003,qualcosa,1,74,0,74
43471,af,0,0,74,74
43038,its,0,0,74,74
38147,μια,0,0,73,73
10145,θα,0,0,73,73
4533,google,2,23,50,73
4289,voci,1,73,0,73
18548,cette,0,0,73,73
5141,algoritmi,1,73,0,73
4588,informazioni,1,73,0,73
19739,या,0,0,73,73
11592,मुझे,0,0,73,73
34315,dit,0,0,72,72
7917,one,2,1,71,72
7417,dall,1,72,0,72
17610,bien,0,0,72,72
5210,rendezvous,2,20,52,72
45944,जो,0,0,72,72
51564,dos,0,0,71,71
4569,use,2,7,64,71
4583,contenuto,1,71,0,71
46726,but,0,0,71,71
48414,με,0,0,71,71
10334,भी,0,0,71,71
422,ed,1,70,0,70
3864,edizioni,1,70,0,70
21359,कुछ,0,0,70,70
30319,करने,0,0,70,70
391,bene,1,69,0,69
3587,dopo,1,69,0,69
20194,αυτό,0,0,69,69
8251,parole,2,68,1,69
8664,about,2,2,67,69
6510,ricerca,1,68,0,68
7186,mondo,1,68,0,68
35065,este,0,0,68,68
347,suoi,1,68,0,68
9562,quello,1,68,0,68
34199,η,0,0,68,68
5094,dai,1,67,0,67
15056,foi,0,0,67,67
31916,для,0,0,67,67
47572,more,0,0,67,67
24856,ने,0,0,66,66
5792,life,2,4,62,66
47096,han,0,0,66,66
8590,sito,1,65,0,65
2348,vista,2,45,20,65
22544,ты,0,0,65,65
45774,qu,0,0,65,65
2026,ci,1,65,0,65
40617,गया,0,0,64,64
2156,progetti,1,64,0,64
4221,molti,1,64,0,64
38903,wat,0,0,64,64
36920,wenn,0,0,64,64
26881,يمكنك,0,0,63,63
5314,new,2,14,49,63
5548,persona,2,42,21,63
7550,modifiche,1,63,0,63
18793,esta,0,0,63,63
558,prima,1,62,0,62
7809,modello,1,62,0,62
7236,fondazione,1,62,0,62
45145,her,0,0,62,62
8928,commons,2,24,38,62
267,forma,2,26,36,62
29014,года,0,0,62,62
33467,आपको,0,0,62,62
5119,spesso,1,62,0,62
4043,ben,2,17,44,61
26200,were,0,0,61,61
48163,çok,0,0,61,61
34672,elle,0,0,61,61
9048,ogni,1,61,0,61
6073,sempre,2,52,9,61
2524,queste,1,61,0,61
7356,particolare,1,61,0,61
2154,altra,1,61,0,61
1069,insieme,1,60,0,60
14015,site,0,0,60,60
4328,davvero,1,60,0,60
5791,questi,1,60,0,60
21742,için,0,0,60,60
28457,बहुत,0,0,60,60
1266,britannica,2,22,38,60
6851,sin,2,3,56,59
7044,alcune,1,59,0,59
22163,എനിക്ക്,0,0,59,59
22923,voor,0,0,59,59
22664,उपयोग,0,0,59,59
20544,être,0,0,59,59
32491,ഈ,0,0,59,59
21022,vikipedi,0,0,58,58
32359,they,0,0,58,58
40551,aux,0,0,58,58
4813,anni,1,58,0,58
3175,lingua,1,58,0,58
33649,had,0,0,58,58
1858,grazie,1,58,0,58
1803,set,2,19,39,58
8797,grande,2,37,21,58
8387,quanto,2,48,10,58
8248,durante,2,45,13,58
5807,conoscenza,1,57,0,57
39850,mot,0,0,57,57
8837,erano,1,57,0,57
27506,muito,0,0,57,57
5407,contenuti,1,57,0,57
14873,isso,0,0,56,56
21848,если,0,0,56,56
4596,mio,2,55,1,56
3398,time,2,4,52,56
49128,அல்லது,0,0,56,56
47258,editors,0,0,56,56
21497,he,0,0,56,56
32647,रूप,0,0,56,56
46941,andere,0,0,56,56
28194,ya,0,0,56,56
49635,été,0,0,56,56
5857,stesso,1,56,0,56
18752,hvis,0,0,56,56
35213,fait,0,0,55,55
48524,التي,0,0,55,55
24416,pouvez,0,0,55,55
14974,their,0,0,55,55
52502,μου,0,0,55,55
9487,problema,2,39,16,55
35508,ನಿಮಗೆ,0,0,55,55
4558,mentre,1,55,0,55
30801,betyder,0,0,55,55
6136,ciò,1,55,0,55
1908,momento,2,36,19,55
44993,साथ,0,0,55,55
19482,μπορείτε,0,0,55,55
19338,ze,0,0,55,55
21214,по,0,0,55,55
6868,editor,2,27,27,54
6928,vengono,1,54,0,54
5730,nelle,1,54,0,54
14480,इस,0,0,54,54
18756,तो,0,0,54,54
39877,sagen,0,0,54,54
52626,αν,0,0,54,54
3905,studio,1,54,0,54
9295,regole,1,54,0,54
48444,ഇത്,0,0,54,54
39713,о,0,0,54,54
50227,like,0,0,54,54
7617,suave,2,1,53,54
292,versione,1,54,0,54
25716,из,0,0,54,54
11319,πολύ,0,0,53,53
3822,what,2,2,51,53
9593,larry,2,20,33,53
979,mediawiki,2,21,32,53
14591,ή,0,0,53,53
30337,sus,0,0,53,53
32413,மிகவும்,0,0,53,53
11320,क्या,0,0,53,53
12897,था,0,0,53,53
16773,say,0,0,53,53
750,diversi,1,53,0,53
8960,libre,2,5,48,53
6315,nome,2,44,9,53
37127,ein,0,0,53,53
30905,these,0,0,52,52
4506,training,2,4,48,52
50873,रहा,0,0,52,52
43138,إذا,0,0,52,52
32622,there,0,0,52,52
8253,poi,1,52,0,52
1153,mit,2,4,48,52
36821,under,0,0,52,52
7699,posso,2,38,14,52
25510,किसी,0,0,51,51
42261,लेख,0,0,51,51
9095,viene,1,51,0,51
6265,encyclopedia,2,6,45,51
11265,википедия,0,0,51,51
15233,used,0,0,50,50
29232,algo,0,0,50,50
4002,mellie,2,12,38,50
8008,computer,2,34,16,50
41658,word,0,0,50,50
5719,caso,2,33,17,50
17286,we,0,0,50,50
32994,της,0,0,49,49
4917,war,2,2,47,49
36542,так,0,0,49,49
43870,ses,0,0,49,49
33091,كان,0,0,49,49
14651,example,0,0,49,49
11116,may,0,0,49,49
867,j,2,1,48,49
45460,kunt,0,0,49,49
2898,information,2,3,46,49
4109,ora,1,49,0,49
9214,tua,1,48,0,48
16101,ಅಥವಾ,0,0,48,48
395,sull,1,48,0,48
32504,ήταν,0,0,48,48
34180,nu,0,0,48,48
52164,можете,0,0,48,48
42291,ένα,0,0,48,48
2604,campo,2,43,5,48
6526,test,2,23,25,48
35393,ces,0,0,48,48
17555,वह,0,0,48,48
6573,vuoi,1,48,0,48
17031,शब्द,0,0,48,48
7212,tipo,2,29,19,48
7950,marian,2,12,36,48
51633,wie,0,0,48,48
6127,state,2,43,5,48
43345,vez,0,0,47,47
26619,här,0,0,47,47
1829,uomo,1,47,0,47
27131,than,0,0,47,47
5351,tanto,2,30,17,47
26766,द्वारा,0,0,47,47
43957,மற்றும்,0,0,47,47
7513,persone,1,47,0,47
7958,man,2,3,44,47
5113,tre,2,34,13,47
36274,അത്,0,0,47,47
46498,hvad,0,0,47,47
8856,diverse,2,44,3,47
3565,tutte,1,47,0,47
26124,vara,0,0,47,47
1577,milioni,1,47,0,47
45251,when,0,0,47,47
2548,usare,1,47,0,47
27767,puedes,0,0,47,47
1325,artificiale,1,47,0,47
1825,casa,2,27,19,46
43426,säga,0,0,46,46
9600,negli,1,46,0,46
5420,madre,2,34,12,46
31146,oder,0,0,46,46
1297,media,2,33,13,46
5332,acqua,1,46,0,46
45801,aussi,0,0,46,46
48326,zo,0,0,46,46
9643,mobile,2,20,26,46
33867,algorithms,0,0,46,46
23612,eine,0,0,45,45
33675,part,0,0,45,45
4906,siti,1,45,0,45
49144,mas,0,0,45,45
5537,volta,1,45,0,45
7379,earth,2,1,44,45
5051,quel,2,37,8,45
42090,nummer,0,0,45,45
6736,pagina,2,43,2,45
26153,हो,0,0,45,45
49481,était,0,0,45,45
3182,culture,2,5,40,45
2517,qualsiasi,1,45,0,45
38085,können,0,0,45,45
20511,number,0,0,45,45
32006,zeggen,0,0,45,45
5939,primo,1,45,0,45
17389,número,0,0,45,45
20649,tem,0,0,45,45
21667,dem,0,0,44,44
2703,intelligente,2,39,5,44
3559,attraverso,1,44,0,44
5512,punto,2,37,7,44
48606,todo,0,0,44,44
22430,dizer,0,0,44,44
6159,vandalismo,2,29,15,44
33846,artiklar,0,0,44,44
6990,addestramento,1,44,0,44
8194,fine,2,40,4,44
13227,இது,0,0,44,44
8638,qualità,1,44,0,44
9062,tuttavia,1,44,0,44
5691,sotto,1,43,0,43
6619,maggior,1,43,0,43
6082,content,2,1,42,43
15256,page,0,0,43,43
2389,flummox,2,9,34,43
3992,sue,2,40,3,43
50370,från,0,0,43,43
48894,någon,0,0,43,43
39719,min,0,0,43,43
14206,τη,0,0,43,43
6979,problemi,1,43,0,43
15405,sige,0,0,43,43
46574,ನಿಮ್ಮ,0,0,43,43
7531,processo,2,38,5,43
46544,к,0,0,43,43
2243,gennaio,1,43,0,43
42136,इसे,0,0,43,43
7371,idea,2,32,11,43
46095,ಅದು,0,0,43,43
50167,iyi,0,0,43,43
44425,ही,0,0,43,43
34979,vad,0,0,43,43
32957,encyclopédie,0,0,43,43
46783,wikipedias,0,0,42,42
1832,editori,1,42,0,42
1857,terra,2,40,2,42
28088,version,0,0,42,42
3200,meno,1,42,0,42
2123,lui,2,16,26,42
1808,english,2,1,41,42
3255,pagine,1,42,0,42
44418,heb,0,0,42,42
50376,também,0,0,42,42
8419,input,2,27,15,42
8543,interno,2,41,1,42
3105,volte,1,42,0,42
23035,autres,0,0,42,42
15155,usar,0,0,41,41
10019,noget,0,0,41,41
41608,τον,0,0,41,41
7910,cultura,2,36,5,41
51994,tout,0,0,41,41
39385,сказать,0,0,41,41
33797,situation,0,0,41,41
37572,она,0,0,41,41
40121,vil,0,0,41,41
2897,terrence,2,10,31,41
23659,هذه,0,0,41,41
1065,metodi,1,41,0,41
11090,ela,0,0,41,41
6908,sta,1,40,0,40
47228,only,0,0,40,40
19630,а,0,0,40,40
19689,ont,0,0,40,40
17256,ذلك,0,0,40,40
39579,στο,0,0,40,40
4785,oro,2,32,8,40
21074,"
",0,0,40,40
13978,ನನ್ನ,0,0,40,40
5379,licenza,1,40,0,40
9303,algoritmo,2,32,8,40
25173,aprendizaje,0,0,40,40
35979,many,0,0,40,40
7698,agli,1,40,0,40
1336,lingue,1,40,0,40
11631,ಈ,0,0,40,40
8674,oltre,1,40,0,40
6777,contributori,1,40,0,40
52533,दिया,0,0,40,40
5486,naturale,1,40,0,40
35918,andra,0,0,39,39
50492,my,0,0,39,39
47502,τα,0,0,39,39
40119,maar,0,0,39,39
29363,editores,0,0,39,39
5973,aveva,1,39,0,39
5972,up,2,1,38,39
33323,smart,0,0,39,39
9526,immagini,1,39,0,39
8549,lento,2,20,19,39
8160,quella,1,39,0,39
44303,мне,0,0,39,39
16120,mijn,0,0,39,39
8082,sulle,1,39,0,39
33376,habe,0,0,39,39
726,anno,2,38,1,39
4571,vi,2,7,32,39
49497,most,0,0,39,39
11709,عن,0,0,39,39
49022,വളരെ,0,0,39,39
1194,va,2,25,14,39
38336,re,0,0,39,39
28069,seu,0,0,39,39
34917,would,0,0,39,39
3997,youtube,2,12,27,39
40578,இந்த,0,0,38,38
45088,ele,0,0,38,38
22187,sites,0,0,38,38
38807,any,0,0,38,38
38565,அது,0,0,38,38
29339,कोई,0,0,38,38
5028,atroce,2,29,9,38
41549,autre,0,0,38,38
46105,был,0,0,38,38
19425,എന്റെ,0,0,38,38
13615,कह,0,0,38,38
23796,உங்களுக்கு,0,0,38,38
43225,было,0,0,38,38
3345,generalmente,2,37,1,38
6010,causa,2,37,1,38
33056,meget,0,0,38,38
8838,science,2,8,30,38
27463,kom,0,0,38,38
22648,την,0,0,38,38
44775,എന്ന്,0,0,37,37
28328,nogen,0,0,37,37
7756,potrebbe,1,37,0,37
909,forme,2,21,16,37
6163,sa,2,3,34,37
4045,ottuso,1,37,0,37
48052,была,0,0,37,37
36247,door,0,0,37,37
45648,alors,0,0,37,37
48599,cada,0,0,37,37
9402,human,2,1,36,37
43137,hun,0,0,37,37
15743,mich,0,0,37,37
5108,voce,1,36,0,36
1356,pane,1,36,0,36
37468,deze,0,0,36,36
18164,leur,0,0,36,36
4956,analisi,1,36,0,36
11804,quelqu,0,0,36,36
23847,exemplo,0,0,36,36
23139,तरह,0,0,36,36
5123,fonte,2,30,6,36
42644,något,0,0,36,36
34889,todos,0,0,36,36
19904,alguém,0,0,36,36
14259,iemand,0,0,36,36
12710,très,0,0,36,36
51615,जैसे,0,0,36,36
37150,रहे,0,0,36,36
15809,также,0,0,36,36
50496,του,0,0,36,36
27087,alguien,0,0,36,36
20114,water,0,0,36,36
3423,dispiace,1,36,0,36
33682,വിക്കിപീഡിയ,0,0,36,36
24756,ejemplo,0,0,36,36
34973,cuando,0,0,36,36
4613,spazio,1,36,0,36
46981,así,0,0,36,36
38410,pero,0,0,36,36
16855,olika,0,0,36,36
21669,person,0,0,35,35
5642,mamma,2,23,12,35
51650,también,0,0,35,35
3956,sebbene,1,35,0,35
4835,esempi,1,35,0,35
3621,quasi,1,35,0,35
28930,conteúdo,0,0,35,35
21208,model,0,0,35,35
30279,don,0,0,35,35
37107,même,0,0,35,35
34329,palabra,0,0,35,35
39698,então,0,0,35,35
19652,decir,0,0,35,35
5080,molte,1,35,0,35
610,chiedere,1,35,0,35
38317,अपने,0,0,35,35
47109,woord,0,0,35,35
36065,language,0,0,35,35
3363,invece,1,35,0,35
28842,ತುಂಬಾ,0,0,35,35
25692,project,0,0,35,35
30546,sig,0,0,35,35
3364,dici,1,35,0,35
36747,palavra,0,0,35,35
13308,شخص,0,0,35,35
34652,كنت,0,0,35,35
9607,free,2,6,29,35
41119,usuarios,0,0,35,35
7858,quale,1,35,0,35
31361,donc,0,0,34,34
1676,sistemi,2,33,1,34
28628,homme,0,0,34,34
41223,sido,0,0,34,34
40046,ça,0,0,34,34
18288,how,0,0,34,34
16313,ನನಗೆ,0,0,34,34
5877,general,2,3,31,34
8318,detta,2,2,32,34
15747,dan,0,0,34,34
5994,—,2,15,19,34
1043,versioni,1,34,0,34
1856,tuo,1,34,0,34
27674,goed,0,0,34,34
2324,work,2,1,33,34
19221,vill,0,0,34,34
1147,editing,2,14,20,34
4021,termine,1,34,0,34
5631,times,2,12,22,34
52069,все,0,0,34,34
4160,importante,2,21,13,34
20750,von,0,0,34,34
48152,edições,0,0,34,34
44759,sens,0,0,34,34
45403,suis,0,0,34,34
47292,selon,0,0,34,34
50163,usuários,0,0,34,34
31615,your,0,0,34,34
20801,into,0,0,34,34
1634,nota,2,20,14,34
19648,ved,0,0,34,34
33338,ಇದು,0,0,34,34
5963,creare,1,33,0,33
42567,phrase,0,0,33,33
9366,po,1,33,0,33
30342,അല്ലെങ്കിൽ,0,0,33,33
3978,research,2,3,30,33
24772,när,0,0,33,33
50715,porque,0,0,33,33
32395,когда,0,0,33,33
42194,aan,0,0,33,33
34706,two,0,0,33,33
342,amici,1,33,0,33
20768,सकता,0,0,33,33
2379,generale,1,33,0,33
1861,umana,1,33,0,33
15556,ao,0,0,33,33
13194,between,0,0,33,33
20793,även,0,0,33,33
45524,ook,0,0,33,33
41649,artigo,0,0,33,33
33113,dir,0,0,33,33
7325,sviluppo,1,33,0,33
5552,natural,2,1,32,33
34327,apprentissage,0,0,33,33
17449,deux,0,0,33,33
20433,очень,0,0,33,33
2298,posto,1,33,0,33
9160,rivista,1,33,0,33
51768,mycket,0,0,33,33
16151,lugar,0,0,33,33
21101,naar,0,0,33,33
3408,proprio,1,33,0,33
3515,encyclopædia,2,6,27,33
6442,argomenti,1,33,0,33
28385,mir,0,0,33,33
2561,libera,1,33,0,33
15543,например,0,0,33,33
9205,circa,2,32,1,33
8310,attività,1,33,0,33
46572,nombre,0,0,33,33
2980,accesso,1,32,0,32
43999,इसके,0,0,32,32
15552,أنا,0,0,32,32
6394,fonti,1,32,0,32
24623,जा,0,0,32,32
8976,fantastico,1,32,0,32
9515,giorno,1,32,0,32
42967,muy,0,0,32,32
4561,già,1,32,0,32
20372,peut,0,0,32,32
27703,бы,0,0,32,32
44156,means,0,0,32,32
13790,hon,0,0,32,32
21089,avez,0,0,32,32
33349,करते,0,0,32,32
40663,كانت,0,0,32,32
52097,अगर,0,0,32,32
38830,auf,0,0,32,32
31825,signifie,0,0,32,32
36280,somebody,0,0,32,32
4265,dette,2,2,30,32
33801,går,0,0,32,32
39411,données,0,0,32,32
33785,another,0,0,32,32
37175,faire,0,0,32,32
10098,bin,0,0,32,32
15602,hebt,0,0,31,31
38035,waren,0,0,31,31
8412,gfdl,2,12,19,31
15475,നിങ്ങളുടെ,0,0,31,31
21709,will,0,0,31,31
15694,well,0,0,31,31
16971,bra,0,0,31,31
43644,einen,0,0,31,31
7491,intelligenza,1,31,0,31
29124,சில,0,0,31,31
2267,mining,2,19,12,31
8858,york,2,13,18,31
41702,chose,0,0,31,31
28129,hur,0,0,31,31
47935,вам,0,0,31,31
26130,статьи,0,0,31,31
4767,deve,2,16,15,31
35792,qualquer,0,0,31,31
6224,casi,2,23,8,31
25183,πείτε,0,0,31,31
13813,often,0,0,31,31
45298,projeto,0,0,31,31
2399,good,2,2,29,31
20045,skulle,0,0,31,31
35991,ο,0,0,31,31
27478,عام,0,0,31,31
24693,dus,0,0,31,31
4352,modifica,1,31,0,31
1397,realmente,2,1,30,31
36739,fix,0,0,31,31
21422,genom,0,0,31,31
42245,exemple,0,0,31,31
9042,sarebbe,1,31,0,31
48344,etwas,0,0,31,31
2297,grado,2,30,1,31
297,pregiudizi,1,30,0,30
3192,linguistiche,1,30,0,30
10317,ಅದನ್ನು,0,0,30,30
1524,alto,2,21,9,30
7892,francese,1,30,0,30
48148,ordet,0,0,30,30
2581,importa,2,15,15,30
3725,edizione,1,30,0,30
23059,λέξη,0,0,30,30
31788,páginas,0,0,30,30
49371,called,0,0,30,30
9174,affermato,1,30,0,30
25791,هل,0,0,30,30
18623,være,0,0,30,30
32143,но,0,0,30,30
8420,riferimento,1,30,0,30
2268,nuovo,1,30,0,30
34279,want,0,0,30,30
4984,utilizzato,1,30,0,30
25882,അതിനാൽ,0,0,30,30
39308,لقد,0,0,30,30
6973,creative,2,11,19,30
15961,partir,0,0,30,30
51007,she,0,0,30,30
40581,artículo,0,0,30,30
7517,visto,2,19,11,30
748,successo,1,30,0,30
8591,situazione,1,30,0,30
9857,статей,0,0,30,30
2557,gnu,2,8,22,30
51742,बारे,0,0,30,30
2872,ambiente,2,29,1,30
17727,fue,0,0,30,30
27538,bem,0,0,30,30
2877,tramite,1,30,0,30
40641,fazer,0,0,29,29
52328,dich,0,0,29,29
22800,لم,0,0,29,29
8031,senso,2,28,1,29
6627,fa,1,29,0,29
10251,आपके,0,0,29,29
7119,principalmente,2,22,7,29
14390,तक,0,0,29,29
5213,libero,1,29,0,29
7093,enciclopedie,1,29,0,29
4563,nuovi,1,29,0,29
47126,जाता,0,0,29,29
35189,gibi,0,0,29,29
24571,exempel,0,0,29,29
23983,puede,0,0,29,29
6894,knowledge,2,2,27,29
8071,frasi,1,29,0,29
8726,redattori,1,29,0,29
40135,study,0,0,29,29
36778,där,0,0,29,29
2258,completamente,2,22,7,29
22174,sorry,0,0,29,29
7998,tan,2,1,28,29
8196,lei,2,24,5,29
20020,он,0,0,29,29
13159,contenu,0,0,29,29
13154,ediciones,0,0,29,29
16491,लेकिन,0,0,29,29
4103,caratteristiche,1,29,0,29
40231,artificial,0,0,29,29
33827,अधिक,0,0,29,29
6218,grandi,1,29,0,29
16248,هي,0,0,29,29
6703,university,2,8,21,29
25800,know,0,0,29,29
35598,estou,0,0,29,29
6168,hey,2,8,21,29
46683,monde,0,0,29,29
43691,who,0,0,29,29
38535,system,0,0,29,29
2024,stessa,1,29,0,29
10860,उस,0,0,29,29
28085,чтобы,0,0,29,29
9348,narciso,2,15,13,28
5306,sogno,1,28,0,28
9523,supervisionato,1,28,0,28
7705,argomento,1,28,0,28
39011,σημαίνει,0,0,28,28
39178,مثل,0,0,28,28
1568,poiché,1,28,0,28
26276,ainsi,0,0,28,28
6084,server,2,22,6,28
33776,которые,0,0,28,28
8580,rispetto,1,28,0,28
20985,din,0,0,28,28
8529,journal,2,7,21,28
40342,because,0,0,28,28
38319,hier,0,0,28,28
715,poco,2,16,12,28
35682,haben,0,0,28,28
50731,them,0,0,28,28
8060,via,2,8,20,28
10573,then,0,0,28,28
42661,हूं,0,0,28,28
21730,apenas,0,0,28,28
10502,உங்கள்,0,0,28,28
19566,ಆದ್ದರಿಂದ,0,0,28,28
5182,include,2,6,22,28
7939,dato,2,25,3,28
45196,أخرى,0,0,28,28
34698,several,0,0,28,28
18882,वे,0,0,28,28
43346,images,0,0,28,28
14045,ಹೇಳಬಹುದು,0,0,28,28
6086,seconda,1,28,0,28
9013,creazione,1,28,0,28
4968,stai,1,28,0,28
8602,get,2,1,27,28
4169,quali,1,28,0,28
31101,هو,0,0,27,27
34506,меня,0,0,27,27
23560,eso,0,0,27,27
9445,dalle,1,27,0,27
8146,piuttosto,1,27,0,27
26620,στην,0,0,27,27
1119,libro,2,22,5,27
6933,specie,1,27,0,27
8522,dove,1,27,0,27
24438,zou,0,0,27,27
2319,chiunque,1,27,0,27
7716,termini,1,27,0,27
32614,gå,0,0,27,27
26635,dont,0,0,27,27
37116,الذي,0,0,27,27
39167,anglais,0,0,27,27
16455,вас,0,0,27,27
27625,за,0,0,27,27
28100,sich,0,0,27,27
47944,τι,0,0,27,27
40192,betekent,0,0,27,27
15729,estoy,0,0,27,27
16006,പറയാൻ,0,0,27,27
45289,while,0,0,27,27
18304,otros,0,0,27,27
51371,åh,0,0,27,27
1041,vari,1,27,0,27
44174,place,0,0,27,27
20700,question,0,0,27,27
18604,revista,0,0,27,27
21507,sind,0,0,27,27
36017,ಒಂದು,0,0,27,27
3406,avere,1,27,0,27
43285,يمكن,0,0,27,27
466,andare,1,27,0,27
14445,அதை,0,0,27,27
5551,seguito,1,26,0,26
9178,community,2,7,19,26
3610,controllo,1,26,0,26
7086,sai,2,25,1,26
50178,inglés,0,0,26,26
32431,μην,0,0,26,26
16936,problem,0,0,26,26
39423,eles,0,0,26,26
18427,very,0,0,26,26
21474,mundo,0,0,26,26
521,modelli,1,26,0,26
29551,أنه,0,0,26,26
11895,known,0,0,26,26
4493,sui,1,26,0,26
2538,errori,1,26,0,26
48813,olduğunu,0,0,26,26
10980,تم,0,0,26,26
42545,än,0,0,26,26
12347,быть,0,0,26,26
13340,τους,0,0,26,26
38204,जब,0,0,26,26
47924,surface,0,0,26,26
51147,αλλά,0,0,26,26
26627,für,0,0,26,26
2403,allora,1,26,0,26
46384,अच्छा,0,0,26,26
8699,cose,1,26,0,26
45530,كل,0,0,26,26
27349,amigos,0,0,26,26
42990,करता,0,0,26,26
1319,rock,2,4,22,26
11645,இல்லை,0,0,26,26
20515,aber,0,0,26,26
37092,είμαι,0,0,26,26
42349,τόσο,0,0,26,26
44466, million,0,0,26,26
43121,ಆದರೆ,0,0,26,26
5040,fase,2,21,5,26
20633,seus,0,0,26,26
12521,daha,0,0,26,26
29728,έχετε,0,0,26,26
3841,corso,2,25,1,26
6879,ama,2,2,24,26
11313,could,0,0,25,25
12076,कई,0,0,25,25
15255,enciclopédia,0,0,25,25
41467,بعض,0,0,25,25
35628,after,0,0,25,25
16696,wort,0,0,25,25
36795,gut,0,0,25,25
39855,ofta,0,0,25,25
11257,made,0,0,25,25
21385,quelque,0,0,25,25
49331,எனவே,0,0,25,25
37557,കഴിയും,0,0,25,25
2471,fosse,2,23,2,25
47517,sätt,0,0,25,25
5530,testo,1,25,0,25
47604,ஆனால்,0,0,25,25
2111,dag,2,1,24,25
52576,dessa,0,0,25,25
3083,quelle,2,19,6,25
1340,tale,2,21,4,25
46547,información,0,0,25,25
36645,nous,0,0,25,25
47463,something,0,0,25,25
45153,sehr,0,0,25,25
6725,premio,2,23,2,25
3658,dello,1,25,0,25
22027,bedeutet,0,0,25,25
19,troppo,1,25,0,25
36360,κάτι,0,0,25,25
29930,அவள்,0,0,25,25
25874,iets,0,0,25,25
29240,uit,0,0,25,25
51972,both,0,0,25,25
4805,vale,2,17,8,25
3524,varie,2,24,1,25
231,livello,1,25,0,25
44824,annat,0,0,25,25
16714,contenido,0,0,25,25
52446,слово,0,0,25,25
6956,dagli,1,25,0,25
48805,था।,0,0,25,25
470,domanda,1,25,0,25
22532,werd,0,0,25,25
40820,الإنجليزية,0,0,25,25
4869,classificazione,1,25,0,25
80,disse,2,3,22,25
12371,tous,0,0,25,25
35570,بشكل,0,0,25,25
41948,kommer,0,0,24,24
2675,principali,1,24,0,24
6716,source,2,6,18,24
27785,found,0,0,24,24
7485,marion,2,6,18,24
35430,efter,0,0,24,24
1818,mai,2,21,3,24
28023,у,0,0,24,24
20025,years,0,0,24,24
15606,hem,0,0,24,24
44533,få,0,0,24,24
4454,compiti,1,24,0,24
49966,alguns,0,0,24,24
49392,diferentes,0,0,24,24
17594,where,0,0,24,24
10376,उदाहरण,0,0,24,24
11405,users,0,0,24,24
28494,estar,0,0,24,24
18441,esto,0,0,24,24
23671,अंग्रेजी,0,0,24,24
22897,bland,0,0,24,24
6098,tiene,2,1,23,24
35121,using,0,0,24,24
19574,sous,0,0,24,24
16718,செய்ய,0,0,24,24
7318,intelligence,2,5,19,24
10735,artikelen,0,0,24,24
24669,process,0,0,24,24
41291,within,0,0,24,24
52622,لك,0,0,24,24
8589,sapere,2,23,1,24
49088,notamment,0,0,24,24
15418,doen,0,0,24,24
49872,estaba,0,0,24,24
791,center,2,8,16,24
37507,desde,0,0,24,24
551,pages,2,1,23,24
21120,automatique,0,0,24,24
4943,meglio,1,24,0,24
301,world,2,1,23,24
47231,outra,0,0,24,24
22592,प्राप्त,0,0,24,24
33693,этого,0,0,24,24
7843,first,2,1,23,24
40961,अन्य,0,0,24,24
22574,pela,0,0,24,24
14405,words,0,0,23,23
5402,rete,1,23,0,23
24785,هناك,0,0,23,23
40532,tão,0,0,23,23
15415,nos,0,0,23,23
8123,forse,1,23,0,23
16653,были,0,0,23,23
15932,really,0,0,23,23
4371,bbc,2,7,16,23
25773,sem,0,0,23,23
28958,ಯಾರಾದರೂ,0,0,23,23
25707,ಅವರು,0,0,23,23
6522,risultati,1,23,0,23
12122,हूँ,0,0,23,23
12919,much,0,0,23,23
398,scopo,1,23,0,23
44246,podem,0,0,23,23
51837,comment,0,0,23,23
50044,including,0,0,23,23
329,go,2,2,21,23
7611,dio,2,19,4,23
8109,fuori,1,23,0,23
2829,tali,1,23,0,23
49207,gebruiken,0,0,23,23
51912,sans,0,0,23,23
24006,κάποιος,0,0,23,23
22452,geen,0,0,23,23
39505,way,0,0,23,23
38368,out,0,0,23,23
31137,even,0,0,23,23
48179,ville,0,0,23,23
24365,godt,0,0,23,23
7087,statistica,1,23,0,23
4936,methods,2,1,22,23
27450,nej,0,0,23,23
6310,semplicemente,1,23,0,23
43939,later,0,0,23,23
40585,hoe,0,0,23,23
3678,vai,2,14,9,23
28528,വിക്കിപീഡിയയിൽ,0,0,23,23
6986,bias,2,3,20,23
37460,också,0,0,23,23
17278,kann,0,0,23,23
17830,each,0,0,23,23
41227,votre,0,0,23,23
8116,paesi,1,23,0,23
21024,meer,0,0,23,23
26640,أي,0,0,23,23
44561,veya,0,0,23,23
9594,fino,2,22,1,23
25376,through,0,0,23,23
5758,naturali,1,23,0,23
2762,reti,1,23,0,23
11581,utiliser,0,0,22,22
10295,является,0,0,22,22
39798,ಬಗ್ಗೆ,0,0,22,22
1039,scusa,1,22,0,22
42347,विश्वकोश,0,0,22,22
8228,see,2,1,21,22
5744,gran,2,16,6,22
26969,just,0,0,22,22
420,voglio,1,22,0,22
2577,serie,2,15,7,22
19410,según,0,0,22,22
13404,projet,0,0,22,22
40018,करना,0,0,22,22
6255,settembre,1,22,0,22
50791,विकिमीडिया,0,0,22,22
5142,tal,2,2,20,22
45968,المقالات,0,0,22,22
14917,denne,0,0,22,22
1651,opera,2,19,3,22
24847,his,0,0,22,22
922,narcis,2,5,17,22
7544,usato,1,22,0,22
34885,​​,0,0,22,22
7710,cibo,1,22,0,22
37874,användare,0,0,22,22
6691,farlo,1,22,0,22
3995,output,2,14,8,22
16901,inteligente,0,0,22,22
2071,portato,1,22,0,22
126,donne,2,15,7,22
49494,использовать,0,0,22,22
37309,proyecto,0,0,22,22
8708,obiettivo,1,22,0,22
32155,otra,0,0,22,22
16015,bara,0,0,22,22
15279,то,0,0,22,22
2413,difficile,2,16,6,22
3512,oggi,1,22,0,22
42738,ska,0,0,22,22
5720,public,2,3,19,22
22400,menos,0,0,22,22
47838,от,0,0,22,22
37898,estava,0,0,22,22
1884,ancora,1,22,0,22
49769,outros,0,0,22,22
1862,allo,1,22,0,22
1904,umani,1,22,0,22
46240,kannst,0,0,22,22
28072,kadar,0,0,22,22
27216,travail,0,0,22,22
39059,hij,0,0,22,22
9021,essa,2,9,13,22
40952,வேண்டும்,0,0,22,22
5088,revisione,1,22,0,22
16543,मेरे,0,0,22,22
33836,शुरू,0,0,22,22
1686,false,2,14,8,22
6556,inoltre,1,22,0,22
18567,году,0,0,22,22
28454,moment,0,0,22,22
24035,alles,0,0,22,22
15058,versions,0,0,22,22
30862,haar,0,0,22,22
9495,melissa,2,6,16,22
3922,accordo,1,22,0,22
958,bomis,2,9,13,22
498,metodo,1,22,0,22
41564,என்ன,0,0,22,22
1704,università,1,22,0,22
4524,alexa,2,7,15,22
6918,società,1,22,0,22
11845,people,0,0,22,22
3622,detto,1,22,0,22
42102,थे,0,0,22,22
34048,edição,0,0,22,22
36613,başka,0,0,22,22
629,storia,1,22,0,22
7127,approccio,1,22,0,22
29267,hade,0,0,22,22
20014,काम,0,0,22,22
17257,fantastisk,0,0,22,22
6829,arrabbiato,1,22,0,22
25642,text,0,0,22,22
38766,sein,0,0,21,21
11935,gøre,0,0,21,21
9257,ottenuto,1,21,0,21
30553,അവൾ,0,0,21,21
4947,aver,1,21,0,21
10947,परियोजना,0,0,21,21
1755,ricercatori,1,21,0,21
28272,hast,0,0,21,21
8938,oggetto,1,21,0,21
50216,related,0,0,21,21
18437,até,0,0,21,21
6340,politica,1,21,0,21
11108,wirklich,0,0,21,21
34818,depuis,0,0,21,21
4446,dicembre,1,21,0,21
26858,ನಿಜವಾಗಿಯೂ,0,0,21,21
34549,том,0,0,21,21
30941,atroz,0,0,21,21
25990,trabalho,0,0,21,21
27617,ver,0,0,21,21
24292,എന്നെ,0,0,21,21
32346,ese,0,0,21,21
18310,mer,0,0,21,21
1454,basato,1,21,0,21
10628,otras,0,0,21,21
28315,kun,0,0,21,21
20951,έχω,0,0,21,21
8062,partire,1,21,0,21
20767,inglês,0,0,21,21
36815,heeft,0,0,21,21
14966,ಅವಳು,0,0,21,21
44978,хорошо,0,0,21,21
10708,என்,0,0,21,21
8096,struttura,1,21,0,21
43111,palabras,0,0,21,21
30808,blev,0,0,21,21
1376,uniti,1,21,0,21
45919,olarak,0,0,21,21
6783,esiste,1,21,0,21
47032,peuvent,0,0,21,21
46794,şey,0,0,21,21
18854,vraiment,0,0,21,21
6915,bot,2,14,7,21
1741,american,2,3,18,21
14707,being,0,0,21,21
15673,field,0,0,21,21
25318,classification,0,0,21,21
43764,environment,0,0,21,21
43453,എന്ന,0,0,21,21
35291,mesmo,0,0,21,21
24843,anlamına,0,0,21,21
18198,finns,0,0,21,21
45152,gerçekten,0,0,21,21
4577,flora,2,11,10,21
34110,أكثر,0,0,21,21
5102,migliorare,1,21,0,21
13239,quand,0,0,21,21
30488,എന്തെങ്കിലും,0,0,21,21
233,origine,2,14,7,21
408,ultima,1,21,0,21
19933,använda,0,0,21,21
5010,animali,1,21,0,21
24945,अपनी,0,0,21,21
32422,reported,0,0,21,21
22345,kelime,0,0,21,21
10409,hat,0,0,21,21
46643,sources,0,0,21,21
1048,collegamenti,1,21,0,21
19281,foram,0,0,21,21
16033,utan,0,0,21,21
4680,volontari,1,21,0,21
5224,studenti,1,21,0,21
18506,تقول,0,0,21,21
1810,examples,2,1,20,21
9941,verwenden,0,0,21,21
46032,οι,0,0,21,21
23153,qué,0,0,21,21
8646,–,2,5,16,21
14606,விக்கிப்பீடியா,0,0,21,21
32163,yüzden,0,0,21,21
15384,generally,0,0,21,21
2163,capacità,1,21,0,21
6945,superficie,1,21,0,21
3471,mia,1,21,0,21
45884,നിങ്ങളെ,0,0,21,21
15481,göra,0,0,21,21
9032,macchina,1,20,0,20
1765,bello,1,20,0,20
9936,يا,0,0,20,20
29211,στη,0,0,20,20
203,»,2,5,15,20
13814,rules,0,0,20,20
6719,enorme,2,12,8,20
10552,भाषा,0,0,20,20
24690,vezes,0,0,20,20
6712,lettori,1,20,0,20
25543,മറ്റൊരു,0,0,20,20
3146,mysql,2,4,16,20
5419,open,2,6,14,20
42353,suas,0,0,20,20
6964,esseri,1,20,0,20
7753,edit,2,2,18,20
7034,sms,2,2,18,20
10547,mots,0,0,20,20
31657,weet,0,0,20,20
33329,également,0,0,20,20
16766,going,0,0,20,20
6748,neurali,1,20,0,20
3491,nello,1,20,0,20
7074,capito,1,20,0,20
47091,estás,0,0,20,20
14905,थी,0,0,20,20
4802,create,2,6,14,20
1148,sto,1,20,0,20
26926,manera,0,0,20,20
1125,siano,1,20,0,20
2357,abbastanza,1,20,0,20
3152,lista,2,5,15,20
33070,क्योंकि,0,0,20,20
29314,jemand,0,0,20,20
36743,êtes,0,0,20,20
3546,intelligenti,1,20,0,20
5900,database,2,16,4,20
16245,får,0,0,20,20
41562,algunas,0,0,20,20
13628,عندما,0,0,20,20
5589,facebook,2,8,12,20
7452,license,2,3,17,20
31024,certaines,0,0,20,20
2481,angolo,1,20,0,20
8498,programma,2,18,2,20
8052,utilizzare,1,20,0,20
7197,dvd,2,9,11,20
52141,ആ,0,0,20,20
5913,buona,1,20,0,20
5576,principe,2,8,12,20
43884,changes,0,0,20,20
3949,systems,2,1,19,20
1030,registrati,1,20,0,20
47612,palavras,0,0,20,20
12879,είσαι,0,0,20,20
13632,algorithm,0,0,20,20
35496,tudo,0,0,20,20
40601,projets,0,0,20,20
15649,skal,0,0,20,20
32757,estado,0,0,20,20
24021,features,0,0,20,20
42635,automático,0,0,20,20
2054,bellezza,1,20,0,20
5230,interesse,2,15,5,20
1449,quelli,1,20,0,20
7264,politiche,1,20,0,20
3228,scritto,1,20,0,20
43553,व्यक्ति,0,0,20,20
39831,यदि,0,0,20,20
8767,consenso,2,9,10,19
32952,время,0,0,19,19
9377,filosofia,2,17,2,19
23474,obtuse,0,0,19,19
37310,mor,0,0,19,19
23580,tiempo,0,0,19,19
2825,rappresentazione,1,19,0,19
1185,scientifiche,1,19,0,19
39914,nogle,0,0,19,19
33222,based,0,0,19,19
6013,giugno,1,19,0,19
7174,luglio,1,19,0,19
4998,facendo,1,19,0,19
3271,cluster,2,13,6,19
23646,particular,0,0,19,19
48398,give,0,0,19,19
1626,includono,1,19,0,19
46552,säger,0,0,19,19
6544,globale,2,17,2,19
1353,fin,2,5,14,19
25195,vie,0,0,19,19
44737,anden,0,0,19,19
38755,similar,0,0,19,19
40355,مع,0,0,19,19
8298,colbert,2,6,13,19
42942,означает,0,0,19,19
5742,tuoi,1,19,0,19
25363,её,0,0,19,19
7806,qualche,1,19,0,19
52255,этом,0,0,19,19
18485,όταν,0,0,19,19
25258,எப்படி,0,0,19,19
2195,guida,1,19,0,19
14559,ligne,0,0,19,19
28012,comunidade,0,0,19,19
7406,mangiare,1,19,0,19
33024,நன்றி,0,0,19,19
33021,artikel,0,0,19,19
47340,different,0,0,19,19
37559,பற்றி,0,0,19,19
34980,meu,0,0,19,19
8458,primi,1,19,0,19
27331,cela,0,0,19,19
23215,nin,0,0,19,19
8141,deep,2,9,10,19
24999,moet,0,0,19,19
47566,पास,0,0,19,19
49922,wir,0,0,19,19
13182,percent,0,0,19,19
43719,شيء,0,0,19,19
26114,hay,0,0,19,19
35548,website,0,0,19,19
13665,संस्करण,0,0,19,19
29194,gör,0,0,19,19
4068,fai,1,19,0,19
49822,गया।,0,0,19,19
2007,tutta,1,19,0,19
35461,certain,0,0,19,19
8953,utilizzati,1,19,0,19
533,parlare,1,19,0,19
17002,peu,0,0,19,19
48167,personas,0,0,19,19
7196,genere,2,16,3,19
16340,naturel,0,0,19,19
50525,ils,0,0,19,19
16,disponibili,1,19,0,19
32357,engelskspråkiga,0,0,19,19
51353,वास्तव,0,0,19,19
6296,español,2,1,18,19
43300,others,0,0,19,19
8920,cita,2,4,15,19
12327,fundación,0,0,19,19
26867,जिसका,0,0,19,19
37065,يعني,0,0,18,18
2576,copyright,2,12,6,18
29501,form,0,0,18,18
47024,चाहते,0,0,18,18
106,distribuzione,1,18,0,18
38595,ಸ್ಮಾರ್ಟ್,0,0,18,18
8501,utilizzando,1,18,0,18
20441,पता,0,0,18,18
9082,narcisse,2,6,12,18
11129,dois,0,0,18,18
1327,chiamato,1,18,0,18
5448,creato,1,18,0,18
21517,editions,0,0,18,18
27359,einer,0,0,18,18
18781,now,0,0,18,18
42280,embora,0,0,18,18
29264,algunos,0,0,18,18
33185,mismo,0,0,18,18
4039,qual,2,11,7,18
6471,email,2,8,10,18
13206,ಆ,0,0,18,18
32288,através,0,0,18,18
30059,могу,0,0,18,18
616,maggio,1,18,0,18
7862,usa,2,7,11,18
30071,सभी,0,0,18,18
45037,år,0,0,18,18
23075,mon,0,0,18,18
7645,tipi,1,18,0,18
31668,gaat,0,0,18,18
37955,contributors,0,0,18,18
6837,scientifica,1,18,0,18
33847,said,0,0,18,18
10011,его,0,0,18,18
42213,although,0,0,18,18
13107,могут,0,0,18,18
15768,sitio,0,0,18,18
42479,എല്ലാ,0,0,18,18
36276,size,0,0,18,18
33880,vilket,0,0,18,18
9933,σαν,0,0,18,18
8440,possibile,1,18,0,18
27594,antes,0,0,18,18
11843,جدًا,0,0,18,18
5464,figlia,1,18,0,18
5876,review,2,4,14,18
51082,u,0,0,18,18
13716,since,0,0,18,18
1939,significato,1,18,0,18
5727,esperienza,1,18,0,18
3321,abbia,1,18,0,18
18062,ihnen,0,0,18,18
36490,يجب,0,0,18,18
4677,cool,2,1,17,18
38206,wordt,0,0,18,18
46040,गए,0,0,18,18
41352,bruge,0,0,18,18
48815,large,0,0,18,18
37448,они,0,0,18,18
22348,आपने,0,0,18,18
9280,pochi,1,18,0,18
36963,उन,0,0,18,18
51210,take,0,0,18,18
3119,fornisce,1,18,0,18
4967,ragazzi,1,18,0,18
41445,art,0,0,18,18
1249,soave,1,18,0,18
5705,chi,1,18,0,18
41124,millions,0,0,18,18
15207,manier,0,0,18,18
45316,pays,0,0,18,18
5338,prossima,1,18,0,18
25908,ктото,0,0,18,18
27688,arbejde,0,0,18,18
37419,поэтому,0,0,18,18
28969,pelo,0,0,18,18
9568,usando,2,10,8,18
44475,حقًا,0,0,18,18
38124,ensemble,0,0,18,18
5892,miei,1,18,0,18
2398,umano,1,18,0,18
46255,trabajo,0,0,18,18
48753,façon,0,0,18,18
32705,அந்த,0,0,18,18
32514,original,0,0,18,18
20824,où,0,0,18,18
48442,without,0,0,18,18
15148,let,0,0,18,18
37018,fois,0,0,18,18
2722,status,2,10,8,18
11465,нет,0,0,18,18
26424,livre,0,0,18,18
4027,amministratori,1,18,0,18
14899,im,0,0,18,18
39629,bent,0,0,18,18
37743,estão,0,0,17,17
8965,wikipediaorg,2,6,11,17
19585,kunne,0,0,17,17
31663,vandalism,0,0,17,17
9002,gentile,1,17,0,17
35917,akıllı,0,0,17,17
15740,ja,0,0,17,17
42904,ευχαριστώ,0,0,17,17
33456,κάνει,0,0,17,17
2442,mezzo,1,17,0,17
8329,acuto,1,17,0,17
6803,scienza,1,17,0,17
8962,concetto,1,17,0,17
15028,बाद,0,0,17,17
2242,modificare,1,17,0,17
3879,mancanza,1,17,0,17
3854,joseph,2,5,12,17
8297,aprile,1,17,0,17
7964,lavorare,1,17,0,17
51220,flera,0,0,17,17
18532,différentes,0,0,17,17
6938,certo,2,16,1,17
25959,न,0,0,17,17
14751,எனக்கு,0,0,17,17
17074,சொல்லலாம்,0,0,17,17
33802,vet,0,0,17,17
38489,τώρα,0,0,17,17
471,news,2,2,15,17
9311,autori,1,17,0,17
42698,various,0,0,17,17
3659,pubblico,1,17,0,17
19800,lad,0,0,17,17
25842,hej,0,0,17,17
7085,totale,1,17,0,17
3794,pena,2,9,8,17
43099,models,0,0,17,17
49235,നന്ദി,0,0,17,17
35683,ocean,0,0,17,17
7072,webby,2,7,10,17
33134,इसलिए,0,0,17,17
42307,ஸ்மார்ட்,0,0,17,17
3804,condizioni,1,17,0,17
44090,लेखों,0,0,17,17
614,solito,1,17,0,17
18558,comunidad,0,0,17,17
15977,mucho,0,0,17,17
9525,funzione,1,17,0,17
627,social,2,6,11,17
45650,tak,0,0,17,17
483,avuto,1,17,0,17
7761,organizzazione,1,17,0,17
27334,சொல்,0,0,17,17
3513,maggiore,1,17,0,17
31573,plusieurs,0,0,17,17
9081,esse,2,7,10,17
8870,appuntamento,1,17,0,17
34869,என்பது,0,0,17,17
8565,networks,2,2,15,17
16091,только,0,0,17,17
26450,woorden,0,0,17,17
30278,есть,0,0,17,17
90,contro,1,17,0,17
15038,políticas,0,0,17,17
40821,vida,0,0,17,17
23242,كلمة,0,0,17,17
10360,igen,0,0,17,17
22997,इसका,0,0,17,17
20308,however,0,0,17,17
22142,cualquier,0,0,17,17
5217,dia,2,3,14,17
13731,flummoxed,0,0,17,17
1699,proprietà,1,17,0,17
39504,väldigt,0,0,17,17
38974,million,0,0,17,17
50835,já,0,0,17,17
34223,tid,0,0,17,17
17503,sedan,0,0,17,17
23656,biraz,0,0,17,17
21379,idiomas,0,0,17,17
3026,riviste,1,17,0,17
29774,material,0,0,17,17
36122,mãe,0,0,17,17
1267,tedesco,1,17,0,17
6081,dicendo,1,17,0,17
51527,அவர்,0,0,17,17
1199,cerca,2,6,11,17
2921,michael,2,7,10,17
47376,datos,0,0,17,17
5467,utilizza,1,17,0,17
22195,några,0,0,17,17
35051,echt,0,0,17,17
1108,neutrale,1,17,0,17
37022,those,0,0,17,17
12870,يتم,0,0,17,17
4629,definizione,1,17,0,17
2913,comuni,1,17,0,17
10169,agora,0,0,17,17
21154,eram,0,0,17,17
4560,android,2,9,8,17
6198,ricerche,1,17,0,17
14292,among,0,0,17,17
9962,bunu,0,0,17,17
4861,ip,2,8,9,17
51373,worden,0,0,17,17
6264,materiale,2,16,1,17
12733,över,0,0,17,17
31045,सबसे,0,0,17,17
5084,contributi,1,17,0,17
5514,lungo,1,17,0,17
50695,during,0,0,17,17
31155,λέξεις,0,0,17,17
32244,ನಿಮ್ಮನ್ನು,0,0,17,17
47022,मैंने,0,0,17,17
46997,job,0,0,17,17
1345,artificiali,1,17,0,17
31030,இருக்கிறேன்,0,0,17,17
36237,många,0,0,17,17
40408,existe,0,0,17,17
11705,pessoa,0,0,17,17
5853,lavori,1,17,0,17
13088,स्मार्ट,0,0,17,17
12549,vers,0,0,17,17
1612,sicuro,1,17,0,17
2886,uomini,1,17,0,17
6226,mondiale,2,14,3,17
10707,lors,0,0,17,17
9874,same,0,0,17,17
6349,classe,2,14,3,17
50389,ಎಂದರೆ,0,0,17,17
22521,fick,0,0,16,16
20728,zin,0,0,16,16
46929,há,0,0,16,16
4097,noto,1,16,0,16
2610,né,2,15,1,16
11967,പക്ഷേ,0,0,16,16
47036,آسف,0,0,16,16
51335,என்னை,0,0,16,16
33153,texto,0,0,16,16
7149,programmazione,1,16,0,16
17679,ahora,0,0,16,16
13675,पहले,0,0,16,16
10916,right,0,0,16,16
10865,ir,0,0,16,16
12651,ನಾವು,0,0,16,16
34721,वाले,0,0,16,16
17829,mest,0,0,16,16
41141,système,0,0,16,16
51934,όπως,0,0,16,16
10830,partie,0,0,16,16
26087,ഏറ്റവും,0,0,16,16
28370,space,0,0,16,16
44004,غير,0,0,16,16
5397,pronuncia,2,15,1,16
34361,heel,0,0,16,16
9152,possibilità,1,16,0,16
38346,certains,0,0,16,16
1555,arte,2,14,2,16
4797,utente,1,16,0,16
2235,leggi,1,16,0,16
39750,making,0,0,16,16
16164,got,0,0,16,16
1385,ml,2,8,8,16
51881,मुफ्त,0,0,16,16
47474,uns,0,0,16,16
3278,importanti,1,16,0,16
7317,necessario,1,16,0,16
130,sarà,1,16,0,16
4997,crescita,1,16,0,16
51134,еще,0,0,16,16
11415,γιατί,0,0,16,16
47731,முடியும்,0,0,16,16
44013,может,0,0,16,16
50302,wäre,0,0,16,16
8413,quantità,1,16,0,16
6112,magazine,2,4,12,16
30577,अब,0,0,16,16
3959,accuratezza,1,16,0,16
23449,erg,0,0,16,16
65,simili,1,16,0,16
49354,того,0,0,16,16
5888,fu,1,16,0,16
42859,σου,0,0,16,16
942,prestazioni,1,16,0,16
47523,species,0,0,16,16
41,legge,1,16,0,16
37833,οπότε,0,0,16,16
1284,mese,1,16,0,16
5750,principale,1,16,0,16
8750,decisioni,1,16,0,16
7239,avanti,1,16,0,16
47976,себя,0,0,16,16
17515,tack,0,0,16,16
49825,january,0,0,16,16
8903,gioco,1,16,0,16
30200,otro,0,0,16,16
38304,wil,0,0,16,16
33362,contributeurs,0,0,16,16
23894,நன்றாக,0,0,16,16
23873,puis,0,0,16,16
15695,العمل,0,0,16,16
15123,όχι,0,0,16,16
28289,değil,0,0,16,16
52562,ഇപ്പോൾ,0,0,16,16
3711,comune,1,16,0,16
1264,motivo,2,11,5,16
29041,mellan,0,0,16,16
18160,ಹೇಗೆ,0,0,16,16
28764,ചില,0,0,16,16
8793,disponibile,1,16,0,16
8777,controversie,1,16,0,16
46422,ആരെങ്കിലും,0,0,16,16
22020,stupendous,0,0,16,16
46673,låt,0,0,16,16
46085,artikeln,0,0,16,16
52379,eftersom,0,0,16,16
20565,ऐसा,0,0,16,16
48969,obtuso,0,0,16,16
33342,bij,0,0,16,16
4295,errore,1,16,0,16
25785,शामिल,0,0,16,16
10320,end,0,0,16,16
6546,ga,2,1,15,16
22200,மீண்டும்,0,0,16,16
7766,sommerso,1,16,0,16
9585, milioni,1,16,0,16
45766,nach,0,0,16,16
1888,categoria,2,14,2,16
48878,antal,0,0,16,16
37198,god,0,0,16,16
30505,बार,0,0,16,16
47013,chaque,0,0,16,16
570,clima,1,16,0,16
6618,tema,2,8,8,16
9375,continua,1,16,0,16
30670,πρέπει,0,0,16,16
10289,μπορώ,0,0,16,16
25646,hvordan,0,0,16,16
4534,stava,1,16,0,16
617,macchine,1,16,0,16
4374,area,2,8,8,16
2679,applicazioni,1,16,0,16
45642,ഇംഗ്ലീഷ്,0,0,16,16
12833,då,0,0,16,16
9410,italiano,2,11,5,16
85,propria,1,16,0,16
49484,ici,0,0,16,16
28124,conception,0,0,16,16
35220,എങ്ങനെ,0,0,16,16
5569,network,2,5,11,16
48490,होता,0,0,16,16
2376,pubblicata,1,16,0,16
37279,समय,0,0,16,16
20443,bijvoorbeeld,0,0,16,16
3442,resto,2,10,6,16
2747,critiche,1,16,0,16
6339,vedi,1,16,0,16
7879,tecniche,1,16,0,16
29836,além,0,0,16,16
12039,ut,0,0,16,16
30025,их,0,0,16,16
14837,έχει,0,0,16,16
2847,vedere,1,16,0,16
29175,വിക്കിപീഡിയർ,0,0,16,16
27728,according,0,0,16,16
7023,preso,2,14,2,16
1174,stupendo,1,16,0,16
7421,economia,2,12,3,15
8344,bella,1,15,0,15
11736,ನನ್ನನ್ನು,0,0,15,15
14601,hvor,0,0,15,15
51594,ലേഖനങ്ങൾ,0,0,15,15
6024,principio,2,14,1,15
6854,php,2,4,11,15
13451,hacer,0,0,15,15
664,whatsapp,2,3,12,15
32393,सब,0,0,15,15
7831,supporto,1,15,0,15
34143,موسوعة,0,0,15,15
33397,start,0,0,15,15
6679,conversazione,1,15,0,15
41266,vamos,0,0,15,15
8489,next,2,1,14,15
34736,portal,0,0,15,15
3024,cinque,1,15,0,15
6886,traffico,1,15,0,15
52647,política,0,0,15,15
2325,infatti,1,15,0,15
6562,lentamente,2,13,2,15
16914,zoals,0,0,15,15
23006,अर्थ,0,0,15,15
30532,sometimes,0,0,15,15
32083,qualité,0,0,15,15
23750,pouco,0,0,15,15
661,sciences,2,2,13,15
7431,weekend,2,2,13,15
7224,verso,1,15,0,15
31447,forms,0,0,15,15
28652,tasks,0,0,15,15
52527,الآن,0,0,15,15
51138,artikler,0,0,15,15
6608,sé,2,8,7,15
7722,teoria,1,15,0,15
20049,كما,0,0,15,15
430,materia,2,14,1,15
33683,होती,0,0,15,15
30277,désolé,0,0,15,15
3971,spagnolo,1,15,0,15
23366,before,0,0,15,15
35514,ella,0,0,15,15
42892,ένας,0,0,15,15
33367,tell,0,0,15,15
2410,preoccuparti,1,15,0,15
23393,janeiro,0,0,15,15
44905,había,0,0,15,15
648,continue,2,1,14,15
50005,estados,0,0,15,15
35576,måste,0,0,15,15
20144,modifications,0,0,15,15
27107,januari,0,0,15,15
8729,raccolta,1,15,0,15
7319,gruppo,1,15,0,15
9974,ter,0,0,15,15
9682,அவர்கள்,0,0,15,15
31479,morgen,0,0,15,15
23607,todas,0,0,15,15
40102,learn,0,0,15,15
8432,narcissus,2,1,14,15
9557,oceano,1,15,0,15
26316,omdat,0,0,15,15
4970,settimana,1,15,0,15
28562,bana,0,0,15,15
20214,μπορείς,0,0,15,15
5509,dizionario,1,15,0,15
51603,keine,0,0,15,15
27296,gracias,0,0,15,15
30258,ಮಾಡಲು,0,0,15,15
5628,informatica,2,14,1,15
29491,العديد,0,0,15,15
5366,propri,1,15,0,15
41091,mindre,0,0,15,15
33950,peux,0,0,15,15
36885,favor,0,0,15,15
2838,gmat,2,3,12,15
2421,scrittura,1,15,0,15
4816,microsoft,2,6,9,15
38505,слова,0,0,15,15
41659,ಏನು,0,0,15,15
6962,funzionalità,1,15,0,15
2608,io,1,15,0,15
5247,programmi,1,15,0,15
7128,categorie,2,14,1,15
2350,digitale,2,12,3,15
12965,ಧನ್ಯವಾದಗಳು,0,0,15,15
22909,considered,0,0,15,15
28403,वाक्यांश,0,0,15,15
16242,utilisé,0,0,15,15
7142,ultimi,1,15,0,15
52292,माँ,0,0,15,15
4631,riconoscimento,1,15,0,15
6219,quattro,1,15,0,15
17101,mars,0,0,15,15
2893,contesto,1,15,0,15
24499,avoir,0,0,15,15
27044,procent,0,0,15,15
6297,extra,2,3,12,15
46942,einem,0,0,15,15
8215,tedesca,1,15,0,15
7062,chiamati,1,15,0,15
8212,confuso,2,9,6,15
49891,रही,0,0,15,15
46133,administradores,0,0,15,15
11984,केवल,0,0,15,15
773,aperto,1,15,0,15
4772,dimensione,1,15,0,15
46136,maintenant,0,0,15,15
38432,wilt,0,0,15,15
4795,regressione,1,15,0,15
22903,frases,0,0,15,15
43066,википедию,0,0,15,15
7108,usano,1,15,0,15
4808,gratuita,2,10,5,15
8145,fornire,1,15,0,15
5426,probabilità,1,15,0,15
15923,இப்போது,0,0,15,15
47232,जिसे,0,0,15,15
13654,statistical,0,0,15,15
3384,sviluppato,1,15,0,15
10200,conditions,0,0,15,15
37809,इसकी,0,0,15,15
4606,notizie,1,15,0,15
44887,använder,0,0,15,15
8133,palo,2,6,9,15
19940,phrases,0,0,15,15
4597,piante,1,15,0,15
11082,कैसे,0,0,15,15
17617,हम,0,0,15,15
5126,marzo,2,13,2,15
7948,ottobre,1,15,0,15
4866,segreto,1,15,0,15
2225,dispositivi,1,15,0,15
215,risposta,1,15,0,15
49188,andre,0,0,15,15
40343,ಅದ್ಭುತ,0,0,15,15
8029,relativamente,2,13,2,15
5114,aumento,2,12,3,15
43,tecnologia,2,14,1,15
13681,αυτή,0,0,15,15
16369,üzgünüm,0,0,15,15
3383,elemento,2,10,5,15
25736,supervised,0,0,15,15
37579,objet,0,0,14,14
17468,قد,0,0,14,14
2452,harvard,2,5,9,14
12757,ഓ,0,0,14,14
3247,energia,2,13,1,14
7824,viventi,1,14,0,14
12970,editorial,0,0,14,14
30541,annan,0,0,14,14
7610,lucro,2,10,4,14
16207,tenho,0,0,14,14
26621,analysis,0,0,14,14
8441,stessi,1,14,0,14
2290,spiega,1,14,0,14
5734,watch,2,2,12,14
47212,hvilket,0,0,14,14
42987,शब्दों,0,0,14,14
11995,small,0,0,14,14
8258,offre,2,10,4,14
33606,geweldig,0,0,14,14
5120,possa,2,10,4,14
255,heller,2,3,11,14
7505,collaborazione,1,14,0,14
5592,cioè,1,14,0,14
52664,notion,0,0,14,14
21941,θέλετε,0,0,14,14
40982,stated,0,0,14,14
13071,toda,0,0,14,14
8263,universo,1,14,0,14
44018,diesem,0,0,14,14
12967,sonra,0,0,14,14
7588,seigenthaler,2,7,7,14
8092,editoriale,1,14,0,14
3049,carrozza,1,14,0,14
18653,sujet,0,0,14,14
49445,jetzt,0,0,14,14
5618,nuove,1,14,0,14
3791,previsioni,1,14,0,14
8414,evoluzione,1,14,0,14
37856,estudo,0,0,14,14
46641,विकी,0,0,14,14
43172,അവർ,0,0,14,14
47433,encyclopedias,0,0,14,14
41236,total,0,0,14,14
33298,fra,0,0,14,14
26744,global,0,0,14,14
25662,gelir,0,0,14,14
17893,bist,0,0,14,14
16458,संस्थान,0,0,14,14
43945,न्यूपीडिया,0,0,14,14
1633,novembre,2,11,3,14
36060,grandes,0,0,14,14
4668,decisione,1,14,0,14
41851,undskyld,0,0,14,14
50104,veel,0,0,14,14
24705,كيف,0,0,14,14
10438,essen,0,0,14,14
30033,ta,0,0,14,14
43747,daar,0,0,14,14
40869,muitas,0,0,14,14
774,ecc,1,14,0,14
7020,temo,2,9,5,14
13958,முடியாது,0,0,14,14
49039,мы,0,0,14,14
25893,make,0,0,14,14
14858,δουλειά,0,0,14,14
1586,international,2,3,11,14
42408,siento,0,0,14,14
1574,conseguenza,1,14,0,14
41720,zit,0,0,14,14
24432,satz,0,0,14,14
1955,raggiunto,1,14,0,14
6209,rna,2,3,11,14
36881,projetos,0,0,14,14
1525,rapporto,1,14,0,14
30107,last,0,0,14,14
6193,fair,2,6,8,14
2915,misura,1,14,0,14
7871,toefl,2,3,11,14
29971,temas,0,0,14,14
38539,outras,0,0,14,14
4407,buon,2,13,1,14
9737,embargo,0,0,14,14
9745,κάποιον,0,0,14,14
37157,popular,0,0,14,14
29829,estupendo,0,0,14,14
15969,أنك,0,0,14,14
4436,esperti,1,14,0,14
35003,animals,0,0,14,14
48862,என்ற,0,0,14,14
17658,statistics,0,0,14,14
4458,consiglio,1,14,0,14
682,facile,2,12,2,14
78,favore,1,14,0,14
27838,لذا,0,0,14,14
34442,allt,0,0,14,14
33106,oss,0,0,14,14
38612,ingen,0,0,14,14
45838,¿qué,0,0,14,14
14321,air,0,0,14,14
29892,types,0,0,14,14
14632,மற்றொரு,0,0,14,14
4544,migliori,1,14,0,14
39017,når,0,0,14,14
3160,care,2,1,13,14
36012,देते,0,0,14,14
6501,performance,2,4,10,14
4353,pensare,1,14,0,14
6459,nuova,1,14,0,14
10234,possible,0,0,14,14
32897,zaman,0,0,14,14
24147,யாராவது,0,0,14,14
6002,andrew,2,6,8,14
2975,presenti,1,14,0,14
5995,aperta,1,14,0,14
33478,biases,0,0,14,14
46502,χρησιμοποιήσετε,0,0,14,14
3574,atti,1,14,0,14
35150,किये,0,0,14,14
26372,ಈಗ,0,0,14,14
16663,feature,0,0,14,14
23529,ihre,0,0,14,14
5442,piccola,1,14,0,14
45163,point,0,0,14,14
5011,richiede,1,14,0,14
51501,página,0,0,14,14
27099,hakkında,0,0,14,14
36729,edits,0,0,14,14
21483,ويكيبيديا،,0,0,14,14
23342,मतलब,0,0,14,14
2133,july,2,1,13,14
34875,pueden,0,0,14,14
3590,principi,1,14,0,14
34871,måde,0,0,14,14
15471,ماذا,0,0,14,14
47600,type,0,0,14,14
41273,common,0,0,14,14
7425,approcci,1,14,0,14
29203,немного,0,0,14,14
5060,attivi,1,14,0,14
40941,pesquisa,0,0,14,14
3923,terrestre,2,13,1,14
11674,अच्छी,0,0,14,14
30809,رقم,0,0,14,14
22531,تكون,0,0,14,14
22399,أنني,0,0,14,14
8904,ipotesi,1,14,0,14
47072,problems,0,0,14,14
8888,parti,2,11,3,14
865,ufficiale,1,14,0,14
31679,después,0,0,14,14
38298,après,0,0,14,14
7205,september,2,1,13,14
41528,hecho,0,0,14,14
7208,punti,1,14,0,14
21064,algumas,0,0,14,14
7983,quest,2,13,1,14
49198,же,0,0,14,14
47892,puedo,0,0,14,14
21217,மன்னிக்கவும்,0,0,14,14
15079,sí,0,0,14,14
26221,linguistiques,0,0,14,14
17408,ओह,0,0,14,14
21026,devam,0,0,14,14
21265,εδώ,0,0,14,14
42636,helt,0,0,14,14
49225,dar,0,0,14,14
23684,ಸಾಧ್ಯವಿಲ್ಲ,0,0,14,14
36783,here,0,0,14,14
16049,более,0,0,14,14
18290,onde,0,0,14,14
16185,ಕ್ಷಮಿಸಿ,0,0,14,14
49167,help,0,0,14,14
44047,sætning,0,0,13,13
7805,inizio,1,13,0,13
3673,informazione,1,13,0,13
29030,ചെയ്യാൻ,0,0,13,13
29066,दो,0,0,13,13
30931,tarde,0,0,13,13
4449,melli,2,3,10,13
3777,studi,1,13,0,13
5498,milione,1,13,0,13
4244,report,2,2,11,13
30026,given,0,0,13,13
30034,active,0,0,13,13
36938,parce,0,0,13,13
4711,visione,1,13,0,13
33486,auch,0,0,13,13
3346,france,2,2,11,13
2903,long,2,1,12,13
4146,centro,2,9,4,13
6171,funzioni,1,13,0,13
2596,prix,2,2,11,13
2916,everything,2,1,12,13
49840,dieses,0,0,13,13
2587,quell,1,13,0,13
6130,stanco,1,13,0,13
36994,इन,0,0,13,13
2664,basata,1,13,0,13
30730,diğer,0,0,13,13
6607,messaggio,1,13,0,13
6713,risultato,1,13,0,13
4441,pigro,1,13,0,13
6766,wikidata,2,3,10,13
6689,seria,2,4,9,13
50915,άλλο,0,0,13,13
4478,ottimizzazione,1,13,0,13
16769,हूं।,0,0,13,13
36042,amis,0,0,13,13
6895,stop,2,1,12,13
2807,copertura,1,13,0,13
17666,siger,0,0,13,13
29909,less,0,0,13,13
6454,niente,1,13,0,13
2672,atmosfera,1,13,0,13
4084,mano,2,11,2,13
2580,policy,2,2,11,13
4877,giapponese,1,13,0,13
17784,எனக்குத்,0,0,13,13
3034,street,2,6,7,13
5805,crescente,2,11,2,13
29352,ли,0,0,13,13
36637,også,0,0,13,13
3235,pain,2,1,12,13
28786,upp,0,0,13,13
31536,ledsen,0,0,13,13
27339,eğer,0,0,13,13
35599,فقط,0,0,13,13
52661,därför,0,0,13,13
2435,linux,2,4,9,13
44021,informatie,0,0,13,13
5216,considera,2,8,5,13
30962,который,0,0,13,13
28658,wird,0,0,13,13
3599,libertà,1,13,0,13
4894,pattern,2,8,5,13
37450,food,0,0,13,13
28471,melhor,0,0,13,13
3295,potresti,1,13,0,13
7210,poche,1,13,0,13
7220,citato,1,13,0,13
6071,editore,1,13,0,13
4005,li,2,11,2,13
36753,maneira,0,0,13,13
5064,differenza,1,13,0,13
2527,permette,1,13,0,13
28579,όλα,0,0,13,13
17761,numéro,0,0,13,13
5925,ragazzo,1,13,0,13
35305,källor,0,0,13,13
35634,ಸ್ವಲ್ಪ,0,0,13,13
2963,continuare,1,13,0,13
38365,modelo,0,0,13,13
838,gratuiti,1,13,0,13
32759,venner,0,0,13,13
46020,están,0,0,13,13
8926,modi,1,13,0,13
49160,نيوبيديا,0,0,13,13
523,dictionary,2,1,12,13
8914,certa,2,9,4,13
8467,contrario,2,11,2,13
49161,merci,0,0,13,13
24961,licence,0,0,13,13
9512,pulsante,1,13,0,13
40452,matter,0,0,13,13
14095,registrados,0,0,13,13
32170,inteligentes,0,0,13,13
45531,sana,0,0,13,13
2027,consente,1,13,0,13
21717,december,0,0,13,13
8521,influenza,1,13,0,13
8439,negative,2,3,10,13
41840,eten,0,0,13,13
23008,vänner,0,0,13,13
2185,esso,1,13,0,13
9362,documentation,2,1,12,13
47537,nasıl,0,0,13,13
24727,τις,0,0,13,13
10364,próxima,0,0,13,13
918,chiamata,1,13,0,13
32793,personne,0,0,13,13
42610,última,0,0,13,13
1645,ciao,1,13,0,13
41026,method,0,0,13,13
17886,largest,0,0,13,13
19399,important,0,0,13,13
33775,friends,0,0,13,13
1654,file,2,11,2,13
768,comportamento,2,12,1,13
42508,vídeo,0,0,13,13
9507,ordine,1,13,0,13
51848,чем,0,0,13,13
25771,مقالة,0,0,13,13
48791,alt,0,0,13,13
20132,day,0,0,13,13
20139,संख्या,0,0,13,13
45747,информации,0,0,13,13
20282,unsupervised,0,0,13,13
669,discussione,1,13,0,13
20186,بالإنجليزية,0,0,13,13
22233,disso,0,0,13,13
48801,സ്മാർട്ട്,0,0,13,13
34174,об,0,0,13,13
8756,libri,1,13,0,13
38183,exempelvis,0,0,13,13
31879,pão,0,0,13,13
1054,comunque,1,13,0,13
12850,informations,0,0,13,13
1052,palude,1,13,0,13
2081,trovare,1,13,0,13
1097,medio,2,5,8,13
1797,aree,1,13,0,13
14276,bazı,0,0,13,13
9790,ψωμί,0,0,13,13
32752,vidéo,0,0,13,13
12234,estas,0,0,13,13
9209,rilevamento,1,13,0,13
32744,voulez,0,0,13,13
45596,major,0,0,13,13
14678,tellement,0,0,13,13
25191,decision,0,0,13,13
47172,vários,0,0,13,13
20450,riktigt,0,0,13,13
21801,techniques,0,0,13,13
43251,lite,0,0,13,13
34153,redigeringar,0,0,13,13
22436,moeder,0,0,13,13
41055,द,0,0,13,13
45888,comer,0,0,13,13
39193,लाइसेंस,0,0,13,13
14024,preocupe,0,0,13,13
13936,بين,0,0,13,13
375,washington,2,5,8,13
9190,utilizzo,1,13,0,13
18156,pan,0,0,13,13
32371,tarafından,0,0,13,13
25843,حتى,0,0,13,13
48288,varios,0,0,13,13
11195,agudo,0,0,13,13
18657,tüm,0,0,13,13
41748,bread,0,0,13,13
1396,oxford,2,5,8,13
46134,brood,0,0,13,13
25864,gaan,0,0,13,13
307,matematica,1,13,0,13
15721,svenskspråkiga,0,0,13,13
39398,कार्य,0,0,13,13
15409,ಅನ್ನು,0,0,13,13
23778,حول,0,0,13,13
8057,facilmente,2,11,2,13
1420,link,2,6,7,13
24375,bunun,0,0,13,13
46376,über,0,0,13,13
311,estremamente,1,13,0,13
23690,comida,0,0,13,13
41694,bom,0,0,13,13
43035,biri,0,0,13,13
37831,mère,0,0,13,13
17865,servidores,0,0,13,13
7945,stavi,1,13,0,13
25926,olan,0,0,13,13
10714,الكلمة,0,0,13,13
47712,എന്താണ്,0,0,13,13
1381,dollari,1,13,0,13
39976,ihr,0,0,13,13
10832,номер,0,0,13,13
2227,post,2,6,7,13
15966,rather,0,0,13,13
48080,எனது,0,0,13,13
404,wikipediani,1,13,0,13
32223,dizendo,0,0,13,13
2233,mal,2,1,12,13
38458,access,0,0,13,13
11635,terme,0,0,13,13
26075,παράδειγμα,0,0,13,13
8247,compito,1,13,0,13
44587,quieres,0,0,13,13
45084,обучения,0,0,13,13
43324,misin,0,0,13,13
48335,unidos,0,0,13,13
13347,versión,0,0,13,13
1917,imparare,1,13,0,13
18115,sendo,0,0,13,13
48373,dock,0,0,13,13
7853,robot,2,8,5,13
10443,think,0,0,13,13
23935,gold,0,0,13,13
47673,يناير,0,0,13,13
1365,prodotto,1,13,0,13
8219,capire,1,13,0,13
50638,спасибо,0,0,12,12
5200,dirlo,1,12,0,12
21861,vinkel,0,0,12,12
9215,ricevuto,1,12,0,12
1788,barack,2,3,9,12
7021,associazione,1,12,0,12
34500,കഴിയില്ല,0,0,12,12
21870,समुदाय,0,0,12,12
868,nozione,1,12,0,12
13577,moi,0,0,12,12
41040,مقالات,0,0,12,12
1824,tretikov,2,6,6,12
10933,നിങ്ങളോട്,0,0,12,12
37236,encontro,0,0,12,12
31378,güzel,0,0,12,12
46507,souvent,0,0,12,12
9406,economist,2,2,10,12
13176,جيدًا,0,0,12,12
1847,note,2,8,4,12
13166,другие,0,0,12,12
34000,cas,0,0,12,12
13412,sob,0,0,12,12
5072,today,2,2,10,12
35320,development,0,0,12,12
206,cambiamenti,1,12,0,12
41431,great,0,0,12,12
13030,twee,0,0,12,12
9573,paese,1,12,0,12
29331,sehen,0,0,12,12
9285,autore,1,12,0,12
3298,darò,1,12,0,12
49932,harika,0,0,12,12
9256,attivo,1,12,0,12
9247,technology,2,1,11,12
9538,lih,2,6,6,12
25606,avait,0,0,12,12
21156,നിന്ന്,0,0,12,12
44193,edición,0,0,12,12
48884,उपलब्ध,0,0,12,12
43727,потому,0,0,12,12
6776,migliore,1,12,0,12
259,lenta,2,5,7,12
12824,dies,0,0,12,12
5836,cache,2,4,8,12
39990,beaucoup,0,0,12,12
1358,visitatori,1,12,0,12
47636,أيضًا,0,0,12,12
23339,നമ്പർ,0,0,12,12
11595,تعني,0,0,12,12
6381,ellie,2,3,9,12
1318,pranzo,1,12,0,12
40184,proyectos,0,0,12,12
28170,leurs,0,0,12,12
39319,normal,0,0,12,12
37013,ചെയ്യുന്നു,0,0,12,12
1305,basati,1,12,0,12
10309,règles,0,0,12,12
16258,उन्हें,0,0,12,12
39117,mejor,0,0,12,12
48487,ραντεβού,0,0,12,12
10227,fut,0,0,12,12
40274,видео,0,0,12,12
28587,gjort,0,0,12,12
10579,सॉफ्टवेयर,0,0,12,12
40980,français,0,0,12,12
1549,quality,2,1,11,12
47988,zorgen,0,0,12,12
39722,discussão,0,0,12,12
6094,https,2,6,6,12
23798,عبارة,0,0,12,12
11230,dieser,0,0,12,12
11248,obtus,0,0,12,12
50270,kind,0,0,12,12
68,best,2,1,11,12
48203,जाने,0,0,12,12
39941,पृष्ठ,0,0,12,12
6232,minuti,1,12,0,12
11305,varit,0,0,12,12
6244,ragione,1,12,0,12
23639,എന്നാൽ,0,0,12,12
6000,must,2,1,11,12
31076,contributions,0,0,12,12
2878,laghi,1,12,0,12
18194,informações,0,0,12,12
47432,شيئًا,0,0,12,12
32512,теперь,0,0,12,12
3059,livelli,1,12,0,12
40768,manière,0,0,12,12
12307,mother,0,0,12,12
6648,confronto,1,12,0,12
25240,haciendo,0,0,12,12
5460,organismi,1,12,0,12
52243,தெரியும்,0,0,12,12
3144,dice,2,10,2,12
32641,milhões,0,0,12,12
12477,dollars,0,0,12,12
40780,real,0,0,12,12
22953,действительно,0,0,12,12
22262,thank,0,0,12,12
31269,хотите,0,0,12,12
40917,വിക്കിപീഡിയയിലെ,0,0,12,12
6733,hg,2,3,9,12
36355,nem,0,0,12,12
6757,rimane,1,12,0,12
5243,domani,1,12,0,12
37176,demander,0,0,12,12
29011,structure,0,0,12,12
9953,stor,0,0,12,12
40569,bidrag,0,0,12,12
22614,history,0,0,12,12
16256,resultado,0,0,12,12
18092,enquanto,0,0,12,12
31225,red,0,0,12,12
168,citizendium,2,4,8,12
50062,देने,0,0,12,12
32539,ile,0,0,12,12
5678,contiene,1,12,0,12
5616,award,2,2,10,12
5571,lucene,2,4,8,12
12130,links,0,0,12,12
22739,βίντεο,0,0,12,12
48612,atrocious,0,0,12,12
40488,जाते,0,0,12,12
6581,cinese,1,12,0,12
25105,score,0,0,12,12
6597,sì,1,12,0,12
25123,விரும்பினால்,0,0,12,12
50485,havde,0,0,12,12
39563,created,0,0,12,12
29978,trop,0,0,12,12
31850,lakes,0,0,12,12
8187,europa,2,8,4,12
20205,ಓಹ್,0,0,12,12
26338,afin,0,0,12,12
16668,vrienden,0,0,12,12
35407,वीडियो,0,0,12,12
45045,grand,0,0,12,12
16131,final,0,0,12,12
8706,percentuale,1,12,0,12
658,massa,2,9,3,12
3455,logo,2,4,8,12
37643,tidigare,0,0,12,12
14572,grymt,0,0,12,12
37494,veces,0,0,12,12
15572,concept,0,0,12,12
51140,modèle,0,0,12,12
3618,diritto,1,12,0,12
42957,algoritmos,0,0,12,12
42058,saying,0,0,12,12
26249,hayır,0,0,12,12
20367,gang,0,0,12,12
34617,aus,0,0,12,12
15685,fragen,0,0,12,12
20273,poderia,0,0,12,12
31567,lado,0,0,12,12
38211,energy,0,0,12,12
4487,concezione,1,12,0,12
18863,gehen,0,0,12,12
2547,caratteristica,1,12,0,12
4505,us,2,1,11,12
33525,zum,0,0,12,12
26299,muazzam,0,0,12,12
373,pubblicità,1,12,0,12
3921,elenco,1,12,0,12
17053,muchas,0,0,12,12
7363,afferma,1,12,0,12
30165,angle,0,0,12,12
4020,ampiamente,1,12,0,12
8301,strumento,1,12,0,12
7446,commerciale,2,11,1,12
2206,fortunato,1,12,0,12
42576,hommes,0,0,12,12
45366,phase,0,0,12,12
8493,linee,1,12,0,12
3944,rispondere,1,12,0,12
45454,vais,0,0,12,12
51017,toutes,0,0,12,12
26545,eksempel,0,0,12,12
42466,أفضل,0,0,12,12
7474,pizza,2,3,9,12
2181,proprie,1,12,0,12
49323,tip,0,0,12,12
33595,स्रोत,0,0,12,12
35832,تريد,0,0,12,12
31527,طريقة,0,0,12,12
463,punteggio,1,12,0,12
52483,aquí,0,0,12,12
453,devono,1,12,0,12
4268,eseguire,1,12,0,12
3983,cura,1,12,0,12
19817,έτσι,0,0,12,12
3976,testi,1,12,0,12
26459,berätta,0,0,12,12
588,specifici,1,12,0,12
15374,ನಂತರ,0,0,12,12
3585,processi,1,12,0,12
18393,सर्वर,0,0,12,12
8249,devi,1,12,0,12
14221,होने,0,0,12,12
27113,مما,0,0,12,12
15014,കഴിയുന്ന,0,0,12,12
2315,utilizzata,1,12,0,12
4667,deriva,1,12,0,12
25952,ठीक,0,0,12,12
7154,luogo,1,12,0,12
49589,généralement,0,0,12,12
26106,nom,0,0,12,12
49863,مقال,0,0,12,12
38333,أنت,0,0,12,12
14011,prendre,0,0,12,12
3789,ripeterlo,1,12,0,12
46118,под,0,0,12,12
43086,फिर,0,0,12,12
41764,മികച്ച,0,0,12,12
38391,name,0,0,12,12
9055,ottenere,1,12,0,12
26094,plants,0,0,12,12
15831,climate,0,0,12,12
31907,étaient,0,0,12,12
44520,issues,0,0,12,12
18693,mayor,0,0,12,12
43603,इंटरनेट,0,0,12,12
51231,should,0,0,12,12
3751,statistiche,1,12,0,12
50802,accuracy,0,0,12,12
35352,ll,0,0,12,12
30516,growth,0,0,12,12
4665,guerra,2,7,5,12
4687,sentito,1,12,0,12
34583,though,0,0,12,12
4818,obama,2,3,9,12
723,comscore,2,5,7,12
8812,sociale,2,8,4,12
34596,nada,0,0,12,12
4845,acceso,2,7,5,12
3836,andiamo,1,12,0,12
8064,turing,2,7,5,12
3323,considerato,1,12,0,12
46233,virkelig,0,0,12,12
13747,للغاية,0,0,12,12
44826,الكلمات,0,0,12,12
15840,tun,0,0,12,12
3726,iphone,2,6,6,12
49176,उपयोगकर्ताओं,0,0,12,12
8892,negativo,2,8,4,12
50240,view,0,0,11,11
23940,reference,0,0,11,11
36837,predictions,0,0,11,11
265,cara,2,10,1,11
3969,linguaggio,1,11,0,11
28702,cuenta,0,0,11,11
1273,tasso,1,11,0,11
492,opinioni,1,11,0,11
3030,quotidiana,1,11,0,11
3051,licenze,1,11,0,11
3739,propose,2,2,9,11
30228,இங்கே,0,0,11,11
16834,ولكن,0,0,11,11
23867,حيث,0,0,11,11
296,successivamente,1,11,0,11
468,creata,1,11,0,11
5776,applicazione,1,11,0,11
42613,είστε,0,0,11,11
43416,sabe,0,0,11,11
1310,dita,1,11,0,11
351,conto,1,11,0,11
35472,पूरी,0,0,11,11
190,originariamente,1,11,0,11
28589,nombreuses,0,0,11,11
11293,websites,0,0,11,11
11297,വാക്കുകൾ,0,0,11,11
30410,día,0,0,11,11
11423,şimdi,0,0,11,11
18724,obrigado,0,0,11,11
40333,reste,0,0,11,11
45024,சொல்ல,0,0,11,11
30404,afschuwelijk,0,0,11,11
3821,wall,2,5,6,11
18735,कहा,0,0,11,11
47756,application,0,0,11,11
39936,देख,0,0,11,11
23559,grupo,0,0,11,11
3876,account,2,10,1,11
44953,एवं,0,0,11,11
5992,raggiungere,1,11,0,11
3895,movimento,1,11,0,11
23500,لكن,0,0,11,11
36740,உங்களிடம்,0,0,11,11
35474,φράση,0,0,11,11
34254,detection,0,0,11,11
3780,usemodwiki,2,3,8,11
51493,ni,0,0,11,11
3935,sconcertato,1,11,0,11
33745,πεις,0,0,11,11
18987,ago,0,0,11,11
40084,langues,0,0,11,11
2960,produce,2,4,7,11
15622,καλά,0,0,11,11
31088,stump,0,0,11,11
3788,svedese,1,11,0,11
2965,theory,2,1,10,11
3909,proposta,2,10,1,11
45046,critiques,0,0,11,11
51177,représentation,0,0,11,11
1368,universale,1,11,0,11
28641,communauté,0,0,11,11
36136,medan,0,0,11,11
19565,nein,0,0,11,11
41107,intelligent,0,0,11,11
46010,மேலும்,0,0,11,11
4651,realtà,1,11,0,11
46687,diese,0,0,11,11
14119,class,0,0,11,11
5139,support,2,1,10,11
4625,esistono,1,11,0,11
20508,beispiel,0,0,11,11
21722,depois,0,0,11,11
18333,ഉപയോഗിക്കാൻ,0,0,11,11
20474,dieu,0,0,11,11
41946,μαζί,0,0,11,11
14196,şeyi,0,0,11,11
14987,estudio,0,0,11,11
720,immagine,1,11,0,11
1021,agosto,2,6,5,11
21863,данных,0,0,11,11
4540,usage,2,1,10,11
29770,became,0,0,11,11
12859,எண்,0,0,11,11
45813,did,0,0,11,11
21909,सुस्त,0,0,11,11
20239,cependant,0,0,11,11
4501,domande,1,11,0,11
4499,posizione,1,11,0,11
981,febbraio,1,11,0,11
5048,scoperta,1,11,0,11
29392,ആണ്,0,0,11,11
46565,πραγματικά,0,0,11,11
863,formato,2,7,4,11
4872,campi,1,11,0,11
51349,altın,0,0,11,11
20887,werk,0,0,11,11
4902,portare,1,11,0,11
52385,слов,0,0,11,11
17374,bonne,0,0,11,11
220,multilingue,2,8,3,11
4778,ottieni,1,11,0,11
32854,internal,0,0,11,11
52398,usually,0,0,11,11
4944,scritti,1,11,0,11
21309,perform,0,0,11,11
50720,order,0,0,11,11
50797,instead,0,0,11,11
41344,approach,0,0,11,11
30750,ശരിക്കും,0,0,11,11
46496,semana,0,0,11,11
30811,realizado,0,0,11,11
4728,etc,2,1,10,11
51333,permet,0,0,11,11
13979,dados,0,0,11,11
35312,laten,0,0,11,11
1056,soprattutto,1,11,0,11
46884,tror,0,0,11,11
22061,ಜೌಗು,0,0,11,11
42299,mutter,0,0,11,11
44669,mij,0,0,11,11
844,passare,1,11,0,11
5542,albero,1,11,0,11
42352,aqui,0,0,11,11
43827,யாரோ,0,0,11,11
16871,atmosphere,0,0,11,11
14781,करें,0,0,11,11
30020,around,0,0,11,11
17276,часто,0,0,11,11
45529,pedir,0,0,11,11
12103,création,0,0,11,11
42387,रोटी,0,0,11,11
22846,सामग्री,0,0,11,11
40399,available,0,0,11,11
11996,conversation,0,0,11,11
45500,nombreux,0,0,11,11
19717,வேண்டாம்,0,0,11,11
28808,zal,0,0,11,11
3527,discipline,2,7,4,11
22918,videon,0,0,11,11
5703,nah,2,3,8,11
11940,உங்களை,0,0,11,11
32522,travers,0,0,11,11
19820,plaats,0,0,11,11
40588,várias,0,0,11,11
50598,entanto,0,0,11,11
14677,soit,0,0,11,11
22075,wikipediaartiklar,0,0,11,11
30897,vragen,0,0,11,11
12604,him,0,0,11,11
46971,siempre,0,0,11,11
5319,ia,2,8,3,11
22214,principal,0,0,11,11
4428,chiedi,1,11,0,11
4408,futuro,2,7,4,11
34120,métodos,0,0,11,11
34129,استخدام,0,0,11,11
4405,radice,1,11,0,11
51436,அதாவது,0,0,11,11
635,interazione,1,11,0,11
22349,ccbysa,0,0,11,11
4395,vuole,1,11,0,11
4391,gratuito,2,9,2,11
29878,سبيل,0,0,11,11
4381,diritti,1,11,0,11
47143,فإن,0,0,11,11
19979,samma,0,0,11,11
17057,वेल्स,0,0,11,11
19914,viel,0,0,11,11
22557,layer,0,0,11,11
4898,tradizionali,1,11,0,11
23196,críticas,0,0,11,11
7352,americani,1,11,0,11
34590,querida,0,0,11,11
2794,attualmente,1,11,0,11
27437,هنا,0,0,11,11
2106,mesi,1,11,0,11
6553,materiali,1,11,0,11
1689,strato,1,11,0,11
8670,ampia,1,11,0,11
26343,കൂടുതൽ,0,0,11,11
25056,researchers,0,0,11,11
2539,questione,1,11,0,11
31460,además,0,0,11,11
8730,sbagliato,1,11,0,11
25155,ويلز,0,0,11,11
34892,processus,0,0,11,11
38210,देता,0,0,11,11
2069,affidabilità,1,11,0,11
38918,tres,0,0,11,11
7230,guardian,2,4,7,11
26227,wörter,0,0,11,11
2766,bisogno,1,11,0,11
1684,fondo,2,9,2,11
7358,apprende,1,11,0,11
39038,ditt,0,0,11,11
2486,zone,2,6,5,11
8422,consiste,2,7,4,11
8452,controversia,2,6,5,11
24716,modifier,0,0,11,11
7466,selezione,1,11,0,11
6436,varietà,1,11,0,11
35063,incrível,0,0,11,11
132,popolare,1,11,0,11
10296,ಬಯಸಿದರೆ,0,0,11,11
27348,मदद,0,0,11,11
2800,complessità,1,11,0,11
8527,notte,1,11,0,11
38109,ask,0,0,11,11
2809,attenzione,1,11,0,11
7394,banco,2,3,8,11
8579,computing,2,9,2,11
2126,generalizzazione,1,11,0,11
27395,जानते,0,0,11,11
51861,परेशान,0,0,11,11
38282,கொள்ளுங்கள்,0,0,11,11
2023,machines,2,1,10,11
31747,tot,0,0,11,11
17979,fueron,0,0,11,11
1899,riguarda,1,11,0,11
9634,giorni,1,11,0,11
2657,gradi,1,11,0,11
159,perdita,1,11,0,11
18058,having,0,0,11,11
25803,βικιπαίδεια,0,0,11,11
31313,países,0,0,11,11
17659,थे।,0,0,11,11
32022,πώς,0,0,11,11
48972,regression,0,0,11,11
44336,hele,0,0,11,11
9567,national,2,1,10,11
1821,team,2,7,4,11
18034,nee,0,0,11,11
9509,valore,1,11,0,11
32031,कम,0,0,11,11
44546,परियोजनाओं,0,0,11,11
16419,questions,0,0,11,11
6912,francia,2,10,1,11
25848,feito,0,0,11,11
37296,மூலம்,0,0,11,11
6772,americana,2,9,2,11
38750,avant,0,0,11,11
38844,ನಾರ್ಸಿಸಾ,0,0,11,11
8942,venduto,1,11,0,11
6668,formale,1,11,0,11
25335,ஓ,0,0,11,11
34555,यहाँ,0,0,11,11
6685,significati,1,11,0,11
9022,lì,1,11,0,11
25410,zich,0,0,11,11
31273,संस्करणों,0,0,11,11
49971,través,0,0,11,11
9155,galles,1,11,0,11
9193,alta,2,6,5,11
25461,один,0,0,11,11
48835,projects,0,0,11,11
10905,few,0,0,11,11
1911,search,2,1,10,11
25484,descartes,0,0,11,11
9653,standard,2,6,5,11
26591,written,0,0,11,11
3690,popolarità,1,11,0,11
33497,année,0,0,11,11
8205,avrebbe,1,11,0,11
10807,burada,0,0,11,11
10868,why,0,0,11,11
7996,basa,2,9,2,11
6194,dieci,1,11,0,11
26856,innehåll,0,0,11,11
34712,sen,0,0,11,11
39265,mes,0,0,11,11
34385,interaction,0,0,11,11
26788,contenidos,0,0,11,11
7887,aspetto,1,11,0,11
33411,enligt,0,0,11,11
28323,häpnadsväckande,0,0,11,11
7677,criteri,1,11,0,11
1558,act,2,2,9,11
2339,far,2,4,7,11
24612,minutes,0,0,11,11
49544,toen,0,0,11,11
1592,business,2,3,8,11
24301,results,0,0,11,11
44325,जानकारी,0,0,11,11
10704,würde,0,0,11,11
8065,john,2,5,6,11
8224,association,2,1,10,11
36954,ഞങ്ങൾ,0,0,11,11
2405,pubblicati,1,11,0,11
34394,three,0,0,11,11
8075,avevano,1,11,0,11
37646,april,0,0,11,11
7664,impatto,1,11,0,11
2407,mente,2,8,3,11
39431,toujours,0,0,11,11
26882,тебе,0,0,11,11
8024,nonostante,1,11,0,11
32000,mere,0,0,10,10
7063,estinzione,1,10,0,10
9184,diventare,1,10,0,10
1941,eh,2,8,2,10
20813,मेरी,0,0,10,10
43019,некоторые,0,0,10,10
33307,مرة,0,0,10,10
8026,list,2,2,8,10
16445,både,0,0,10,10
8293,almeno,1,10,0,10
9120,rappresentano,1,10,0,10
43499,ಪದವನ್ನು,0,0,10,10
8932,group,2,2,8,10
20607,learned,0,0,10,10
33589,seen,0,0,10,10
29650,acesso,0,0,10,10
38330,வேறு,0,0,10,10
35597,جميع,0,0,10,10
38334,versões,0,0,10,10
34914,outer,0,0,10,10
20682,англ,0,0,10,10
13967,fonctionnement,0,0,10,10
29612,wrote,0,0,10,10
44938,topic,0,0,10,10
7138,amo,2,7,3,10
3827,show,2,3,7,10
7131,parlando,1,10,0,10
29602,которую,0,0,10,10
50803,cansado,0,0,10,10
8989,amsterdam,2,4,6,10
16715,ಅದರ,0,0,10,10
46103,onder,0,0,10,10
9026,servizi,1,10,0,10
30400,algorithmes,0,0,10,10
25973,examen,0,0,10,10
9094,cattura,1,10,0,10
2641,fluente,2,7,3,10
9208,originale,1,10,0,10
7037,aumentare,1,10,0,10
29435,तुम,0,0,10,10
3273,eravamo,1,10,0,10
34525,நல்லது,0,0,10,10
13306,जिन्हें,0,0,10,10
21459,sina,0,0,10,10
44436,ancak,0,0,10,10
923,david,2,3,7,10
46533,दी,0,0,10,10
21472,അവൻ,0,0,10,10
293,matrimonio,2,8,2,10
7800,culturali,1,10,0,10
21490,чтото,0,0,10,10
21499,langue,0,0,10,10
3721,usata,1,10,0,10
41267,अंत,0,0,10,10
289,particolarmente,1,10,0,10
46573,bedankt,0,0,10,10
41250,सम्बंधित,0,0,10,10
44836,enero,0,0,10,10
7838,mobili,1,10,0,10
41243,licença,0,0,10,10
21586,बात,0,0,10,10
13122,inglesa,0,0,10,10
27021,मूल,0,0,10,10
34784,അങ്ങനെ,0,0,10,10
1882,potrei,1,10,0,10
37812,दिन,0,0,10,10
1925,piace,1,10,0,10
2636,tendenza,1,10,0,10
7033,rapidamente,1,10,0,10
9237,preoccupazione,1,10,0,10
8020,metà,1,10,0,10
9242,perso,1,10,0,10
30411,bidragsgivare,0,0,10,10
41495,medical,0,0,10,10
27090,मिला,0,0,10,10
13543,raison,0,0,10,10
13459,november,0,0,10,10
17667,denk,0,0,10,10
27066,स्थिति,0,0,10,10
7750,considerati,1,10,0,10
33322,இருக்கும்,0,0,10,10
33438,represented,0,0,10,10
33326,bots,0,0,10,10
41383,body,0,0,10,10
41367,leven,0,0,10,10
2662,spagnola,1,10,0,10
44882,voir,0,0,10,10
37792,rigtig,0,0,10,10
49827,law,0,0,10,10
15705,tengo,0,0,10,10
18812,nas,0,0,10,10
14090,almost,0,0,10,10
19663,philosophie,0,0,10,10
4214,professor,2,2,8,10
42781,things,0,0,10,10
31794,लगभग,0,0,10,10
4215,quegli,1,10,0,10
7444,premi,1,10,0,10
35443,ki,0,0,10,10
3507,dovrei,1,10,0,10
19116,toute,0,0,10,10
19768,own,0,0,10,10
51705,بعد,0,0,10,10
2149,dovrebbe,1,10,0,10
4264,strumenti,1,10,0,10
8523,deutschland,2,3,7,10
578,presenta,2,7,3,10
4273,iniziò,1,10,0,10
15506,laws,0,0,10,10
26472,møde,0,0,10,10
7597,states,2,1,9,10
19868,organisms,0,0,10,10
19007,problemas,0,0,10,10
30311,verkligen,0,0,10,10
26435,الأخرى,0,0,10,10
27221,casos,0,0,10,10
3964,segnale,1,10,0,10
8476,accademici,1,10,0,10
4111,secolo,1,10,0,10
7535,pubblicazioni,1,10,0,10
15366,nouveaux,0,0,10,10
480,potrebbero,1,10,0,10
15089,раз,0,0,10,10
26567,முடியுமா,0,0,10,10
7490,clic,2,7,3,10
27298,utilisation,0,0,10,10
8417,sugli,1,10,0,10
3540,internazionale,1,10,0,10
8264,noi,1,10,0,10
35753,bort,0,0,10,10
19637,lack,0,0,10,10
35758,во,0,0,10,10
7469,logica,1,10,0,10
19624,منذ,0,0,10,10
42749,sure,0,0,10,10
16063,υπάρχει,0,0,10,10
45448,varför,0,0,10,10
519,responsabilità,1,10,0,10
49682,sætninger,0,0,10,10
2476,super,2,3,7,10
7462,nessun,1,10,0,10
2238,cambiamento,1,10,0,10
44469,inputs,0,0,10,10
7369,pianeta,1,10,0,10
2566,rappresentare,1,10,0,10
37679,ud,0,0,10,10
45015,നന്നായി,0,0,10,10
3882,cercando,1,10,0,10
20295,communautés,0,0,10,10
26264,neural,0,0,10,10
43948,mim,0,0,10,10
49480,الذكية,0,0,10,10
31888,വിക്കിപീഡിയയുടെ,0,0,10,10
18340,enkele,0,0,10,10
8779,dolce,1,10,0,10
33894,bon,0,0,10,10
7683,prendere,1,10,0,10
7213,lévistrauss,2,5,5,10
26196,covered,0,0,10,10
20461,тебя,0,0,10,10
20484,janvier,0,0,10,10
29707,tog,0,0,10,10
2409,inizialmente,1,10,0,10
8872,criticata,1,10,0,10
34910,участники,0,0,10,10
14112,разделов,0,0,10,10
7193,assunto,2,4,6,10
3894,automaticamente,2,7,3,10
43669,program,0,0,10,10
45630,too,0,0,10,10
3919,habitat,2,6,4,10
8230,chiede,1,10,0,10
27413,അടുത്ത,0,0,10,10
4383,gpl,2,4,6,10
7361,united,2,1,9,10
7618,canale,1,10,0,10
17907,geven,0,0,10,10
8607,forte,2,9,1,10
37245,بدلاً,0,0,10,10
641,cartesio,1,10,0,10
7629,iniziato,1,10,0,10
20085,function,0,0,10,10
8702,scienze,1,10,0,10
4431,male,2,3,7,10
27441,निर्माण,0,0,10,10
662,multimediali,1,10,0,10
20182,svenska,0,0,10,10
43283,encore,0,0,10,10
16520,millones,0,0,10,10
8659,critici,2,9,1,10
33047,didn,0,0,10,10
4480,rende,2,9,1,10
31558,fortælle,0,0,10,10
24128,topics,0,0,10,10
41509,subject,0,0,10,10
48808,χρυσό,0,0,10,10
40425,ഉദാഹരണത്തിന്,0,0,10,10
6704,beh,1,10,0,10
24466,gemaakt,0,0,10,10
24485,ob,0,0,10,10
23301,guld,0,0,10,10
16393,teşekkür,0,0,10,10
29102,étude,0,0,10,10
12512,areas,0,0,10,10
47035,gebruikt,0,0,10,10
2869,gemelli,1,10,0,10
1742,linguistica,1,10,0,10
27966,applications,0,0,10,10
47045,dank,0,0,10,10
5606,piangere,1,10,0,10
40742,têm,0,0,10,10
50010,خلال,0,0,10,10
52177,تفعل,0,0,10,10
40704,ಬ್ರೆಡ್,0,0,10,10
22284,konsensus,0,0,10,10
1228,rosenzweig,2,2,8,10
1395,bysa,2,5,5,10
11340,engelska,0,0,10,10
22090,يكون,0,0,10,10
40889,ऑनलाइन,0,0,10,10
40873,تحرير,0,0,10,10
185,sezione,1,10,0,10
7820,economista,2,8,2,10
34290,okay,0,0,10,10
5317,golden,2,1,9,10
46984,πιο,0,0,10,10
32253,चिंता,0,0,10,10
39915,можешь,0,0,10,10
9765,можно,0,0,10,10
24708,mis,0,0,10,10
9777,came,0,0,10,10
39216,dream,0,0,10,10
2843,importanza,1,10,0,10
1566,decisionale,1,10,0,10
44311,vision,0,0,10,10
1688,positive,2,3,7,10
6246,donazioni,1,10,0,10
24608,ibland,0,0,10,10
40089,चाहता,0,0,10,10
11520,izin,0,0,10,10
50022,fondation,0,0,10,10
3120,pari,1,10,0,10
22554,traag,0,0,10,10
30952,பயன்படுத்தக்கூடிய,0,0,10,10
32228,έξυπνη,0,0,10,10
12152,होगा,0,0,10,10
48617,trouve,0,0,10,10
51450,internautes,0,0,10,10
36973,développement,0,0,10,10
2848,portale,1,10,0,10
40582,أستطيع,0,0,10,10
12238,υπέροχο,0,0,10,10
34446,pendant,0,0,10,10
6614,cuore,1,10,0,10
1347,biografia,2,8,2,10
36943,ellos,0,0,10,10
2858,valori,1,10,0,10
17605,stedet,0,0,10,10
3000,donna,2,9,1,10
29051,accord,0,0,10,10
16218,ಬಳಸಬಹುದಾದ,0,0,10,10
29050,diz,0,0,10,10
3133,wikiquote,2,5,5,10
59,chiedendo,1,10,0,10
48704,fontes,0,0,10,10
6658,pregiudizio,1,10,0,10
48679,ക്ഷമിക്കണം,0,0,10,10
28066,wide,0,0,10,10
5466,passaggio,1,10,0,10
1370,fammi,1,10,0,10
12324,vue,0,0,10,10
47160,humaine,0,0,10,10
2789,siamo,1,10,0,10
1726,aggiornamento,1,10,0,10
11482,waar,0,0,10,10
31278,«нупедии»,0,0,10,10
6364,educato,1,10,0,10
41038,ويكي,0,0,10,10
6178,computazionale,1,10,0,10
5711,piccoli,1,10,0,10
2905,linea,1,10,0,10
36314,nur,0,0,10,10
47378,μητέρα,0,0,10,10
47382,l’idée,0,0,10,10
6150,utilizzate,1,10,0,10
6791,cebuano,2,5,5,10
24796,tinha,0,0,10,10
1281,society,2,3,7,10
10367,ಕೆಲವು,0,0,10,10
34419,público,0,0,10,10
24913,வேலை,0,0,10,10
23877,mein,0,0,10,10
48039,nécessaire,0,0,10,10
48879,maioria,0,0,10,10
16828,قبل,0,0,10,10
29304,möte,0,0,10,10
6488,privacy,2,6,4,10
1663,comunicazione,1,10,0,10
52294,disputas,0,0,10,10
28134,பின்னர்,0,0,10,10
2936,dicono,1,10,0,10
21726,nouvelle,0,0,10,10
24191,استخدامها,0,0,10,10
11028,deras,0,0,10,10
44545,tienes,0,0,10,10
9496,alan,2,4,6,10
47479,मुख्य,0,0,10,10
24018,fras,0,0,10,10
36833,published,0,0,10,10
5710,incluso,2,4,6,10
39653,вместо,0,0,10,10
1542,fatti,1,10,0,10
25438,parfois,0,0,10,10
23077,temps,0,0,10,10
52630,തന്നെ,0,0,10,10
40929,premier,0,0,10,10
37158,erreurs,0,0,10,10
24337,ναρκίσσα,0,0,10,10
6037,programming,2,1,9,10
1067,cd,2,2,8,10
48199,liv,0,0,10,10
2817,numerosi,1,10,0,10
21688,ಇಲ್ಲ,0,0,10,10
36793,living,0,0,10,10
2833,mantenere,1,10,0,10
47805,serait,0,0,10,10
10314,imagens,0,0,10,10
6517,alcun,1,10,0,10
32716,outro,0,0,10,10
1526,felice,1,10,0,10
23151,உங்களுக்குத்,0,0,10,10
1248,james,2,4,6,10
39799,الفيديو,0,0,10,10
5225,possibili,1,10,0,10
40227,istället,0,0,10,10
50275,certeza,0,0,10,10
44679,свою,0,0,10,10
10702,signal,0,0,10,10
8324,ok,2,5,4,9
18425,ponto,0,0,9,9
7441,attuale,1,9,0,9
51086,способ,0,0,9,9
30223,bueno,0,0,9,9
51000,look,0,0,9,9
11794,havia,0,0,9,9
42380,typically,0,0,9,9
45353,अद्भुत,0,0,9,9
35691,этот,0,0,9,9
15120,нарцисса,0,0,9,9
17887,kunde,0,0,9,9
26569,feliz,0,0,9,9
5840,regioni,1,9,0,9
42558,கட்டுரைகள்,0,0,9,9
19731,nästa,0,0,9,9
40097,zegt,0,0,9,9
6421,utili,1,9,0,9
36699,permite,0,0,9,9
4136,condotto,1,9,0,9
7527,aggiunta,1,9,0,9
14936,आवश्यकता,0,0,9,9
6399,offline,2,6,3,9
6382,idee,2,5,4,9
15001,plant,0,0,9,9
30151,rêve,0,0,9,9
45459,able,0,0,9,9
11793,fler,0,0,9,9
45473,assim,0,0,9,9
42536,تمامًا,0,0,9,9
50342,ओर,0,0,9,9
30048,birçok,0,0,9,9
49357,bruger,0,0,9,9
4205,month,2,1,8,9
23089,gentil,0,0,9,9
47480,usado,0,0,9,9
50387,ge,0,0,9,9
25666,weil,0,0,9,9
51111,κάνω,0,0,9,9
17252,leren,0,0,9,9
17868,الكثير,0,0,9,9
27079,σπίτι,0,0,9,9
28396,επίσης,0,0,9,9
15829,vou,0,0,9,9
23835,kanal,0,0,9,9
6083,update,2,1,8,9
43027,sluggish,0,0,9,9
18723,mathematical,0,0,9,9
48129,olmak,0,0,9,9
36818,ഉള്ള,0,0,9,9
47866,fordi,0,0,9,9
48131,mine,0,0,9,9
17141,interview,0,0,9,9
10737,improve,0,0,9,9
6051,centinaia,1,9,0,9
30391,inhoud,0,0,9,9
8067,intera,1,9,0,9
28357,référence,0,0,9,9
39522,hasta,0,0,9,9
36823,ஏதாவது,0,0,9,9
43412,cet,0,0,9,9
35539,traditional,0,0,9,9
28430,erstaunlich,0,0,9,9
37781,بها,0,0,9,9
7851,prove,2,7,2,9
17152,persoon,0,0,9,9
43118,eat,0,0,9,9
18611,decline,0,0,9,9
39595,ഇല്ല,0,0,9,9
43091,manger,0,0,9,9
7906,accademica,1,9,0,9
24164,கனவு,0,0,9,9
7785,kiwix,2,4,5,9
3746,talvolta,1,9,0,9
16335,situación,0,0,9,9
48094,werken,0,0,9,9
16584,third,0,0,9,9
7896,sembrare,1,9,0,9
15689,μετά,0,0,9,9
24369,sitios,0,0,9,9
49404,lidt,0,0,9,9
37896,error,0,0,9,9
45146,و,0,0,9,9
15419,variables,0,0,9,9
24652,approximately,0,0,9,9
18461,organização,0,0,9,9
36727,хлеб,0,0,9,9
27237,held,0,0,9,9
19186,interest,0,0,9,9
37601,smarta,0,0,9,9
42712,dices,0,0,9,9
19303,cümle,0,0,9,9
30246,ಇಲ್ಲಿ,0,0,9,9
45270,started,0,0,9,9
18458,ಯಾವುದೇ,0,0,9,9
15219,echter,0,0,9,9
7554,país,2,2,7,9
45294,तरीका,0,0,9,9
48384,sabes,0,0,9,9
45142,ಚಿನ್ನದ,0,0,9,9
8261,sera,2,3,6,9
49677,grausam,0,0,9,9
23546,ಯಾರನ್ನಾದರೂ,0,0,9,9
23654,ഇവിടെ,0,0,9,9
24388,لذلك,0,0,9,9
10651,जाती,0,0,9,9
42913,section,0,0,9,9
42912,தங்க,0,0,9,9
8210,pubblicato,1,9,0,9
51128,alterações,0,0,9,9
24550,juste,0,0,9,9
7432,elaborazione,1,9,0,9
42854,date,0,0,9,9
8245,trova,1,9,0,9
3928,url,2,3,6,9
39962,warum,0,0,9,9
6309,factor,2,3,6,9
39988,നാർസിസ,0,0,9,9
16637,alemán,0,0,9,9
39091,lieu,0,0,9,9
8601,russo,2,7,2,9
28752,beste,0,0,9,9
41689,policies,0,0,9,9
49052,fazla,0,0,9,9
7073,lincoln,2,3,6,9
44184,slim,0,0,9,9
46267,அற்புதமான,0,0,9,9
38746,anyone,0,0,9,9
37317,ಇನ್ನೊಂದು,0,0,9,9
36356,stort,0,0,9,9
44702,seni,0,0,9,9
13635,वेब,0,0,9,9
21065,revisão,0,0,9,9
4868,mostra,1,9,0,9
48823,تعديل,0,0,9,9
9236,candidato,2,6,3,9
21119,river,0,0,9,9
46344,ω,0,0,9,9
5270,occhi,1,9,0,9
36338,anstelle,0,0,9,9
12740,tag,0,0,9,9
7008,dna,2,5,4,9
20870,muchos,0,0,9,9
46170,hand,0,0,9,9
5229,osservazioni,1,9,0,9
46155,étatsunis,0,0,9,9
7164,sabato,1,9,0,9
40719,sonho,0,0,9,9
4698,miglioramento,1,9,0,9
4706,succedendo,1,9,0,9
22322,дела,0,0,9,9
12487,designed,0,0,9,9
36090,better,0,0,9,9
40769,debido,0,0,9,9
4739,commento,1,9,0,9
9786,dess,0,0,9,9
26039,अवयवों,0,0,9,9
38407,average,0,0,9,9
29130,geben,0,0,9,9
4768,normalmente,2,3,6,9
5355,ricorda,1,9,0,9
25960,bajo,0,0,9,9
9785,maior,0,0,9,9
4791,radio,2,3,6,9
20789,författarna,0,0,9,9
37171,இருக்க,0,0,9,9
6989,effetti,1,9,0,9
4232,ascoltando,1,9,0,9
38611,sueño,0,0,9,9
36264,goal,0,0,9,9
46688,klotter,0,0,9,9
50690,politique,0,0,9,9
9403,metawiki,2,4,5,9
9492,ambito,1,9,0,9
46685,passe,0,0,9,9
16429,gemacht,0,0,9,9
9409,italiana,2,8,1,9
46682,moins,0,0,9,9
46600,करें।,0,0,9,9
44684,importe,0,0,9,9
9459,regno,1,9,0,9
21696,mina,0,0,9,9
13164,μερικές,0,0,9,9
21694,principales,0,0,9,9
21572,yo,0,0,9,9
13138,språk,0,0,9,9
43886,policyer,0,0,9,9
41175,beauty,0,0,9,9
29401,ದೌರ್ಜನ್ಯ,0,0,9,9
25630,eran,0,0,9,9
4928,apprendere,1,9,0,9
41135,conocimiento,0,0,9,9
4934,presso,1,9,0,9
44699,şekilde,0,0,9,9
38682,addition,0,0,9,9
6775,ibm,2,4,5,9
27748,имеет,0,0,9,9
25823,serveurs,0,0,9,9
9597,interni,1,9,0,9
5208,strettamente,1,9,0,9
6960,target,2,2,7,9
9337,minuto,2,7,2,9
16412,honom,0,0,9,9
12891,gebruik,0,0,9,9
29441,esa,0,0,9,9
41342,लगता,0,0,9,9
27867,quelques,0,0,9,9
5186,possano,1,9,0,9
13319,am,0,0,9,9
9545,scholarpedia,2,2,7,9
46731,physical,0,0,9,9
5432,significativo,2,8,1,9
47083,publicados,0,0,9,9
25288,человека,0,0,9,9
29882,arbete,0,0,9,9
22906,aos,0,0,9,9
13058,logiciel,0,0,9,9
4396,azioni,1,9,0,9
22890,devices,0,0,9,9
44563,overspoeld,0,0,9,9
40393,ஏன்,0,0,9,9
8624,gode,2,2,7,9
26406,cuya,0,0,9,9
12021,இருக்கிறது,0,0,9,9
42192,நல்ல,0,0,9,9
45691,hvorfor,0,0,9,9
39018,ليس,0,0,9,9
8628,variazioni,1,9,0,9
14509,universe,0,0,9,9
17334,المحتوى,0,0,9,9
8630,opere,1,9,0,9
47309,दोस्तों,0,0,9,9
8645,sparse,2,2,7,9
12116,اليوم,0,0,9,9
48540,когото,0,0,9,9
24919,créer,0,0,9,9
14067,humans,0,0,9,9
5695,unità,1,9,0,9
50991,со,0,0,9,9
14782,meses,0,0,9,9
5754,culturale,1,9,0,9
14780,home,0,0,9,9
6472,stavo,1,9,0,9
14761,yerine,0,0,9,9
8524,servizio,1,9,0,9
48510,latin,0,0,9,9
8525,ultimo,1,9,0,9
14749,ಹೇಳಲು,0,0,9,9
43443,næste,0,0,9,9
50970,страниц,0,0,9,9
7412,florida,2,4,5,9
19825,моя,0,0,9,9
5721,provenienti,1,9,0,9
10188,മലയാളം,0,0,9,9
36620,veux,0,0,9,9
27412,weather,0,0,9,9
45636,pessoas,0,0,9,9
4461,unici,1,9,0,9
40476,sitt,0,0,9,9
12143,لديك,0,0,9,9
44562,sûr,0,0,9,9
22563,influence,0,0,9,9
6634,case,2,1,8,9
8789,terzo,1,9,0,9
22542,analyse,0,0,9,9
29730,sea,0,0,9,9
29018,versiones,0,0,9,9
20462,لأي,0,0,9,9
14159,image,0,0,9,9
12297,waarom,0,0,9,9
7207,wikimédia,2,1,8,9
20482,still,0,0,9,9
45969,إن,0,0,9,9
50852,этих,0,0,9,9
41902,jemanden,0,0,9,9
41891,seguro,0,0,9,9
12393,elles,0,0,9,9
41874,λίγο,0,0,9,9
47086,personen,0,0,9,9
17996,pourquoi,0,0,9,9
45889,τρόπος,0,0,9,9
27529,vraagt,0,0,9,9
4559,angelo,1,9,0,9
16514,aunque,0,0,9,9
4488,dentro,2,3,6,9
42086,जाना,0,0,9,9
26300,των,0,0,9,9
6604,ecologia,1,9,0,9
48636,i̇ngilizce,0,0,9,9
12212,estos,0,0,9,9
42062,situação,0,0,9,9
4507,separate,2,2,7,9
7251,adams,2,3,6,9
9952,described,0,0,9,9
45824,fråga,0,0,9,9
45834,போல,0,0,9,9
37426,droom,0,0,9,9
40564,comprendre,0,0,9,9
20309,june,0,0,9,9
42020,где,0,0,9,9
25172,رائع,0,0,9,9
14294,especially,0,0,9,9
26991,என்றால்,0,0,9,9
44068,jour,0,0,9,9
3054,lunga,1,9,0,9
33171,været,0,0,9,9
33020,disponible,0,0,9,9
2212,incontro,1,9,0,9
647,corpo,1,9,0,9
51516,estupenda,0,0,9,9
621,mie,1,9,0,9
2977,ovvero,1,9,0,9
603,marca,2,2,7,9
1321,cofondatore,1,9,0,9
575,risolvere,1,9,0,9
35171,ouro,0,0,9,9
3018,store,2,3,6,9
1338,zeit,2,1,8,9
34688,எந்த,0,0,9,9
490,prestito,1,9,0,9
718,là,2,5,4,9
52529,фраза,0,0,9,9
1424,soluzione,1,9,0,9
51462,forskare,0,0,9,9
51460,लोग,0,0,9,9
409,apportate,1,9,0,9
3099,precedenti,1,9,0,9
1431,preoccupare,1,9,0,9
397,miliardi,1,9,0,9
1468,stanno,1,9,0,9
33726,क्यों,0,0,9,9
2038,opinione,1,9,0,9
3166,elementi,1,9,0,9
34556,become,0,0,9,9
52201,vertellen,0,0,9,9
2252,correggere,1,9,0,9
31977,cases,0,0,9,9
886,richieste,1,9,0,9
2628,mille,2,8,1,9
31397,çünkü,0,0,9,9
51651,stumpf,0,0,9,9
2573,collaborative,2,2,7,9
31440,falta,0,0,9,9
34899,ஆம்,0,0,9,9
32781,anne,0,0,9,9
966,baidu,2,4,5,9
31345,sicher,0,0,9,9
1144,passato,1,9,0,9
904,conservapedia,2,3,6,9
2727,presenza,1,9,0,9
34001,languages,0,0,9,9
33989,நாங்கள்,0,0,9,9
727,cielo,2,7,2,9
1170,diventata,1,9,0,9
32607,ked,0,0,9,9
34161,وهذا,0,0,9,9
856,darwin,2,4,5,9
2408,tom,2,4,5,9
822,beni,2,3,6,9
31210,land,0,0,9,9
3609,top,2,1,8,9
31153,άτομο,0,0,9,9
2883,presto,1,9,0,9
32551,creación,0,0,9,9
2899,biblioteca,2,6,3,9
2264,venuto,1,9,0,9
3184,consultazione,1,9,0,9
52271,थी।,0,0,9,9
1971,citata,1,9,0,9
214,riferito,1,9,0,9
52687,الرغم,0,0,9,9
3436,organizzazioni,1,9,0,9
3552,vanno,1,9,0,9
3429,recenti,1,9,0,9
30842,تعرف,0,0,9,9
3256,oceani,1,9,0,9
154,motori,1,9,0,9
34413,им,0,0,9,9
3275,boris,2,3,6,9
1903,stasera,1,9,0,9
35325,quer,0,0,9,9
137,funzionamento,1,9,0,9
3314,valutazione,1,9,0,9
1819,neuroni,1,9,0,9
33462,vu,0,0,9,9
3237,presentare,1,9,0,9
103,dipende,1,9,0,9
3684,pubblicate,1,9,0,9
1969,rappresentazioni,1,9,0,9
51296,которое,0,0,9,9
33667,ಏಕೆಂದರೆ,0,0,9,9
3484,rinforzo,1,9,0,9
1513,oggetti,1,9,0,9
34443,ತಿಳಿದಿದೆ,0,0,9,9
33561,своей,0,0,9,9
33544,vetenskapliga,0,0,9,9
49586,primeira,0,0,8,8
31575,vid,0,0,8,8
9461,adottato,1,8,0,8
49824,estce,0,0,8,8
37707,അവളുടെ,0,0,8,8
49837,அடுத்த,0,0,8,8
9581,soldi,1,8,0,8
25653,scientific,0,0,8,8
1719,caro,1,8,0,8
48915,etmek,0,0,8,8
27595,പദം,0,0,8,8
7819,beck,2,4,4,8
49563,здесь,0,0,8,8
37867,ging,0,0,8,8
25568,tradition,0,0,8,8
49525,lass,0,0,8,8
38647,പോലെ,0,0,8,8
34759,ಒಳ್ಳೆಯದು,0,0,8,8
8049,scritte,1,8,0,8
7916,triste,2,4,4,8
49730,ordinateur,0,0,8,8
9606,rispettivamente,1,8,0,8
2457,fame,1,8,0,8
38797,trois,0,0,8,8
48761,eens,0,0,8,8
32092,société,0,0,8,8
31475,ее,0,0,8,8
7433,wikibooks,2,4,4,8
31500,будет,0,0,8,8
2466,correnti,1,8,0,8
2463,feedback,2,5,3,8
7354,normale,1,8,0,8
7238,california,2,5,3,8
9893,много,0,0,8,8
38737,अक्सर,0,0,8,8
31534,lost,0,0,8,8
37915,swamped,0,0,8,8
1786,tavolo,1,8,0,8
1790,delhi,2,2,6,8
25548,التعلم,0,0,8,8
7584,bang,2,1,7,8
37653,oceans,0,0,8,8
34461,programa,0,0,8,8
2444,fattori,1,8,0,8
26659,verschillende,0,0,8,8
37954,mad,0,0,8,8
25678,biography,0,0,8,8
8538,centrale,2,7,1,8
8546,geografia,2,6,2,8
38112,developed,0,0,8,8
25886,λάθος,0,0,8,8
26433,incluindo,0,0,8,8
49281,अनुसार,0,0,8,8
9221,phusis,2,4,4,8
9176,cdrom,2,4,4,8
9140,olandese,1,8,0,8
34647,book,0,0,8,8
26359,smaller,0,0,8,8
49251,às,0,0,8,8
49067,últimos,0,0,8,8
8701,costituisce,1,8,0,8
31866,ice,0,0,8,8
9125,svm,2,5,3,8
8774,devo,2,7,1,8
49217,amazing,0,0,8,8
8822,esistenza,1,8,0,8
9115,wikireader,2,6,2,8
9054,stupido,1,8,0,8
49179,പുതിയ,0,0,8,8
8929,percento,1,8,0,8
38329,δύο,0,0,8,8
8971,testa,1,8,0,8
7139,black,2,3,5,8
2141,prosa,2,4,4,8
31797,больше,0,0,8,8
51824,smarte,0,0,8,8
9453,dimenticare,1,8,0,8
1851,ecosistema,1,8,0,8
8227,lineare,1,8,0,8
34713,ஆங்கில,0,0,8,8
26081,coverage,0,0,8,8
8267,peter,2,3,5,8
31750,planer,0,0,8,8
9399,dilemma,2,3,5,8
49389,которая,0,0,8,8
25774,विकास,0,0,8,8
8340,fiume,1,8,0,8
9289,corsi,1,8,0,8
31792,просто,0,0,8,8
26555,inundado,0,0,8,8
26546,peutêtre,0,0,8,8
9252,autorità,1,8,0,8
31771,fri,0,0,8,8
9231,mellon,2,3,5,8
26537,engelstalige,0,0,8,8
31782,делать,0,0,8,8
9230,scoperto,1,8,0,8
8453,k,2,4,4,8
26510,control,0,0,8,8
8496,induttiva,1,8,0,8
3688,correlati,1,8,0,8
6637,umm,2,2,6,8
27607,déjà,0,0,8,8
5308,sistemici,1,8,0,8
29291,प्रकार,0,0,8,8
36296,വാചകം,0,0,8,8
5184,americano,1,8,0,8
29262,വലിയ,0,0,8,8
5205,disturbo,1,8,0,8
30874,basic,0,0,8,8
5223,comitato,1,8,0,8
3196,wiktionary,2,3,5,8
3190,creati,1,8,0,8
29222,organización,0,0,8,8
5265,george,2,3,5,8
35267,choses,0,0,8,8
29196,voiture,0,0,8,8
5297,sostengono,1,8,0,8
36371,возможность,0,0,8,8
7103,membri,1,8,0,8
36385,aberta,0,0,8,8
5367,illustrazioni,1,8,0,8
50529,hause,0,0,8,8
29059,hui,0,0,8,8
3130,diventato,1,8,0,8
51447,¿cómo,0,0,8,8
35231,области,0,0,8,8
30954,örneğin,0,0,8,8
28987,nuevo,0,0,8,8
5527,esame,1,8,0,8
5531,tipicamente,1,8,0,8
28914,arbeta,0,0,8,8
28887,ರೆಂಡೆಜ್ವಸ್,0,0,8,8
28857,objetivo,0,0,8,8
3221,occidentale,2,5,3,8
5104,incredibile,1,8,0,8
29349,disponibles,0,0,8,8
50676,numaralı,0,0,8,8
35897,dann,0,0,8,8
3465,necessaria,1,8,0,8
4392,solitamente,1,8,0,8
4402,etichettati,1,8,0,8
4437,equinix,2,4,4,8
35940,sammen,0,0,8,8
3441,frequentemente,2,4,4,8
3431,giro,2,7,1,8
30684,उसे,0,0,8,8
30688,kanske,0,0,8,8
4532,scuola,1,8,0,8
29749,വാക്ക്,0,0,8,8
4593,tradizione,1,8,0,8
50861,trög,0,0,8,8
3392,bel,2,7,1,8
36022,ತಾಯಿ,0,0,8,8
36024,हुए,0,0,8,8
30726,εντάξει,0,0,8,8
36062,ಅವನು,0,0,8,8
4713,engels,2,1,7,8
4800,azione,1,8,0,8
35344,neutral,0,0,8,8
50761,हमेशा,0,0,8,8
4840,credo,1,8,0,8
4879,liste,2,1,7,8
4891,costante,1,8,0,8
4903,eventi,1,8,0,8
5001,pratica,1,8,0,8
5017,caa,2,4,4,8
36602,ಪದ,0,0,8,8
30992,கொடூரமான,0,0,8,8
36632,daily,0,0,8,8
28304,eg,0,0,8,8
6318,latina,2,6,2,8
28235,cosas,0,0,8,8
6365,verbo,2,6,2,8
6395,ex,1,8,0,8
6417,determinate,1,8,0,8
6445,nulla,1,8,0,8
6494,ubuntu,2,3,5,8
6512,mangiarlo,1,8,0,8
37062,بما,0,0,8,8
28065,sadece,0,0,8,8
28058,loss,0,0,8,8
6590,questioni,1,8,0,8
25164,along,0,0,8,8
50004,importance,0,0,8,8
6698,censura,2,6,2,8
6705,difficoltà,1,8,0,8
51611,criticada,0,0,8,8
2734,piacere,1,8,0,8
6747,rilevare,1,8,0,8
6869,fornito,1,8,0,8
6913,fisico,1,8,0,8
31366,आज,0,0,8,8
27752,stora,0,0,8,8
51647,trained,0,0,8,8
6976,chiesto,1,8,0,8
37280,സ്വർണ്ണ,0,0,8,8
37304,avril,0,0,8,8
7039,cervello,1,8,0,8
7050,senti,1,8,0,8
31160,laquelle,0,0,8,8
50176,сделать,0,0,8,8
28750,simple,0,0,8,8
50179,bekommen,0,0,8,8
5778,buono,1,8,0,8
5815,lezioni,1,8,0,8
28675,विशेष,0,0,8,8
36709,quiser,0,0,8,8
28659,variations,0,0,8,8
3027,indicare,1,8,0,8
5849,unito,1,8,0,8
31027,عدد,0,0,8,8
28648,στον,0,0,8,8
5881,numerose,1,8,0,8
31040,ജോലി,0,0,8,8
3003,evidenti,1,8,0,8
5966,lit,2,1,7,8
36782,edition,0,0,8,8
2970,verifica,1,8,0,8
6026,prova,2,7,1,8
31087,misschien,0,0,8,8
6042,aiutarti,1,8,0,8
6058,priori,2,3,5,8
31105,dedos,0,0,8,8
6087,formazione,1,8,0,8
31107,down,0,0,8,8
6111,piaciuto,1,8,0,8
6116,mediante,2,1,7,8
6143,pensiero,1,8,0,8
2918,accurate,2,3,5,8
2900,ars,2,3,5,8
6229,serio,2,4,4,8
6247,stampa,1,8,0,8
25177,ಕೆಲಸ,0,0,8,8
39272,present,0,0,8,8
9984,central,0,0,8,8
33136,pourrait,0,0,8,8
467,produrre,1,8,0,8
507,quotidiano,1,8,0,8
14967,term,0,0,8,8
19683,эти,0,0,8,8
19700,utilisateurs,0,0,8,8
19708,gång,0,0,8,8
19726,गाड़ी,0,0,8,8
20097,अध्ययन,0,0,8,8
14827,saber,0,0,8,8
585,school,2,1,7,8
42333,buena,0,0,8,8
52469,represent,0,0,8,8
14620,done,0,0,8,8
14563,true,0,0,8,8
15160,lequel,0,0,8,8
19370,ξέρετε,0,0,8,8
19353,tais,0,0,8,8
42651,لدي,0,0,8,8
15229,таких,0,0,8,8
42686,computers,0,0,8,8
19261,التحرير,0,0,8,8
19251,κάνεις,0,0,8,8
42723,tut,0,0,8,8
33758,आया,0,0,8,8
42765,accès,0,0,8,8
15408,boa,0,0,8,8
412,miglior,1,8,0,8
33227,घर,0,0,8,8
19059,योगदानकर्ता,0,0,8,8
19047,εκεί,0,0,8,8
45105,στιγμή,0,0,8,8
642,includere,1,8,0,8
14458,zeker,0,0,8,8
15513,ताकि,0,0,8,8
13824,ಸಂಖ್ಯೆ,0,0,8,8
41834,limited,0,0,8,8
46048,θέλω,0,0,8,8
785,dedicato,1,8,0,8
20759,parmi,0,0,8,8
20821,dites,0,0,8,8
20828,grâce,0,0,8,8
33951,работы,0,0,8,8
42108,സ്വയം,0,0,8,8
41619,ويكيميديا,0,0,8,8
13713,étant,0,0,8,8
837,differenze,1,8,0,8
33971,ecosystem,0,0,8,8
41548,सहयोग,0,0,8,8
13569,introduced,0,0,8,8
20594,möchten,0,0,8,8
41867,हालाँकि,0,0,8,8
14060,ऑफ़,0,0,8,8
41887,diyebilirsin,0,0,8,8
41912,أكبر,0,0,8,8
14128,لغة,0,0,8,8
20493,meine,0,0,8,8
743,app,2,5,3,8
33904,extinction,0,0,8,8
20456,trafic,0,0,8,8
32993,quero,0,0,8,8
722,autonoma,1,8,0,8
20386,animal,0,0,8,8
45844,zien,0,0,8,8
42049,universidad,0,0,8,8
33878,federal,0,0,8,8
42091,mitt,0,0,8,8
15510,gave,0,0,8,8
18967,bli,0,0,8,8
21207,två,0,0,8,8
44384,அதைப்,0,0,8,8
43748,എന്നതാണ്,0,0,8,8
43722,verstanden,0,0,8,8
33484,klar,0,0,8,8
94,bancario,2,6,2,8
97,adesso,1,8,0,8
98,merito,1,8,0,8
43652,أنها,0,0,8,8
17942,العبارة,0,0,8,8
17800,nobrainer,0,0,8,8
17806,minha,0,0,8,8
124,amico,1,8,0,8
16562,recherche,0,0,8,8
16538,liberté,0,0,8,8
43562,luego,0,0,8,8
17593,defined,0,0,8,8
44285,car,0,0,8,8
17497,launched,0,0,8,8
17494,ഉപയോക്താക്കൾ,0,0,8,8
16900,behavior,0,0,8,8
17480,பதிலாக,0,0,8,8
44206,lent,0,0,8,8
40,foto,2,6,2,8
16997,sais,0,0,8,8
43949,kunnen,0,0,8,8
17299,gedaan,0,0,8,8
43991,सवाल,0,0,8,8
17218,स्थापना,0,0,8,8
17200,καλή,0,0,8,8
44048,relatively,0,0,8,8
44053,самых,0,0,8,8
44072,legal,0,0,8,8
17930,συγνώμη,0,0,8,8
43530,« nature »,0,0,8,8
42883,सामान्य,0,0,8,8
18813,geht,0,0,8,8
43085,നിങ്ങൾ‌ക്ക്,0,0,8,8
44908,لو,0,0,8,8
15771,энциклопедии,0,0,8,8
15770,traum,0,0,8,8
15735,leid,0,0,8,8
44975,bei,0,0,8,8
44990,denna,0,0,8,8
146,crea,2,7,1,8
18848,amerika,0,0,8,8
42933,tijd,0,0,8,8
18870,kullanabileceğiniz,0,0,8,8
42926,நர்சிசா,0,0,8,8
33261,хочу,0,0,8,8
381,impact,2,3,5,8
15895,äta,0,0,8,8
15937,regions,0,0,8,8
264,specchio,1,8,0,8
18542,crear,0,0,8,8
15979,hög,0,0,8,8
44772,नाम,0,0,8,8
18421,языковых,0,0,8,8
18386,always,0,0,8,8
228,stallman,2,2,6,8
43336,volgende,0,0,8,8
18207,existen,0,0,8,8
18190,सन्दर्भ,0,0,8,8
16334,slimme,0,0,8,8
18106,lunch,0,0,8,8
18074,ayant,0,0,8,8
44565,neurons,0,0,8,8
151,inferiore,1,8,0,8
21192,onlara,0,0,8,8
21231,nog,0,0,8,8
1710,maher,2,4,4,8
10960,enlaces,0,0,8,8
11033,voluntários,0,0,8,8
11022,κάνετε,0,0,8,8
11005,без,0,0,8,8
32322,oversvømmet,0,0,8,8
24051,ലേഖനം,0,0,8,8
24053,सोने,0,0,8,8
10957,coisa,0,0,8,8
39497,situatie,0,0,8,8
24105,ക്യാച്ച്,0,0,8,8
34349,ഉപയോഗിക്കുന്നു,0,0,8,8
24139,செல்ல,0,0,8,8
48087,él,0,0,8,8
24189,सच,0,0,8,8
48113,contrôle,0,0,8,8
39693,erros,0,0,8,8
23840,प्रयोग,0,0,8,8
11170,всего,0,0,8,8
47848,benim,0,0,8,8
11258,mil,0,0,8,8
23711,أريد,0,0,8,8
23698,ഇന്ന്,0,0,8,8
52147,birisi,0,0,8,8
1416,inglesi,1,8,0,8
39889,  ,0,0,8,8
23561,novos,0,0,8,8
11409,changed,0,0,8,8
23541,ज्यादा,0,0,8,8
39997,fik,0,0,8,8
11496,maddeleri,0,0,8,8
40016,källa,0,0,8,8
1363,identità,1,8,0,8
48116,وقت,0,0,8,8
48173,cadre,0,0,8,8
11559,ரொட்டி,0,0,8,8
24873,சொற்கள்,0,0,8,8
24671,desculpe,0,0,8,8
24676,وأنت,0,0,8,8
39202,μπορεί,0,0,8,8
48419,universidade,0,0,8,8
39163,प्रवृति,0,0,8,8
10287,bazen,0,0,8,8
24957,asking,0,0,8,8
24314,गयी,0,0,8,8
1683,costruzione,1,8,0,8
10119,ಎಂಬ,0,0,8,8
24986,constante,0,0,8,8
25019,explica,0,0,8,8
48604,будто,0,0,8,8
48637,hans,0,0,8,8
48382,arbeit,0,0,8,8
24666,unique,0,0,8,8
1603,wikivoyage,2,4,4,8
48366,ekmek,0,0,8,8
10458,mange,0,0,8,8
50943,ಏನನ್ನಾದರೂ,0,0,8,8
39278,بواسطة,0,0,8,8
39317,secret,0,0,8,8
10575,إنه,0,0,8,8
39387,lang,0,0,8,8
24413,readers,0,0,8,8
1556,logic,2,1,7,8
10674,الشخص,0,0,8,8
24354,nya,0,0,8,8
24335,мать,0,0,8,8
39445,säker,0,0,8,8
10731,past,0,0,8,8
23419,തിരുത്തലുകൾ,0,0,8,8
23380,जनवरी,0,0,8,8
46429,septembre,0,0,8,8
22148,increasing,0,0,8,8
12817,ಮೇಲೆ,0,0,8,8
1049,superato,1,8,0,8
32717,academic,0,0,8,8
1062,storico,1,8,0,8
12690,മറ്റ്,0,0,8,8
22098,hennes,0,0,8,8
22181,क्षमा,0,0,8,8
47105,höflich,0,0,8,8
22190,current,0,0,8,8
12568,ας,0,0,8,8
32670,المنزل,0,0,8,8
40796,fuente,0,0,8,8
40770,muitos,0,0,8,8
47085,contribuições,0,0,8,8
12861,المحررين,0,0,8,8
21858,என்னால்,0,0,8,8
12929,देखा,0,0,8,8
12953,vissa,0,0,8,8
13020,धन्यवाद।,0,0,8,8
13026,noch,0,0,8,8
13028,lige,0,0,8,8
13029,change,0,0,8,8
21677,صفحة,0,0,8,8
973,prese,1,8,0,8
962,auto,1,8,0,8
21529,basis,0,0,8,8
41324,early,0,0,8,8
46488,modelos,0,0,8,8
13370,mientras,0,0,8,8
897,statistici,1,8,0,8
21298,reports,0,0,8,8
12405,demande,0,0,8,8
47114,दूसरे,0,0,8,8
47593,εάν,0,0,8,8
34226,usuário,0,0,8,8
11931,första,0,0,8,8
22960,specific,0,0,8,8
11899,hatte,0,0,8,8
40322,auteur,0,0,8,8
23042,несколько,0,0,8,8
23054,against,0,0,8,8
47459,worry,0,0,8,8
47131,கேட்க,0,0,8,8
1283,definita,1,8,0,8
11802,plans,0,0,8,8
23103,புதிய,0,0,8,8
23125,लोगों,0,0,8,8
47535,quiero,0,0,8,8
1331,ciascuno,1,8,0,8
40360,происходит,0,0,8,8
11997,شكرا,0,0,8,8
12041,maddelerin,0,0,8,8
22828,ಮೂಲಕ,0,0,8,8
22820,викимедиа,0,0,8,8
1222,mercato,1,8,0,8
12094,senare,0,0,8,8
22694,செய்து,0,0,8,8
22671,conjunto,0,0,8,8
47234,άλλη,0,0,8,8
12202,المثال,0,0,8,8
40555,تقلق,0,0,8,8
1188,disciplina,2,7,1,8
12256,നു,0,0,8,8
22528,naam,0,0,8,8
12328,धन्यवाद,0,0,8,8
1162,secoli,1,8,0,8
35431,cofundador,0,0,8,8
10430,genetic,0,0,8,8
3514,anticipo,1,8,0,8
35442,première,0,0,8,8
3855,album,2,4,4,8
30152,rate,0,0,8,8
3797,carnegie,2,3,5,8
30611,brot,0,0,8,8
35582,कहने,0,0,8,8
4019,daniel,2,2,6,8
4228,virginia,2,3,5,8
51059,ello,0,0,8,8
3805,tener,2,1,7,8
50977,pensar,0,0,8,8
30212,análisis,0,0,8,8
4166,sviluppati,1,8,0,8
30502,año,0,0,8,8
30245,الذين,0,0,8,8
3999,virgin,2,2,6,8
4266,pubblicazione,1,8,0,8
30129,servers,0,0,8,8
30116,already,0,0,8,8
4082,episodio,2,7,1,8
29970,referência,0,0,8,8
35696,всех,0,0,8,8
27924,changement,0,0,7,7
38245,العالم,0,0,7,7
34524,யாரையாவது,0,0,7,7
22445,heute,0,0,7,7
35308,setembro,0,0,7,7
37411,biological,0,0,7,7
17857,தனது,0,0,7,7
4200,letteralmente,1,7,0,7
15080,முறை,0,0,7,7
14757,detect,0,0,7,7
6752,comprendere,1,7,0,7
15819,работу,0,0,7,7
52022,opinión,0,0,7,7
37162,يوم,0,0,7,7
123,discovery,2,1,6,7
19467,сша,0,0,7,7
47493,conhecimento,0,0,7,7
1868,comunemente,1,7,0,7
22437,geral,0,0,7,7
43608,processes,0,0,7,7
26457,disputes,0,0,7,7
5927,sarò,1,7,0,7
10779,संपादन,0,0,7,7
40687,टिप्पणी,0,0,7,7
3287,cina,1,7,0,7
19838,अमेरिकी,0,0,7,7
51225,fall,0,0,7,7
19836,medida,0,0,7,7
8406,ovviamente,1,7,0,7
5919,porta,1,7,0,7
2188,needs,2,1,6,7
29447,vos,0,0,7,7
41918,library,0,0,7,7
22429,três,0,0,7,7
29443,sagde,0,0,7,7
37154,موعد,0,0,7,7
19462,rätt,0,0,7,7
16610,experience,0,0,7,7
23135,fonds,0,0,7,7
21807,effort,0,0,7,7
5904,ridurre,1,7,0,7
7600,inductive,2,1,6,7
3009,guardando,1,7,0,7
18700,hendes,0,0,7,7
19822,donde,0,0,7,7
584,estensione,1,7,0,7
46738,zei,0,0,7,7
25170,விரும்புகிறேன்,0,0,7,7
4201,fondamentale,1,7,0,7
15888,språkversioner,0,0,7,7
13572,έξυπνες,0,0,7,7
48222,further,0,0,7,7
25000,autor,0,0,7,7
17954,وفقًا,0,0,7,7
38059,பிறகு,0,0,7,7
565,esterno,1,7,0,7
11836,جيد,0,0,7,7
27598,engel,0,0,7,7
39027,liens,0,0,7,7
4253,interna,2,6,1,7
11842,жизни,0,0,7,7
1560,consentono,1,7,0,7
7177,umane,1,7,0,7
38525,γωνία,0,0,7,7
26470,gün,0,0,7,7
21581,भाषाओँ,0,0,7,7
26930,service,0,0,7,7
21768,difícil,0,0,7,7
15035,utilisée,0,0,7,7
46071,result,0,0,7,7
27866,maddeler,0,0,7,7
44511,jusqu,0,0,7,7
22534,idag,0,0,7,7
19771,particulier,0,0,7,7
19495,complex,0,0,7,7
11825,suficiente,0,0,7,7
567,sforzi,1,7,0,7
12336,comparison,0,0,7,7
5031,consultare,1,7,0,7
51832,ತಿಳಿದಿಲ್ಲ,0,0,7,7
5859,ceo,2,3,4,7
29388,நிச்சயமாக,0,0,7,7
9395,limiti,1,7,0,7
42553,presque,0,0,7,7
12365,amount,0,0,7,7
24346,случае,0,0,7,7
5047,clustering,2,3,4,7
35686,doing,0,0,7,7
1874,offensivo,1,7,0,7
27581,எப்போதும்,0,0,7,7
39001,وهو,0,0,7,7
32271,geliyor,0,0,7,7
19802,händer,0,0,7,7
8104,semplice,1,7,0,7
20688,വേഡ്,0,0,7,7
5061,stupenda,1,7,0,7
51673,posibilidad,0,0,7,7
2593,effetto,1,7,0,7
12340,aller,0,0,7,7
3984,encarta,2,3,4,7
44889,विषय,0,0,7,7
44901,به,0,0,7,7
19848,andet,0,0,7,7
42577,científica,0,0,7,7
44356,ಚಿಂತಿಸಬೇಡಿ,0,0,7,7
41056,mind,0,0,7,7
36791,students,0,0,7,7
43720,aprender,0,0,7,7
9016,bloccato,1,7,0,7
32307,studie,0,0,7,7
33089,danke,0,0,7,7
26051,കഴിക്കാൻ,0,0,7,7
7268,positivi,1,7,0,7
1852,riferimenti,1,7,0,7
51733,acordo,0,0,7,7
25225,nieuwe,0,0,7,7
32649,aardig,0,0,7,7
6048,ore,1,7,0,7
15692,publications,0,0,7,7
39552,சதுப்பு,0,0,7,7
14163,once,0,0,7,7
876,fortemente,2,5,2,7
25711,systemic,0,0,7,7
24181,every,0,0,7,7
33282,virtual,0,0,7,7
1126,nomi,1,7,0,7
10861,publicado,0,0,7,7
1730,viaggio,1,7,0,7
1514,pae,2,3,4,7
44342,contributeur,0,0,7,7
32453,originally,0,0,7,7
10855,kvinnor,0,0,7,7
22293,altijd,0,0,7,7
46119,pergunta,0,0,7,7
2942,insider,2,3,4,7
17624,série,0,0,7,7
34267,following,0,0,7,7
2944,solare,1,7,0,7
26076,sexual,0,0,7,7
3679,budget,2,3,4,7
50792,overall,0,0,7,7
43740,الويكي,0,0,7,7
14422,ऐसी,0,0,7,7
1849,terreno,1,7,0,7
43735,moyens,0,0,7,7
35132,அழகாக,0,0,7,7
35349,два,0,0,7,7
43733,ಟೆರ್ರಿ,0,0,7,7
79,richiedono,1,7,0,7
6072,walsh,2,3,4,7
25270,യന്ത്രപഠന,0,0,7,7
6656,orribile,1,7,0,7
50779,together,0,0,7,7
10894,tiden,0,0,7,7
42609,yok,0,0,7,7
18860,mannen,0,0,7,7
1115,annunciato,1,7,0,7
28536,podría,0,0,7,7
4855,corpi,1,7,0,7
4950,periodo,1,7,0,7
6715,biosfera,1,7,0,7
33476,alguma,0,0,7,7
48120,mise,0,0,7,7
49627,عمل,0,0,7,7
15754,meus,0,0,7,7
26769,left,0,0,7,7
12913,leder,0,0,7,7
24225,ಕ್ಯಾಚ್,0,0,7,7
3828,future,2,1,6,7
5950,perplesso,1,7,0,7
20712,ye,0,0,7,7
4014,nostro,1,7,0,7
19850,hela,0,0,7,7
4913,proposto,1,7,0,7
33034,نهاية,0,0,7,7
19448,उसकी,0,0,7,7
104,zona,2,6,1,7
26554,table,0,0,7,7
40208,étudiants,0,0,7,7
13977,يمكنني,0,0,7,7
334,notato,1,7,0,7
11725,pris,0,0,7,7
30442,pense,0,0,7,7
24252,tree,0,0,7,7
52244,fortsätt,0,0,7,7
7233,cyberarts,2,3,4,7
40733,beter,0,0,7,7
2973,scoperte,1,7,0,7
34458,yolu,0,0,7,7
9939,espèces,0,0,7,7
352,scienziati,1,7,0,7
28550,mom,0,0,7,7
17739,tels,0,0,7,7
25201,contain,0,0,7,7
10847,अधिकांश,0,0,7,7
44379,используется,0,0,7,7
24197,dessutom,0,0,7,7
34653,avezvous,0,0,7,7
40148,uses,0,0,7,7
6696,sviluppare,1,7,0,7
33828,μαμά,0,0,7,7
19437,roll,0,0,7,7
31706,obtusa,0,0,7,7
13933,seja,0,0,7,7
13175,टेरी,0,0,7,7
21150,libres,0,0,7,7
7876,ambienti,1,7,0,7
48427,imágenes,0,0,7,7
44385,ανησυχείτε,0,0,7,7
23211,devient,0,0,7,7
22350,freunden,0,0,7,7
40736,vær,0,0,7,7
8571,relative,2,6,1,7
1010,partecipazione,1,7,0,7
8084,dov,1,7,0,7
7124,opposizione,1,7,0,7
12162,джимми,0,0,7,7
18433,उसने,0,0,7,7
34538,رائعة,0,0,7,7
16265,качестве,0,0,7,7
32962,ihrer,0,0,7,7
22707,começou,0,0,7,7
14071,dina,0,0,7,7
16070,forbløffende,0,0,7,7
33654,منها,0,0,7,7
27143,llamada,0,0,7,7
19602,കാരണം,0,0,7,7
18424,denken,0,0,7,7
10449,которых,0,0,7,7
8032,ampio,1,7,0,7
37302,möchte,0,0,7,7
36401,approaches,0,0,7,7
33399,voire,0,0,7,7
19604,தெரியாது,0,0,7,7
31346,encyclopedie,0,0,7,7
48369,calidad,0,0,7,7
6999,correzione,1,7,0,7
39227,riktlinjer,0,0,7,7
43369,verbete,0,0,7,7
18224,led,0,0,7,7
10437,gør,0,0,7,7
2690,simonite,2,3,4,7
24627,currents,0,0,7,7
7969,politico,1,7,0,7
13652,february,0,0,7,7
32761,naturels,0,0,7,7
36370,sería,0,0,7,7
40516,zwei,0,0,7,7
22678,¿por,0,0,7,7
43391,commercial,0,0,7,7
4233,riportato,1,7,0,7
32204,நடக்கிறது,0,0,7,7
51467,textos,0,0,7,7
27815,werden,0,0,7,7
10493,mensagem,0,0,7,7
47245,مجموعة,0,0,7,7
39258,स्थान,0,0,7,7
48352,जीवन,0,0,7,7
13651,likely,0,0,7,7
6881,user,2,1,6,7
6882,moderne,2,1,6,7
41827,búsqueda,0,0,7,7
24821,mode,0,0,7,7
39252,sker,0,0,7,7
10274,الخاصة,0,0,7,7
5343,riportava,1,7,0,7
38480,επόμενη,0,0,7,7
7017,terribile,1,7,0,7
35728,मुक्त,0,0,7,7
44654,junho,0,0,7,7
30925,ಉದಾಹರಣೆಗೆ,0,0,7,7
28927,fez,0,0,7,7
12085,αντί,0,0,7,7
1905,produzione,1,7,0,7
207,verità,1,7,0,7
39168,verwirrt,0,0,7,7
40442,proceso,0,0,7,7
24757,weiß,0,0,7,7
5453,probabilmente,1,7,0,7
27784,importantes,0,0,7,7
6958,incidente,2,5,2,7
36448,parece,0,0,7,7
6926,dorato,1,7,0,7
3913,collaborativa,1,7,0,7
6950,applicato,1,7,0,7
16235,ಮುಂದಿನ,0,0,7,7
14039,alltid,0,0,7,7
18308,meeting,0,0,7,7
32839,spørger,0,0,7,7
50494,следующий,0,0,7,7
3873,necessariamente,2,6,1,7
5485,sorte,2,1,6,7
995,etichette,1,7,0,7
22770,أمي,0,0,7,7
29009,weißt,0,0,7,7
34761,allowing,0,0,7,7
19627,aujourd,0,0,7,7
35219,snabbt,0,0,7,7
9235,usarlo,2,5,2,7
852,carr,2,2,5,7
12063,comunicación,0,0,7,7
10298,fantastiskt,0,0,7,7
45467,знаю,0,0,7,7
1607,letto,1,7,0,7
6991,sicurezza,1,7,0,7
7979,chiamate,1,7,0,7
34405,अच्छे,0,0,7,7
36425,συγγνώμη,0,0,7,7
1227,richard,2,2,5,7
1209,sostenuto,1,7,0,7
992,mcpherson,2,2,5,7
28947,такие,0,0,7,7
31350,статья,0,0,7,7
51946,inom,0,0,7,7
201,piattaforma,1,7,0,7
12058,இடத்தில்,0,0,7,7
35553,investigación,0,0,7,7
51648,καλό,0,0,7,7
49236,अगली,0,0,7,7
3142,divertente,1,7,0,7
43269,lavet,0,0,7,7
16118,sätze,0,0,7,7
227,fanno,1,7,0,7
6975,gruppi,1,7,0,7
19584,tant,0,0,7,7
7026,matematico,1,7,0,7
32946,சொல்லுங்கள்,0,0,7,7
24492,мама,0,0,7,7
26917,carruagem,0,0,7,7
25936,började,0,0,7,7
8444,stephen,2,2,5,7
862,fossi,1,7,0,7
6819,bravo,2,5,2,7
31870,maak,0,0,7,7
51196,ως,0,0,7,7
51793,умное,0,0,7,7
22594,task,0,0,7,7
18063,øjeblik,0,0,7,7
3748,soggetto,1,7,0,7
39330,meio,0,0,7,7
16424,involves,0,0,7,7
32250,numérique,0,0,7,7
52036,helemaal,0,0,7,7
40328,wel,0,0,7,7
5207,wikipediacom,2,3,4,7
14371,revisión,0,0,7,7
48520,sound,0,0,7,7
33671,fácil,0,0,7,7
45833,விக்கிப்பீடியாவின்,0,0,7,7
3548,negativi,1,7,0,7
32014,droits,0,0,7,7
37213,مشروع,0,0,7,7
48535,शादी,0,0,7,7
16425,début,0,0,7,7
51726,l’apprentissage,0,0,7,7
35558,सेंगर,0,0,7,7
24963,environ,0,0,7,7
144,composto,1,7,0,7
9106,istanze,1,7,0,7
20236,rapidement,0,0,7,7
35294,estiver,0,0,7,7
46720,لـ,0,0,7,7
2400,dunque,1,7,0,7
9114,codice,1,7,0,7
37802,escritos,0,0,7,7
280,aumenta,2,6,1,7
35293,numbers,0,0,7,7
20667,tenía,0,0,7,7
39360,बजाय,0,0,7,7
7624,mettere,1,7,0,7
3046,prevedere,1,7,0,7
39047,почему,0,0,7,7
27858,pregunta,0,0,7,7
5163,lasciato,1,7,0,7
32602,तब,0,0,7,7
840,paura,1,7,0,7
49658,مليون,0,0,7,7
42067,permettent,0,0,7,7
26920,neden,0,0,7,7
40314,repetir,0,0,7,7
44568,minutos,0,0,7,7
18519,diffusion,0,0,7,7
9310,vero,1,7,0,7
36352,performing,0,0,7,7
24553,πάντα,0,0,7,7
47379,आपकी,0,0,7,7
32538,parler,0,0,7,7
2326,associazioni,1,7,0,7
7962,vocale,2,6,1,7
10235,collaboration,0,0,7,7
176,zero,2,4,3,7
25911,escrito,0,0,7,7
2633,descritto,1,7,0,7
32587,cause,0,0,7,7
49886,உன்னை,0,0,7,7
1931,contribuito,1,7,0,7
39315,brød,0,0,7,7
45487,votación,0,0,7,7
42492,إنشاء,0,0,7,7
7666,unica,1,7,0,7
49939,сегодня,0,0,7,7
51654,терри,0,0,7,7
34768,sistemas,0,0,7,7
7636,superiore,1,7,0,7
38087,linguistique,0,0,7,7
18472,representation,0,0,7,7
18174,المقالات،,0,0,7,7
52299,administrators,0,0,7,7
8459,overfitting,2,4,3,7
21654,rapport,0,0,7,7
690,sforzo,1,7,0,7
49881,المعلومات,0,0,7,7
25923,mostly,0,0,7,7
3073,ultime,2,6,1,7
51941,الخبز,0,0,7,7
30981,fundação,0,0,7,7
43174,zinnen,0,0,7,7
12235,सपना,0,0,7,7
50617,seulement,0,0,7,7
10217,آخر,0,0,7,7
44578,again,0,0,7,7
46658,associated,0,0,7,7
24532,unido,0,0,7,7
11929,meinen,0,0,7,7
5684,messenger,2,3,4,7
5682,discutere,1,7,0,7
18099,ihm,0,0,7,7
50612,innehållet,0,0,7,7
24878,فظيعة,0,0,7,7
38234,पहला,0,0,7,7
22936,одна,0,0,7,7
172,film,2,4,3,7
34203,années,0,0,7,7
8457,obiettivi,1,7,0,7
3500,mantiene,2,4,3,7
38344,പറഞ്ഞു,0,0,7,7
3122,frequenti,1,7,0,7
18993,cited,0,0,7,7
41429,carruaje,0,0,7,7
13823,ನುಡಿಗಟ್ಟು,0,0,7,7
44128,rien,0,0,7,7
19996,लाख,0,0,7,7
47786,diskussioner,0,0,7,7
3783,festival,2,3,4,7
48856,avaient,0,0,7,7
37084,brugere,0,0,7,7
36021,φίλους,0,0,7,7
49579,años,0,0,7,7
41330,ഇത്തരം,0,0,7,7
6383,sarebbero,1,7,0,7
6599,variabili,1,7,0,7
19990,nature »,0,0,7,7
34308,idée,0,0,7,7
8198,awards,2,3,4,7
49151,دائمًا,0,0,7,7
13749,year,0,0,7,7
38325,kelimeyi,0,0,7,7
1836,classificati,1,7,0,7
2510,paradigmi,1,7,0,7
21347,thus,0,0,7,7
8931,pronto,2,2,5,7
43866,vilken,0,0,7,7
35922,संचालित,0,0,7,7
26626,smuk,0,0,7,7
50133,programs,0,0,7,7
39890,intelligents,0,0,7,7
8345,fortuna,2,5,2,7
26696,organization,0,0,7,7
3948,iniziale,1,7,0,7
29865,ಕನಸು,0,0,7,7
7777,superando,2,5,2,7
39975,willen,0,0,7,7
2231,concentra,1,7,0,7
30360,лучше,0,0,7,7
23962,വളരെയധികം,0,0,7,7
15289,boos,0,0,7,7
42843,provide,0,0,7,7
11031,முடியவில்லை,0,0,7,7
52138,wikipedians,0,0,7,7
17454,первоначально,0,0,7,7
52393,ಹೆಚ್ಚು,0,0,7,7
4123,capo,1,7,0,7
24019,acadêmicos,0,0,7,7
19977,बना,0,0,7,7
4369,implica,2,6,1,7
30353,उनके,0,0,7,7
826,eckart,2,2,5,7
23440,சிறந்த,0,0,7,7
37040,jeu,0,0,7,7
23765,exist,0,0,7,7
42151,चाहिए,0,0,7,7
4649,campione,1,7,0,7
3378,trovano,1,7,0,7
4118,protezione,1,7,0,7
4652,seguenti,1,7,0,7
50215,observations,0,0,7,7
47851,maison,0,0,7,7
49286,compte,0,0,7,7
8851,biology,2,1,6,7
39651,stating,0,0,7,7
1785,citazioni,1,7,0,7
33240,estivesse,0,0,7,7
19162,कहते,0,0,7,7
26137,drie,0,0,7,7
1369,dominio,2,6,1,7
25658,जिमी,0,0,7,7
12608,لي,0,0,7,7
23475,across,0,0,7,7
2841,http,2,2,5,7
1367,equivalente,2,6,1,7
2251,tende,2,6,1,7
17269,ζωή,0,0,7,7
4628,william,2,3,4,7
47858,जिस,0,0,7,7
23460, billion,0,0,7,7
23770,qualidade,0,0,7,7
28119,मीडिया,0,0,7,7
3644,connessione,1,7,0,7
40007,visar,0,0,7,7
20081,января,0,0,7,7
15412,അതിനർത്ഥം,0,0,7,7
34005,dezembro,0,0,7,7
51560,teşekkürler,0,0,7,7
19103,materials,0,0,7,7
39917,सुंदर,0,0,7,7
1469,html,2,2,5,7
20911,использования,0,0,7,7
36923,बता,0,0,7,7
21467,другой,0,0,7,7
15440,cual,0,0,7,7
29776,хотя,0,0,7,7
6276,descrivono,1,7,0,7
6557,sole,1,7,0,7
4525,electronica,2,3,4,7
34597,began,0,0,7,7
2020,riceve,1,7,0,7
4527,big,2,3,4,7
30694,êtres,0,0,7,7
42181,ಅವರಿಗೆ,0,0,7,7
19052,sejam,0,0,7,7
11400,rédacteurs,0,0,7,7
27344,tatlı,0,0,7,7
22102,donner,0,0,7,7
45688,नहीं।,0,0,7,7
39929,दोस्त,0,0,7,7
31840,ولا,0,0,7,7
4486,stanford,2,3,4,7
8236,vediamo,1,7,0,7
11386,reino,0,0,7,7
2205,ei,2,4,3,7
28285,आगे,0,0,7,7
4496,saggio,1,7,0,7
52458,uppslagsverket,0,0,7,7
4116,pubblica,1,7,0,7
7423,classificare,1,7,0,7
42189,ber,0,0,7,7
3883,cc,2,3,4,7
52531,bare,0,0,7,7
52457,bank,0,0,7,7
37748,absence,0,0,7,7
33517,contre,0,0,7,7
38021,знаете,0,0,7,7
25612,oficial,0,0,7,7
26344,cruel,0,0,7,7
45666,всегда,0,0,7,7
4434,chiamare,1,7,0,7
39706,mening,0,0,7,7
33756,പറയുന്നു,0,0,7,7
4022,esistenti,1,7,0,7
4158,preoccupazioni,1,7,0,7
30705,проекты,0,0,7,7
38268,നല്ല,0,0,7,7
43873,användas,0,0,7,7
40884,которой,0,0,7,7
2887,anomalie,1,7,0,7
11172,दुनिया,0,0,7,7
39700,niveau,0,0,7,7
14203,ವ್ಯಕ್ತಿಯನ್ನು,0,0,7,7
2032,atlantic,2,2,5,7
11353,imagen,0,0,7,7
12635,makes,0,0,7,7
17058,talk,0,0,7,7
36000,consulter,0,0,7,7
45278,terms,0,0,7,7
8222,katherine,2,3,4,7
32708,find,0,0,7,7
45151,tar,0,0,7,7
50882,effect,0,0,7,7
27025,estàdire,0,0,7,7
7453,figure,2,2,5,7
14534,sorgen,0,0,7,7
46530,போன்ற,0,0,7,7
11419,समीक्षा,0,0,7,7
34313,therefore,0,0,7,7
4447,utilizzano,1,7,0,7
6263,writing,2,1,6,7
13761,ocasiones,0,0,7,7
23844,colaboradores,0,0,7,7
442,stream,2,1,6,7
26132,programas,0,0,7,7
4549,modalità,1,7,0,7
440,nascita,1,7,0,7
19119,spise,0,0,7,7
19354,ذات,0,0,7,7
41434,हुआ,0,0,7,7
39632,wikiscanner,0,0,7,7
29646,ദൈനംദിന,0,0,7,7
9833,científicos,0,0,7,7
15607,résultat,0,0,7,7
6623,risoluzione,1,7,0,7
7334,supervisione,1,7,0,7
30180,अत्याचारी,0,0,7,7
17137,أعتقد,0,0,7,7
21518,ಪದಗಳು,0,0,7,7
50242,german,0,0,7,7
4736,statistico,1,7,0,7
8660,susningnu,2,3,4,7
4334,continuo,1,7,0,7
15355,dine,0,0,7,7
44302,до,0,0,7,7
16854,значит,0,0,7,7
11597,anderen,0,0,7,7
46570,καθώς,0,0,7,7
8358,scientifico,1,7,0,7
26186,quoi,0,0,7,7
18934,forfærdeligt,0,0,7,7
34606,collection,0,0,7,7
15359,ensuite,0,0,7,7
41346,frågar,0,0,7,7
13219,neste,0,0,7,7
28431,carriage,0,0,7,7
23712,verärgert,0,0,7,7
26648,تعلم,0,0,7,7
19367,ربما,0,0,7,7
50822,भोजन,0,0,7,7
29926,decirle,0,0,7,7
2221,ufficiali,1,7,0,7
28155,submergé,0,0,7,7
6125,suoni,1,7,0,7
8800,città,1,7,0,7
13529,drøm,0,0,7,7
8366,disposizione,1,7,0,7
34838,जिसमें,0,0,7,7
8835,college,2,3,4,7
13234,estilo,0,0,7,7
41952,hoek,0,0,7,7
33001,reinforcement,0,0,7,7
47828,liquid,0,0,7,7
49572,εαυτό,0,0,7,7
29628,distribution,0,0,7,7
36072,mobila,0,0,7,7
2927,piano,1,7,0,7
17576,increasingly,0,0,7,7
33078,обучение,0,0,7,7
3588,narcissa,2,2,5,7
28020,segundo,0,0,7,7
17596,laat,0,0,7,7
25675,doesn,0,0,7,7
20444,développé,0,0,7,7
17568,potential,0,0,7,7
38163,properties,0,0,7,7
9580,vivente,1,7,0,7
40976,عليها,0,0,7,7
31116,फाउंडेशन,0,0,7,7
34642,keer,0,0,7,7
31524,håller,0,0,7,7
4180,apache,2,1,6,7
42632,siden,0,0,7,7
2,singola,1,7,0,7
49414,ಪದಗಳನ್ನು,0,0,7,7
7500,sun,2,1,6,7
7717,genetici,1,7,0,7
2461,assenza,1,7,0,7
14491,என்பதை,0,0,7,7
4672,imparato,1,7,0,7
34568,principes,0,0,7,7
30519,einige,0,0,7,7
44049,second,0,0,7,7
17117,particulière,0,0,7,7
4747,complessa,1,7,0,7
37613,കാര്യങ്ങൾ,0,0,7,7
21396,ആരെയെങ്കിലും,0,0,7,7
620,nonché,1,7,0,7
36857,criticized,0,0,7,7
38039,tekrar,0,0,7,7
49695,alsof,0,0,7,7
3890,atto,1,7,0,7
29911,gewoon,0,0,7,7
25571,جيدة,0,0,7,7
6612,alias,2,4,3,7
25292,upon,0,0,7,7
7349,vector,2,1,6,7
48010,upset,0,0,7,7
3376,p,2,5,2,7
13246,bodies,0,0,7,7
9805,при,0,0,7,7
4345,significativa,2,5,2,7
3692,collaboratore,1,7,0,7
15329,gånger,0,0,7,7
29596,nett,0,0,7,7
48523,máquinas,0,0,6,6
6330,penso,2,5,1,6
15002,ಹಾಗೆ,0,0,6,6
5524,brown,2,3,3,6
43181,définition,0,0,6,6
5716,migliora,1,6,0,6
6925,giù,1,6,0,6
32065,معلومات,0,0,6,6
30627,wagen,0,0,6,6
46894,ordre,0,0,6,6
3110,unico,1,6,0,6
21743,upprepa,0,0,6,6
42720,пока,0,0,6,6
22638,måske,0,0,6,6
45154,¿te,0,0,6,6
46883,maman,0,0,6,6
5675,crudele,1,6,0,6
8662,classico,1,6,0,6
6453,sesto,1,6,0,6
44789,författare,0,0,6,6
503,mezzi,1,6,0,6
43178,yani,0,0,6,6
14958,produit,0,0,6,6
22037,στα,0,0,6,6
50486,हूँ।,0,0,6,6
33753,угол,0,0,6,6
41888,modification,0,0,6,6
41880,ನಾರ್ಸಿಸಸ್,0,0,6,6
6312,probabilistico,1,6,0,6
36484,εκ,0,0,6,6
21252,അനേകം,0,0,6,6
19108,تحصل,0,0,6,6
7956,umanità,1,6,0,6
21087,leben,0,0,6,6
37256,redigera,0,0,6,6
36475,tus,0,0,6,6
50155,coisas,0,0,6,6
6316,lago,1,6,0,6
51472,harder,0,0,6,6
9307,distribuire,1,6,0,6
26286,gick,0,0,6,6
20272,daran,0,0,6,6
45832,sábado,0,0,6,6
21931,environnement,0,0,6,6
38623,hitta,0,0,6,6
46396,mettre,0,0,6,6
29002,άλλες,0,0,6,6
7670,bambini,1,6,0,6
13600,hjälpa,0,0,6,6
21752,начала,0,0,6,6
43157,discussion,0,0,6,6
32016,différents,0,0,6,6
8641,america,2,4,2,6
45907,ಅಂದರೆ,0,0,6,6
37255,είχε,0,0,6,6
1629,visitati,1,6,0,6
9535,aristotele,1,6,0,6
31646,enciclopédias,0,0,6,6
6447,aggiunto,1,6,0,6
18517,decisions,0,0,6,6
10338,जून,0,0,6,6
45206,abril,0,0,6,6
31590,auteurs,0,0,6,6
45138,four,0,0,6,6
515,messo,1,6,0,6
6322,appropriate,2,1,5,6
19294,beskriver,0,0,6,6
29005,؛,0,0,6,6
24754,eerste,0,0,6,6
44712,experter,0,0,6,6
26890,amigo,0,0,6,6
44814,விரும்பவில்லை,0,0,6,6
28817,hallo,0,0,6,6
16143,आपका,0,0,6,6
41455,ಜೀವನದಲ್ಲಿ,0,0,6,6
49005,критики,0,0,6,6
37737,só,0,0,6,6
3557,critica,1,6,0,6
25847,icke,0,0,6,6
35214,തിരഞ്ഞെടുത്ത,0,0,6,6
6393,carlos,2,2,4,6
9277,edwin,2,3,3,6
19169,moyen,0,0,6,6
34501,vandalisme,0,0,6,6
44743,गलत,0,0,6,6
41149,fille,0,0,6,6
51063,مؤسسة,0,0,6,6
427,vapore,1,6,0,6
5612,wikiversity,2,4,2,6
41986,describe,0,0,6,6
30534,acuerdo,0,0,6,6
48450,initially,0,0,6,6
6419,pensavo,1,6,0,6
52302,φορά,0,0,6,6
51166,നാർസിസസ്,0,0,6,6
5614,stile,1,6,0,6
6384,klein,2,2,4,6
6883,identificare,1,6,0,6
15357,продолжайте,0,0,6,6
3084,domesday,2,2,4,6
6503,preoccupata,1,6,0,6
43252,entry,0,0,6,6
36999,única,0,0,6,6
19587,этим,0,0,6,6
1641,speciale,2,4,2,6
32205,могли,0,0,6,6
48863,characteristic,0,0,6,6
42470,методы,0,0,6,6
25583,उसके,0,0,6,6
14975,whole,0,0,6,6
26489,soms,0,0,6,6
1643,logico,1,6,0,6
14070,सैक्सन,0,0,6,6
9624,descrizione,1,6,0,6
6898,potenziale,1,6,0,6
1647,teorici,1,6,0,6
6892,arthur,2,4,2,6
48458,πω,0,0,6,6
19179,datum,0,0,6,6
21255,context,0,0,6,6
5594,lettore,1,6,0,6
46851,criar,0,0,6,6
13479,brain,0,0,6,6
1642,wired,2,2,4,6
25846,بطيئة,0,0,6,6
36993,factors,0,0,6,6
25578,помочь,0,0,6,6
47254,ಮರಿಯನ್,0,0,6,6
34074,d’un,0,0,6,6
43201,часть,0,0,6,6
51454,статье,0,0,6,6
43277,istiyorsanız,0,0,6,6
44782,fiabilité,0,0,6,6
50137,günlük,0,0,6,6
9263,collaborativo,1,6,0,6
27828,neutralité,0,0,6,6
28975,கேட்ச்,0,0,6,6
20280,savez,0,0,6,6
42732,الأمر,0,0,6,6
46848,мире,0,0,6,6
36579,relacionados,0,0,6,6
6514,dì,1,6,0,6
6477,motore,1,6,0,6
6515,listen,2,3,3,6
6352,fiumi,1,6,0,6
12990,englishlanguage,0,0,6,6
19127,grupos,0,0,6,6
6857,rifiuta,1,6,0,6
37020,beautiful,0,0,6,6
226,sviluppate,1,6,0,6
52539,aider,0,0,6,6
38629,mehr,0,0,6,6
8507,guai,1,6,0,6
52273,ದಯವಿಟ್ಟು,0,0,6,6
45882,chamado,0,0,6,6
6865,determinato,1,6,0,6
1804,avesse,1,6,0,6
31875,खेद,0,0,6,6
1057,rappresenta,1,6,0,6
34534,tradicionais,0,0,6,6
50105,artificielle,0,0,6,6
44734,fortsæt,0,0,6,6
245,modificato,1,6,0,6
6877,fondatore,1,6,0,6
6876,conosci,1,6,0,6
6427,cambiato,1,6,0,6
27036,leuk,0,0,6,6
28878,dagelijks,0,0,6,6
25596,жаль,0,0,6,6
18360,mesa,0,0,6,6
9652,enciclopedico,1,6,0,6
41978,mach,0,0,6,6
9572,dà,1,6,0,6
14075,dear,0,0,6,6
28166,partes,0,0,6,6
5546,ritiene,1,6,0,6
3629,desiderato,1,6,0,6
43189,portanto,0,0,6,6
22013,बीच,0,0,6,6
26492,telefon,0,0,6,6
20572,comes,0,0,6,6
42707,εσάς,0,0,6,6
41488,colaboración,0,0,6,6
6806,arrivato,1,6,0,6
755,offensive,2,3,3,6
26977,lassen,0,0,6,6
51511,secreto,0,0,6,6
19431,respectively,0,0,6,6
31265,belki,0,0,6,6
26442,ಬಾರಿ,0,0,6,6
31071,शानदार,0,0,6,6
7880,sopraffatto,1,6,0,6
15192,nearly,0,0,6,6
5971,disaccordo,1,6,0,6
47060,आपसे,0,0,6,6
31247,willst,0,0,6,6
35803,évolution,0,0,6,6
5964,iniziare,1,6,0,6
27945,required,0,0,6,6
51243,träge,0,0,6,6
6708,indicato,1,6,0,6
6700,sofisticato,1,6,0,6
22340,undersökning,0,0,6,6
28561,opposition,0,0,6,6
37787,yine,0,0,6,6
12901,gentage,0,0,6,6
34786,alemão,0,0,6,6
7833,totalmente,2,3,3,6
32677,actions,0,0,6,6
36845,allons,0,0,6,6
6697,interne,2,4,2,6
5988,modificata,1,6,0,6
1842,hardware,2,4,2,6
48750,ortaklaşa,0,0,6,6
9411,mira,1,6,0,6
38791,φορές,0,0,6,6
22208,instance,0,0,6,6
42885,meaning,0,0,6,6
42591,little,0,0,6,6
7696,neutralità,1,6,0,6
18775,kelimeler,0,0,6,6
15575,μόνο,0,0,6,6
9478,entità,1,6,0,6
50209,جيمي,0,0,6,6
38952,बेटी,0,0,6,6
41920,tenha,0,0,6,6
42574,esprit,0,0,6,6
8616,ciascuna,1,6,0,6
38554,simplement,0,0,6,6
15548,ligesom,0,0,6,6
9396,gabriel,2,2,4,6
40682,diciendo,0,0,6,6
10016,experiencia,0,0,6,6
5912,documentazione,1,6,0,6
46955,plutôt,0,0,6,6
30372,market,0,0,6,6
15092,attention,0,0,6,6
25372,administratorer,0,0,6,6
28607,terrible,0,0,6,6
25365,αργή,0,0,6,6
6180,indipendentemente,1,6,0,6
15758,europe,0,0,6,6
7885,vestito,1,6,0,6
42033,विध्वंस,0,0,6,6
15567,ಯಾವಾಗಲೂ,0,0,6,6
7826,lawrence,2,2,4,6
32045,segunda,0,0,6,6
28405,ಏಕೆ,0,0,6,6
49559,содержания,0,0,6,6
35021,train,0,0,6,6
19449,daughter,0,0,6,6
32632,visitors,0,0,6,6
3755,education,2,2,4,6
14318,realizada,0,0,6,6
42642,linear,0,0,6,6
12899,net,0,0,6,6
18931,καθημερινή,0,0,6,6
7822,pagamento,1,6,0,6
38795,capacité,0,0,6,6
48717,ദയവായി,0,0,6,6
42925,créée,0,0,6,6
28481,slowly,0,0,6,6
9880,jezelf,0,0,6,6
40802,стороны,0,0,6,6
38818,ocupado,0,0,6,6
7844,sette,1,6,0,6
40771,ಅವಳ,0,0,6,6
30517,думаю,0,0,6,6
7854,controversi,1,6,0,6
25695,indo,0,0,6,6
1034,altoparlante,1,6,0,6
6062,suite,2,1,5,6
32734,protection,0,0,6,6
19382,νούμερο,0,0,6,6
7846,venerdì,1,6,0,6
1736,radici,1,6,0,6
37111,rapports,0,0,6,6
42025,sidan,0,0,6,6
50018,frage,0,0,6,6
15641,modern,0,0,6,6
9861,upprörd,0,0,6,6
22287,içinde,0,0,6,6
6089,ios,2,3,3,6
38576,सही,0,0,6,6
6103,velocità,1,6,0,6
33264,humains,0,0,6,6
38832,supervisado,0,0,6,6
25302,déjame,0,0,6,6
15161,επιδιόρθωση,0,0,6,6
51528,freaked,0,0,6,6
15648,frères,0,0,6,6
26421,конечно,0,0,6,6
50261,привет,0,0,6,6
1740,ringraziare,1,6,0,6
48702,ಕ್ಷಣ,0,0,6,6
9466,collaboratori,1,6,0,6
6019,attribuzione,1,6,0,6
9930,projecten,0,0,6,6
38805,методов,0,0,6,6
50279,desarrollo,0,0,6,6
15183,عبر,0,0,6,6
7866,traduzione,1,6,0,6
28537,ചെയ്യുന്നത്,0,0,6,6
34132,ejemplos,0,0,6,6
33740,yanı,0,0,6,6
22324,agit,0,0,6,6
8582,troviamo,1,6,0,6
48949,five,0,0,6,6
9417,netflix,2,3,3,6
45344,ಚೆನ್ನಾಗಿ,0,0,6,6
42952,wilderness,0,0,6,6
14308,சாங்கர்,0,0,6,6
28504,meilleur,0,0,6,6
46767,probabilistic,0,0,6,6
6121,robert,2,3,3,6
6667,direttamente,1,6,0,6
31255,حصلت,0,0,6,6
48698,contra,0,0,6,6
6669,höfling,2,2,4,6
9460,operazioni,1,6,0,6
4034,alternative,2,3,3,6
42893,ever,0,0,6,6
1743,fronte,1,6,0,6
40816,certaine,0,0,6,6
6031,computational,2,1,5,6
42601,musst,0,0,6,6
35801,noite,0,0,6,6
6681,immagino,1,6,0,6
7898,archaea,2,3,3,6
5903,ecco,1,6,0,6
12829,grader,0,0,6,6
35559,endast,0,0,6,6
15485,प्रयास,0,0,6,6
1830,suggerisce,1,6,0,6
45025,दोनों,0,0,6,6
284,sembrava,1,6,0,6
28738,இன்று,0,0,6,6
6807,bush,2,2,4,6
15484,difficult,0,0,6,6
6559,heilman,2,3,3,6
42516,vestido,0,0,6,6
14108,alguna,0,0,6,6
19053,ise,0,0,6,6
3045,alberi,1,6,0,6
281,watson,2,3,3,6
45271,milhão,0,0,6,6
32055,groups,0,0,6,6
44856,fields,0,0,6,6
2140,aria,1,6,0,6
12308,tekst,0,0,6,6
46798,units,0,0,6,6
30235,αυτά,0,0,6,6
25635,hjælpe,0,0,6,6
25423,القول,0,0,6,6
8681,apportare,1,6,0,6
47153,leitores,0,0,6,6
21773,dröm,0,0,6,6
6262,scrivere,1,6,0,6
3857,ecologico,1,6,0,6
1880,economico,1,6,0,6
25784,dochter,0,0,6,6
36670,anses,0,0,6,6
35102,ऐसे,0,0,6,6
10128,യന്ത്രപഠനം,0,0,6,6
44861,génial,0,0,6,6
7935,aa,1,6,0,6
1680,esplicitamente,1,6,0,6
24958,أفعل,0,0,6,6
31157,gjorde,0,0,6,6
45264,позже,0,0,6,6
20542,culturelle,0,0,6,6
38729,octobre,0,0,6,6
8534,usi,1,6,0,6
52595,rivers,0,0,6,6
33344,രസകരമായ,0,0,6,6
6821,samuel,2,4,2,6
15024,vem,0,0,6,6
6822,gestione,1,6,0,6
32721,beauté,0,0,6,6
37059,corriger,0,0,6,6
2705,biblioteche,1,6,0,6
1668,attive,1,6,0,6
5723,citazione,1,6,0,6
36928,നിമിഷം,0,0,6,6
1775,riconoscere,1,6,0,6
52233,വീണ്ടും,0,0,6,6
28751,cuanto,0,0,6,6
42667,completely,0,0,6,6
9332,regolarmente,1,6,0,6
19539,quatre,0,0,6,6
5759,native,2,1,5,6
31010,الموسوعة,0,0,6,6
42668,однако,0,0,6,6
887,personal,2,1,5,6
46329,gesagt,0,0,6,6
18564,randevu,0,0,6,6
28759,wo,0,0,6,6
28760,ponds,0,0,6,6
14104,características,0,0,6,6
40926,знаешь,0,0,6,6
15464,olur,0,0,6,6
32090,иногда,0,0,6,6
33984,voy,0,0,6,6
12403,viendo,0,0,6,6
20528,yardım,0,0,6,6
5878,latine,2,3,3,6
31033,അവിടെ,0,0,6,6
43034,técnicas,0,0,6,6
2894,riuscito,1,6,0,6
52431,compris,0,0,6,6
49555,majority,0,0,6,6
9763,remember,0,0,6,6
50347,savoir,0,0,6,6
49978,कभी,0,0,6,6
6582,record,2,3,3,6
45288,شخصًا,0,0,6,6
52024,വിഷമിക്കേണ്ട,0,0,6,6
8716,intende,1,6,0,6
1872,serve,2,5,1,6
15838,endişelenme,0,0,6,6
6587,indipendenti,1,6,0,6
9766,tochter,0,0,6,6
44919,അതിൽ,0,0,6,6
488,interfaccia,1,6,0,6
8693,modificabile,1,6,0,6
42850,संग्रह,0,0,6,6
20340,snel,0,0,6,6
30562,clusters,0,0,6,6
15205,machen,0,0,6,6
12398,vivant,0,0,6,6
6594,preferita,1,6,0,6
26997,اللغات,0,0,6,6
745,clifford,2,2,4,6
3875,somma,1,6,0,6
1020,perl,2,2,4,6
3856,piccole,1,6,0,6
35687,λέτε,0,0,6,6
40862,altid,0,0,6,6
22153,diskussionssidor,0,0,6,6
48973,இரண்டு,0,0,6,6
6762,riflettere,1,6,0,6
12956,ни,0,0,6,6
47140,അവരുടെ,0,0,6,6
39006,prodigieux,0,0,6,6
51622,genial,0,0,6,6
22144,femmes,0,0,6,6
3874,basso,1,6,0,6
33784,criação,0,0,6,6
3785,entrambe,1,6,0,6
49969,इस्तेमाल,0,0,6,6
41469,predict,0,0,6,6
39021,δείτε,0,0,6,6
12957,ability,0,0,6,6
42533,пожалуйста,0,0,6,6
43078,bilder,0,0,6,6
6787,esperimento,1,6,0,6
12345,herhangi,0,0,6,6
2087,dispiacerebbe,1,6,0,6
7909,fondata,1,6,0,6
32026,दो।,0,0,6,6
33995,മറ്റു,0,0,6,6
12633,montre,0,0,6,6
9367,relazioni,1,6,0,6
15222,connaissances,0,0,6,6
2113,stima,1,6,0,6
3771,indipendente,1,6,0,6
20516,याद,0,0,6,6
7914,cronologia,1,6,0,6
32025,successful,0,0,6,6
6235,progresso,1,6,0,6
5841,neurale,1,6,0,6
15508,continents,0,0,6,6
2723,colto,1,6,0,6
36901,είπε,0,0,6,6
8290,pew,2,2,4,6
29116,тем,0,0,6,6
3123,quadriga,2,2,4,6
16727,ಕೇಳಲು,0,0,6,6
4849,rappresentato,1,6,0,6
13179,científicas,0,0,6,6
92,precisa,2,3,3,6
32459,definition,0,0,6,6
4842,diventa,1,6,0,6
3494,ospitare,1,6,0,6
4839,governo,2,5,1,6
11640,usan,0,0,6,6
7260,ospita,1,6,0,6
23227,مكان,0,0,6,6
1976,coniato,1,6,0,6
41621,домой,0,0,6,6
20198,œuvre,0,0,6,6
49796,चाहिए।,0,0,6,6
35532,trend,0,0,6,6
3329,però,1,6,0,6
1333,rendere,1,6,0,6
45772,incroyable,0,0,6,6
48092,range,0,0,6,6
13177,volunteer,0,0,6,6
17711,formas,0,0,6,6
43693,specifically,0,0,6,6
36152,organizations,0,0,6,6
16684,hjem,0,0,6,6
32467,ham,0,0,6,6
34893,kära,0,0,6,6
26236,weinen,0,0,6,6
24200,crying,0,0,6,6
44380,plats,0,0,6,6
8142,creando,2,4,2,6
30477,previously,0,0,6,6
44377,fortæller,0,0,6,6
50748,action,0,0,6,6
41616,wikipedistas,0,0,6,6
47567,पसंद,0,0,6,6
37916,need,0,0,6,6
20727,بطريقة,0,0,6,6
3845,usati,1,6,0,6
34360,individual,0,0,6,6
13921,वर्णन,0,0,6,6
46243,artiklarnas,0,0,6,6
27490,skarp,0,0,6,6
24131,وفي,0,0,6,6
34352,рандеву,0,0,6,6
4761,nsa,2,3,3,6
7300,ricevere,1,6,0,6
4752,esattamente,1,6,0,6
23335,increase,0,0,6,6
17613,rule,0,0,6,6
36093,hör,0,0,6,6
40086,okej,0,0,6,6
3354,nazionali,1,6,0,6
1352,costantemente,1,6,0,6
1987,scritta,1,6,0,6
45629,illustrations,0,0,6,6
30300,horrible,0,0,6,6
48042,latest,0,0,6,6
29618,да,0,0,6,6
14643,அவளுடைய,0,0,6,6
7323,prenderlo,1,6,0,6
4763,incrociate,1,6,0,6
11607,извините,0,0,6,6
42284,говорите,0,0,6,6
38353,looked,0,0,6,6
52373,vagnen,0,0,6,6
26056,squid,0,0,6,6
16756,ελεύθερης,0,0,6,6
4799,franco,2,2,4,6
7282,intitolato,1,6,0,6
32310,differences,0,0,6,6
27488,efforts,0,0,6,6
36114,haven,0,0,6,6
13390,சாப்பிட,0,0,6,6
36105,മന്ദഗതിയിലുള്ള,0,0,6,6
33085,língua,0,0,6,6
33838,разных,0,0,6,6
29580,själv,0,0,6,6
77,inclusa,1,6,0,6
3580,rendering,2,3,3,6
16772,entries,0,0,6,6
828,popolari,1,6,0,6
4888,errate,1,6,0,6
42092,realidad,0,0,6,6
7326,telefono,1,6,0,6
16572,mí,0,0,6,6
14759,deste,0,0,6,6
17890,ನಿಧಾನಗತಿಯ,0,0,6,6
20224,generalization,0,0,6,6
30600,vraag,0,0,6,6
5013,portoghese,1,6,0,6
39468,gik,0,0,6,6
43595,experts,0,0,6,6
47495,ഗണിത,0,0,6,6
2582,corrispondente,1,6,0,6
4892,ricordati,1,6,0,6
48165,kære,0,0,6,6
2186,pubblicare,1,6,0,6
11766,poäng,0,0,6,6
582,cellule,1,6,0,6
8119,giornalisti,1,6,0,6
17848,please,0,0,6,6
8409,san,2,2,4,6
31705,valeur,0,0,6,6
9077,indica,2,3,3,6
783,continenti,1,6,0,6
34369,values,0,0,6,6
29393,ரெண்டெஸ்வஸ்,0,0,6,6
13680,populaire,0,0,6,6
23078,منك,0,0,6,6
34546,தொகுப்புக்கள்,0,0,6,6
17919,contribuintes,0,0,6,6
21316,iki,0,0,6,6
14772,instances,0,0,6,6
19804,இல்,0,0,6,6
31699,referred,0,0,6,6
16525,labels,0,0,6,6
47472,sefere,0,0,6,6
40265,τότε,0,0,6,6
51724,друзьями,0,0,6,6
40263,vanliga,0,0,6,6
571,abilità,1,6,0,6
27573,resultados,0,0,6,6
3802,documenti,1,6,0,6
7609,scala,1,6,0,6
26786,blevet,0,0,6,6
21325,بالفعل,0,0,6,6
46086,emploi,0,0,6,6
1313,icona,1,6,0,6
4925,scoprire,1,6,0,6
41777,obras,0,0,6,6
4919,economic,2,1,5,6
39520,ദിവസം,0,0,6,6
9044,determinare,1,6,0,6
24214,droit,0,0,6,6
34550,पाठ,0,0,6,6
4909,€,2,2,4,6
17753,argued,0,0,6,6
32468,sett,0,0,6,6
4905,universal,2,1,5,6
17750,added,0,0,6,6
16675,egen,0,0,6,6
4897,dominante,2,3,3,6
29493,regras,0,0,6,6
43298,kommentar,0,0,6,6
1316,terrestri,1,6,0,6
959,sarei,1,6,0,6
10799,லாரி,0,0,6,6
4972,carico,1,6,0,6
32295,λες,0,0,6,6
19833,около,0,0,6,6
3285,potere,1,6,0,6
48144,six,0,0,6,6
24267,vandalismos,0,0,6,6
10777,samt,0,0,6,6
36182,études,0,0,6,6
16631,jam,0,0,6,6
27531,πάω,0,0,6,6
26027,utilise,0,0,6,6
40218,kendini,0,0,6,6
13950,canal,0,0,6,6
48136,कवर,0,0,6,6
4948,casuale,1,6,0,6
35665,prata,0,0,6,6
39503,excuses,0,0,6,6
40212,बेहतर,0,0,6,6
20708,jij,0,0,6,6
42252,mamá,0,0,6,6
939,sopa,2,1,5,6
9086,toc,2,3,3,6
1451,stagni,1,6,0,6
3485,repository,2,5,1,6
4453,utile,2,5,1,6
13781,contar,0,0,6,6
52154,conoce,0,0,6,6
4439,doctor,2,2,4,6
27326,поскольку,0,0,6,6
4286,bayesiana,2,3,3,6
11362,verwendet,0,0,6,6
8313,carino,1,6,0,6
8229,assistenza,1,6,0,6
8871,peer,2,2,4,6
4429,paideia,2,3,3,6
47890,uw,0,0,6,6
33527,editoriais,0,0,6,6
42174,plupart,0,0,6,6
23620,ಇತರ,0,0,6,6
8867,impegnato,1,6,0,6
47878,வரை,0,0,6,6
2237,quinto,2,4,2,6
17034,mañana,0,0,6,6
32917,impacts,0,0,6,6
20057,acho,0,0,6,6
27355,demasiado,0,0,6,6
26134,goede,0,0,6,6
2203,nucleo,1,6,0,6
41715,formal,0,0,6,6
46212,begon,0,0,6,6
21446,ger,0,0,6,6
52690,controversial,0,0,6,6
8889,caratteri,1,6,0,6
23876,வீட்டிற்கு,0,0,6,6
46207,ನಡೆಯುತ್ತಿದೆ,0,0,6,6
23868,problèmes,0,0,6,6
52691,должны,0,0,6,6
21366,selv,0,0,6,6
26149,buna,0,0,6,6
8883,intellettuale,1,6,0,6
17028,visade,0,0,6,6
3438,tron,2,2,4,6
29868,onu,0,0,6,6
2473,adattamento,1,6,0,6
7475,ranking,2,2,4,6
49703,ಕೆಲವೊಮ್ಮೆ,0,0,6,6
41690,celui,0,0,6,6
13344,træg,0,0,6,6
50944,nice,0,0,6,6
20128,gesehen,0,0,6,6
46184,ಸಹಾಯ,0,0,6,6
50949,αμβλεία,0,0,6,6
29933,yourself,0,0,6,6
49409,doğru,0,0,6,6
46185,कल,0,0,6,6
3,voto,1,6,0,6
23685,éditions,0,0,6,6
49694,बिना,0,0,6,6
4309,berkman,2,2,4,6
17158,вашей,0,0,6,6
27261,nødt,0,0,6,6
3861,vandalismi,1,6,0,6
2222,casino,1,6,0,6
45732,pensée,0,0,6,6
51155,permettant,0,0,6,6
33562,huh,0,0,6,6
11237,multimedia,0,0,6,6
8862,composta,2,5,1,6
23789,φράσεις,0,0,6,6
44121,sagst,0,0,6,6
42118,करती,0,0,6,6
4290,poter,1,6,0,6
14511,уверен,0,0,6,6
47793,سيكون,0,0,6,6
29884,ларри,0,0,6,6
20094,такой,0,0,6,6
37991,sikker,0,0,6,6
4376,prenditi,1,6,0,6
29894,pass,0,0,6,6
44001,غارق,0,0,6,6
7492,iniziativa,1,6,0,6
4368,migliaia,1,6,0,6
20153,eve,0,0,6,6
33543,använde,0,0,6,6
2240,myspace,2,2,4,6
1394,rapporti,1,6,0,6
1360,spirito,1,6,0,6
8190,richiesta,1,6,0,6
27432,ಏನಾದರೂ,0,0,6,6
35663,projektet,0,0,6,6
16859,n’est,0,0,6,6
10986,उपयोगकर्ता,0,0,6,6
27422,ചിലർ,0,0,6,6
47666,ಉತ್ತಮ,0,0,6,6
3542,risorse,1,6,0,6
1494,calo,1,6,0,6
36045,förlåt,0,0,6,6
29975,longtemps,0,0,6,6
4646,jaffe,2,3,3,6
45763,शायद,0,0,6,6
11504,समाचार,0,0,6,6
8195,confini,1,6,0,6
11486,kritik,0,0,6,6
23476,terre,0,0,6,6
35528,खुश,0,0,6,6
35376,bitte,0,0,6,6
52394,category,0,0,6,6
36061,flesta,0,0,6,6
43810,decisiones,0,0,6,6
58,consentire,1,6,0,6
615,francisco,2,2,4,6
29634,aantal,0,0,6,6
17559,escreveu,0,0,6,6
17558,existence,0,0,6,6
2525,phuein,2,3,3,6
1993,ragionamento,1,6,0,6
43802,increíble,0,0,6,6
20941,optimization,0,0,6,6
23404,kişiyi,0,0,6,6
50828,redigeras,0,0,6,6
4685,wikinews,2,3,3,6
41277,recent,0,0,6,6
39623,krijgt,0,0,6,6
21501,message,0,0,6,6
31468,editar,0,0,6,6
4679,carattere,1,6,0,6
49145,humaines,0,0,6,6
20783,sim,0,0,6,6
2199,politici,2,5,1,6
39989,män,0,0,6,6
8808,philosophy,2,1,5,6
43872,obtenu,0,0,6,6
51910,машинного,0,0,6,6
39704,ಮತ್ತೊಂದು,0,0,6,6
20925,gouden,0,0,6,6
2016,dico,1,6,0,6
23544,entrada,0,0,6,6
14571,större,0,0,6,6
7410,coprirmi,1,6,0,6
51312,outside,0,0,6,6
23911,deixeme,0,0,6,6
7558,straordinario,1,6,0,6
8225,originali,1,6,0,6
26682,между,0,0,6,6
30496,grad,0,0,6,6
35980,после,0,0,6,6
2498,appropriato,1,6,0,6
4514,marchio,1,6,0,6
20012,الطعام,0,0,6,6
21482,cours,0,0,6,6
17484,quase,0,0,6,6
27388,tur,0,0,6,6
44233,തവണ,0,0,6,6
31904,ಸಮಯದಲ್ಲಿ,0,0,6,6
4602,dibattito,1,6,0,6
3390,nazionale,1,6,0,6
39669,noche,0,0,6,6
41734,bliver,0,0,6,6
4598,famoso,2,4,2,6
39672,hija,0,0,6,6
4276,alternativa,1,6,0,6
27404,ಹೇಳಿ,0,0,6,6
14435,dispositivos,0,0,6,6
8935,criticato,1,6,0,6
29727,utilizada,0,0,6,6
43860,obtenir,0,0,6,6
27391,amerikaner,0,0,6,6
39968,κάτω,0,0,6,6
46,dispute,2,2,4,6
44483,contrast,0,0,6,6
49808,regler,0,0,6,6
18165,länge,0,0,6,6
13108,الوقت,0,0,6,6
5425,smartphone,2,4,2,6
4044,ilp,2,4,2,6
12062,"है।
",0,0,6,6
37336,educado,0,0,6,6
6984,sembra,1,6,0,6
199,numeri,1,6,0,6
552,latino,1,6,0,6
11916,ίσως,0,0,6,6
2653,insulto,2,4,2,6
16216,процессе,0,0,6,6
8061,riferisce,1,6,0,6
9161,interessante,2,4,2,6
44567,αγγλικά,0,0,6,6
25887,cannot,0,0,6,6
19729,informatique,0,0,6,6
196,kernel,2,3,3,6
18252,ret,0,0,6,6
22955,له,0,0,6,6
5227,locale,2,5,1,6
8761,responsabile,1,6,0,6
43353,واحد,0,0,6,6
9165,dovresti,1,6,0,6
47329,φίλοι,0,0,6,6
11926,until,0,0,6,6
49874,stomp,0,0,6,6
9171,furono,1,6,0,6
5238,lanciato,1,6,0,6
29237,needed,0,0,6,6
9173,sostanzialmente,1,6,0,6
45513,nourriture,0,0,6,6
8471,correlato,1,6,0,6
26838,vier,0,0,6,6
13667,участников,0,0,6,6
49071,ángulo,0,0,6,6
3138,ward,2,4,2,6
209,considerata,1,6,0,6
37275,üzerine,0,0,6,6
3217,appena,1,6,0,6
41809,terwijl,0,0,6,6
18029,pobre,0,0,6,6
1945,autonome,2,1,5,6
9141,°,1,6,0,6
43484,snart,0,0,6,6
5175,molestie,1,6,0,6
8764,operativa,1,6,0,6
1918,istruzione,1,6,0,6
18045,பிழைத்திருத்தத்தில்,0,0,6,6
16402,regarding,0,0,6,6
1571,alcuna,1,6,0,6
48405,gezien,0,0,6,6
21621,communication,0,0,6,6
37278,hjælp,0,0,6,6
30869,allemaal,0,0,6,6
11888,formed,0,0,6,6
27165,local,0,0,6,6
26835,titled,0,0,6,6
30109,enkelt,0,0,6,6
1942,componenti,1,6,0,6
5197,dare,2,4,2,6
22986,tinham,0,0,6,6
49515,ذكية,0,0,6,6
1934,complesso,1,6,0,6
35823,науки,0,0,6,6
24539,issue,0,0,6,6
8759,distingue,2,3,3,6
11970,lide,0,0,6,6
7025,pedia,2,5,1,6
34620,debe,0,0,6,6
29173,comenzó,0,0,6,6
32234,эта,0,0,6,6
47364,ângulo,0,0,6,6
4139,assegnato,1,6,0,6
9198,spero,1,6,0,6
47354,views,0,0,6,6
16296,ಮನೆಗೆ,0,0,6,6
8466,tecnici,1,6,0,6
36372,plan,0,0,6,6
8040,vocabolario,1,6,0,6
22899,française,0,0,6,6
16304,درجة,0,0,6,6
51783,deki,0,0,6,6
10467,werde,0,0,6,6
1237,gerarchia,1,6,0,6
26853,എന്നാണ്,0,0,6,6
48341,children,0,0,6,6
29162,används,0,0,6,6
51286,countries,0,0,6,6
32546,glad,0,0,6,6
11985,нарциса,0,0,6,6
45480,level,0,0,6,6
772,segue,1,6,0,6
5344,line,2,2,4,6
1600,caching,2,2,4,6
30355,créé,0,0,6,6
32766,labeled,0,0,6,6
18242,veut,0,0,6,6
13065,ஒருவர்,0,0,6,6
39222,particularmente,0,0,6,6
48307,sample,0,0,6,6
1920,addirittura,1,6,0,6
20627,cobertura,0,0,6,6
14906,रिपोर्ट,0,0,6,6
5378,marmellata,1,6,0,6
7058,fattore,1,6,0,6
3736,intervista,1,6,0,6
47346,அம்மா,0,0,6,6
538,revisioni,1,6,0,6
34402,helst,0,0,6,6
27673,ജനുവരി,0,0,6,6
9180,killer,2,1,5,6
21660,இருக்கிறீர்கள்,0,0,6,6
7029,carne,2,4,2,6
39282,críticos,0,0,6,6
19666,страницы,0,0,6,6
9185,identifica,2,5,1,6
5279,nica,2,3,3,6
7042,vicino,1,6,0,6
1251,office,2,1,5,6
48323,varias,0,0,6,6
43404,videnskabelige,0,0,6,6
7035,multimediale,1,6,0,6
26518,учтивый,0,0,6,6
50566,aynı,0,0,6,6
14884,geld,0,0,6,6
5301,previsione,1,6,0,6
38427,obter,0,0,6,6
5339,sapevo,1,6,0,6
43535,résultats,0,0,6,6
5461,ann,2,3,3,6
50510,variety,0,0,6,6
5095,dovuto,1,6,0,6
47438,algorithme,0,0,6,6
31421,rédaction,0,0,6,6
30595,تغييرات,0,0,6,6
9101,specifico,1,6,0,6
2606,voi,1,6,0,6
39413,कोण,0,0,6,6
2594,qualcos,1,6,0,6
17990,solar,0,0,6,6
39386,danske,0,0,6,6
38217,línea,0,0,6,6
26824,أقول,0,0,6,6
24381,freunde,0,0,6,6
29325,comigo,0,0,6,6
42074,hace,0,0,6,6
29042,lütfen,0,0,6,6
37264,ederim,0,0,6,6
29334,ξέρω,0,0,6,6
19783,dahaki,0,0,6,6
29039,നിന്നും,0,0,6,6
14798,ordnung,0,0,6,6
10643,artiklarna,0,0,6,6
8091,citando,2,2,4,6
24439,wikis,0,0,6,6
1913,deus,2,1,5,6
35298,lorsque,0,0,6,6
16171,deres,0,0,6,6
23045,turn,0,0,6,6
48415,göre,0,0,6,6
36256,jemandem,0,0,6,6
26804,filha,0,0,6,6
27756,frente,0,0,6,6
5115,ascolta,1,6,0,6
30840,personnes,0,0,6,6
3127,manning,2,3,3,6
19763,κατάσταση,0,0,6,6
21596,வார்த்தையை,0,0,6,6
8770,essendo,1,6,0,6
10672,затем,0,0,6,6
27628,quais,0,0,6,6
3249,affermando,1,6,0,6
13135,step,0,0,6,6
24737,matière,0,0,6,6
9119,progettati,1,6,0,6
4144,lascia,1,6,0,6
8428,lumaca,1,6,0,6
51446,emin,0,0,6,6
44526,vergeet,0,0,6,6
25871,yavaş,0,0,6,6
8742,veri,1,6,0,6
8766,amiche,1,6,0,6
44689,இருந்தால்,0,0,6,6
51442,؟,0,0,6,6
38425,largement,0,0,6,6
34388,conducted,0,0,6,6
38229,refers,0,0,5,5
21469,നല്ലതാണ്,0,0,5,5
42202,ميلي,0,0,5,5
1800,universitari,1,5,0,5
13345,कहाँ,0,0,5,5
27371,schon,0,0,5,5
38214,either,0,0,5,5
20129,रखें,0,0,5,5
45876,commonly,0,0,5,5
41162,wouldn,0,0,5,5
14479,does,0,0,5,5
45667,vê,0,0,5,5
31937,dirigido,0,0,5,5
2787,redattore,1,5,0,5
892,jay,2,2,3,5
7016,interpretazione,1,5,0,5
51717,tråkigt,0,0,5,5
9508,amministratore,1,5,0,5
7404,pollice,1,5,0,5
42196,работой,0,0,5,5
34851,संपादकों,0,0,5,5
14950,القواعد,0,0,5,5
25892,significant,0,0,5,5
9510,peso,2,4,1,5
38645,¿puedes,0,0,5,5
34872,mı,0,0,5,5
21963,tú,0,0,5,5
38599,ಪದದ,0,0,5,5
1921,semi,1,5,0,5
13475,gars,0,0,5,5
987,generano,1,5,0,5
27713,ομορφιά,0,0,5,5
2502,enwikipediaorg,2,2,3,5
7559,pornografia,2,2,3,5
21965,спросить,0,0,5,5
8905,discussioni,1,5,0,5
46792,requests,0,0,5,5
6465,rappresentati,1,5,0,5
14604,beleza,0,0,5,5
33762,பெரிய,0,0,5,5
37575,ideia,0,0,5,5
7011,evitare,1,5,0,5
37233,aí,0,0,5,5
42127,പറയുക,0,0,5,5
51720,precisão,0,0,5,5
6946,entro,1,5,0,5
1927,argento,1,5,0,5
50086,многие,0,0,5,5
49911,ej,0,0,5,5
13265,dado,0,0,5,5
2004,interessato,1,5,0,5
31238,إنها,0,0,5,5
8833,ciclo,2,3,2,5
25872,ധാരാളം,0,0,5,5
21897,practice,0,0,5,5
6470,andando,1,5,0,5
15327,reached,0,0,5,5
31951,juillet,0,0,5,5
42648,rare,0,0,5,5
34502,الأخيرة,0,0,5,5
21387,selection,0,0,5,5
3628,protette,1,5,0,5
33067,versão,0,0,5,5
20352,mean,0,0,5,5
20350,popularidad,0,0,5,5
14983,खुद,0,0,5,5
34814,intended,0,0,5,5
19328,लायक,0,0,5,5
8915,modificano,1,5,0,5
9574,capitolo,1,5,0,5
21678,ämnen,0,0,5,5
38479,lernen,0,0,5,5
32007,widely,0,0,5,5
6572,tecnica,1,5,0,5
14898,resulting,0,0,5,5
654,salata,1,5,0,5
7751,studente,1,5,0,5
14343,منه,0,0,5,5
27399,πράγμα,0,0,5,5
26292,aften,0,0,5,5
27750,نفسك,0,0,5,5
8737,gestito,1,5,0,5
9513,slashdot,2,1,4,5
25865,सम्पादकीय,0,0,5,5
9266,promuovere,1,5,0,5
2477,temperature,2,1,4,5
2663,pop,2,1,4,5
3553,forniscono,1,5,0,5
6519,sostanza,1,5,0,5
6520,suggerito,1,5,0,5
35760,engine,0,0,5,5
31353,തീർച്ചയായും,0,0,5,5
9539,intraprendere,1,5,0,5
20065,حماية,0,0,5,5
6924,riguardanti,1,5,0,5
2030,forum,2,3,2,5
21372,adopted,0,0,5,5
31509,şimdiden,0,0,5,5
8875,publishing,2,2,3,5
4162,dipendenti,1,5,0,5
21377,вопрос,0,0,5,5
27250,claimed,0,0,5,5
8877,separato,1,5,0,5
46482,بدأت,0,0,5,5
42452,nästan,0,0,5,5
3533,andarono,1,5,0,5
514,citate,1,5,0,5
1815,panorama,2,2,3,5
9265,ispirati,1,5,0,5
26348,لها,0,0,5,5
19621,சொற்றொடரை,0,0,5,5
9238,annuale,1,5,0,5
42697,maakt,0,0,5,5
21935,encyclopedieën,0,0,5,5
49715,chance,0,0,5,5
20163,lucky,0,0,5,5
12819,evidence,0,0,5,5
917,blue,2,3,2,5
8866,aspetta,1,5,0,5
916,descrivere,1,5,0,5
19271,χρησιμοποιώ,0,0,5,5
28114,zonder,0,0,5,5
38637,पूछ,0,0,5,5
6966,intrinsecamente,1,5,0,5
38299,learns,0,0,5,5
1813,evitando,2,2,3,5
41997,autores,0,0,5,5
21944,أحيانًا,0,0,5,5
46814,focus,0,0,5,5
37724,recursos,0,0,5,5
51947,paid,0,0,5,5
28115,huis,0,0,5,5
31923,μέρα,0,0,5,5
14931,depending,0,0,5,5
19286,dizem,0,0,5,5
37594,fim,0,0,5,5
42450,assez,0,0,5,5
6909,singole,1,5,0,5
28084,कार्यक्रम,0,0,5,5
52301,leading,0,0,5,5
42445,terrain,0,0,5,5
21461,ಎರಡು,0,0,5,5
25581,schön,0,0,5,5
20121,huilen,0,0,5,5
444,concesso,1,5,0,5
37271,سأكون,0,0,5,5
26172,bruges,0,0,5,5
40995,الأساسية,0,0,5,5
31492,இருப்பேன்,0,0,5,5
21915,hafta,0,0,5,5
14268,bus,0,0,5,5
14942,direitos,0,0,5,5
37663,opinion,0,0,5,5
26177,डर,0,0,5,5
37237,effet,0,0,5,5
21465,geography,0,0,5,5
21962,अतिरिक्त,0,0,5,5
894,prodigioso,1,5,0,5
51976,modos,0,0,5,5
52344,जबकि,0,0,5,5
9258,genera,2,4,1,5
7501,memoria,2,4,1,5
31222,comuns,0,0,5,5
912,barzelletta,1,5,0,5
21441,onion,0,0,5,5
7549,nessuno,1,5,0,5
33059,आश्चर्यजनक,0,0,5,5
20173,preocupes,0,0,5,5
49907,classified,0,0,5,5
13414,unknown,0,0,5,5
13356,അതിശയകരമായ,0,0,5,5
34945,محرري,0,0,5,5
45450,mama,0,0,5,5
19256,mismos,0,0,5,5
991,networking,2,1,4,5
38294,activities,0,0,5,5
6537,passa,2,4,1,5
9530,tadić,2,2,3,5
6927,popolazione,1,5,0,5
31387,πάνω,0,0,5,5
45758,vocês,0,0,5,5
33066,thanks,0,0,5,5
9260,werkstatt,2,1,4,5
42150,mieux,0,0,5,5
31495,built,0,0,5,5
31493,രീതിയിൽ,0,0,5,5
42149,τρόπο,0,0,5,5
45881,juin,0,0,5,5
2720,specificamente,1,5,0,5
26337,получите,0,0,5,5
19854,täglichen,0,0,5,5
37619,divided,0,0,5,5
13167,положении,0,0,5,5
35024,होकर,0,0,5,5
19435,stykke,0,0,5,5
9043,dover,1,5,0,5
3867,età,1,5,0,5
19439,oroa,0,0,5,5
9124,query,2,2,3,5
9122,matrice,1,5,0,5
49216,تلك,0,0,5,5
970,mitchell,2,4,1,5
14716,لست,0,0,5,5
9046,rey,2,2,3,5
41391,went,0,0,5,5
7258,ulteriori,1,5,0,5
2707,legato,1,5,0,5
51240,yorgun,0,0,5,5
45358,sinto,0,0,5,5
45573,المرة,0,0,5,5
7620,interessa,1,5,0,5
27185,словами,0,0,5,5
14804,türkiye,0,0,5,5
19776,عليك,0,0,5,5
48956,såsom,0,0,5,5
45846,beder,0,0,5,5
25727,streams,0,0,5,5
2602,sum,2,1,4,5
25728,områden,0,0,5,5
32774,rädd,0,0,5,5
45402,francés,0,0,5,5
956,registrato,1,5,0,5
27517,καλύτερα,0,0,5,5
31981,após,0,0,5,5
42503,siguiente,0,0,5,5
51663,ತಪ್ಪು,0,0,5,5
42506,historical,0,0,5,5
42066,colère,0,0,5,5
31262,βικιπαίδειας,0,0,5,5
33832,atolado,0,0,5,5
26295,информация,0,0,5,5
9328,conosciuta,1,5,0,5
19417,पार,0,0,5,5
30135,traits,0,0,5,5
25934,substance,0,0,5,5
15126,minute,0,0,5,5
6820,esercizio,1,5,0,5
20283,responder,0,0,5,5
9414,organizzate,1,5,0,5
25937,المساهمين,0,0,5,5
13092,aigu,0,0,5,5
26042,hiçbir,0,0,5,5
678,egli,1,5,0,5
37433,træt,0,0,5,5
25944,التخريب,0,0,5,5
49115,mois,0,0,5,5
51966,datter,0,0,5,5
52477,तरीके,0,0,5,5
25948,εγώ,0,0,5,5
9331,rischio,1,5,0,5
9053,gardner,2,2,3,5
9335,dichiarazioni,1,5,0,5
21583,« wikipédia »,0,0,5,5
13131,normas,0,0,5,5
45559,sério,0,0,5,5
9076,bibliotecario,2,4,1,5
3554,adam,2,1,4,5
4131,contenenti,1,5,0,5
37395,hacerlo,0,0,5,5
41232,vielleicht,0,0,5,5
1870,rond,2,1,4,5
52432,évidence,0,0,5,5
7615,domini,1,5,0,5
19507,terrestrial,0,0,5,5
27579,зрения,0,0,5,5
33173,fangede,0,0,5,5
13143,sah,0,0,5,5
14768,named,0,0,5,5
7170,riguardo,1,5,0,5
41238,издание,0,0,5,5
42541,souhaitée,0,0,5,5
41415,نيويورك,0,0,5,5
33820,desconcertado,0,0,5,5
25757,وأنا,0,0,5,5
20226,associations,0,0,5,5
15067,versie,0,0,5,5
6770,diretto,1,5,0,5
25762,ذلك،,0,0,5,5
14775,versionen,0,0,5,5
7156,soggetti,1,5,0,5
49838,wiederholen,0,0,5,5
21567,பயன்படுத்தும்,0,0,5,5
1879,vettore,1,5,0,5
2735,lasciami,1,5,0,5
579,completa,1,5,0,5
7214,institute,2,1,4,5
46443,agree,0,0,5,5
4133,linguistici,1,5,0,5
49669,connaissance,0,0,5,5
13163,sverige,0,0,5,5
2569,wwwwikipediacom,2,1,4,5
34907,fem,0,0,5,5
13160,categories,0,0,5,5
12926,மந்தமான,0,0,5,5
15090,errors,0,0,5,5
13157,дорогая,0,0,5,5
6800,svolgere,1,5,0,5
486,succede,1,5,0,5
13152,тупым,0,0,5,5
7601,identificazione,1,5,0,5
2731,nata,1,5,0,5
7201,continuato,1,5,0,5
37414,apuros,0,0,5,5
25788,université,0,0,5,5
20288,questões,0,0,5,5
37160,şeyler,0,0,5,5
27544,должна,0,0,5,5
9099,fsf,2,1,4,5
51669,தவறு,0,0,5,5
27118,herhalen,0,0,5,5
45390,позволяет,0,0,5,5
9096,medico,1,5,0,5
2550,propone,2,4,1,5
49060,layers,0,0,5,5
986,piani,1,5,0,5
41037,novembro,0,0,5,5
2395,collaborare,1,5,0,5
7336,dispositivo,2,4,1,5
49045,träffar,0,0,5,5
19964,संपादित,0,0,5,5
7159,ruscello,1,5,0,5
31248,mejora,0,0,5,5
9191,autorizzazione,1,5,0,5
14881,हों,0,0,5,5
26101,diskussionssidorna,0,0,5,5
34020,female,0,0,5,5
31968,почти,0,0,5,5
4137,chiave,1,5,0,5
6856,cima,2,2,3,5
32727,δω,0,0,5,5
2438,costituiscono,1,5,0,5
49941,μας,0,0,5,5
35719,كلمات,0,0,5,5
20321,gained,0,0,5,5
46566,siguientes,0,0,5,5
9182,«wikipedia,2,2,3,5
27679,pasar,0,0,5,5
28009,geniş,0,0,5,5
26093,resources,0,0,5,5
19944,पल,0,0,5,5
9304,journalism,2,2,3,5
21514,معظم,0,0,5,5
21883,വ്യക്തിയെ,0,0,5,5
547,fondamentali,1,5,0,5
7031,manske,2,2,3,5
9471,rimozione,1,5,0,5
37313,enorm,0,0,5,5
2695,ambientale,1,5,0,5
14609,photos,0,0,5,5
20342,പോകുന്നു,0,0,5,5
459,presente,2,3,2,5
33844,എണ്ണം,0,0,5,5
2512,soggetta,1,5,0,5
6878,editoriali,1,5,0,5
15203,daarom,0,0,5,5
42228,вами,0,0,5,5
2514,garantire,1,5,0,5
8695,recente,2,4,1,5
7360,addestrare,1,5,0,5
34605,لن,0,0,5,5
6605,hosting,2,4,1,5
7571,eventuali,1,5,0,5
8949,difesa,1,5,0,5
38481,bange,0,0,5,5
30529,arbetet,0,0,5,5
27417,المستخدمين,0,0,5,5
42241,elkaar,0,0,5,5
13248,الذهبي,0,0,5,5
8951,wikiproject,2,1,4,5
1896,definite,1,5,0,5
19355,polar,0,0,5,5
14992,technique,0,0,5,5
9296,consulta,2,2,3,5
461,precedente,1,5,0,5
4148,dimostrato,1,5,0,5
2093,npov,2,2,3,5
6853,possiamo,1,5,0,5
7308,corretti,1,5,0,5
45323,wieder,0,0,5,5
51605,wanneer,0,0,5,5
31570,propre,0,0,5,5
20250,premiers,0,0,5,5
6839,protect,2,1,4,5
27975,allemand,0,0,5,5
2545,confondere,1,5,0,5
12981,francesa,0,0,5,5
12889,प्रस्तुत,0,0,5,5
46590,alligevel,0,0,5,5
49795,പോയി,0,0,5,5
32035,gyllene,0,0,5,5
27971,korkunç,0,0,5,5
27659,لويكيبيديا,0,0,5,5
7077,grafico,1,5,0,5
46591,uppge,0,0,5,5
14682,escrita,0,0,5,5
15012,ಅತ್ಯಂತ,0,0,5,5
7265,quota,1,5,0,5
9159,grandioso,1,5,0,5
7262,ieri,1,5,0,5
21333,hora,0,0,5,5
14307,olmadığını,0,0,5,5
37337,receives,0,0,5,5
45335,رقيق,0,0,5,5
25929,istiyorum,0,0,5,5
9324,naturacultura,1,5,0,5
2753,rallegrati,1,5,0,5
14672,américains,0,0,5,5
42499,பல,0,0,5,5
26330,health,0,0,5,5
21864,сейчас,0,0,5,5
33841,भयानक,0,0,5,5
46576,मत,0,0,5,5
46577,другими,0,0,5,5
26223,этому,0,0,5,5
2699,hayek,2,2,3,5
46578,skønhed,0,0,5,5
21522,कमी,0,0,5,5
21300,gehört,0,0,5,5
3549,affermazione,1,5,0,5
30405,licencias,0,0,5,5
42269,الأولى,0,0,5,5
41048,नए,0,0,5,5
51876,particulièrement,0,0,5,5
7059,verificabilità,1,5,0,5
27670,birini,0,0,5,5
14659,doit,0,0,5,5
13204,हर,0,0,5,5
49130,நேரம்,0,0,5,5
6848,intervento,1,5,0,5
9168,visualeditor,2,2,3,5
7580,concorso,1,5,0,5
13379,ನಿಮ್ಮೊಂದಿಗೆ,0,0,5,5
49125,القادمة,0,0,5,5
6654,wikisource,2,3,2,5
9440,tenuto,1,5,0,5
19723,затруднительном,0,0,5,5
45414,rulebased,0,0,5,5
51984,connection,0,0,5,5
33696,حال,0,0,5,5
46833,अनुसंधान,0,0,5,5
24457,applied,0,0,5,5
17986,καταπληκτική,0,0,5,5
48240,sida,0,0,5,5
17982,معينة,0,0,5,5
23039,clear,0,0,5,5
26809,dólares,0,0,5,5
32259,माध्यम,0,0,5,5
10647,தொகுப்பாளர்கள்,0,0,5,5
50662,possuem,0,0,5,5
3497,mission,2,1,4,5
17967,gange,0,0,5,5
33447,develop,0,0,5,5
2175,effettuato,1,5,0,5
3242,corpus,2,2,3,5
3243,costruita,1,5,0,5
36245,usuario,0,0,5,5
39420,bedste,0,0,5,5
5077,wikispecies,2,3,2,5
10673,भाग,0,0,5,5
51383,seul,0,0,5,5
17941,vide,0,0,5,5
23063,principaux,0,0,5,5
23066,blir,0,0,5,5
48207,kennis,0,0,5,5
26801,കഴിയുമോ,0,0,5,5
10688,πως,0,0,5,5
5062,twitter,2,2,3,5
36229,desenvolvimento,0,0,5,5
5121,sogni,1,5,0,5
51394,сон,0,0,5,5
37882,എല്ലായ്പ്പോഴും,0,0,5,5
48253,inicialmente,0,0,5,5
842,cancer,2,1,4,5
13990,conocida,0,0,5,5
33433,siendo,0,0,5,5
40312,works,0,0,5,5
29305,extremes,0,0,5,5
44532,pueda,0,0,5,5
5161,portano,1,5,0,5
1271,tratti,1,5,0,5
18021,мой,0,0,5,5
11875,bilgi,0,0,5,5
18009,peur,0,0,5,5
18007,bästa,0,0,5,5
23011,produced,0,0,5,5
50658,वाली,0,0,5,5
10621,अपना,0,0,5,5
49352,chez,0,0,5,5
5145,comporta,1,5,0,5
18001,besser,0,0,5,5
32508,geheime,0,0,5,5
39380,recognition,0,0,5,5
50652,conversación,0,0,5,5
1564,seguire,1,5,0,5
5133,minnesota,2,2,3,5
32258,проекта,0,0,5,5
17992,emellertid,0,0,5,5
3229,suono,1,5,0,5
46075,weg,0,0,5,5
31776,easy,0,0,5,5
36224,root,0,0,5,5
10781,époque,0,0,5,5
8124,gratuitamente,2,4,1,5
4982,riesco,1,5,0,5
4981,definito,1,5,0,5
43621,perguntar,0,0,5,5
24276,solve,0,0,5,5
10765,zie,0,0,5,5
52658,funciones,0,0,5,5
8127,tradizionale,1,5,0,5
24268,நண்பர்கள்,0,0,5,5
50716,hors,0,0,5,5
10778,tillförlitlighet,0,0,5,5
11734,चल,0,0,5,5
26553,call,0,0,5,5
24280,hebben,0,0,5,5
51364,helfen,0,0,5,5
39511,marriage,0,0,5,5
40194,कारण,0,0,5,5
39514,might,0,0,5,5
4929,vietnamita,2,3,2,5
3297,precedenza,1,5,0,5
48124,share,0,0,5,5
36165,eines,0,0,5,5
48121,ജീവിതത്തിൽ,0,0,5,5
23202,pesquisas,0,0,5,5
13703,konflikter,0,0,5,5
4911,mchenry,2,1,4,5
23128,उपयुक्त,0,0,5,5
30309,معك,0,0,5,5
39436,ഉപയോഗിക്കുന്ന,0,0,5,5
29394,director,0,0,5,5
16522,όνειρο,0,0,5,5
5044,forza,1,5,0,5
5042,ii,2,3,2,5
1546,largo,2,3,2,5
44473,cuales,0,0,5,5
5036,vedrai,1,5,0,5
1293,descriveva,1,5,0,5
13682,λέει,0,0,5,5
3576,controllare,1,5,0,5
4085,avrei,1,5,0,5
24326,حوالي,0,0,5,5
23098,autorais,0,0,5,5
24315,руки,0,0,5,5
4990,dimmi,1,5,0,5
46083,являются,0,0,5,5
50966,എന്നത്,0,0,5,5
40248,الآلي,0,0,5,5
30825,correctif,0,0,5,5
17866,manchmal,0,0,5,5
16578,பொருள்,0,0,5,5
4258,terza,1,5,0,5
17851,πήρε,0,0,5,5
24293,chamada,0,0,5,5
47499,environments,0,0,5,5
30383,möglichkeit,0,0,5,5
50708,neutro,0,0,5,5
16432,ये,0,0,5,5
18046,présentée,0,0,5,5
1221,phone,2,1,4,5
39355,सूचना,0,0,5,5
40426,entschuldigung,0,0,5,5
36426,endroit,0,0,5,5
3148,marchi,1,5,0,5
40423,tillräckligt,0,0,5,5
3570,portmanteau,2,3,2,5
18245,उनकी,0,0,5,5
8481,deciso,1,5,0,5
40409,वेबसाईट,0,0,5,5
6458,sviluppa,1,5,0,5
36416,naast,0,0,5,5
5384,baike,2,2,3,5
39228,तहत,0,0,5,5
40403,entradas,0,0,5,5
16251,gesprek,0,0,5,5
3572,necessari,1,5,0,5
37851,ചിലപ്പോൾ,0,0,5,5
10453,love,0,0,5,5
14020,episode,0,0,5,5
22868,участниками,0,0,5,5
44639,liten,0,0,5,5
43373,كانوا,0,0,5,5
49336,تبدو,0,0,5,5
10473,μένα,0,0,5,5
18205,повезло,0,0,5,5
24613,milieu,0,0,5,5
16293,chateado,0,0,5,5
775,derivati,1,5,0,5
22821,تمت,0,0,5,5
8487,visualizzazioni,1,5,0,5
29076,component,0,0,5,5
5454,array,2,2,3,5
8000,pratici,1,5,0,5
216,registrazione,1,5,0,5
5475,acque,1,5,0,5
8003,impiegano,1,5,0,5
13626,पुस्तक,0,0,5,5
767,arrivo,1,5,0,5
43316,ihåg,0,0,5,5
12081,வார்த்தையின்,0,0,5,5
5459,buone,1,5,0,5
37838,dele,0,0,5,5
47311,തങ്ങളുടെ,0,0,5,5
12078,oubliez,0,0,5,5
5451,scelti,1,5,0,5
44673,लिखा,0,0,5,5
12077,china,0,0,5,5
8007,significativamente,2,3,2,5
8009,moderna,1,5,0,5
20617,cover,0,0,5,5
44681,aldım,0,0,5,5
8491,yongle,2,3,2,5
5433,densità,1,5,0,5
43331,சொற்றொடர்,0,0,5,5
24703,travailler,0,0,5,5
29068,små,0,0,5,5
29069,إنني,0,0,5,5
10400,puntos,0,0,5,5
29172,connue,0,0,5,5
26845,wikipedianer,0,0,5,5
49340,lake,0,0,5,5
10561,écriture,0,0,5,5
16367,свои,0,0,5,5
52066,enough,0,0,5,5
8056,fauna,2,4,1,5
34749,गूगल,0,0,5,5
8455,programmati,1,5,0,5
22949,encuentran,0,0,5,5
5234,aiutare,1,5,0,5
29245,γεια,0,0,5,5
3194,trattati,1,5,0,5
3195,presidente,2,3,2,5
10557,spørge,0,0,5,5
10559,समर्थन,0,0,5,5
22961,άλλος,0,0,5,5
52635,restaurant,0,0,5,5
26525,उपयोगी,0,0,5,5
33625,πού,0,0,5,5
31686,βάλτο,0,0,5,5
8450,trattato,1,5,0,5
11909,भर,0,0,5,5
3204,oceaniche,1,5,0,5
49345,core,0,0,5,5
41811,objects,0,0,5,5
39327,ರಾತ್ರಿ,0,0,5,5
10580,menar,0,0,5,5
40321,released,0,0,5,5
47420,biosphere,0,0,5,5
32530,celle,0,0,5,5
5255,prendi,1,5,0,5
26843,جاء,0,0,5,5
21040,billion,0,0,5,5
36362,weiter,0,0,5,5
18172,bewerkers,0,0,5,5
24584,പല,0,0,5,5
186,pasticcio,1,5,0,5
5298,atroci,1,5,0,5
18161,yemek,0,0,5,5
35676,yeni,0,0,5,5
1247,esclusivamente,1,5,0,5
43408,ajudar,0,0,5,5
44610,सूची,0,0,5,5
179,canto,2,4,1,5
178,antropologie,1,5,0,5
5282,regione,1,5,0,5
18109,ತಾಯಿಗೆ,0,0,5,5
39281,similarity,0,0,5,5
5278,paul,2,1,4,5
24560,grupp,0,0,5,5
8050,diversità,1,5,0,5
30894,அன்றாட,0,0,5,5
48313,sueco,0,0,5,5
29214,chine,0,0,5,5
31678,sugerem,0,0,5,5
43425,allí,0,0,5,5
43427,तीन,0,0,5,5
21029,உங்களுடன்,0,0,5,5
20654,domaine,0,0,5,5
50737,reliable,0,0,5,5
30583,வாழ்க்கையில்,0,0,5,5
43666,सहमत,0,0,5,5
16676,länder,0,0,5,5
46211,ثم,0,0,5,5
29795,millón,0,0,5,5
4489,mettendo,1,5,0,5
44176,റെൻഡെജൂസ്,0,0,5,5
4484,reale,1,5,0,5
49395,вандализма,0,0,5,5
39926,arquivos,0,0,5,5
17014,address,0,0,5,5
8316,intero,1,5,0,5
8244,beyond,2,1,4,5
4469,weinberger,2,2,3,5
17025,requires,0,0,5,5
4466,austria,2,4,1,5
20839,сентября,0,0,5,5
47910,değişiklikler,0,0,5,5
23595,πραγματικότητα,0,0,5,5
44162,livro,0,0,5,5
33520,ಕೆಲಸವನ್ನು,0,0,5,5
29824,personer,0,0,5,5
32409,orden,0,0,5,5
32364,moeten,0,0,5,5
17335,eerder,0,0,5,5
3443,dimensioni,1,5,0,5
35410,серверов,0,0,5,5
3446,somiglianza,1,5,0,5
3958,siete,2,4,1,5
4285,classica,1,5,0,5
35,polari,1,5,0,5
52386,ಇದರರ್ಥ,0,0,5,5
43923,ಓ,0,0,5,5
8333,grillini,2,2,3,5
17456,hjälp,0,0,5,5
3400,mirror,2,4,1,5
3401,follow,2,1,4,5
4568,jonathan,2,1,4,5
51320,repeat,0,0,5,5
16949,spørgsmål,0,0,5,5
3487,contengono,1,5,0,5
49434,ifade,0,0,5,5
11428,എനിക്കറിയാം,0,0,5,5
39956,distribución,0,0,5,5
35997,abrumado,0,0,5,5
39955,soin,0,0,5,5
43889,रात,0,0,5,5
35521,disponíveis,0,0,5,5
29762,забудьте,0,0,5,5
16972,cinco,0,0,5,5
50884,fatigué,0,0,5,5
1473,spazi,1,5,0,5
1471,contributo,1,5,0,5
17406,polynomial,0,0,5,5
33515,aristote,0,0,5,5
23895,easily,0,0,5,5
3426,incontrare,1,5,0,5
35975,بينما,0,0,5,5
47743,novo,0,0,5,5
11122,amable,0,0,5,5
1452,tentativi,1,5,0,5
17051,должен,0,0,5,5
1405,antropologia,1,5,0,5
44035,lead,0,0,5,5
50939,ആയിരുന്നു,0,0,5,5
20855,കാണുന്നു,0,0,5,5
51053,claro,0,0,5,5
8271,farai,1,5,0,5
23742,mayoría,0,0,5,5
23741,söyleyebilirsiniz,0,0,5,5
23676,surveillance,0,0,5,5
3695,conoscenze,1,5,0,5
52149,थीं,0,0,5,5
17136,ayrıca,0,0,5,5
29922,exists,0,0,5,5
4330,spam,2,3,2,5
29929,اليومية,0,0,5,5
23759,بالنسبة,0,0,5,5
47803,succès,0,0,5,5
8279,andrea,2,2,3,5
4319,blocco,1,5,0,5
23724,गुणवत्ता,0,0,5,5
44046,prochaine,0,0,5,5
4313,falso,2,4,1,5
13805,continuar,0,0,5,5
8282,regionali,1,5,0,5
11284,οποία,0,0,5,5
11282,canım,0,0,5,5
23707,misma,0,0,5,5
23696,الآخر,0,0,5,5
4094,settimanale,1,5,0,5
3586,mostrano,1,5,0,5
8312,affidabile,1,5,0,5
44122,programme,0,0,5,5
44145,directly,0,0,5,5
44141,நாள்,0,0,5,5
39899,पाया,0,0,5,5
30666,algorithmic,0,0,5,5
11348,serviço,0,0,5,5
23821,ihren,0,0,5,5
44132,espace,0,0,5,5
4092,audience,2,1,4,5
46202,tired,0,0,5,5
35519,explain,0,0,5,5
39790,someone,0,0,5,5
4397,vegetali,1,5,0,5
13784,содержит,0,0,5,5
11,sopra,1,5,0,5
29880,rédacteur,0,0,5,5
11315,завален,0,0,5,5
11314,vá,0,0,5,5
17270,मिलियन,0,0,5,5
3473,sostituito,1,5,0,5
11221,شكرًا,0,0,5,5
29898,ήρθε,0,0,5,5
44005,tools,0,0,5,5
23764,utilisant,0,0,5,5
44006,britannicas,0,0,5,5
37992,mevcuttur,0,0,5,5
13817,telif,0,0,5,5
39970,мелли,0,0,5,5
3399,ortografia,1,5,0,5
17460,décembre,0,0,5,5
23313,yapmak,0,0,5,5
84,generare,1,5,0,5
17663,necesidad,0,0,5,5
29563,ಬಳಸಬಹುದು,0,0,5,5
3335,piedi,1,5,0,5
46114,ஆண்டு,0,0,5,5
23305,yer,0,0,5,5
4790,nonenglish,2,1,4,5
23309,hiç,0,0,5,5
29574,príncipe,0,0,5,5
4782,eccezione,1,5,0,5
36103,blive,0,0,5,5
10902,طلب,0,0,5,5
8377,brandchannelcom,2,1,4,5
43725,veta,0,0,5,5
48058,lieber,0,0,5,5
4764,episodi,1,5,0,5
51105,cómo,0,0,5,5
48053,rüya,0,0,5,5
52106,meet,0,0,5,5
16796,essas,0,0,5,5
4750,valutare,1,5,0,5
44308,beschikbaar,0,0,5,5
4746,subito,1,5,0,5
10923,största,0,0,5,5
44304,ευγενικό,0,0,5,5
4740,ten,2,1,4,5
10887,இதன்,0,0,5,5
4811,greco,1,5,0,5
10927,colaborar,0,0,5,5
3713,telegram,2,1,4,5
16677,μία,0,0,5,5
48114,मेरा,0,0,5,5
51357,уэйлс,0,0,5,5
50979,جملة,0,0,5,5
36149,потрясающий,0,0,5,5
29508,jobb,0,0,5,5
4881,positivo,2,2,3,5
48108,ligga,0,0,5,5
17744,ಕೇಳಿದಾಗ,0,0,5,5
48106,даже,0,0,5,5
4876,trovi,1,5,0,5
4858,corretta,1,5,0,5
39543,prins,0,0,5,5
32454,prince,0,0,5,5
30377,хочет,0,0,5,5
8148,pazienza,1,5,0,5
16725,стоит,0,0,5,5
16731,раздел,0,0,5,5
29539,പലപ്പോഴും,0,0,5,5
44357,contains,0,0,5,5
4826,usate,1,5,0,5
32939,events,0,0,5,5
49462,παραδείγματα,0,0,5,5
44354,principalement,0,0,5,5
3596,comprensione,1,5,0,5
88,comprese,1,5,0,5
13903,bouton,0,0,5,5
1350,dobbiamo,1,5,0,5
39971,vardı,0,0,5,5
50,guadagnato,1,5,0,5
54,narcisismo,2,3,2,5
43831,बातचीत,0,0,5,5
20778,ചെയ്യുക,0,0,5,5
23438,ದೈನಂದಿನ,0,0,5,5
8192,eletti,1,5,0,5
43842,trött,0,0,5,5
16888,dotter,0,0,5,5
16891,anthropologies,0,0,5,5
3380,determinati,1,5,0,5
40006,പോകാൻ,0,0,5,5
39654,travaille,0,0,5,5
4620,personaggio,1,5,0,5
4615,maggiori,1,5,0,5
40027,الإنترنت,0,0,5,5
3387,geologia,1,5,0,5
38030,schönheit,0,0,5,5
1372,condotta,1,5,0,5
17481,كثيرًا,0,0,5,5
30716,quem,0,0,5,5
51212,iş,0,0,5,5
1373,riconosciute,1,5,0,5
37966,krijgen,0,0,5,5
20933,maintain,0,0,5,5
29725,attrition,0,0,5,5
13869,هم,0,0,5,5
39978,arbeiten,0,0,5,5
48004,shown,0,0,5,5
23423,main,0,0,5,5
52375,رسالة,0,0,5,5
29635,explicitly,0,0,5,5
35356,வழி,0,0,5,5
36080,pares,0,0,5,5
23382,simplemente,0,0,5,5
43776,concerning,0,0,5,5
8367,temperate,2,3,2,5
29620,δώσω,0,0,5,5
4089,votazione,1,5,0,5
11568,فيها,0,0,5,5
40054,maybe,0,0,5,5
13740,beetje,0,0,5,5
39601,falar,0,0,5,5
8362,temporale,1,5,0,5
47649,moe,0,0,5,5
47658,இருந்தது,0,0,5,5
24079,olması,0,0,5,5
50823,ander,0,0,5,5
50824,dorado,0,0,5,5
39616,lois,0,0,5,5
10972,മാറ്റങ്ങൾ,0,0,5,5
16852,sélection,0,0,5,5
11542,truth,0,0,5,5
51806,increased,0,0,5,5
26590,heldig,0,0,5,5
10981,jamais,0,0,5,5
4669,rilasciato,1,5,0,5
11534,presse,0,0,5,5
218,survey,2,2,3,5
39225,composed,0,0,5,5
20143,സാധാരണ,0,0,5,5
20406,വിവിധ,0,0,5,5
35459,menudo,0,0,5,5
5975,molteplici,1,5,0,5
44962,അതിനെക്കുറിച്ച്,0,0,5,5
340,rimanere,1,5,0,5
28578,सकता।,0,0,5,5
7882,attendibilità,1,5,0,5
44960,days,0,0,5,5
9979,ಸ್ನೇಹಿತರೊಂದಿಗೆ,0,0,5,5
34139,القيام,0,0,5,5
40718,handling,0,0,5,5
35157,maio,0,0,5,5
22047,நினைவில்,0,0,5,5
33300,complètement,0,0,5,5
20408,بطيئًا,0,0,5,5
28597,അവരോട്,0,0,5,5
36939,mantenimiento,0,0,5,5
30421,золотого,0,0,5,5
48652,ಸಂಪೂರ್ಣವಾಗಿ,0,0,5,5
22391,correct,0,0,5,5
46341,voluntarios,0,0,5,5
1138,tardi,1,5,0,5
49558,measure,0,0,5,5
26446,months,0,0,5,5
8575,considerano,1,5,0,5
46897,sidevisninger,0,0,5,5
40744,इसने,0,0,5,5
353,correttamente,1,5,0,5
33716,மேலே,0,0,5,5
12493,vielen,0,0,5,5
25216,asked,0,0,5,5
38149,innebär,0,0,5,5
40758,unos,0,0,5,5
33277,nächsten,0,0,5,5
28290,λήμματα,0,0,5,5
42946,manner,0,0,5,5
12488,बस,0,0,5,5
25449,கூறலாம்,0,0,5,5
6006,divine,2,1,4,5
26439,goud,0,0,5,5
35142,गैर,0,0,5,5
6004,cellulari,1,5,0,5
25202,donné,0,0,5,5
2976,conclusioni,1,5,0,5
48677,matrix,0,0,5,5
52569,geralmente,0,0,5,5
47041,bloquear,0,0,5,5
46899,opinions,0,0,5,5
40754,før,0,0,5,5
22063,parts,0,0,5,5
36737,работе,0,0,5,5
37740,engelse,0,0,5,5
9707,इतना,0,0,5,5
32627,contrairement,0,0,5,5
1156,suggeriscono,1,5,0,5
48619,φαγητό,0,0,5,5
49305,исследований,0,0,5,5
25070,meilleure,0,0,5,5
25501,ഇന്ത്യൻ,0,0,5,5
8559,rocce,1,5,0,5
1157,trucco,1,5,0,5
1159,reso,1,5,0,5
30443,ಪದಗುಚ್,0,0,5,5
6348,introdotto,1,5,0,5
45984,anglophone,0,0,5,5
1697,tendono,1,5,0,5
22018,belleza,0,0,5,5
38984,nın,0,0,5,5
3022,apprese,1,5,0,5
18683,contigo,0,0,5,5
44898,γι,0,0,5,5
25052,ie,0,0,5,5
25045,വീഡിയോ,0,0,5,5
31632,ಅವನ,0,0,5,5
8557,miglio,1,5,0,5
22015,utilizar,0,0,5,5
4204,generazione,1,5,0,5
22450,ontzagwekkend,0,0,5,5
20514,naquele,0,0,5,5
37797,nouveau,0,0,5,5
8648,protocollo,1,5,0,5
45977,प्रस्ताव,0,0,5,5
48638,αυτός,0,0,5,5
10010,ziet,0,0,5,5
8647,interessi,1,5,0,5
7894,turista,2,3,2,5
5917,muove,1,5,0,5
41521,require,0,0,5,5
28624,wees,0,0,5,5
51008,उसी,0,0,5,5
40949,response,0,0,5,5
325,affermazioni,1,5,0,5
22442,interfaz,0,0,5,5
12727,खाना,0,0,5,5
28630,tales,0,0,5,5
26380,geluk,0,0,5,5
10020,കുറച്ച്,0,0,5,5
31181,കാണാൻ,0,0,5,5
322,terabyte,2,3,2,5
9666,classifica,1,5,0,5
44925,ಫ್ಲಮ್ಮಾಕ್ಸ್,0,0,5,5
26458,pouvezvous,0,0,5,5
8561,magnus,2,2,3,5
38872,нужно,0,0,5,5
45130,ಹೇಳಿದರೆ,0,0,5,5
41913,वाक्य,0,0,5,5
3888,creatore,1,5,0,5
2369,vinto,1,5,0,5
13523,أذهب,0,0,5,5
25380,तर्क,0,0,5,5
46956,rijtuig,0,0,5,5
18989,الشيء,0,0,5,5
34478,jämfört,0,0,5,5
2367,dallo,1,5,0,5
26415,nível,0,0,5,5
42860,understood,0,0,5,5
28407,சந்திப்பு,0,0,5,5
7827,lanciata,1,5,0,5
9800,lagras,0,0,5,5
20436,கட்டுரைகளின்,0,0,5,5
9736,उद्देश्य,0,0,5,5
28415,lembrese,0,0,5,5
38783,språket,0,0,5,5
2365,ottimo,1,5,0,5
25354,estrutura,0,0,5,5
22110,वर्तमान,0,0,5,5
28418,تقديم,0,0,5,5
22203,crescimento,0,0,5,5
31121,താളുകളിൽ,0,0,5,5
28319,tillsammans,0,0,5,5
26409,എന്നീ,0,0,5,5
12613,lecteurs,0,0,5,5
48780,dacht,0,0,5,5
45096,изображений,0,0,5,5
25405,ögonblick,0,0,5,5
19029,الجيد,0,0,5,5
19013,ficar,0,0,5,5
51553,presence,0,0,5,5
45106,description,0,0,5,5
7812,jimbo,2,2,3,5
46374,χωρίς,0,0,5,5
12626,दलदल,0,0,5,5
15520,forskarna,0,0,5,5
7814,scott,2,2,3,5
6220,dump,2,3,2,5
38769,verbazingwekkend,0,0,5,5
51548,أين,0,0,5,5
1754,perfetto,1,5,0,5
1078,esterna,1,5,0,5
36890,существует,0,0,5,5
45092,difficulté,0,0,5,5
50196,complexity,0,0,5,5
25386,ainda,0,0,5,5
20426,our,0,0,5,5
15535,apart,0,0,5,5
7817,venivano,1,5,0,5
42819,मामले,0,0,5,5
14189,lange,0,0,5,5
36794,എല്ലാം,0,0,5,5
1744,fenomeni,1,5,0,5
18891,müde,0,0,5,5
22288,anomaly,0,0,5,5
36922,बताया,0,0,5,5
21174,όλη,0,0,5,5
26962,повседневной,0,0,5,5
15665,geology,0,0,5,5
9722,उन्होंने,0,0,5,5
3762,breve,2,3,2,5
8599,contribuisce,1,5,0,5
27009,υπέροχη,0,0,5,5
49291,tendance,0,0,5,5
8595,prende,1,5,0,5
38851,seninle,0,0,5,5
38118,points,0,0,5,5
25250,ongoing,0,0,5,5
40920,nergis,0,0,5,5
1733,sociali,1,5,0,5
44998,ಸರಿ,0,0,5,5
48701,bayesian,0,0,5,5
38003,responsabilité,0,0,5,5
22310,wissen,0,0,5,5
22314,critics,0,0,5,5
2870,limitato,1,5,0,5
45120,guys,0,0,5,5
22088,bekend,0,0,5,5
30057,explique,0,0,5,5
2363,presentato,1,5,0,5
6139,ipertestuali,1,5,0,5
22107,patrimoine,0,0,5,5
6266,relativi,1,5,0,5
3889,profondo,1,5,0,5
14187,occurred,0,0,5,5
45041,научных,0,0,5,5
2930,comprende,1,5,0,5
6124,wireless,2,2,3,5
30433,anonymous,0,0,5,5
2932,conservazione,1,5,0,5
40804,свой,0,0,5,5
1771,fisica,1,5,0,5
1075,definire,1,5,0,5
38127,construction,0,0,5,5
51015,revistas,0,0,5,5
22258,emot,0,0,5,5
52418,eres,0,0,5,5
6271,forniti,1,5,0,5
6097,denuncia,2,4,1,5
48723,representations,0,0,5,5
34121,claim,0,0,5,5
28470,ändå,0,0,5,5
18675,verir,0,0,5,5
50351,ಕಾಳಜಿ,0,0,5,5
18670,деле,0,0,5,5
8514,cinema,2,4,1,5
2383,occupa,2,4,1,5
36554,ಹೇಗಾದರೂ,0,0,5,5
5613,civil,2,1,4,5
24819,خوادم,0,0,5,5
37001,основном,0,0,5,5
41990,salt,0,0,5,5
40507,fraser,0,0,5,5
242,farina,2,4,1,5
44758,söylemek,0,0,5,5
15354,ему,0,0,5,5
16071,сайт,0,0,5,5
40494,الإصلاح,0,0,5,5
36595,informação,0,0,5,5
6425,assicurati,1,5,0,5
3088,hard,2,3,2,5
3089,modellazione,1,5,0,5
40979,அதன்,0,0,5,5
18401,всю,0,0,5,5
35216,send,0,0,5,5
34079,tard,0,0,5,5
8512,veloce,1,5,0,5
38086,samen,0,0,5,5
50100,നിങ്ങൾ‌,0,0,5,5
16088,passou,0,0,5,5
47247,अलावा,0,0,5,5
16054,debes,0,0,5,5
28888,meinem,0,0,5,5
10271,वर्णित,0,0,5,5
35210,πρόσβασης,0,0,5,5
52040,systèmes,0,0,5,5
47226,للمحررين,0,0,5,5
28851,நண்பர்களுடன்,0,0,5,5
5657,mostrato,1,5,0,5
43061,മരിയൻ,0,0,5,5
10243,soir,0,0,5,5
32586,ಮಾಡುತ್ತಿದ್ದೀರಿ,0,0,5,5
13608,random,0,0,5,5
5646,incomplete,2,3,2,5
15368,diesen,0,0,5,5
40521,kon,0,0,5,5
7967,evento,1,5,0,5
9618,confronti,1,5,0,5
24840,conversa,0,0,5,5
43191,studied,0,0,5,5
18463,taille,0,0,5,5
39120,exact,0,0,5,5
5633,mass,2,1,4,5
22679,फॉर,0,0,5,5
16045,സ്വന്തം,0,0,5,5
50442,wurde,0,0,5,5
12182,empresa,0,0,5,5
3091,stesse,1,5,0,5
18390,സ്വപ്നം,0,0,5,5
6434,wapedia,2,2,3,5
33000,الثاني,0,0,5,5
36493,innan,0,0,5,5
43284,niets,0,0,5,5
35226,vanaf,0,0,5,5
9592,background,2,2,3,5
13612,olurdu,0,0,5,5
7989,civiltà,1,5,0,5
8663,essenzialmente,1,5,0,5
48437,изменения,0,0,5,5
33645,rates,0,0,5,5
50999,hold,0,0,5,5
43294,bijna,0,0,5,5
28999,गयी।,0,0,5,5
51152,possível,0,0,5,5
22765,ano,0,0,5,5
5508,bibliotecari,1,5,0,5
50093,entirely,0,0,5,5
21077,anderes,0,0,5,5
6456,piccolo,1,5,0,5
16150,किया।,0,0,5,5
37029,kaynak,0,0,5,5
33389,remaining,0,0,5,5
18316,പറയാം,0,0,5,5
21067,histoire,0,0,5,5
10330,onderzoek,0,0,5,5
15338,cells,0,0,5,5
22718,கவலைப்பட,0,0,5,5
14247,känner,0,0,5,5
16095,nouvelles,0,0,5,5
3095,fluido,2,2,3,5
27048,पूछा,0,0,5,5
7980,mentalmente,2,3,2,5
10308,kwam,0,0,5,5
28943,announced,0,0,5,5
43254,ഉപയോഗിച്ച്,0,0,5,5
43255,ξέρεις,0,0,5,5
40477,lot,0,0,5,5
42731,components,0,0,5,5
52218,αυτές,0,0,5,5
38655,founded,0,0,5,5
50095,whether,0,0,5,5
22736,முற்றிலும்,0,0,5,5
28954,patterns,0,0,5,5
3096,dirmi,1,5,0,5
39160,invés,0,0,5,5
45202,لأن,0,0,5,5
1212,arts,2,1,4,5
20574,καλύτερο,0,0,5,5
1793,necessità,1,5,0,5
1794,notevole,1,5,0,5
9596,polinomiale,1,5,0,5
46014,الموقع,0,0,5,5
10242,சொல்வது,0,0,5,5
20538,leute,0,0,5,5
28227,такими,0,0,5,5
28717,continuer,0,0,5,5
20392,snälla,0,0,5,5
33332,problemet,0,0,5,5
38685,कोमन्स,0,0,5,5
38683,ट्रेडमार्क,0,0,5,5
46404,initial,0,0,5,5
24980,talvez,0,0,5,5
24976,visual,0,0,5,5
285,pm,2,1,4,5
22533,hombres,0,0,5,5
22537,identité,0,0,5,5
44846,referencia,0,0,5,5
15925,वाला,0,0,5,5
3043,denota,2,2,3,5
10143,نفس,0,0,5,5
13583,night,0,0,5,5
31011,ihrem,0,0,5,5
21115,അവന്റെ,0,0,5,5
15940,правок,0,0,5,5
12224,immer,0,0,5,5
32185,ganze,0,0,5,5
34163,الصفحات,0,0,5,5
50404,nye,0,0,5,5
28225,ακούγεται,0,0,5,5
14110,répéter,0,0,5,5
39063,يستخدم,0,0,5,5
36671,नीचे,0,0,5,5
7915,identificato,1,5,0,5
5837,futura,2,3,2,5
3539,digital,2,1,4,5
47142,julho,0,0,5,5
5830,abstract,2,3,2,5
32174,ξανά,0,0,5,5
26375,ಸಾಮಾನ್ಯ,0,0,5,5
15867,varje,0,0,5,5
36693,ಮತ್ತೆ,0,0,5,5
27031,uniquement,0,0,5,5
28237,ഭാഷകളിൽ,0,0,5,5
8652,letteratura,1,5,0,5
12334,comercial,0,0,5,5
5821,campagna,1,5,0,5
40965,services,0,0,5,5
45989,सर्च,0,0,5,5
5816,immediatamente,1,5,0,5
51851,zag,0,0,5,5
51486,ಮೆಲ್ಲಿ,0,0,5,5
48571,ಮಾಡಿದ್ದೇನೆ,0,0,5,5
46332,useful,0,0,5,5
39029,cuál,0,0,5,5
22004,remains,0,0,5,5
36627,least,0,0,5,5
19028,உதாரணமாக,0,0,5,5
6388,entrambi,1,5,0,5
40562,thought,0,0,5,5
1669,limitate,1,5,0,5
38665,quien,0,0,5,5
22627,inloggade,0,0,5,5
52228,forskellige,0,0,5,5
10213,കാര്യങ്ങളും,0,0,5,5
44820,forvirret,0,0,5,5
30994,σήμερα,0,0,5,5
18541,egna,0,0,5,5
47199,अकादमिक,0,0,5,5
18500,दे,0,0,5,5
10197,வெவ்வேறு,0,0,5,5
258,diventando,1,5,0,5
24908,prêmio,0,0,5,5
6391,ciffolilli,2,2,3,5
32595,controle,0,0,5,5
22633,डेटाबेस,0,0,5,5
31190,verder,0,0,5,5
10220,fake,0,0,5,5
28215,birinin,0,0,5,5
10179,concerns,0,0,5,5
32867,inc,0,0,5,5
39078,entendi,0,0,5,5
9619,affatto,1,5,0,5
18491,analysera,0,0,5,5
26369,delar,0,0,5,5
47206,göbl,0,0,5,5
1197,juan,2,2,3,5
27040,genre,0,0,5,5
18547,feitas,0,0,5,5
9638,patrimonio,1,5,0,5
9630,disegno,1,5,0,5
1787,trimestre,2,2,3,5
8292,φύσις,2,2,2,4
31838,previous,0,0,4,4
33998,poor,0,0,4,4
49276,чего,0,0,4,4
8304,africa,2,3,1,4
13756,июня,0,0,4,4
21257,chacun,0,0,4,4
33982,bis,0,0,4,4
49202,الثانية,0,0,4,4
30361,സമയം,0,0,4,4
20889,took,0,0,4,4
2208,russa,2,3,1,4
20926,direito,0,0,4,4
30155,खा,0,0,4,4
49401,карета,0,0,4,4
2046,larousse,2,2,2,4
46405,reviews,0,0,4,4
26357,हुई,0,0,4,4
13482,tomorrow,0,0,4,4
20912,särskilt,0,0,4,4
8826,sorprendente,2,2,2,4
46215,riquezas,0,0,4,4
3843,catalano,1,4,0,4
46415,seven,0,0,4,4
20868,dur,0,0,4,4
41463,خبراء,0,0,4,4
2214,click,2,2,2,4
26609,kwaliteit,0,0,4,4
21373,sense,0,0,4,4
41361,dort,0,0,4,4
2211,rubini,1,4,0,4
38022,écologie,0,0,4,4
2109,nascosti,1,4,0,4
26607,outputs,0,0,4,4
8306,tribunale,1,4,0,4
46379,beginnen,0,0,4,4
26351,catégories,0,0,4,4
41433,डाल,0,0,4,4
13363,barn,0,0,4,4
13507,answer,0,0,4,4
33953,dollar,0,0,4,4
31791,नशीली,0,0,4,4
13369,чегото,0,0,4,4
8528,raccomandazione,1,4,0,4
8765,ambientali,1,4,0,4
26531,σελίδα,0,0,4,4
13593,vanligt,0,0,4,4
46323,أقل,0,0,4,4
21025,ninguna,0,0,4,4
52368,ange,0,0,4,4
21027,plads,0,0,4,4
2078,anonimato,2,3,1,4
13662,græde,0,0,4,4
8763,suffisso,1,4,0,4
8728,pezzo,1,4,0,4
34627,ആംഗിൾ,0,0,4,4
38236,interactive,0,0,4,4
2142,vendita,1,4,0,4
31867,ஆண்டின்,0,0,4,4
13582,natuurlijk,0,0,4,4
46274,aldrig,0,0,4,4
41411,entendu,0,0,4,4
21310,skapa,0,0,4,4
49310,أصدقائي,0,0,4,4
13581,друзья,0,0,4,4
26467,dónde,0,0,4,4
8435,varma,2,2,2,4
38099,concerned,0,0,4,4
21125,az,0,0,4,4
38061,clara,0,0,4,4
21315,ದಿನ,0,0,4,4
41593,института,0,0,4,4
2065,doveva,1,4,0,4
26539,statistik,0,0,4,4
839,comparsa,1,4,0,4
13602,novas,0,0,4,4
8454,giusto,1,4,0,4
2179,retrieval,2,1,3,4
34680,básicas,0,0,4,4
850,sequenze,1,4,0,4
2153,enmwikipediaorg,2,1,3,4
13610,comments,0,0,4,4
51843,ansiklopedisi,0,0,4,4
13417,viele,0,0,4,4
21305,அவை,0,0,4,4
21062,μπορούσα,0,0,4,4
51846,dagliga,0,0,4,4
32883,kwamen,0,0,4,4
21304,baan,0,0,4,4
21081,sucede,0,0,4,4
41554,skönhet,0,0,4,4
8495,genetico,1,4,0,4
41556,latter,0,0,4,4
41567,legais,0,0,4,4
8482,andato,1,4,0,4
38226,लिखे,0,0,4,4
2077,personalmente,2,3,1,4
13639,सहकर्मी,0,0,4,4
21055,வேல்ஸ்,0,0,4,4
32889,verkauft,0,0,4,4
13643,ambos,0,0,4,4
13644,lektioner,0,0,4,4
8472,formare,1,4,0,4
8469,ripetutamente,1,4,0,4
2068,impossibile,1,4,0,4
38232,länkar,0,0,4,4
8465,simile,1,4,0,4
49322,wikipediaartikel,0,0,4,4
41585,yanlış,0,0,4,4
32869,sucesso,0,0,4,4
26540,لدى,0,0,4,4
26250,início,0,0,4,4
46223,—como,0,0,4,4
49376,citou,0,0,4,4
8363,scrivono,1,4,0,4
8698,prendendo,1,4,0,4
8368,incarichi,1,4,0,4
46366,código,0,0,4,4
2116,aiutarmi,1,4,0,4
38182,wrong,0,0,4,4
8373,presentate,1,4,0,4
13544,dessas,0,0,4,4
49375,लगा,0,0,4,4
20946,apportées,0,0,4,4
21168,främst,0,0,4,4
31856,வேடிக்கையான,0,0,4,4
51892,exatamente,0,0,4,4
33957,പദ്ധതികൾ,0,0,4,4
41481,expérience,0,0,4,4
38179,verstaan,0,0,4,4
8360,minimo,1,4,0,4
38129,боюсь,0,0,4,4
26587,mudança,0,0,4,4
8802,premendo,1,4,0,4
26417,कितना,0,0,4,4
8354,inaffidabile,1,4,0,4
26334,правила,0,0,4,4
51823,функционирование,0,0,4,4
8690,uscì,1,4,0,4
41643,octubre,0,0,4,4
41430,έναν,0,0,4,4
2200,associata,1,4,0,4
21348,seconde,0,0,4,4
26407,जिससे,0,0,4,4
49386,volontaires,0,0,4,4
21164,enojado,0,0,4,4
13729,substantially,0,0,4,4
30164,اعتبارًا,0,0,4,4
2134,prossimo,1,4,0,4
41416,ഞാൻ‌,0,0,4,4
8785,esercito,1,4,0,4
31860,ನೀಡಲು,0,0,4,4
13696,akıcı,0,0,4,4
46434,freund,0,0,4,4
13561,கட்டற்ற,0,0,4,4
8714,uv,2,2,2,4
13444,നഷ്ടം,0,0,4,4
13692,получаете,0,0,4,4
903,gestiti,1,4,0,4
2061,faccia,1,4,0,4
8778,faccio,1,4,0,4
13402,பல்வேறு,0,0,4,4
13403,जांच,0,0,4,4
41505,allez,0,0,4,4
30373,ஏனென்றால்,0,0,4,4
41503,இதை,0,0,4,4
13552,وإذا,0,0,4,4
21284,സ്വാഗതം,0,0,4,4
35733,corrigés,0,0,4,4
49296,praten,0,0,4,4
8707,personale,1,4,0,4
13715,повторить,0,0,4,4
832,anderson,2,1,3,4
26565,happy,0,0,4,4
13391,inmiddels,0,0,4,4
875,bell,2,3,1,4
13723,наиболее,0,0,4,4
46351,البرنامج,0,0,4,4
33981,verpest,0,0,4,4
26571,court,0,0,4,4
8788,tenute,1,4,0,4
3577,bambino,1,4,0,4
31914,channel,0,0,4,4
22896,internationale,0,0,4,4
47356,détectés,0,0,4,4
24631,சொற்களை,0,0,4,4
39247,zones,0,0,4,4
24622,humanité,0,0,4,4
11990,quotidienne,0,0,4,4
10479,åka,0,0,4,4
24614,hope,0,0,4,4
11983,aquela,0,0,4,4
24606,கவலையும்,0,0,4,4
10494,अ,0,0,4,4
3573,slate,2,1,3,4
24597,कहता,0,0,4,4
11976,حد,0,0,4,4
32542,മുതൽ,0,0,4,4
32235,zusammen,0,0,4,4
22913,tipos,0,0,4,4
40371,champ,0,0,4,4
48328,senin,0,0,4,4
24574,stable,0,0,4,4
1591,rapido,1,4,0,4
24642,нескольких,0,0,4,4
48362,बनाने,0,0,4,4
13349,flest,0,0,4,4
24702,allowed,0,0,4,4
34410,initiatives,0,0,4,4
24714,رائعًا,0,0,4,4
24711,fact,0,0,4,4
10387,ellas,0,0,4,4
40439,ആവശ്യമാണ്,0,0,4,4
10391,κουμπί,0,0,4,4
1225,esterni,1,4,0,4
24706,പറയുകയും,0,0,4,4
52051,العلمية,0,0,4,4
39208,progrès,0,0,4,4
24644,coming,0,0,4,4
22815,obra,0,0,4,4
12056,других,0,0,4,4
22822,permitir,0,0,4,4
22848,अमेरिका,0,0,4,4
47342,أفهم,0,0,4,4
32550,क्रिएटिव,0,0,4,4
40398,looking,0,0,4,4
12010,ним,0,0,4,4
40397,lyser,0,0,4,4
24554,sabor,0,0,4,4
11947,கிட்டத்தட்ட,0,0,4,4
40361,देखते,0,0,4,4
40301,مستخدم,0,0,4,4
10605,underlättar,0,0,4,4
24453,puissance,0,0,4,4
47421,φοβάμαι,0,0,4,4
39372,geweldige,0,0,4,4
39376,amplamente,0,0,4,4
23013,ouvir,0,0,4,4
52197,värt,0,0,4,4
39378,بعتني,0,0,4,4
40303,imod,0,0,4,4
23024,правильно,0,0,4,4
35475,σαββατοκύριακο,0,0,4,4
48244,killar,0,0,4,4
23026,дочь,0,0,4,4
47439,மட்டுமே,0,0,4,4
40295,അമ്മ,0,0,4,4
1562,servire,1,4,0,4
11847,denke,0,0,4,4
24401,lesquels,0,0,4,4
10653,contexte,0,0,4,4
11840,creado,0,0,4,4
22998,sådan,0,0,4,4
39359,spelar,0,0,4,4
24471,बौद्धिक,0,0,4,4
11889,clasificación,0,0,4,4
11941,настолько,0,0,4,4
48309,diversas,0,0,4,4
34396,каждый,0,0,4,4
24530,vaak,0,0,4,4
10550,दस,0,0,4,4
39309,αριθμός,0,0,4,4
48290,них,0,0,4,4
24512,finalidad,0,0,4,4
11915,brödet,0,0,4,4
48287,correspondant,0,0,4,4
22964,сми,0,0,4,4
24505,bit,0,0,4,4
10574,enig,0,0,4,4
24504,steeds,0,0,4,4
3603,precipitazioni,1,4,0,4
3602,appare,1,4,0,4
24486,அவரது,0,0,4,4
11893,gender,0,0,4,4
22992,சரளமாக,0,0,4,4
22792,afraid,0,0,4,4
12086,الأشياء,0,0,4,4
12088,expertos,0,0,4,4
40596,миллионов,0,0,4,4
10146,passed,0,0,4,4
32605,sålde,0,0,4,4
48547,présente,0,0,4,4
24944,läsare,0,0,4,4
22558,pantano,0,0,4,4
22562,connected,0,0,4,4
39058,അതെ,0,0,4,4
12278,செய்த,0,0,4,4
1673,sorta,1,4,0,4
24931,تمانع,0,0,4,4
24882,पारंपरिक,0,0,4,4
48532,pedidos,0,0,4,4
12272,stället,0,0,4,4
32192,той,0,0,4,4
12269,favorita,0,0,4,4
22596,давай,0,0,4,4
35620,ചെറിയ,0,0,4,4
24907,проблем,0,0,4,4
24900,ಹೇ,0,0,4,4
39079,ordinateurs,0,0,4,4
1681,attivamente,1,4,0,4
3612,alghe,1,4,0,4
10142,publicerar,0,0,4,4
30335,публикации,0,0,4,4
1161,presupposto,1,4,0,4
12346,ಬಳಸುವ,0,0,4,4
25024,وظيفة,0,0,4,4
10086,بذلك,0,0,4,4
3564,cifre,1,4,0,4
12335,översvämmad,0,0,4,4
48582,diriezvous,0,0,4,4
40626,incident,0,0,4,4
51137,പോകണം,0,0,4,4
1163,precisione,1,4,0,4
40622,fungi,0,0,4,4
39025,members,0,0,4,4
48569,welke,0,0,4,4
10120,котором,0,0,4,4
12316,للحصول,0,0,4,4
39031,лет,0,0,4,4
30238,ಬಟನ್,0,0,4,4
10126,graag,0,0,4,4
48564,stomverbaasd,0,0,4,4
1193,attuali,1,4,0,4
12229,tipp,0,0,4,4
10372,μερικά,0,0,4,4
24746,बदल,0,0,4,4
22746,næsten,0,0,4,4
10321,incluyendo,0,0,4,4
32572,sollte,0,0,4,4
1631,conoscere,1,4,0,4
22754,sommige,0,0,4,4
1630,derakhshan,2,2,2,4
10331,tegen,0,0,4,4
10333,энциклопедией,0,0,4,4
40464,ಎಲ್ಲವೂ,0,0,4,4
48430,derechos,0,0,4,4
1660,liberi,1,4,0,4
10348,разными,0,0,4,4
48428,भाग्यशाली,0,0,4,4
10350,licencia,0,0,4,4
1628,commenti,1,4,0,4
1627,difficili,1,4,0,4
40455,dynamic,0,0,4,4
22775,pântano,0,0,4,4
47300,വീട്ടിലേക്ക്,0,0,4,4
40448,mudanças,0,0,4,4
22737,rejse,0,0,4,4
24781,раздела,0,0,4,4
12156,références,0,0,4,4
1646,implicitamente,2,3,1,4
51091,files,0,0,4,4
22639,نعم,0,0,4,4
40537,himlen,0,0,4,4
39103,staat,0,0,4,4
1198,accadono,1,4,0,4
1656,aiuto,1,4,0,4
32584,इतिहास,0,0,4,4
22662,வண்டியில்,0,0,4,4
47238,كبير,0,0,4,4
12192,antar,0,0,4,4
24842,worldwide,0,0,4,4
10263,industrial,0,0,4,4
10276,सुना,0,0,4,4
12174,विचार,0,0,4,4
24807,योगदान,0,0,4,4
39137,जर्मन,0,0,4,4
24798,تسمح,0,0,4,4
22714,minuten,0,0,4,4
10292,статьях,0,0,4,4
23051,दृष्टिकोण,0,0,4,4
40281,самом,0,0,4,4
48223,trabalhe,0,0,4,4
11412,entschuldigen,0,0,4,4
1384,scarsa,1,4,0,4
11091,akşam,0,0,4,4
11095,νομίζω,0,0,4,4
23548,ans,0,0,4,4
47939,fit,0,0,4,4
23913,مجتمع,0,0,4,4
39948,projekt,0,0,4,4
39944,popularity,0,0,4,4
47933,nuevas,0,0,4,4
1391,conflitto,1,4,0,4
52128,single,0,0,4,4
35469,propia,0,0,4,4
47742,existing,0,0,4,4
47923,sofisticado,0,0,4,4
11393,σχέδια,0,0,4,4
11126,रखने,0,0,4,4
11390,அவர்களிடம்,0,0,4,4
39930,ಸಾಕಷ್ಟು,0,0,4,4
47921,septiembre,0,0,4,4
39733,spel,0,0,4,4
47942,unutmayın,0,0,4,4
11083,उचित,0,0,4,4
23536,gonna,0,0,4,4
11430,പകരം,0,0,4,4
40014,plates,0,0,4,4
23462,فأنت,0,0,4,4
23990,recognized,0,0,4,4
11478,όλοι,0,0,4,4
32334,άρχισε,0,0,4,4
39668,يهم,0,0,4,4
34278,متعبًا,0,0,4,4
11466,σχεδόν,0,0,4,4
23970,"
विकिपीडिया",0,0,4,4
1374,soli,1,4,0,4
23965,पृष्ठों,0,0,4,4
23957,closely,0,0,4,4
11059,concern,0,0,4,4
47709,ब्रिटेन,0,0,4,4
11069,haut,0,0,4,4
11439,favorit,0,0,4,4
11074,distinguished,0,0,4,4
11431,digo,0,0,4,4
11079,γίνεται,0,0,4,4
11134,knap,0,0,4,4
1460,stia,1,4,0,4
11508,ಯೋಗ್ಯವಾಗಿಲ್ಲ,0,0,4,4
23743,എന്തായാലും,0,0,4,4
1417,interessanti,1,4,0,4
23666,делает,0,0,4,4
39813,kvar,0,0,4,4
11309,bedre,0,0,4,4
23755,aime,0,0,4,4
11308,notably,0,0,4,4
23672,británica,0,0,4,4
23673,engelsk,0,0,4,4
1436,gas,2,3,1,4
11298,இரவு,0,0,4,4
23587,உள்ளது,0,0,4,4
32381,слишком,0,0,4,4
39828,estabas,0,0,4,4
32382,nacht,0,0,4,4
23728,ceux,0,0,4,4
32394,എന്നു,0,0,4,4
39857,event,0,0,4,4
47823,evet,0,0,4,4
3589,pur,2,3,1,4
3591,giardino,1,4,0,4
39808,प्रभाव,0,0,4,4
23768,غالبًا,0,0,4,4
39806,வார,0,0,4,4
23771,américaine,0,0,4,4
11140,тупой,0,0,4,4
39919,nächste,0,0,4,4
47757,contributed,0,0,4,4
23860,इसमें,0,0,4,4
47908,menor,0,0,4,4
47760,spanish,0,0,4,4
11154,कैसा,0,0,4,4
47902,поддерживает,0,0,4,4
51108,வருந்துகிறேன்,0,0,4,4
11355,gidiyor,0,0,4,4
47886,planos,0,0,4,4
1406,filtraggio,1,4,0,4
11341,τίποτα,0,0,4,4
47777,fantastisch,0,0,4,4
23807,culturels,0,0,4,4
47785,lovely,0,0,4,4
11325,போமிஸ்,0,0,4,4
1410,fica,2,1,3,4
47859,durum,0,0,4,4
24016,άρεσε,0,0,4,4
11513,creó,0,0,4,4
34378,propios,0,0,4,4
11722,vermasselt,0,0,4,4
32482,sak,0,0,4,4
48150,originais,0,0,4,4
1531,ipotetico,1,4,0,4
23150,médio,0,0,4,4
1302,elliot,2,2,2,4
24271,работает,0,0,4,4
40214,plaît,0,0,4,4
23163,plannen,0,0,4,4
48132,всем,0,0,4,4
47531,perdido,0,0,4,4
1323,rimettiti,1,4,0,4
10810,scientifique,0,0,4,4
24224,भिन्न,0,0,4,4
10813,inquiétez,0,0,4,4
23204,économie,0,0,4,4
23226,உதவ,0,0,4,4
1517,rimasto,1,4,0,4
48110,பொதுவான,0,0,4,4
48099,محرر,0,0,4,4
10848,discovering,0,0,4,4
23126,റൊട്ടി,0,0,4,4
48158,തെറ്റുകൾ,0,0,4,4
24288,mesure,0,0,4,4
24289,nombres,0,0,4,4
23072,diferente,0,0,4,4
47468,दिल,0,0,4,4
1288,impara,1,4,0,4
48201,långsamt,0,0,4,4
35465,screwed,0,0,4,4
48198,वेबसाइट,0,0,4,4
24349,arkadaşlarımla,0,0,4,4
11806,près,0,0,4,4
32272,shows,0,0,4,4
52190,fått,0,0,4,4
34371,عزيزي,0,0,4,4
32484,possibles,0,0,4,4
10722,अप्रैल,0,0,4,4
24318,παιδιά,0,0,4,4
48174,laissezmoi,0,0,4,4
11774,predictive,0,0,4,4
23111,sold,0,0,4,4
23112,navn,0,0,4,4
23117,primera,0,0,4,4
24196,സ്വതന്ത്ര,0,0,4,4
40143,isto,0,0,4,4
11003,ತನ್ನ,0,0,4,4
10964,product,0,0,4,4
1346,individuo,2,3,1,4
23362,font,0,0,4,4
40060,människor,0,0,4,4
10940,prijs,0,0,4,4
34346,bons,0,0,4,4
48038,servir,0,0,4,4
23391,avis,0,0,4,4
24088,identified,0,0,4,4
3967,addestrati,1,4,0,4
40043,crítica,0,0,4,4
23271,fundador,0,0,4,4
11543,hoy,0,0,4,4
39626,जारी,0,0,4,4
23407,однажды,0,0,4,4
23412,actual,0,0,4,4
11535,café,0,0,4,4
24047,publié,0,0,4,4
40025,éxito,0,0,4,4
11518,egal,0,0,4,4
24033,försökt,0,0,4,4
24121,कभीकभी,0,0,4,4
48050,அதற்கு,0,0,4,4
1344,madrid,2,1,3,4
47615,إجراؤها,0,0,4,4
23278,leitor,0,0,4,4
3972,ero,1,4,0,4
10872,visiteurs,0,0,4,4
39551,primeiro,0,0,4,4
39553,nonlinear,0,0,4,4
47585,прежде,0,0,4,4
23286,gespräch,0,0,4,4
40120,κλαίει,0,0,4,4
10881,anderer,0,0,4,4
34353,damit,0,0,4,4
40112,significantly,0,0,4,4
48071,employ,0,0,4,4
32452,ಇಂಗ್ಲಿಷ್,0,0,4,4
39570,sociala,0,0,4,4
48066,buluşma,0,0,4,4
1337,creativa,1,4,0,4
47601,потрясающе,0,0,4,4
24135,गई,0,0,4,4
23333,места,0,0,4,4
1160,asia,2,2,2,4
25041,özgür,0,0,4,4
48609,behöver,0,0,4,4
9286,stabilite,1,4,0,4
996,distinzione,1,4,0,4
51950,heures,0,0,4,4
1907,rimuovere,1,4,0,4
49023,الزاوية,0,0,4,4
21715,bilgiler,0,0,4,4
25856,letterlijk,0,0,4,4
41140,studien,0,0,4,4
49012,स्वतंत्र,0,0,4,4
1901,bassa,1,4,0,4
49010,committee,0,0,4,4
1890,merleauponty,2,2,2,4
38482,पुरस्कार,0,0,4,4
25837,argent,0,0,4,4
1895,sembravano,1,4,0,4
9306,equilibrio,1,4,0,4
49003,natürlich,0,0,4,4
12986,بسبب,0,0,4,4
25829,planes,0,0,4,4
25815,источника,0,0,4,4
25808,«википедии»,0,0,4,4
4042,tosh,2,2,2,4
30354,вики,0,0,4,4
9240,probabile,1,4,0,4
1914,mailing,2,2,2,4
9156,stub,2,3,1,4
9158,generalista,1,4,0,4
38438,neem,0,0,4,4
21636,technologie,0,0,4,4
21648,erhalten,0,0,4,4
49050,चरण,0,0,4,4
51942,farklı,0,0,4,4
13053,நாம்,0,0,4,4
25897,ಇದನ್ನು,0,0,4,4
9201,nominata,1,4,0,4
46670,αύριο,0,0,4,4
9211,percettroni,1,4,0,4
25888,pratique,0,0,4,4
988,cell,2,1,3,4
13037,أعلم,0,0,4,4
9227,richiesto,1,4,0,4
49031,подумать,0,0,4,4
32756,hein,0,0,4,4
49029,എന്നോട്,0,0,4,4
9326,breiman,2,2,2,4
34055,espacio,0,0,4,4
21631,εντελώς,0,0,4,4
12880,trabajar,0,0,4,4
38564,regional,0,0,4,4
9422,applicare,1,4,0,4
1025,risposte,1,4,0,4
4037,divenne,1,4,0,4
48941,समर्पित,0,0,4,4
52286,tuvo,0,0,4,4
1031,color,2,1,3,4
25689,één,0,0,4,4
32037,تأخذ,0,0,4,4
32733,முதலில்,0,0,4,4
21762,vrouwen,0,0,4,4
38577,ಅಲ್ಲಿ,0,0,4,4
4036,citizen,2,1,3,4
32040,ديسمبر,0,0,4,4
38588,faites,0,0,4,4
9467,osservare,1,4,0,4
34517,celles,0,0,4,4
12862,imagine,0,0,4,4
9474,gratuite,2,3,1,4
9477,contributore,1,4,0,4
25712,essentiellement,0,0,4,4
48950,исследования,0,0,4,4
1024,gradualmente,1,4,0,4
51964,версия,0,0,4,4
32020,nedan,0,0,4,4
25801,λυπάμαι,0,0,4,4
32021,lentement,0,0,4,4
1883,pubbliche,1,4,0,4
32023,værd,0,0,4,4
12947,polaco,0,0,4,4
12945,enciclopédica,0,0,4,4
41106,hemen,0,0,4,4
38542,amanhã,0,0,4,4
21793,sted,0,0,4,4
9381,energetica,1,4,0,4
9392,potenziali,1,4,0,4
1866,parentesi,1,4,0,4
1022,padre,2,3,1,4
48954,uppslagsverk,0,0,4,4
38558,महत्वपूर्ण,0,0,4,4
41084,traffic,0,0,4,4
41082,side,0,0,4,4
1859,visibili,1,4,0,4
21633,automática,0,0,4,4
21616,vacker,0,0,4,4
1037,intervallo,1,4,0,4
31953,possibly,0,0,4,4
8907,introduce,2,3,1,4
49164,أوه,0,0,4,4
32817,لأنني,0,0,4,4
46536,τελευταία,0,0,4,4
8922,esperanto,2,2,2,4
26120,treffen,0,0,4,4
13270,key,0,0,4,4
8930,affidamento,1,4,0,4
46549,редакторов,0,0,4,4
32810,сообщество,0,0,4,4
49129,nehmen,0,0,4,4
8946,wikiwiki,2,2,2,4
8947,essenziali,1,4,0,4
46557,mayores,0,0,4,4
1997,ruolo,1,4,0,4
52326,κόρη,0,0,4,4
8961,basate,1,4,0,4
21513,vendiste,0,0,4,4
34021,enciclopedias,0,0,4,4
13215,प्रारंभ,0,0,4,4
34585,ಸ್ಥಳದಲ್ಲಿ,0,0,4,4
46520,l’anthropologie,0,0,4,4
31928,अक्टूबर,0,0,4,4
38305,одно,0,0,4,4
26182,considéré,0,0,4,4
34007,ध्वनि,0,0,4,4
8853,apertura,2,3,1,4
49184,permettre,0,0,4,4
41336,dynamique,0,0,4,4
21409,μπορούσες,0,0,4,4
2035,offrire,1,4,0,4
32822,اللغة,0,0,4,4
13317,المقال,0,0,4,4
21429,നല്ലത്,0,0,4,4
21430,التغييرات,0,0,4,4
919,dinamica,1,4,0,4
13307,ಅದ್ಭುತವಾಗಿದೆ,0,0,4,4
49173,நேரங்களில்,0,0,4,4
8882,descritta,1,4,0,4
49171,mu,0,0,4,4
34010,flere,0,0,4,4
13305,версии,0,0,4,4
21445,первой,0,0,4,4
34553,includes,0,0,4,4
41256,snällt,0,0,4,4
21615,degrees,0,0,4,4
41235,oktober,0,0,4,4
38396,രാത്രി,0,0,4,4
13148,الذهب,0,0,4,4
21566,algemeen,0,0,4,4
13144,helpen,0,0,4,4
31987,ಮಾರಿದ್ದೀರಿ,0,0,4,4
21570,drei,0,0,4,4
9083,accessibili,1,4,0,4
21574,diaria,0,0,4,4
9090,sola,2,2,2,4
38415,سانجر,0,0,4,4
46588,glas,0,0,4,4
1956,arti,1,4,0,4
25972,citing,0,0,4,4
41230,होना,0,0,4,4
25970,проект,0,0,4,4
25961,botão,0,0,4,4
1950,funzionare,1,4,0,4
31992,άμαξα,0,0,4,4
30202,samarbete,0,0,4,4
21610,январе,0,0,4,4
26005,grec,0,0,4,4
9069,porterò,1,4,0,4
46611,goda,0,0,4,4
46610,cruzados,0,0,4,4
49124,ಮಾಡಬಹುದು,0,0,4,4
9014,campioni,1,4,0,4
26049,योगदानकर्ताओं,0,0,4,4
46592,kullanıcılar,0,0,4,4
13180,constituye,0,0,4,4
31980,kullanılır,0,0,4,4
34029,olabilir,0,0,4,4
1972,cento,2,3,1,4
41247,முறையில்,0,0,4,4
957,pone,1,4,0,4
38371,falsas,0,0,4,4
9045,successivi,1,4,0,4
1967,simboli,1,4,0,4
9050,yahoo,2,2,2,4
38375,fluide,0,0,4,4
30198,logical,0,0,4,4
960,potevo,1,4,0,4
38385,higher,0,0,4,4
49104,reglas,0,0,4,4
21891,speech,0,0,4,4
25654,disagreement,0,0,4,4
1701,pianeti,1,4,0,4
1106,miglioramenti,1,4,0,4
9845,بالمائة,0,0,4,4
40809,gibisin,0,0,4,4
25310,всё,0,0,4,4
9850,gute,0,0,4,4
9852,båda,0,0,4,4
47004,ರಾಕ್,0,0,4,4
48729,imagem,0,0,4,4
1103,maurice,2,2,2,4
25295,haber,0,0,4,4
9873,വഴി,0,0,4,4
9915,filosofía,0,0,4,4
25279,vapor,0,0,4,4
9882,estimation,0,0,4,4
34124,hålla,0,0,4,4
34468,ό,0,0,4,4
25256,уловка,0,0,4,4
1114,jan,2,1,3,4
25251,просмотра,0,0,4,4
9899,skribenter,0,0,4,4
38861,തോന്നുന്നു,0,0,4,4
1101,fondatori,1,4,0,4
9841,wikipédias,0,0,4,4
12550,ονομάζεται,0,0,4,4
32668,rocks,0,0,4,4
9776,tyska,0,0,4,4
9782,கூடுதல்,0,0,4,4
12610,zeg,0,0,4,4
9784,chorando,0,0,4,4
34481,بشأن,0,0,4,4
12603,botón,0,0,4,4
12602,enlightenment,0,0,4,4
12600,allmänhet,0,0,4,4
25368,dumps,0,0,4,4
40849,propos,0,0,4,4
32682,போகிறீர்கள்,0,0,4,4
40841,ൽ,0,0,4,4
1089,belle,2,1,3,4
46968,текст,0,0,4,4
9823,redigering,0,0,4,4
22219,doe,0,0,4,4
12571,உணவு,0,0,4,4
22226,activos,0,0,4,4
22232,temel,0,0,4,4
25229,vriend,0,0,4,4
48687,delen,0,0,4,4
12620,numerous,0,0,4,4
40680,самым,0,0,4,4
38943,среди,0,0,4,4
52241,criterios,0,0,4,4
9999,modificaciones,0,0,4,4
47090,weten,0,0,4,4
22421,resolução,0,0,4,4
48639,licensed,0,0,4,4
22424,فيه,0,0,4,4
30340,médias,0,0,4,4
38956,problemática,0,0,4,4
1705,gustosi,1,4,0,4
38878,वितरित,0,0,4,4
47103,frågor,0,0,4,4
25095,organizações,0,0,4,4
47106,பிடிக்கவில்லை,0,0,4,4
1150,dale,2,1,3,4
25082,solución,0,0,4,4
10038,neutralitet,0,0,4,4
47121,όσο,0,0,4,4
38977,रखते,0,0,4,4
38981,formes,0,0,4,4
40703,continued,0,0,4,4
9986,значения,0,0,4,4
9985,eux,0,0,4,4
1135,anch,1,4,0,4
1120,vada,1,4,0,4
47039,neredeyse,0,0,4,4
4018,sviluppata,1,4,0,4
1727,bloomberg,2,2,2,4
25196,élevé,0,0,4,4
47044,french,0,0,4,4
32638,toch,0,0,4,4
25185,حياتك,0,0,4,4
1722,riflesso,1,4,0,4
1720,herring,2,3,1,4
40745,greater,0,0,4,4
38905,gott,0,0,4,4
48667,προτάσεις,0,0,4,4
12463,الإنجليزية،,0,0,4,4
35689,focused,0,0,4,4
1133,mark,2,1,3,4
12454,mann,0,0,4,4
22358,propio,0,0,4,4
38929,flórida,0,0,4,4
9773,தொந்தரவு,0,0,4,4
38768,angry,0,0,4,4
9484,paradigma,2,3,1,4
46834,anterior,0,0,4,4
3624,ferro,1,4,0,4
21945,предложение,0,0,4,4
25584,universelle,0,0,4,4
48890,தருகிறேன்,0,0,4,4
12792,раньше,0,0,4,4
9578,salto,2,3,1,4
9579,visualizzazione,1,4,0,4
25570,begyndte,0,0,4,4
48875,δεδομένων,0,0,4,4
1796,condivisione,1,4,0,4
25530,كبيرة,0,0,4,4
1795,rari,1,4,0,4
38652,करे,0,0,4,4
46838,heureux,0,0,4,4
21968,hetzelfde,0,0,4,4
38658,संगठन,0,0,4,4
38659,nova,0,0,4,4
12771,статью,0,0,4,4
9617,mac,2,2,2,4
12760,fins,0,0,4,4
46817,மொழிகளில்,0,0,4,4
9540,emozioni,1,4,0,4
41007,hola,0,0,4,4
21932,يوجد,0,0,4,4
9486,anonimi,1,4,0,4
12855,வருத்தப்பட,0,0,4,4
25652,stompe,0,0,4,4
46793,sommes,0,0,4,4
12849,ജോലിയിൽ,0,0,4,4
32051,worries,0,0,4,4
12847,تحتوي,0,0,4,4
9499,riconosciuto,1,4,0,4
9501,mirano,1,4,0,4
38607,bureau,0,0,4,4
9504,vedo,1,4,0,4
25634,கோபமாக,0,0,4,4
38610,wikileaks,0,0,4,4
9517,verbale,2,3,1,4
9519,probabilistici,1,4,0,4
38614,desculpas,0,0,4,4
12830,fürchte,0,0,4,4
21927,വർഷം,0,0,4,4
25617,internacional,0,0,4,4
21993,açı,0,0,4,4
9636,pilastri,1,4,0,4
1756,minori,1,4,0,4
1074,costo,1,4,0,4
32082,thing,0,0,4,4
9694,advocacy,0,0,4,4
22051,hablar,0,0,4,4
38723,இனிமையான,0,0,4,4
9699,ней,0,0,4,4
38728,coined,0,0,4,4
51266,classifier,0,0,4,4
22076,ερώτηση,0,0,4,4
48814,bother,0,0,4,4
9735,diyebilirsiniz,0,0,4,4
9640,wysiwyg,2,2,2,4
51996,журналах,0,0,4,4
22120,former,0,0,4,4
22125,univers,0,0,4,4
12646,hear,0,0,4,4
12636,creo,0,0,4,4
32104,initiative,0,0,4,4
38758,قواعد,0,0,4,4
40872,entrou,0,0,4,4
48786,कौन,0,0,4,4
22046,ಮೊದಲು,0,0,4,4
38714,pardon,0,0,4,4
40945,mam,0,0,4,4
25470,sorun,0,0,4,4
21998,dakika,0,0,4,4
21999,nenhum,0,0,4,4
40968,skrivandet,0,0,4,4
38686,eau,0,0,4,4
22001,لطف,0,0,4,4
12745,момент,0,0,4,4
22010,button,0,0,4,4
48850,xixe siècle,0,0,4,4
22012,avance,0,0,4,4
34082,waard,0,0,4,4
46868,शांत,0,0,4,4
22025,tonto,0,0,4,4
9670,shapiro,2,2,2,4
40950,llegó,0,0,4,4
25489,மகள்,0,0,4,4
3623,larga,2,3,1,4
46886,anders,0,0,4,4
1779,carini,1,4,0,4
51988,multicellular,0,0,4,4
52269,deu,0,0,4,4
11276,رؤية,0,0,4,4
28381,sprogversioner,0,0,4,4
29532,planet,0,0,4,4
30846,ಸ್ನೇಹಿತರು,0,0,4,4
29340,இருந்தார்கள்,0,0,4,4
19391,probleem,0,0,4,4
17973,जिसके,0,0,4,4
35033,olumsuz,0,0,4,4
27999,sentences,0,0,4,4
42614,ven,0,0,4,4
6647,intrusioni,1,4,0,4
35032,éventuellement,0,0,4,4
43527,naziksiniz,0,0,4,4
33193,dafür,0,0,4,4
50663,outubro,0,0,4,4
44495,ответ,0,0,4,4
5093,consentendo,1,4,0,4
469,occupato,1,4,0,4
5092,yasseri,2,2,2,4
27988,heat,0,0,4,4
5089,esterne,1,4,0,4
6670,visualizzate,1,4,0,4
50984,facts,0,0,4,4
27972,ouverte,0,0,4,4
28007,fundada,0,0,4,4
16482,محتوى,0,0,4,4
2767,collegato,1,4,0,4
460,trek,2,1,3,4
37083,unten,0,0,4,4
456,concentrano,1,4,0,4
43517,أظهرت,0,0,4,4
5128,michel,2,2,2,4
50036,английская,0,0,4,4
37086,nonprofit,0,0,4,4
28033,alright,0,0,4,4
15199,aide,0,0,4,4
15198,measured,0,0,4,4
2773,structural,2,1,3,4
17977,fredag,0,0,4,4
19362,χρησιμοποιείται,0,0,4,4
5117,affermare,1,4,0,4
5112,wap,2,1,3,4
28026,другом,0,0,4,4
6625,massima,1,4,0,4
2770,g,2,2,2,4
15182,scientifiques,0,0,4,4
42623,вклад,0,0,4,4
15177,குறிப்பிட்ட,0,0,4,4
15150,attempt,0,0,4,4
19406,medios,0,0,4,4
27968,δωρεάν,0,0,4,4
3253,visti,1,4,0,4
37159,exemplos,0,0,4,4
15083,там,0,0,4,4
43550,ಇಂದು,0,0,4,4
42559,junto,0,0,4,4
33783,tend,0,0,4,4
15077,kennen,0,0,4,4
15076,വാക്കിന്റെ,0,0,4,4
27914,المشروع,0,0,4,4
6761,wikislavia,2,2,2,4
30105,പ്രധാന,0,0,4,4
6732,aggiungere,1,4,0,4
2726,affermava,1,4,0,4
31287,resolution,0,0,4,4
45376,ल्युसेन,0,0,4,4
31289,ofte,0,0,4,4
36232,cambio,0,0,4,4
5056,intenzione,1,4,0,4
27890,ahead,0,0,4,4
36227,छोटे,0,0,4,4
494,provi,1,4,0,4
6737,sale,1,4,0,4
6731,costruire,1,4,0,4
50007,बताने,0,0,4,4
37146,diversos,0,0,4,4
6682,fantasiose,1,4,0,4
6683,certe,1,4,0,4
4155,christian,2,2,2,4
42600,jaar,0,0,4,4
43541,сказал,0,0,4,4
15124,dicho,0,0,4,4
6695,finanziamento,1,4,0,4
29362,democrática,0,0,4,4
45351,faz,0,0,4,4
30839,moon,0,0,4,4
42575,بي,0,0,4,4
31270,உள்ளன,0,0,4,4
16503,αξίζει,0,0,4,4
15108,travaux,0,0,4,4
17943,guess,0,0,4,4
5073,malapena,1,4,0,4
6724,avviene,1,4,0,4
31279,preocupada,0,0,4,4
37153,effective,0,0,4,4
15099,inklusive,0,0,4,4
5132,formattazione,1,4,0,4
15210,específicas,0,0,4,4
28045,huge,0,0,4,4
33214,función,0,0,4,4
19210,defining,0,0,4,4
19212,fram,0,0,4,4
2820,voleva,1,4,0,4
6460,ripristinate,1,4,0,4
3198,altamente,1,4,0,4
163,universalis,2,2,2,4
44560,ടെറിയും,0,0,4,4
30880,oluyor,0,0,4,4
50089,analyses,0,0,4,4
36316,совершенно,0,0,4,4
30418,स्रोतों,0,0,4,4
30632,परिणाम,0,0,4,4
436,giornalista,1,4,0,4
50085,ടെക്സ്റ്റ്,0,0,4,4
6476,cena,2,3,1,4
5209,abbandonato,1,4,0,4
28131,aprendizagem,0,0,4,4
19244,प्रत्येक,0,0,4,4
5206,nphard,2,1,3,4
4245,festa,2,3,1,4
6450,procedure,1,4,0,4
3735,andati,1,4,0,4
19253,w ·,0,0,4,4
42741,الجد,0,0,4,4
166,tue,2,3,1,4
36995,съесть,0,0,4,4
15371,фонда,0,0,4,4
35277,любой,0,0,4,4
19178,ужасное,0,0,4,4
6405,sorpresa,1,4,0,4
45191,away,0,0,4,4
6409,declino,1,4,0,4
19181,políticos,0,0,4,4
6415,aggiustare,1,4,0,4
6441,forti,1,4,0,4
2835,strati,1,4,0,4
44572,glück,0,0,4,4
33215,sentido,0,0,4,4
6428,piangendo,1,4,0,4
28164,appel,0,0,4,4
5226,ridistribuzione,1,4,0,4
19192,instant,0,0,4,4
30009,recentes,0,0,4,4
31207,şu,0,0,4,4
18070,sharp,0,0,4,4
44554,levar,0,0,4,4
5134,anomali,1,4,0,4
19320,ವೀಡಿಯೊವನ್ನು,0,0,4,4
31236,estadounidenses,0,0,4,4
19309,istemek,0,0,4,4
29316,изза,0,0,4,4
6558,roc,2,2,2,4
2790,descola,2,2,2,4
19312,magnifique,0,0,4,4
3731,gong,2,2,2,4
43509,citations,0,0,4,4
5146,records,2,1,3,4
44517,diga,0,0,4,4
3219,lavora,1,4,0,4
19327,वैसे,0,0,4,4
30854,« le,0,0,4,4
28050,theoretical,0,0,4,4
19340,ait,0,0,4,4
455,maggiormente,1,4,0,4
43516,skriva,0,0,4,4
45290,பெற,0,0,4,4
6586,legale,1,4,0,4
6588,stavano,1,4,0,4
30858,मुलाकात,0,0,4,4
6551,memory,2,1,3,4
28123,использование,0,0,4,4
28105,méthodes,0,0,4,4
5196,specialmente,1,4,0,4
36309,noticias,0,0,4,4
6497,professore,1,4,0,4
15299,áreas,0,0,4,4
6499,incompatibili,1,4,0,4
45234,faible,0,0,4,4
6506,patate,1,4,0,4
45240,dica,0,0,4,4
33622,özellikle,0,0,4,4
45245,esfuerzo,0,0,4,4
445,cellulare,1,4,0,4
29280,inget,0,0,4,4
30004,над,0,0,4,4
15262,tam,0,0,4,4
42673,especificamente,0,0,4,4
43488,تقوله,0,0,4,4
43490,término,0,0,4,4
28087,broke,0,0,4,4
31232,büyük,0,0,4,4
2797,trovato,1,4,0,4
19508,processing,0,0,4,4
6788,ottocento,1,4,0,4
15047,demain,0,0,4,4
7095,portali,1,4,0,4
2622,collegate,1,4,0,4
4926,sostiene,1,4,0,4
31409,ورائعة,0,0,4,4
7089,finire,1,4,0,4
16665,situations,0,0,4,4
14835,madde,0,0,4,4
7091,proposito,1,4,0,4
14834,وغير,0,0,4,4
4921,interrogativo,1,4,0,4
7096,istruzioni,1,4,0,4
42396,signification,0,0,4,4
3299,cercare,1,4,0,4
14830,zowel,0,0,4,4
43662,välja,0,0,4,4
3801,storiche,1,4,0,4
17754,أعرف,0,0,4,4
50736,ребята,0,0,4,4
19748,чрезвычайно,0,0,4,4
27642,प्रारंभिक,0,0,4,4
35757,συνομιλία,0,0,4,4
42395,fiabilidad,0,0,4,4
42397,بأن,0,0,4,4
51359,вместе,0,0,4,4
3294,diamo,1,4,0,4
19688,gingen,0,0,4,4
45486,ألا,0,0,4,4
51365,partido,0,0,4,4
42420,komme,0,0,4,4
45490,pesar,0,0,4,4
3292,dartmouth,2,1,3,4
4942,metapedia,2,2,2,4
7048,nobel,2,2,2,4
17772,misstag,0,0,4,4
51363,usadas,0,0,4,4
7079,reinvestimento,1,4,0,4
27671,जिनमें,0,0,4,4
29472,хочешь,0,0,4,4
30602,ataques,0,0,4,4
548,prodotti,1,4,0,4
45501,adelante,0,0,4,4
42403,மில்லியன்,0,0,4,4
29476,باللغة,0,0,4,4
7071,geografici,1,4,0,4
30409,создания,0,0,4,4
4907,magnifico,1,4,0,4
33811,പൂർണ്ണമായും,0,0,4,4
16643,toi,0,0,4,4
42348,acontecendo,0,0,4,4
51356,mantener,0,0,4,4
37382,neler,0,0,4,4
7160,selvagge,1,4,0,4
37384,уже,0,0,4,4
51674,encontrados,0,0,4,4
51675,títulos,0,0,4,4
37400,anyway,0,0,4,4
27556,trabaja,0,0,4,4
44365,nothing,0,0,4,4
45561,couldn,0,0,4,4
27592,understand,0,0,4,4
7195,figura,2,2,2,4
31433,πήρα,0,0,4,4
36137,ranked,0,0,4,4
583,kovitz,2,1,3,4
27539,mostrou,0,0,4,4
51039,ആരംഭിച്ചു,0,0,4,4
7206,roy,2,1,3,4
51351,tittade,0,0,4,4
14741,योजना,0,0,4,4
568,bradley,2,2,2,4
50745,position,0,0,4,4
4900,xkcd,2,1,3,4
2614,manutenzione,1,4,0,4
2615,comprensiva,2,3,1,4
4895,considerate,1,4,0,4
7109,monitoraggio,1,4,0,4
16679,espere,0,0,4,4
19756,difference,0,0,4,4
30791,horas,0,0,4,4
43668,move,0,0,4,4
4884,noioso,1,4,0,4
33591,देना,0,0,4,4
27622,redan,0,0,4,4
27599,impacto,0,0,4,4
7117,lancio,1,4,0,4
14813,deben,0,0,4,4
3310,stabilisce,1,4,0,4
37364,ways,0,0,4,4
33122,copy,0,0,4,4
17743,vardır,0,0,4,4
14799,tribunal,0,0,4,4
49848,बुरा,0,0,4,4
45543,നിങ്ങൾക്കറിയാം,0,0,4,4
37314,ശേഷം,0,0,4,4
44401,populares,0,0,4,4
27882,inga,0,0,4,4
19580,centaines,0,0,4,4
6845,sostentamento,1,4,0,4
6846,biografie,1,4,0,4
19560,quickly,0,0,4,4
37214,предложений,0,0,4,4
33163,recommendation,0,0,4,4
17896,വാൻഡലിസം,0,0,4,4
6860,raccolti,1,4,0,4
51235,moral,0,0,4,4
5025,lato,1,4,0,4
37225,gud,0,0,4,4
45415,handsome,0,0,4,4
33453,verb,0,0,4,4
2692,modificando,2,3,1,4
5018,differenti,1,4,0,4
16552,raised,0,0,4,4
6901,zuppa,1,4,0,4
45435,ensayo,0,0,4,4
44453,appelée,0,0,4,4
27798,dépend,0,0,4,4
37242,detectar,0,0,4,4
6844,classificato,1,4,0,4
27836,empresas,0,0,4,4
16565,умных,0,0,4,4
19528,சூழ்நிலையில்,0,0,4,4
36225,nederlands,0,0,4,4
19514,¿no,0,0,4,4
35304,लिए।,0,0,4,4
45393,conseguiu,0,0,4,4
29386,akademiska,0,0,4,4
17916,pasa,0,0,4,4
5046,sorprende,2,3,1,4
2710,permanente,2,1,3,4
42523,سياسات,0,0,4,4
49959,പ്രവർത്തിക്കുന്ന,0,0,4,4
16542,البيانات,0,0,4,4
19536,fast,0,0,4,4
19540,அன்று,0,0,4,4
6824,territorio,2,3,1,4
19551,المقالة,0,0,4,4
31327,इंजन,0,0,4,4
44471,ಯಾಕೆ,0,0,4,4
15011,såg,0,0,4,4
3675,categorizzazione,1,4,0,4
6836,foresta,1,4,0,4
3724,freedom,2,1,3,4
19612,altına,0,0,4,4
42425,sprechen,0,0,4,4
37293,fluent,0,0,4,4
3281,liberamente,1,4,0,4
6977,espresso,1,4,0,4
27736,bakış,0,0,4,4
31382,ली,0,0,4,4
51367,tage,0,0,4,4
42447,πράγματα,0,0,4,4
27734,boundaries,0,0,4,4
50718,classique,0,0,4,4
42446,inanılmaz,0,0,4,4
49899,الحصول,0,0,4,4
19641,quoted,0,0,4,4
7002,norman,2,1,3,4
49895,सकती,0,0,4,4
19671,spijt,0,0,4,4
36179,मिनट,0,0,4,4
27702,razón,0,0,4,4
2644,singapore,2,2,2,4
27699,trovärdighet,0,0,4,4
42428,frei,0,0,4,4
14889,आधारित,0,0,4,4
3279,copia,1,4,0,4
29440,различные,0,0,4,4
33461,keinen,0,0,4,4
2673,convenzioni,1,4,0,4
42465,gråta,0,0,4,4
44442,books,0,0,4,4
44441,rapid,0,0,4,4
3676,soft,1,4,0,4
6916,sequence,2,1,3,4
6917,cunningham,2,3,1,4
2677,esplosione,1,4,0,4
34961,correspond,0,0,4,4
49915,பார்க்க,0,0,4,4
49912,läser,0,0,4,4
33154,kijken,0,0,4,4
51033,englisch,0,0,4,4
14949,solid,0,0,4,4
14947,aspect,0,0,4,4
4988,shane,2,2,2,4
6943,ea,1,4,0,4
5699,dataset,2,2,2,4
4985,camelcase,2,1,3,4
17826,lío,0,0,4,4
27755,game,0,0,4,4
35275,estaré,0,0,4,4
33219,கணம்,0,0,4,4
28193,yet,0,0,4,4
3004,polacco,1,4,0,4
43025,d’apprentissage,0,0,4,4
5562,coinvolge,1,4,0,4
5559,suggerimenti,1,4,0,4
16109,насчет,0,0,4,4
18364,incluem,0,0,4,4
43271,paar,0,0,4,4
327,occasionalmente,1,4,0,4
28961,بالتأكيد,0,0,4,4
44935,português,0,0,4,4
3101,chris,2,1,3,4
5893,calcolo,1,4,0,4
28619,watching,0,0,4,4
28618,sinds,0,0,4,4
44729,livres,0,0,4,4
18746,estraguei,0,0,4,4
18355,vognen,0,0,4,4
5539,julie,2,2,2,4
43007,promover,0,0,4,4
28609,told,0,0,4,4
5928,enciclopedici,1,4,0,4
50335,ತಿನ್ನಲು,0,0,4,4
15806,consejo,0,0,4,4
5535,presentata,1,4,0,4
36525,فقد,0,0,4,4
4202,inviare,1,4,0,4
15845,extension,0,0,4,4
50460,wasn,0,0,4,4
5863,adatta,1,4,0,4
43039,αστείο,0,0,4,4
28646,tâche,0,0,4,4
36533,языке,0,0,4,4
16085,notre,0,0,4,4
5583,copiare,1,4,0,4
15816,vereceğim,0,0,4,4
28636,julio,0,0,4,4
18711,vilka,0,0,4,4
36523,senaste,0,0,4,4
30451,enstaka,0,0,4,4
30035,хорошая,0,0,4,4
18715,வீடியோவில்,0,0,4,4
28939,devem,0,0,4,4
4198,analitico,1,4,0,4
18718,يقرب,0,0,4,4
16102,ελεύθερου,0,0,4,4
332,locali,1,4,0,4
28979,funcionar,0,0,4,4
50356,परेशानी,0,0,4,4
5479,duro,2,1,3,4
5490,muhammad,2,1,3,4
44707,nós,0,0,4,4
28559,videoyu,0,0,4,4
15730,içindeyim,0,0,4,4
5483,caldo,1,4,0,4
15723,comité,0,0,4,4
31073,agrupamiento,0,0,4,4
36461,genoemd,0,0,4,4
51512,lenguas,0,0,4,4
28552,primero,0,0,4,4
16152,estimated,0,0,4,4
18814,имя,0,0,4,4
33394,المنفرجة,0,0,4,4
42954,நர்சிஸஸ்,0,0,4,4
28530,code,0,0,4,4
44988,gekommen,0,0,4,4
18839,நுபீடியா,0,0,4,4
36784,ami,0,0,4,4
36785,θυμηθείτε,0,0,4,4
30946,ρίζες,0,0,4,4
18796,larger,0,0,4,4
221,password,2,3,1,4
3510,sfondo,1,4,0,4
33294,tópico,0,0,4,4
33646,sister,0,0,4,4
15773,толку,0,0,4,4
5935,individui,1,4,0,4
18755,ಮಾಡಿದ,0,0,4,4
5523,recentemente,1,4,0,4
5521,digita,1,4,0,4
5948,stampate,1,4,0,4
35229,беспокойтесь,0,0,4,4
33297,risk,0,0,4,4
16147,highly,0,0,4,4
50497,niveaux,0,0,4,4
36751,multiples,0,0,4,4
31063,कैच,0,0,4,4
28577,രണ്ട്,0,0,4,4
31067,letzte,0,0,4,4
341,distribuito,1,4,0,4
18792,emprego,0,0,4,4
5506,colombiano,2,2,2,4
343,limitati,1,4,0,4
51449,يبدو,0,0,4,4
16069,guapo,0,0,4,4
5602,sede,1,4,0,4
6030,iniziative,1,4,0,4
5667,ciascun,1,4,0,4
15949,sıra,0,0,4,4
15948,dix,0,0,4,4
28765,själva,0,0,4,4
3055,azienda,1,4,0,4
5672,sala,2,3,1,4
18561,método,0,0,4,4
251,parlamento,2,3,1,4
5668,universalmente,2,3,1,4
3050,unesco,2,2,2,4
36589,trata,0,0,4,4
28824,orientação,0,0,4,4
50396,диск,0,0,4,4
50394,reçu,0,0,4,4
5664,tassi,1,4,0,4
44786,reasons,0,0,4,4
278,campana,2,3,1,4
18569,haft,0,0,4,4
28741,falando,0,0,4,4
5772,emigh,2,3,1,4
5777,confusione,1,4,0,4
274,starò,1,4,0,4
43176,nunca,0,0,4,4
43102,zeer,0,0,4,4
5725,solida,1,4,0,4
43155,ecological,0,0,4,4
18524,désigner,0,0,4,4
3070,inutile,2,3,1,4
36621,العربة,0,0,4,4
50415,arg,0,0,4,4
28789,ಕಡಿಮೆ,0,0,4,4
3065,hegel,2,3,1,4
33350,ആഗ്രഹിക്കുന്നുണ്ടോ,0,0,4,4
28783,ಮಾಡುವ,0,0,4,4
3062,academy,2,2,2,4
16010,gjordes,0,0,4,4
269,predittiva,1,4,0,4
5731,reuters,2,1,3,4
5685,modificate,1,4,0,4
18493,problemen,0,0,4,4
15958,gente,0,0,4,4
36605,başladı,0,0,4,4
50421,elas,0,0,4,4
15955,sikkert,0,0,4,4
16009,ಭಯಾನಕ,0,0,4,4
28855,vaya,0,0,4,4
28856,الأسبوع,0,0,4,4
5850,tratta,1,4,0,4
35176,publica,0,0,4,4
302,distinto,1,4,0,4
43070,bekymre,0,0,4,4
304,origini,1,4,0,4
248,controverse,2,3,1,4
5632,corrette,1,4,0,4
18658,diciembre,0,0,4,4
15859,अलगअलग,0,0,4,4
28673,мило,0,0,4,4
44771,времени,0,0,4,4
44769,présence,0,0,4,4
5637,meccanismo,1,4,0,4
50448,hypothesis,0,0,4,4
51280,πάει,0,0,4,4
50358,générale,0,0,4,4
3085,co,2,2,2,4
28893,ಪ್ರಾರಂಭಿಸಿದಳು,0,0,4,4
33658,точки,0,0,4,4
36712,വന്നു,0,0,4,4
36548,dedicado,0,0,4,4
241,originarie,1,4,0,4
28875,fingers,0,0,4,4
36684,toe,0,0,4,4
30977,पॉलिश,0,0,4,4
5644,tornato,1,4,0,4
43100,أخشى,0,0,4,4
287,lila,2,2,2,4
15905,bonito,0,0,4,4
3040,assouline,2,2,2,4
44863,women,0,0,4,4
36570,ಮಗಳು,0,0,4,4
28709,verbe,0,0,4,4
15896,colaboração,0,0,4,4
5645,carnegiemellon,2,2,2,4
44869,citation,0,0,4,4
16035,rendre,0,0,4,4
35185,cofounder,0,0,4,4
52590,usada,0,0,4,4
44870,reality,0,0,4,4
3079,mathrm,2,2,2,4
33365,согласно,0,0,4,4
18628,obvious,0,0,4,4
18633,diye,0,0,4,4
18641,manmade,0,0,4,4
43074,ferramenta,0,0,4,4
6029,stegbauer,2,2,2,4
44693,historique,0,0,4,4
2840,lille,2,1,3,4
16300,descobriu,0,0,4,4
31149,लग,0,0,4,4
30423,connu,0,0,4,4
16292,терренс,0,0,4,4
6268,bellissima,1,4,0,4
36373,этой,0,0,4,4
5320,featured,2,1,3,4
51185,excepción,0,0,4,4
44620,ಹೆದರುತ್ತೇನೆ,0,0,4,4
35453,बेहद,0,0,4,4
29174,التعديلات,0,0,4,4
30913,തുടങ്ങി,0,0,4,4
16303,mujeres,0,0,4,4
15465,absoluto,0,0,4,4
19083,совет,0,0,4,4
15462,ஜனவரி,0,0,4,4
18173,அன்பே,0,0,4,4
50161,कॉपीराइट,0,0,4,4
6294,situazioni,1,4,0,4
15459,एकमात्र,0,0,4,4
19091,vrije,0,0,4,4
6256,pratiche,1,4,0,4
45113,programmed,0,0,4,4
183,thomas,2,2,2,4
16273,ആഗ്രഹിക്കുന്നു,0,0,4,4
5347,marte,1,4,0,4
28365,செய்யப்பட்ட,0,0,4,4
52544,frequently,0,0,4,4
42842,förklarar,0,0,4,4
51549,острый,0,0,4,4
31145,outlier,0,0,4,4
15519,mesaj,0,0,4,4
28356,tool,0,0,4,4
35452,kez,0,0,4,4
5341,personali,1,4,0,4
3167,descrive,1,4,0,4
35251,herzen,0,0,4,4
36900,relacionado,0,0,4,4
18200,золотой,0,0,4,4
6245,progettata,1,4,0,4
35104,indicate,0,0,4,4
36912,occurs,0,0,4,4
29158,எதையாவது,0,0,4,4
18188,الصفحة,0,0,4,4
35790,devoirs,0,0,4,4
2866,selvaggia,1,4,0,4
31159,énergie,0,0,4,4
401,insegnante,1,4,0,4
5259,distribuita,1,4,0,4
2851,diffusione,1,4,0,4
19130,back,0,0,4,4
421,affrontare,1,4,0,4
15407,correction,0,0,4,4
15406,сэнгер,0,0,4,4
423,distinguono,1,4,0,4
15404,venligt,0,0,4,4
16352,yapılan,0,0,4,4
19134,solgte,0,0,4,4
19138,genoeg,0,0,4,4
36956,namn,0,0,4,4
45167,ссылок,0,0,4,4
19142,ഹേയ്,0,0,4,4
35574,visitas,0,0,4,4
16363,विश्वसनीयता,0,0,4,4
18097,प्रविष्टियों,0,0,4,4
170,industriale,1,4,0,4
19148,reinvestment,0,0,4,4
6385,addestrato,1,4,0,4
5245,josé,2,2,2,4
28248,பயப்படுகிறேன்,0,0,4,4
29212,الغرق,0,0,4,4
6302,host,2,1,3,4
5283,ppt,2,2,2,4
6303,filosofi,1,4,0,4
36936,labor,0,0,4,4
15448,überfüllt,0,0,4,4
51421,fantastiska,0,0,4,4
3775,persino,1,4,0,4
45143,അത്ഭുതകരമായ,0,0,4,4
28275,रोक,0,0,4,4
29199,writers,0,0,4,4
36350,нравится,0,0,4,4
29202,облажался,0,0,4,4
18128,tijdens,0,0,4,4
15431,مستخدمي,0,0,4,4
35087,algum,0,0,4,4
35266,dios,0,0,4,4
35082,preguntar,0,0,4,4
6335,componente,1,4,0,4
42780,meningar,0,0,4,4
44602,ನೋಡುತ್ತೀರಿ,0,0,4,4
5275,tono,2,3,1,4
2854,falun,2,2,2,4
30512,πολλά,0,0,4,4
28369,получил,0,0,4,4
16179,publicidad,0,0,4,4
45026,tycker,0,0,4,4
29072,مواقع,0,0,4,4
45008,streek,0,0,4,4
2951,£,2,1,3,4
15657,mentioned,0,0,4,4
5416,tipico,1,4,0,4
18887,ಭಾವಿಸುತ್ತೇನೆ,0,0,4,4
45020,daglige,0,0,4,4
42915,domains,0,0,4,4
33256,peine,0,0,4,4
35123,مركز,0,0,4,4
18865,زر,0,0,4,4
15636,pelos,0,0,4,4
5413,avrà,1,4,0,4
29082,effects,0,0,4,4
16215,perto,0,0,4,4
197,ucraino,1,4,0,4
6108,ripetere,1,4,0,4
18916,lugares,0,0,4,4
15617,सम्बन्धी,0,0,4,4
50547,örnek,0,0,4,4
18273,mat,0,0,4,4
28487,style,0,0,4,4
51016,titre,0,0,4,4
18284,يحدث,0,0,4,4
18847,identify,0,0,4,4
362,coloro,1,4,0,4
15686,ಹೇಳುತ್ತೀರಿ,0,0,4,4
50522,новые,0,0,4,4
52620,दैनिक,0,0,4,4
4188,moderno,1,4,0,4
52621,बैठक,0,0,4,4
6043,wikinfo,2,1,3,4
3139,windows,2,2,2,4
29064,हिस्सा,0,0,4,4
5430,raccogliere,1,4,0,4
5437,rimasta,1,4,0,4
36805,hørt,0,0,4,4
33396,unless,0,0,4,4
6057,dicotomia,1,4,0,4
4187,chaos,2,1,3,4
15675,benimle,0,0,4,4
36809,tamamen,0,0,4,4
6063,sconosciuta,1,4,0,4
45003,dernier,0,0,4,4
28455,nerede,0,0,4,4
6117,vecchio,1,4,0,4
15536,चुके,0,0,4,4
29128,சரி,0,0,4,4
42875,pedindo,0,0,4,4
50565,συνάντηση,0,0,4,4
16253,complexe,0,0,4,4
192,codifica,1,4,0,4
50214,dons,0,0,4,4
18978,continuous,0,0,4,4
36862,activamente,0,0,4,4
44643,charge,0,0,4,4
35114,разделе,0,0,4,4
15551,homem,0,0,4,4
44647,  articles,0,0,4,4
44642,duas,0,0,4,4
394,autoapprendimento,1,4,0,4
2907,intento,2,1,3,4
6197,funghi,1,4,0,4
31133,अलग,0,0,4,4
29136,processos,0,0,4,4
29142,samme,0,0,4,4
28380,estudantes,0,0,4,4
16268,исследование,0,0,4,4
35246,redes,0,0,4,4
50221,udgivet,0,0,4,4
2933,affermano,1,4,0,4
382,linterweb,2,1,3,4
28452,sonu,0,0,4,4
36834,ongeveer,0,0,4,4
2929,importava,2,3,1,4
16222,вандализм,0,0,4,4
18922,कहना,0,0,4,4
15611,waarin,0,0,4,4
36838,شركة,0,0,4,4
6137,cibi,1,4,0,4
16223,إجراء,0,0,4,4
28439,വേണം,0,0,4,4
18943,advance,0,0,4,4
6146,canzoni,1,4,0,4
18227,kluges,0,0,4,4
51541,mío,0,0,4,4
29100,यकीन,0,0,4,4
36409,editable,0,0,4,4
29112,igång,0,0,4,4
3158,complessiva,1,4,0,4
36848,conocidos,0,0,4,4
29119,functions,0,0,4,4
16716,langsam,0,0,4,4
14944,visas,0,0,4,4
43815,وتريد,0,0,4,4
43844,d’autres,0,0,4,4
14367,உண்மையில்,0,0,4,4
51301,θέση,0,0,4,4
31692,ana,0,0,4,4
42057,τυχερός,0,0,4,4
26834,¿puedo,0,0,4,4
20259,determine,0,0,4,4
7641,mdp,2,2,2,4
42053,വാക്യം,0,0,4,4
50847,जगह,0,0,4,4
49500,لماذا,0,0,4,4
27166,period,0,0,4,4
4632,jordan,2,3,1,4
44243,ഭക്ഷണം,0,0,4,4
30662,തന്റെ,0,0,4,4
33509,stilig,0,0,4,4
2427,regalo,2,3,1,4
37636,ഇതുവരെ,0,0,4,4
4113,reagle,2,2,2,4
42065,incluir,0,0,4,4
20213,zelf,0,0,4,4
4645,espressione,1,4,0,4
20217,फ्लोरिडा,0,0,4,4
17500,प्यार,0,0,4,4
17499,impossible,0,0,4,4
49666,विश्व,0,0,4,4
37868,завтра,0,0,4,4
4642,gnulinux,2,2,2,4
20662,naturelles,0,0,4,4
7614,arbitrale,1,4,0,4
26833,hoje,0,0,4,4
20660,तैयार,0,0,4,4
2429,vegetale,1,4,0,4
29684,وتيري,0,0,4,4
45805,comparando,0,0,4,4
27159,τρία,0,0,4,4
34743,emotions,0,0,4,4
44250,económico,0,0,4,4
776,contesti,1,4,0,4
33879,respeito,0,0,4,4
31559,neerlandés,0,0,4,4
4616,ufficialmente,1,4,0,4
16903,ஒவ்வொரு,0,0,4,4
8038,routine,2,2,2,4
42040,multiple,0,0,4,4
51784,ലഭിച്ചു,0,0,4,4
30395,ಬಳಸಲಾಗುತ್ತದೆ,0,0,4,4
20294,chicos,0,0,4,4
43961,हाल,0,0,4,4
4426,prendo,1,4,0,4
3452,rivolge,1,4,0,4
29714,चीज,0,0,4,4
14313,region,0,0,4,4
44231,soimême,0,0,4,4
20281,तुम्हें,0,0,4,4
17064,mensaje,0,0,4,4
13996,vendu,0,0,4,4
7673,graphic,2,1,3,4
13998,birlikte,0,0,4,4
51326,wants,0,0,4,4
695,ruby,2,2,2,4
14001,responsible,0,0,4,4
36031,först,0,0,4,4
16897,espero,0,0,4,4
31554,नार्सीसा,0,0,4,4
26841,المزيد,0,0,4,4
42045,கடந்து,0,0,4,4
32951,फर्क,0,0,4,4
43975,deseja,0,0,4,4
37666,परिवर्तन,0,0,4,4
49640,réponse,0,0,4,4
7672,play,2,1,3,4
16899,vaut,0,0,4,4
7598,sesso,1,4,0,4
20668,वाक्यांशों,0,0,4,4
2303,preparato,1,4,0,4
13954,सहयोगी,0,0,4,4
8118,ricca,1,4,0,4
4683,strutture,1,4,0,4
52454,पाठ्य,0,0,4,4
20131,creation,0,0,4,4
7521,tecnico,1,4,0,4
4682,derivato,1,4,0,4
3483,sensibili,1,4,0,4
3368,analogamente,1,4,0,4
35368,பார்க்கிறேன்,0,0,4,4
16857,working,0,0,4,4
3371,corse,2,3,1,4
14470,आमतौर,0,0,4,4
17086,kallas,0,0,4,4
655,sottostante,1,4,0,4
35912,ciertas,0,0,4,4
7511,algoritmico,2,3,1,4
4684,copre,1,4,0,4
2270,offrono,1,4,0,4
3367,crawler,2,2,2,4
13946,قاموس,0,0,4,4
30736,croyance,0,0,4,4
34856,واحدة,0,0,4,4
4385,ministro,2,3,1,4
7493,erasmus,2,1,3,4
33533,statut,0,0,4,4
20111,மெதுவாக,0,0,4,4
37907,σίγουρα,0,0,4,4
27290,ലേഖനങ്ങളെ,0,0,4,4
41781,الأكثر,0,0,4,4
44268,translation,0,0,4,4
37903,παρακαλώ,0,0,4,4
4690,potevano,1,4,0,4
29647,focuses,0,0,4,4
34735,ciertos,0,0,4,4
29654,بخير,0,0,4,4
42120,devenue,0,0,4,4
33032,employed,0,0,4,4
49685,debate,0,0,4,4
45762,pontos,0,0,4,4
45768,fel,0,0,4,4
37892,januar,0,0,4,4
7581,stimato,1,4,0,4
35372,liebe,0,0,4,4
2276,passive,2,1,3,4
45771,creada,0,0,4,4
37617,मान्यता,0,0,4,4
27213,ವೀಡಿಯೊದಲ್ಲಿ,0,0,4,4
31538,einfach,0,0,4,4
55,ozono,1,4,0,4
2278,titoli,1,4,0,4
16879,φρικτό,0,0,4,4
14406,буду,0,0,4,4
31540,typ,0,0,4,4
33860,списке,0,0,4,4
4663,operatori,1,4,0,4
42119,child,0,0,4,4
37607,einmal,0,0,4,4
7540,noti,1,4,0,4
14461,ಹೋಗಬೇಕು,0,0,4,4
3813,maniera,1,4,0,4
2272,dovrebbero,1,4,0,4
20699,मिल,0,0,4,4
42112,आदमी,0,0,4,4
7552,otto,1,4,0,4
657,svms,2,2,2,4
3814,collaborativi,1,4,0,4
31634,المرتبة,0,0,4,4
8106,direttore,1,4,0,4
7560,diagnosi,1,4,0,4
660,sistemico,1,4,0,4
52451,تذكر,0,0,4,4
33052,realidade,0,0,4,4
704,spinoza,2,2,2,4
16912,anos,0,0,4,4
37558,अनुमति,0,0,4,4
14097,एनसाइक्लोपीडिया,0,0,4,4
30693,фонд,0,0,4,4
44164,développer,0,0,4,4
7946,möller,2,2,2,4
33900,vooral,0,0,4,4
44192,ακούσει,0,0,4,4
31642,texte,0,0,4,4
43899,laatste,0,0,4,4
2360,funziona,1,4,0,4
41894,tussen,0,0,4,4
37805,الرئيسية,0,0,4,4
51752,room,0,0,4,4
4515,scrittori,1,4,0,4
735,proposte,1,4,0,4
17396,mee,0,0,4,4
31616,части,0,0,4,4
52410,videre,0,0,4,4
41892,журнала,0,0,4,4
3437,assolutamente,1,4,0,4
45932,diverses,0,0,4,4
33919,course,0,0,4,4
37754,altından,0,0,4,4
33569,fout,0,0,4,4
45927,vred,0,0,4,4
4541,radiazione,1,4,0,4
29760,பெற்றேன்,0,0,4,4
29763,ಬಯಸುತ್ತೇನೆ,0,0,4,4
51770,interprétation,0,0,4,4
4468,stupefacente,1,4,0,4
29765,cabo,0,0,4,4
29766,исправлении,0,0,4,4
35959,algae,0,0,4,4
26984,धाराप्रवाह,0,0,4,4
26981,प्रक्रिया,0,0,4,4
32965,passer,0,0,4,4
7859,alain,2,2,2,4
4511,norme,1,4,0,4
14204,pläne,0,0,4,4
45970,clasificar,0,0,4,4
3432,nicholas,2,1,3,4
7921,attimo,1,4,0,4
45971,küçük,0,0,4,4
49557,förvirrade,0,0,4,4
4495,conoscerti,1,4,0,4
747,orlowski,2,1,3,4
34780,biliyorsun,0,0,4,4
4491,italia,1,4,0,4
7897,costituito,1,4,0,4
7899,liquida,1,4,0,4
26933,venlig,0,0,4,4
7901,medici,1,4,0,4
7905,impatti,1,4,0,4
746,tropicale,2,3,1,4
43927,சென்று,0,0,4,4
4482,economiche,1,4,0,4
4497,ortega,2,1,3,4
14107,besoin,0,0,4,4
7924,luna,1,4,0,4
7861,parla,1,4,0,4
49548,औपचारिक,0,0,4,4
26927,طويل,0,0,4,4
31620,​​​,0,0,4,4
4280,preservare,1,4,0,4
20473,simply,0,0,4,4
3427,etichetta,1,4,0,4
7873,affidabili,1,4,0,4
26928,आम,0,0,4,4
33908,independent,0,0,4,4
14111,некоторых,0,0,4,4
14147,réalisée,0,0,4,4
17368,konnte,0,0,4,4
35966,"
पश्चिमी",0,0,4,4
2346,potessi,1,4,0,4
4462,conteneva,1,4,0,4
28,relativo,1,4,0,4
26861,википедии —,0,0,4,4
37842,dicha,0,0,4,4
36010,erreur,0,0,4,4
769,kdd,2,2,2,4
20357,yarın,0,0,4,4
44222,badstof,0,0,4,4
3396,complesse,1,4,0,4
14269,worth,0,0,4,4
37710,إصلاح,0,0,4,4
45880,nemen,0,0,4,4
44218,genau,0,0,4,4
14263,crianças,0,0,4,4
26877,kelimenin,0,0,4,4
2311,completo,2,2,2,4
14735,ഭയപ്പെടുന്നു,0,0,4,4
31661,соответствии,0,0,4,4
4573,sondaggio,1,4,0,4
7730,biologia,1,4,0,4
17470,espèce,0,0,4,4
31582,aumentar,0,0,4,4
17045,ind,0,0,4,4
14305,indicated,0,0,4,4
7707,laggiù,1,4,0,4
35935,présenter,0,0,4,4
17477,ഗുരുതരമായ,0,0,4,4
27102,studies,0,0,4,4
33006,പരിഹാരത്തിലാണ്,0,0,4,4
7718,ritmo,2,3,1,4
37849,atualmente,0,0,4,4
46046,conseil,0,0,4,4
44149,wütend,0,0,4,4
37845,ceci,0,0,4,4
3537,lockyer,2,1,3,4
20345,parle,0,0,4,4
17472,مصادر,0,0,4,4
37699,αναστατωμένος,0,0,4,4
14255,korkarım,0,0,4,4
3445,interessate,1,4,0,4
27007,particularly,0,0,4,4
26892,ಸಾಧ್ಯವಾಗಲಿಲ್ಲ,0,0,4,4
20575,фразы,0,0,4,4
761,storici,1,4,0,4
45916,consists,0,0,4,4
37749,πριν,0,0,4,4
4451,incoraggiare,1,4,0,4
37821,वाणिज्यिक,0,0,4,4
29750,பிற,0,0,4,4
45920,selflearning,0,0,4,4
17339,позвольте,0,0,4,4
20419,überflutet,0,0,4,4
49532,الاتصال,0,0,4,4
14074,radiation,0,0,4,4
7968,svolgono,1,4,0,4
33514,namnet,0,0,4,4
49535,आसान,0,0,4,4
4448,primaria,2,3,1,4
41865,பகுதி,0,0,4,4
20615,रखता,0,0,4,4
20402,skicka,0,0,4,4
46035,materiais,0,0,4,4
20371,gehoord,0,0,4,4
14251,चलो,0,0,4,4
2385,finché,1,4,0,4
52422,ചോദിക്കുന്നു,0,0,4,4
31583,vrij,0,0,4,4
41989,réalise,0,0,4,4
41987,विश्वसनीय,0,0,4,4
7771,elevato,1,4,0,4
7772,dinamico,1,4,0,4
20596,одним,0,0,4,4
4443,impedire,1,4,0,4
20398,relève,0,0,4,4
7779,successivo,1,4,0,4
4564,vengano,1,4,0,4
36067,protocole,0,0,4,4
7911,aspettare,1,4,0,4
17243,βρίσκεστε,0,0,4,4
20827,schwierigen,0,0,4,4
17123,aparecer,0,0,4,4
14592,إزالة,0,0,4,4
2504,geometria,2,3,1,4
50805,aparecen,0,0,4,4
2226,copyleft,2,2,2,4
13893,मिलने,0,0,4,4
37438,обычно,0,0,4,4
20852,verkocht,0,0,4,4
8182,sostituzione,1,4,0,4
4827,orizzontale,1,4,0,4
20811,heard,0,0,4,4
8183,generali,1,4,0,4
30774,şaşırtıcı,0,0,4,4
2505,enciclopedicamente,2,3,1,4
4348,chiaramente,1,4,0,4
4346,eugene,2,2,2,4
52467,schoonheid,0,0,4,4
14597,फिक्स,0,0,4,4
41740,جامعة,0,0,4,4
33499,senden,0,0,4,4
630,trasformano,1,4,0,4
20847,vloeiend,0,0,4,4
2549,problematica,1,4,0,4
35883,όμορφη,0,0,4,4
16806,получила,0,0,4,4
29949,hermosa,0,0,4,4
26720,primeros,0,0,4,4
4796,settore,1,4,0,4
37947,തുടങ്ങിയ,0,0,4,4
26673,komt,0,0,4,4
29906,verlegenheit,0,0,4,4
14575,half,0,0,4,4
50813,إضافة,0,0,4,4
30777,passieren,0,0,4,4
42251,يبكي,0,0,4,4
807,animale,1,4,0,4
4722,collegamento,1,4,0,4
3481,protetti,1,4,0,4
42249,activités,0,0,4,4
17253,répondre,0,0,4,4
27375,côté,0,0,4,4
29952,ಬಯಸುವುದಿಲ್ಲ,0,0,4,4
19960,وجهة,0,0,4,4
33849,vandalismes,0,0,4,4
42209,tio,0,0,4,4
34888,मूर्खतापूर्ण,0,0,4,4
7256,insegnanti,1,4,0,4
44102,investigation,0,0,4,4
33090,slow,0,0,4,4
37938,hellre,0,0,4,4
14588,انخفاض,0,0,4,4
8176,controverso,1,4,0,4
32937,поводу,0,0,4,4
44298,محمل,0,0,4,4
20844,téléphone,0,0,4,4
19909,realize,0,0,4,4
17680,bleek,0,0,4,4
37956,héberge,0,0,4,4
41726,ചിലർക്ക്,0,0,4,4
41724,материалы,0,0,4,4
46173,बाहर,0,0,4,4
3807,impone,1,4,0,4
42276,colaborativa,0,0,4,4
4807,denominativo,2,2,2,4
42235,développée,0,0,4,4
29588,apparition,0,0,4,4
31730,الأحيان,0,0,4,4
42242,κείμενο,0,0,4,4
44084,fazendo,0,0,4,4
8242,interessati,1,4,0,4
34860,декабре,0,0,4,4
27421,αυτήν,0,0,4,4
37457,historial,0,0,4,4
2248,internauti,1,4,0,4
14626,wochenende,0,0,4,4
20808,kelimesinin,0,0,4,4
51808,aberto,0,0,4,4
27428,ting,0,0,4,4
42275,editada,0,0,4,4
86,automatica,1,4,0,4
2522,inclusi,1,4,0,4
7339,ritenuto,1,4,0,4
14628,olacağım,0,0,4,4
17620,multimédia,0,0,4,4
7292,storicamente,1,4,0,4
7337,precedentemente,1,4,0,4
43755,guidelines,0,0,4,4
41709,lisans,0,0,4,4
33585,winkel,0,0,4,4
7272,grammatica,2,3,1,4
4745,prime,1,4,0,4
4817,controversa,2,3,1,4
17672,caractéristiques,0,0,4,4
52675,japanese,0,0,4,4
26667,begrepp,0,0,4,4
33553,flydende,0,0,4,4
27405,vendeu,0,0,4,4
4753,waray,2,2,2,4
33581,заявил,0,0,4,4
20796,имеют,0,0,4,4
50773,अनुरोध,0,0,4,4
42282,perguntas,0,0,4,4
14669,chinese,0,0,4,4
42281,बटन,0,0,4,4
13828,ആഗ്രഹിക്കുന്നുവെങ്കിൽ,0,0,4,4
4756,sfera,1,4,0,4
16785,bättre,0,0,4,4
30769,ராக்,0,0,4,4
4757,ricchezze,1,4,0,4
7289,guide,2,1,3,4
8217,lamentarti,1,4,0,4
27370,برنامج,0,0,4,4
33092,بأي,0,0,4,4
7403,temperatura,1,4,0,4
2485,lsjbot,2,1,3,4
45700,ಕೆಲಸದಲ್ಲಿ,0,0,4,4
43697,distinction,0,0,4,4
13846,fantastiske,0,0,4,4
13930,проблема,0,0,4,4
13808,équivalent,0,0,4,4
42177,soort,0,0,4,4
42317,ಹೌದು,0,0,4,4
8149,wikizionario,1,4,0,4
7455,creano,1,4,0,4
35873,japonais,0,0,4,4
27465,συμβαίνει,0,0,4,4
8150,soglia,1,4,0,4
42180,actually,0,0,4,4
37422,chaîne,0,0,4,4
16829,usam,0,0,4,4
29983,würden,0,0,4,4
41766,تايمز,0,0,4,4
33103,டெர்ரி,0,0,4,4
14545,annually,0,0,4,4
19939,ಪದವು,0,0,4,4
17103,мог,0,0,4,4
29964,भाषाओं,0,0,4,4
45589,مشكلة,0,0,4,4
4125,rilevante,1,4,0,4
14546,دراسة,0,0,4,4
51804,fail,0,0,4,4
8283,res,2,3,1,4
17100,файлов,0,0,4,4
27316,कानून,0,0,4,4
35861,supuesto,0,0,4,4
2472,ashburn,2,2,2,4
27311,mår,0,0,4,4
2567,puzzle,1,4,0,4
43799,fyre,0,0,4,4
7216,iii,2,2,2,4
7476,recensioni,1,4,0,4
61,security,2,1,3,4
30401,movement,0,0,4,4
8285,floricic,2,1,3,4
7471,apple,2,1,3,4
2474,siabra,2,2,2,4
42327,perçue,0,0,4,4
13934,उनसे,0,0,4,4
34905,errores,0,0,4,4
42168,നമുക്ക്,0,0,4,4
2563,ritengono,1,4,0,4
27464,happen,0,0,4,4
4291,ragazza,1,4,0,4
27322,ஜிம்மி,0,0,4,4
2536,konanykhin,2,2,2,4
2560,dubbi,1,4,0,4
17169,prize,0,0,4,4
4379,definizioni,1,4,0,4
34898,afable,0,0,4,4
27341,fish,0,0,4,4
29900,होते,0,0,4,4
49784,reunión,0,0,4,4
30597,entender,0,0,4,4
27353,كانون,0,0,4,4
44111,गलती,0,0,4,4
37975,ലേഖനങ്ങളുടെ,0,0,4,4
7418,mantenimento,1,4,0,4
27469,सितंबर,0,0,4,4
81,annegare,1,4,0,4
20035,तीव्र,0,0,4,4
19878,yapabilirsin,0,0,4,4
19890,στις,0,0,4,4
45677,நினைக்கிறேன்,0,0,4,4
51694,lära,0,0,4,4
46117,σημασία,0,0,4,4
20034,vertel,0,0,4,4
19948,प्रविष्टि,0,0,4,4
4361,casella,1,4,0,4
4360,essi,1,4,0,4
52459,όμορφος,0,0,4,4
42256,ничего,0,0,4,4
33930,mistake,0,0,4,4
30763,intervju,0,0,4,4
7405,identificano,1,4,0,4
46120,пользователей,0,0,4,4
20036,говоря,0,0,4,4
7314,associato,1,4,0,4
33537,لهم,0,0,4,4
20744,quatro,0,0,4,4
7304,beta,2,2,2,4
45590,entendí,0,0,4,4
41763,motores,0,0,4,4
816,grafici,1,4,0,4
20746,flytande,0,0,4,4
17590,дам,0,0,4,4
26748,सर्वरों,0,0,4,4
29584,ναι,0,0,4,4
7429,guerre,2,3,1,4
7435,diminuisce,1,4,0,4
793,hacker,2,1,3,4
45681,sägs,0,0,4,4
27350,ήμουν,0,0,4,4
35434,பயன்படுத்தலாம்,0,0,4,4
8275,priorità,1,4,0,4
17591,εκπληκτικό,0,0,4,4
42312,extremamente,0,0,4,4
50788,sidorna,0,0,4,4
12055,express,0,0,3,3
26,fenomeno,1,3,0,3
52624,methodes,0,0,3,3
12059,εξαιρετικά,0,0,3,3
22640,står,0,0,3,3
3683,tyler,2,1,2,3
52156,extérieur,0,0,3,3
16205,dünya,0,0,3,3
44152,وهم,0,0,3,3
16200,ಬಳಿಗೆ,0,0,3,3
47219,hambre,0,0,3,3
16211,अनुभव,0,0,3,3
47804,mídia,0,0,3,3
43343,encontrar,0,0,3,3
11369,match,0,0,3,3
3950,rischi,1,3,0,3
40486,இருப்பதாக,0,0,3,3
22819,publicação,0,0,3,3
40404,hyperlinks,0,0,3,3
44662,welcome,0,0,3,3
43363,सार्वजनिक,0,0,3,3
18494,λάβετε,0,0,3,3
16000,gramática,0,0,3,3
40405,вялым,0,0,3,3
18226,sert,0,0,3,3
47343,volumes,0,0,3,3
17194,fehler,0,0,3,3
47810,realm,0,0,3,3
195,curriculum,2,2,1,3
12019,citações,0,0,3,3
3686,strict,2,1,2,3
33665,sorge,0,0,3,3
47210,مثير,0,0,3,3
22625,مراجعة,0,0,3,3
43170,importancia,0,0,3,3
194,vieta,1,3,0,3
33670,consecuencia,0,0,3,3
17369,duitstalige,0,0,3,3
16247,فكرة,0,0,3,3
43165,ينزعج,0,0,3,3
40549,ಬಹುಶಃ,0,0,3,3
44646,toward,0,0,3,3
47350,английский,0,0,3,3
39856,folk,0,0,3,3
22842,शीर्ष,0,0,3,3
39861,любом,0,0,3,3
39860,istiyorsan,0,0,3,3
47323,செய்யும்,0,0,3,3
40542,निर्माता,0,0,3,3
3914,ampie,1,3,0,3
12050,ജാം,0,0,3,3
33523,ωραία,0,0,3,3
35477,множество,0,0,3,3
12044,αργά,0,0,3,3
12043,नकारात्मक,0,0,3,3
12042,daarmee,0,0,3,3
43944,ótimo,0,0,3,3
40543,incluye,0,0,3,3
17153,allezy,0,0,3,3
47334,readership,0,0,3,3
16220,வார்த்தையைப்,0,0,3,3
44082,فعل,0,0,3,3
44080,ലേഖനങ്ങളും,0,0,3,3
44168,móveis,0,0,3,3
44169,beau,0,0,3,3
17015,модели,0,0,3,3
17010,básicamente,0,0,3,3
43354,приятно,0,0,3,3
22840,tillgänglig,0,0,3,3
44794,слушал,0,0,3,3
18248,അതിശയകരമാണ്,0,0,3,3
23601,foiré,0,0,3,3
22660,scherpe,0,0,3,3
22646,bunların,0,0,3,3
11333,trees,0,0,3,3
223,etiche,1,3,0,3
34289,nok,0,0,3,3
18343,hiérarchie,0,0,3,3
18451,पूछते,0,0,3,3
12127,assise,0,0,3,3
17075,seres,0,0,3,3
16061,pollution,0,0,3,3
43983,grote,0,0,3,3
3911,riportano,1,3,0,3
44721,üzülmemesini,0,0,3,3
17110,locales,0,0,3,3
11336,biais,0,0,3,3
12170,ко,0,0,3,3
1409,wikiality,2,1,2,3
47252,извиниться,0,0,3,3
1215,accanto,1,3,0,3
23667,εξηγεί,0,0,3,3
43291,escreve,0,0,3,3
33554,sujets,0,0,3,3
12188,вечером,0,0,3,3
40518,scherp,0,0,3,3
35520,conmigo,0,0,3,3
18462,давайте,0,0,3,3
22,digitali,1,3,0,3
16044,saker,0,0,3,3
3745,descrizioni,1,3,0,3
22688,jogo,0,0,3,3
22761,samtale,0,0,3,3
22686,программного,0,0,3,3
39870,друг,0,0,3,3
44713,ஆரம்பித்தாள்,0,0,3,3
22760,ಪರೀಕ್ಷೆಯಲ್ಲಿ,0,0,3,3
12120,بأنه,0,0,3,3
11334,lördag,0,0,3,3
23647,عما,0,0,3,3
12114,ವರ್ಡ್,0,0,3,3
22751,alvo,0,0,3,3
43244,palácio,0,0,3,3
43994,şaşkın,0,0,3,3
33648,onto,0,0,3,3
22717,gama,0,0,3,3
40481,realizan,0,0,3,3
1411,eri,1,3,0,3
52613,voorbaat,0,0,3,3
52696,senere,0,0,3,3
22727,inteligencia,0,0,3,3
1415,tesoro,1,3,0,3
12148,verá,0,0,3,3
17092,heart,0,0,3,3
40485,பெரும்பாலும்,0,0,3,3
18383,yaygın,0,0,3,3
33559,maj,0,0,3,3
34172,மெல்லி,0,0,3,3
47788,மட்டும்,0,0,3,3
43241,wikipédiens,0,0,3,3
47278,nasılsın,0,0,3,3
18347,contents,0,0,3,3
23650,بكل,0,0,3,3
33652,நடுவில்,0,0,3,3
16075,لهذا,0,0,3,3
23653,அவற்றின்,0,0,3,3
43989,ಮಾರ್ಗವಾಗಿದೆ,0,0,3,3
12163,face,0,0,3,3
44123,बन,0,0,3,3
12135,frasen,0,0,3,3
33381,للتخريب,0,0,3,3
43990,vogn,0,0,3,3
44730,marais,0,0,3,3
18403,θέλατε,0,0,3,3
17102,eletrônico,0,0,3,3
32570,especial,0,0,3,3
17301,vingers,0,0,3,3
44043,ശനിയാഴ്ച,0,0,3,3
16029,décontenancé,0,0,3,3
17215,название,0,0,3,3
1223,includevano,1,3,0,3
47765,बेच,0,0,3,3
23608,possessed,0,0,3,3
44688,venus,0,0,3,3
43320,जर्नल,0,0,3,3
23609,ثلاثة,0,0,3,3
23610,capítulo,0,0,3,3
44692,العام,0,0,3,3
44031,говоришь,0,0,3,3
1202,averne,1,3,0,3
30327,roughly,0,0,3,3
43315,മാർഗ്ഗം,0,0,3,3
17327,millioner,0,0,3,3
11357,يكن,0,0,3,3
17044,ഇതാണ്,0,0,3,3
43182,hjertet,0,0,3,3
16023,degrés,0,0,3,3
43328,included,0,0,3,3
39910,opiniões,0,0,3,3
18276,strength,0,0,3,3
18277,toutefois,0,0,3,3
18482,अलविदा,0,0,3,3
23606,pornographic,0,0,3,3
17208,மதிய,0,0,3,3
47317,هؤلاء,0,0,3,3
12073,verklaart,0,0,3,3
40533,ozone,0,0,3,3
18481,mellem,0,0,3,3
5,esatto,1,3,0,3
47225,darte,0,0,3,3
43327,tatsächlich,0,0,3,3
1224,efficace,1,3,0,3
18301,знать,0,0,3,3
17133,ஒன்றாக,0,0,3,3
11345,buenos,0,0,3,3
17322,besökare,0,0,3,3
17232,threshold,0,0,3,3
17307,gemiddeld,0,0,3,3
11300,पैदा,0,0,3,3
18314,possui,0,0,3,3
47295,publicar,0,0,3,3
16158,ಗಾಡಿಯಲ್ಲಿ,0,0,3,3
32566,ήδη,0,0,3,3
11302,fevereiro,0,0,3,3
12109,taget,0,0,3,3
39891,proposal,0,0,3,3
52700,aussehen,0,0,3,3
12111,बनी,0,0,3,3
47290,comptes,0,0,3,3
3910,fisici,1,3,0,3
44136,அதைச்,0,0,3,3
43307,discussões,0,0,3,3
40453,yakında,0,0,3,3
12100,historia,0,0,3,3
35552,climat,0,0,3,3
32582,φιλικός,0,0,3,3
43313,réseaux,0,0,3,3
22667,gemensam,0,0,3,3
44698,разделы,0,0,3,3
23614,हमें,0,0,3,3
12089,стал,0,0,3,3
3912,raggruppamento,1,3,0,3
17229,elegidos,0,0,3,3
47301,verbetes,0,0,3,3
44094,gekomen,0,0,3,3
23,vincolate,1,3,0,3
23615,gelukkig,0,0,3,3
43970,stationära,0,0,3,3
44095,dada,0,0,3,3
16719,ελεύθερη,0,0,3,3
23518,प्रेरित,0,0,3,3
44178,lijst,0,0,3,3
40051,items,0,0,3,3
17889,contient,0,0,3,3
17891,ഡിഗ്രിയിൽ,0,0,3,3
40255,rockst,0,0,3,3
1295,moderate,2,1,2,3
32433,الاشتراك,0,0,3,3
44289,καταπληκτικό,0,0,3,3
16544,liked,0,0,3,3
23087,utvecklas,0,0,3,3
30484,κουρασμένοι,0,0,3,3
40261,pasando,0,0,3,3
47481,tourist,0,0,3,3
11801,المثال،,0,0,3,3
11563,prazer,0,0,3,3
47640,απόψεις,0,0,3,3
134,basano,1,3,0,3
11791,машинное,0,0,3,3
33451,supplémentaire,0,0,3,3
23085,ενοχλεί,0,0,3,3
47641,അവൾക്ക്,0,0,3,3
47477,ചിത്രങ്ങൾ,0,0,3,3
17903,kväll,0,0,3,3
11797,список,0,0,3,3
40251,receiving,0,0,3,3
23101,mooi,0,0,3,3
3597,spontaneamente,1,3,0,3
17884,beim,0,0,3,3
47624,teve,0,0,3,3
40074,peki,0,0,3,3
40073,يعمل,0,0,3,3
11758,sekund,0,0,3,3
52656,reading,0,0,3,3
16811,esperar,0,0,3,3
17840,लोकप्रिय,0,0,3,3
34238,फ्रेंच,0,0,3,3
16812,laisse,0,0,3,3
33465,majeure,0,0,3,3
16586,наличие,0,0,3,3
23376,समूह,0,0,3,3
43765,skett,0,0,3,3
16574,fichier,0,0,3,3
63,markup,2,2,1,3
44449,trabalhos,0,0,3,3
11771,जुलाई,0,0,3,3
11571,nedenle,0,0,3,3
23108,चैनल,0,0,3,3
40055,ouvrages,0,0,3,3
40247,vor,0,0,3,3
1290,etica,1,3,0,3
11558,cour,0,0,3,3
191,suggerendo,1,3,0,3
11830,valt,0,0,3,3
35631,возможно,0,0,3,3
3600,oppure,1,3,0,3
40275,continuación,0,0,3,3
23406,μυστική,0,0,3,3
16508,nor,0,0,3,3
11824,три,0,0,3,3
3729,chiederti,1,3,0,3
23413,declaró,0,0,3,3
11826,rend,0,0,3,3
11827,золота,0,0,3,3
40280,essential,0,0,3,3
43782,éditions ,0,0,3,3
16502,contrarié,0,0,3,3
47453,sollten,0,0,3,3
16496,ஏய்,0,0,3,3
16860,مشاكل,0,0,3,3
16862,feet,0,0,3,3
23056,ವಿಭಿನ್ನ,0,0,3,3
40034,американцы,0,0,3,3
23055,observaciones,0,0,3,3
30317,awesome,0,0,3,3
17964,dediğini,0,0,3,3
47461,gelip,0,0,3,3
23068,spécifiques,0,0,3,3
40272,gek,0,0,3,3
140,esercitarsi,1,3,0,3
35473,lycklig,0,0,3,3
1359,immaginare,1,3,0,3
16532,ஒன்றை,0,0,3,3
136,esistevano,1,3,0,3
3674,occhio,1,3,0,3
16527,serem,0,0,3,3
23396,representative,0,0,3,3
47646,لحظة,0,0,3,3
43784,störa,0,0,3,3
11807,renderização,0,0,3,3
11809,appear,0,0,3,3
23401,récemment,0,0,3,3
3727,ripeta,1,3,0,3
11549,ίδιο,0,0,3,3
17546,tek,0,0,3,3
17926,ഒക്കെ,0,0,3,3
17932,थोड़ी,0,0,3,3
1287,pertanto,1,3,0,3
16511,periódico,0,0,3,3
11547,പോലുള്ള,0,0,3,3
11546,därmed,0,0,3,3
116,mare,1,3,0,3
33471,selvom,0,0,3,3
23127,creating,0,0,3,3
23297,उससे,0,0,3,3
40153,globorompecabezas,0,0,3,3
17692,racine,0,0,3,3
43716,ruim,0,0,3,3
52182,surtei,0,0,3,3
16687,lätt,0,0,3,3
16686,பணிகள்,0,0,3,3
33485,ക്രൂരമായ,0,0,3,3
23239,inspirados,0,0,3,3
17671,ojos,0,0,3,3
23292,"
उत्तरी",0,0,3,3
47594,большой,0,0,3,3
52173,कवरेज़,0,0,3,3
16670,historically,0,0,3,3
33586,kocaman,0,0,3,3
47545,joke,0,0,3,3
16666,каждой,0,0,3,3
40187,old,0,0,3,3
52670,месте,0,0,3,3
23303,verden,0,0,3,3
1314,pdf,2,2,1,3
11695,escrever,0,0,3,3
11622,சிறிது,0,0,3,3
40152,தெரியவில்லை,0,0,3,3
40150,फोन,0,0,3,3
16691,forskningspublikationer,0,0,3,3
11666,المحادثة,0,0,3,3
43696,morgon,0,0,3,3
32461,mag,0,0,3,3
23275,participation,0,0,3,3
23266,വിഷമിക്കേണ്ടതില്ല,0,0,3,3
16721,σκληρότερα,0,0,3,3
40123,ενός,0,0,3,3
47573,இறுதியில்,0,0,3,3
96,legali,1,3,0,3
52181,söyle,0,0,3,3
43689,eyes,0,0,3,3
44372,refer,0,0,3,3
34255,intéresse,0,0,3,3
43681,ಒಟ್ಟಿಗೆ,0,0,3,3
3715,gorilla,1,3,0,3
16701,cheer,0,0,3,3
17705,comentario,0,0,3,3
16726,antemano,0,0,3,3
43704,ஒன்று,0,0,3,3
43707,repetirlo,0,0,3,3
16693,απλώς,0,0,3,3
1322,sbalordita,1,3,0,3
16664,العلماء,0,0,3,3
16764,बच्चे,0,0,3,3
16765,ബ്രെഡ്,0,0,3,3
1307,ognuno,1,3,0,3
47613,linda,0,0,3,3
43643,dulce,0,0,3,3
16626,evolved,0,0,3,3
16625,rica,0,0,3,3
44412,mantém,0,0,3,3
40219,usarse,0,0,3,3
1306,globali,1,3,0,3
47518,hello,0,0,3,3
1303,sposarti,1,3,0,3
43632,protected,0,0,3,3
44417,fort,0,0,3,3
44309,الألمانية,0,0,3,3
33472,skrivs,0,0,3,3
16802,мечты,0,0,3,3
44421,composé,0,0,3,3
67,parallelo,1,3,0,3
1300,ammirati,1,3,0,3
43625,druk,0,0,3,3
114,costruiscono,1,3,0,3
16604,alls,0,0,3,3
44300,redigerats,0,0,3,3
52663,पाठ्यक्रम,0,0,3,3
43757,என்னவென்றால்,0,0,3,3
52666,स्क्वीड,0,0,3,3
11729,fazladan,0,0,3,3
44392,ഒബ്‌ട്യൂസ്,0,0,3,3
43737,ನೆನಪಿಡಿ,0,0,3,3
17768,zustimmen,0,0,3,3
40193,ಹೆಚ್ಚುವರಿ,0,0,3,3
33492,doce,0,0,3,3
11704,attributed,0,0,3,3
47536,betydligt,0,0,3,3
23183,keskin,0,0,3,3
33493,gråter,0,0,3,3
47532,сообщение,0,0,3,3
16776,observed,0,0,3,3
47607,latitude,0,0,3,3
16650,cité,0,0,3,3
44396,போகிறேன்,0,0,3,3
16648,zacht,0,0,3,3
74,plantae,2,1,2,3
17776,zamandır,0,0,3,3
43648,കുറച്ചുകൂടി,0,0,3,3
23162,«un,0,0,3,3
44400,решений,0,0,3,3
16786,voorbeelden,0,0,3,3
17535,सामने,0,0,3,3
16486,utilisateur,0,0,3,3
1280,belli,1,3,0,3
43413,bloqueios,0,0,3,3
16952,kullanılmaktadır,0,0,3,3
3681,implicito,1,3,0,3
44203,कार्यों,0,0,3,3
11954,annonce,0,0,3,3
11955,engelske,0,0,3,3
17431,história,0,0,3,3
44202,hårdere,0,0,3,3
17430,malgré,0,0,3,3
1250,dipendente,1,3,0,3
47725,enklare,0,0,3,3
44200,dichotomie,0,0,3,3
17457,ol,0,0,3,3
40369,conduit,0,0,3,3
11960,precisión,0,0,3,3
11424,कुल,0,0,3,3
22917,yorum,0,0,3,3
182,dichiara,1,3,0,3
22916,απόγευμα,0,0,3,3
52685,tittar,0,0,3,3
44196,bekymret,0,0,3,3
30285,английском,0,0,3,3
18169,hen,0,0,3,3
44207,статистики,0,0,3,3
33633,preserve,0,0,3,3
16946,لديها,0,0,3,3
11949,γουέιλς,0,0,3,3
44579,determinados,0,0,3,3
52636,grund,0,0,3,3
3606,biologici,1,3,0,3
39963,അവ,0,0,3,3
1258,pesante,1,3,0,3
32528,மிக,0,0,3,3
47717,beschrijven,0,0,3,3
44213,scorpions,0,0,3,3
16360,méthode,0,0,3,3
18119,klaga,0,0,3,3
23526,modellen,0,0,3,3
16942,contenant,0,0,3,3
44593,αρκετά,0,0,3,3
11945,कोलबर्ट,0,0,3,3
44598,stockholm,0,0,3,3
32423,formuleringar,0,0,3,3
16945,distributed,0,0,3,3
1383,maschile,1,3,0,3
18127,suerte,0,0,3,3
39959,estarei,0,0,3,3
18129,الموضوع,0,0,3,3
17420,ακριβώς,0,0,3,3
30490,weight,0,0,3,3
47370,alstublieft,0,0,3,3
23567,assigned,0,0,3,3
17394,italien,0,0,3,3
16275,bilmiyorum,0,0,3,3
1398,abbi,1,3,0,3
16992,हिस्से,0,0,3,3
16995,animales,0,0,3,3
11395,άπταιστα,0,0,3,3
22889,खोज,0,0,3,3
17385,εκπληκτική,0,0,3,3
44179,skriver,0,0,3,3
16270,aquellos,0,0,3,3
18209,euxmêmes,0,0,3,3
11392,divertida,0,0,3,3
34192,особенно,0,0,3,3
3918,rappresentata,1,3,0,3
22877,издания,0,0,3,3
33401,മുന്നോട്ട്,0,0,3,3
40395,يقوم,0,0,3,3
16266,சொன்னது,0,0,3,3
44640,nam,0,0,3,3
23574,volcanic,0,0,3,3
22867,परवाह,0,0,3,3
16277,الخاص,0,0,3,3
22892,विकिसमाचार,0,0,3,3
52686,yoğun,0,0,3,3
44631,croate,0,0,3,3
16307,அம்மாவிடம்,0,0,3,3
16301,sentence,0,0,3,3
40376,αλλιώς,0,0,3,3
16299,tanrım,0,0,3,3
1387,dorate,1,3,0,3
32415,density,0,0,3,3
43898,используются,0,0,3,3
1242,print,2,1,2,3
16294,முன்பு,0,0,3,3
16983,étonnant,0,0,3,3
1241,osservati,1,3,0,3
1389,manuali,1,3,0,3
43904,secreta,0,0,3,3
1392,insalate,1,3,0,3
16289,красив,0,0,3,3
3738,soluzioni,1,3,0,3
51256,semelhantes,0,0,3,3
43386,servere,0,0,3,3
11986,savoirs,0,0,3,3
22894,वहाँ,0,0,3,3
43385,éthique,0,0,3,3
18087,geef,0,0,3,3
18086,встречи,0,0,3,3
43817,underrepresented,0,0,3,3
43495,ಕ್ಷಮಿಸು,0,0,3,3
43512,utöver,0,0,3,3
23450,ஒருவரை,0,0,3,3
23019,dra,0,0,3,3
17492,തെറ്റ്,0,0,3,3
44241,कॉल,0,0,3,3
147,citare,1,3,0,3
3943,raro,2,2,1,3
3595,asturie,1,3,0,3
16446,बनाना।,0,0,3,3
33440,obstante,0,0,3,3
30461,mitten,0,0,3,3
33627,eliminación,0,0,3,3
40310,lastige,0,0,3,3
11878,lokalt,0,0,3,3
43845,встретиться,0,0,3,3
23479,لأنك,0,0,3,3
18035,ஆங்கிலத்தில்,0,0,3,3
11483,marmelade,0,0,3,3
153,riscontrati,1,3,0,3
18042,build,0,0,3,3
43479,üzerinde,0,0,3,3
16421,constant,0,0,3,3
43514,demandez,0,0,3,3
30485,ലേഖനങ്ങളെഴുതുക,0,0,3,3
11505,spiel,0,0,3,3
34276,bugün,0,0,3,3
47662,biomass,0,0,3,3
43822,fifth,0,0,3,3
40026,πουλήσατε,0,0,3,3
56,colpito,1,3,0,3
1279,muoversi,1,3,0,3
52168,fais,0,0,3,3
33612,hemmelige,0,0,3,3
11850,statistiques,0,0,3,3
23033,ones,0,0,3,3
43523,daumen,0,0,3,3
43839,легко,0,0,3,3
33506,expression,0,0,3,3
47440,regulares,0,0,3,3
44507,yi,0,0,3,3
17989,intervention,0,0,3,3
16470,membros,0,0,3,3
1362,temi,1,3,0,3
40017,ficou,0,0,3,3
30507,skillnader,0,0,3,3
44514,narrow,0,0,3,3
52,climatici,1,3,0,3
3733,adattare,1,3,0,3
43477,souligne,0,0,3,3
32510,actes,0,0,3,3
1262,statunitense,1,3,0,3
43851,miljoen,0,0,3,3
39983,கடவுளே,0,0,3,3
164,approssimativamente,1,3,0,3
16918,longer,0,0,3,3
16390,publication,0,0,3,3
3734,formali,1,3,0,3
47702,ಎಲ್ಲಾ,0,0,3,3
3604,sapore,1,3,0,3
32518,criador,0,0,3,3
44571,biotic,0,0,3,3
11459,редактирования,0,0,3,3
40346,wahr,0,0,3,3
16920,representa,0,0,3,3
16379,നിലവിൽ,0,0,3,3
43857,sagte,0,0,3,3
1260,rigoroso,1,3,0,3
23508,buen,0,0,3,3
1375,variano,1,3,0,3
47396,قام,0,0,3,3
11452,உங்களைப்,0,0,3,3
23513,தயவு,0,0,3,3
39984,அதிக,0,0,3,3
49,light,2,1,2,3
16414,seis,0,0,3,3
23490,comunes,0,0,3,3
40315,എന്നിരുന്നാലും,0,0,3,3
16413,feitos,0,0,3,3
43475,फिल्मों,0,0,3,3
43473,location,0,0,3,3
18057,सवार,0,0,3,3
11481,لديهم,0,0,3,3
16902,விட,0,0,3,3
33425,écologique,0,0,3,3
161,pensava,1,3,0,3
17489,bas,0,0,3,3
44557,enviarle,0,0,3,3
39993,थीं।,0,0,3,3
11900,ήθελα,0,0,3,3
16397,northern,0,0,3,3
23486,unglaublich,0,0,3,3
18071,कृपया,0,0,3,3
17488,ಅವರ,0,0,3,3
1265,rapidi,1,3,0,3
17487,uppmärksamhet,0,0,3,3
44235,âge,0,0,3,3
47406,acquérir,0,0,3,3
1192,membro,2,1,2,3
20864,almindelige,0,0,3,3
12246,visit,0,0,3,3
42220,karar,0,0,3,3
937,strutturale,1,3,0,3
42246,dårligt,0,0,3,3
14629,école,0,0,3,3
13243,expressions,0,0,3,3
41280,сообществе,0,0,3,3
45640,régression,0,0,3,3
3645,colloquio,1,3,0,3
622,dimentica,1,3,0,3
13252,ಇದೆ,0,0,3,3
21493,acquis,0,0,3,3
19986,«вики»,0,0,3,3
42225,contradictoires,0,0,3,3
52329,sabía,0,0,3,3
13258,dil,0,0,3,3
13261,ببطء,0,0,3,3
924,foreste,1,3,0,3
628,formano,1,3,0,3
42212,ursprung,0,0,3,3
20011,स्थानांतरित,0,0,3,3
14593,boek,0,0,3,3
930,alexandre,2,1,2,3
928,incoraggia,1,3,0,3
632,aggiornata,1,3,0,3
21478,ಸಿಹಿ,0,0,3,3
21477,δει,0,0,3,3
14589,sociétés,0,0,3,3
13276,بـ,0,0,3,3
926,luce,1,3,0,3
13281,kunna,0,0,3,3
42204,publikationer,0,0,3,3
13238,relevanta,0,0,3,3
42259,समायोजित,0,0,3,3
46567,ലേഖനത്തിനു,0,0,3,3
19945,waardoor,0,0,3,3
21548,visa,0,0,3,3
45604,notions,0,0,3,3
52318,bör,0,0,3,3
14680,ഓരോ,0,0,3,3
14679,planets,0,0,3,3
602,magico,1,3,0,3
14676,குழப்பமான,0,0,3,3
21542,пользователи,0,0,3,3
45609,samenwerking,0,0,3,3
32794,بوابة,0,0,3,3
41252,olmayan,0,0,3,3
14666,принимайте,0,0,3,3
950,abusata,1,3,0,3
13202,tijdschriften,0,0,3,3
21531,mutlu,0,0,3,3
3627,annuncia,1,3,0,3
949,esposizione,1,3,0,3
46583,gerçek,0,0,3,3
21527,prêt,0,0,3,3
19928,estatísticas,0,0,3,3
14653,مني,0,0,3,3
46581,صحيح,0,0,3,3
46580,akıllıca,0,0,3,3
948,iniziali,1,3,0,3
32797,നൽകും,0,0,3,3
45626,natureza,0,0,3,3
32801,kullandığım,0,0,3,3
34023,l’algorithme,0,0,3,3
612,corrispondenti,1,3,0,3
52460,esos,0,0,3,3
46532,hårdare,0,0,3,3
597,creek,2,1,2,3
42095,डिग्री,0,0,3,3
653,pensata,1,3,0,3
14476,tänka,0,0,3,3
14475,único,0,0,3,3
14472,सुन,0,0,3,3
46490,analytique,0,0,3,3
3862,considerando,1,3,0,3
42123,förvånad,0,0,3,3
21370,posible,0,0,3,3
20167,teste,0,0,3,3
45754,réaliser,0,0,3,3
20179,trotzdem,0,0,3,3
41371,week,0,0,3,3
14436,نظام,0,0,3,3
42098,viewed,0,0,3,3
33044,لإزعاجك,0,0,3,3
45670,matérialistes,0,0,3,3
41381,huvudsak,0,0,3,3
20196,версий,0,0,3,3
46468,abone,0,0,3,3
41390,off,0,0,3,3
46463,déclare,0,0,3,3
20207,dingen,0,0,3,3
46461,എത്ര,0,0,3,3
21328,despite,0,0,3,3
21326,работать,0,0,3,3
33029,أربعة,0,0,3,3
45788,mondial,0,0,3,3
20220,grundades,0,0,3,3
33997,voz,0,0,3,3
21317,круто,0,0,3,3
20130,φάτε,0,0,3,3
651,brand,2,1,2,3
41349,haga,0,0,3,3
14485,capable,0,0,3,3
34012,सहमति,0,0,3,3
21449,الإناث,0,0,3,3
41306,ವಾರಾಂತ್ಯದಲ್ಲಿ,0,0,3,3
14557,खुले,0,0,3,3
30402,vocabulaire,0,0,3,3
45685,ഒപ്പം,0,0,3,3
20047,लिखी,0,0,3,3
14548,automated,0,0,3,3
14544,sjov,0,0,3,3
20050,ontmoeten,0,0,3,3
42186,necesario,0,0,3,3
45699,προτέρων,0,0,3,3
14531,orolig,0,0,3,3
21427,autant,0,0,3,3
21423,obtener,0,0,3,3
14527,appuie,0,0,3,3
45702,fragt,0,0,3,3
20088,tahmin,0,0,3,3
20089,inden,0,0,3,3
42158,torno,0,0,3,3
41337,construção,0,0,3,3
649,identificate,1,3,0,3
42157,रोने,0,0,3,3
20098,dernières,0,0,3,3
911,aumentando,2,2,1,3
910,tecnologie,1,3,0,3
45727,कपड़े,0,0,3,3
20124,clase,0,0,3,3
45730,hak,0,0,3,3
46597,വ്യത്യസ്ത,0,0,3,3
19891,hvem,0,0,3,3
41145,ಬಯಸುತ್ತೀರಿ,0,0,3,3
34043,تأكل,0,0,3,3
13043,مشاريع,0,0,3,3
21681,заранее,0,0,3,3
14904,όνομα,0,0,3,3
41173,reviewed,0,0,3,3
21679,açıklayan,0,0,3,3
19670,idé,0,0,3,3
33804,வந்தது,0,0,3,3
19676,highest,0,0,3,3
13051,словам,0,0,3,3
3796,suona,1,3,0,3
21674,alemã,0,0,3,3
41178,статус,0,0,3,3
14886,நுபீடியாவின்,0,0,3,3
45484,communities,0,0,3,3
41181,секретный,0,0,3,3
14853,olhos,0,0,3,3
21661,vår,0,0,3,3
14876,cidessous,0,0,3,3
42419,buscar,0,0,3,3
19695,suggère,0,0,3,3
19704,ужасно,0,0,3,3
19706,публикаций,0,0,3,3
21650,yakışıklı,0,0,3,3
34039,droeg,0,0,3,3
3798,rumelhart,2,2,1,3
19714,مرحباً,0,0,3,3
19715,copiar,0,0,3,3
41194,बिल्कुल,0,0,3,3
52310,universitaire,0,0,3,3
30540,ശൈലികൾ,0,0,3,3
21684,første,0,0,3,3
536,finanziare,1,3,0,3
14915,другим,0,0,3,3
990,elaborare,1,3,0,3
513,assumere,1,3,0,3
14965,källbeskrivning,0,0,3,3
13011,thèmes,0,0,3,3
46689,இருந்தார்,0,0,3,3
998,calmati,1,3,0,3
41152,relationships,0,0,3,3
14961,καλός,0,0,3,3
42462,rede,0,0,3,3
997,fossero,1,3,0,3
19625,reprenant,0,0,3,3
14955,आसानी,0,0,3,3
21711,रखा,0,0,3,3
21702,effekt,0,0,3,3
45447,viewers,0,0,3,3
518,ulteriormente,1,3,0,3
13024,سمعت,0,0,3,3
14943,confundir,0,0,3,3
3870,agricoltura,1,3,0,3
14940,говорить,0,0,3,3
994,eccitante,1,3,0,3
42456,स्वीकार,0,0,3,3
525,seguente,1,3,0,3
42454,градусов,0,0,3,3
14928,ولم,0,0,3,3
52503,subjects,0,0,3,3
529,cercano,1,3,0,3
13032,användning,0,0,3,3
33150,मीड़याविकी,0,0,3,3
21695,replaced,0,0,3,3
41200,appearing,0,0,3,3
21637,மிக்க,0,0,3,3
45599,posé,0,0,3,3
45563,tex,0,0,3,3
19784,റോക്ക്,0,0,3,3
21582,हे,0,0,3,3
45544,ಹೋಗಿ,0,0,3,3
42362,adequada,0,0,3,3
42359,understanding,0,0,3,3
14776,ಆಗಿದೆ,0,0,3,3
30358,ಮುಂಚಿತವಾಗಿ,0,0,3,3
32786,சொந்த,0,0,3,3
14773,systematic,0,0,3,3
14770,midt,0,0,3,3
14767,schaltfläche,0,0,3,3
14765,передать,0,0,3,3
13145,ouvindo,0,0,3,3
14755,planète,0,0,3,3
42345,modeling,0,0,3,3
14846,recupera,0,0,3,3
13150,επειδή,0,0,3,3
34031,infantil,0,0,3,3
46608,décisions,0,0,3,3
35606,தங்கள்,0,0,3,3
19829,μοίρες,0,0,3,3
13161,afspraak,0,0,3,3
14737,അതിന്റെ,0,0,3,3
21558,actualmente,0,0,3,3
19858,contained,0,0,3,3
19863,थोड़ा,0,0,3,3
19866,incorporado,0,0,3,3
21553,plaindre,0,0,3,3
13173,пальцы,0,0,3,3
42309,tenderar,0,0,3,3
14801,странице,0,0,3,3
33117,решение,0,0,3,3
14809,يونيو,0,0,3,3
41229,концу,0,0,3,3
46650,είχα,0,0,3,3
13084,خبرة,0,0,3,3
556,immagina,1,3,0,3
975,pubblicano,1,3,0,3
19742,organisations,0,0,3,3
42391,referências,0,0,3,3
32773,serious,0,0,3,3
19745,akzeptiere,0,0,3,3
13097,केन्द्रित,0,0,3,3
46638,critères,0,0,3,3
14829,affirme,0,0,3,3
21605,fejl,0,0,3,3
13104,എന്നോട്,0,0,3,3
21603,newspaper,0,0,3,3
21601,اجتماع,0,0,3,3
42388,utrymme,0,0,3,3
33130,confiáveis,0,0,3,3
42384,filmer,0,0,3,3
46633,abierta,0,0,3,3
41222,değilim,0,0,3,3
33128,والمعلوماتية,0,0,3,3
19760,doivent,0,0,3,3
13117,houdt,0,0,3,3
14816,implique,0,0,3,3
13119,principles,0,0,3,3
21590,மேற்பட்ட,0,0,3,3
32783,paintings,0,0,3,3
41228,foutieve,0,0,3,3
46623,βιβλίο,0,0,3,3
45794,high,0,0,3,3
685,buoni,1,3,0,3
45798,environnementaux,0,0,3,3
32893,encyklopædi,0,0,3,3
41830,ಅಲ್ಲ,0,0,3,3
14012,davon,0,0,3,3
20639,próximo,0,0,3,3
20640,канал,0,0,3,3
32892,इससे,0,0,3,3
14007,sump,0,0,3,3
41822,seção,0,0,3,3
41818,diferenças,0,0,3,3
21028,meest,0,0,3,3
13999,devons,0,0,3,3
20658,λέξης,0,0,3,3
46060,объясняет,0,0,3,3
13661,ಅತ್ಯುತ್ತಮ,0,0,3,3
13993,depends,0,0,3,3
46067,ترى,0,0,3,3
784,continuano,1,3,0,3
20674,wusste,0,0,3,3
13975,usual,0,0,3,3
41801,lição,0,0,3,3
41800,topla,0,0,3,3
41596,evaluated,0,0,3,3
33927,referendo,0,0,3,3
13971,surtout,0,0,3,3
41791,deelnemers,0,0,3,3
20690,querer,0,0,3,3
41787,listening,0,0,3,3
13959,effets,0,0,3,3
13684,ಹೊಸ,0,0,3,3
13685,intérieur,0,0,3,3
51245,brug,0,0,3,3
21044,escuela,0,0,3,3
46050,reach,0,0,3,3
46049,ρωτήσετε,0,0,3,3
21051,उद्धरण,0,0,3,3
20555,aandacht,0,0,3,3
21095,komen,0,0,3,3
21091,elbette,0,0,3,3
46009,registered,0,0,3,3
3849,gorman,2,1,2,3
46012,பயனர்,0,0,3,3
41876,origin,0,0,3,3
14069,உறுதியாக,0,0,3,3
760,controlli,1,3,0,3
20571,μέρος,0,0,3,3
41871,الأول,0,0,3,3
41869,fossil,0,0,3,3
14055,speaker,0,0,3,3
41857,ഖേദിക്കുന്നു,0,0,3,3
51158,किए,0,0,3,3
21072,älskar,0,0,3,3
41855,മാത്രം,0,0,3,3
763,proprietari,1,3,0,3
46302,blocage,0,0,3,3
46042,perguntando,0,0,3,3
14031,encyklopedi,0,0,3,3
14030,ποια,0,0,3,3
13636,remis,0,0,3,3
46296,alma,0,0,3,3
20624,d’une,0,0,3,3
46047,cinq,0,0,3,3
21054,hombre,0,0,3,3
14023,puntuación,0,0,3,3
35486,termo,0,0,3,3
46266,interesses,0,0,3,3
20992,logiciels,0,0,3,3
41402,പദമാണ്,0,0,3,3
41705,tijdschrift,0,0,3,3
32927,видели,0,0,3,3
41731,humano,0,0,3,3
13861,direkt,0,0,3,3
20809,shift,0,0,3,3
13765,первый,0,0,3,3
20913,tidsskriftet,0,0,3,3
33937,ಮಾಡಿ,0,0,3,3
13852,ಅಳುವುದು,0,0,3,3
46159,aslında,0,0,3,3
41716,öka,0,0,3,3
41714,സുഹൃത്തുക്കളുമായി,0,0,3,3
13840,ಅಸಮಾಧಾನಗೊಳ್ಳಬೇಡಿ,0,0,3,3
41712,reverting,0,0,3,3
41660,नीतियों,0,0,3,3
13833,ஆமாம்,0,0,3,3
20991,piada,0,0,3,3
46174,उनका,0,0,3,3
13826,озадачены,0,0,3,3
3635,piatto,1,3,0,3
20850,ഉപയോഗിക്കാം,0,0,3,3
13785,ഫ്ലമ്മോക്സ്,0,0,3,3
41678,razões,0,0,3,3
46179,economía,0,0,3,3
41679,pois,0,0,3,3
821,certi,1,3,0,3
13812,erklärt,0,0,3,3
13794,rencontrer,0,0,3,3
20857,थक,0,0,3,3
20863,verte,0,0,3,3
46191,beings,0,0,3,3
13877,grundare,0,0,3,3
20785,पोशाक,0,0,3,3
20781,संग्रहण,0,0,3,3
20936,விற்றீர்கள்,0,0,3,3
13694,ടിപ്പ്,0,0,3,3
836,guardato,1,3,0,3
13702,pleurer,0,0,3,3
46091,verbaasd,0,0,3,3
20716,unseen,0,0,3,3
20979,pasado,0,0,3,3
41613,hemliga,0,0,3,3
20975,πειράζει,0,0,3,3
41769,langzaam,0,0,3,3
789,sguardi,1,3,0,3
13719,seule,0,0,3,3
41624,träsk,0,0,3,3
41765,uzun,0,0,3,3
41628,samedi,0,0,3,3
20747,ವನ್ನು,0,0,3,3
20948,बड़े,0,0,3,3
13734,fingre,0,0,3,3
794,ricercatore,1,3,0,3
41756,प्रिय,0,0,3,3
20753,என்னிடம்,0,0,3,3
46235,निश्चित,0,0,3,3
20758,இருக்கும்போது,0,0,3,3
3838,diceva,1,3,0,3
46123,tivesse,0,0,3,3
46232,sprog,0,0,3,3
797,lottato,1,3,0,3
20938,evaluation,0,0,3,3
46128,fortfarande,0,0,3,3
20779,sırasında,0,0,3,3
46324,servidor,0,0,3,3
21108,व्याख्या,0,0,3,3
21114,beide,0,0,3,3
890,congratulazioni,1,3,0,3
41420,écoutais,0,0,3,3
20310,driven,0,0,3,3
20312,arkadaşlarınız,0,0,3,3
14300,décrire,0,0,3,3
42023,skrivna,0,0,3,3
52430,தவறுகள்,0,0,3,3
20328,unit,0,0,3,3
21282,விரும்புகிறீர்கள்,0,0,3,3
20339,πάμε,0,0,3,3
20348,engineering,0,0,3,3
21276,appareil,0,0,3,3
41427,намного,0,0,3,3
42005,நிலத்தில்,0,0,3,3
45873,दिए,0,0,3,3
20351,perplexo,0,0,3,3
14102,plateforme,0,0,3,3
42000,anúncios,0,0,3,3
32843,wikikod,0,0,3,3
20360,besøgt,0,0,3,3
13464,usados,0,0,3,3
14264,ذهبية,0,0,3,3
41436,знал,0,0,3,3
33002,ಮಾರ್ಗವೆಂದರೆ,0,0,3,3
711,primarie,1,3,0,3
41442,हाँ,0,0,3,3
713,onestamente,1,3,0,3
20375,каждого,0,0,3,3
41981,keep,0,0,3,3
41453,ഡാറ്റ,0,0,3,3
41974,utilizadas,0,0,3,3
14309,ಉದಾಹರಣೆ,0,0,3,3
21285,procesos,0,0,3,3
42031,μυαλό,0,0,3,3
42034,diskussion,0,0,3,3
33876,ampla,0,0,3,3
687,dovrai,1,3,0,3
14369,television,0,0,3,3
20253,sousjacente,0,0,3,3
20260,getan,0,0,3,3
46452,ess,0,0,3,3
20263,zelfs,0,0,3,3
46450,lucrativos,0,0,3,3
14356,concurso,0,0,3,3
13418,apparence,0,0,3,3
30396,अवयव,0,0,3,3
42047,pidiendo,0,0,3,3
20271,blague,0,0,3,3
41406,ofensivo,0,0,3,3
14348,instalación,0,0,3,3
13424,organisatie,0,0,3,3
20274,எந்தவொரு,0,0,3,3
42046,हमारे,0,0,3,3
42044,anunció,0,0,3,3
46444,desafios,0,0,3,3
14332,तुलना,0,0,3,3
46439,tidskriften,0,0,3,3
33013,συνηθισμένο,0,0,3,3
13433,प्रोजेक्ट,0,0,3,3
14330,नीति,0,0,3,3
41413,मिडिया,0,0,3,3
13437,eliminar,0,0,3,3
20296,molestarte,0,0,3,3
46435,revelou,0,0,3,3
23703,प्रकल्प,0,0,3,3
20403,ಹೋಗೋಣ,0,0,3,3
35493,sino,0,0,3,3
45946,läuft,0,0,3,3
30393,அதிர்ஷ்டசாலி,0,0,3,3
20457,ചെയ്യും,0,0,3,3
21167,llorar,0,0,3,3
21165,dress,0,0,3,3
32856,asusté,0,0,3,3
33902,अभ्यास,0,0,3,3
21161,fio,0,0,3,3
46353,vanligaste,0,0,3,3
20463,siz,0,0,3,3
20468,சொன்னால்,0,0,3,3
3826,educativo,2,2,1,3
14156,किस,0,0,3,3
20475,indépendamment,0,0,3,3
33906,insanların,0,0,3,3
20486,नया,0,0,3,3
32861,exemples,0,0,3,3
33912,aparece,0,0,3,3
41925,जवाब,0,0,3,3
41522,ángel,0,0,3,3
35587,obtenez,0,0,3,3
41524,brought,0,0,3,3
871,andò,1,3,0,3
21121,l’aa,0,0,3,3
32865,cargos,0,0,3,3
749,collettivamente,1,3,0,3
751,salutare,1,3,0,3
46331,sagt,0,0,3,3
21116,അധിക,0,0,3,3
45994,sidste,0,0,3,3
21171,ഉണ്ട്,0,0,3,3
45945,episódio,0,0,3,3
45912,πλημμυρίσει,0,0,3,3
21184,forget,0,0,3,3
20409,σκορ,0,0,3,3
21218,கற்றுக்,0,0,3,3
46391,بحاجة,0,0,3,3
20415,दी।,0,0,3,3
719,dovremmo,1,3,0,3
52348,présentes,0,0,3,3
21209,erstaunliche,0,0,3,3
3630,partecipativa,1,3,0,3
14209,ولكني,0,0,3,3
45921,references,0,0,3,3
721,abraham,2,1,2,3
41473,आई,0,0,3,3
13514,complexes,0,0,3,3
41476,kendine,0,0,3,3
20425,árboles,0,0,3,3
45924,comportements,0,0,3,3
21195,auktoritativa,0,0,3,3
21193,изменений,0,0,3,3
3632,trasmettere,1,3,0,3
3823,accurati,1,3,0,3
20435,firm,0,0,3,3
46369,keek,0,0,3,3
14193,saisi,0,0,3,3
46368,gostaria,0,0,3,3
51165,करो।,0,0,3,3
33896,δάχτυλα,0,0,3,3
13530,यात्रा,0,0,3,3
32989,mathématique,0,0,3,3
45942,conta,0,0,3,3
34050,suppose,0,0,3,3
19608,línguas,0,0,3,3
44812,làbas,0,0,3,3
12508,بدأ,0,0,3,3
358,matematici,1,3,0,3
22319,प्रयुक्त,0,0,3,3
42945,submit,0,0,3,3
12494,sådana,0,0,3,3
22318,ലാറ്റിൻ,0,0,3,3
359,avevo,1,3,0,3
47031,august,0,0,3,3
47030,pond,0,0,3,3
363,avvera,1,3,0,3
47029,लिखते,0,0,3,3
22313,voyez,0,0,3,3
12504,numerosas,0,0,3,3
1117,gira,1,3,0,3
33719,inútil,0,0,3,3
12511,sitting,0,0,3,3
22292,λογισμικού,0,0,3,3
15682,raíz,0,0,3,3
365,variabile,1,3,0,3
18855,samstag,0,0,3,3
18858,noyau,0,0,3,3
22305,aviso,0,0,3,3
15676,suene,0,0,3,3
12514,hadi,0,0,3,3
42934,प्रसिद्ध,0,0,3,3
47019,mauvais,0,0,3,3
51142,கருத்து,0,0,3,3
22295,своих,0,0,3,3
15668,таким,0,0,3,3
18873,περιεχομένου,0,0,3,3
1112,provenga,1,3,0,3
3759,vieni,1,3,0,3
354,credere,1,3,0,3
12484,ಅದ್ಭುತವಾದ,0,0,3,3
18821,επαναλάβετε,0,0,3,3
337,dormiva,1,3,0,3
44958,للجدل,0,0,3,3
40722,inspired,0,0,3,3
40724,indem,0,0,3,3
15741,അവരെ,0,0,3,3
47058,uppgifter,0,0,3,3
1132,occasione,1,3,0,3
47056,syfte,0,0,3,3
344,comprato,1,3,0,3
15737,employé,0,0,3,3
47054,abend,0,0,3,3
12465,neuronas,0,0,3,3
3666,semplici,1,3,0,3
42977,ലോഗിൻ,0,0,3,3
18799,ஏற்கனவே,0,0,3,3
40747,टिप,0,0,3,3
345,pediapress,2,1,2,3
15728,skriven,0,0,3,3
18804,पूछने,0,0,3,3
40751,verktyg,0,0,3,3
33291,gaf,0,0,3,3
22328,diária,0,0,3,3
22326,chorar,0,0,3,3
51193,самой,0,0,3,3
22325,والتي,0,0,3,3
33710,permanence,0,0,3,3
44979,meddelande,0,0,3,3
15716,ಹೃದಯಕ್ಕೆ,0,0,3,3
3665,pensi,1,3,0,3
42922,ιδέα,0,0,3,3
369,climatiche,1,3,0,3
12440,paniqué,0,0,3,3
1086,randy,1,3,0,3
12581,waarop,0,0,3,3
52260,தங்கத்தால்,0,0,3,3
45056,utilisent,0,0,3,3
45057,इतने,0,0,3,3
40840,propuesta,0,0,3,3
18945,revert,0,0,3,3
42881,soon,0,0,3,3
40842,maddesi,0,0,3,3
46964,согласен,0,0,3,3
52550,ഭാഷയിൽ,0,0,3,3
18968,propias,0,0,3,3
18970,reconnaître,0,0,3,3
22184,grados,0,0,3,3
392,heman,2,1,2,3
15550,condición,0,0,3,3
40778,fundadores,0,0,3,3
18990,categorías,0,0,3,3
33235,نصية,0,0,3,3
18998,takke,0,0,3,3
19000,jou,0,0,3,3
1085,prontamente,1,3,0,3
46189,actifs,0,0,3,3
12614,இருக்கிறார்,0,0,3,3
40858,وصلت,0,0,3,3
22170,источник,0,0,3,3
400,insiemi,1,3,0,3
15537,debajo,0,0,3,3
45090,ihop,0,0,3,3
15530,الويكيبيديا,0,0,3,3
34100,vyn,0,0,3,3
22209,صحيفة,0,0,3,3
40834,nimm,0,0,3,3
40833,artık,0,0,3,3
15590,dela,0,0,3,3
51190,manières,0,0,3,3
18895,الأم,0,0,3,3
1107,sorveglianza,1,3,0,3
22280,desk,0,0,3,3
42908,portent,0,0,3,3
42905,மேல்,0,0,3,3
33248,üç,0,0,3,3
40798,ನೀಡಲಿದ್ದೇನೆ,0,0,3,3
45034,farvel,0,0,3,3
18911,कॉमन्स,0,0,3,3
379,manuale,1,3,0,3
18915,verifiability,0,0,3,3
15620,élus,0,0,3,3
52256,задач,0,0,3,3
15614,νέα,0,0,3,3
42895,вялый,0,0,3,3
1094,telefonata,1,3,0,3
22227,essayez,0,0,3,3
32674,branches,0,0,3,3
383,fluenti,1,3,0,3
15605,شعبية,0,0,3,3
33739,கேட்கவில்லை,0,0,3,3
15597,സ്വതന്ത്രവും,0,0,3,3
22220,acute,0,0,3,3
52551,selvfølgelig,0,0,3,3
22215,vanavond,0,0,3,3
15592,जापानी,0,0,3,3
42888,lärare,0,0,3,3
40832,únicos,0,0,3,3
18772,പോലും,0,0,3,3
15761,approche,0,0,3,3
1003,assoluto,1,3,0,3
18614,richtig,0,0,3,3
18596,serai,0,0,3,3
22535,മുമ്പ്,0,0,3,3
44852,откуда,0,0,3,3
43105,editados,0,0,3,3
1169,hinton,2,2,1,3
1168,crimson,2,1,2,3
22529,looks,0,0,3,3
35618,सम्पादन,0,0,3,3
44865,universel,0,0,3,3
18612,blandt,0,0,3,3
47157,प्यारे,0,0,3,3
22527,feita,0,0,3,3
18613,verdade,0,0,3,3
12317,capacités,0,0,3,3
22516,onun,0,0,3,3
18667,fiche,0,0,3,3
1164,risulta,1,3,0,3
299,resa,2,1,2,3
22512,innefattar,0,0,3,3
40625,potentially,0,0,3,3
18648,viki,0,0,3,3
33328,திறந்த,0,0,3,3
18650,låta,0,0,3,3
18651,speciellt,0,0,3,3
12337,nichts,0,0,3,3
3613,amministrazione,1,3,0,3
15861,provenant,0,0,3,3
22496,പ്രിയപ്പെട്ട,0,0,3,3
306,esteso,1,3,0,3
40638,entrevista,0,0,3,3
282,sento,1,3,0,3
44840,ಯಾರಿಗಾದರೂ,0,0,3,3
22541,جديدة,0,0,3,3
18568,doğruluğu,0,0,3,3
35556,الحقيقة,0,0,3,3
15973,pesquisador,0,0,3,3
40568,dez,0,0,3,3
15972,arbeitet,0,0,3,3
30563,εγχειρήματα,0,0,3,3
15970,c’estàdire,0,0,3,3
52229,yapamam,0,0,3,3
32597,लेने,0,0,3,3
1183,criterio,2,2,1,3
12264,behavioral,0,0,3,3
15959,receio,0,0,3,3
47188,unlabeled,0,0,3,3
18549,भेज,0,0,3,3
15956,studenter,0,0,3,3
22571,laver,0,0,3,3
271,strategia,1,3,0,3
47183,suggest,0,0,3,3
22566,cher,0,0,3,3
43136,afirma,0,0,3,3
275,contatto,1,3,0,3
1178,gergo,1,3,0,3
22553,könntest,0,0,3,3
15943,friend,0,0,3,3
22551,überrascht,0,0,3,3
277,stampata,1,3,0,3
12290,dinge,0,0,3,3
44835,जहाँ,0,0,3,3
22546,திருகினேன்,0,0,3,3
1172,bigipedia,2,1,2,3
18665,mätte,0,0,3,3
15852,casar,0,0,3,3
18762,volgens,0,0,3,3
18742,follows,0,0,3,3
47113,underlying,0,0,3,3
34150,grundläggande,0,0,3,3
33311,горит,0,0,3,3
44924,порядке,0,0,3,3
324,universitario,2,2,1,3
43024,criança,0,0,3,3
1149,elettronica,1,3,0,3
30561,الصوت,0,0,3,3
40677,мнения,0,0,3,3
43022,woher,0,0,3,3
15791,பிஸியாக,0,0,3,3
15786,americanos,0,0,3,3
47098,நான்கு,0,0,3,3
44941,constituent,0,0,3,3
12414,preguntas,0,0,3,3
47139,biográficos,0,0,3,3
18747,moves,0,0,3,3
43008,redigeringskrig,0,0,3,3
47093,attribution,0,0,3,3
12418,ಮಾತ್ರ,0,0,3,3
43004,nosotros,0,0,3,3
22418,motion,0,0,3,3
40693,baixos,0,0,3,3
44947,രജിസ്റ്റർ,0,0,3,3
3892,filtra,2,2,1,3
33700,publicatie,0,0,3,3
43001,maten,0,0,3,3
15764,سيجنثالر,0,0,3,3
18761,escuchando,0,0,3,3
22383,crecimiento,0,0,3,3
51250,lyssnade,0,0,3,3
320,fede,1,3,0,3
1154,scorre,1,3,0,3
22459,gutaussehend,0,0,3,3
12349,πάρετε,0,0,3,3
47138,italian,0,0,3,3
47136,robotskapade,0,0,3,3
12354,anônimos,0,0,3,3
22490,идти,0,0,3,3
12358,graves,0,0,3,3
22485,relação,0,0,3,3
33325,compostura,0,0,3,3
12360,मिलता,0,0,3,3
47133,умные,0,0,3,3
40648,أكن,0,0,3,3
3614,carica,1,3,0,3
18681,ನಿರರ್ಗಳವಾಗಿ,0,0,3,3
12366,vind,0,0,3,3
44904,comentário,0,0,3,3
15836,couverture,0,0,3,3
43043,परीक्षण,0,0,3,3
22474,الولايات,0,0,3,3
1158,trattavi,1,3,0,3
18704,discusiones,0,0,3,3
22466,άσε,0,0,3,3
44916,fallen,0,0,3,3
47122,granskning,0,0,3,3
12377,sine,0,0,3,3
33312,रोना,0,0,3,3
43032,βλέπω,0,0,3,3
18713,termos,0,0,3,3
15813,разговоре,0,0,3,3
12380,كذلك,0,0,3,3
22162,शिकायत,0,0,3,3
12625,jullie,0,0,3,3
15516,apoyo,0,0,3,3
21862,relation,0,0,3,3
42621,banklån,0,0,3,3
21885,middle,0,0,3,3
15172,ഉദാഹരണങ്ങൾ,0,0,3,3
19386,значение,0,0,3,3
33772,härter,0,0,3,3
21880,strongly,0,0,3,3
12876,अनुरोधों,0,0,3,3
21874,μήνυμα,0,0,3,3
45319,sammenlignet,0,0,3,3
30412,фраз,0,0,3,3
19395,मूर्ख,0,0,3,3
15158,klinkt,0,0,3,3
19396,acquisition,0,0,3,3
12885,vinklat,0,0,3,3
472,dirgli,1,3,0,3
42586,automatically,0,0,3,3
19401,économiques,0,0,3,3
34065,संपादक,0,0,3,3
34064,ലേഖകർ,0,0,3,3
30557,போல்,0,0,3,3
15141,reconnaissance,0,0,3,3
19414,potencialmente,0,0,3,3
19418,editör,0,0,3,3
15125,место,0,0,3,3
478,spinto,1,3,0,3
42592,estimé,0,0,3,3
42589,ಹೇಳುತ್ತೇನೆ,0,0,3,3
46763,phénomènes,0,0,3,3
21830,мечта,0,0,3,3
52518,данные,0,0,3,3
3654,proteggere,1,3,0,3
21888,entrenamiento,0,0,3,3
41036,слышали,0,0,3,3
19365,nio,0,0,3,3
21924,संशोधन,0,0,3,3
12831,º,0,0,3,3
19302,ترخيص,0,0,3,3
41014,convencional,0,0,3,3
45265,cientistas,0,0,3,3
42669,forklarer,0,0,3,3
12837,ваше,0,0,3,3
1044,tentativo,1,3,0,3
21907,japonesa,0,0,3,3
15247,usas,0,0,3,3
446,nostra,1,3,0,3
1042,arrivò,1,3,0,3
12843,sweet,0,0,3,3
19314,piece,0,0,3,3
52530,cœur,0,0,3,3
19326,عامة,0,0,3,3
41027,located,0,0,3,3
3787,tremendamente,2,2,1,3
52526,bitten,0,0,3,3
15214,cambios,0,0,3,3
41031,modificar,0,0,3,3
46791,träffa,0,0,3,3
21895,muestra,0,0,3,3
33200,мое,0,0,3,3
41032,tornar,0,0,3,3
15204,العشر,0,0,3,3
42643,provided,0,0,3,3
45302,занят,0,0,3,3
46788,തുടർന്ന്,0,0,3,3
46756,അമേരിക്കക്കാർ,0,0,3,3
12915,கீழே,0,0,3,3
32690,दावा,0,0,3,3
505,scuse,1,3,0,3
15022,setting,0,0,3,3
42510,tidsskrift,0,0,3,3
33167,déranger,0,0,3,3
19553,racines,0,0,3,3
34053,conseguir,0,0,3,3
21757,below,0,0,3,3
46711,изображения,0,0,3,3
21754,വചനം,0,0,3,3
45409,spielt,0,0,3,3
12982,elke,0,0,3,3
19557,النرجسية,0,0,3,3
41129,participação,0,0,3,3
21747,அல்ல,0,0,3,3
33789,aucune,0,0,3,3
32751,ohne,0,0,3,3
21816,нейросети,0,0,3,3
19575,ഒബ്ട്യൂസ്,0,0,3,3
42483,يطلب,0,0,3,3
508,chiara,1,3,0,3
33792,ನಂಬರ್,0,0,3,3
46704,أصدقاؤك,0,0,3,3
21738,αργότερα,0,0,3,3
19592,transaction,0,0,3,3
41139,tienen,0,0,3,3
14981,won,0,0,3,3
19600,दिया।,0,0,3,3
19601,contribuinte,0,0,3,3
52509,النرجس,0,0,3,3
19607,знаний,0,0,3,3
1004,biodiversità,1,3,0,3
51176,прямо,0,0,3,3
34060,conteúdos,0,0,3,3
42526,ಈಗಾಗಲೇ,0,0,3,3
15036,интернете,0,0,3,3
15107,primeiros,0,0,3,3
15101,πολλές,0,0,3,3
52517,sigan,0,0,3,3
41092,ilegal,0,0,3,3
15091,istemiyorum,0,0,3,3
21806,स्वतंत्रता,0,0,3,3
42562,ಕೇಳುತ್ತೀರಿ,0,0,3,3
42560,يريد,0,0,3,3
46744,faktisk,0,0,3,3
46743,mallar,0,0,3,3
46740,showed,0,0,3,3
41105,prevent,0,0,3,3
19481,basin,0,0,3,3
491,ripresa,1,3,0,3
1019,leggendo,1,3,0,3
19487,ediyorum,0,0,3,3
45375,élèves,0,0,3,3
15065,विश्वविद्यालय,0,0,3,3
12948,anında,0,0,3,3
12951,النظر,0,0,3,3
21775,incapable,0,0,3,3
1017,accetto,1,3,0,3
42527,işe,0,0,3,3
45392,माइकल,0,0,3,3
45394,goodbye,0,0,3,3
1016,seduto,1,3,0,3
41116,hébergement,0,0,3,3
33172,ಸ್ಕೋರ್,0,0,3,3
21770,சற்று,0,0,3,3
42672,agradecer,0,0,3,3
15260,നിന്നാണ്,0,0,3,3
19295,dersin,0,0,3,3
414,promosso,1,3,0,3
19094,anjo,0,0,3,3
19096,entered,0,0,3,3
52270,herramienta,0,0,3,3
42792,ante,0,0,3,3
1068,arabo,1,3,0,3
45139,الحياة,0,0,3,3
19101,पूरे,0,0,3,3
33751,lieve,0,0,3,3
40946,vinieron,0,0,3,3
19109,variable,0,0,3,3
1066,lavorando,1,3,0,3
46888,сердцу,0,0,3,3
3662,conosciuto,1,3,0,3
413,springer,2,1,2,3
12718,बनाती,0,0,3,3
19291,стала,0,0,3,3
12722,puisje,0,0,3,3
15425,passar,0,0,3,3
52272,بالطبع,0,0,3,3
46876,deine,0,0,3,3
15424,αυτούς,0,0,3,3
22022,जिसने,0,0,3,3
19120,mutually,0,0,3,3
42776,authors,0,0,3,3
418,ghiacciai,1,3,0,3
15410,tacka,0,0,3,3
35573,chercheurs,0,0,3,3
42771,கேட்டால்,0,0,3,3
46862,μιας,0,0,3,3
19136,فوق,0,0,3,3
46900,باسم,0,0,3,3
46902,ஆச்சரியமாக,0,0,3,3
40932,biliyorum,0,0,3,3
42801,ailleurs,0,0,3,3
19018,आधार,0,0,3,3
15514,ഓൺലൈൻ,0,0,3,3
19026,seek,0,0,3,3
403,fermata,1,3,0,3
12637,самое,0,0,3,3
52265,गुस्सा,0,0,3,3
1080,incorporato,1,3,0,3
40874,ideas,0,0,3,3
42829,passiert,0,0,3,3
12643,عند,0,0,3,3
45108,проекте,0,0,3,3
15493,पंजीकृत,0,0,3,3
42821,veracidad,0,0,3,3
40900,ويمكن,0,0,3,3
19045,grammatik,0,0,3,3
12658,ίδρυμα,0,0,3,3
1076,lolicon,2,1,2,3
46926,avond,0,0,3,3
15487,içeriğini,0,0,3,3
51145,överbelastad,0,0,3,3
405,sottoinsiemi,1,3,0,3
19054,مارس,0,0,3,3
52543,computacional,0,0,3,3
12678,ഫ്രഞ്ച്,0,0,3,3
19063,vroeg,0,0,3,3
19066,απασχολημένος,0,0,3,3
22077,apparaît,0,0,3,3
19075,originalmente,0,0,3,3
22074,φάω,0,0,3,3
45168,dedicados,0,0,3,3
15393,conocimientos,0,0,3,3
42764,oorspronkelijke,0,0,3,3
19228,episódios,0,0,3,3
46830,liefste,0,0,3,3
42708,എന്തിനാണ്,0,0,3,3
19239,degree,0,0,3,3
19247,geographic,0,0,3,3
12794,पाठक,0,0,3,3
42701,eua,0,0,3,3
35575,κανόνες,0,0,3,3
15306,கொள்ள,0,0,3,3
46826,onze,0,0,3,3
21955,प्रश्न,0,0,3,3
21954,ಅನೇಕ,0,0,3,3
15303,rama,0,0,3,3
19257,beschäftigt,0,0,3,3
12803,doet,0,0,3,3
21951,через,0,0,3,3
41002,adicional,0,0,3,3
15297,നോക്കി,0,0,3,3
45235,στείλω,0,0,3,3
21938,poursuit,0,0,3,3
33212,oración,0,0,3,3
3878,fetta,1,3,0,3
15286,métaphysique,0,0,3,3
45242,entendeu,0,0,3,3
45243,inquiète,0,0,3,3
15280,följande,0,0,3,3
45246,incomodálo,0,0,3,3
45247,seit,0,0,3,3
19280,സംസാരിക്കാൻ,0,0,3,3
45254,ഏത്,0,0,3,3
19229,falsk,0,0,3,3
19220,documents,0,0,3,3
46856,കഠിനാധ്വാനം,0,0,3,3
12790,وبالتالي,0,0,3,3
42761,«нупедия»,0,0,3,3
40970,estes,0,0,3,3
33220,aceso,0,0,3,3
19154,громадно,0,0,3,3
42754,zoveel,0,0,3,3
34080,desigual,0,0,3,3
46853,dedicada,0,0,3,3
21992,لديه,0,0,3,3
429,multicellulari,1,3,0,3
21988,إدخال,0,0,3,3
42747,созданию,0,0,3,3
21985,external,0,0,3,3
12768,समान,0,0,3,3
432,incorpora,2,1,2,3
45198,möjligt,0,0,3,3
21980,الإطلاق,0,0,3,3
21972,sætningen,0,0,3,3
19199,intonation,0,0,3,3
12782,fonctions,0,0,3,3
45203,मार्क,0,0,3,3
46837,atroces,0,0,3,3
21967,день,0,0,3,3
15344,notability,0,0,3,3
15343,söyleyebileceğin,0,0,3,3
46835,сделали,0,0,3,3
19213,træk,0,0,3,3
19214,söylemenin,0,0,3,3
19216,gäller,0,0,3,3
46831,recientes,0,0,3,3
14228,privacidade,0,0,3,3
51289,experiência,0,0,3,3
37741,spreken,0,0,3,3
27051,southern,0,0,3,3
7749,spettatori,1,3,0,3
37721,enseignants,0,0,3,3
37719,manual,0,0,3,3
37715,allerede,0,0,3,3
7743,appartenente,1,3,0,3
49606,നിർദ്ദേശങ്ങൾ,0,0,3,3
37709,शनिवार,0,0,3,3
7736,hawaiano,1,3,0,3
30136,ஒலிக்க,0,0,3,3
27080,മനോഹരമായ,0,0,3,3
49616,நுபீடியாவிற்கு,0,0,3,3
7727,fonda,1,3,0,3
51738,όσα,0,0,3,3
7724,qualunque,1,3,0,3
31574,kategorier,0,0,3,3
27092,forhånd,0,0,3,3
49619,lohnt,0,0,3,3
2396,iscrizione,1,3,0,3
27104,மதிப்பெண்,0,0,3,3
7711,webos,2,2,1,3
7709,esitante,1,3,0,3
7754,carte,2,2,1,3
2386,sharealike,2,1,2,3
37765,databases,0,0,3,3
7758,facessi,1,3,0,3
37763,μαρία,0,0,3,3
37756,ganhou,0,0,3,3
27004,ethical,0,0,3,3
27006,activity,0,0,3,3
2371,valutate,1,3,0,3
37751,mouvement,0,0,3,3
7802,regola,1,3,0,3
7801,sostegno,1,3,0,3
7799,povera,1,3,0,3
7796,perceptrons,2,1,2,3
34802,açık,0,0,3,3
11273,perspektiv,0,0,3,3
7784,voluto,1,3,0,3
7781,elezioni,1,3,0,3
27034,författaren,0,0,3,3
27038,بضع,0,0,3,3
7768,correio,2,1,2,3
27043,tráfego,0,0,3,3
2380,controllati,1,3,0,3
7763,venissero,1,3,0,3
49602,saturday,0,0,3,3
7708,stesura,1,3,0,3
7706,java,2,1,2,3
27106,opposite,0,0,3,3
27108,traditionele,0,0,3,3
7638,hopfield,2,2,1,3
27172,provides,0,0,3,3
27181,saknas,0,0,3,3
7630,proviene,2,2,1,3
2428,bayesiano,1,3,0,3
7628,lenti,1,3,0,3
7627,condizione,1,3,0,3
49659,تقريبًا,0,0,3,3
7621,dimenticano,1,3,0,3
27186,أستمع,0,0,3,3
34835,क्षेत्र,0,0,3,3
37632,contribuer,0,0,3,3
7605,vantaggio,1,3,0,3
37626,نص,0,0,3,3
7602,scorso,1,3,0,3
2434,veramente,1,3,0,3
27202,organisation,0,0,3,3
27207,lecteur,0,0,3,3
27209,advanced,0,0,3,3
49675,justo,0,0,3,3
35748,ಹಿಡಿಯಲಿಲ್ಲ,0,0,3,3
7639,mediche,1,3,0,3
7642,maschi,1,3,0,3
27169,साईट,0,0,3,3
27124,задачи,0,0,3,3
7700,includendo,1,3,0,3
27111,καθόλου,0,0,3,3
27112,ελεύθερος,0,0,3,3
37684,requisitos,0,0,3,3
49631,gens,0,0,3,3
31563,rejected,0,0,3,3
49632,vegetation,0,0,3,3
2417,telegiornale,1,3,0,3
27123,lørdag,0,0,3,3
31562,vän,0,0,3,3
27164,dereceden,0,0,3,3
27133,pessoal,0,0,3,3
37672,önce,0,0,3,3
7663,giocando,1,3,0,3
37662,संस्थापक,0,0,3,3
27149,सफलता,0,0,3,3
37655,talen,0,0,3,3
27156,dåligt,0,0,3,3
7652,estate,1,3,0,3
49650,वर्ष,0,0,3,3
7821,diretta,1,3,0,3
26982,signals,0,0,3,3
37921,тоже,0,0,3,3
37864,zuilen,0,0,3,3
8058,funge,1,3,0,3
49505,ക്ഷമിക്കൂ,0,0,3,3
31680,जिम्मी,0,0,3,3
8048,sanitaria,1,3,0,3
26847,detección,0,0,3,3
8041,naturalismo,1,3,0,3
8036,batteri,1,3,0,3
31674,kenmerken,0,0,3,3
8034,finito,1,3,0,3
49511,αμερικανοί,0,0,3,3
34756,actividades,0,0,3,3
37846,asombroso,0,0,3,3
35738,estadísticas,0,0,3,3
37844,கொடூரமானது,0,0,3,3
8016,puzzolente,1,3,0,3
8010,degustazione,1,3,0,3
31662,கவனித்துக்,0,0,3,3
2314,augurare,1,3,0,3
7997,risorsa,1,3,0,3
31653,आए,0,0,3,3
2321,samareño,2,1,2,3
8059,troverai,1,3,0,3
30147,primordial,0,0,3,3
26974,globally,0,0,3,3
2283,spiegano,1,3,0,3
8138,iwf,2,1,2,3
26773,πάρα,0,0,3,3
8135,lezione,1,3,0,3
49471,frygtelig,0,0,3,3
26782,dinlemiyordum,0,0,3,3
8126,chiodo,1,3,0,3
26789,духе,0,0,3,3
37899,ತೆಗೆದುಕೊಳ್ಳಬೇಡಿ,0,0,3,3
26791,ಧನ್ಯವಾದ,0,0,3,3
2271,poterlo,1,3,0,3
37897,skrev,0,0,3,3
2273,percezione,1,3,0,3
8110,paragonabile,1,3,0,3
34738,الويكي،,0,0,3,3
37894,themselves,0,0,3,3
37893,adaptation,0,0,3,3
26802,vidste,0,0,3,3
8098,delizioso,1,3,0,3
37875,चलने,0,0,3,3
2280,sottolineare,1,3,0,3
8078,giornale,1,3,0,3
7991,raccolte,1,3,0,3
7990,solamente,2,1,2,3
30142,skaffa,0,0,3,3
37829,contraire,0,0,3,3
26938,utvalda,0,0,3,3
2341,morendo,1,3,0,3
26940,केचे,0,0,3,3
7895,suscettibilità,1,3,0,3
34781,മുഴുവൻ,0,0,3,3
7891,agiscono,1,3,0,3
31628,álbum,0,0,3,3
26944,licenças,0,0,3,3
7883,accettano,1,3,0,3
7875,sottoinsieme,1,3,0,3
7870,prestarmi,1,3,0,3
37785,വിക്കിമീഡിയ,0,0,3,3
7865,meteorologiche,1,3,0,3
31618,penser,0,0,3,3
26960,выглядела,0,0,3,3
7855,dinamiche,1,3,0,3
31613,opinião,0,0,3,3
7850,riprendere,1,3,0,3
31609,full,0,0,3,3
7839,grafica,1,3,0,3
31607,suffer,0,0,3,3
7913,adorabile,1,3,0,3
7922,miguel,2,1,2,3
7923,salute,1,3,0,3
7953,condivisi,1,3,0,3
37823,करेंगे,0,0,3,3
31650,விரைவில்,0,0,3,3
49530,danken,0,0,3,3
7978,stamattina,1,3,0,3
7975,liquido,1,3,0,3
7973,ehi,1,3,0,3
7959,portata,1,3,0,3
2327,aggiuntive,1,3,0,3
7955,ipod,2,1,2,3
7952,guidate,1,3,0,3
7925,fermati,1,3,0,3
49538,ரகசிய,0,0,3,3
49539,வாக்கியங்கள்,0,0,3,3
34773,literalmente,0,0,3,3
7947,invito,1,3,0,3
37807,உரை,0,0,3,3
37806,συμφωνώ,0,0,3,3
34776,pull,0,0,3,3
7936,placche,1,3,0,3
26923,kamen,0,0,3,3
27215,எனினும்,0,0,3,3
2439,schekman,1,3,0,3
27220,ದೇವರೇ,0,0,3,3
51676,இருப்பது,0,0,3,3
49831,candidat,0,0,3,3
7171,segnali,1,3,0,3
49833,जरुरत,0,0,3,3
31429,computadoras,0,0,3,3
30118,suivent,0,0,3,3
7151,matto,1,3,0,3
7150,tanta,2,2,1,3
2599,vado,1,3,0,3
34916,swamp,0,0,3,3
27603,sumpf,0,0,3,3
27604,moeras,0,0,3,3
7134,loves,2,1,2,3
7132,contraddittorie,1,3,0,3
37370,juntamente,0,0,3,3
2609,manipolare,1,3,0,3
27612,rejeitou,0,0,3,3
34919,والدتها,0,0,3,3
27615,مزعج,0,0,3,3
7122,quadro,1,3,0,3
34923,ನುಡಿಗಟ್ಟುಗಳು,0,0,3,3
37358,estávamos,0,0,3,3
34912,auktoritet,0,0,3,3
2579,funzionerà,1,3,0,3
49679,appuyant,0,0,3,3
27543,exibido,0,0,3,3
7254,marmellate,1,3,0,3
27507,« les,0,0,3,3
2551,impiegato,1,3,0,3
37436,التقاء,0,0,3,3
7245,usanze,1,3,0,3
7242,eccezioni,1,3,0,3
7240,healthcare,2,1,2,3
49810,अधिकार,0,0,3,3
7231,iscriverti,1,3,0,3
31449,rolle,0,0,3,3
49812,devenir,0,0,3,3
34901,emner,0,0,3,3
49813,bygger,0,0,3,3
7221,«una,2,1,2,3
27533,മെല്ലിയും,0,0,3,3
27534,consideraba,0,0,3,3
30122,présent,0,0,3,3
7211,respinto,1,3,0,3
2571,soldati,1,3,0,3
7202,diciamo,1,3,0,3
49820,السبت,0,0,3,3
7112,sorella,1,3,0,3
27630,φαίνεται,0,0,3,3
37348,throughout,0,0,3,3
7105,chiamante,1,3,0,3
7024,cancellare,1,3,0,3
2639,anonimo,1,3,0,3
2640,imprecise,2,2,1,3
34933,tendens,0,0,3,3
2646,banca,1,3,0,3
27705,minuter,0,0,3,3
2647,pianto,1,3,0,3
7007,dicesse,1,3,0,3
27719,கொண்டுள்ளது,0,0,3,3
2649,passo,2,2,1,3
6994,notorietà,1,3,0,3
6992,latitudine,1,3,0,3
34943,சொற்றொடர்கள்,0,0,3,3
6987,assiste,2,2,1,3
6985,sorridendosi,1,3,0,3
37281,endereços,0,0,3,3
31381,м,0,0,3,3
2658,garanzia,1,3,0,3
27745,получить,0,0,3,3
6969,dedicati,1,3,0,3
4143,infine,1,3,0,3
51653,apprend,0,0,3,3
7032,bicchiere,1,3,0,3
2637,influenzato,1,3,0,3
7081,disaccordi,1,3,0,3
2616,fermò,1,3,0,3
34924,fortalte,0,0,3,3
7098,tettoniche,1,3,0,3
27647,«фаза,0,0,3,3
7094,reputazione,1,3,0,3
7092,particolari,1,3,0,3
27648,existem,0,0,3,3
31412,afirmou,0,0,3,3
7083,caffè,1,3,0,3
31406,lång,0,0,3,3
37315,whatever,0,0,3,3
7069,cancellazioni,1,3,0,3
37331,voraus,0,0,3,3
27672,doigts,0,0,3,3
7052,femminili,1,3,0,3
27680,bibliotecarios,0,0,3,3
7045,permesso,1,3,0,3
7040,costruisce,1,3,0,3
27691,dames,0,0,3,3
30113,снова,0,0,3,3
7255,proporzione,1,3,0,3
37439,вот,0,0,3,3
37440,вещи,0,0,3,3
7426,aiutami,1,3,0,3
7502,inserendo,1,3,0,3
7498,felipe,2,1,2,3
4119,debba,1,3,0,3
27302,visat,0,0,3,3
37560,sammanhang,0,0,3,3
34858,परीक्षा,0,0,3,3
2469,eliminare,1,3,0,3
37552,وداعًا,0,0,3,3
7465,interrompo,1,3,0,3
27330,करके,0,0,3,3
31503,asturian,0,0,3,3
7456,deliberatamente,1,3,0,3
2479,obiettività,1,3,0,3
7449,biologico,1,3,0,3
51706,superior,0,0,3,3
2483,guinness,1,3,0,3
2487,chiedevo,1,3,0,3
7437,opposti,1,3,0,3
27346,prose,0,0,3,3
35749,später,0,0,3,3
2491,apparire,1,3,0,3
7509,percepita,1,3,0,3
7516,contratto,1,3,0,3
7520,sviluppatori,1,3,0,3
7543,voti,1,3,0,3
30130,videoda,0,0,3,3
37610,knew,0,0,3,3
27230,ausgeflippt,0,0,3,3
7565,pensanti,1,3,0,3
7562,dodici,1,3,0,3
2447,flusso,1,3,0,3
7553,vissuto,1,3,0,3
7548,menzionato,1,3,0,3
2450,reciprocamente,1,3,0,3
7542,ˌwɪkiˈpiːdiə,2,2,1,3
4117,genoma,1,3,0,3
37591,gizli,0,0,3,3
7536,wikihpeedeeə,2,1,2,3
2453,globalmente,2,2,1,3
7532,lineari,1,3,0,3
37587,ماريان,0,0,3,3
2455,piacerebbe,1,3,0,3
2456,vegetazione,1,3,0,3
37584,которым,0,0,3,3
37580,özür,0,0,3,3
7430,fallimenti,1,3,0,3
2494,acqueo,1,3,0,3
27498,posteriormente,0,0,3,3
30126,considérés,0,0,3,3
2529,medica,1,3,0,3
2530,concluso,1,3,0,3
27451,نمو,0,0,3,3
27457,offers,0,0,3,3
37472,அமெரிக்கர்கள்,0,0,3,3
7307,commentando,1,3,0,3
7305,illegale,1,3,0,3
7299,playstation,2,1,2,3
51692,tvärtom,0,0,3,3
2540,schemi,1,3,0,3
7291,tracce,1,3,0,3
7290,bambola,1,3,0,3
7287,esprimere,1,3,0,3
27487,പറയാനുള്ള,0,0,3,3
51689,flawed,0,0,3,3
7281,browser,2,2,1,3
2544,comportato,1,3,0,3
7279,epico,1,3,0,3
7276,dichiarato,1,3,0,3
37447,επιτρέψτε,0,0,3,3
7269,lontano,1,3,0,3
49776,polémica,0,0,3,3
2528,inserire,1,3,0,3
27443,kelimesini,0,0,3,3
51700,subset,0,0,3,3
2497,guardò,1,3,0,3
7414,preferirei,1,3,0,3
7409,gestita,1,3,0,3
27368,sista,0,0,3,3
7401,transazione,1,3,0,3
7400,jeopardy,2,1,2,3
7399,stiamo,1,3,0,3
37522,üben,0,0,3,3
37520,الذكور,0,0,3,3
7388,inserito,1,3,0,3
7331,warring,2,1,2,3
49749,ನಿನ್ನನ್ನು,0,0,3,3
2507,intonazione,1,3,0,3
34878,ಪಡೆದಿದ್ದೇನೆ,0,0,3,3
7366,seduta,1,3,0,3
49758,நபரை,0,0,3,3
34882,espécie,0,0,3,3
37490,rahatsız,0,0,3,3
37487,kender,0,0,3,3
27440,уловил,0,0,3,3
51802,board,0,0,3,3
8152,religiose,1,3,0,3
9488,parchi,1,3,0,3
1962,risultando,1,3,0,3
51930,е,0,0,3,3
26019,esteja,0,0,3,3
9057,potenzialmente,1,3,0,3
9056,cosiddetti,1,3,0,3
1966,restrizioni,1,3,0,3
9049,sentire,1,3,0,3
26031,മാത്രമേ,0,0,3,3
30195,silver,0,0,3,3
9029,avvento,1,3,0,3
38366,remove,0,0,3,3
38364,conçu,0,0,3,3
49120,تيري,0,0,3,3
34551,dejligt,0,0,3,3
9017,divennero,1,3,0,3
49123,يقدم,0,0,3,3
30190,കാണും,0,0,3,3
9003,branca,1,3,0,3
38352,эту,0,0,3,3
8997,supera,1,3,0,3
38348,ಪ್ರಿಯ,0,0,3,3
1981,fiducia,1,3,0,3
38388,கேட்கும்போது,0,0,3,3
49100,implicitly,0,0,3,3
31996,биологии,0,0,3,3
25997,préalablement,0,0,3,3
25942,recuerda,0,0,3,3
30204,marcas,0,0,3,3
9138,spaventoso,1,3,0,3
9136,riesce,1,3,0,3
49068,प्रणाली,0,0,3,3
25953,போது,0,0,3,3
25954,harte,0,0,3,3
49076,elde,0,0,3,3
3551,diversa,1,3,0,3
49079,فضلك,0,0,3,3
49081,عملية,0,0,3,3
9100,crocker,2,1,2,3
1952,scrivendo,1,3,0,3
51935,ánimo,0,0,3,3
25976,विशेषज्ञ,0,0,3,3
49091,صغيرة,0,0,3,3
25980,responsáveis,0,0,3,3
1957,scoraggia,1,3,0,3
25984,geometri,0,0,3,3
1959,ricchezza,1,3,0,3
34547,खुला,0,0,3,3
31974,κάποιο,0,0,3,3
8990,coppie,1,3,0,3
1983,andrebbe,1,3,0,3
8986,aggiornare,1,3,0,3
8899,entrato,1,3,0,3
8897,integrato,1,3,0,3
8895,composizione,1,3,0,3
8894,soddisfano,1,3,0,3
2028,rientra,1,3,0,3
8880,strategie,1,3,0,3
8878,moglie,1,3,0,3
49175,modified,0,0,3,3
31924,negativt,0,0,3,3
8865,piantare,1,3,0,3
4062,ufficio,1,3,0,3
2034,titolo,1,3,0,3
49182,sunulmaktadır,0,0,3,3
31922,ваши,0,0,3,3
26168,marché,0,0,3,3
26170,média,0,0,3,3
34591,കഴിഞ്ഞില്ല,0,0,3,3
2042,equilibrate,1,3,0,3
8834,partita,1,3,0,3
26187,punktzahl,0,0,3,3
26192,grands,0,0,3,3
49166,começar,0,0,3,3
8908,collettiva,1,3,0,3
8909,avverando,1,3,0,3
51918,participar,0,0,3,3
8985,diventate,1,3,0,3
1985,caporedattore,1,3,0,3
8981,facciamo,1,3,0,3
51921,nodig,0,0,3,3
1988,supporta,1,3,0,3
8970,ricco,1,3,0,3
8968,wii,2,1,2,3
26099,woman,0,0,3,3
8963,internazionali,1,3,0,3
8959,espressioni,1,3,0,3
31941,hungrig,0,0,3,3
1999,master,2,2,1,3
30184,estábamos,0,0,3,3
8940,rise,2,1,2,3
8937,fotografica,1,3,0,3
34571,قل,0,0,3,3
51269,شبه,0,0,3,3
49155,fortsätta,0,0,3,3
8924,παιδεία,2,2,1,3
2010,ˌwɪkɪˈpiːdiə,2,1,2,3
38431,അവസാന,0,0,3,3
1943,associate,2,1,2,3
8155,opportunità,1,3,0,3
1864,starnutito,1,3,0,3
25745,deliver,0,0,3,3
9379,energetico,1,3,0,3
1869,automatici,1,3,0,3
9373,commentato,1,3,0,3
25751,lisansı,0,0,3,3
9368,artigiano,1,3,0,3
34526,निर्मित,0,0,3,3
38531,klingt,0,0,3,3
48978,نطاق,0,0,3,3
1877,colore,1,3,0,3
25777,बैंक,0,0,3,3
38523,äußerst,0,0,3,3
38514,основе,0,0,3,3
34530,οποίο,0,0,3,3
9330,attraversato,1,3,0,3
38507,horizontal,0,0,3,3
38501,lema,0,0,3,3
25819,klagen,0,0,3,3
9319,meraviglioso,1,3,0,3
9317,appaiono,1,3,0,3
38488,perdón,0,0,3,3
25732,luisterde,0,0,3,3
9404,conflitti,1,3,0,3
25935,extremadamente,0,0,3,3
34523,classement,0,0,3,3
9473,sembrano,1,3,0,3
32041,ജിമ്മി,0,0,3,3
25671,mensen,0,0,3,3
9456,douglas,2,1,2,3
25679,résoudre,0,0,3,3
25686,προσπάθεια,0,0,3,3
9449,efficiente,1,3,0,3
9448,polemica,1,3,0,3
51967,செல்லலாம்,0,0,3,3
25688,archives,0,0,3,3
9442,impegno,1,3,0,3
38574,bastante,0,0,3,3
25702,أشار,0,0,3,3
25704,ನೋಡೋಣ,0,0,3,3
9432,vicina,1,3,0,3
48942,sabia,0,0,3,3
38566,σύντομα,0,0,3,3
9426,uccello,1,3,0,3
9425,esagerare,1,3,0,3
38563,bibliothèque,0,0,3,3
9413,maggioranza,1,3,0,3
25830,busy,0,0,3,3
1893,provengono,1,3,0,3
1894,ringraziarti,1,3,0,3
4040,rosso,1,3,0,3
9219,quei,1,3,0,3
9217,protisti,1,3,0,3
38461,chamados,0,0,3,3
32004,l’encontre,0,0,3,3
1923,knol,2,1,2,3
9206,giudicare,1,3,0,3
49041,வேலையில்,0,0,3,3
9202,fallo,1,3,0,3
38457,إلهي,0,0,3,3
25899,கேட்கிறது,0,0,3,3
1930,supportare,1,3,0,3
25907,cofondateur,0,0,3,3
1932,cancellano,1,3,0,3
9183,alterate,1,3,0,3
25914,считается,0,0,3,3
49049,सुनिश्चित,0,0,3,3
1933,cronometra,2,2,1,3
9170,offerta,1,3,0,3
34539,αναμμένο,0,0,3,3
51939,onunla,0,0,3,3
25930,torna,0,0,3,3
9220,ambiguità,1,3,0,3
4047,ospitato,1,3,0,3
25885,bunlar,0,0,3,3
25861,ಎಲ್ಲಿದ್ದೇವೆ,0,0,3,3
49013,russian,0,0,3,3
9281,cognitive,2,2,1,3
1902,congratularsi,1,3,0,3
9279,collega,1,3,0,3
35707,bed,0,0,3,3
25852,machinaal,0,0,3,3
25855,débat,0,0,3,3
25858,scientists,0,0,3,3
25859,ವ್ಯಕ್ತಿ,0,0,3,3
38472,απλά,0,0,3,3
49034,محيرة,0,0,3,3
49024,libros,0,0,3,3
25869,område,0,0,3,3
9251,immangiabile,1,3,0,3
1912,segnalare,1,3,0,3
49028,merhaba,0,0,3,3
9241,fondi,1,3,0,3
25879,betydelse,0,0,3,3
49032,havalı,0,0,3,3
25883,ذلك؟,0,0,3,3
26193,ಕೇಳಿದ್ದೀರಿ,0,0,3,3
34595,faktiskt,0,0,3,3
8823,inquinamento,1,3,0,3
34691,klinken,0,0,3,3
26549,moved,0,0,3,3
26550,incluant,0,0,3,3
8400,seduti,1,3,0,3
8397,autonomamente,1,3,0,3
26558,എനിക്കറിയില്ല,0,0,3,3
31766,இத்திட்டம்,0,0,3,3
8391,certamente,2,2,1,3
2192,direzioni,1,3,0,3
2193,vialetto,1,3,0,3
49369,вопросу,0,0,3,3
2194,catturare,1,3,0,3
38041,लगाया,0,0,3,3
49372,tarafsız,0,0,3,3
31760,സ്നേഹിക്കുന്നു,0,0,3,3
26583,challenges,0,0,3,3
8364,illuminismo,1,3,0,3
26586,μπήκε,0,0,3,3
8359,bellissimo,1,3,0,3
8353,induttivo,1,3,0,3
49384,thématique,0,0,3,3
8347,dieta,2,2,1,3
30160,değmez,0,0,3,3
26542,यूट्यूब,0,0,3,3
8819,alimentare,1,3,0,3
8415,conosco,1,3,0,3
8488,conferenze,1,3,0,3
26506,जाम,0,0,3,3
26508,oldukça,0,0,3,3
8484,norma,2,2,1,3
8483,perry,2,1,2,3
8480,cavaliere,1,3,0,3
30166,உதாரணம்,0,0,3,3
34681,seinen,0,0,3,3
38073,n’a,0,0,3,3
49337,ಒಳ್ಳೆಯ,0,0,3,3
26517,catégorie,0,0,3,3
38069,successfully,0,0,3,3
38064,tager,0,0,3,3
8442,superficiale,1,3,0,3
8433,jefferson,2,1,2,3
8429,sensibilità,1,3,0,3
49353,distintas,0,0,3,3
8424,bokmål,2,1,2,3
8421,impresa,2,1,2,3
8418,giornalismo,1,3,0,3
31773,probability,0,0,3,3
26597,доступны,0,0,3,3
2201,basti,1,3,0,3
38028,ಮುಂದೆ,0,0,3,3
3544,tropenmuseum,2,1,2,3
2244,tampa,2,1,2,3
2245,diffuse,2,2,1,3
37973,طريق,0,0,3,3
37967,mundial,0,0,3,3
8204,filtro,2,2,1,3
37963,resolver,0,0,3,3
26709,remainder,0,0,3,3
4098,espansione,1,3,0,3
37953,ನಾಳೆ,0,0,3,3
2254,veicoli,1,3,0,3
37952,coolt,0,0,3,3
37949,gehad,0,0,3,3
8180,paradosso,1,3,0,3
8173,partecipanti,1,3,0,3
26736,leve,0,0,3,3
49450,entire,0,0,3,3
49456,планы,0,0,3,3
26746,അല്ലെങ്കിൽ‌,0,0,3,3
2259,riferiscono,1,3,0,3
37926,عرض,0,0,3,3
26754,put,0,0,3,3
37978,trevliga,0,0,3,3
8234,appartiene,1,3,0,3
49428,beschweren,0,0,3,3
8288,provenienza,1,3,0,3
51822,herramientas,0,0,3,3
49393,móvel,0,0,3,3
8321,pnina,2,1,2,3
2207,simpatici,1,3,0,3
34701,atual,0,0,3,3
26630,harcèlement,0,0,3,3
26634,characters,0,0,3,3
8300,brutto,1,3,0,3
2215,interrompendo,2,2,1,3
8286,diverso,1,3,0,3
49427,boas,0,0,3,3
26644,دخلت,0,0,3,3
26645,entrées,0,0,3,3
8266,teorica,1,3,0,3
49418,πόσο,0,0,3,3
2232,spinge,1,3,0,3
26668,tells,0,0,3,3
31729,gorillas,0,0,3,3
8243,sezioni,1,3,0,3
37980,petite,0,0,3,3
38076,encuentro,0,0,3,3
31789,söka,0,0,3,3
51841,άντρας,0,0,3,3
49271,collected,0,0,3,3
38193,घटनाओं,0,0,3,3
8715,traguardo,1,3,0,3
49242,kelimeden,0,0,3,3
26315,μέση,0,0,3,3
26325,toll,0,0,3,3
8687,comprare,1,3,0,3
8685,micro,2,1,2,3
8684,requisiti,1,3,0,3
49252,langsomt,0,0,3,3
26349,explains,0,0,3,3
38168,hört,0,0,3,3
2096,derivate,1,3,0,3
26358,мои,0,0,3,3
34640,oui,0,0,3,3
49260,അടുത്തേക്ക്,0,0,3,3
26365,escala,0,0,3,3
2101,modificati,1,3,0,3
8657,lasciando,1,3,0,3
26371,vergelijking,0,0,3,3
49266,carefully,0,0,3,3
26374,never,0,0,3,3
34632,aqueles,0,0,3,3
38208,பார்த்துக்,0,0,3,3
8725,giochi,1,3,0,3
34613,olma,0,0,3,3
2048,spiegazione,1,3,0,3
26203,кто,0,0,3,3
2049,inferenza,1,3,0,3
8811,pakistan,2,1,2,3
26220,durumda,0,0,3,3
2057,smussato,1,3,0,3
8784,purtroppo,1,3,0,3
49218,أيضا,0,0,3,3
38247,annulations,0,0,3,3
4066,classiche,1,3,0,3
31871,دعني,0,0,3,3
49224,पोर्टल,0,0,3,3
31884,webbläsare,0,0,3,3
8753,incontrato,1,3,0,3
8752,cane,1,3,0,3
2072,maometto,1,3,0,3
31882,моем,0,0,3,3
8746,discute,2,2,1,3
38215,olduğu,0,0,3,3
8732,improvvisamente,1,3,0,3
31843,системы,0,0,3,3
38152,अत्याचार,0,0,3,3
26501,réunion,0,0,3,3
35726,sons,0,0,3,3
26468,ಮುಂದುವರಿಯಿರಿ,0,0,3,3
51060,cambió,0,0,3,3
34665,speed,0,0,3,3
26478,समकक्ष,0,0,3,3
8535,parlamentare,1,3,0,3
49315,образом,0,0,3,3
26482,ಸೌಂದರ್ಯವನ್ನು,0,0,3,3
8531,swartz,2,1,2,3
26487,vijf,0,0,3,3
31808,ಸಂಭಾಷಣೆಯಲ್ಲಿ,0,0,3,3
31803,hé,0,0,3,3
51845,ekstra,0,0,3,3
49318,semelhante,0,0,3,3
49319,kullanmak,0,0,3,3
49320,dijo,0,0,3,3
26493,gift,0,0,3,3
8503,assegnati,1,3,0,3
38080,klage,0,0,3,3
2158,compresi,1,3,0,3
26500,माफ,0,0,3,3
8499,rilevanti,1,3,0,3
8551,evidenziato,1,3,0,3
8554,generati,1,3,0,3
49307,sannolikt,0,0,3,3
38126,örnekleri,0,0,3,3
38136,പറഞ്ഞാൽ,0,0,3,3
2110,titano,1,3,0,3
4072,kimmel,2,1,2,3
8619,tendenze,1,3,0,3
26412,vient,0,0,3,3
8617,markov,2,2,1,3
8609,dando,2,1,2,3
8608,teorie,1,3,0,3
2114,commesso,1,3,0,3
2117,h,2,1,2,3
34659,ещё,0,0,3,3
8597,short,2,1,2,3
51862,aman,0,0,3,3
31829,pengar,0,0,3,3
2125,pronunciare,1,3,0,3
17172,goldene,0,0,3,3
8583,inserite,1,3,0,3
8576,leggermente,1,3,0,3
4074,rispettare,1,3,0,3
34655,düzeltme,0,0,3,3
51645,abonnieren,0,0,3,3
6955,memorizzate,1,3,0,3
6952,antico,1,3,0,3
5191,clarke,2,1,2,3
36303,φαινόταν,0,0,3,3
5187,sosteneva,1,3,0,3
30866,observable,0,0,3,3
30865,automatisch,0,0,3,3
5179,cambiare,1,3,0,3
4248,abbigliamento,1,3,0,3
36293,zaterdag,0,0,3,3
3215,henry,2,1,2,3
29292,uden,0,0,3,3
36289,பதிவு,0,0,3,3
5169,designa,1,3,0,3
5167,parodia,2,2,1,3
5159,parigi,1,3,0,3
5158,castello,1,3,0,3
5156,useresti,1,3,0,3
5153,sedeva,1,3,0,3
5152,scusi,1,3,0,3
36266,фразу,0,0,3,3
29326,الويب,0,0,3,3
50654,penge,0,0,3,3
5135,mando,1,3,0,3
36306,deuxième,0,0,3,3
30870,लाभ,0,0,3,3
5272,practices,2,1,2,3
36310,bloggar,0,0,3,3
35268,الموسوعة،,0,0,3,3
5257,nodi,1,3,0,3
5254,racconta,1,3,0,3
5253,redazione,1,3,0,3
5251,minaccia,1,3,0,3
36329,vandaag,0,0,3,3
5246,cox,2,1,2,3
50616,aktualitet,0,0,3,3
5242,ideologia,1,3,0,3
5235,osservabile,1,3,0,3
5231,tempestosa,1,3,0,3
5228,modificarlo,1,3,0,3
3197,stabile,1,3,0,3
4243,estremi,1,3,0,3
50623,ലഭ്യമായ,0,0,3,3
30882,أحدهم,0,0,3,3
51412,correspondiente,0,0,3,3
5203,averlo,1,3,0,3
5202,wrestling,1,3,0,3
5201,etimologicamente,1,3,0,3
51288,criticou,0,0,3,3
51395,transform,0,0,3,3
35296,hende,0,0,3,3
5122,eccezionalmente,1,3,0,3
3233,disco,2,2,1,3
36220,சொன்னேன்,0,0,3,3
3261,etichettare,1,3,0,3
3262,encyclopaedia,2,1,2,3
5026,considerazione,1,3,0,3
5024,limite,2,1,2,3
5022,col,1,3,0,3
50693,traitement,0,0,3,3
36219,ومن,0,0,3,3
29402,provient,0,0,3,3
3267,sottolinea,1,3,0,3
29404,lyttede,0,0,3,3
36210,व्यस्त,0,0,3,3
29408,другое,0,0,3,3
29414,fuentes,0,0,3,3
4999,aggiunte,1,3,0,3
4995,lettera,1,3,0,3
29418,neurales,0,0,3,3
50710,सहायता,0,0,3,3
4980,dimostra,1,3,0,3
50711,kritiserats,0,0,3,3
4978,attraversò,1,3,0,3
36221,संस्कृति,0,0,3,3
5034,sappi,1,3,0,3
29389,llorando,0,0,3,3
5082,directory,1,3,0,3
5111,caballero,2,1,2,3
5109,sparsa,1,3,0,3
5103,permettono,1,3,0,3
5097,cipolla,1,3,0,3
3240,gelato,1,3,0,3
29351,criteria,0,0,3,3
5090,chiamano,1,3,0,3
5086,respirare,1,3,0,3
51387,covers,0,0,3,3
30838,cultural,0,0,3,3
5037,logoramento,1,3,0,3
5070,lavorativa,1,3,0,3
36236,pontuação,0,0,3,3
5065,canada,2,2,1,3
30835,боже,0,0,3,3
5063,acquisizione,1,3,0,3
5049,blog,2,2,1,3
29992,ഇവരെ,0,0,3,3
5045,pesci,1,3,0,3
5039,veridicità,1,3,0,3
50992,melhores,0,0,3,3
29206,konu,0,0,3,3
6951,sostantivo,1,3,0,3
36480,எல்லா,0,0,3,3
5510,efficacemente,1,3,0,3
35230,δοκιμάστε,0,0,3,3
5502,cooperazione,1,3,0,3
36473,extended,0,0,3,3
5492,diagrammi,1,3,0,3
5487,visivo,1,3,0,3
36463,abonnement,0,0,3,3
29023,serves,0,0,3,3
3126,cammina,1,3,0,3
30950,parecia,0,0,3,3
3505,vettori,1,3,0,3
29046,nommée,0,0,3,3
5449,espandere,1,3,0,3
36445,suggested,0,0,3,3
5444,visualizzare,1,3,0,3
29065,θεέ,0,0,3,3
30937,devido,0,0,3,3
50534,ton,0,0,3,3
35240,existencia,0,0,3,3
36438,« la,0,0,3,3
5422,distinti,1,3,0,3
51451,establecidas,0,0,3,3
5518,opposto,1,3,0,3
50602,opgericht,0,0,3,3
5522,vite,2,2,1,3
3087,commerciali,1,3,0,3
28907,ur,0,0,3,3
5600,abito,1,3,0,3
36538,متطوعين,0,0,3,3
36537,ämnet,0,0,3,3
5590,settimo,1,3,0,3
28922,लगाने,0,0,3,3
5585,libertine,2,1,2,3
5581,cowen,2,1,2,3
5580,x,2,1,2,3
4218,andasse,1,3,0,3
5573,notizia,1,3,0,3
28938,photographic,0,0,3,3
5567,eccoti,1,3,0,3
5566,entrò,1,3,0,3
36513,visste,0,0,3,3
30623,operations,0,0,3,3
3100,scrive,1,3,0,3
3106,falsità,1,3,0,3
3107,decrescente,1,3,0,3
4222,appresa,1,3,0,3
29077,فهي,0,0,3,3
36430,menées,0,0,3,3
36428,предложения,0,0,3,3
5410,confine,2,2,1,3
50581,harassment,0,0,3,3
5325,eliminazione,1,3,0,3
50583,kontroversiella,0,0,3,3
3169,acquisito,1,3,0,3
50587,शब्दकोष,0,0,3,3
50588,seviyorum,0,0,3,3
35255,estudos,0,0,3,3
5310,sessuale,1,3,0,3
35816,कड़ी,0,0,3,3
5305,mandare,1,3,0,3
51423,permission,0,0,3,3
5299,pertinenza,1,3,0,3
35818,rocker,0,0,3,3
5296,battlestar,2,1,2,3
51422,commun,0,0,3,3
5294,consultabili,1,3,0,3
29195,será,0,0,3,3
5290,culto,2,1,2,3
35265,género,0,0,3,3
35819,говорил,0,0,3,3
29197,culturais,0,0,3,3
3503,piacessero,1,3,0,3
36388,orthographe,0,0,3,3
5345,flore,2,2,1,3
5374,sensori,1,3,0,3
5401,sporco,1,3,0,3
36421,prediction,0,0,3,3
5398,designare,1,3,0,3
30928,devenues,0,0,3,3
50550,söyleyebilir,0,0,3,3
5393,sorrisi,1,3,0,3
30923,liberdade,0,0,3,3
36410,balansen,0,0,3,3
29110,खराब,0,0,3,3
36403,volonté,0,0,3,3
5348,gestire,1,3,0,3
5369,finanziata,1,3,0,3
35440,amélioration,0,0,3,3
29125,пришли,0,0,3,3
5361,contribuiscono,1,3,0,3
35247,travlt,0,0,3,3
5358,collegehumor,2,1,2,3
3163,tutela,1,3,0,3
5354,allenamento,1,3,0,3
29143,dilde,0,0,3,3
29448,варенье,0,0,3,3
50717,étais,0,0,3,3
4960,progettato,1,3,0,3
4278,sollevato,1,3,0,3
35394,പോകുന്നു,0,0,3,3
4522,scientifici,1,3,0,3
35982,мотивации,0,0,3,3
29783,atividades,0,0,3,3
50892,ecology,0,0,3,3
4509,incredibilmente,1,3,0,3
4503,riporta,1,3,0,3
4494,classificata,1,3,0,3
4492,hudong,2,1,2,3
3433,infelice,1,3,0,3
29799,fréquemment,0,0,3,3
4479,recupero,1,3,0,3
4477,saranno,1,3,0,3
4476,malattie,1,3,0,3
4474,ereditato,1,3,0,3
4473,studiati,1,3,0,3
35960,используют,0,0,3,3
35954,أصدقائك,0,0,3,3
35952,läsarna,0,0,3,3
4460,vede,1,3,0,3
4459,sposarmi,1,3,0,3
3419,credenze,1,3,0,3
29757,давно,0,0,3,3
30807,subscribe,0,0,3,3
4543,volontariamente,1,3,0,3
29721,capaz,0,0,3,3
4274,volumi,1,3,0,3
4595,ristorante,1,3,0,3
50974,кроме,0,0,3,3
4591,cittadini,1,3,0,3
4587,blodget,2,1,2,3
4586,carta,2,2,1,3
30710,использую,0,0,3,3
29734,источниках,0,0,3,3
50869,robots,0,0,3,3
4575,soddisfare,1,3,0,3
4574,risposto,1,3,0,3
4570,potuto,1,3,0,3
3404,simbolici,1,3,0,3
29743,casamento,0,0,3,3
3407,prendessi,1,3,0,3
30702,løsning,0,0,3,3
30701,തമ്മിൽ,0,0,3,3
36001,repetidas,0,0,3,3
4554,esecuzione,1,3,0,3
4551,chiaro,1,3,0,3
30675,தானியங்கிகள்,0,0,3,3
35408,extrêmement,0,0,3,3
29826,ontwikkeling,0,0,3,3
4450,meritare,1,3,0,3
29965,konversationen,0,0,3,3
3474,arias,2,1,2,3
50934,हार्वर्ड,0,0,3,3
4362,sorridere,1,3,0,3
4357,cuocere,1,3,0,3
30643,ner,0,0,3,3
4351,legati,1,3,0,3
4349,riescono,1,3,0,3
4344,visitato,1,3,0,3
4343,mette,1,3,0,3
29914,experto,0,0,3,3
4338,galactica,2,1,2,3
4333,costretto,1,3,0,3
30639,εμένα,0,0,3,3
4326,coprivano,1,3,0,3
35868,नरसीसा,0,0,3,3
35867,humain,0,0,3,3
29945,ದೊಡ್ಡ,0,0,3,3
4310,stime,1,3,0,3
35863,lå,0,0,3,3
29957,அடிக்கடி,0,0,3,3
3470,truppe,1,3,0,3
35901,கொண்ட,0,0,3,3
35429,extent,0,0,3,3
35414,acımasız,0,0,3,3
35945,सहित,0,0,3,3
29828,value,0,0,3,3
3447,separa,1,3,0,3
3448,rilasciata,1,3,0,3
4430,rotto,1,3,0,3
29843,administratörerna,0,0,3,3
35932,നിങ്ങൾക്കറിയില്ല,0,0,3,3
35930,lag,0,0,3,3
50913,explosion,0,0,3,3
50919,сайта,0,0,3,3
29887,റോന്ദേവൂ,0,0,3,3
4414,accadendo,1,3,0,3
35417,annesi,0,0,3,3
29862,miriam,0,0,3,3
35418,சவாரி,0,0,3,3
3460,giornali,1,3,0,3
35913,gentils,0,0,3,3
4399,rilevati,1,3,0,3
4394,integrante,1,3,0,3
4384,indirizzo,1,3,0,3
36016,baseada,0,0,3,3
3389,viaggi,1,3,0,3
29708,considerada,0,0,3,3
36101,επιπλέον,0,0,3,3
29520,करो,0,0,3,3
50758,ஏதேனும்,0,0,3,3
36133,ಏನೂ,0,0,3,3
4837,spaventato,1,3,0,3
50762,nivel,0,0,3,3
30779,جدية,0,0,3,3
4834,epoca,1,3,0,3
29538,posição,0,0,3,3
29542,uk,0,0,3,3
36128,وليس,0,0,3,3
50767,recomponha,0,0,3,3
36124,fome,0,0,3,3
51348,χρήματα,0,0,3,3
4815,vorrebbe,1,3,0,3
30770,विकिबुक्स,0,0,3,3
36116,stoor,0,0,3,3
3492,stargli,1,3,0,3
4804,vasta,1,3,0,3
3334,bioinformatica,1,3,0,3
3490,rights,2,1,2,3
29564,தமிழ்,0,0,3,3
29519,digits,0,0,3,3
4859,greca,1,3,0,3
36143,déplacer,0,0,3,3
4923,autoctona,1,3,0,3
36176,работал,0,0,3,3
29462,равно,0,0,3,3
50727,kjole,0,0,3,3
3289,addetti,1,3,0,3
29463,belangrijk,0,0,3,3
29468,junio,0,0,3,3
4937,glielo,1,3,0,3
4935,ricompensa,1,3,0,3
36167,américain,0,0,3,3
30803,وتقول,0,0,3,3
29517,eliminan,0,0,3,3
50735,marque,0,0,3,3
4914,guardarla,1,3,0,3
4260,confermare,1,3,0,3
4889,coperti,1,3,0,3
36148,запущенным,0,0,3,3
4878,tante,1,3,0,3
4874,divino,1,3,0,3
3495,varia,2,2,1,3
29515,എഴുതുന്ന,0,0,3,3
29569,λένε,0,0,3,3
4776,logistica,1,3,0,3
3388,fianco,1,3,0,3
50789,semble,0,0,3,3
29645,sidor,0,0,3,3
36063,chino,0,0,3,3
4673,freddo,1,3,0,3
3372,unicamente,1,3,0,3
30732,भ्रमित,0,0,3,3
29656,عديدة,0,0,3,3
4661,esisteva,1,3,0,3
4660,sognato,1,3,0,3
4657,quarto,1,3,0,3
50844,τραβήξτε,0,0,3,3
29681,журналов,0,0,3,3
4639,spezzato,1,3,0,3
29683,améliorer,0,0,3,3
4635,rank,2,1,2,3
36036,συμβουλή,0,0,3,3
36027,representing,0,0,3,3
4619,offrirti,1,3,0,3
35851,vinden,0,0,3,3
4614,chiedo,1,3,0,3
4612,marketing,2,2,1,3
4611,rocciose,1,3,0,3
4693,bayesiane,1,3,0,3
29636,lyde,0,0,3,3
4703,spiegare,1,3,0,3
4743,raramente,2,2,1,3
3341,nient,1,3,0,3
35350,powers,0,0,3,3
4769,accetta,1,3,0,3
35351,licens,0,0,3,3
3344,bacino,1,3,0,3
29586,οξεία,0,0,3,3
4759,fortunata,1,3,0,3
4754,manifesta,1,3,0,3
4751,gamma,1,3,0,3
4742,divano,1,3,0,3
3362,rumore,1,3,0,3
3350,crossover,2,2,1,3
50800,buscador,0,0,3,3
35353,utiles,0,0,3,3
35354,hjärtat,0,0,3,3
3356,otterrai,1,3,0,3
35357,synonyme,0,0,3,3
4717,istanza,1,3,0,3
29622,högst,0,0,3,3
4707,nato,1,3,0,3
5608,organizzato,1,3,0,3
28895,κανάλι,0,0,3,3
50450,dourado,0,0,3,3
6511,preprocessing,2,1,2,3
28107,actuellement,0,0,3,3
28110,nå,0,0,3,3
2810,aziendali,1,3,0,3
6500,salì,1,3,0,3
6498,organizzati,1,3,0,3
37042,officielle,0,0,3,3
6491,contrariamente,1,3,0,3
6487,specifiche,1,3,0,3
28125,ettiğim,0,0,3,3
6481,profondamente,1,3,0,3
28130,l’enseignement,0,0,3,3
28132,கடினமாக,0,0,3,3
31213,две,0,0,3,3
37033,chefredaktör,0,0,3,3
6464,fotografia,2,2,1,3
6463,neurone,1,3,0,3
28142,выходные,0,0,3,3
51581,verdad,0,0,3,3
37028,encompasses,0,0,3,3
6446,tavola,1,3,0,3
28149,accept,0,0,3,3
2808,usiamo,1,3,0,3
28103,rubis,0,0,3,3
3528,supponiamo,1,3,0,3
2806,fermarti,1,3,0,3
2783,gestisce,1,3,0,3
6580,impareremo,1,3,0,3
50045,afbeeldingen,0,0,3,3
2786,minima,1,3,0,3
28059,wetenschappelijke,0,0,3,3
30089,ലേഖനങ്ങളിൽ,0,0,3,3
6565,sufficiente,1,3,0,3
6564,inventata,1,3,0,3
6563,nozioni,1,3,0,3
2788,sonno,1,3,0,3
31237,हों।,0,0,3,3
35040,sets,0,0,3,3
2795,venga,2,2,1,3
6543,star,2,1,2,3
28083,cumartesi,0,0,3,3
50058,received,0,0,3,3
6531,diamanti,1,3,0,3
28094,أحدث,0,0,3,3
6529,communications,2,1,2,3
37054,henne,0,0,3,3
2804,passati,1,3,0,3
37024,collective,0,0,3,3
2823,saluti,1,3,0,3
37016,prática,0,0,3,3
6431,raccontato,1,3,0,3
36949,νάρκισσος,0,0,3,3
6338,decenni,1,3,0,3
35085,confused,0,0,3,3
6326,evoluta,1,3,0,3
50151,م,0,0,3,3
3530,businessweek,2,2,1,3
28279,பிரமாதமானது,0,0,3,3
2864,naso,1,3,0,3
28286,hoofdredacteur,0,0,3,3
50157,أستخدمها,0,0,3,3
2868,vecchia,1,3,0,3
50160,பேச,0,0,3,3
36930,bilgilerin,0,0,3,3
28295,longterm,0,0,3,3
6288,carceri,1,3,0,3
35099,قائمة,0,0,3,3
6284,nemmeno,1,3,0,3
28302,assistindo,0,0,3,3
28303,конце,0,0,3,3
50170,திருமணம்,0,0,3,3
51021,campaña,0,0,3,3
6350,relazione,1,3,0,3
28244,முடிவில்,0,0,3,3
28243,hablando,0,0,3,3
28195,völlig,0,0,3,3
2834,yaacov,2,1,2,3
50106,additional,0,0,3,3
50111,aparte,0,0,3,3
28186,vão,0,0,3,3
36996,—y,0,0,3,3
6406,feifei,2,1,2,3
6403,affiliati,1,3,0,3
31195,jantar,0,0,3,3
6400,annullamento,1,3,0,3
31189,learner,0,0,3,3
36961,المتحدة,0,0,3,3
28216,svårt,0,0,3,3
28221,march,0,0,3,3
6371,shachaf,2,1,2,3
31188,allumé,0,0,3,3
36972,relativement,0,0,3,3
6366,considerare,1,3,0,3
36967,développe,0,0,3,3
30077,ഓൺ‌ലൈൻ,0,0,3,3
6359,roccia,1,3,0,3
35774,autour,0,0,3,3
50037,ಅಪ್ರಸ್ತುತವಾಗುತ್ತದೆ,0,0,3,3
35037,lançado,0,0,3,3
27898,nou,0,0,3,3
6843,occasioni,1,3,0,3
6842,affari,1,3,0,3
6841,esci,1,3,0,3
51629,característica,0,0,3,3
27839,أليس,0,0,3,3
27841,miyim,0,0,3,3
2704,comprerei,1,3,0,3
6830,mangi,1,3,0,3
27851,எடுத்துக்,0,0,3,3
37202,kanaal,0,0,3,3
27857,ಟದ,0,0,3,3
6815,collegio,1,3,0,3
27864,cobertos,0,0,3,3
27870,सितम्बर,0,0,3,3
6798,interattiva,1,3,0,3
6797,vederti,1,3,0,3
6795,dibattute,1,3,0,3
37190,материалов,0,0,3,3
6789,abbiamo,1,3,0,3
31309,بطلاقة,0,0,3,3
31301,собственном,0,0,3,3
27835,currently,0,0,3,3
6850,cambiata,1,3,0,3
6859,occorrenze,1,3,0,3
27792,october,0,0,3,3
31371,tillgång,0,0,3,3
6941,umile,1,3,0,3
6935,knowledgebased,2,2,1,3
6930,sembri,1,3,0,3
31356,него,0,0,3,3
27789,نارسسا,0,0,3,3
51638,wikiwand,0,0,3,3
2682,piange,1,3,0,3
51636,плакать,0,0,3,3
6907,costi,1,3,0,3
31338,delas,0,0,3,3
6906,reazione,1,3,0,3
2686,navigare,1,3,0,3
6896,comportamenti,1,3,0,3
27804,amerikanen,0,0,3,3
27808,composition,0,0,3,3
27809,وقد,0,0,3,3
49929,filtros,0,0,3,3
6880,guardarono,1,3,0,3
6873,vestiti,1,3,0,3
49967,النهاية,0,0,3,3
49974,vaste,0,0,3,3
28036,voice,0,0,3,3
31286,similarly,0,0,3,3
2761,copie,2,1,2,3
27992,levou,0,0,3,3
50016,soucis,0,0,3,3
6651,fisiche,1,3,0,3
37109,مصدر,0,0,3,3
28005,sizin,0,0,3,3
37103,kvalitet,0,0,3,3
30096,anything,0,0,3,3
31250,ഉള്ളടക്കം,0,0,3,3
2769,ghiaccio,1,3,0,3
35035,आ,0,0,3,3
6626,combattere,1,3,0,3
28027,redo,0,0,3,3
6620,diteci,1,3,0,3
2774,consentito,1,3,0,3
6617,dizionari,1,3,0,3
6616,fammelo,1,3,0,3
6615,blocca,1,3,0,3
37093,espaces,0,0,3,3
2776,passata,1,3,0,3
2779,individuare,1,3,0,3
6659,esercitati,1,3,0,3
2758,rami,1,3,0,3
6677,specializzate,1,3,0,3
49994,ಯೋಜನೆಗಳನ್ನು,0,0,3,3
2729,cartacea,1,3,0,3
6753,cadere,1,3,0,3
6751,entrate,1,3,0,3
27923,try,0,0,3,3
2732,infantile,1,3,0,3
6730,salutarono,1,3,0,3
6727,offerte,1,3,0,3
6722,fini,2,1,2,3
6721,rendi,1,3,0,3
37145,mobiltelefoner,0,0,3,3
27960,पड़ता,0,0,3,3
6706,velocemente,1,3,0,3
4153,segretamente,1,3,0,3
37143,forskning,0,0,3,3
27949,മിക്കവാറും,0,0,3,3
6694,brockhaus,2,2,1,3
6693,studiano,1,3,0,3
2751,letture,1,3,0,3
27956,görs,0,0,3,3
27957,утверждал,0,0,3,3
2876,manager,2,2,1,3
6261,benvenuti,1,3,0,3
4216,mantengono,1,3,0,3
5854,ammetti,1,3,0,3
35805,кнопку,0,0,3,3
28663,மரியன்,0,0,3,3
3028,verificato,1,3,0,3
28668,oraciones,0,0,3,3
5835,espressa,1,3,0,3
30045,bununla,0,0,3,3
5831,legami,1,3,0,3
36698,கொள்க,0,0,3,3
36697,मन,0,0,3,3
5827,dedica,2,1,2,3
28678,angel,0,0,3,3
35179,प्रतिपादन,0,0,3,3
5823,pubblicamente,1,3,0,3
36689,εκείνη,0,0,3,3
28693,еда,0,0,3,3
28697,ouvert,0,0,3,3
5808,riprodurre,1,3,0,3
5804,progettazione,1,3,0,3
5803,elettorale,1,3,0,3
28703,результаты,0,0,3,3
28714,puan,0,0,3,3
5852,km,2,2,1,3
50355,planeta,0,0,3,3
6260,dubbio,1,3,0,3
31029,escribir,0,0,3,3
5918,supervisionati,1,3,0,3
5911,benvenuto,1,3,0,3
35164,characteristics,0,0,3,3
50332,политики,0,0,3,3
5899,guidato,1,3,0,3
5897,effettivamente,1,3,0,3
36722,خبز,0,0,3,3
36721,exakt,0,0,3,3
3010,informatico,1,3,0,3
28635,состоянию,0,0,3,3
3011,documentario,1,3,0,3
5887,consegnato,1,3,0,3
5886,registrano,1,3,0,3
36720,machst,0,0,3,3
30615,nadat,0,0,3,3
5880,newsletter,2,2,1,3
50346,money,0,0,3,3
3019,vanderbilt,2,1,2,3
36716,hören,0,0,3,3
50350,negotiation,0,0,3,3
5861,smetti,1,3,0,3
28715,bisschen,0,0,3,3
28719,അധികം,0,0,3,3
36661,θυμωμένος,0,0,3,3
5789,naturalmente,2,2,1,3
3067,stagno,1,3,0,3
35198,émissions,0,0,3,3
5708,xx,2,1,2,3
28794,tras,0,0,3,3
5701,croato,1,3,0,3
28797,americans,0,0,3,3
3075,eo,1,3,0,3
28818,bak,0,0,3,3
28825,şeyin,0,0,3,3
50425,thème,0,0,3,3
5669,aiutato,1,3,0,3
28853,ശ്രദ്ധിച്ചില്ല,0,0,3,3
36574,amounts,0,0,3,3
36569,pairs,0,0,3,3
28870,buitengewoon,0,0,3,3
50439,പേര്,0,0,3,3
5639,leo,2,2,1,3
36563,الجديدة,0,0,3,3
5630,cartaceo,1,3,0,3
36562,neuron,0,0,3,3
5624,autobus,1,3,0,3
5712,desiderio,1,3,0,3
50410,production,0,0,3,3
5714,ossigeno,1,3,0,3
50392,മാർഗമാണ്,0,0,3,3
5787,intesa,1,3,0,3
36657,ಕೊನೆಯ,0,0,3,3
36655,beschreiben,0,0,3,3
36654,gruwelijke,0,0,3,3
36653,précise,0,0,3,3
5781,discrete,2,1,2,3
51004,सीखने,0,0,3,3
28740,güzelliği,0,0,3,3
50391,geschreven,0,0,3,3
5766,paritaria,1,3,0,3
3063,passaggi,1,3,0,3
30044,dicen,0,0,3,3
35446,fyra,0,0,3,3
36634,ಕುರಿತು,0,0,3,3
35194,φαγητά,0,0,3,3
30041,ಫಿಕ್ಸ್‌ನಲ್ಲಿದ್ದೇನೆ,0,0,3,3
36628,olá,0,0,3,3
50405,yes,0,0,3,3
5733,affondare,1,3,0,3
5726,avveri,1,3,0,3
36735,दोहरान,0,0,3,3
5929,incontri,1,3,0,3
50318,सप्ताहांत,0,0,3,3
6091,definitivamente,1,3,0,3
31126,ängeln,0,0,3,3
31124,busca,0,0,3,3
28427,instellingen,0,0,3,3
6147,rivelare,1,3,0,3
6145,potesse,1,3,0,3
36841,التخريب،,0,0,3,3
6138,balcone,1,3,0,3
28446,सुंदरता,0,0,3,3
50236,κοίταξε,0,0,3,3
6128,sfide,1,3,0,3
28448,extremely,0,0,3,3
6114,accettato,1,3,0,3
6113,metri,1,3,0,3
50243,wollen,0,0,3,3
31114,pesquisadores,0,0,3,3
6104,afi,2,2,1,3
31112,schrecklich,0,0,3,3
6101,incongruenze,1,3,0,3
36825,tipset,0,0,3,3
51532,تعديلات,0,0,3,3
28465,αγαπητέ,0,0,3,3
50217,écrire,0,0,3,3
31129,കുറഞ്ഞ,0,0,3,3
2914,passarmi,1,3,0,3
6201,circa milioni,1,3,0,3
28331,ocak,0,0,3,3
36897,അർത്ഥമാക്കുന്നത്,0,0,3,3
28349,juridique,0,0,3,3
51551,bidrar,0,0,3,3
6227,singoli,1,3,0,3
50193,normalt,0,0,3,3
6217,aaron,2,1,2,3
36884,textes,0,0,3,3
6210,immanente,2,2,1,3
28392,некоторым,0,0,3,3
6172,termica,1,3,0,3
2909,biomassa,1,3,0,3
6188,viaggiando,1,3,0,3
36867,fora,0,0,3,3
28399,ಚಿನ್ನದಿಂದ,0,0,3,3
6182,settimane,1,3,0,3
51543,editörlerin,0,0,3,3
6177,credenza,1,3,0,3
6174,fattibile,1,3,0,3
2912,cancellando,1,3,0,3
50248,оно,0,0,3,3
4185,maniere,1,3,0,3
35162,நீண்ட,0,0,3,3
28473,somme,0,0,3,3
50292,advertising,0,0,3,3
28557,upptagen,0,0,3,3
5987,ragioni,1,3,0,3
5985,tentano,1,3,0,3
50296,दोपहर,0,0,3,3
5981,scelte,1,3,0,3
5980,sinonimo,1,3,0,3
28565,يسمى,0,0,3,3
5976,trascinare,1,3,0,3
5974,importasse,2,2,1,3
28572,محتويات,0,0,3,3
5959,piacevole,1,3,0,3
5956,prigionieri,1,3,0,3
31060,விக்கிப்பீடியாவில்,0,0,3,3
36742,amateur,0,0,3,3
5943,ideatori,1,3,0,3
5940,quarta,2,2,1,3
31052,ஒருவருக்கு,0,0,3,3
35160,கொஞ்சம்,0,0,3,3
28604,graus,0,0,3,3
28606,apporter,0,0,3,3
35144,respect,0,0,3,3
5996,prevede,1,3,0,3
4194,crossbar,2,1,2,3
36789,വിക്കി,0,0,3,3
6075,siciliano,2,2,1,3
28482,studenten,0,0,3,3
6069,magici,1,3,0,3
2955,avviato,1,3,0,3
28491,ആരോടെങ്കിലും,0,0,3,3
28492,صفحات,0,0,3,3
50263,lhe,0,0,3,3
2961,mutazione,1,3,0,3
4189,ingegneria,1,3,0,3
28523,biased,0,0,3,3
50287,komma,0,0,3,3
51517,ситуацию,0,0,3,3
3522,riportati,1,3,0,3
51012,«wikipedia»,0,0,3,3
6018,materialiste,1,3,0,3
50280,uppfyllelse,0,0,3,3
2971,assumerti,1,3,0,3
35140,dinheiro,0,0,3,3
28543,steadily,0,0,3,3
6003,contenere,1,3,0,3
9476,bad,2,1,2,3
26434,glaciers,0,0,3,3
25127,age,0,0,3,3
24370,contribution,0,0,3,3
48768,allow,0,0,3,3
38776,ആളുകൾ,0,0,3,3
48483,değişiklik,0,0,3,3
24384,studenterna,0,0,3,3
23995,объектами,0,0,3,3
1653,pierre,2,1,2,3
52006,ниже,0,0,3,3
3561,tv,2,2,1,3
24003,свидание,0,0,3,3
10660,sürümü,0,0,3,3
9807,गए।,0,0,3,3
32267, مليون,0,0,3,3
10679,تناول,0,0,3,3
39429,اسم,0,0,3,3
52041,licentie,0,0,3,3
48488,outil,0,0,3,3
9811,abaixo,0,0,3,3
48209,lyder,0,0,3,3
25374,frecuentemente,0,0,3,3
32203,asturias,0,0,3,3
24010,wist,0,0,3,3
1485,ospitano,1,3,0,3
39131,வீடியோ,0,0,3,3
47969,científico,0,0,3,3
48779,φράσης,0,0,3,3
48230,decisão,0,0,3,3
23982,işi,0,0,3,3
10652,hyperliens,0,0,3,3
11039,facilement,0,0,3,3
39130,ihn,0,0,3,3
24818,ഉപയോക്താക്കൾക്ക്,0,0,3,3
1557,viste,1,3,0,3
38770,लेरी,0,0,3,3
10269,economics,0,0,3,3
1751,renderà,1,3,0,3
10266,возьми,0,0,3,3
1649,organizzata,1,3,0,3
24836,respecto,0,0,3,3
39412,ಕೆಳಗೆ,0,0,3,3
35658,mayo,0,0,3,3
10247,investigadores,0,0,3,3
47987,πηγαίνετε,0,0,3,3
9855,films,0,0,3,3
10224,الأطعمة,0,0,3,3
39645,cumplen,0,0,3,3
11002,alternativas,0,0,3,3
9838,зависимость,0,0,3,3
39644,abierto,0,0,3,3
24036,sections,0,0,3,3
25323,ήρθατε,0,0,3,3
38810,vilja,0,0,3,3
52038,लागू,0,0,3,3
38811,additionally,0,0,3,3
3963,economici,1,3,0,3
39636,नंबर,0,0,3,3
39630,encourage,0,0,3,3
24879,വിവാഹം,0,0,3,3
10991,bald,0,0,3,3
24343,தோழர்களே,0,0,3,3
3582,agenzia,1,3,0,3
24880,declaraciones,0,0,3,3
9849,скажите,0,0,3,3
10691,kızı,0,0,3,3
1550,bevanda,1,3,0,3
48755,व्यापक,0,0,3,3
24857,cabida,0,0,3,3
52114,ವಿದಾಯ,0,0,3,3
47989,αυτόν,0,0,3,3
9816,pratiques,0,0,3,3
32327,விஷயம்,0,0,3,3
9819,soru,0,0,3,3
9821,इन्टरनेट,0,0,3,3
11011,حسب,0,0,3,3
38792,общего,0,0,3,3
48747,buy,0,0,3,3
25331,взаимодействия,0,0,3,3
32117,φυσικά,0,0,3,3
32323,sparsely,0,0,3,3
48744,conflict,0,0,3,3
3562,povero,1,3,0,3
38800,låter,0,0,3,3
9832,ट्रेफिक,0,0,3,3
39101,ontving,0,0,3,3
24024,actúan,0,0,3,3
24408,græder,0,0,3,3
9772,കയറി,0,0,3,3
39395,estimates,0,0,3,3
11103,graden,0,0,3,3
38736,düzelme,0,0,3,3
1470,visite,2,2,1,3
38738,raise,0,0,3,3
11105,ajouter,0,0,3,3
10346,occupé,0,0,3,3
23906,utilización,0,0,3,3
39177,devenu,0,0,3,3
24745,sequences,0,0,3,3
24752,примеры,0,0,3,3
23904,रास्ता,0,0,3,3
39170,barnpornografi,0,0,3,3
47940,revisões,0,0,3,3
23917,βρίσκεται,0,0,3,3
11092,θέλει,0,0,3,3
10335,liées,0,0,3,3
38748,propres,0,0,3,3
48438,answers,0,0,3,3
48440,titan,0,0,3,3
11109,aquele,0,0,3,3
24735,universitaires,0,0,3,3
9767,counterproductive,0,0,3,3
25450,advertisements,0,0,3,3
10368,पर्याप्त,0,0,3,3
25463,gebeurt,0,0,3,3
38718,nuevos,0,0,3,3
23889,يستحق,0,0,3,3
1464,apportato,1,3,0,3
1467,separati,1,3,0,3
34389,supervisé,0,0,3,3
23899,അതൊരു,0,0,3,3
1776,inserimento,1,3,0,3
10358,ona,0,0,3,3
52048,लिया,0,0,3,3
39339,locais,0,0,3,3
30586,erro,0,0,3,3
39185,الحظ,0,0,3,3
24477,استمر,0,0,3,3
9709,chacune,0,0,3,3
39344,före,0,0,3,3
38732,automatiskt,0,0,3,3
24435,remercier,0,0,3,3
32351,комментариев,0,0,3,3
23926,pegar,0,0,3,3
39147,américa,0,0,3,3
32095,jongens,0,0,3,3
39692,sexuellt,0,0,3,3
11057,обучающей,0,0,3,3
24776,miljoner,0,0,3,3
48242,expert,0,0,3,3
9751,двое,0,0,3,3
48793,sesgo,0,0,3,3
10301,commencé,0,0,3,3
48239,vond,0,0,3,3
32211,εγκυκλοπαίδεια,0,0,3,3
48787,substantiv,0,0,3,3
11045,officiel,0,0,3,3
25396,coordenar,0,0,3,3
9764,bekymringer,0,0,3,3
39393,maken,0,0,3,3
24809,лучший,0,0,3,3
24810,consequence,0,0,3,3
39133,derece,0,0,3,3
23947,πρόβλημα,0,0,3,3
10633,believed,0,0,3,3
3960,danno,1,3,0,3
52043,ಅದೇ,0,0,3,3
9728,encyclopédies,0,0,3,3
39701,खींचते,0,0,3,3
30587,envoyer,0,0,3,3
32088,பொத்தானை,0,0,3,3
1565,migliorano,1,3,0,3
32209,reveal,0,0,3,3
23937,ആർക്കും,0,0,3,3
11067,ಆಹಾರ,0,0,3,3
1637,convinzione,1,3,0,3
11066,गति,0,0,3,3
24769,நீ,0,0,3,3
24429,réduire,0,0,3,3
1484,assegnazione,1,3,0,3
39694,anonymt,0,0,3,3
32093,சிறிய,0,0,3,3
11062,понял,0,0,3,3
32206,arruiné,0,0,3,3
3982,suscitato,1,3,0,3
10984,décision,0,0,3,3
34392,sanki,0,0,3,3
1509,risultante,1,3,0,3
9980,भूगोल,0,0,3,3
4007,rispettano,1,3,0,3
48570,ήμασταν,0,0,3,3
24158,hellere,0,0,3,3
39560,شيوعًا,0,0,3,3
10802,cartoon,0,0,3,3
25129,donations,0,0,3,3
10882,agriculture,0,0,3,3
38941,ಇರುವ,0,0,3,3
24239,catalan,0,0,3,3
32176,വിരലുകൾ,0,0,3,3
39014,compute,0,0,3,3
32175,مجلة,0,0,3,3
24169,आलोचकों,0,0,3,3
30231,перед,0,0,3,3
25122,جون,0,0,3,3
25121,வகையானது,0,0,3,3
25012,विकिस्रोत,0,0,3,3
38924,несмотря,0,0,3,3
24981,utilizado,0,0,3,3
1510,educazione,1,3,0,3
10136,нее,0,0,3,3
24959,desarrollar,0,0,3,3
39494,चार,0,0,3,3
39495,ajouts,0,0,3,3
32144,ನಿಧಾನವಾಗಿ,0,0,3,3
24966,διόρθωση,0,0,3,3
39041,स्कूल्स,0,0,3,3
48558,متأكد,0,0,3,3
38908,उच्चारण,0,0,3,3
38917,αδελφικά,0,0,3,3
10124,birine,0,0,3,3
24968,بالإضافة,0,0,3,3
32311,المثيرة,0,0,3,3
32157,generate,0,0,3,3
24972,garçon,0,0,3,3
9971,taken,0,0,3,3
1527,sposa,1,3,0,3
48563,ಮಾಡುವುದು,0,0,3,3
10129,प्रशासक,0,0,3,3
39009,மனதில்,0,0,3,3
24229,förekommer,0,0,3,3
25297,juntos,0,0,3,3
25080,unas,0,0,3,3
25093,edebilir,0,0,3,3
10852,ardından,0,0,3,3
10849,ಮಾಡುತ್ತೀರಿ,0,0,3,3
10031,ज्ञान,0,0,3,3
48626,فقدت,0,0,3,3
39526,прав,0,0,3,3
38982,ons,0,0,3,3
25081,سوف,0,0,3,3
10840,ran,0,0,3,3
38987,ಅಮೆರಿಕನ್ನರು,0,0,3,3
10040,deles,0,0,3,3
30266,bile,0,0,3,3
10054,ഔട്പുട്ട്,0,0,3,3
48104,maanden,0,0,3,3
39527,innehåller,0,0,3,3
39529,июле,0,0,3,3
32299,لإنشاء,0,0,3,3
25064,minder,0,0,3,3
25094,गणित,0,0,3,3
1519,dipinti,1,3,0,3
32304,bacteria,0,0,3,3
39544,pequeña,0,0,3,3
10089,moteurs,0,0,3,3
38947,добросовестного,0,0,3,3
48643,دقائق,0,0,3,3
48642,दौरान,0,0,3,3
25022,internetleverantörer,0,0,3,3
24227,capa,0,0,3,3
32297,ആവശ്യപ്പെടുന്നു,0,0,3,3
25025,libraries,0,0,3,3
48595,വിലകൾ,0,0,3,3
25039,derfor,0,0,3,3
38998,gefragt,0,0,3,3
1708,collabora,1,3,0,3
1707,villaggio,1,3,0,3
39518,वृत्तचित्र,0,0,3,3
10820,أعمال,0,0,3,3
10021,கடைசி,0,0,3,3
30268,содержимое,0,0,3,3
10026,aplicación,0,0,3,3
25176,donnée,0,0,3,3
24258,criado,0,0,3,3
48059,близко,0,0,3,3
39457,raderas,0,0,3,3
25264,வீட்டில்,0,0,3,3
39076,klingen,0,0,3,3
9890,contas,0,0,3,3
10958,venu,0,0,3,3
9892,förhand,0,0,3,3
38859,représentations,0,0,3,3
32282,verbluffend,0,0,3,3
1732,frequente,2,2,1,3
38863,अमेरिकन,0,0,3,3
25268,نارسيس,0,0,3,3
34366,gece,0,0,3,3
32321,σίγουρος,0,0,3,3
38865,combatir,0,0,3,3
39469,рядом,0,0,3,3
34345,kabul,0,0,3,3
24914,உரையாடலில்,0,0,3,3
39069,förstå,0,0,3,3
32290,നാളെ,0,0,3,3
10959,позднее,0,0,3,3
24074,сэнгером,0,0,3,3
24130,गुप्त,0,0,3,3
48017,vrouw,0,0,3,3
10713,வகையில்,0,0,3,3
10983,bonjour,0,0,3,3
52111,atmospheric,0,0,3,3
48186,الجديد,0,0,3,3
25291,продали,0,0,3,3
3966,nord,2,2,1,3
48724,weer,0,0,3,3
24054,удивительно,0,0,3,3
1738,lee,2,1,2,3
10204,нам,0,0,3,3
1737,appreso,1,3,0,3
48182,ಹೇಳುವ,0,0,3,3
24893,artisan,0,0,3,3
48020,narcissism,0,0,3,3
48180,genug,0,0,3,3
24067,mener,0,0,3,3
48515,wikipediasidor,0,0,3,3
10965,disputed,0,0,3,3
25231,names,0,0,3,3
1533,touch,2,1,2,3
10185,tendencia,0,0,3,3
10922,geweest,0,0,3,3
10928,ಸುವ್,0,0,3,3
34459,अंतिम,0,0,3,3
1677,farsi,1,3,0,3
48541,obtuve,0,0,3,3
10926,പൊതുവേ,0,0,3,3
9947,estudiantes,0,0,3,3
39581,ತಮ್ಮ,0,0,3,3
10924,masse,0,0,3,3
48545,καρδιά,0,0,3,3
39590,aquellas,0,0,3,3
10155,sad,0,0,3,3
10915,precipitation,0,0,3,3
25188,subsets,0,0,3,3
39489,growing,0,0,3,3
24124,जनमत,0,0,3,3
10775,फ़्रिसियाई,0,0,3,3
24955,reason,0,0,3,3
4017,sapeva,1,3,0,3
39582,inaccuracies,0,0,3,3
48149,одном,0,0,3,3
9943,kleine,0,0,3,3
34422,بنفسك,0,0,3,3
9918,dinero,0,0,3,3
9919,मेहनत,0,0,3,3
24109,чемнибудь,0,0,3,3
38874,रख,0,0,3,3
38875,discover,0,0,3,3
10936,meiner,0,0,3,3
10753,सुनहरी,0,0,3,3
38879,حالة,0,0,3,3
24281,الرجل,0,0,3,3
24925,básicos,0,0,3,3
38887,argue,0,0,3,3
10172,رفاق,0,0,3,3
32130,المتخصصين,0,0,3,3
39481,വിവരങ്ങൾ,0,0,3,3
48046,الحادة,0,0,3,3
39584,verblüfft,0,0,3,3
25203,чувствую,0,0,3,3
39731,individuele,0,0,3,3
25066,oxygen,0,0,3,3
11128,وكان,0,0,3,3
51979,cuidar,0,0,3,3
47896,البعض,0,0,3,3
9656,praticamente,2,1,2,3
48361,mathématiques,0,0,3,3
32245,considers,0,0,3,3
3989,macmillan,2,1,2,3
39234,kein,0,0,3,3
23833,требует,0,0,3,3
24651,stören,0,0,3,3
9651,singolo,1,3,0,3
23825,humanos,0,0,3,3
24527,വാക്കുകളും,0,0,3,3
9648,stone,2,1,2,3
48325,utilisés,0,0,3,3
24653,देखने,0,0,3,3
11178,أنواع,0,0,3,3
9543,modellare,1,3,0,3
23824,lektion,0,0,3,3
24655,identification,0,0,3,3
1615,meta,2,1,2,3
25604,fritt,0,0,3,3
34393,செய்கிறீர்கள்,0,0,3,3
32220,विकसित,0,0,3,3
25526,comunidades,0,0,3,3
9641,publishers,2,1,2,3
24533,φρικτή,0,0,3,3
39320,अंग्रेज़ी,0,0,3,3
38689,запрос,0,0,3,3
52132,samples,0,0,3,3
1618,hoiberg,2,1,2,3
10385,moyenne,0,0,3,3
47909,dérivé,0,0,3,3
48356,females,0,0,3,3
24709,eksik,0,0,3,3
39264,husk,0,0,3,3
48357,telles,0,0,3,3
23717,fully,0,0,3,3
9671,interested,0,0,3,3
47824,मल्टीमीडिया,0,0,3,3
32233,swedish,0,0,3,3
9668,norvegese,1,3,0,3
23720,claims,0,0,3,3
11256,geldi,0,0,3,3
39758,البداية,0,0,3,3
10392,koets,0,0,3,3
9527,incoraggiato,1,3,0,3
32246,bedanken,0,0,3,3
25503,matematik,0,0,3,3
32383,ನೀಡುತ್ತೇನೆ,0,0,3,3
38693,vikipedilerin,0,0,3,3
25506,letar,0,0,3,3
10393,денег,0,0,3,3
48359,учёными,0,0,3,3
48849,tecnología,0,0,3,3
11180,colaborativos,0,0,3,3
10444,έκανε,0,0,3,3
23863,special,0,0,3,3
51096,செல்லுங்கள்,0,0,3,3
32067,símbolos,0,0,3,3
39300,täcka,0,0,3,3
24658,gerne,0,0,3,3
48375,शीर्षक,0,0,3,3
25585,போலவே,0,0,3,3
23805,நாளை,0,0,3,3
39783,مصنوع,0,0,3,3
3556,riducendo,1,3,0,3
11197,falsa,0,0,3,3
1809,morte,1,3,0,3
38651,prensa,0,0,3,3
9598,riproduzione,1,3,0,3
39223,большинство,0,0,3,3
32068,reiß,0,0,3,3
9595,partecipare,1,3,0,3
1445,shopping,2,1,2,3
23785,ബട്ടൺ,0,0,3,3
38648,kendi,0,0,3,3
11205,fournir,0,0,3,3
3689,specifica,1,3,0,3
1801,tendiamo,1,3,0,3
39295,ejercicio,0,0,3,3
52135,überhaupt,0,0,3,3
4030,accade,1,3,0,3
23795,όνειρό,0,0,3,3
48317,يؤدي,0,0,3,3
25549,эй,0,0,3,3
24542,drawn,0,0,3,3
24678,elsker,0,0,3,3
24684,opfyldelse,0,0,3,3
39212,पहुँच,0,0,3,3
10516,ಬದಲು,0,0,3,3
23823,ampliar,0,0,3,3
3990,raggi,1,3,0,3
25599,negativ,0,0,3,3
1440,diderot,2,2,1,3
10521,योग्य,0,0,3,3
48372,ஆகிய,0,0,3,3
25536,bede,0,0,3,3
48302,पकड़ा,0,0,3,3
10417,bröd,0,0,3,3
9613,lacrime,1,3,0,3
24569,comparable,0,0,3,3
39775,général,0,0,3,3
1604,sconcertata,1,3,0,3
24534,chanserna,0,0,3,3
38667,വെബ്,0,0,3,3
9554,madrelingua,1,3,0,3
23813,либо,0,0,3,3
10524,individus,0,0,3,3
9620,pomeriggio,1,3,0,3
47860,организация,0,0,3,3
23772,ഇതിനകം,0,0,3,3
32062,publiées,0,0,3,3
1805,determinata,1,3,0,3
25478,चीजें,0,0,3,3
9505,copertina,1,3,0,3
39194,ανησυχείς,0,0,3,3
1831,dipendenza,1,3,0,3
34316,alleen,0,0,3,3
1599,abbiano,1,3,0,3
10380,fears,0,0,3,3
52073,αιχμηρή,0,0,3,3
38699,желание,0,0,3,3
24725,முன்கூட்டியே,0,0,3,3
1780,mattina,1,3,0,3
1622,sgarbatamente,1,3,0,3
10486,narcisses,0,0,3,3
32058,primary,0,0,3,3
51973,trabalhar,0,0,3,3
48844,இருந்தபோது,0,0,3,3
1459,filosofica,1,3,0,3
11272,propósito,0,0,3,3
1619,sconosciute,1,3,0,3
34400,mala,0,0,3,3
24617,सोचना,0,0,3,3
39190,люди,0,0,3,3
25479,lançou,0,0,3,3
24726,எப்படியும்,0,0,3,3
48918,naturalisme,0,0,3,3
28637,ægteskab,0,0,2,2
43029,قليلاً,0,0,2,2
19313,estés,0,0,2,2
24611,zavallı,0,0,2,2
31031,capables,0,0,2,2
28639,stødte,0,0,2,2
39479,الشخصية,0,0,2,2
23212,publicités,0,0,2,2
40232,daad,0,0,2,2
23131,comprar,0,0,2,2
43028,أخذت,0,0,2,2
28640,दलदली,0,0,2,2
35173,सिद्धांत,0,0,2,2
28781,ridder,0,0,2,2
39475,şaşırdı,0,0,2,2
32231,verscheen,0,0,2,2
23118,أراك,0,0,2,2
36723,βόλτα,0,0,2,2
40240,utifrån,0,0,2,2
28071,narzisse,0,0,2,2
22895,ರೀತಿಯಲ್ಲಿ,0,0,2,2
43026,и т п,0,0,2,2
23123,സഹകരണത്തോടെ,0,0,2,2
24290,μέλι,0,0,2,2
28822,ನಾಲ್ಕು,0,0,2,2
19310,ifadesi,0,0,2,2
28070,القناة,0,0,2,2
28067,மேற்கொள்ளப்படும்,0,0,2,2
43175,оставить,0,0,2,2
28815,investigação,0,0,2,2
30980,sampled,0,0,2,2
40236,महीनों,0,0,2,2
36603,långsammare,0,0,2,2
18719,بالكامل,0,0,2,2
39474,dudas,0,0,2,2
36718,περισσότερες,0,0,2,2
19317,сообщила,0,0,2,2
36717,multimídia,0,0,2,2
43047,leyendo,0,0,2,2
42657,imparcialidade,0,0,2,2
27997,alcançar,0,0,2,2
28649,conséquence,0,0,2,2
34239,commonalities,0,0,2,2
23143,specifika,0,0,2,2
28063,ಯಾವುದನ್ನಾದರೂ,0,0,2,2
43044,tour,0,0,2,2
33324,probably,0,0,2,2
43169,сначала,0,0,2,2
18686,التعبير,0,0,2,2
18705,λέξεων,0,0,2,2
28653,profesor,0,0,2,2
37071,énorme,0,0,2,2
31028,citerede,0,0,2,2
35509,источником,0,0,2,2
23145,administrativo,0,0,2,2
18682,കുറിച്ചുള്ള,0,0,2,2
43167,verwijderd,0,0,2,2
40223,lancer,0,0,2,2
28802,προχωρήστε,0,0,2,2
33687,atención,0,0,2,2
33689,லத்தீன்,0,0,2,2
40368,случая,0,0,2,2
42659,entreprises,0,0,2,2
28812,πράξη,0,0,2,2
28810,contribute,0,0,2,2
42663,üye,0,0,2,2
42612,ಪಡೆಯುತ್ತೀರಿ,0,0,2,2
18496,​​eller,0,0,2,2
28645,interesseret,0,0,2,2
33691,χρησιμοποιώντας,0,0,2,2
30513,मोटापे,0,0,2,2
32291,terabytes,0,0,2,2
37110,रखें।,0,0,2,2
18698,banka,0,0,2,2
33314,χρυσή,0,0,2,2
18697,questioned,0,0,2,2
18499,مراقبة,0,0,2,2
28807,لقول,0,0,2,2
36614,учёных,0,0,2,2
33315,responsabilidade,0,0,2,2
35199,utförd,0,0,2,2
40230,regel,0,0,2,2
28631,angst,0,0,2,2
27991,حلمها,0,0,2,2
18726,webben,0,0,2,2
35045,сне,0,0,2,2
28584,própria,0,0,2,2
39456,instructions,0,0,2,2
28585,ಹೆಚ್ಚಾಗಿ,0,0,2,2
23225,أنشأ,0,0,2,2
23104,சிக்கலான,0,0,2,2
18477,ходе,0,0,2,2
18478,सुनहरे,0,0,2,2
43183,trace,0,0,2,2
31227,ഇഷ്ടപ്പെടുന്നു,0,0,2,2
31057,மாட்டேன்,0,0,2,2
28583,നിഷ്പക്ഷത,0,0,2,2
32534,traces,0,0,2,2
28590,முந்தைய,0,0,2,2
42993,हो।,0,0,2,2
28591,acíclico,0,0,2,2
18764,mobiele,0,0,2,2
28594,коммерческой,0,0,2,2
35158,nenhuma,0,0,2,2
28859,inappropriées,0,0,2,2
40173,january update,0,0,2,2
37058,αρνητικό,0,0,2,2
24615,inserção,0,0,2,2
36581,confiável,0,0,2,2
37124,नयी,0,0,2,2
24321,alınır,0,0,2,2
43190,заболоченного,0,0,2,2
18794,assets,0,0,2,2
24316,animé,0,0,2,2
30259,independentes,0,0,2,2
35148,alegação,0,0,2,2
36565,स्वयंसेवकों,0,0,2,2
42674,esas,0,0,2,2
36760,indse,0,0,2,2
40250,intermédiaire,0,0,2,2
35666,pleasure,0,0,2,2
18791,അക്യൂട്ട്,0,0,2,2
35031,coleção,0,0,2,2
31066,muita,0,0,2,2
43188,vivants,0,0,2,2
18787,fonction,0,0,2,2
28092,கிடைக்குமா,0,0,2,2
19298,propuso,0,0,2,2
31064,fiable,0,0,2,2
18785,अगस्त,0,0,2,2
23105,faitesle,0,0,2,2
35159,puesto,0,0,2,2
24291,oldu,0,0,2,2
40241,maddesini,0,0,2,2
36730,кандидата,0,0,2,2
30530,assurer,0,0,2,2
28073,kararlar,0,0,2,2
43013,βράδυ,0,0,2,2
18740,hantera,0,0,2,2
28620,chosen,0,0,2,2
35804,voix,0,0,2,2
43016,ख्याल,0,0,2,2
43017,विकि,0,0,2,2
28623,нарцис,0,0,2,2
36588,الجمعة,0,0,2,2
40174,ответов,0,0,2,2
42666,assessment,0,0,2,2
40176,correcteur,0,0,2,2
28827,ചെയ്ത്,0,0,2,2
18733,மூன்று,0,0,2,2
33662,تهتم,0,0,2,2
18732,विवाह,0,0,2,2
35170,„википедию“,0,0,2,2
30620,xxi,0,0,2,2
43010,моментом,0,0,2,2
36734,analogs,0,0,2,2
18760,kreeg,0,0,2,2
24308,സബ്‌സ്‌ക്രൈബ്,0,0,2,2
28600,raiz,0,0,2,2
39290,сделано,0,0,2,2
43002,ലേഖനത്തിന്,0,0,2,2
40364,உண்மையிலேயே,0,0,2,2
34367,poderem,0,0,2,2
24310,machinelearning,0,0,2,2
37060,« res,0,0,2,2
28843,participated,0,0,2,2
31049,rigorous,0,0,2,2
35041,തീയതി,0,0,2,2
39470,bericht,0,0,2,2
40246,interesante,0,0,2,2
34365,manuals,0,0,2,2
30605,considerou,0,0,2,2
37063,समानांतर,0,0,2,2
36587,kökeni,0,0,2,2
22924,المرور,0,0,2,2
31046,объёмом,0,0,2,2
18483,виделись,0,0,2,2
28610,banda,0,0,2,2
23148,yıl,0,0,2,2
43058,mandos,0,0,2,2
39277,கூர்மையான,0,0,2,2
18578,erişim,0,0,2,2
43116,equatorial,0,0,2,2
28031,lancement,0,0,2,2
18583,sommaren,0,0,2,2
31013,للشك,0,0,2,2
33336,редко,0,0,2,2
43117,கணித,0,0,2,2
19380,fête,0,0,2,2
36650,symbolistes,0,0,2,2
43119,காணப்படும்,0,0,2,2
32476,funcionava,0,0,2,2
18590,repita,0,0,2,2
23187,именно,0,0,2,2
18575,navegar,0,0,2,2
40374,graphs,0,0,2,2
22898,कहना।,0,0,2,2
35636,cultures,0,0,2,2
43124,содержание,0,0,2,2
32298,escola,0,0,2,2
18572,censure,0,0,2,2
28029,randevum,0,0,2,2
40203,അവസ്ഥയിൽ,0,0,2,2
18591,supporting,0,0,2,2
19378,போன்றது,0,0,2,2
18603,формате,0,0,2,2
31014,وإرشادات,0,0,2,2
18608,erkänner,0,0,2,2
36658,wikiznanie,0,0,2,2
31245,diversity,0,0,2,2
40204,oprindeligt,0,0,2,2
28730,dourada,0,0,2,2
18533,accepterar,0,0,2,2
23176,يحررها,0,0,2,2
39519,türkçe,0,0,2,2
24236,внимание,0,0,2,2
36652,தனிப்பட்ட,0,0,2,2
42640,edited,0,0,2,2
43147,jugées,0,0,2,2
24232,أحضر,0,0,2,2
43104,deposition,0,0,2,2
18536,représente,0,0,2,2
43142,molesto,0,0,2,2
18599,rolig,0,0,2,2
23177,analizar,0,0,2,2
23178,drömmar,0,0,2,2
28787,πρίγκιπας,0,0,2,2
24589,elegir,0,0,2,2
35447,साथ।,0,0,2,2
37100,demand,0,0,2,2
40195,presença,0,0,2,2
22904,idées,0,0,2,2
23194,kollektivt,0,0,2,2
39513,പാഠങ്ങൾ,0,0,2,2
33347,ونظر,0,0,2,2
28775,ചോദിച്ചപ്പോൾ,0,0,2,2
23191,مثال,0,0,2,2
28018,visible,0,0,2,2
19369,иметь,0,0,2,2
28777,واسع,0,0,2,2
35190,κλικ,0,0,2,2
19373,منهم,0,0,2,2
24600,ഇതിൽ,0,0,2,2
18544,медленно,0,0,2,2
30999,απόφαση,0,0,2,2
18546,civilisation,0,0,2,2
28779,bénévoles,0,0,2,2
35195,ಪ್ರಿಯನು,0,0,2,2
28014,bewerkt,0,0,2,2
33345,выделились,0,0,2,2
32474,குறிக்கிறது,0,0,2,2
28766,gamla,0,0,2,2
28742,copier,0,0,2,2
22907,classiques,0,0,2,2
28743,voedsel,0,0,2,2
24231,foco,0,0,2,2
36648,वेबसाईटों,0,0,2,2
28749,maintains,0,0,2,2
24591,ayudar,0,0,2,2
30997,சர்ச்சைக்குரிய,0,0,2,2
32475,categorized,0,0,2,2
31007,дальнейшем,0,0,2,2
28753,oefenen,0,0,2,2
35188,trouwen,0,0,2,2
36625,ಚಾನಲ್‌ಗೆ,0,0,2,2
33199,स्टीफन,0,0,2,2
40191,contratados,0,0,2,2
43129,ertesi,0,0,2,2
42633,offer,0,0,2,2
34195,relicense,0,0,2,2
36638,تعليقًا,0,0,2,2
18560,செய்யவில்லை,0,0,2,2
24595,besökta,0,0,2,2
24596,ಮಧ್ಯದಲ್ಲಿದ್ದರೆ,0,0,2,2
31244,объявил,0,0,2,2
43097,unable,0,0,2,2
23174,verbal,0,0,2,2
33203,платье,0,0,2,2
43158,ajudam,0,0,2,2
24261,flows,0,0,2,2
24210,ಸಂಧಿಸಲು,0,0,2,2
28795,ആയിരിക്കും,0,0,2,2
32292,homepage,0,0,2,2
33765,idéologie,0,0,2,2
34397,основана,0,0,2,2
43069,مذهل,0,0,2,2
30040,conhecido,0,0,2,2
33684,சொல்வதற்கான,0,0,2,2
40181,yiyeceklere,0,0,2,2
31240,allemande,0,0,2,2
39271,dedican,0,0,2,2
23157,κατά,0,0,2,2
34240,atrozes,0,0,2,2
42618,vocabulary,0,0,2,2
37080,littérature,0,0,2,2
36690,improves,0,0,2,2
43072,लिनक्स,0,0,2,2
24253,أكون,0,0,2,2
24602,yeux,0,0,2,2
18515,locomotion,0,0,2,2
40207,oorsprong,0,0,2,2
24579,importaria,0,0,2,2
24275,ಗೊತ್ತು,0,0,2,2
19329,தாய்,0,0,2,2
18674,relationship,0,0,2,2
28002,மேற்கொள்ளும்,0,0,2,2
24274,stackars,0,0,2,2
28782,ausmachen,0,0,2,2
36704,पत्रकारिता,0,0,2,2
42654,áfrica,0,0,2,2
19387,يقول,0,0,2,2
37074,विशाल,0,0,2,2
18511,ಹೊಂದಿದ್ದೇನೆ,0,0,2,2
24264,katılıyorum,0,0,2,2
28667,supprimé,0,0,2,2
19337,الواقع,0,0,2,2
32480,والعمل,0,0,2,2
28056,मारी,0,0,2,2
37076,existent,0,0,2,2
35177,ഇംഗ്ലീഷിൽ,0,0,2,2
28799,الحالات,0,0,2,2
18659,astuce,0,0,2,2
28690,experimento,0,0,2,2
24251,एंड्रयू,0,0,2,2
43077,permis,0,0,2,2
18615,विस्तृत,0,0,2,2
35182,ελέγξετε,0,0,2,2
43092,pardelà,0,0,2,2
40372,préstamo,0,0,2,2
24587,möten,0,0,2,2
32540,вообще,0,0,2,2
36622,daglig,0,0,2,2
18617,लें।,0,0,2,2
37089,ideologiskt,0,0,2,2
24588,உம்,0,0,2,2
40210,narcissisme,0,0,2,2
18528,βιβλιοθήκη,0,0,2,2
37091,encanta,0,0,2,2
30515,rapidez,0,0,2,2
40186,student,0,0,2,2
28010,мальчик,0,0,2,2
42641,échecs,0,0,2,2
36673,avisos,0,0,2,2
23169,notable,0,0,2,2
32296,«фонд,0,0,2,2
19381,जैसा,0,0,2,2
32294,gebied,0,0,2,2
28701,jämföra,0,0,2,2
33331,lumières,0,0,2,2
28040,ekmeği,0,0,2,2
30618,pouvoir,0,0,2,2
36682,മൂന്നാം,0,0,2,2
18637,رأي,0,0,2,2
31241,உடையில்,0,0,2,2
19342,सफल,0,0,2,2
39499,wünschen,0,0,2,2
39262,இருக்கிறீர்களா,0,0,2,2
42647,υπέροχα,0,0,2,2
18632,entendiste,0,0,2,2
39269,rod,0,0,2,2
28564,neurones,0,0,2,2
43149,என்பதால்,0,0,2,2
24216,gouvernement,0,0,2,2
43148,वहां,0,0,2,2
28698,лишнюю,0,0,2,2
36679,répertoire,0,0,2,2
42646,भूखा,0,0,2,2
18627,ഞങ്ങൾ‌,0,0,2,2
28043,хорош,0,0,2,2
35181,lære,0,0,2,2
18827,volledig,0,0,2,2
24323,maintenance,0,0,2,2
31198,década,0,0,2,2
42824,торговой,0,0,2,2
19037,suma,0,0,2,2
28326,hayatınızda,0,0,2,2
42826,millet,0,0,2,2
19035,കാര്യങ്ങൾക്കോ,0,0,2,2
39325,waarmee,0,0,2,2
19197,ملايين,0,0,2,2
35791,περισσότερο,0,0,2,2
35571,libre—,0,0,2,2
42830,ಬಳಸಿ,0,0,2,2
24508,attempted,0,0,2,2
36909,കരുതുന്നു,0,0,2,2
28337,origen,0,0,2,2
28344,ಅಭಿಪ್ರಾಯಗಳು,0,0,2,2
28345,desarrolló,0,0,2,2
39381,l’opposition,0,0,2,2
24426,« ont,0,0,2,2
19023,prens,0,0,2,2
35064,periodistas,0,0,2,2
19021,ஆடம்பரமான,0,0,2,2
30425,тупому,0,0,2,2
28350,ولكنها,0,0,2,2
31201,poli,0,0,2,2
19041,horizontale,0,0,2,2
19042,زائر,0,0,2,2
23012,computed,0,0,2,2
28325,последние,0,0,2,2
19062,дня,0,0,2,2
36925,ಸಭೆಗೆ,0,0,2,2
19060,problème,0,0,2,2
40306,descrita,0,0,2,2
19189,ಬನ್ನಿ,0,0,2,2
28312,വിട,0,0,2,2
40341,médiatiques,0,0,2,2
19191,वैसा,0,0,2,2
28313,artiklerne,0,0,2,2
36918,പിന്നീട്,0,0,2,2
23016,macha,0,0,2,2
28317,مقدمًا,0,0,2,2
19051,साइट,0,0,2,2
40305,ಮಗಳ,0,0,2,2
35101,الطريقة,0,0,2,2
19049,registrarse,0,0,2,2
24433,reuse,0,0,2,2
35067,değiştirilmesi,0,0,2,2
36913,opdagelser,0,0,2,2
35103,utgången,0,0,2,2
30069,décidé,0,0,2,2
28324,الإبداعي,0,0,2,2
28168,μέσα,0,0,2,2
24422,nederland,0,0,2,2
36895,agua,0,0,2,2
42839,especialistas,0,0,2,2
28352,reprennent,0,0,2,2
36876,शब्दकोश,0,0,2,2
31132,político,0,0,2,2
30426,تسير,0,0,2,2
28391,ನೋಡಿದ,0,0,2,2
35113,تكن,0,0,2,2
42726,ஒருவேளை,0,0,2,2
28393,quotations,0,0,2,2
36868,demuestra,0,0,2,2
39391,digg,0,0,2,2
34219,reduction,0,0,2,2
40291,πύλη,0,0,2,2
35674,twelve,0,0,2,2
31208,перешла,0,0,2,2
18986,दोहराने,0,0,2,2
42857,отметку,0,0,2,2
33241,ದಾಟಿದೆ,0,0,2,2
42858,ನೋಟ,0,0,2,2
18983,الستة,0,0,2,2
33741,recorded,0,0,2,2
35058,kaldet,0,0,2,2
28148,enviaré,0,0,2,2
23040,beğendiyseniz,0,0,2,2
18977,beleuchtet,0,0,2,2
28382,observant,0,0,2,2
42728,تعرض,0,0,2,2
39389,usarem,0,0,2,2
19008,vorm,0,0,2,2
23025,ഭാഗം,0,0,2,2
19203,computador,0,0,2,2
31141,edersiniz,0,0,2,2
24513,джозефом,0,0,2,2
24514,village,0,0,2,2
28359,volumétrie,0,0,2,2
19011,ആരാണ്,0,0,2,2
30085,മുൻ‌കൂട്ടി,0,0,2,2
28360,توجد,0,0,2,2
19009,τύπο,0,0,2,2
40299,incorporated,0,0,2,2
19001,أصبح,0,0,2,2
35109,понравилось,0,0,2,2
30253,எப்படிப்,0,0,2,2
42846,स्वप्न,0,0,2,2
30060,lesquelles,0,0,2,2
42847,artikelhistoriken,0,0,2,2
42848,potentiel,0,0,2,2
28371,escuchado,0,0,2,2
28372,история,0,0,2,2
36883,surpassing,0,0,2,2
31134,vy,0,0,2,2
39377,sueños,0,0,2,2
33746,länka,0,0,2,2
18798,forest,0,0,2,2
36962,ആരംഭിച്ച,0,0,2,2
36988,jaarlijkse,0,0,2,2
42773,falschen,0,0,2,2
24484,dis,0,0,2,2
28196,globo,0,0,2,2
19163,работайте,0,0,2,2
22991,esfera,0,0,2,2
19128,проектов,0,0,2,2
19164,وسط,0,0,2,2
28245,ordförråd,0,0,2,2
19165,experientes,0,0,2,2
22976,diseño,0,0,2,2
36959,диска,0,0,2,2
28252,kring,0,0,2,2
19170,scrubs,0,0,2,2
19123,yasal,0,0,2,2
36955,yoktur,0,0,2,2
24478,gobierno,0,0,2,2
35079,bureaucrats,0,0,2,2
35070,arrêt,0,0,2,2
28262,फाइलें,0,0,2,2
36946,மைல்,0,0,2,2
28264,ഓർമ്മിക്കുക,0,0,2,2
22974,considerado,0,0,2,2
42772,portaal,0,0,2,2
31184,ungefär,0,0,2,2
19069,मौजूद,0,0,2,2
30570,apresenta,0,0,2,2
19150,cumulative,0,0,2,2
28207,balança,0,0,2,2
19149,τραπεζικό,0,0,2,2
36987,bryde,0,0,2,2
28209,التراجع,0,0,2,2
28211,plágio,0,0,2,2
40327,когдалибо,0,0,2,2
28220,semanas,0,0,2,2
40325,sonhos,0,0,2,2
28222,வேண்டிய,0,0,2,2
28223,പ്രസിദ്ധമായ,0,0,2,2
28224,संभव,0,0,2,2
42766,irrelevant,0,0,2,2
39333,obscene,0,0,2,2
39337,elegido,0,0,2,2
19156,listas,0,0,2,2
33221,obtive,0,0,2,2
40324,χρησιμοποιείτε,0,0,2,2
40323,party,0,0,2,2
30079,néerlandais,0,0,2,2
35073,ícone,0,0,2,2
24488,görüyorum,0,0,2,2
24487,hébergeant,0,0,2,2
39326,கொடூரமானவை,0,0,2,2
19174,primarily,0,0,2,2
28268,riken,0,0,2,2
28269,ganó,0,0,2,2
19097,trække,0,0,2,2
28288,encontrado,0,0,2,2
19183,falls,0,0,2,2
19095,dillerdeki,0,0,2,2
23002,marquée,0,0,2,2
39366,प्रकट,0,0,2,2
28172,επί,0,0,2,2
19090,couch,0,0,2,2
19088,bacterial,0,0,2,2
39369,बल,0,0,2,2
19084,environnementale,0,0,2,2
39371,ilustrativo,0,0,2,2
24441,വിളിക്കുന്നു,0,0,2,2
39375,vrijdag,0,0,2,2
23007,ಸುಂದರ,0,0,2,2
35783,describes,0,0,2,2
28300,groeide,0,0,2,2
19082,αόριστος,0,0,2,2
32509,biblioteket,0,0,2,2
33759,журналы,0,0,2,2
37012,பயன்படுத்த,0,0,2,2
24506,അടിസ്ഥാനമാക്കി,0,0,2,2
19073,partout,0,0,2,2
23001,condutas,0,0,2,2
36998,suspect,0,0,2,2
40339,winter,0,0,2,2
35093,administrativas,0,0,2,2
35092,daher,0,0,2,2
39348,r,0,0,2,2
30252,bounds,0,0,2,2
42784,فيمكنك,0,0,2,2
19112,எவ்வளவு,0,0,2,2
28189,omhoog,0,0,2,2
22971,abordagem,0,0,2,2
28274,varies,0,0,2,2
39351,எரிகிறது,0,0,2,2
28277,prevención,0,0,2,2
24458,ಸುಲಭವಾದ,0,0,2,2
42790,ഇല്ലാതെ,0,0,2,2
19106,dein,0,0,2,2
35095,процесса,0,0,2,2
39362,işle,0,0,2,2
19105,importaría,0,0,2,2
28280,описания,0,0,2,2
36937,störst,0,0,2,2
30075,maakte,0,0,2,2
39365,explicações,0,0,2,2
40338,usaron,0,0,2,2
28284,salades,0,0,2,2
19211,अध्यक्ष,0,0,2,2
42864,«когда,0,0,2,2
18974,பெறுவீர்கள்,0,0,2,2
33266,lien,0,0,2,2
37047,langsamer,0,0,2,2
22937,terminar,0,0,2,2
39301,φίλος,0,0,2,2
28493,önemli,0,0,2,2
35131,വിളിക്കുന്നത്,0,0,2,2
36808,மாத்திரமே,0,0,2,2
24355,iniciados,0,0,2,2
28506,natuurwetenschappelijk,0,0,2,2
35777,സംരംഭത്തിന്റെ,0,0,2,2
36796,estatuto,0,0,2,2
31091,"
árabe",0,0,2,2
39299,нажав,0,0,2,2
18853,ഓർക്കുക,0,0,2,2
28511,dog,0,0,2,2
35135,considerable,0,0,2,2
28516,protégées,0,0,2,2
40266,organisé,0,0,2,2
40359,говорит,0,0,2,2
30440,subdomain,0,0,2,2
42691,rédigé,0,0,2,2
28517,العناء,0,0,2,2
37051,unidas,0,0,2,2
24350,oceanic,0,0,2,2
33720,ερωτήσεις,0,0,2,2
36810,overlying,0,0,2,2
18973,लाइफ,0,0,2,2
19263,success,0,0,2,2
36816,hit,0,0,2,2
28121,animese,0,0,2,2
28477,literature,0,0,2,2
18878,हैरान,0,0,2,2
24360,computadora,0,0,2,2
40354,pues,0,0,2,2
35562,anteriormente,0,0,2,2
31096,overrasket,0,0,2,2
42927,പരിശോധിച്ച്,0,0,2,2
24535,creditado,0,0,2,2
31095,probeer,0,0,2,2
24359,മാർഗങ്ങൾ,0,0,2,2
22940,divisions,0,0,2,2
24358,उनमें,0,0,2,2
28113,voorzichtig,0,0,2,2
42929,सोर्बियाई,0,0,2,2
28483,kentinde,0,0,2,2
19259,ചുമതലയും,0,0,2,2
19260,ertrinken,0,0,2,2
37046,പെട്ടെന്നു,0,0,2,2
32269,rijkdom,0,0,2,2
33213,الأيمن,0,0,2,2
28486,devrait,0,0,2,2
24347,руководств,0,0,2,2
28101,பெயர்,0,0,2,2
28521,familiar,0,0,2,2
24345,stört,0,0,2,2
42684,oferecer,0,0,2,2
28548,ചെയ്തിട്ടുണ്ടെങ്കിൽ,0,0,2,2
33283,месяцы,0,0,2,2
28098,xbox,0,0,2,2
34236,ställde,0,0,2,2
33209,praised,0,0,2,2
35047,mantêm,0,0,2,2
19284,autoridade,0,0,2,2
36767,svag,0,0,2,2
42681,faculdade,0,0,2,2
36766,sección,0,0,2,2
42972,उंगलियों,0,0,2,2
28097,ഉദാഹരണമായി,0,0,2,2
42973,provedores,0,0,2,2
39444,ampliamente,0,0,2,2
39296,l’utilisation,0,0,2,2
19287,mécanisme,0,0,2,2
24333,بحثًا,0,0,2,2
28558,l’espèce,0,0,2,2
32239,veía,0,0,2,2
18800,estimer,0,0,2,2
24330,raíces,0,0,2,2
24552,conectado,0,0,2,2
39443,ಕೇಳುತ್ತಿದ್ದಾರೆ,0,0,2,2
32277,abiotic,0,0,2,2
39441,faço,0,0,2,2
30051,ന്,0,0,2,2
36786,tummen,0,0,2,2
35049,ಹೊಂದಿಲ್ಲ,0,0,2,2
30416,reproduce,0,0,2,2
31083,അറിവു,0,0,2,2
33278,அனைத்தையும்,0,0,2,2
34232,pide,0,0,2,2
42948,grundlegende,0,0,2,2
22932,создание,0,0,2,2
42949,desconcertada,0,0,2,2
39438,projelerinin,0,0,2,2
34375,sesgado,0,0,2,2
18818,nereden,0,0,2,2
37052,английским,0,0,2,2
23081,vocabulario,0,0,2,2
34373,verificabilidade,0,0,2,2
40264,salinity,0,0,2,2
42955,बढ़ें।,0,0,2,2
18830,ευγενικά,0,0,2,2
36774,suppe,0,0,2,2
19151,طوال,0,0,2,2
18825,respirar,0,0,2,2
28542,مختلفة,0,0,2,2
30434,kinderspiel,0,0,2,2
36817,cambiar,0,0,2,2
19254,yerde,0,0,2,2
19237,solaire,0,0,2,2
28417,obviedad,0,0,2,2
30431,skapas,0,0,2,2
36851,teknolojileri,0,0,2,2
32261,corrigilos,0,0,2,2
42886,distintos,0,0,2,2
28426,evlenmek,0,0,2,2
23052,lives,0,0,2,2
23233,faktorer,0,0,2,2
31122,πατήσει,0,0,2,2
31118,réseau,0,0,2,2
18933,tive,0,0,2,2
18932,yankovic,0,0,2,2
28433,iğrenç,0,0,2,2
19236,kaffe,0,0,2,2
18930,talte,0,0,2,2
18929,compose,0,0,2,2
18927,vidt,0,0,2,2
28434,இடமில்லை,0,0,2,2
33245,встреча,0,0,2,2
35451,simbolizando,0,0,2,2
39414,بسهولة,0,0,2,2
28437,सवारी,0,0,2,2
18926,авторском,0,0,2,2
24399,وتعني,0,0,2,2
36860,beskriva,0,0,2,2
40282,மின்னஞ்சல்,0,0,2,2
18959,noms,0,0,2,2
18972,profound,0,0,2,2
28143,reverts,0,0,2,2
18971,секунду,0,0,2,2
24520,μικρό,0,0,2,2
30318,levels,0,0,2,2
35510,понимаю,0,0,2,2
39399,precies,0,0,2,2
39311,أستحق,0,0,2,2
22952,etmektedir,0,0,2,2
18965,daarvoor,0,0,2,2
22951,منظمة,0,0,2,2
18947,dominate,0,0,2,2
37034,adição,0,0,2,2
42873,onderdeel,0,0,2,2
28137,ಸ್ಪೀಕರ್,0,0,2,2
19223,അറിയപ്പെടുന്ന,0,0,2,2
42717,brilhantes,0,0,2,2
30087,photographs,0,0,2,2
18953,போன்றவற்றைக்,0,0,2,2
31211,εύκολη,0,0,2,2
42880,طبعة,0,0,2,2
18948,ಮರುದಿನ,0,0,2,2
31117,dias,0,0,2,2
36836,κάθε,0,0,2,2
18884,produto,0,0,2,2
22944,diretrizes,0,0,2,2
33737,portable,0,0,2,2
33250,нейросетей,0,0,2,2
18896,notícia,0,0,2,2
19248,சொல்கிறீர்கள்,0,0,2,2
39427,holde,0,0,2,2
31108,இருவரும்,0,0,2,2
19249,meat,0,0,2,2
28468,eşit,0,0,2,2
42914,autoridades,0,0,2,2
39430,härligt,0,0,2,2
28126,culturel,0,0,2,2
32493,bäst,0,0,2,2
22943,juego,0,0,2,2
35055,viewpoints,0,0,2,2
19252,സമവാക്യത്തിന്റെ,0,0,2,2
31106,سيرة,0,0,2,2
30056,ute,0,0,2,2
35125,അതുകൊണ്ട്,0,0,2,2
18889,russie,0,0,2,2
18888,classical,0,0,2,2
31102,പറയുന്നതെന്ന്,0,0,2,2
40353,perhaps,0,0,2,2
18886,acadêmicas,0,0,2,2
28128,herregud,0,0,2,2
19246,dazu,0,0,2,2
18901,محايدة,0,0,2,2
31115,مكبر,0,0,2,2
28445,அதனால்,0,0,2,2
39415,νόμιζα,0,0,2,2
42705,نفسها,0,0,2,2
24376,vilar,0,0,2,2
35671,centuries,0,0,2,2
35630,summer,0,0,2,2
42898,zetten,0,0,2,2
42899,trevlig,0,0,2,2
42703,fungerar,0,0,2,2
40277,kunst,0,0,2,2
33246,finesser,0,0,2,2
24366,चट्टान,0,0,2,2
34382,ನಿಮಿಷಗಳಲ್ಲಿ,0,0,2,2
28456,sophistiqué,0,0,2,2
31214,caractères,0,0,2,2
18913,manhã,0,0,2,2
24372,agradecendo,0,0,2,2
42903,bevatte,0,0,2,2
42702,ocho,0,0,2,2
36829,tålmodigt,0,0,2,2
18908,ಲ್ಯಾಟಿನ್,0,0,2,2
39426,റൂട്ട്,0,0,2,2
36844,πιθανούς,0,0,2,2
25649,comparaison,0,0,2,2
39528,derivadas,0,0,2,2
39943,söylüyorsunuz,0,0,2,2
43756,pertinence,0,0,2,2
36098,resultat,0,0,2,2
17625,सीजेनथेलर,0,0,2,2
29590,تتبع,0,0,2,2
17623,binden,0,0,2,2
17621,मांग,0,0,2,2
29594,എളുപ്പത്തിൽ,0,0,2,2
30753,niye,0,0,2,2
43759,ലാറി,0,0,2,2
23905,cold,0,0,2,2
29595,honneur,0,0,2,2
30752,teil,0,0,2,2
17616,trabajando,0,0,2,2
33580,universitetet,0,0,2,2
43754,donnent,0,0,2,2
23556,permitan,0,0,2,2
29597,vakgebieden,0,0,2,2
35655,мужчина,0,0,2,2
39942,verification,0,0,2,2
32414,вся,0,0,2,2
29601,έξω,0,0,2,2
17608,поражена,0,0,2,2
36088,вроде,0,0,2,2
36081,sender,0,0,2,2
33579,leitura,0,0,2,2
43772,ages,0,0,2,2
43773,lançada,0,0,2,2
29615,begynde,0,0,2,2
23908,विशिष्ट,0,0,2,2
32356,rationality,0,0,2,2
33366,manipular,0,0,2,2
17655,konsensusbeslut,0,0,2,2
39957,சந்தா,0,0,2,2
29553,பிரமாதமான,0,0,2,2
29554,الموسوعات,0,0,2,2
23933,requiere,0,0,2,2
39707,dirigida,0,0,2,2
34328,recognize,0,0,2,2
34323,назван,0,0,2,2
30765,gelden,0,0,2,2
23921,χρήση,0,0,2,2
43730,uppsatser,0,0,2,2
30762,confus,0,0,2,2
17657,compétence,0,0,2,2
43732,νάρκισα,0,0,2,2
17654,distribuído,0,0,2,2
33582,procédures,0,0,2,2
30761,algoritmes,0,0,2,2
39714,أشهر,0,0,2,2
36109,எளிதான,0,0,2,2
36106,പദാവലി,0,0,2,2
29576,carga,0,0,2,2
32355,какой,0,0,2,2
30757,vänster,0,0,2,2
17648,تستحق,0,0,2,2
29583,geleden,0,0,2,2
23542,acomodar,0,0,2,2
17639,phenomena,0,0,2,2
17638,bans,0,0,2,2
32419,संदेश,0,0,2,2
29617,νέες,0,0,2,2
35531,ಸಿಲ್ಲಿ,0,0,2,2
36079,servicios,0,0,2,2
43823,yanıyor,0,0,2,2
29652,രുചികരമായ,0,0,2,2
39935,ήξερα,0,0,2,2
43814,nde,0,0,2,2
23893,diet,0,0,2,2
17537,обозначения,0,0,2,2
29655,svare,0,0,2,2
30728,remplacement,0,0,2,2
39931,ಖಚಿತಪಡಿಸಿಕೊಳ್ಳಿ,0,0,2,2
17534,विज्ञापन,0,0,2,2
17533,группы,0,0,2,2
17531,comparou,0,0,2,2
33505,engang,0,0,2,2
36057,журнале,0,0,2,2
17520,södertörns,0,0,2,2
39724,κοινές,0,0,2,2
17518,चाहती,0,0,2,2
36056,cubrirme,0,0,2,2
36055,छवि,0,0,2,2
17509,அனைவரும்,0,0,2,2
29666,حالات,0,0,2,2
29667,leisure,0,0,2,2
29668,ஆபத்துடைய,0,0,2,2
36046,discrètes,0,0,2,2
29678,soar,0,0,2,2
29981,потом,0,0,2,2
23882,दूसरी,0,0,2,2
23881,öva,0,0,2,2
23577,heavy,0,0,2,2
35369,direct,0,0,2,2
29649,интересно,0,0,2,2
17544,страница,0,0,2,2
32362,उम्मीदवार,0,0,2,2
36078,label,0,0,2,2
23900,വിവാഹത്തിൽ,0,0,2,2
43777,bordet,0,0,2,2
17588,εξαιτίας,0,0,2,2
29623,உடனடியாக,0,0,2,2
17586,everyone,0,0,2,2
33576,परी,0,0,2,2
36075,научные,0,0,2,2
43781,τρόπους,0,0,2,2
35360,products,0,0,2,2
17580,telefoon,0,0,2,2
29627,complémentarité,0,0,2,2
39939,indicar,0,0,2,2
43786,поблагодарить,0,0,2,2
43788,degré,0,0,2,2
23897,redigeringen,0,0,2,2
17564,ഉദാഹരണമാണ്,0,0,2,2
17562,connais,0,0,2,2
43798,அழகான,0,0,2,2
23896,προφορά,0,0,2,2
29637,drüben,0,0,2,2
35366,universidades,0,0,2,2
33504,undisclosed,0,0,2,2
17554,informática,0,0,2,2
29641,floras,0,0,2,2
17552,относить,0,0,2,2
43805,സൗന്ദര്യം,0,0,2,2
35342,optimal,0,0,2,2
36123,series,0,0,2,2
30773,hang,0,0,2,2
43654,interés,0,0,2,2
43645,ಹೋಗಲು,0,0,2,2
23494,  images,0,0,2,2
23495,devoted,0,0,2,2
23979,ಬಹುತೇಕ,0,0,2,2
17779,terrível,0,0,2,2
23978,ganzen,0,0,2,2
29464,ορισμένους,0,0,2,2
30473,forkerte,0,0,2,2
29466,bloqueo,0,0,2,2
29467,வணிக,0,0,2,2
23973,californië,0,0,2,2
17771,систем,0,0,2,2
23969,affiliates,0,0,2,2
29477,ಬುದ್ದಿವಂತನಲ್ಲ,0,0,2,2
39687,”allmän,0,0,2,2
17767,princípios,0,0,2,2
39677,ajout,0,0,2,2
43657,проекту,0,0,2,2
17762,ಭೇಟಿಯಾಗಲು,0,0,2,2
35537,intereses,0,0,2,2
43659,ಹೇಳಿದರು,0,0,2,2
43661,switch,0,0,2,2
36166,miles,0,0,2,2
23501,étymologiquement,0,0,2,2
29482,கோணம்,0,0,2,2
36162,അനുമതി,0,0,2,2
23966,creativity,0,0,2,2
30802,kampen,0,0,2,2
23493,سوى,0,0,2,2
33596,सोच,0,0,2,2
33473,tidskrifter,0,0,2,2
17785,suivant,0,0,2,2
39991,inse,0,0,2,2
17818,exame,0,0,2,2
43622,السرية,0,0,2,2
23485,comédia,0,0,2,2
17816,equipe,0,0,2,2
23986,teacher,0,0,2,2
43623,gett,0,0,2,2
29436,wikiconcept,0,0,2,2
36188,ആഗ്രഹിക്കുന്നില്ല,0,0,2,2
17810,reforço,0,0,2,2
36187,nahm,0,0,2,2
30810,работа,0,0,2,2
43629,arrangement,0,0,2,2
17805,रखना,0,0,2,2
29450,sujette,0,0,2,2
43633,оригинальных,0,0,2,2
35538,noterat,0,0,2,2
29452,عربة,0,0,2,2
17797,confiture,0,0,2,2
17796,ഇനി,0,0,2,2
17795,الأعمال,0,0,2,2
17794,zilver,0,0,2,2
29454,partage,0,0,2,2
43636,ಪುನರಾವರ್ತಿಸಲು,0,0,2,2
43638,s’intéressent,0,0,2,2
43641,ले,0,0,2,2
29455,videnskabsfolk,0,0,2,2
43664,esqueça,0,0,2,2
23507,steht,0,0,2,2
23532,dualisme,0,0,2,2
34336,influences,0,0,2,2
39696,blockerades,0,0,2,2
29522,«не,0,0,2,2
43695,instituto,0,0,2,2
30479,редактируют,0,0,2,2
29523,последнее,0,0,2,2
36135,ब्रिटेनिका,0,0,2,2
29531,спрашиваю,0,0,2,2
35337,स्वभाव,0,0,2,2
36134,publics,0,0,2,2
39967,assist,0,0,2,2
17706,egoistisk,0,0,2,2
29535,ziemlich,0,0,2,2
43701,translated,0,0,2,2
39699,عشرة,0,0,2,2
29488,discuss,0,0,2,2
36131,participate,0,0,2,2
43708,adopté,0,0,2,2
23936,régulièrement,0,0,2,2
29541,öppenhet,0,0,2,2
32343,ശരാശരി,0,0,2,2
43709,envolve,0,0,2,2
39960,känd,0,0,2,2
23531,வெள்ளிக்கிழமை,0,0,2,2
17689,representación,0,0,2,2
43715,queria,0,0,2,2
17684,försökte,0,0,2,2
29549,അഭിപ്രായം,0,0,2,2
17681,лицензию,0,0,2,2
32425,исследователей,0,0,2,2
43688,dezelfde,0,0,2,2
17722,omkring,0,0,2,2
43682,എഴുതുവാനും,0,0,2,2
29490,uenig,0,0,2,2
23952,biografías,0,0,2,2
35846,noção,0,0,2,2
35326,anordnas,0,0,2,2
29492,remained,0,0,2,2
35328,durch,0,0,2,2
29500,becoming,0,0,2,2
17748,بحلول,0,0,2,2
17747,exclusivamente,0,0,2,2
35535,augmentation,0,0,2,2
36151,largely,0,0,2,2
29510,स्त्रोत,0,0,2,2
29985,correctement,0,0,2,2
29511,στους,0,0,2,2
17742,gustó,0,0,2,2
17741,डिजाइन,0,0,2,2
36145,ويكيبيديا؛,0,0,2,2
30789,خطط,0,0,2,2
29513,plek,0,0,2,2
35331,tarea,0,0,2,2
17740,sustaining,0,0,2,2
29514,fancy,0,0,2,2
23511,साबित,0,0,2,2
17734,fichiers,0,0,2,2
30787,«знания»,0,0,2,2
39972,inscrição,0,0,2,2
30782,വേഗത,0,0,2,2
23578,άλλως,0,0,2,2
29685,விரும்புவதை,0,0,2,2
34287,parís,0,0,2,2
30650,öppen,0,0,2,2
39869,dili,0,0,2,2
32400,издан,0,0,2,2
29869,naquela,0,0,2,2
17288,visitantes,0,0,2,2
30660,stiftelsen,0,0,2,2
29969,revoir,0,0,2,2
34293,quatrième,0,0,2,2
35421,viaje,0,0,2,2
34305,wortes,0,0,2,2
43992,होगा।,0,0,2,2
17280,l’étude,0,0,2,2
17279,décimo,0,0,2,2
35426,mogelijkheden,0,0,2,2
39819,ekstremt,0,0,2,2
23735,sofort,0,0,2,2
30501,gap,0,0,2,2
29874,espaço,0,0,2,2
30649,सुविधा,0,0,2,2
35428,encyclopedic,0,0,2,2
35903,helgen,0,0,2,2
39820,بحث,0,0,2,2
39867,ಅರ್ಹನೆಂದು,0,0,2,2
39822,συναντήσω,0,0,2,2
23740,स्थित,0,0,2,2
17267,verward,0,0,2,2
17266,poèmes,0,0,2,2
35900,മുകളിൽ,0,0,2,2
33535,सुभाषितों,0,0,2,2
29866,വലിപ്പം,0,0,2,2
17296,собираетесь,0,0,2,2
34306,enquête,0,0,2,2
23756,بأنها,0,0,2,2
32376,παρασκευή,0,0,2,2
23657,είχαν,0,0,2,2
32403,ಸಂದೇಶವನ್ನು,0,0,2,2
17332,ontvoering,0,0,2,2
29833,زوار,0,0,2,2
32401,aanstaande,0,0,2,2
17329,potatoes,0,0,2,2
23781,drömmen,0,0,2,2
35936,querido,0,0,2,2
43956,പിൻബലത്തോടെ,0,0,2,2
33565,procuram,0,0,2,2
35412,debated,0,0,2,2
30574,ಕಷ್ಟಪಟ್ಟು,0,0,2,2
23780,entró,0,0,2,2
17320,publiée,0,0,2,2
43962,स्कोर,0,0,2,2
23762,montrent,0,0,2,2
35928,bancaire,0,0,2,2
43963,weile,0,0,2,2
39810,مجال,0,0,2,2
43972,formel,0,0,2,2
35927,fouten,0,0,2,2
35924,éditée,0,0,2,2
39811,παρακάτω,0,0,2,2
43973,autoridad,0,0,2,2
29860,konuda,0,0,2,2
43976,लेखक,0,0,2,2
23736,propuesto,0,0,2,2
23679,nacimiento,0,0,2,2
17340,réellement,0,0,2,2
17198,yakalama,0,0,2,2
23710,ஒன்றைப்,0,0,2,2
44039,maandenlang,0,0,2,2
17209,वेब्बी,0,0,2,2
29935,privatisé,0,0,2,2
35870,विध्वंसक,0,0,2,2
17202,स्थापित,0,0,2,2
39844,fiz,0,0,2,2
29942,gradually,0,0,2,2
29943,evening,0,0,2,2
23708,¿quieres,0,0,2,2
32386,enbart,0,0,2,2
29946,ಮೂಲವನ್ನು,0,0,2,2
39845,நிறைய,0,0,2,2
17197,الفور,0,0,2,2
39829,göndereceğim,0,0,2,2
35865,opérateurs,0,0,2,2
29950,diario,0,0,2,2
30280,official,0,0,2,2
29954,നടത്തുന്നു,0,0,2,2
29955,ilgili,0,0,2,2
35862,ganska,0,0,2,2
44054,illustre,0,0,2,2
44058,मंडल,0,0,2,2
35517,പങ്കാളിത്തത്തിലൂടെ,0,0,2,2
44063,استعدت,0,0,2,2
17175,factualmente,0,0,2,2
29958,യഥാർത്ഥത്തിൽ,0,0,2,2
44067,بيانات,0,0,2,2
33545,பயன்படுகிறது,0,0,2,2
44038,courses,0,0,2,2
32385,requested,0,0,2,2
29925,விளக்குகிறது,0,0,2,2
29901,weglatingen,0,0,2,2
35892,printed,0,0,2,2
29904,μίλι,0,0,2,2
17259,المسجلين,0,0,2,2
39837,desired,0,0,2,2
33538,geschenk,0,0,2,2
35890,формального,0,0,2,2
17254,включён,0,0,2,2
35888,handlar,0,0,2,2
17251,kullanabilirsiniz,0,0,2,2
30644,manter,0,0,2,2
17250,vendredi,0,0,2,2
30641,κακό,0,0,2,2
23721,märkspråk,0,0,2,2
35887,राजनीतिज्ञ,0,0,2,2
17238,étiquette,0,0,2,2
30281,ಸ್ವರ್ಗ,0,0,2,2
44022,क्रिया,0,0,2,2
29912,wikcionário,0,0,2,2
17228,collectie,0,0,2,2
29913,chegou,0,0,2,2
29963,financer,0,0,2,2
17224,kesinlikle,0,0,2,2
23687,മാസവും,0,0,2,2
29917,anúncio,0,0,2,2
32390,påverkas,0,0,2,2
35879,pandemic,0,0,2,2
17336,kingdoms,0,0,2,2
30498,другу,0,0,2,2
29687,neveneffect,0,0,2,2
30706,«нравится»,0,0,2,2
43861,açısını,0,0,2,2
43864,mile,0,0,2,2
35385,മാതൃക,0,0,2,2
29731,рекламу,0,0,2,2
43865,insiders,0,0,2,2
23838,прошла,0,0,2,2
39762,إصدارات,0,0,2,2
33512,ശല്യപ്പെടുത്തുന്നതിൽ,0,0,2,2
43869,merezco,0,0,2,2
29736,बनाई,0,0,2,2
17450,العملية,0,0,2,2
39763,மறக்காதீர்கள்,0,0,2,2
33513,செல்வது,0,0,2,2
29742,പ്രധാനമായും,0,0,2,2
29756,conduite,0,0,2,2
39765,kibar,0,0,2,2
23828,നൽകാൻ,0,0,2,2
17443,tidsskriftets,0,0,2,2
17442,எப்போது,0,0,2,2
39768,теме,0,0,2,2
17441,diário,0,0,2,2
23826,nommé,0,0,2,2
29744,« wikipedia »,0,0,2,2
43876,வணக்கம்,0,0,2,2
17435,fingrar,0,0,2,2
29751,سألك,0,0,2,2
35998,αντίο,0,0,2,2
29755,th,0,0,2,2
29729,turns,0,0,2,2
23842,ഏതാണ്,0,0,2,2
17466,posibilidades,0,0,2,2
33572,undervisningen,0,0,2,2
17493,voluntaria,0,0,2,2
35374,rostro,0,0,2,2
30723,verwijderen,0,0,2,2
23880,διαφορετικά,0,0,2,2
29694,ليست,0,0,2,2
29698,rechaza,0,0,2,2
39741,coordination,0,0,2,2
29703,третье,0,0,2,2
23589,rubiner,0,0,2,2
39920,गोल्डन,0,0,2,2
32410,choisis,0,0,2,2
39918,وهي,0,0,2,2
23862,വിശദീകരിച്ചു,0,0,2,2
30635,"
मिन",0,0,2,2
29710,تمزح,0,0,2,2
29715,സുഹൃത്ത്,0,0,2,2
23859,consigues,0,0,2,2
23858,तुंरत,0,0,2,2
23849,pelas,0,0,2,2
39756,suena,0,0,2,2
34312,resulted,0,0,2,2
30715,incompatibles,0,0,2,2
43854,birbirlerinin,0,0,2,2
32408,morning,0,0,2,2
36011,ಕ್ರೂರ,0,0,2,2
30712,equilibradas,0,0,2,2
23605,சிறப்புக்,0,0,2,2
17429,pourraient,0,0,2,2
43885,undvika,0,0,2,2
29819,точности,0,0,2,2
39784,لفترة,0,0,2,2
17376,γνωρίζετε,0,0,2,2
35971,begann,0,0,2,2
23641,durant,0,0,2,2
33570,aprenderá,0,0,2,2
30636,savaşı,0,0,2,2
39779,परिणामों,0,0,2,2
39882,konfliktlösning,0,0,2,2
29796,राजकुमार,0,0,2,2
32372,कराया,0,0,2,2
17366,аппроксимации,0,0,2,2
17365,kleiner,0,0,2,2
17363,उसका,0,0,2,2
35963,अगले,0,0,2,2
43932,تخلق,0,0,2,2
35390,evde,0,0,2,2
23648,bonitos,0,0,2,2
43934,tijdje,0,0,2,2
35961,vandalismprone,0,0,2,2
43940,gênante,0,0,2,2
17352,attendez,0,0,2,2
23649,grundlæggende,0,0,2,2
17348,اعتقدت,0,0,2,2
29814,aktiva,0,0,2,2
23802,ഞങ്ങളുടെ,0,0,2,2
34309,لاروس,0,0,2,2
35951,paradoks,0,0,2,2
43947,verificabilidad,0,0,2,2
17343,army,0,0,2,2
30677,recibido,0,0,2,2
43916,decided,0,0,2,2
35973,தொகுப்புக்களை,0,0,2,2
29972,الادعاء,0,0,2,2
43888,paradox,0,0,2,2
23624,souligner,0,0,2,2
35391,व्यक्त,0,0,2,2
43892,financiada,0,0,2,2
43894,recommended,0,0,2,2
35992,cultlike,0,0,2,2
30697,männer,0,0,2,2
43896,filmes,0,0,2,2
23628,probabilité,0,0,2,2
39769,vrijgegeven,0,0,2,2
17412,сказали,0,0,2,2
17411,रे,0,0,2,2
17410,παίρνετε,0,0,2,2
39770,evenwichtig,0,0,2,2
35984,интернета,0,0,2,2
39774,invloed,0,0,2,2
29782,hel,0,0,2,2
17404,γρήγορη,0,0,2,2
43902,promedio,0,0,2,2
43905,universities,0,0,2,2
17399,vælges,0,0,2,2
29788,época,0,0,2,2
39777,சனவரி,0,0,2,2
29789,πάρω,0,0,2,2
35404,റൊട്ടിയും,0,0,2,2
43915,மதிப்புக்குரியது,0,0,2,2
39778,répandue,0,0,2,2
23989,annexes,0,0,2,2
17822,occasion,0,0,2,2
17824,deltagarna,0,0,2,2
30301,röra,0,0,2,2
18265,contagens,0,0,2,2
24143,രഹസ്യ,0,0,2,2
36431,manufactured,0,0,2,2
24141,posted,0,0,2,2
43344,सकें,0,0,2,2
36429,agradeciendo,0,0,2,2
33640,narzissenmutter,0,0,2,2
24138,devait,0,0,2,2
24136,случаях,0,0,2,2
30930,føler,0,0,2,2
29086,contou,0,0,2,2
29087,suggestions,0,0,2,2
30929,rápido,0,0,2,2
29093,défaut,0,0,2,2
29097,schreiben,0,0,2,2
23318,массачусетского,0,0,2,2
32445,முரண்பாடான,0,0,2,2
43355,wikier,0,0,2,2
29094,فلا,0,0,2,2
18243,amendement,0,0,2,2
23320,oft,0,0,2,2
36420,dabei,0,0,2,2
18241,पेश,0,0,2,2
18238,trabaje,0,0,2,2
43360,fransızca,0,0,2,2
23322,கேட்டபோது,0,0,2,2
36419,appeler,0,0,2,2
18231,рендеринга,0,0,2,2
30932,viktigt,0,0,2,2
43338,dagen,0,0,2,2
35242,lämpligt,0,0,2,2
30457,последний,0,0,2,2
35235,pensei,0,0,2,2
18296,sterk,0,0,2,2
30943,ആവശ്യമായ,0,0,2,2
29047,speaking,0,0,2,2
36447,ήσουν,0,0,2,2
18291,etti,0,0,2,2
33395,físico,0,0,2,2
30940,उच्च,0,0,2,2
23295,telegrama,0,0,2,2
35239,देखना,0,0,2,2
29055,اللجنة,0,0,2,2
18286,bloqueado,0,0,2,2
18285,funding,0,0,2,2
35640,birkaç,0,0,2,2
29060,agradeço,0,0,2,2
30028,архитектуры,0,0,2,2
29063,soyez,0,0,2,2
39561,power,0,0,2,2
39565,بكثير,0,0,2,2
24151,فيما,0,0,2,2
23302,ejecuta,0,0,2,2
24149,sociólogo,0,0,2,2
43332,anonyma,0,0,2,2
36437,പറഞ്ഞത്,0,0,2,2
30935,kendt,0,0,2,2
43335,ഉയർന്ന,0,0,2,2
24148,ملاحظة,0,0,2,2
18230,brutes,0,0,2,2
24134,энциклопедической,0,0,2,2
39558,அடிப்படையிலும்,0,0,2,2
18183,رسمية,0,0,2,2
36387,aplicaciones,0,0,2,2
32440,आंशिक,0,0,2,2
33405,modify,0,0,2,2
33406,miljon,0,0,2,2
36384,underlätta,0,0,2,2
36381,appellation,0,0,2,2
29160,थका,0,0,2,2
18189,ramène,0,0,2,2
29163,lacking,0,0,2,2
18187,يكتب,0,0,2,2
43389,lycka,0,0,2,2
34272,साइटों,0,0,2,2
29166,vestir,0,0,2,2
23347,tekniken,0,0,2,2
36413,dispose,0,0,2,2
30910,образуют,0,0,2,2
40077,hacen,0,0,2,2
23351,weitermachen,0,0,2,2
24114,lösning,0,0,2,2
43395,долю,0,0,2,2
35258,seas,0,0,2,2
18176,ग्रस्त,0,0,2,2
43397,trodde,0,0,2,2
35259,ಯೋಚಿಸುವುದಿಲ್ಲ,0,0,2,2
23358,similitud,0,0,2,2
36367,تناوله,0,0,2,2
30899,അമ്മയെ,0,0,2,2
23359,അതേ,0,0,2,2
43379,l’écologie,0,0,2,2
18203,φίλο,0,0,2,2
43378,στείλετε,0,0,2,2
29146,παρακαλούμε,0,0,2,2
18225,الحال,0,0,2,2
29108,εκτός,0,0,2,2
40098,øjne,0,0,2,2
34264,färre,0,0,2,2
29117,akademik,0,0,2,2
43370,vars,0,0,2,2
40096,лицо,0,0,2,2
36404,cooperación,0,0,2,2
18220,apoio,0,0,2,2
23326,focal,0,0,2,2
30921,größer,0,0,2,2
18219,philosophique,0,0,2,2
18218,स्टालमेन,0,0,2,2
40091,становятся,0,0,2,2
29127,verbets,0,0,2,2
36399,критикуют,0,0,2,2
18217,aquatic,0,0,2,2
34348,மக்கள்,0,0,2,2
36398,perte,0,0,2,2
18212,следующую,0,0,2,2
24123,كتب,0,0,2,2
36392,seasonal,0,0,2,2
30919,διαγραφών,0,0,2,2
40088,τόσα,0,0,2,2
29144,रो,0,0,2,2
43377,تحب,0,0,2,2
29145,conclusão,0,0,2,2
24160,комунибудь,0,0,2,2
29040,altofalante,0,0,2,2
23360,césar,0,0,2,2
28926,சாரும்,0,0,2,2
40145,நம்புகிறேன்,0,0,2,2
43220,rêves,0,0,2,2
24198,تدل,0,0,2,2
28912, млн,0,0,2,2
28913,autonomes,0,0,2,2
30450,else,0,0,2,2
35809,துல்லியத்தன்மை,0,0,2,2
43230,italie,0,0,2,2
43232,போதுமான,0,0,2,2
43237,കാഴ്ചപ്പാടുകൾ,0,0,2,2
24193,rikedomar,0,0,2,2
36528,تأثير,0,0,2,2
43242,seine,0,0,2,2
40140,bedöms,0,0,2,2
28949,"
we",0,0,2,2
18395,digamos,0,0,2,2
43246,ആറ്,0,0,2,2
40138,निम्न,0,0,2,2
39536,قرار,0,0,2,2
28932,born,0,0,2,2
43249,эффект,0,0,2,2
30582,देखें।,0,0,2,2
33384,ಹೇಳುತ್ತಾರೆ,0,0,2,2
35218,όλο,0,0,2,2
23264,ಕೋನವು,0,0,2,2
39539,traitant,0,0,2,2
33385,capteurs,0,0,2,2
28940,последним,0,0,2,2
36539,atualização,0,0,2,2
23252,подбодритесь,0,0,2,2
39533,"
मराठी",0,0,2,2
24202,നിരവധി,0,0,2,2
43192,mundo​,0,0,2,2
18464,ചതുപ്പുനിലം,0,0,2,2
28874,verdiene,0,0,2,2
28877,sat,0,0,2,2
43196,تغطيني,0,0,2,2
39531,gehts,0,0,2,2
35212,veio,0,0,2,2
33659,sentindo,0,0,2,2
40155,அழகாகவும்,0,0,2,2
36556,மாற்றங்களை,0,0,2,2
35638,hallan,0,0,2,2
43199,ناجحًا,0,0,2,2
28886,yapacak,0,0,2,2
24203,boğuldum,0,0,2,2
43202,convective,0,0,2,2
36555,proportion,0,0,2,2
18444,கட்டுரைகளில்,0,0,2,2
43209,gestion,0,0,2,2
40151,усерднее,0,0,2,2
33655,kelimesi,0,0,2,2
18436,neurosciences,0,0,2,2
28896,لأول,0,0,2,2
43214,área,0,0,2,2
18434,principer,0,0,2,2
36549,prontitud,0,0,2,2
43215,ಪಾಠಗಳನ್ನು,0,0,2,2
36544,considerar,0,0,2,2
40134,containing,0,0,2,2
18379,ತಾನು,0,0,2,2
29036,yeterli,0,0,2,2
43301,сильно,0,0,2,2
43292,classify,0,0,2,2
28993,kelimeleri,0,0,2,2
40124,സ്വാതന്ത്ര്യവും,0,0,2,2
18330,fique,0,0,2,2
18329,rädsla,0,0,2,2
40122,начал,0,0,2,2
39548,النطق,0,0,2,2
24174,aspectos,0,0,2,2
43297,existentes,0,0,2,2
36470,resource,0,0,2,2
29013,nosso,0,0,2,2
24168,खाते,0,0,2,2
30032,ಇನ್ನೊಂದನ್ನು,0,0,2,2
18318,думаешь,0,0,2,2
43257,structures,0,0,2,2
35029,формально,0,0,2,2
29019,pare,0,0,2,2
36464,vejo,0,0,2,2
24166,отметил,0,0,2,2
18315,തർക്കങ്ങൾ,0,0,2,2
43308,typical,0,0,2,2
29026,baixo,0,0,2,2
33641,impersonation,0,0,2,2
23290,unmatched,0,0,2,2
29031,بأكثر,0,0,2,2
36457,ആവർത്തിക്കാൻ,0,0,2,2
36455,കൂടിക്കാഴ്‌ച,0,0,2,2
36454,anayasa,0,0,2,2
36483,विशेषज्ञों,0,0,2,2
43289,forêt,0,0,2,2
33387,numera,0,0,2,2
39545,kopen,0,0,2,2
43258,stötte,0,0,2,2
18375,expressed,0,0,2,2
28950,குளிர்ச்சியாக,0,0,2,2
18374,birinden,0,0,2,2
43261,neutral»,0,0,2,2
28951,награда,0,0,2,2
43264,energética,0,0,2,2
36512,нередко,0,0,2,2
28955,publicación,0,0,2,2
30968,contrôler,0,0,2,2
30967,ναρκίσσου,0,0,2,2
28956,encontrou,0,0,2,2
40131,स्पष्ट,0,0,2,2
28965,глаза,0,0,2,2
28968,episodes,0,0,2,2
43272,automatizado,0,0,2,2
43273,சொல்கிறேன்,0,0,2,2
34359,κάνοντας,0,0,2,2
36502,φέρω,0,0,2,2
43280,naturelle,0,0,2,2
43282,ಚಿಕಿತ್ಸೆ,0,0,2,2
40128,ಮನಸ್ಸಿನಲ್ಲಿ,0,0,2,2
36497,എന്തുകൊണ്ടാണ്,0,0,2,2
36494,வீடியோவின்,0,0,2,2
18345,heter,0,0,2,2
23277,voorbeeld,0,0,2,2
36489,comidas,0,0,2,2
43400,draußen,0,0,2,2
18166,परिणामस्वरूप,0,0,2,2
43617,sag,0,0,2,2
24015,πρόγραμμα,0,0,2,2
35654,बड़ा,0,0,2,2
43542,ഇതിനർത്ഥം,0,0,2,2
30841,rapporte,0,0,2,2
29364,desenvolvido,0,0,2,2
17948,l’environnement,0,0,2,2
36239,documentaire,0,0,2,2
23448,முடியாமல்,0,0,2,2
29368,identifier,0,0,2,2
29993,multilingual,0,0,2,2
32325,മാറ്റം,0,0,2,2
36234,संचालन,0,0,2,2
17933,sowohl,0,0,2,2
33449,கணக்குகள்,0,0,2,2
30465,удачи,0,0,2,2
17901,ótima,0,0,2,2
43556,fundamental,0,0,2,2
29373,doute,0,0,2,2
33450,gerek,0,0,2,2
29380,aren,0,0,2,2
40009,बोलना,0,0,2,2
17915,बच्चों,0,0,2,2
17914,περιμένατε,0,0,2,2
29387,jourlà,0,0,2,2
17911,« l,0,0,2,2
30833,simplesmente,0,0,2,2
43570,تذهب,0,0,2,2
30829,geweigerd,0,0,2,2
24007,लेकर,0,0,2,2
17955,kæreste,0,0,2,2
17959,seguida,0,0,2,2
35652,contexto,0,0,2,2
17962,schaffen,0,0,2,2
36269,വാരാന്ത്യത്തിൽ,0,0,2,2
23427,vandaan,0,0,2,2
30855,bonnes,0,0,2,2
23429,coup,0,0,2,2
23431,publicidade,0,0,2,2
29327,duración,0,0,2,2
29329,संशोधित,0,0,2,2
36263,تأسيسها,0,0,2,2
24043,migrating,0,0,2,2
30850,—«wikipedia,0,0,2,2
17988,pequena,0,0,2,2
24037,ಮನೆಯಲ್ಲಿ,0,0,2,2
29333,pr,0,0,2,2
17985,أدناه,0,0,2,2
35297,giver,0,0,2,2
17980,existantes,0,0,2,2
36259,språkversionerna,0,0,2,2
23437,കഴിഞ്ഞ്,0,0,2,2
29998,ಅಡಿಯಲ್ಲಿ,0,0,2,2
17974,കിടക്കുന്ന,0,0,2,2
30845,удаления,0,0,2,2
36253,« apprentissage,0,0,2,2
43528,cambrian,0,0,2,2
30462,poussé,0,0,2,2
40023,बताते,0,0,2,2
36249,accordent,0,0,2,2
17966,ride,0,0,2,2
34338,परिष्कृत,0,0,2,2
23463,cautions,0,0,2,2
33443,perfect,0,0,2,2
17850,ação,0,0,2,2
36209,compétences,0,0,2,2
29410,banque,0,0,2,2
29411,тесно,0,0,2,2
17858,secondary,0,0,2,2
30819,एंड,0,0,2,2
43599,transfer,0,0,2,2
29412,demandé,0,0,2,2
17853,besef,0,0,2,2
17852,moles,0,0,2,2
39663,λεξιλόγιό,0,0,2,2
23480,computadores,0,0,2,2
30818,racist,0,0,2,2
30813,mittagessen,0,0,2,2
29416,sprekend,0,0,2,2
23464,running,0,0,2,2
39994,fundamentales,0,0,2,2
29417,agency,0,0,2,2
43604,جميعًا,0,0,2,2
36206,ينتهك,0,0,2,2
17839,ಶಬ್ದಕೋಶವನ್ನು,0,0,2,2
43609,छवियों,0,0,2,2
29427,λοιπόν,0,0,2,2
43611,മാറി,0,0,2,2
17835,وجدت,0,0,2,2
17831,continues,0,0,2,2
36197,början,0,0,2,2
35317,मूल्यांकन,0,0,2,2
35844,الأستاذ,0,0,2,2
17859,komm,0,0,2,2
17861,derived,0,0,2,2
17863,mentalt,0,0,2,2
23993,sensitivity,0,0,2,2
43576,أولئك,0,0,2,2
17899,display,0,0,2,2
30828,المؤسس,0,0,2,2
40005,write,0,0,2,2
33452,सूत्रों,0,0,2,2
40004,клеток,0,0,2,2
43578,يفعل,0,0,2,2
40002,banning,0,0,2,2
17894,percepção,0,0,2,2
40000,بشيء,0,0,2,2
30274,tillfälliga,0,0,2,2
24002,loslegen,0,0,2,2
35437,trabajos,0,0,2,2
33608,tiende,0,0,2,2
33607,नियंत्रण,0,0,2,2
30826,grappige,0,0,2,2
43584,fiil,0,0,2,2
17881,weeds,0,0,2,2
17877,ಬೆಳಗಿದೆ,0,0,2,2
17875,manden,0,0,2,2
17874,protocol,0,0,2,2
36217,இன்னும்,0,0,2,2
23997,release,0,0,2,2
30469,soll,0,0,2,2
23996,gerade,0,0,2,2
30820,ಕನಸಿನ,0,0,2,2
34337,ഇല്ലാത്തതിനാൽ,0,0,2,2
36270,thuiskwam,0,0,2,2
36272,കൊണ്ടാണ്,0,0,2,2
32318,statuts,0,0,2,2
24101,إس,0,0,2,2
36337,bekannt,0,0,2,2
18116,மூழ்கி,0,0,2,2
36332,openness,0,0,2,2
33417,historiadores,0,0,2,2
43434,varandra,0,0,2,2
18113,ಕೇಳಿದ್ದೇನೆ,0,0,2,2
36331,gostou,0,0,2,2
36330,descending,0,0,2,2
18107,добавления,0,0,2,2
29230,حادة,0,0,2,2
23387,tantas,0,0,2,2
43444,жениться,0,0,2,2
23388,മനോഹരമായി,0,0,2,2
18095,வந்தீர்கள்,0,0,2,2
18079,ووجدوا,0,0,2,2
35271,olduğunuzu,0,0,2,2
29233,février,0,0,2,2
35272,इण्टरनेट,0,0,2,2
24094,समस्या,0,0,2,2
24093,образ,0,0,2,2
39599,jättebra,0,0,2,2
29234,التعريف,0,0,2,2
29239,informou,0,0,2,2
35648,جذر,0,0,2,2
43455,يدفع,0,0,2,2
43458,clasificadores,0,0,2,2
24089,preparado,0,0,2,2
40049,säg,0,0,2,2
24102,propiedad,0,0,2,2
43429,لشركة,0,0,2,2
24103,bekæmpe,0,0,2,2
33413,comportamientos,0,0,2,2
24113,förtydliga,0,0,2,2
18162,slet,0,0,2,2
23363,operating,0,0,2,2
34273,stel,0,0,2,2
29191,antielitism,0,0,2,2
18157,wortel,0,0,2,2
33408,installed,0,0,2,2
39587,mediawikiservern,0,0,2,2
43409,illegal,0,0,2,2
18150,autriche,0,0,2,2
18147,opdrachten,0,0,2,2
33410,ну,0,0,2,2
40059,lessons,0,0,2,2
18137,recebendo,0,0,2,2
18136,приятного,0,0,2,2
43421,крупным,0,0,2,2
35512,समावेश,0,0,2,2
23381,western,0,0,2,2
18132,travel,0,0,2,2
43424,الهدف,0,0,2,2
24106,அப்படி,0,0,2,2
30631,الشكوى,0,0,2,2
36346,​​om,0,0,2,2
30581,borrowed,0,0,2,2
35820,ലേഖനങ്ങളെഴുതിയ,0,0,2,2
36342,الآلة,0,0,2,2
29216,ställe,0,0,2,2
24084,παίρνεις,0,0,2,2
43460,concluded,0,0,2,2
43508,dinner,0,0,2,2
30860,അമ്മയും,0,0,2,2
30005,பேசிக்கொண்டிருக்கலாம்,0,0,2,2
29275,марион,0,0,2,2
29281,дома,0,0,2,2
36294,konuşmak,0,0,2,2
43481,يجري,0,0,2,2
23414,значок,0,0,2,2
43483,banken,0,0,2,2
23417,ಅಸಮಾಧಾನ,0,0,2,2
29288,publicly,0,0,2,2
30290,cieux,0,0,2,2
36284,осуществлён,0,0,2,2
29300,lagen,0,0,2,2
18027,अखबार,0,0,2,2
43493,gebracht,0,0,2,2
30269,squared,0,0,2,2
18023,eder,0,0,2,2
29307,സുന്ദരനുമാണ്,0,0,2,2
23420,artists,0,0,2,2
23421,மெல்லியாக,0,0,2,2
36279,கட்டுரைகளைக்,0,0,2,2
43497,فارما,0,0,2,2
43498,utvecklade,0,0,2,2
33442,स्कूल,0,0,2,2
24049,étymologie,0,0,2,2
43504,famosos,0,0,2,2
35834,incapazes,0,0,2,2
24048,relaciones,0,0,2,2
18006,freitag,0,0,2,2
18047,शेष,0,0,2,2
29274,αποτέλεσμα,0,0,2,2
18049,profesionales,0,0,2,2
33431,അമ്മയോട്,0,0,2,2
29247,bize,0,0,2,2
18076,confiabilidade,0,0,2,2
29250,historien,0,0,2,2
43463,исключительно,0,0,2,2
33422,أنحاء,0,0,2,2
36318,നൂപീഡിയ,0,0,2,2
29252,hänger,0,0,2,2
36317,llevamos,0,0,2,2
23398,принятия,0,0,2,2
35284,reclamar,0,0,2,2
29261,रखना।,0,0,2,2
24081,comedy,0,0,2,2
43467,увижу,0,0,2,2
18065,ali,0,0,2,2
35285,repositório,0,0,2,2
24073,adresse,0,0,2,2
39612,സ്യൂവ്,0,0,2,2
30871,ανησυχούσε,0,0,2,2
33426,അടിസ്ഥാന,0,0,2,2
29266,drives,0,0,2,2
18055,ಚಂದಾದಾರ,0,0,2,2
24070,الشديد,0,0,2,2
43474,расстраивался,0,0,2,2
23403,назвать,0,0,2,2
33623,allebei,0,0,2,2
24065,recuerde,0,0,2,2
39618,получает,0,0,2,2
27973,encountered,0,0,2,2
42502,progressivement,0,0,2,2
42608,kurallarına,0,0,2,2
41559,побуждает,0,0,2,2
21093,hazards,0,0,2,2
31798,macs,0,0,2,2
22221,competition,0,0,2,2
32871,recebe,0,0,2,2
21085,fire,0,0,2,2
26497,rockar,0,0,2,2
21082,antisocial,0,0,2,2
38081,सेंटर,0,0,2,2
22229,തുടർച്ചയായി,0,0,2,2
40823,internettet,0,0,2,2
25328,sabah,0,0,2,2
32876,tusentals,0,0,2,2
22234,политик,0,0,2,2
21069,उपस्थित,0,0,2,2
41544,estadunidense,0,0,2,2
30168,القائمة,0,0,2,2
30167,gelişmesi,0,0,2,2
34109,ndesanjo,0,0,2,2
25326,édition,0,0,2,2
32878,большая,0,0,2,2
32884,mathématicien,0,0,2,2
40817,krijg,0,0,2,2
25325,английских,0,0,2,2
32886,lindo,0,0,2,2
40815,gehe,0,0,2,2
21058,pageviews,0,0,2,2
33963,motsats,0,0,2,2
40814,ഉത്തരവും,0,0,2,2
34106,populære,0,0,2,2
30170,cümleyi,0,0,2,2
41618,ஆய்வின்,0,0,2,2
41529,संगठनों,0,0,2,2
41519,voorbeeldzinnen,0,0,2,2
25355,उत्पन्न,0,0,2,2
41520,അതായത്‌,0,0,2,2
31817,सुनें।,0,0,2,2
33978,острого,0,0,2,2
26456,पागल,0,0,2,2
40836,hoop,0,0,2,2
26463,sektioner,0,0,2,2
38786,പ്രൈമറി,0,0,2,2
38789,தற்போது,0,0,2,2
32864,befinden,0,0,2,2
32115,diagnostic,0,0,2,2
32866,அனைத்து,0,0,2,2
26469,sereno,0,0,2,2
26485,സ്വർഗ്ഗം,0,0,2,2
22210,احتلت,0,0,2,2
38097,udelukkende,0,0,2,2
38096,lezzetli,0,0,2,2
41530,парень,0,0,2,2
26475,الأكادميين,0,0,2,2
26476,akademiske,0,0,2,2
38094,acontecem,0,0,2,2
21109,informatiques,0,0,2,2
25347,raffiniert,0,0,2,2
41537,birbirlerine,0,0,2,2
25345,conhece,0,0,2,2
41538,सैनिकों,0,0,2,2
41539,شهرة,0,0,2,2
22244,должно,0,0,2,2
34113,ήρθαν,0,0,2,2
26509,уэйлсу,0,0,2,2
31770,relying,0,0,2,2
26532,noot,0,0,2,2
25307,intéressé,0,0,2,2
21009,puisse,0,0,2,2
38820,domínio,0,0,2,2
40800,artículos—,0,0,2,2
34475,bankkredit,0,0,2,2
21004,ιδρυτή,0,0,2,2
25304,бизнесе,0,0,2,2
21002,കൈകാര്യം,0,0,2,2
21001,conclusions,0,0,2,2
38058,fanns,0,0,2,2
32662,wikification,0,0,2,2
20998,ميزات,0,0,2,2
22272,metabolism,0,0,2,2
26512,conocido,0,0,2,2
40782,unreliable,0,0,2,2
20989,ಸೂಚಿಸಲು,0,0,2,2
38055,étudient,0,0,2,2
32898,idén,0,0,2,2
41610,августа,0,0,2,2
20982,வாங்க,0,0,2,2
20980,журнал,0,0,2,2
26557,सामान,0,0,2,2
38831,ಡಿಗ್ರಿಗಳಿಗಿಂತ,0,0,2,2
41614,आदि,0,0,2,2
32900,базой,0,0,2,2
25284,موقف,0,0,2,2
25283,وأن,0,0,2,2
34687,عطلة,0,0,2,2
21012,अर्न्तगत,0,0,2,2
21013,ಸರಿಯಾಗಿ,0,0,2,2
21019,önemi,0,0,2,2
40813,iniciado,0,0,2,2
22249,имели,0,0,2,2
21049,suggests,0,0,2,2
41573,smile,0,0,2,2
38072,maand,0,0,2,2
41575,существуют,0,0,2,2
21041,parada,0,0,2,2
22251,बोमिस,0,0,2,2
34682,technologies,0,0,2,2
32890,दस्तावेज़,0,0,2,2
40805,académico,0,0,2,2
38067,improved,0,0,2,2
41576,mens,0,0,2,2
41577,rode,0,0,2,2
26523,skaffe,0,0,2,2
31783,suédois,0,0,2,2
26524,håber,0,0,2,2
38065,parvient,0,0,2,2
26527,فما,0,0,2,2
25312,سروري,0,0,2,2
26529,വൈകുന്നേരം,0,0,2,2
26530,proposent,0,0,2,2
34684,suisse,0,0,2,2
34685,ولكنك,0,0,2,2
21023,ister,0,0,2,2
32896,missão,0,0,2,2
21021,ലേഖനത്തിൽ,0,0,2,2
21136,redacteuren,0,0,2,2
26444,enviados,0,0,2,2
21138,المتطوعين,0,0,2,2
41441,الإعجاب,0,0,2,2
25387,lieverd,0,0,2,2
33994,दिसम्बर,0,0,2,2
1,f,2,1,1,2
26353,revertir,0,0,2,2
22165,தகவல்கள்,0,0,2,2
22167,colaborativo,0,0,2,2
21261,привести,0,0,2,2
26356,promovido,0,0,2,2
34484,σίγουροι,0,0,2,2
21259,« d,0,0,2,2
21256,viktiga,0,0,2,2
22172,seinem,0,0,2,2
26362,أعلى,0,0,2,2
26363,கூறுகிறீர்கள்,0,0,2,2
21230,numarası,0,0,2,2
25384,officiellement,0,0,2,2
41443,निर्धारित,0,0,2,2
41444,tomada,0,0,2,2
31846,enfatizar,0,0,2,2
21245,accordingly,0,0,2,2
25382,سخيف,0,0,2,2
40854,بعيدًا,0,0,2,2
38771,الإسبانية,0,0,2,2
21242,воспитанный,0,0,2,2
21238,красота,0,0,2,2
41451,presentes,0,0,2,2
21235,لدرجة,0,0,2,2
31845,بالكاد,0,0,2,2
25389,chamber,0,0,2,2
30175,dentre,0,0,2,2
21270,consulted,0,0,2,2
22158,രാഷ്ട്രീയ,0,0,2,2
34621,ampliación,0,0,2,2
26289,ofrecer,0,0,2,2
25401,poised,0,0,2,2
38759,parliament,0,0,2,2
30345,معرفة,0,0,2,2
41407,estabelecido,0,0,2,2
26296,annoncerede,0,0,2,2
41409,τζίμι,0,0,2,2
25397,സാഹചര്യം,0,0,2,2
41410,correctly,0,0,2,2
30176,बेवकूफ़,0,0,2,2
40871,vores,0,0,2,2
38200,surrounding,0,0,2,2
22152,blij,0,0,2,2
32689,tendem,0,0,2,2
26317,schule,0,0,2,2
38188,acceptées,0,0,2,2
31859,май,0,0,2,2
31858,ipucu,0,0,2,2
26335,المهام,0,0,2,2
41421,tecnológicos,0,0,2,2
21279,хлеба,0,0,2,2
31855,duyduğunuzda,0,0,2,2
21277,الناس,0,0,2,2
38176,πάτε,0,0,2,2
31854,unregistered,0,0,2,2
41425,soi,0,0,2,2
21233,användarna,0,0,2,2
25379,pornography,0,0,2,2
38113,hagas,0,0,2,2
26430,düğmesine,0,0,2,2
22186,تلفظ,0,0,2,2
32684,മറ്റെന്തെങ്കിലും,0,0,2,2
35480,главный,0,0,2,2
31834,ബാങ്ക്,0,0,2,2
22194,problemer,0,0,2,2
21179,rigdom,0,0,2,2
41487,négative,0,0,2,2
38777,കരുതി,0,0,2,2
34649,essay,0,0,2,2
31832,بمدى,0,0,2,2
21169,görüşürüz,0,0,2,2
22197,classificada,0,0,2,2
38120,impresionante,0,0,2,2
34651,ground,0,0,2,2
21225,proposed,0,0,2,2
30171,neemt,0,0,2,2
25361,όνομά,0,0,2,2
38782,θέματος,0,0,2,2
41499,deleted,0,0,2,2
31827,حلمي,0,0,2,2
31826,quotes,0,0,2,2
31823,verdi,0,0,2,2
26436,python,0,0,2,2
41504,atributos,0,0,2,2
40839,eet,0,0,2,2
38115,ultraviolet,0,0,2,2
21146,électronique,0,0,2,2
32858,ഇതിലൂടെ,0,0,2,2
21188,venha,0,0,2,2
38130,obscur,0,0,2,2
26414,தயாராக,0,0,2,2
21191,possam,0,0,2,2
34645,limité,0,0,2,2
41460,फिल्म,0,0,2,2
21220,நினைக்கவில்லை,0,0,2,2
26384,opnieuw,0,0,2,2
25378,सर्वोत्तम,0,0,2,2
30368,தேவை,0,0,2,2
22179,latijnse,0,0,2,2
30344,journalist,0,0,2,2
33987,ikiniz,0,0,2,2
21210,sextafeira,0,0,2,2
38146,ടെറി,0,0,2,2
33986,riparian,0,0,2,2
38144,ഒരുമിച്ച്,0,0,2,2
26397,soldater,0,0,2,2
38138,generellt,0,0,2,2
38137,बदला,0,0,2,2
21205,kullanım,0,0,2,2
41471,തോന്നുന്നതിനുള്ള,0,0,2,2
25377,excepcionalmente,0,0,2,2
32114,shape,0,0,2,2
26403,propensos,0,0,2,2
21200,collect,0,0,2,2
21198,religieuses,0,0,2,2
26404,brittisk,0,0,2,2
31836,تنزعج,0,0,2,2
38132,skriv,0,0,2,2
25370,صديقي,0,0,2,2
20973,primer,0,0,2,2
20970,हास्य,0,0,2,2
21306,juli,0,0,2,2
26742,ruso,0,0,2,2
30590,ആദ്യത്തെ,0,0,2,2
37939,кредит,0,0,2,2
20764,syftet,0,0,2,2
41750,وتمييز,0,0,2,2
20760,kritikerna,0,0,2,2
37937,tendencias,0,0,2,2
37935,கிடைத்தது,0,0,2,2
20755,reputation,0,0,2,2
22343,உருவாக்கும்,0,0,2,2
34731,godkännande,0,0,2,2
26738,estaban,0,0,2,2
32635,उल्लेख,0,0,2,2
37931,départ,0,0,2,2
26743,verabschieden,0,0,2,2
25180,mooie,0,0,2,2
20749,καλέσετε,0,0,2,2
31710,móvil,0,0,2,2
37929,enseignement,0,0,2,2
32149,saudiarabien,0,0,2,2
20745,நினைத்தேன்,0,0,2,2
34448,princesa,0,0,2,2
20743,artikelns,0,0,2,2
20742,சனிக்கிழமையன்று,0,0,2,2
20740,spokesman,0,0,2,2
34138,letter,0,0,2,2
26751,പദങ്ങളുടെ,0,0,2,2
20733,repeatedly,0,0,2,2
20732,λιγότερο,0,0,2,2
26718,perteneciente,0,0,2,2
20771,добро,0,0,2,2
38050,abuse,0,0,2,2
38897,objeto,0,0,2,2
37971,gerekirse,0,0,2,2
37970,wisdom,0,0,2,2
26692,gustaría,0,0,2,2
31718,parmaklar,0,0,2,2
20804,प्राथमिक,0,0,2,2
20803,സംഭാവന,0,0,2,2
26693,ಗಾಡಿ,0,0,2,2
33936,лицензиями,0,0,2,2
41727,الأنماط,0,0,2,2
26694,الصور,0,0,2,2
31717,diffuser,0,0,2,2
34133,പരസ്പരം,0,0,2,2
32928,свободен,0,0,2,2
41735,posee,0,0,2,2
20772,واراي,0,0,2,2
32930,kaum,0,0,2,2
20787,essenciais,0,0,2,2
37961,latines,0,0,2,2
26704,dromen,0,0,2,2
26708,glass,0,0,2,2
32931,incoming,0,0,2,2
25189,ಬಂದಿದ್ದೀರಿ,0,0,2,2
33931,servent,0,0,2,2
22330,ato,0,0,2,2
20780,etnologiämnet,0,0,2,2
31712,belirtilmeli,0,0,2,2
40749,جدا,0,0,2,2
41743,parlementaire,0,0,2,2
38916,ενώ,0,0,2,2
37922,ഭയാനകമായ,0,0,2,2
32152,langsom,0,0,2,2
37877,suivi,0,0,2,2
22377,pedido,0,0,2,2
38931,pronunciando,0,0,2,2
33928,लिये,0,0,2,2
26798,जल्द,0,0,2,2
22379,private,0,0,2,2
41795,viés,0,0,2,2
26800,doorgeven,0,0,2,2
25140,natifs,0,0,2,2
25139,knappt,0,0,2,2
31698,ഇന്ത്യൻഭാഷകളിലും,0,0,2,2
37889,pilares,0,0,2,2
26810,الحرية,0,0,2,2
26819,parfaite,0,0,2,2
32948,brincando,0,0,2,2
32941,первые,0,0,2,2
22387,acht,0,0,2,2
20673,wachten,0,0,2,2
41806,hareket,0,0,2,2
20669,zitten,0,0,2,2
31697,выделенных,0,0,2,2
25136,oraya,0,0,2,2
37872,относительно,0,0,2,2
41807,vital,0,0,2,2
34739,langzamer,0,0,2,2
20663,nariz,0,0,2,2
31693,словарный,0,0,2,2
22395,flinke,0,0,2,2
22396,glöm,0,0,2,2
41789,usted,0,0,2,2
20693,correcting,0,0,2,2
40717,kâr,0,0,2,2
20698,இல்லையென்றால்,0,0,2,2
26759,κλαίνε,0,0,2,2
31707,risque,0,0,2,2
26764,лицензией,0,0,2,2
30150,oye,0,0,2,2
41770,λόγους,0,0,2,2
32942,sorunlu,0,0,2,2
20717,bevor,0,0,2,2
25153,പരിചയം,0,0,2,2
41778,mágicos,0,0,2,2
32943,சோதனையில்,0,0,2,2
25152,skolan,0,0,2,2
20711,centre,0,0,2,2
20710,manutenção,0,0,2,2
20709,cuidadosamente,0,0,2,2
26775,ενδιαφέρει,0,0,2,2
30149,रिचर्ड,0,0,2,2
32158,significados,0,0,2,2
20706,tchèque,0,0,2,2
26779,enlace,0,0,2,2
38922,increases,0,0,2,2
20702,cross,0,0,2,2
22361,considérablement,0,0,2,2
40725,reliability,0,0,2,2
22370,ഉള്ളടക്കവും,0,0,2,2
38925,fikir,0,0,2,2
26793,beror,0,0,2,2
38930,stakkels,0,0,2,2
20812,الرياضيات,0,0,2,2
31719,magnífico,0,0,2,2
20814,erzogen,0,0,2,2
26601,cualquiera,0,0,2,2
34128,escuche,0,0,2,2
38029,citoyens,0,0,2,2
20932,രൂപത്തിൽ,0,0,2,2
20931,ರಾಜಕುಮಾರ,0,0,2,2
22306,correo,0,0,2,2
20929,abonner,0,0,2,2
20928,சொர்க்கம்,0,0,2,2
26598,tekniskt,0,0,2,2
26599,producir,0,0,2,2
20924,höja,0,0,2,2
33955,فظيع,0,0,2,2
20917,حالك؟,0,0,2,2
41653,இயங்கும்,0,0,2,2
20914,يشجع,0,0,2,2
41674,ദൈവമേ,0,0,2,2
40766,quão,0,0,2,2
38020,varsa,0,0,2,2
38016,princip,0,0,2,2
25236,försöker,0,0,2,2
38015,الموجود,0,0,2,2
33954,leende,0,0,2,2
38868,അടിസ്ഥാനം,0,0,2,2
20904,قوله,0,0,2,2
26617,fördröjs,0,0,2,2
25232,l’accès,0,0,2,2
41662,alter,0,0,2,2
41667,directions,0,0,2,2
40761,ökar,0,0,2,2
25242,kritiken,0,0,2,2
38031,domain,0,0,2,2
38860,hämtar,0,0,2,2
26588,effectué,0,0,2,2
26562,பயன்படுத்தப்படுகிறது,0,0,2,2
26564,сидела,0,0,2,2
34122,பெறவில்லை,0,0,2,2
31763,അതുകൊണ്ടുതന്നെ,0,0,2,2
20966,grecs,0,0,2,2
34696,लगी,0,0,2,2
32901,harmful,0,0,2,2
20964,relied,0,0,2,2
38835,vectores,0,0,2,2
26570,telle,0,0,2,2
41627,passait,0,0,2,2
25275,ensaio,0,0,2,2
38042,спрашивает,0,0,2,2
41629,tabeller,0,0,2,2
41632,députés,0,0,2,2
25272,εκκαθάρισης,0,0,2,2
26575,kontroversielle,0,0,2,2
25269,gitmeliyim,0,0,2,2
32121,sex,0,0,2,2
25265,चूंकि,0,0,2,2
20947,erróneos,0,0,2,2
38040,raisonné,0,0,2,2
41637,அவர்களின்,0,0,2,2
26584,géographiques,0,0,2,2
20944,judío,0,0,2,2
20943,glem,0,0,2,2
41639,lektionen,0,0,2,2
34704,abonneerknop,0,0,2,2
31751,lente,0,0,2,2
26685,aient,0,0,2,2
38889,conexión,0,0,2,2
37989,minhas,0,0,2,2
37987,acte,0,0,2,2
38883,υπάρχουν,0,0,2,2
26664,perception,0,0,2,2
26666,portail,0,0,2,2
32645,vandalizme,0,0,2,2
25210,homens,0,0,2,2
31731,darle,0,0,2,2
26669,sugerencias,0,0,2,2
33944,sylt,0,0,2,2
37985,gelen,0,0,2,2
41706,contributor,0,0,2,2
37981,journals,0,0,2,2
20830,качества,0,0,2,2
38009,déterminant,0,0,2,2
41713,hänvisar,0,0,2,2
25204,ಯಾವುದು,0,0,2,2
30378,വർഗ്ഗ,0,0,2,2
34463,ومدى,0,0,2,2
26678,университета,0,0,2,2
25199,matemáticas,0,0,2,2
37977,ಬೆಳಿಗ್ಗೆ,0,0,2,2
34460,forfærdelig,0,0,2,2
20822,vídeos,0,0,2,2
30379,overgenomen,0,0,2,2
20820,تتم,0,0,2,2
26683,transphobie,0,0,2,2
33943,negatief,0,0,2,2
20849,verdens,0,0,2,2
30153,conter,0,0,2,2
31737,climatiques,0,0,2,2
31739,மந்தமாக,0,0,2,2
40760,базовые,0,0,2,2
26633,названием,0,0,2,2
20883,പഠനം,0,0,2,2
38870,seiner,0,0,2,2
38871,déterminer,0,0,2,2
20876,strategy,0,0,2,2
41684,zouden,0,0,2,2
41685,فظيعًا,0,0,2,2
31744,शब्दावली,0,0,2,2
32909,factually,0,0,2,2
31743,évidents,0,0,2,2
38005,burden,0,0,2,2
26638,சோர்வடையவில்லை,0,0,2,2
31742,sonunda,0,0,2,2
20865,begonnen,0,0,2,2
38002,lending,0,0,2,2
20862,pédagogique,0,0,2,2
26643,programmes,0,0,2,2
20861,αγόρι,0,0,2,2
38001,балл,0,0,2,2
37999,ಆಹಾರವನ್ನು,0,0,2,2
37996,மாற,0,0,2,2
37995,शुरुआत,0,0,2,2
33948,består,0,0,2,2
33945,tråkiga,0,0,2,2
20856,अपाचे,0,0,2,2
26656,stoppede,0,0,2,2
26279,modifying,0,0,2,2
26277,книгу,0,0,2,2
33773,köpa,0,0,2,2
40978,fed,0,0,2,2
40987,övervaka,0,0,2,2
41165,pegou,0,0,2,2
21686,التحقق,0,0,2,2
40985,igår,0,0,2,2
21682,εμπειρία,0,0,2,2
30352,береги,0,0,2,2
21978,aanbieden,0,0,2,2
32073,मेटा,0,0,2,2
38657,dictionnaire,0,0,2,2
32003,demais,0,0,2,2
32002,cuatro,0,0,2,2
25895,आवश्यक,0,0,2,2
25554,dum,0,0,2,2
25544,moeite,0,0,2,2
38656,clicking,0,0,2,2
41176,zenodot,0,0,2,2
25900,artificiales,0,0,2,2
25902,mermelada,0,0,2,2
32762,antwoord,0,0,2,2
25903,tornouse,0,0,2,2
38453,kullanıcıların,0,0,2,2
21663,inscription,0,0,2,2
35462,arriver,0,0,2,2
21989,proposée,0,0,2,2
21659,wikitext,0,0,2,2
41187,fıkra,0,0,2,2
38668,världens,0,0,2,2
21652,карете,0,0,2,2
30207,traité,0,0,2,2
25557,mannelijk,0,0,2,2
22024,വേണ്ട,0,0,2,2
25860,εσύ,0,0,2,2
21735,valores,0,0,2,2
21734,крупные,0,0,2,2
38641,professores,0,0,2,2
21731,honger,0,0,2,2
38643,चलाने,0,0,2,2
21729,pertinent,0,0,2,2
41144,ಮೂಲ,0,0,2,2
21959,आहार,0,0,2,2
25851,وبعض,0,0,2,2
40992,arreglar,0,0,2,2
41150,conscience,0,0,2,2
34505,thin,0,0,2,2
25576,representan,0,0,2,2
25573,descrição,0,0,2,2
25561,precisos,0,0,2,2
32008,tabii,0,0,2,2
25569,dizaines,0,0,2,2
38471,السياسية,0,0,2,2
41159,médical,0,0,2,2
35695,sofistike,0,0,2,2
21704,மொழிகளிலும்,0,0,2,2
41160,ocorreu,0,0,2,2
25870,காலத்தில்,0,0,2,2
21701,ഇത്തരത്തിൽ,0,0,2,2
25875,سيجنثالر،,0,0,2,2
38466,والزاوية,0,0,2,2
35484,σημείο,0,0,2,2
25566,hayalim,0,0,2,2
40972,town,0,0,2,2
38669,geïnteresseerd,0,0,2,2
30206,يتضمن,0,0,2,2
25965,berättade,0,0,2,2
34541,débattues,0,0,2,2
41220,traduction,0,0,2,2
22006,buenas,0,0,2,2
34543,языкового,0,0,2,2
25955,الثلاثة,0,0,2,2
21595,uneven,0,0,2,2
21592,எதுவும்,0,0,2,2
32079, millions,0,0,2,2
21591,convirtió,0,0,2,2
38688,الماضي,0,0,2,2
38424,acusação,0,0,2,2
32782,ferais,0,0,2,2
22011,symbolic,0,0,2,2
32784,verdien,0,0,2,2
38446,ತೀಕ್ಷ್ಣ,0,0,2,2
25966,أجمل,0,0,2,2
38417,കരുതുക,0,0,2,2
34544,restaurante,0,0,2,2
32080,altitude,0,0,2,2
21579,சுவையான,0,0,2,2
40959,publicaties,0,0,2,2
25504,groter,0,0,2,2
34032,теории,0,0,2,2
25985,toegekend,0,0,2,2
25499,மூலமும்,0,0,2,2
25498,выглядеть,0,0,2,2
41239,प्रतिष्ठा,0,0,2,2
25988,repositorio,0,0,2,2
25951,desarrollada,0,0,2,2
25949,ofertas,0,0,2,2
25947,स्वयं,0,0,2,2
38429,கலைக்களஞ்சியத்தின்,0,0,2,2
38442,मुफ़्त,0,0,2,2
41195,protección,0,0,2,2
38440,comerlo,0,0,2,2
30227,nåede,0,0,2,2
25927,¿estás,0,0,2,2
21634,displace,0,0,2,2
25533,ಬಳಸಬಾರದು,0,0,2,2
31997,disciplinas,0,0,2,2
21632,рецензирования,0,0,2,2
38674,coloquial,0,0,2,2
38437,visitados,0,0,2,2
41203,revanche,0,0,2,2
21627,quant,0,0,2,2
38436,plantar,0,0,2,2
21626,kolay,0,0,2,2
25528,punkt,0,0,2,2
21619,tidig,0,0,2,2
21996,الأصل،,0,0,2,2
21618,pornográficos,0,0,2,2
34498,ಬೇರೆ,0,0,2,2
32078,ബ്യൂറോക്രാറ്റുകൾ,0,0,2,2
30356,इनमें,0,0,2,2
21612,jornalismo,0,0,2,2
30203,மேற்கொள்ளப்பட்ட,0,0,2,2
41214,lachen,0,0,2,2
25515,stichting,0,0,2,2
25514,optimisation,0,0,2,2
40996,sent,0,0,2,2
34535,सुबह,0,0,2,2
32012,तुमने,0,0,2,2
41068,регистрации,0,0,2,2
25706,விரைவான,0,0,2,2
41013,dominant,0,0,2,2
41057,materiaal,0,0,2,2
25623,мэриан,0,0,2,2
25709,ഒരേ,0,0,2,2
41059,सम्बन्ध,0,0,2,2
21923,employs,0,0,2,2
41064,koordinering,0,0,2,2
35699,توقف,0,0,2,2
25714,remain,0,0,2,2
32034,vertelt,0,0,2,2
41066,geduldig,0,0,2,2
21845,preocupações,0,0,2,2
21841,لما,0,0,2,2
21810,ഹലോ,0,0,2,2
41072,ಮಾಂತ್ರಿಕ,0,0,2,2
38561,पूरक,0,0,2,2
21828,ವೀಡಿಯೊದ,0,0,2,2
32064,الموضوعات,0,0,2,2
32032,ceremony,0,0,2,2
25620,മറ്റും,0,0,2,2
25723,juni,0,0,2,2
21822,высоко,0,0,2,2
21819,данный,0,0,2,2
35704,говорят,0,0,2,2
34062,извини,0,0,2,2
21814,подождите,0,0,2,2
25725,kallade,0,0,2,2
32063,tung,0,0,2,2
25625,сбит,0,0,2,2
41054,manejo,0,0,2,2
21910,ആരോ,0,0,2,2
32048,passent,0,0,2,2
30594,अग्रिम,0,0,2,2
25655,κόσμο,0,0,2,2
38596,отправить,0,0,2,2
32046,bottom,0,0,2,2
38600,ചെയ്യാം,0,0,2,2
32726,collectively,0,0,2,2
25660,कोशिश,0,0,2,2
38592,nätverk,0,0,2,2
34073,ذكرت,0,0,2,2
25670,меньше,0,0,2,2
25673,أيضاً,0,0,2,2
34068,सलाह,0,0,2,2
32053,sattın,0,0,2,2
38605,hayatında,0,0,2,2
32730,argumentam,0,0,2,2
41041,ലേഖനത്തെ,0,0,2,2
25682,necesariamente,0,0,2,2
41045,സുന്ദരൻ,0,0,2,2
41029,जाना।,0,0,2,2
21873,facteurs,0,0,2,2
35703,संस्था,0,0,2,2
21902,ಪಡೆಯಲು,0,0,2,2
41053,gifta,0,0,2,2
34511,बाप।,0,0,2,2
25700,കത്തിക്കാം,0,0,2,2
38567,hasn,0,0,2,2
25618,മനസ്സിൽ,0,0,2,2
21808,കേൾക്കുമ്പോൾ,0,0,2,2
25838,സ്ഥലം,0,0,2,2
21761,religión,0,0,2,2
38515,آخرون,0,0,2,2
25600,geliştirmesine,0,0,2,2
25795,producera,0,0,2,2
25797,durgun,0,0,2,2
25802,контроля,0,0,2,2
32743,fortjener,0,0,2,2
41120,profond,0,0,2,2
25804,redactados,0,0,2,2
21765,pekar,0,0,2,2
34057,påståenden,0,0,2,2
41121,இணைப்புக்கள்,0,0,2,2
21763,maintained,0,0,2,2
25593,மதிப்பு,0,0,2,2
25589,لمدة,0,0,2,2
25734,standing,0,0,2,2
21942,semiprotegidos,0,0,2,2
41126,intrude,0,0,2,2
38493,فهذه,0,0,2,2
25588,वर्तनी,0,0,2,2
25587,வைக்க,0,0,2,2
38490,дайте,0,0,2,2
21950,éditoriale,0,0,2,2
41128,körs,0,0,2,2
21952,वर्ग,0,0,2,2
41131,større,0,0,2,2
25831,أطول,0,0,2,2
25832,प्रदर्शित,0,0,2,2
38486,redactor,0,0,2,2
41005,சேனலுக்கு,0,0,2,2
38630,tillämpas,0,0,2,2
34528,английской,0,0,2,2
41006,തുടരാൻ,0,0,2,2
25735,सब्सक्राइब,0,0,2,2
38545,அங்கே,0,0,2,2
21803,विश्वविद्यालयों,0,0,2,2
25743,ಪುಸ್ತಕವನ್ನು,0,0,2,2
25744,register,0,0,2,2
21928,finally,0,0,2,2
21800,establecer,0,0,2,2
21929,interessiert,0,0,2,2
21799,acha,0,0,2,2
41099,anglaise,0,0,2,2
38544,доступа,0,0,2,2
25748,item,0,0,2,2
32720,vir,0,0,2,2
21790,skarpt,0,0,2,2
38624,وموسوعة,0,0,2,2
21788,проектом,0,0,2,2
21787,καλύψεις,0,0,2,2
38627,världen,0,0,2,2
25607,définie,0,0,2,2
21783,सेना,0,0,2,2
25760,libertés,0,0,2,2
41110,actos,0,0,2,2
32740,porém,0,0,2,2
25765,голоден,0,0,2,2
41113,recueil,0,0,2,2
25766,diamanten,0,0,2,2
21776,idade,0,0,2,2
38404,μεσημεριανό,0,0,2,2
26001,ಹೋಗುವುದು,0,0,2,2
25406,ഒരിക്കലും,0,0,2,2
21398,reflection,0,0,2,2
22100,begin,0,0,2,2
22101,anunciada,0,0,2,2
41331,मुश्किल,0,0,2,2
26161,техас,0,0,2,2
41335,मियां,0,0,2,2
25424,düzeltmede,0,0,2,2
26162,حسنًا,0,0,2,2
26164,deluged,0,0,2,2
41338,болото,0,0,2,2
41339,तारीख,0,0,2,2
26166,gylden,0,0,2,2
26167,लगते,0,0,2,2
21399,ervan,0,0,2,2
34589,schleppend,0,0,2,2
21420,милю,0,0,2,2
32827,diseñado,0,0,2,2
32828,форме,0,0,2,2
21395,للمشاركة,0,0,2,2
26179,പദമായ,0,0,2,2
26180,syn,0,0,2,2
38285,yeniden,0,0,2,2
40904,wer,0,0,2,2
21388,മറ്റൊന്ന്,0,0,2,2
34004,ratings,0,0,2,2
25422,contrat,0,0,2,2
40902,ಮಾಡಬೇಕೆಂದು,0,0,2,2
38749,phones,0,0,2,2
25420,reconnu,0,0,2,2
41328,έκανα,0,0,2,2
26156,спрашиваете,0,0,2,2
25497,നിന്നു,0,0,2,2
41309,judges,0,0,2,2
38743,emotion,0,0,2,2
41296,ehe,0,0,2,2
21462,ജനകീയ,0,0,2,2
34494,cama,0,0,2,2
38312,poucas,0,0,2,2
41299,διαγραφή,0,0,2,2
21452,trouver,0,0,2,2
41305,சொற்களைக்,0,0,2,2
38744,comentou,0,0,2,2
31930,klik,0,0,2,2
40916,രണ്ടു,0,0,2,2
40915,تصنيف,0,0,2,2
38745,ಜಾಮ್,0,0,2,2
41310,சோதனை,0,0,2,2
22099,extrême,0,0,2,2
31926,executando,0,0,2,2
26145,priorities,0,0,2,2
38301,l’encyclopédie,0,0,2,2
38747,maturation,0,0,2,2
26150,പദങ്ങൾ,0,0,2,2
21437,χρησιμοποιούν,0,0,2,2
22091,dependent,0,0,2,2
22092,ಒಳ್ಳೆಯದನ್ನು,0,0,2,2
26151,παιδί,0,0,2,2
41321,σχεδίου,0,0,2,2
41323,scolaires,0,0,2,2
40913,ಪ್ರದೇಶದ,0,0,2,2
26155,про,0,0,2,2
22112,vikipedi’ye,0,0,2,2
26195,пожаловать,0,0,2,2
21382,framstående,0,0,2,2
40882,الأفضل,0,0,2,2
41385,λεπτά,0,0,2,2
41386,operated,0,0,2,2
26232,വിക്കിപീഡിയയെ,0,0,2,2
34607,объектах,0,0,2,2
26234,sentados,0,0,2,2
26237,incroyablement,0,0,2,2
31893,parties,0,0,2,2
35723,göndermek,0,0,2,2
40888,gebeuren,0,0,2,2
41393,askerler,0,0,2,2
26239,άντρες,0,0,2,2
25414,பொருட்டல்ல,0,0,2,2
21320,percebe,0,0,2,2
34615,одной,0,0,2,2
34003,رأيك,0,0,2,2
32098,neşelen,0,0,2,2
26251,nybörjare,0,0,2,2
34096,dumm,0,0,2,2
26252,amostra,0,0,2,2
26258,nøjagtigt,0,0,2,2
25413,prononciation,0,0,2,2
26268,privatisation,0,0,2,2
21308,aggregated,0,0,2,2
34488,ಫ್ಲಮ್ಮೋಕ್ಸ್,0,0,2,2
32102,almacenamiento,0,0,2,2
25407,inserted,0,0,2,2
41404,meinung,0,0,2,2
38225,admite,0,0,2,2
41384,technical,0,0,2,2
30364,trick,0,0,2,2
38254,personnel,0,0,2,2
41382,تعال,0,0,2,2
25419,skäl,0,0,2,2
26197,വീട്ടിൽ,0,0,2,2
22117,يرجع,0,0,2,2
30179,bewegen,0,0,2,2
41360,oficialmente,0,0,2,2
38276,gördüğü,0,0,2,2
40896,நனவாகும்,0,0,2,2
25418,τεστ,0,0,2,2
26201,pourrais,0,0,2,2
41362,bildning,0,0,2,2
22121,måder,0,0,2,2
38272,langsommere,0,0,2,2
32692,descriptions,0,0,2,2
40893,curso,0,0,2,2
34599,inclusão,0,0,2,2
21360,bijdragen,0,0,2,2
32836,combination,0,0,2,2
26213,сайтом,0,0,2,2
21354,naturaleza,0,0,2,2
41377,outperformed,0,0,2,2
26219,appears,0,0,2,2
41378,menace,0,0,2,2
26225,wetland,0,0,2,2
21345,costs,0,0,2,2
41380,നടത്തി,0,0,2,2
25416,जड़,0,0,2,2
21341,errado,0,0,2,2
26133,journalistes,0,0,2,2
41293,gelernt,0,0,2,2
34584,फैसला,0,0,2,2
41257,olduğuna,0,0,2,2
21547,παιχνίδι,0,0,2,2
41251,hoewel,0,0,2,2
21544,портал,0,0,2,2
26048,objectionable,0,0,2,2
22038,mand,0,0,2,2
26055,namen,0,0,2,2
21543,comprise,0,0,2,2
31978,kişinin,0,0,2,2
25476,recouvre,0,0,2,2
26059,mesma,0,0,2,2
38356,группа,0,0,2,2
41254,παρακολουθείτε,0,0,2,2
22039,udseende,0,0,2,2
25475,தேதி,0,0,2,2
25458,gusta,0,0,2,2
21534,termed,0,0,2,2
26062,—literalmente—,0,0,2,2
26063,माणिक,0,0,2,2
25472,diyebilirim,0,0,2,2
22040,deviations,0,0,2,2
38712,машинами,0,0,2,2
25469,वाक्यों,0,0,2,2
30187,മൂന്ന്,0,0,2,2
21526,श्रेणी,0,0,2,2
41263,находятся,0,0,2,2
40942,கட்டுரைகளுடன்,0,0,2,2
34554,वेबसाइटों,0,0,2,2
38340,análises,0,0,2,2
26047,helg,0,0,2,2
41248,talt,0,0,2,2
34027,عكس,0,0,2,2
25486,переход,0,0,2,2
38393,invitation,0,0,2,2
26009,दोहरा,0,0,2,2
31985,ಶನಿವಾರ,0,0,2,2
21563,agence,0,0,2,2
38698,ningún,0,0,2,2
38383,മറക്കരുത്,0,0,2,2
21562,ekmekten,0,0,2,2
22028,referenced,0,0,2,2
41242,ссылки,0,0,2,2
38380,सवेव,0,0,2,2
38376,gördüğünü,0,0,2,2
22029,produktionssätt,0,0,2,2
32789,pronunciation,0,0,2,2
40953,μαθήματα,0,0,2,2
35612,researched,0,0,2,2
26030,redigeringarna,0,0,2,2
38369,entity,0,0,2,2
21555,appropriately,0,0,2,2
21554,navnet,0,0,2,2
26037,ρήμα,0,0,2,2
35711,sage,0,0,2,2
31982,"
norueguês",0,0,2,2
22035,पुर्तगाली,0,0,2,2
26040,κουρασμένος,0,0,2,2
26043,पंजीकरण,0,0,2,2
25492,jornalistas,0,0,2,2
21551,algún,0,0,2,2
38720,öppet,0,0,2,2
26083,размещения,0,0,2,2
32084,ഇതിനു,0,0,2,2
31947,സന്തോഷം,0,0,2,2
26110,sunucuları,0,0,2,2
21492,desacuerdos,0,0,2,2
21491,كتاب,0,0,2,2
34569,descreveu,0,0,2,2
38324,hawaiiska,0,0,2,2
41283,وتم,0,0,2,2
21487,estudios,0,0,2,2
21485,bobo,0,0,2,2
40931,kalifornien,0,0,2,2
21484,தோற்றம்,0,0,2,2
34572,préciser,0,0,2,2
32813,habitats,0,0,2,2
25440,rostros,0,0,2,2
32814,secteur,0,0,2,2
26084,’de,0,0,2,2
21480,deserve,0,0,2,2
31946,émancipation,0,0,2,2
22073,يكفي,0,0,2,2
41288,нов,0,0,2,2
31945,നിർമ്മിച്ച,0,0,2,2
32815,دواعي,0,0,2,2
34084,источники,0,0,2,2
26125,ரொட்டியை,0,0,2,2
26126,смог,0,0,2,2
31939,споров,0,0,2,2
41292,welches,0,0,2,2
34582,songs,0,0,2,2
38742,முயற்சிக்கவும்,0,0,2,2
38328,கோணத்திலும்,0,0,2,2
21494,പോകുന്നത്,0,0,2,2
38727,family,0,0,2,2
41282,sakıncası,0,0,2,2
32795,junge,0,0,2,2
40940,चलता,0,0,2,2
32798,говорю,0,0,2,2
34024,термин,0,0,2,2
38721,doorgaan,0,0,2,2
26088,microfilm,0,0,2,2
26090,andel,0,0,2,2
40939,менее,0,0,2,2
26092,reçel,0,0,2,2
22056,исправления,0,0,2,2
38335,нарцисой,0,0,2,2
26096,heißt,0,0,2,2
22060,rely,0,0,2,2
21512,verbijsterd,0,0,2,2
35720,sturen,0,0,2,2
38722,شعرت,0,0,2,2
41274,ಸಮಯ,0,0,2,2
38724,parodied,0,0,2,2
31966,skolen,0,0,2,2
25453,hidden,0,0,2,2
21500,proibir,0,0,2,2
34560,ಕ್ಲಿಕ್,0,0,2,2
26102,الليلة,0,0,2,2
31960,جذور,0,0,2,2
26105,സ്കൂളിൽ,0,0,2,2
34017,logra,0,0,2,2
22064,hieronder,0,0,2,2
31690,implicit,0,0,2,2
37865,अविश्वसनीय,0,0,2,2
34747,centros,0,0,2,2
34414,glemmer,0,0,2,2
27552,décrivent,0,0,2,2
34911,pasaron,0,0,2,2
22745,erkek,0,0,2,2
37406,historiador,0,0,2,2
19814,основные,0,0,2,2
37402,auparavant,0,0,2,2
33822,सदी,0,0,2,2
27568,drücken,0,0,2,2
19810,प्रशासकों,0,0,2,2
33821,illustrer,0,0,2,2
37387,protists,0,0,2,2
31430,ನಿಧಾನವಾಗಿದೆ,0,0,2,2
19807,électriques,0,0,2,2
22747,عشر,0,0,2,2
33110,graphical,0,0,2,2
42354,ഇതെല്ലാം,0,0,2,2
27580,acted,0,0,2,2
22748,шутка,0,0,2,2
31428,ರೀತಿಯದ್ದಾಗಿದೆ,0,0,2,2
27582,precisamos,0,0,2,2
32575,apply,0,0,2,2
27587,സന്ദേശം,0,0,2,2
19801,classifying,0,0,2,2
33115,hinanden,0,0,2,2
37380,കാഴ്ചപ്പാട്,0,0,2,2
24758,സൗകര്യവും,0,0,2,2
27593,manipulate,0,0,2,2
19798,rays,0,0,2,2
27549,presentó,0,0,2,2
39161,ಕಣ್ಣುಗಳು,0,0,2,2
34930,welchem,0,0,2,2
42338,экспертных,0,0,2,2
24777,السماح,0,0,2,2
27526,recognition‏,0,0,2,2
42324,rentrer,0,0,2,2
33105,व्यवस्थित,0,0,2,2
22725,low,0,0,2,2
40482,scharf,0,0,2,2
19851,appliquer,0,0,2,2
37420,νομίζετε,0,0,2,2
31443,sluta,0,0,2,2
42334,porte,0,0,2,2
24775,انتظر,0,0,2,2
33108,средства,0,0,2,2
27532,wortels,0,0,2,2
40478,αρχείο,0,0,2,2
33109,inference,0,0,2,2
19832,retour,0,0,2,2
39158,இதற்காக,0,0,2,2
19830,enfant,0,0,2,2
32207,കഴിഞ്ഞാൽ,0,0,2,2
32576,അതായത്,0,0,2,2
19828,visitar,0,0,2,2
19826,incluidos,0,0,2,2
31437,clicando,0,0,2,2
35581,glömmer,0,0,2,2
42343,ഘടകങ്ങളാണ്,0,0,2,2
27540,sov,0,0,2,2
22735,сердца,0,0,2,2
31436,известна,0,0,2,2
42360,корень,0,0,2,2
19791,tâches,0,0,2,2
42363,saß,0,0,2,2
19734,ಪಡೆಯಲಿಲ್ಲ,0,0,2,2
37344,صفحاتها,0,0,2,2
19747,dalga,0,0,2,2
37343,ذي,0,0,2,2
40456,общих,0,0,2,2
34925,söyleyebilirsin,0,0,2,2
39182,francophones,0,0,2,2
39184,ಹೊರತು,0,0,2,2
34181,delete,0,0,2,2
33810,sejt,0,0,2,2
19738,entretient,0,0,2,2
33133,djur,0,0,2,2
27654,ലാഭേച്ഛയില്ലാതെ,0,0,2,2
37338,ಸ್ಥಳವನ್ನು,0,0,2,2
31408,രഥത്തിൽ,0,0,2,2
19788,dúvida,0,0,2,2
34928,verificar,0,0,2,2
19728,أشعر,0,0,2,2
42400,огромный,0,0,2,2
31404,kent,0,0,2,2
42402,مرتبطة,0,0,2,2
27660,kidding,0,0,2,2
39186,bientôt,0,0,2,2
27661,कथित,0,0,2,2
19719,intresserad,0,0,2,2
19718,लिख,0,0,2,2
31403,исходя,0,0,2,2
33808,hoş,0,0,2,2
22779,ukrainien,0,0,2,2
39180,almoço,0,0,2,2
22768,σχετικά,0,0,2,2
24739,indígenas,0,0,2,2
24740,últimas,0,0,2,2
37375,satın,0,0,2,2
27602,goals,0,0,2,2
42367,commentaire,0,0,2,2
22755,kötü,0,0,2,2
19782,fuera,0,0,2,2
19781,أما,0,0,2,2
19780,muss,0,0,2,2
22757,انا,0,0,2,2
40463,reise,0,0,2,2
19779,mereço,0,0,2,2
22759,टु,0,0,2,2
24748,political,0,0,2,2
42374,праве,0,0,2,2
42376,movimiento,0,0,2,2
19765,approches,0,0,2,2
42378,मजाक,0,0,2,2
33119,douce,0,0,2,2
31419,kızgın,0,0,2,2
33812,kiggede,0,0,2,2
37361,asignaciones,0,0,2,2
22766,daré,0,0,2,2
19762,colour,0,0,2,2
37357,variantes,0,0,2,2
24742,jours,0,0,2,2
32568,poder,0,0,2,2
19755,gyldne,0,0,2,2
27638,flattening,0,0,2,2
42319,subsequent,0,0,2,2
39151,band,0,0,2,2
27525,dynasty,0,0,2,2
31473,alcanzar,0,0,2,2
19992,kopiera,0,0,2,2
34879,conduta,0,0,2,2
37500,വരുത്തുന്നതിൽ,0,0,2,2
27409,امرأة,0,0,2,2
19989,vertelde,0,0,2,2
33076,experiente,0,0,2,2
34416,conclusión,0,0,2,2
24844,первое,0,0,2,2
19985,للصفحة,0,0,2,2
42231,grandiosa,0,0,2,2
27414,أخرى،,0,0,2,2
27416,fest,0,0,2,2
34883,ترَ,0,0,2,2
30124,frankrike,0,0,2,2
37481,casos—,0,0,2,2
34884,добровольцев,0,0,2,2
31471,குறைவாக,0,0,2,2
27426,sufficiently,0,0,2,2
27431,apps,0,0,2,2
39114,التعليق,0,0,2,2
27438,devenant,0,0,2,2
27439,relevancia,0,0,2,2
22673,ves,0,0,2,2
40519,परिवर्तनों,0,0,2,2
19962,политика,0,0,2,2
37483,mobiltelefon,0,0,2,2
42248,பெருமை,0,0,2,2
24839,मुद्दों,0,0,2,2
33074,réfléchir,0,0,2,2
37501,تصدر,0,0,2,2
27403,فضلك؟,0,0,2,2
20003,بريتانيكا،,0,0,2,2
37526,orada,0,0,2,2
42201,efeitos,0,0,2,2
24852,दानपुण्य,0,0,2,2
22656,bekymmer,0,0,2,2
40527,कोष,0,0,2,2
32585,கட்டுரைகளைத்,0,0,2,2
42203,ώρα,0,0,2,2
37521,प्रकाशित,0,0,2,2
20022,deja,0,0,2,2
20018,собственные,0,0,2,2
20016,വ്യക്തിയോട്,0,0,2,2
27376,prüfung,0,0,2,2
37519,أشتري,0,0,2,2
27380,intonationen,0,0,2,2
37515,relevant,0,0,2,2
30326,википедией,0,0,2,2
27383,numerators,0,0,2,2
37514,أمثلة,0,0,2,2
22661,encarga,0,0,2,2
27393,historian,0,0,2,2
20010,അജ്ഞാത,0,0,2,2
42210,decirles,0,0,2,2
34877,चित्रों,0,0,2,2
39111,holocene,0,0,2,2
27397,advent,0,0,2,2
42215,пятница,0,0,2,2
27402,consensus,0,0,2,2
27445,piezas,0,0,2,2
37480,ചോദിക്കാം,0,0,2,2
31450,inteligência,0,0,2,2
34894,voitures,0,0,2,2
24801,habilidades,0,0,2,2
42286,reciben,0,0,2,2
30588,misión,0,0,2,2
19908,negócios,0,0,2,2
42288,math,0,0,2,2
39141,intellectual,0,0,2,2
42289,موسوعات,0,0,2,2
27505,விவரிக்கிறார்கள்,0,0,2,2
42290,antiquité,0,0,2,2
24797,ചർച്ച,0,0,2,2
42294,collaboratif,0,0,2,2
24794,pacientemente,0,0,2,2
32577,samtalen,0,0,2,2
19887,undersökningar,0,0,2,2
24829,hakkına,0,0,2,2
19882,commented,0,0,2,2
33099,téléchargé,0,0,2,2
27509,executive,0,0,2,2
19879,pointu,0,0,2,2
37430,samman,0,0,2,2
39150,pronunciación,0,0,2,2
42310,расстраивайтесь,0,0,2,2
37429,oito,0,0,2,2
22719,decisões,0,0,2,2
42313,लिंक्स,0,0,2,2
40487,descrevem,0,0,2,2
35752,ações,0,0,2,2
19871,batmak,0,0,2,2
19911,dün,0,0,2,2
37443,ರಹಸ್ಯವಾದ,0,0,2,2
37444,strong,0,0,2,2
40496,disciplines,0,0,2,2
31464,suggesting,0,0,2,2
22684,patronen,0,0,2,2
37473,kvalitén,0,0,2,2
24825,معه,0,0,2,2
24824,remover,0,0,2,2
31463,pocos,0,0,2,2
33842,filtering,0,0,2,2
39126,опубликованы,0,0,2,2
37463,ಮದುವೆಯಲ್ಲಿ,0,0,2,2
42265,очередь,0,0,2,2
42267,ಸೌಂದರ್ಯವು,0,0,2,2
24822,editam,0,0,2,2
42270,ночью,0,0,2,2
27476,verrückt,0,0,2,2
42273,pudo,0,0,2,2
34891,reunião,0,0,2,2
27481,അറിയിക്കുക,0,0,2,2
22695,പ്രശ്നങ്ങളിൽ,0,0,2,2
37453,φύγω,0,0,2,2
40504,forbindelse,0,0,2,2
19917,yazılımı,0,0,2,2
37452,முதல்,0,0,2,2
22697,apprenez,0,0,2,2
40500,ಆಗಿ,0,0,2,2
24812,examiner,0,0,2,2
22704,åren,0,0,2,2
42285,earlier,0,0,2,2
27666,содержимого,0,0,2,2
27669,kommit,0,0,2,2
31682,founder,0,0,2,2
42543,വിക്കിപീഡിയരുടെ,0,0,2,2
19517,soluções,0,0,2,2
31311,alterar,0,0,2,2
27884,internas,0,0,2,2
19511,microorganisms,0,0,2,2
19510,beslutning,0,0,2,2
27886,p ,0,0,2,2
19505,nyheden,0,0,2,2
31303,विनम्र,0,0,2,2
42540,amerikanska,0,0,2,2
33786,uppfattning,0,0,2,2
19499,المواقع,0,0,2,2
27888,map,0,0,2,2
42542,தரத்தைக்,0,0,2,2
27889,controversos,0,0,2,2
37188,അതുപോലെ,0,0,2,2
19492,finales,0,0,2,2
31293,ഉറപ്പില്ല,0,0,2,2
37180,लेता,0,0,2,2
31288,अर्थशास्त्र,0,0,2,2
22860,இருக்கலாம்,0,0,2,2
42546,lecciones,0,0,2,2
42547,sistémicos,0,0,2,2
27907,poner,0,0,2,2
27912,diez,0,0,2,2
42556,سأرسل,0,0,2,2
22865,تمييز,0,0,2,2
37165,seguir,0,0,2,2
30531,procedentes,0,0,2,2
19519,καλώς,0,0,2,2
27879,الشائعة,0,0,2,2
32212,लिह,0,0,2,2
33168,internes,0,0,2,2
42501,healthrelated,0,0,2,2
31328,administrada,0,0,2,2
39218,aussprache,0,0,2,2
30585,gérée,0,0,2,2
34515,पढ़,0,0,2,2
32562,فترة,0,0,2,2
27845,консенсуса,0,0,2,2
37208,ಶೀಘ್ರದಲ್ಲೇ,0,0,2,2
37206,отсутствие,0,0,2,2
22849,சரியாகப்,0,0,2,2
27852,малых,0,0,2,2
19543,продолжить,0,0,2,2
37205,må,0,0,2,2
40410,kinds,0,0,2,2
34404,أمر,0,0,2,2
32559,solução,0,0,2,2
27859,wörtern,0,0,2,2
37199,ಫೋನ್,0,0,2,2
22854,சந்திக்க,0,0,2,2
27865,holen,0,0,2,2
42520,الربع,0,0,2,2
31326,aprenda,0,0,2,2
34988,misiniz,0,0,2,2
34187,diamanter,0,0,2,2
34990,ಎಂದರ್ಥ,0,0,2,2
19522,جميلة,0,0,2,2
27873,mutation,0,0,2,2
30322,நேரத்தில்,0,0,2,2
37164,पूर्वाग्रह,0,0,2,2
39232,ಹೋಗುತ್ತಿದ್ದೇನೆ,0,0,2,2
27920,ابتهج,0,0,2,2
24626,لذلك،,0,0,2,2
33184,الاقتصاد,0,0,2,2
35770,يتحقق,0,0,2,2
42593,милая,0,0,2,2
39244,жизнь,0,0,2,2
39246,باستخدام,0,0,2,2
37140,noemen,0,0,2,2
35026,чемто,0,0,2,2
19427,النسخة,0,0,2,2
19426,aktif,0,0,2,2
27955,incorporam,0,0,2,2
33190,അറിയാൻ,0,0,2,2
42594,ouvi,0,0,2,2
19419,функции,0,0,2,2
22881,peuxtu,0,0,2,2
31285,ಸಂತೋಷದ,0,0,2,2
42599,математике,0,0,2,2
40388,observou,0,0,2,2
39249,hata,0,0,2,2
31260,civilization,0,0,2,2
31258,ακούσετε,0,0,2,2
42602,roots,0,0,2,2
34193,насколько,0,0,2,2
42603,نوفمبر,0,0,2,2
33191,τέσσερα,0,0,2,2
42606,editorinchief,0,0,2,2
27970,vestidos,0,0,2,2
19404,عنك,0,0,2,2
19403,കമ്പ്യൂട്ടർ,0,0,2,2
27950,vidéos,0,0,2,2
22879,exige,0,0,2,2
19432,sehe,0,0,2,2
22876,varnish,0,0,2,2
30103,σχόλιο,0,0,2,2
19470,marry,0,0,2,2
27925,acessível,0,0,2,2
33179,yapamayacağınız,0,0,2,2
31282,poetry,0,0,2,2
27928,credenciais,0,0,2,2
35766,federated,0,0,2,2
37155,செய்தி,0,0,2,2
19458,ταινίες,0,0,2,2
39236,format,0,0,2,2
27932,رؤيته,0,0,2,2
19454,πήγαν,0,0,2,2
27933,ഉപയോഗിക്കാൻ‌,0,0,2,2
35017,അവനോട്,0,0,2,2
24635,ചേർക്കുന്നു,0,0,2,2
42579,distincts,0,0,2,2
22872,mythologie,0,0,2,2
27938,verrast,0,0,2,2
27939,свободной,0,0,2,2
42583,pillars,0,0,2,2
37149,verlicht,0,0,2,2
31271,positivt,0,0,2,2
32549,странах,0,0,2,2
35767,mvs,0,0,2,2
35022,கொண்டிருக்கிறீர்கள்,0,0,2,2
19438,ಹುರಿದುಂಬಿಸಲು,0,0,2,2
22874,ರಹಸ್ಯ,0,0,2,2
24670,εγγραφής,0,0,2,2
19558,idioma,0,0,2,2
22838,paths,0,0,2,2
42448,reorganized,0,0,2,2
22793,прикрыть,0,0,2,2
27709,மரியான்,0,0,2,2
27718,voulait,0,0,2,2
33800,ccbysalicentie,0,0,2,2
34938,koordinationsarbete,0,0,2,2
19660,förutsäga,0,0,2,2
19656,банковский,0,0,2,2
39195,இருந்தன,0,0,2,2
19653,publicitários,0,0,2,2
33799,الاستقرائي,0,0,2,2
27729,لكنها,0,0,2,2
22796,दूसरा,0,0,2,2
22797,gången,0,0,2,2
33151,प्रतिबंधित,0,0,2,2
22810,norte,0,0,2,2
42449,ready,0,0,2,2
19646,ஆற்றல்,0,0,2,2
27735,восстановить,0,0,2,2
42451,believe,0,0,2,2
24707,tages,0,0,2,2
19642,numerosos,0,0,2,2
27743,wildlife,0,0,2,2
22807,doré,0,0,2,2
42453,tråkig,0,0,2,2
22809,देशों,0,0,2,2
37276,κοινή,0,0,2,2
19638,olmanın,0,0,2,2
31380,المتعلقة,0,0,2,2
33146,exceptions,0,0,2,2
35759,اللطيف,0,0,2,2
19673,rire,0,0,2,2
24721,begge,0,0,2,2
42409,verhoog,0,0,2,2
31401,consequência,0,0,2,2
32213,энциклопедического,0,0,2,2
19705,physique,0,0,2,2
30603,मिलती,0,0,2,2
19701,bases,0,0,2,2
40451,സംഭാഷണത്തിൽ,0,0,2,2
19698,essentially,0,0,2,2
42416,न्यासी,0,0,2,2
33137,cuentas,0,0,2,2
37320,ವಿವರಿಸುತ್ತಾರೆ,0,0,2,2
31399,पूरा,0,0,2,2
31398,entier,0,0,2,2
40449,derovre,0,0,2,2
33141,இதுதான்,0,0,2,2
22786,logistic,0,0,2,2
22787,smaragden,0,0,2,2
39189,вопросов,0,0,2,2
22789,eerst,0,0,2,2
19685,formar,0,0,2,2
24722,удалить,0,0,2,2
27697,buraya,0,0,2,2
22790,nedenfor,0,0,2,2
42427,ettiği,0,0,2,2
30242,verschrikkelijk,0,0,2,2
34934,викимедиа»,0,0,2,2
19679,هائلة,0,0,2,2
33795,ವಿವರಿಸುತ್ತದೆ,0,0,2,2
19634,reçus,0,0,2,2
22833,книга,0,0,2,2
19583,avsedd,0,0,2,2
35457,darüber,0,0,2,2
39213,वीं,0,0,2,2
27807,समतुल्य,0,0,2,2
19594,candidate,0,0,2,2
27812,sunmaktadır,0,0,2,2
19593,أعجبك,0,0,2,2
37230,прецедентам,0,0,2,2
24677,lágrimas,0,0,2,2
33160,έπιασα,0,0,2,2
30243,talep,0,0,2,2
37229,welk,0,0,2,2
39214,классических,0,0,2,2
30325,لأنه,0,0,2,2
19582,halsiz,0,0,2,2
22811,أحلامه,0,0,2,2
37226,mantidas,0,0,2,2
37223,iğrençti,0,0,2,2
37220,தவிர,0,0,2,2
27829,βικιβιβλία,0,0,2,2
31332,संरक्षण,0,0,2,2
42490,மெதுவான,0,0,2,2
34406,सुधारने,0,0,2,2
37216,مساعدتك,0,0,2,2
34981,думал,0,0,2,2
32563,differentiated,0,0,2,2
27834,síntomas,0,0,2,2
39217,баз,0,0,2,2
22830,волнуйтесь,0,0,2,2
40428,onthoud,0,0,2,2
24680,الحر,0,0,2,2
34967,pedi,0,0,2,2
37240,إم,0,0,2,2
39198,перцептрон,0,0,2,2
19632,λειτουργία,0,0,2,2
39206,δάνειο,0,0,2,2
31377,littéralement,0,0,2,2
27763,baseras,0,0,2,2
27765,längre,0,0,2,2
22812,quejarme,0,0,2,2
31369,despedir,0,0,2,2
33158,asunto,0,0,2,2
22814,increíblemente,0,0,2,2
37262,سحرية,0,0,2,2
33159,welgemanierd,0,0,2,2
19629,dibujo,0,0,2,2
19628,öğrenmeye,0,0,2,2
37257,advice,0,0,2,2
32219,τέλος,0,0,2,2
34959,ചുവടുവപ്പ്,0,0,2,2
37250,geçmiş,0,0,2,2
24688,bittet,0,0,2,2
24687,pública,0,0,2,2
27790,relativt,0,0,2,2
34407,acontecimentos,0,0,2,2
19613,बाप,0,0,2,2
24686,കുഴപ്പമില്ല,0,0,2,2
24685,dealing,0,0,2,2
19611,rift,0,0,2,2
27793,académica,0,0,2,2
22655,βικιλεξικό,0,0,2,2
20029,yolunda,0,0,2,2
42199,ಬೆರಳುಗಳನ್ನು,0,0,2,2
25040,εσείς,0,0,2,2
37780,gifte,0,0,2,2
26966,आरोप,0,0,2,2
22479,grootste,0,0,2,2
41951,oben,0,0,2,2
20445,मेलिंग,0,0,2,2
37778,hacia,0,0,2,2
26970,സുഹൃത്തുക്കൾ,0,0,2,2
34438,ലേഖനങ്ങളുള്ള,0,0,2,2
25051,описывают,0,0,2,2
26973,gjorda,0,0,2,2
37771,espanhol,0,0,2,2
41955,directa,0,0,2,2
25044,esmeraldas,0,0,2,2
31604,xviie,0,0,2,2
26964,விரும்பினேன்,0,0,2,2
35491,ζούσε,0,0,2,2
30137,examination,0,0,2,2
41962,ಎಷ್ಟು,0,0,2,2
20427,பரவாயில்லை,0,0,2,2
34434,criticado,0,0,2,2
25038,غاضبًا,0,0,2,2
22491,insulte,0,0,2,2
31602,nativos,0,0,2,2
38993,schémas,0,0,2,2
20423,specialiserade,0,0,2,2
38997,agradable,0,0,2,2
31601,typer,0,0,2,2
41966,quite,0,0,2,2
20452,пример,0,0,2,2
32986,begränsas,0,0,2,2
42197,ഇവരുടെ,0,0,2,2
30139,enda,0,0,2,2
20491,الآخرين,0,0,2,2
20488,audessus,0,0,2,2
31626,rejette,0,0,2,2
37790,человек,0,0,2,2
20485,പ്രശ്നം,0,0,2,2
33910,editorchefe,0,0,2,2
40658,semblaient,0,0,2,2
37788,systematische,0,0,2,2
20478,विश्वकोशों,0,0,2,2
41936,kl,0,0,2,2
31623,mulheres,0,0,2,2
38979,أجريت,0,0,2,2
32979,hazırlanmaktadır,0,0,2,2
20472,ins,0,0,2,2
32984,விரும்பும்,0,0,2,2
41938,dirigentes,0,0,2,2
40657,tillbaka,0,0,2,2
37784,predominantemente,0,0,2,2
20464,récompense,0,0,2,2
40653,consacrée,0,0,2,2
26957,стоимость,0,0,2,2
25060,insertion,0,0,2,2
20458,ध्यान,0,0,2,2
26961,ಅದಕ್ಕೆ,0,0,2,2
41945,icon,0,0,2,2
20454,favorite,0,0,2,2
25054,estabelecidos,0,0,2,2
25053,altaylı,0,0,2,2
22493,इन्हें,0,0,2,2
22494,குழப்பம்,0,0,2,2
34797,ಕನಸುಗಳ,0,0,2,2
37714,denominators,0,0,2,2
37727,ಬೇಕಾದುದನ್ನು,0,0,2,2
31579,признана,0,0,2,2
41995,кусок,0,0,2,2
40629,hangisinin,0,0,2,2
32178,anda,0,0,2,2
32179,piensa,0,0,2,2
20363,പറയാൻ‌,0,0,2,2
27062,detinha,0,0,2,2
24996,अंतर,0,0,2,2
24995,weekenden,0,0,2,2
31577,доступные,0,0,2,2
24994,jornal,0,0,2,2
20361,записи,0,0,2,2
37713,olup,0,0,2,2
20417,vigiadas,0,0,2,2
40623,indiquer,0,0,2,2
39024,الأمثلة,0,0,2,2
37708,سعيد,0,0,2,2
24988,ifadeler,0,0,2,2
27078,मतदान,0,0,2,2
39028,trægt,0,0,2,2
37700,هاه,0,0,2,2
33003,diseñador,0,0,2,2
40620,يوفر,0,0,2,2
22519,bidra,0,0,2,2
22520,medmindre,0,0,2,2
20346,amables,0,0,2,2
42008,conduire,0,0,2,2
20368,ಸಂಧಿಸುವಿಕೆಯನ್ನು,0,0,2,2
22505,eight,0,0,2,2
27049,والكلمة,0,0,2,2
33893,ஜாம்,0,0,2,2
38999,нем,0,0,2,2
20413,большое,0,0,2,2
20412,pools,0,0,2,2
27015,sød,0,0,2,2
39003,succes,0,0,2,2
27020,rent,0,0,2,2
31591,refiriéndose,0,0,2,2
41972,anímate,0,0,2,2
20405,целях,0,0,2,2
27024,deveria,0,0,2,2
20404,وتعديل,0,0,2,2
31584,reis,0,0,2,2
25023,எங்களுக்கு,0,0,2,2
27026,semisupervised,0,0,2,2
41975,padrões,0,0,2,2
27033,நேற்று,0,0,2,2
20396,hiervan,0,0,2,2
25021,absolutamente,0,0,2,2
20390,börja,0,0,2,2
37732,« principal »,0,0,2,2
27042,இல்லாமல்,0,0,2,2
39007,forvaltere,0,0,2,2
40633,तौर,0,0,2,2
20378,குறிக்கோளை,0,0,2,2
27045,toegang,0,0,2,2
25011,ಯಾವ,0,0,2,2
20373,équipe,0,0,2,2
26947,rédigés,0,0,2,2
37793,meerderheid,0,0,2,2
20494,сетей,0,0,2,2
25109,يوليو,0,0,2,2
22422,ثمانية,0,0,2,2
26885,iria,0,0,2,2
35688,വരാൻ,0,0,2,2
41846,gotta,0,0,2,2
32956,بيديا,0,0,2,2
20604,விடுங்கள்,0,0,2,2
33921,просят,0,0,2,2
41853,श्रेय,0,0,2,2
37832,boundary,0,0,2,2
31660,தலைமையான,0,0,2,2
20599,എന്നിങ്ങനെ,0,0,2,2
32160,noviembre,0,0,2,2
32961,aurait,0,0,2,2
25106,अदालत,0,0,2,2
26902,χθες,0,0,2,2
26891,vs,0,0,2,2
20592,dozen,0,0,2,2
41862,largescale,0,0,2,2
20582,ചോദിക്കാൻ,0,0,2,2
30385,convey,0,0,2,2
34146,possess,0,0,2,2
30389,ನೋಡುತ್ತೇನೆ,0,0,2,2
25103,स्वादिष्ट,0,0,2,2
41872,edemezsiniz,0,0,2,2
37827,இதற்குக்,0,0,2,2
25102,என்னைப்,0,0,2,2
37822,niño,0,0,2,2
38957,ansåg,0,0,2,2
38953,falsch,0,0,2,2
37839,portugués,0,0,2,2
41836,rápidas,0,0,2,2
37840,четыре,0,0,2,2
34140,significado,0,0,2,2
20656,सॉरी,0,0,2,2
25125,ಸಂಜೆ,0,0,2,2
22404,latinas,0,0,2,2
37863,geçebilirsin,0,0,2,2
41821,semanal,0,0,2,2
35460,ಇರುತ್ತೇನೆ,0,0,2,2
22406,വിശദീകരിക്കുന്നു,0,0,2,2
34750,تكراره,0,0,2,2
26844,trots,0,0,2,2
37859,μαθαίνετε,0,0,2,2
22416,telefone,0,0,2,2
32953,planalto,0,0,2,2
20632,ಪಠ್ಯವನ್ನು,0,0,2,2
40688,وصف,0,0,2,2
25120,glückspilz,0,0,2,2
31673,dedicated,0,0,2,2
26862,oprette,0,0,2,2
20628,middag,0,0,2,2
34753,vois,0,0,2,2
38944,ställning,0,0,2,2
32954,одного,0,0,2,2
34757,സ്വയംചലിത,0,0,2,2
38945,predicts,0,0,2,2
30384,destruction,0,0,2,2
34760,ಐಕಾನ್,0,0,2,2
20622,λόγω,0,0,2,2
38960,opérations,0,0,2,2
25096,கவனிப்புப்,0,0,2,2
22465,हाथ,0,0,2,2
38971,விரல்களைக்,0,0,2,2
26929,inventé,0,0,2,2
26931,geschikt,0,0,2,2
20534,സിസോപ്പുകളേയും,0,0,2,2
41900,visages,0,0,2,2
22454,nöje,0,0,2,2
40666,jeito,0,0,2,2
31635,veelvoorkomende,0,0,2,2
41906,contexts,0,0,2,2
26932,ماريون,0,0,2,2
20523,creencia,0,0,2,2
30549,работала,0,0,2,2
22456,verrai,0,0,2,2
26936,രണ്ടുപേരും,0,0,2,2
22460,दुर्लभ,0,0,2,2
37819,permanecer,0,0,2,2
37798,estadística,0,0,2,2
38972,λέω,0,0,2,2
37795,senha,0,0,2,2
20510,globalement,0,0,2,2
33916,symptoms,0,0,2,2
25074,cia,0,0,2,2
25071,لتكون,0,0,2,2
20505,citados,0,0,2,2
31629,eukaryotic,0,0,2,2
20500,ಹೇಗಿದ್ದೀರಿ,0,0,2,2
41923,ويكيميديا،,0,0,2,2
25067,huylu,0,0,2,2
41927,यू,0,0,2,2
20535,минутку,0,0,2,2
31636,enof,0,0,2,2
25077,ಮರೆಯದಿರಿ,0,0,2,2
37804,खेल,0,0,2,2
41875,смотрите,0,0,2,2
26907,landen,0,0,2,2
37816,указания,0,0,2,2
20568,identifié,0,0,2,2
37814,क़िताबें,0,0,2,2
32963,partielle,0,0,2,2
37813,rör,0,0,2,2
41878,benutze,0,0,2,2
20563,blivit,0,0,2,2
37810,ತಂಪಾದ,0,0,2,2
22438,sediments,0,0,2,2
41882,രഹസ്യമായി,0,0,2,2
41883,extraction,0,0,2,2
25089,सपनों,0,0,2,2
35588,videregive,0,0,2,2
22440,crisis,0,0,2,2
34771,contó,0,0,2,2
20548,مفرداتك,0,0,2,2
20547,manipulación,0,0,2,2
33917,മുങ്ങുക,0,0,2,2
25086,يستخدمها,0,0,2,2
41893,prédominance,0,0,2,2
40672,physician,0,0,2,2
25085,kommet,0,0,2,2
22447,fantásticas,0,0,2,2
34775,şaşkına,0,0,2,2
20540,stored,0,0,2,2
34155,werkt,0,0,2,2
20341,ಒಬ್ಟೂಸ್,0,0,2,2
24983,narcissemor,0,0,2,2
27280,தவறான,0,0,2,2
27258,πολλοί,0,0,2,2
35622,vested,0,0,2,2
40552,hızlı,0,0,2,2
24901,accommodate,0,0,2,2
20135,எல்லாவற்றையும்,0,0,2,2
20134,teléfono,0,0,2,2
40550,participantes,0,0,2,2
24896,ميليسا,0,0,2,2
32200,biz,0,0,2,2
37574,"
bielorrusso",0,0,2,2
27276,conventions,0,0,2,2
24894,कॉमंस,0,0,2,2
31519,trends,0,0,2,2
27281,मिलेगा,0,0,2,2
27295,licenses,0,0,2,2
27282,formulée,0,0,2,2
20126,рамках,0,0,2,2
27283,libre»—,0,0,2,2
20125,எடுத்துக்காட்டுகள்,0,0,2,2
27286,citar,0,0,2,2
31516,convection,0,0,2,2
27289,arise,0,0,2,2
42141,المواضيع,0,0,2,2
32589,troede,0,0,2,2
33058,ഏവർക്കും,0,0,2,2
42145,വാക്യങ്ങൾ‌,0,0,2,2
42146,studera,0,0,2,2
40548,appris,0,0,2,2
40557,dünyanın,0,0,2,2
39077,κι,0,0,2,2
27257,focusing,0,0,2,2
37588,यहां,0,0,2,2
22597,salida,0,0,2,2
37605,மற்றதைச்,0,0,2,2
24911,tráfico,0,0,2,2
20181,quantité,0,0,2,2
37603,мной,0,0,2,2
27238,encuentre,0,0,2,2
22603,الملاك,0,0,2,2
34843,horrível,0,0,2,2
42109,beseffen,0,0,2,2
39072,بأس,0,0,2,2
27242,preserves,0,0,2,2
34844,நபரிடம்,0,0,2,2
20172,كنا,0,0,2,2
20171,"
इस",0,0,2,2
20170,विभिन्न,0,0,2,2
24909,χαρούμενη,0,0,2,2
37593,மகிழ்ச்சியான,0,0,2,2
20164,फाउनडेशन,0,0,2,2
34417,materialet,0,0,2,2
33856,resolve,0,0,2,2
42114,purement,0,0,2,2
42115,εμφανίζεται,0,0,2,2
39075,നൽകി,0,0,2,2
20160,ocorre,0,0,2,2
40560,الوصول,0,0,2,2
20156,afscheid,0,0,2,2
27254,occident,0,0,2,2
27293,fruto,0,0,2,2
27297,regardez,0,0,2,2
27229,fruktansvärt,0,0,2,2
42188,contrário,0,0,2,2
27336,besten,0,0,2,2
20054,«por,0,0,2,2
42184,മുൻകൂട്ടി,0,0,2,2
24870,comenzar,0,0,2,2
27337,الأسئلة,0,0,2,2
24869,medidas,0,0,2,2
22641,saiu,0,0,2,2
37541,wikipediaanvändare,0,0,2,2
27342,نظر,0,0,2,2
33062,utilizan,0,0,2,2
37540,मुझसे,0,0,2,2
39098,स्पीकर,0,0,2,2
40539,extérieure,0,0,2,2
37539,separates,0,0,2,2
20102,geçti,0,0,2,2
32201,obscenas,0,0,2,2
31497,taking,0,0,2,2
20040,achieving,0,0,2,2
22647,opgaver,0,0,2,2
42193,generates,0,0,2,2
24860,حولها,0,0,2,2
24858,procedimientos,0,0,2,2
24855,uitspraak,0,0,2,2
39106,ತಿಳಿಸಿ,0,0,2,2
37529,سأقدم,0,0,2,2
39107,einfache,0,0,2,2
37528,século,0,0,2,2
37527,आपत्तिजनक,0,0,2,2
34863,considérer,0,0,2,2
39096,beteende,0,0,2,2
20061,reglerna,0,0,2,2
27333,acéfalo,0,0,2,2
20099,onlar,0,0,2,2
31514,γλυκιά,0,0,2,2
32588,σχολείο,0,0,2,2
20096,varying,0,0,2,2
27301,celular,0,0,2,2
24888,dépendra,0,0,2,2
22628,privada,0,0,2,2
24881,fer,0,0,2,2
40547,ens,0,0,2,2
20091,welkom,0,0,2,2
20090,facility,0,0,2,2
27313,katılmıyorum,0,0,2,2
27315,نوع,0,0,2,2
42162,saiba,0,0,2,2
42163,eventos,0,0,2,2
37550,slutet,0,0,2,2
20078,murat,0,0,2,2
20077,iedere,0,0,2,2
27320,técnicos,0,0,2,2
42169,hiervoor,0,0,2,2
31505,ρίζα,0,0,2,2
20067,consultation,0,0,2,2
27324,acerca,0,0,2,2
20066,dantas,0,0,2,2
27327,manipulation,0,0,2,2
27329,motsvarande,0,0,2,2
39093,zittrain,0,0,2,2
32197,ಟೆರೆನ್ಸ್,0,0,2,2
33861,winkels,0,0,2,2
20338,bloqueio,0,0,2,2
27144,équilibre,0,0,2,2
42041,söylemektir,0,0,2,2
24962,diğerini,0,0,2,2
27125,خاطئة,0,0,2,2
37677,uppnått,0,0,2,2
20284,வாழ்த்துக்கள்,0,0,2,2
37675,jongen,0,0,2,2
33016,словом,0,0,2,2
31555,تدرك,0,0,2,2
30589,soldados,0,0,2,2
37671,ദത്തവിവര,0,0,2,2
37664,கருத்துக்கள்,0,0,2,2
35494,gratuit,0,0,2,2
20278,pauvre,0,0,2,2
40607,ಪ್ರೀತಿಸುತ್ತೇನೆ,0,0,2,2
42055,apprendre,0,0,2,2
27148,விக்கிப்பீடியாவிலுள்ள,0,0,2,2
24954,deposited,0,0,2,2
37660,любое,0,0,2,2
39048,animar,0,0,2,2
33022,destinamse,0,0,2,2
20270,mache,0,0,2,2
40602,goldenen,0,0,2,2
37649,تفضل,0,0,2,2
39056,चला,0,0,2,2
42052,contrato,0,0,2,2
31549,مصداقية,0,0,2,2
30334,plainte,0,0,2,2
24939,object,0,0,2,2
20287,pseudonyme,0,0,2,2
40609,nela,0,0,2,2
40611,مشاهدة,0,0,2,2
42039,потрясающе»,0,0,2,2
20332,പതുക്കെ,0,0,2,2
20331,hoovering,0,0,2,2
27095,ranging,0,0,2,2
40618,ന്റെ,0,0,2,2
33008,сбудется,0,0,2,2
20324,ಒಂದೇ,0,0,2,2
33885,drowning,0,0,2,2
27103,lessen,0,0,2,2
20320,областях,0,0,2,2
32611,göstermek,0,0,2,2
20315,कला,0,0,2,2
42024,способы,0,0,2,2
20313,run,0,0,2,2
34815,πείραζε,0,0,2,2
34157,ആരുടെയെങ്കിലും,0,0,2,2
32184,المساهمات,0,0,2,2
34817,protegidos,0,0,2,2
40613,പണം,0,0,2,2
33884,mp,0,0,2,2
42028,നിങ്ങളോടൊപ്പമുണ്ടാകും,0,0,2,2
20303,публикует,0,0,2,2
34819,read,0,0,2,2
31564,motivos,0,0,2,2
37682,സിൽവർ,0,0,2,2
27117,പുസ്തകം,0,0,2,2
27119,எடுத்துக்காட்டு,0,0,2,2
39042,ഉദാഹരണത്തിൽ,0,0,2,2
34830,alegações,0,0,2,2
33023,உலகளவில்,0,0,2,2
33863,maiores,0,0,2,2
34165,uitkomt,0,0,2,2
24921,savais,0,0,2,2
20212,trubbig,0,0,2,2
20211,പറയുന്നത്,0,0,2,2
40590,ആൺകുട്ടി,0,0,2,2
22577,произношение,0,0,2,2
37620,века,0,0,2,2
42087,i̇nternet,0,0,2,2
32599,exactly,0,0,2,2
33037,دقيقة,0,0,2,2
20203,undo,0,0,2,2
33039,свободы,0,0,2,2
20201,موثوق,0,0,2,2
35584,ಸಭೆ,0,0,2,2
27210,exchange,0,0,2,2
20252,koruma,0,0,2,2
39068,indexação,0,0,2,2
33868,podrían,0,0,2,2
33866,ലാരി,0,0,2,2
32193,custommade,0,0,2,2
32596,sigue,0,0,2,2
34837,yapmalıyım,0,0,2,2
27218,മൈൽ,0,0,2,2
40577,registran,0,0,2,2
24917,языка,0,0,2,2
42097,semaine,0,0,2,2
33864,ശരിയായ,0,0,2,2
27222,soutien,0,0,2,2
42099,klicken,0,0,2,2
24924,réel,0,0,2,2
37628,واليابانية,0,0,2,2
34164,wellmannered,0,0,2,2
42082,ചതുപ്പുനിലമാണ്,0,0,2,2
22559,empréstimo,0,0,2,2
37644,exeditor,0,0,2,2
37638,seguinte,0,0,2,2
22560,ولطيف,0,0,2,2
34427,مناسب,0,0,2,2
35585,webbplats,0,0,2,2
33026,أسفل,0,0,2,2
20247,مساهمات,0,0,2,2
42064,mágico,0,0,2,2
20244,твои,0,0,2,2
24936,sade,0,0,2,2
39060,branch,0,0,2,2
27183,reçoit,0,0,2,2
24933,haya,0,0,2,2
42069,ಇಷ್ಟಪಟ್ಟರೆ,0,0,2,2
27184,politikartiklar,0,0,2,2
22567,integral,0,0,2,2
20235,ஆரம்பத்தில்,0,0,2,2
34833,forkert,0,0,2,2
20229,золотая,0,0,2,2
20228,verilere,0,0,2,2
27187,locations,0,0,2,2
27188,केंद्र,0,0,2,2
24932,mijl,0,0,2,2
42080,διαφωνώ,0,0,2,2
27196,promotion,0,0,2,2
42081,mainly,0,0,2,2
23705,armazenadas,0,0,2,2
33551,ஃப்ளூமொக்ஸ்,0,0,2,2
10340,acciones,0,0,2,2
10325,ومنفرجة,0,0,2,2
14514,interesting,0,0,2,2
45713,chère,0,0,2,2
45714,نظرًا,0,0,2,2
46973,snigel,0,0,2,2
14510,stimuli,0,0,2,2
45715,cult,0,0,2,2
5947,manga,2,1,1,2
14506,praktik,0,0,2,2
45717,impose,0,0,2,2
12583,entonces,0,0,2,2
11398,togs,0,0,2,2
4655,sky,1,2,0,2
46969,escrituras,0,0,2,2
48441,biliyordum,0,0,2,2
14501,विस्तार,0,0,2,2
14542,نبدأ,0,0,2,2
12587,cellesci,0,0,2,2
10326,языковые,0,0,2,2
49865,ومنع,0,0,2,2
2725,chimica,1,2,0,2
45723,ernst,0,0,2,2
10329,ಬೇಕು,0,0,2,2
46967,سأعطيك,0,0,2,2
12589,ستة,0,0,2,2
7097,svolge,1,2,0,2
2733,sicuramente,1,2,0,2
5513,subì,1,2,0,2
46966,treated,0,0,2,2
51617,ansiklopedi,0,0,2,2
14492,விஷயங்கள்,0,0,2,2
2716,federali,1,2,0,2
4662,missione,1,2,0,2
4664,strette,1,2,0,2
14516,gelijk,0,0,2,2
2698,wikee,2,1,1,2
7123,decidere,1,2,0,2
47733,vocabulário,0,0,2,2
2708,discorso,1,2,0,2
48457,محظوظ,0,0,2,2
45696,tomes,0,0,2,2
5941,peggio,1,2,0,2
47736,objectifs,0,0,2,2
14535,aura,0,0,2,2
5942,tornare,1,2,0,2
10302,biographies,0,0,2,2
2709,competenza,1,2,0,2
14529,trying,0,0,2,2
45701,hydrosphere,0,0,2,2
45703,presión,0,0,2,2
49856,വിഷയങ്ങൾ,0,0,2,2
2711,approfondire,1,2,0,2
4686,sfida,1,2,0,2
11404,république,0,0,2,2
49858,eleições,0,0,2,2
45705,audaz,0,0,2,2
2712,diminuzione,1,2,0,2
7114,partner,2,1,1,2
2713,inutili,1,2,0,2
50832,gegangen,0,0,2,2
7111,marianne,2,1,1,2
10307,ചെയ്യുന്ന,0,0,2,2
50834,понять,0,0,2,2
50312,repareren,0,0,2,2
2739,profonde,1,2,0,2
49869,रखाव,0,0,2,2
14489,riches,0,0,2,2
2777,figaro,2,1,1,2
51597,जिन,0,0,2,2
10366,crash,0,0,2,2
14451,l’homme,0,0,2,2
46958,lower,0,0,2,2
5957,jean,2,1,1,2
2784,catalizzatore,1,2,0,2
4647,rappresentativo,1,2,0,2
10373,حذف,0,0,2,2
7057,problematici,1,2,0,2
45755,proposa,0,0,2,2
12605,قاموا,0,0,2,2
48411,seeks,0,0,2,2
2796,espinoza,2,1,1,2
45757,sophisticated,0,0,2,2
2798,partecipato,1,2,0,2
14439,midden,0,0,2,2
51589,bildirin,0,0,2,2
45761,changé,0,0,2,2
14430,respektive,0,0,2,2
12611,ابنتها,0,0,2,2
51588,publiceringen,0,0,2,2
5960,concerto,1,2,0,2
2803,poteri,1,2,0,2
10383,useless,0,0,2,2
48407,juger,0,0,2,2
45769,menade,0,0,2,2
14423,λήμμα,0,0,2,2
10386,भंडार,0,0,2,2
7051,platt,2,1,1,2
14453,telling,0,0,2,2
12598,precis,0,0,2,2
51614,പ്രകൃതിയുടെ,0,0,2,2
51599,switched,0,0,2,2
12594,fraude,0,0,2,2
14482,dom,0,0,2,2
14481,produire,0,0,2,2
2742,omonimo,1,2,0,2
45736,ആയി,0,0,2,2
48432,μικρότερη,0,0,2,2
7084,terence,1,2,0,2
2746,fusione,1,2,0,2
48431,νόστιμα,0,0,2,2
46962,nuestro,0,0,2,2
7080,contrappone,1,2,0,2
10353,शोधकर्ताओं,0,0,2,2
4654,rivolto,1,2,0,2
10355,namens,0,0,2,2
14469,assurezvous,0,0,2,2
14468,augen,0,0,2,2
2754,nascor,2,1,1,2
7076,sbagli,1,2,0,2
2755,archivi,1,2,0,2
2756,planctu,2,1,1,2
7070,denotando,1,2,0,2
2757,guerel,2,1,1,2
4650,urbane,1,2,0,2
47745,ഫോൺ,0,0,2,2
14465,ξεχάσετε,0,0,2,2
14464,एडम्स,0,0,2,2
14463,z,0,0,2,2
47746,வைத்திருக்கிறேன்,0,0,2,2
2768,waraywaray,2,1,1,2
2697,accademico,1,2,0,2
2696,scheda,1,2,0,2
10389,ರೀತಿ,0,0,2,2
47726,fondateurs,0,0,2,2
2612,khosla,2,1,1,2
10239,രേഖകൾ,0,0,2,2
50807,yerime,0,0,2,2
14647,समूहों,0,0,2,2
2617,enhanced,1,2,0,2
51664,ചോദിക്കാനുള്ള,0,0,2,2
2620,avvenuto,1,2,0,2
10246,авторитетных,0,0,2,2
49828,സ്വതന്ത്രവിജ്ഞാനകോശത്തിന്റെ,0,0,2,2
7179,adattarsi,1,2,0,2
45633,sensibilité,0,0,2,2
7178,secondi,1,2,0,2
2624,calore,1,2,0,2
47724,കൈ,0,0,2,2
4721,specializzati,1,2,0,2
51630,ಹೊಂದಿದ್ದೀರಿ,0,0,2,2
14637,مفيدة,0,0,2,2
14635,mudou,0,0,2,2
50812,മിനിറ്റിനുള്ളിൽ,0,0,2,2
10255,സഹായിക്കാൻ,0,0,2,2
48482,anlatıyorlar,0,0,2,2
51655,daarnaast,0,0,2,2
14630,देखभाल,0,0,2,2
14627,carved,0,0,2,2
2632,controllate,1,2,0,2
2634,goostman,2,1,1,2
45641,يتطلب,0,0,2,2
14623,ಚೂಪಾದ,0,0,2,2
10257,interessado,0,0,2,2
10258,ഉണ്ടോ,0,0,2,2
50324,cuma,0,0,2,2
7181,quantificare,1,2,0,2
5920,motto,1,2,0,2
7182,gravi,1,2,0,2
2562,professionale,1,2,0,2
14688,erzählt,0,0,2,2
45605,redigere,0,0,2,2
48501,galilée,0,0,2,2
14685,resposta,0,0,2,2
14684,நிலத்தின்,0,0,2,2
4732,loveland,2,1,1,2
10226,tenzij,0,0,2,2
14675,ജൂൺ,0,0,2,2
11437,الانتظار,0,0,2,2
10230,ರ,0,0,2,2
14668,mão,0,0,2,2
7189, gb,2,1,1,2
48498,होगी।,0,0,2,2
2572,estendere,1,2,0,2
2574,farebbe,1,2,0,2
4729,sufficienti,1,2,0,2
45614,verfijnd,0,0,2,2
2575,complessivo,1,2,0,2
51678,organized,0,0,2,2
7185,denominatori,1,2,0,2
2585,walter,2,1,1,2
2588,spinta,1,2,0,2
2590,diffusa,1,2,0,2
2591,warren,2,1,1,2
12533,ಹೆಸರಿನ,0,0,2,2
50325,participants,0,0,2,2
11435,വ്യക്തമായ,0,0,2,2
47720,accepteer,0,0,2,2
2643,newyorkese,1,2,0,2
4718,tomasz,2,1,1,2
4716,virtuale,1,2,0,2
49844,sofistikerad,0,0,2,2
10279,british,0,0,2,2
46994,الجامعات,0,0,2,2
12555,conjunta,0,0,2,2
2678,simboliste,1,2,0,2
7144,sedimenti,1,2,0,2
14583,kitabı,0,0,2,2
47730,celebrated,0,0,2,2
14581,لعبتك,0,0,2,2
14578,प्रोत्साहित,0,0,2,2
45668,pronúncia,0,0,2,2
46992,எங்கிருந்து,0,0,2,2
51635,متفرغ,0,0,2,2
45672,स्वागत,0,0,2,2
11414,chaotic,0,0,2,2
4701,east,2,1,1,2
2687,vulva,2,1,1,2
5936,esaminati,1,2,0,2
46987,minutter,0,0,2,2
5937,vietare,1,2,0,2
4699,rappresentanti,1,2,0,2
46985,förtjänar,0,0,2,2
4695,assomigli,1,2,0,2
45683,сетевой,0,0,2,2
48461,निर्णय,0,0,2,2
2693,constable,2,1,1,2
49853,inherently,0,0,2,2
12565,divers,0,0,2,2
14552,zorg,0,0,2,2
48459,ഇങ്ങനെ,0,0,2,2
45662,касается,0,0,2,2
46995,indiquant,0,0,2,2
14622,والآن,0,0,2,2
7147,wikireto,2,1,1,2
2648,legate,1,2,0,2
7175,raccomandato,1,2,0,2
12544,rigor,0,0,2,2
2651,permettersi,1,2,0,2
45645,próprio,0,0,2,2
51649,responsabilidad,0,0,2,2
2654,metadati,1,2,0,2
2656,lacus,2,1,1,2
51646,чтонибудь,0,0,2,2
14611,« pour,0,0,2,2
14610,dışında,0,0,2,2
2665,schede,1,2,0,2
14607,muntra,0,0,2,2
2666,smettila,1,2,0,2
7163,eliminato,1,2,0,2
47000,ನೋಡುತ್ತಿದ್ದೇನೆ,0,0,2,2
45652,डोक्युमेंटेशन,0,0,2,2
48477,puedan,0,0,2,2
50816,lendemain,0,0,2,2
4710,campus,2,1,1,2
49841,க்கு,0,0,2,2
14602,magical,0,0,2,2
11418,neuronaux,0,0,2,2
10272,அம்மாவாக,0,0,2,2
12548,विपरीत,0,0,2,2
2670,raggiungendo,1,2,0,2
50818,छोड़,0,0,2,2
7148,fontenelle,2,1,1,2
10277,दिखती,0,0,2,2
46954,блокировки,0,0,2,2
14413,النزاعات,0,0,2,2
46908,vrijwilligers,0,0,2,2
45909,missing,0,0,2,2
2984,esperienze,1,2,0,2
10499,matériel,0,0,2,2
6942,posizioni,1,2,0,2
2987,civile,1,2,0,2
48334,सरंचना,0,0,2,2
45901,neue,0,0,2,2
2989,watchlist,2,1,1,2
50289,moquez,0,0,2,2
14232,தன்னை,0,0,2,2
48331,plaisir,0,0,2,2
12662,ನುಡಿಗಟ್ಟುಗಳನ್ನು,0,0,2,2
14229,cry,0,0,2,2
6939,iso,2,1,1,2
49913,explicit,0,0,2,2
45910,genomfördes,0,0,2,2
14275,krydsede,0,0,2,2
10510,paramos,0,0,2,2
4578,agisce,1,2,0,2
2995,federato,1,2,0,2
10513,വീഡിയോയിൽ,0,0,2,2
6005,tenere,1,2,0,2
48324,السياسات,0,0,2,2
10517,надеюсь,0,0,2,2
46924,personajes,0,0,2,2
14210,emails,0,0,2,2
14208,आँखें,0,0,2,2
3005,contemporaneamente,1,2,0,2
6923,coordinamento,1,2,0,2
10519,hoort,0,0,2,2
47775,വഴികൾ,0,0,2,2
10498,eksempler,0,0,2,2
14238,जलाया,0,0,2,2
2982,acquisire,1,2,0,2
6947,regolarità,1,2,0,2
47770,prueba,0,0,2,2
49906,écoutez,0,0,2,2
10480,ಹುಡುಗ,0,0,2,2
4599,appuntito,1,2,0,2
14272,редакторами,0,0,2,2
2956,imminente,2,1,1,2
6959,clienti,1,2,0,2
45878,γεύμα,0,0,2,2
6954,suddivide,1,2,0,2
2958,lastre,1,2,0,2
14260,sulten,0,0,2,2
50862,फ़ाइल,0,0,2,2
10485,yardımcı,0,0,2,2
10487,verbessern,0,0,2,2
48342,достаточно,0,0,2,2
4590,huiquipedia,2,1,1,2
12655,magische,0,0,2,2
14252,sustenta,0,0,2,2
51518,huset,0,0,2,2
4589,seguendo,1,2,0,2
10490,كيفية,0,0,2,2
5990,antisociale,1,2,0,2
6948,scriverò,1,2,0,2
45893,छात्रों,0,0,2,2
14243,policyn,0,0,2,2
45894,paris,0,0,2,2
50864,क्लिक,0,0,2,2
48338,nomes,0,0,2,2
2981,sapresti,1,2,0,2
50286,ആദ്യം,0,0,2,2
45925,kurumu,0,0,2,2
14199,dække,0,0,2,2
51479,opmuntre,0,0,2,2
3056,pearl,2,1,1,2
14162,ನೋಡುವುದಿಲ್ಲ,0,0,2,2
3057,dinastia,1,2,0,2
45956,நிமிடங்களில்,0,0,2,2
10537,tengan,0,0,2,2
50880,skruede,0,0,2,2
45958,anladım,0,0,2,2
51477,ಮಿಲಿಯನ್,0,0,2,2
46911,geometrie,0,0,2,2
6891,filosofico,1,2,0,2
3064,complementarità,1,2,0,2
4546,spingono,1,2,0,2
48305,lié,0,0,2,2
14152,ಅಲ್ಲಿಗೆ,0,0,2,2
6889,supercontinente,1,2,0,2
6888,apporta,1,2,0,2
45964,دعنا,0,0,2,2
3071,indossavo,1,2,0,2
51471,lá,0,0,2,2
4545,circolazione,1,2,0,2
14146,συνεχίσουν,0,0,2,2
48304,സമവാക്യത്തിലെ,0,0,2,2
11339,scoring,0,0,2,2
10545,மெலிசா,0,0,2,2
14142,würdest,0,0,2,2
14141,builds,0,0,2,2
6014,dima,2,1,1,2
4539,proceedings,2,1,1,2
10551,avais,0,0,2,2
10535,volunteers,0,0,2,2
11342,минут,0,0,2,2
50284,editoriales,0,0,2,2
3047,sive,2,1,1,2
3008,regni,1,2,0,2
3012,consentite,1,2,0,2
4557,spera,1,2,0,2
3013,habermas,2,1,1,2
6919,bazar,2,1,1,2
45930,ninguém,0,0,2,2
6914,franchecomté,2,1,1,2
6911,obiezioni,1,2,0,2
51491,vise,0,0,2,2
3021,visiva,1,2,0,2
3023,controproducente,1,2,0,2
11346,प्यारी,0,0,2,2
48318,البريدية,0,0,2,2
45936,метавики,0,0,2,2
3029,occupazione,1,2,0,2
14182,الفيلم,0,0,2,2
48316,واستمر,0,0,2,2
6905,foglie,1,2,0,2
4556,conosciamo,1,2,0,2
45940,thuis,0,0,2,2
11344,næppe,0,0,2,2
46917,origens,0,0,2,2
3035,sorgenti,1,2,0,2
51485,şanslısın,0,0,2,2
47776,വാക്കുകളിൽ,0,0,2,2
10529,പ്രകൃതി,0,0,2,2
51484,அனுப்புவேன்,0,0,2,2
6903,ricoperta,1,2,0,2
46915,acyclic,0,0,2,2
46935,sahiptir,0,0,2,2
2952,scale,2,1,1,2
10390,महान,0,0,2,2
14363,लैरी,0,0,2,2
7022,rothenburg,2,1,1,2
7019,costituiscano,1,2,0,2
11379,निरीक्षण,0,0,2,2
45806,habitualmente,0,0,2,2
10413,menciones,0,0,2,2
45809,«punto,0,0,2,2
48390,டெரன்ஸ்,0,0,2,2
2853,sangue,2,1,1,2
12624,قلقة,0,0,2,2
48388,sourire,0,0,2,2
48386,kelimelerin,0,0,2,2
14365,ii»,0,0,2,2
4626,dozzine,1,2,0,2
14364,bristande,0,0,2,2
2856,prestigiose,1,2,0,2
6965,svegliato,1,2,0,2
7010,riassunto,1,2,0,2
10424,warten,0,0,2,2
12627,venido,0,0,2,2
14359,रहूँगा,0,0,2,2
14358,اعتني,0,0,2,2
45818,llevando,0,0,2,2
10427,beskrev,0,0,2,2
12628,простое,0,0,2,2
11373,participación,0,0,2,2
2860,estensioni,1,2,0,2
11371,όλων,0,0,2,2
7004,formulati,1,2,0,2
11370,सम्पादक,0,0,2,2
14350,kurohin,0,0,2,2
45802,reprise,0,0,2,2
2849,verdú,2,1,1,2
2846,ambizioso,1,2,0,2
2845,—o,2,1,1,2
50303,خبزًا,0,0,2,2
5967,accademiche,1,2,0,2
2814,corsa,1,2,0,2
2815,emozione,1,2,0,2
4638,bootstrap,2,1,1,2
46951,άγγελο,0,0,2,2
2818,idrosfera,1,2,0,2
10399,ordforråd,0,0,2,2
2822,legalmente,1,2,0,2
45784,делаешь,0,0,2,2
2824,focalizzate,1,2,0,2
7047,stanislas,2,1,1,2
14400,afortunado,0,0,2,2
4636,risolvibili,1,2,0,2
4633,corrente,1,2,0,2
12619,ഏതെങ്കിലും,0,0,2,2
45791,τίτλο,0,0,2,2
14394,inondé,0,0,2,2
51577,saltwater,0,0,2,2
2830,tian,2,1,1,2
49887,स्वर,0,0,2,2
7036,esibito,1,2,0,2
10404,തരാമോ,0,0,2,2
45795,diretamente,0,0,2,2
10405,ಹೇಳುತ್ತಿರುವುದನ್ನು,0,0,2,2
48397,grap,0,0,2,2
7027,addosso,1,2,0,2
46948,rejste,0,0,2,2
48395,ದಿನಾಂಕವನ್ನು,0,0,2,2
2865,gfdle,2,1,1,2
2867,aziende,1,2,0,2
12638,ameaça,0,0,2,2
2919,volere,1,2,0,2
6988,immaginassero,1,2,0,2
51542,ಉತ್ತಮವಾಗಿ,0,0,2,2
6983,traduzioni,1,2,0,2
45860,réside,0,0,2,2
6981,controllano,1,2,0,2
45862,τεράστιο,0,0,2,2
2924,indipendenza,1,2,0,2
5979,symbol,2,1,1,2
47766,городе,0,0,2,2
10465,अग्रसर,0,0,2,2
14290,ήθελε,0,0,2,2
47768,συμβαίνουν,0,0,2,2
10468,mitad,0,0,2,2
14289,programmés,0,0,2,2
6974,altrimenti,1,2,0,2
2938,nativi,1,2,0,2
6972,lette,1,2,0,2
50294,ಹೇಳುತ್ತಿದ್ದೀರಿ,0,0,2,2
10472,கண்கள்,0,0,2,2
5986,regolano,1,2,0,2
45866,آي,0,0,2,2
45868,densité,0,0,2,2
14284,constar,0,0,2,2
14283,विकिशब्दकोष,0,0,2,2
10475,результате,0,0,2,2
12649,esbozos,0,0,2,2
2949,leader,1,2,0,2
14280,ಮದುವೆಯಾಗಲು,0,0,2,2
6967,animato,1,2,0,2
14299,dining,0,0,2,2
12645,théoriquement,0,0,2,2
46940,பயங்கரமான,0,0,2,2
14303,பின்,0,0,2,2
45831,بنسبة,0,0,2,2
14337,constraint,0,0,2,2
7001,goto,2,1,1,2
45836,habla,0,0,2,2
12641,ट्रुथ,0,0,2,2
51558,role,0,0,2,2
51557,ogg,0,0,2,2
6998,semestre,2,1,1,2
4621,protein,2,1,1,2
6996,imieliński,2,1,1,2
10447,ссылался,0,0,2,2
11366,etablerade,0,0,2,2
4617,germania,1,2,0,2
14323,الرجال,0,0,2,2
2891,arrabbiati,1,2,0,2
10451,financiamento,0,0,2,2
2896,wikicodeq,2,1,1,2
4610,excel,2,1,1,2
48364,ஆர்வம்,0,0,2,2
6995,svolta,1,2,0,2
6993,integrità,1,2,0,2
45851,ابنتي,0,0,2,2
2902,zim,2,1,1,2
2906,filtri,1,2,0,2
10459,bestrijden,0,0,2,2
50854,gitmeye,0,0,2,2
2917,emancipazione,1,2,0,2
45855,βικινέα,0,0,2,2
11365,gav,0,0,2,2
14690,livet,0,0,2,2
45602,المعتاد,0,0,2,2
2559,leggere,1,2,0,2
2210,riduce,1,2,0,2
2189,anglia,2,1,1,2
7402,personalità,1,2,0,2
10012,findings,0,0,2,2
15070,« ce,0,0,2,2
49737,राय,0,0,2,2
15064,बताता,0,0,2,2
4901,convergenti,1,2,0,2
10013,потрясающую,0,0,2,2
15060,recharge,0,0,2,2
15059,publicou,0,0,2,2
45380,बह,0,0,2,2
7393,razzista,1,2,0,2
2209,indonesiano,1,2,0,2
5822,plotkin,2,1,1,2
12428,фильм,0,0,2,2
7420,ridendo,1,2,0,2
10024,teksten,0,0,2,2
47676,википедии»,0,0,2,2
51817,weise,0,0,2,2
10027,пишут,0,0,2,2
11506,episch,0,0,2,2
11503,effectively,0,0,2,2
15046,αγαπητή,0,0,2,2
49746,dominios,0,0,2,2
2223,variazione,1,2,0,2
15045,μπορούσε,0,0,2,2
50743,تعتمد,0,0,2,2
4887,abiotici,1,2,0,2
48627,prisons,0,0,2,2
45391,accumulated,0,0,2,2
50372,assignments,0,0,2,2
50738,معًا,0,0,2,2
2187,trattamento,1,2,0,2
51828,kriterier,0,0,2,2
2155,interpreta,1,2,0,2
4924,modellano,1,2,0,2
9990,förvirrad,0,0,2,2
15098,другую,0,0,2,2
2161,località,1,2,0,2
15096,daquela,0,0,2,2
12415,süredir,0,0,2,2
9992,ಬಯಸುತ್ತೀರಾ,0,0,2,2
2165,svolti,1,2,0,2
4922,curati,1,2,0,2
2166,circondano,1,2,0,2
51839,καταλάβατε,0,0,2,2
15093,korta,0,0,2,2
9993,tonight,0,0,2,2
9994,"
डच",0,0,2,2
2171,verificabili,1,2,0,2
48649,obtienes,0,0,2,2
15087,flux,0,0,2,2
2173,evolve,1,2,0,2
45365,último,0,0,2,2
7415,sfrutta,1,2,0,2
48645,അല്ല,0,0,2,2
4918,fece,1,2,0,2
15081,acuñado,0,0,2,2
12423,περάσετε,0,0,2,2
10002,പോകാം,0,0,2,2
45370,σφαίρα,0,0,2,2
5818,ispirato,1,2,0,2
15074,सदस्यता,0,0,2,2
15037,खाद्य,0,0,2,2
4886,dottrina,1,2,0,2
2230,stimare,1,2,0,2
10053,constitutes,0,0,2,2
2269,creep,2,1,1,2
10055,goldbrot,0,0,2,2
10056,işler,0,0,2,2
7372,stabilizza,1,2,0,2
50751,जल्दी,0,0,2,2
45420,цели,0,0,2,2
51795,ഇപ്പോഴും,0,0,2,2
10058,uygun,0,0,2,2
14996,credit,0,0,2,2
7370,analoghi,1,2,0,2
2282,cercato,1,2,0,2
49757,skoja,0,0,2,2
7367,curve,2,1,1,2
14994,चुनाव,0,0,2,2
11498,настоящее,0,0,2,2
11495,выпущен,0,0,2,2
2288,dichiarazione,1,2,0,2
14988,числа,0,0,2,2
10069,esses,0,0,2,2
7359,copriva,1,2,0,2
4853,discrepanza,1,2,0,2
48602,implies,0,0,2,2
2293,incontrerò,1,2,0,2
45428,pt,0,0,2,2
45429,bancário,0,0,2,2
51787,இருப்பினும்,0,0,2,2
10072,libertad,0,0,2,2
2300,rimase,1,2,0,2
49763,opensolaris,0,0,2,2
51800,poucos,0,0,2,2
7374,importarmene,1,2,0,2
4885,strutturali,1,2,0,2
10052,uppfattningar,0,0,2,2
4883,fondanti,1,2,0,2
49750,terceira,0,0,2,2
48623,couvrir,0,0,2,2
2236,strizzarono,1,2,0,2
2239,compositore,1,2,0,2
4882,particelle,1,2,0,2
10037,iedereen,0,0,2,2
7380,eccessivo,1,2,0,2
51810,nieuws,0,0,2,2
10039,dejlig,0,0,2,2
10041,कृप्या,0,0,2,2
15025,dominated,0,0,2,2
48621,essencialmente,0,0,2,2
48620,முழு,0,0,2,2
15021,resumen,0,0,2,2
2249,occhiata,1,2,0,2
15019,krävs,0,0,2,2
4875,continui,1,2,0,2
10046,görünüyordu,0,0,2,2
4873,elabora,1,2,0,2
5826,hoefler,2,1,1,2
45406,kvaliteten,0,0,2,2
15016,виду,0,0,2,2
5828,misurazione,1,2,0,2
2253,martin,2,1,1,2
2256,strickland,2,1,1,2
10051,vieram,0,0,2,2
2261,pos,2,1,1,2
45416,итак,0,0,2,2
4927,legata,1,2,0,2
11523,bryr,0,0,2,2
7192,swarm,2,1,1,2
2079,riguardano,1,2,0,2
15223,hou,0,0,2,2
9935,परिभाषित,0,0,2,2
5798,homo,2,1,1,2
2074,variare,1,2,0,2
15215,للكلمة,0,0,2,2
9940,λικνίζεις,0,0,2,2
5799,moulinwiki,2,1,1,2
5800,péréa,2,1,1,2
49713,ആവർത്തിക്കാമോ,0,0,2,2
45296,செய்வோம்,0,0,2,2
15201,affranchir,0,0,2,2
15200,रिकॉर्ड,0,0,2,2
2076,collaborano,1,2,0,2
48675,αριθμό,0,0,2,2
15196,സൗജന്യവും,0,0,2,2
4932,timori,1,2,0,2
7483,indiano,1,2,0,2
7482,complementari,1,2,0,2
47656,féliciter,0,0,2,2
5801,accompagnato,1,2,0,2
15189,будут,0,0,2,2
15188,ഇഷ്‌ടപ്പെട്ടെങ്കിൽ,0,0,2,2
9948,उपयोगिता,0,0,2,2
48672,فضيًا,0,0,2,2
48671,assis,0,0,2,2
2085,sottoposta,1,2,0,2
7479,significativi,1,2,0,2
49714,positivos,0,0,2,2
11530,utformning,0,0,2,2
9954,நிலைமை,0,0,2,2
51889,долларов,0,0,2,2
15224,إمكانية,0,0,2,2
9932,शिक्षाविद,0,0,2,2
47119,viernes,0,0,2,2
2045,indirizzi,1,2,0,2
48688,друзей,0,0,2,2
11541,"
बेलारूसी",0,0,2,2
2050,contenessero,1,2,0,2
15251,numa,0,0,2,2
15250,gideceksin,0,0,2,2
2051,complementare,1,2,0,2
5795,relazionali,1,2,0,2
4965,conferisce,1,2,0,2
45272,stand,0,0,2,2
4962,buffon,2,1,1,2
2055,asterisco,2,1,1,2
7497,—usemod—,2,1,1,2
15238,turquie,0,0,2,2
2059,patch,2,1,1,2
45276,pourraistu,0,0,2,2
12381,paysbas,0,0,2,2
9926,diskussionsforum,0,0,2,2
12382,bedeutung,0,0,2,2
5797,valutazioni,1,2,0,2
48682,simples,0,0,2,2
7494,decentralizzato,1,2,0,2
7489,stiegler,2,1,1,2
47653,sentada,0,0,2,2
2063,passando,2,1,1,2
15227,النمو,0,0,2,2
9931,tænke,0,0,2,2
2064,sarai,1,2,0,2
2066,informativa,2,1,1,2
47111,februari,0,0,2,2
9955,rockt,0,0,2,2
9956,observar,0,0,2,2
7454,confrontando,1,2,0,2
51856,supercontinent,0,0,2,2
7451,fiscale,2,1,1,2
7450,netfront,2,1,1,2
45338,ആധികാരികത,0,0,2,2
51853,aprobación,0,0,2,2
12406,feel,0,0,2,2
15132,доступными,0,0,2,2
7447,riferirsi,1,2,0,2
2136,ecml,2,1,1,2
7445,parlarne,1,2,0,2
7443,colloquiale,1,2,0,2
5811,hughes,2,1,1,2
7440,gravità,1,2,0,2
7438,inciclopedia,2,1,1,2
15127,skruvade,0,0,2,2
15122,irme,0,0,2,2
7436,gentili,1,2,0,2
2139,tranne,1,2,0,2
15117,fácilmente,0,0,2,2
9978,sept,0,0,2,2
9981,état,0,0,2,2
45349,intensifier,0,0,2,2
9982,ಒಪ್ಪುತ್ತೇನೆ,0,0,2,2
12407,കുറച്ചുകാലമായി,0,0,2,2
15112,explicó,0,0,2,2
47100,pequeño,0,0,2,2
7428,biologica,1,2,0,2
7427,alpha,2,1,1,2
2146,valenciana,2,1,1,2
2129,posta,1,2,0,2
5809,artisti,1,2,0,2
4945,dominique,2,1,1,2
51859,gerelateerd,0,0,2,2
9957,статистических,0,0,2,2
15178,хотел,0,0,2,2
49719,ettiğimi,0,0,2,2
9959,ordning,0,0,2,2
15175,troublesome,0,0,2,2
49720,edemem,0,0,2,2
47108,locked,0,0,2,2
7464,nostre,1,2,0,2
2100,irrilevante,1,2,0,2
48665,hazırlandım,0,0,2,2
2103,induzione,1,2,0,2
5802,mcculloch,2,1,1,2
4939,hrw,2,1,1,2
45318,externes,0,0,2,2
15165,ब्रेड,0,0,2,2
15163,κάνουν,0,0,2,2
49723,мультимедийных,0,0,2,2
9966,ومع,0,0,2,2
15157,الذهاب,0,0,2,2
47663,إليك,0,0,2,2
51865,papier,0,0,2,2
49724,واسعة,0,0,2,2
45325,நடத்தப்படும்,0,0,2,2
7458,hong,2,1,1,2
48663,läggas,0,0,2,2
2119,physis,2,1,1,2
49725,opener,0,0,2,2
51860,decisión,0,0,2,2
45330,évidentes,0,0,2,2
2304,deviazioni,1,2,0,2
14977,verilir,0,0,2,2
48598,disponen,0,0,2,2
51714,"
पिकार्ड",0,0,2,2
45549,ಸುಂದರವಾಗಿ,0,0,2,2
11451,கவலைப்படுகிறீர்களா,0,0,2,2
49804,मेजबानी,0,0,2,2
14783,denotar,0,0,2,2
10176,wurzeln,0,0,2,2
7248,batterica,1,2,0,2
45552,raiva,0,0,2,2
47020,aucun,0,0,2,2
50790,höre,0,0,2,2
14771,πρωί,0,0,2,2
49805,weekly,0,0,2,2
48529,omedelbart,0,0,2,2
12518,donaciones,0,0,2,2
10181,حل,0,0,2,2
12519,ativas,0,0,2,2
2305,imprecisioni,1,2,0,2
51713,متأكدا,0,0,2,2
10183,تأكد,0,0,2,2
14760,الإعلانات,0,0,2,2
14758,തങ്ങൾ,0,0,2,2
5896,bravi,1,2,0,2
10186,structurale,0,0,2,2
14748,evlilikte,0,0,2,2
14747,beri,0,0,2,2
51711,damas,0,0,2,2
7241,scheletro,1,2,0,2
14743,sætte,0,0,2,2
4765,noprofit,1,2,0,2
14742,cidadão,0,0,2,2
7237,hamburger,2,1,1,2
2451,puntando,1,2,0,2
2449,palazzo,1,2,0,2
50336,consider,0,0,2,2
14787,reconocimiento,0,0,2,2
14819,بداية,0,0,2,2
14818,considerados,0,0,2,2
12501,सकते।,0,0,2,2
5882,anomalo,1,2,0,2
14815,അദ്ദേഹം,0,0,2,2
7271,direttrice,1,2,0,2
4786,annualmente,1,2,0,2
2426,ritardo,1,2,0,2
2430,settentrionale,1,2,0,2
48542,necessarily,0,0,2,2
2431,conosce,1,2,0,2
2433,finlandese,1,2,0,2
5890,sony,2,1,1,2
47706,இளவரசன்,0,0,2,2
2437,ordinate,1,2,0,2
51722,बैठे,0,0,2,2
2441,fnr,2,1,1,2
4780,annegamento,1,2,0,2
14797,വായ്പ,0,0,2,2
45540,θέλεις,0,0,2,2
2446,rimani,1,2,0,2
14794,شكك,0,0,2,2
14793,പുതുതായി,0,0,2,2
5891,eucarioti,1,2,0,2
7259,slide,2,1,1,2
10171,деятельности,0,0,2,2
45545,beslissing,0,0,2,2
10173,bırak,0,0,2,2
45546,ούτως,0,0,2,2
10193,இருந்ததால்,0,0,2,2
10194,intellectuelle,0,0,2,2
12520,skål,0,0,2,2
2516,scoprono,1,2,0,2
2519,preparazione,1,2,0,2
2521,avanzamento,1,2,0,2
48507,அங்கு,0,0,2,2
14708,வந்தேன்,0,0,2,2
14706,şikayet,0,0,2,2
2523,aude,2,1,1,2
45591,पसंदीदा,0,0,2,2
45592,ಅತ್ಯಾಧುನಿಕ,0,0,2,2
5909,massimo,1,2,0,2
2526,tematiche,1,2,0,2
2531,wikiwikiwebad,2,1,1,2
2533,apprezzo,1,2,0,2
14699,politician,0,0,2,2
51693,olumlu,0,0,2,2
7203,avviata,1,2,0,2
50328,πάρτε,0,0,2,2
7200,enmobilewikipediaorg,2,1,1,2
12532,تحدث,0,0,2,2
7194,meridionale,1,2,0,2
48505,εγκυκλοπαίδειας,0,0,2,2
48504,ответить,0,0,2,2
14695,amerikanere,0,0,2,2
10221,अरे,0,0,2,2
45600,clearly,0,0,2,2
51685,نحن,0,0,2,2
2555,informatici,1,2,0,2
11440,அடிப்படை,0,0,2,2
51684,fikrim,0,0,2,2
14692,primárias,0,0,2,2
11443,pensé,0,0,2,2
45585,duim,0,0,2,2
14736,fransa,0,0,2,2
2515,osserva,1,2,0,2
2480,asturiana,1,2,0,2
45569,അടുത്ത്,0,0,2,2
2484,trovarsi,1,2,0,2
14732,δουλέψει,0,0,2,2
12522,energi,0,0,2,2
2488,impedito,1,2,0,2
11447,siècles,0,0,2,2
14729,drømme,0,0,2,2
7234,creativi,1,2,0,2
10201,zoek,0,0,2,2
45574,नार्किसा,0,0,2,2
45575,இதன்மூலம்,0,0,2,2
10202,soruyorum,0,0,2,2
2495,divisioni,1,2,0,2
49811,organizan,0,0,2,2
2496,violando,2,1,1,2
7226,ac,1,2,0,2
45577,hemskt,0,0,2,2
2500,edifici,1,2,0,2
7225,superano,1,2,0,2
48512,box,0,0,2,2
47015,patients,0,0,2,2
14720,situationen,0,0,2,2
2508,legislative,1,2,0,2
7217,commonso,2,1,1,2
2511,nuclei,2,1,1,2
12528,சொன்னாள்,0,0,2,2
4758,fornendo,1,2,0,2
45583,വിറ്റു,0,0,2,2
12500,siehst,0,0,2,2
2424,snow,2,1,1,2
50341,números,0,0,2,2
12451,திட்டங்களை,0,0,2,2
11488,تسمع,0,0,2,2
2331,kurier,2,1,1,2
45461,ζητώντας,0,0,2,2
10093,मिलाकर,0,0,2,2
7340,cambriana,1,2,0,2
14921,enerji,0,0,2,2
14920,ordnummer,0,0,2,2
2333,litt,2,1,1,2
45466,lire,0,0,2,2
14913,utformas,0,0,2,2
45468,ஒருவருக்கொருவர்,0,0,2,2
7333,xvi,2,1,1,2
51766,தெரியப்படுத்துங்கள்,0,0,2,2
51765,обсуждаются,0,0,2,2
7332,presa,1,2,0,2
7329,mammiferi,1,2,0,2
7328,wikipetan,2,1,1,2
12453,bild,0,0,2,2
4828,continuò,1,2,0,2
50361,biliyorsunuz,0,0,2,2
4825,sensi,1,2,0,2
10100,ಮನಸ್ಸಿಲ್ಲವೇ,0,0,2,2
14902,letárgico,0,0,2,2
11484,örneği,0,0,2,2
51757,luimême,0,0,2,2
51756,presents,0,0,2,2
45476,അർത്ഥമാക്കുന്നു,0,0,2,2
2352,jarre,2,1,1,2
45477,zoekmachines,0,0,2,2
2330,scintillanti,1,2,0,2
14933,udgave,0,0,2,2
48578,ನಾರ್ಸಿಸ್,0,0,2,2
4832,redattrici,1,2,0,2
14973,படிப்பினைகளை,0,0,2,2
45434,awarded,0,0,2,2
5842,pittura,1,2,0,2
47067,øve,0,0,2,2
47687,какое,0,0,2,2
4847,rumeno,1,2,0,2
4846,destino,1,2,0,2
10079,बढ़ा,0,0,2,2
10080,محتواها,0,0,2,2
14963,nações,0,0,2,2
14962,интернетпользователей,0,0,2,2
50759,ഇൻപുട്ട്,0,0,2,2
7345,secondaria,1,2,0,2
2317,prestigio,2,1,1,2
4843,reali,1,2,0,2
2318,subodh,2,1,1,2
10084,möta,0,0,2,2
14957,berbat,0,0,2,2
51773,evolves,0,0,2,2
48591,ಧ್ವನಿಸಲು,0,0,2,2
10088,philosophies,0,0,2,2
45445,velopdragen,0,0,2,2
45446,besværlig,0,0,2,2
14948,المستنقع,0,0,2,2
45449,kullanabileceğin,0,0,2,2
50362,avhandlingen,0,0,2,2
2323,affrontato,1,2,0,2
45452,disposition,0,0,2,2
7341,convenzione,1,2,0,2
4822,gboard,2,1,1,2
11476,välkomna,0,0,2,2
45525,субботу,0,0,2,2
45499,olduğumuzu,0,0,2,2
7295,divisa,1,2,0,2
10140,independence,0,0,2,2
7294,farei,1,2,0,2
14851,மிகச்சிறந்த,0,0,2,2
2388,metrix,2,1,1,2
47042,வழியாகும்,0,0,2,2
2390,hossein,2,1,1,2
7293,letargico,1,2,0,2
45509,பார்க்கிறீர்கள்,0,0,2,2
51737,свидетельствуют,0,0,2,2
2394,giornalistiche,1,2,0,2
51736,செய்ததற்கு,0,0,2,2
45511,ಕೆಲಸದ,0,0,2,2
14843,äter,0,0,2,2
48553,l’influence,0,0,2,2
45515,benzeri,0,0,2,2
7288,seguita,1,2,0,2
2411,backpropagation,2,1,1,2
10150,obtiendrez,0,0,2,2
45517,бесконечно,0,0,2,2
45518,وشكك,0,0,2,2
7286,maya,2,1,1,2
2415,yale,2,1,1,2
2416,venir,2,1,1,2
2418,stagioni,1,2,0,2
50343,ಕೇಳಿದರೆ,0,0,2,2
49790,yaptığı,0,0,2,2
47037,volledige,0,0,2,2
10154,d’aa,0,0,2,2
10135,sought,0,0,2,2
12479,включая,0,0,2,2
14892,biçiminde,0,0,2,2
14861,نيتشر,0,0,2,2
14891,novamente,0,0,2,2
7315,maturazione,1,2,0,2
2359,separazione,1,2,0,2
47055,учёные,0,0,2,2
10109,valor,0,0,2,2
7312,brandchannel,2,1,1,2
2362,otterresti,1,2,0,2
47053,அர்த்தம்,0,0,2,2
4814,perciò,1,2,0,2
10112,använt,0,0,2,2
10113,geléia,0,0,2,2
2368,credito,1,2,0,2
48572,ചങ്ങാതിമാരുമായി,0,0,2,2
10118,المبالغة,0,0,2,2
11475,tried,0,0,2,2
12468,reasoning,0,0,2,2
47051,kullansam,0,0,2,2
11474,dark,0,0,2,2
47049,consultés,0,0,2,2
14869,നടത്താൻ,0,0,2,2
2374,ostan,2,1,1,2
11471,spot,0,0,2,2
14867,интересные,0,0,2,2
14866,πλαίσιο,0,0,2,2
14865,contact,0,0,2,2
12473,impactfactor,0,0,2,2
14864,weinig,0,0,2,2
11469,विकिताबें,0,0,2,2
50776,ressource,0,0,2,2
49931,grew,0,0,2,2
47778,nature ,0,0,2,2
2043,londra,1,2,0,2
46442,см,0,0,2,2
3851,raggiunge,1,2,0,2
51150,привело,0,0,2,2
13445,ಕೈ,0,0,2,2
13442,പ്രശ്നമുണ്ടോ,0,0,2,2
13441,ऋण,0,0,2,2
3853,sovrappongono,1,2,0,2
4294,imperfetto,1,2,0,2
46436,positives,0,0,2,2
12921,durumu,0,0,2,2
3860,alembert,2,1,1,2
13432,ouviu,0,0,2,2
4288,esatti,1,2,0,2
3865,wikimed,2,1,1,2
3866,prossimi,1,2,0,2
6413,contestata,1,2,0,2
13486,pendentes,0,0,2,2
3868,classici,1,2,0,2
3869,machinery,2,1,1,2
3872,pietra,1,2,0,2
3877,prezzi,1,2,0,2
13420,coole,0,0,2,2
3880,partnership,1,2,0,2
12923,unser,0,0,2,2
6411,entrano,1,2,0,2
6408,generalizzare,1,2,0,2
48023,cuyas,0,0,2,2
13408,fortsätter,0,0,2,2
50969,التحدث,0,0,2,2
13407,മികച്ചതായിരിക്കും,0,0,2,2
50972,frau,0,0,2,2
3847,accessibile,1,2,0,2
13449,svara,0,0,2,2
10961,பயன்படுத்தப்படுகின்றன,0,0,2,2
50222,internets,0,0,2,2
10942,términos,0,0,2,2
6443,microrganismi,1,2,0,2
3808,aggiunti,1,2,0,2
3809,logicamente,1,2,0,2
3811,wilson,2,1,1,2
10946,leads,0,0,2,2
13477,hadden,0,0,2,2
13476,sofá,0,0,2,2
3815,combinazione,1,2,0,2
6438,serres,2,1,1,2
3817,contribuire,1,2,0,2
3819,svolto,1,2,0,2
4312,françois,2,1,1,2
6158,feeder,2,1,1,2
11212,വണ്ടിയിൽ,0,0,2,2
13467,dreams,0,0,2,2
46416,relatou,0,0,2,2
4305,stabiliti,1,2,0,2
50960,இயங்கி,0,0,2,2
48032,supongo,0,0,2,2
46420,नार्सीसस,0,0,2,2
3835,—e,1,2,0,2
3837,inserzionisti,1,2,0,2
6429,connessioni,1,2,0,2
47863,mercado,0,0,2,2
4301,trader,2,1,1,2
47864,således,0,0,2,2
10956,fenômeno,0,0,2,2
50964,reproduction,0,0,2,2
46457,sos,0,0,2,2
50218,exactamente,0,0,2,2
3887,estranei,1,2,0,2
50208,использоваться,0,0,2,2
13371,понятие,0,0,2,2
11198,προτάσεων,0,0,2,2
13368,läget,0,0,2,2
51119,αμέσως,0,0,2,2
6376,aperti,1,2,0,2
3936,procedura,1,2,0,2
6190,falsamente,2,1,1,2
13361,pequenos,0,0,2,2
51117,concordo,0,0,2,2
13359,domaines,0,0,2,2
46484,एन्साइक्लोपीडिया,0,0,2,2
3938,fresco,2,1,1,2
6374,scarsamente,1,2,0,2
12949,britânica,0,0,2,2
46485,rodando,0,0,2,2
11192,വിജ്ഞാനകോശം,0,0,2,2
6192,enti,1,2,0,2
13354,profundamente,0,0,2,2
11189,korrekt,0,0,2,2
46487,ஆங்கிலம்,0,0,2,2
3940,conclusione,1,2,0,2
13346,மாற்றப்பட்டது,0,0,2,2
12959,அதனை,0,0,2,2
13343,еды,0,0,2,2
51115,könnte,0,0,2,2
47993,totaal,0,0,2,2
6363,autorevole,1,2,0,2
13339,fremsætter,0,0,2,2
46724,købe,0,0,2,2
3931,applicati,1,2,0,2
50980,betydning,0,0,2,2
13401,wp,0,0,2,2
3929,pazienti,1,2,0,2
50213,laddade,0,0,2,2
51141,संकलन,0,0,2,2
6398,www,2,1,1,2
50116,ene,0,0,2,2
50117,kişi,0,0,2,2
50119,naissance,0,0,2,2
13397,occasionally,0,0,2,2
51133,antecipadamente,0,0,2,2
46746,agi,0,0,2,2
4279,holtzbrinck,2,1,1,2
13392,character,0,0,2,2
12932,فأنا,0,0,2,2
50211,evolution,0,0,2,2
4277,famiglie,1,2,0,2
13388,ലേഖനങ്ങളാവാൻ,0,0,2,2
13384,gegevens,0,0,2,2
50976,extensión,0,0,2,2
13382,بوميس,0,0,2,2
48009,objective,0,0,2,2
8613,pagerank,2,1,1,2
4269,stabili,1,2,0,2
48006,апреле,0,0,2,2
13376,publiceerde,0,0,2,2
46474,കേരളത്തിനുള്ളിൽ,0,0,2,2
6380,sufficientemente,1,2,0,2
50978,witz,0,0,2,2
3926,wikipediocracy,2,1,1,2
6379,porti,1,2,0,2
12939,geração,0,0,2,2
10941,ಅದೃಷ್ಟದ,0,0,2,2
4316,blackout,2,1,1,2
3951,equità,1,2,0,2
13558,ലഭിക്കുന്നു,0,0,2,2
6132,puramente,1,2,0,2
13567,ട്യൂമറിന്റെ,0,0,2,2
6525,realizzare,1,2,0,2
46340,tratando,0,0,2,2
6524,aciclico,1,2,0,2
50942,ಯಾರು,0,0,2,2
4339,alfabeti,1,2,0,2
50069,i̇letişim,0,0,2,2
13562,defesa,0,0,2,2
51213,internos,0,0,2,2
46343,verspreiden,0,0,2,2
3707,porterà,1,2,0,2
12881,redor,0,0,2,2
4337,—libro,2,1,1,2
3710,tempestata,1,2,0,2
48041,inicial,0,0,2,2
50233,velkommen,0,0,2,2
6135,shepelyansky,2,1,1,2
6508,arun,2,1,1,2
13556,tornandoa,0,0,2,2
48075,vermektedir,0,0,2,2
12883,leaves,0,0,2,2
46349,bienvenue,0,0,2,2
3718,previa,2,1,1,2
6504,sessuali,1,2,0,2
47846,outsiders,0,0,2,2
46352,aşağıdaki,0,0,2,2
6496,rilevato,1,2,0,2
3723,reciproche,1,2,0,2
4331,impersonificazione,1,2,0,2
3702,nascoste,1,2,0,2
10873,closest,0,0,2,2
4350,razionalità,1,2,0,2
4355,criticò,1,2,0,2
46318,illustration,0,0,2,2
3657,obsoleti,1,2,0,2
51232,க்கும்,0,0,2,2
3663,dedicata,1,2,0,2
46321,പക്ഷെ,0,0,2,2
10856,வண்டி,0,0,2,2
3667,carenze,1,2,0,2
51229,güvenilir,0,0,2,2
6541,mantello,1,2,0,2
48093,اسمها,0,0,2,2
12867,видела,0,0,2,2
3671,classificatore,1,2,0,2
6538,monobook,2,1,1,2
4359,aggiornate,1,2,0,2
4358,esplorativa,1,2,0,2
13590,obligé,0,0,2,2
13588,ಮಾಡುತ್ತಿದ್ದಳು,0,0,2,2
48089,डूब,0,0,2,2
46781,duiden,0,0,2,2
6532,rapida,1,2,0,2
13587,заслуживаю,0,0,2,2
3696,austriaca,2,1,1,2
13585,comprises,0,0,2,2
13584,κόπο,0,0,2,2
10869,частности,0,0,2,2
13576,ಖಚಿತವಾಗಿ,0,0,2,2
13575,starten,0,0,2,2
46334,временем,0,0,2,2
6126,catturata,1,2,0,2
46355,للسؤال,0,0,2,2
10893,ennuyeux,0,0,2,2
4327,claude,2,1,1,2
6144,fungono,1,2,0,2
46381,എവിടെ,0,0,2,2
3764,tradotti,1,2,0,2
51189,länk,0,0,2,2
50229,boy,0,0,2,2
3767,disgrazia,1,2,0,2
46764,affaires,0,0,2,2
6466,scomposizione,1,2,0,2
50228,crée,0,0,2,2
3769,distribuite,1,2,0,2
46390,إرسال,0,0,2,2
48049,established,0,0,2,2
6155,lava,2,1,1,2
46392,sensitive,0,0,2,2
13498,ശരി,0,0,2,2
3773,unumerit,2,1,1,2
10929,caché,0,0,2,2
6156,inverno,1,2,0,2
51183,σταματήστε,0,0,2,2
10930,കൊള്ളാം,0,0,2,2
12906,बंद,0,0,2,2
3782,turner,2,1,1,2
11216,saindo,0,0,2,2
6452,nauruano,2,1,1,2
6451,contempo,1,2,0,2
48044,podía,0,0,2,2
12907,என,0,0,2,2
13490,изначально,0,0,2,2
13489,credited,0,0,2,2
4317,luminosi,1,2,0,2
6148,corretto,1,2,0,2
6474,riservato,1,2,0,2
12892,सारे,0,0,2,2
10910,besvärlig,0,0,2,2
46359,предоставляет,0,0,2,2
6492,dehaene,2,1,1,2
3730,accettate,1,2,0,2
6490,tradotto,1,2,0,2
6489,coltivate,1,2,0,2
50078,gerektiğini,0,0,2,2
3737,primitive,2,1,1,2
12893,കൂടിക്കാഴ്‌ചയുണ്ട്,0,0,2,2
46768,вашим,0,0,2,2
13534,الأشهر,0,0,2,2
6483,atmosferiche,1,2,0,2
3741,scelta,1,2,0,2
11227,criaram,0,0,2,2
3743,meccanismi,1,2,0,2
51197,بشخص,0,0,2,2
10906,tone,0,0,2,2
3747,volontario,1,2,0,2
50083,istediğin,0,0,2,2
13527,caracol,0,0,2,2
3750,supervisionate,1,2,0,2
3752,superare,1,2,0,2
51195,nederländska,0,0,2,2
46371,ikväll,0,0,2,2
50084,لاحقًا,0,0,2,2
4323,riscontrato,1,2,0,2
46373,правлю,0,0,2,2
46375,fandt,0,0,2,2
3760,identificarsi,1,2,0,2
46377,parecer,0,0,2,2
46497,kaufen,0,0,2,2
46499,recebeu,0,0,2,2
6871,battuta,1,2,0,2
47930,tamaño,0,0,2,2
51003,doctrine,0,0,2,2
11098,возможности,0,0,2,2
13014,begrepen,0,0,2,2
4210,verificata,1,2,0,2
46625,publicerades,0,0,2,2
47937,खुशी,0,0,2,2
4108,vincolo,1,2,0,2
46627,faces,0,0,2,2
6259,rousseau,2,1,1,2
13016,мариан,0,0,2,2
46629,naturligt,0,0,2,2
47904,ноября,0,0,2,2
13112,gerekmez,0,0,2,2
6254,cohen,2,1,1,2
50180,chérie,0,0,2,2
13185,gevraagd,0,0,2,2
11112,φωτεινά,0,0,2,2
46636,zichzelf,0,0,2,2
47929,expansion,0,0,2,2
4122,soggette,1,2,0,2
47928,allerlei,0,0,2,2
4124,consultata,1,2,0,2
51040,വിക്കിപീഡിയയാണ്,0,0,2,2
13101,narzissenhand,0,0,2,2
4127,offra,1,2,0,2
4129,annegando,1,2,0,2
46640,fångst,0,0,2,2
6251,potete,1,2,0,2
47927,lanserades,0,0,2,2
13096,zat,0,0,2,2
13128,medo,0,0,2,2
6272,docente,1,2,0,2
6273,immagazzinare,1,2,0,2
11093,demandes,0,0,2,2
4078,implementazione,1,2,0,2
6282,sottodominio,1,2,0,2
4080,proprietario,1,2,0,2
47946,daarvan,0,0,2,2
51055,comparável,0,0,2,2
4086,incompleta,2,1,1,2
46603,portion,0,0,2,2
6280,adattata,1,2,0,2
11080,مجرد,0,0,2,2
6279,esegue,1,2,0,2
4087,levrel,2,1,1,2
4088,superficiali,1,2,0,2
6215,vicente,2,1,1,2
46693,erfarne,0,0,2,2
11156,génère,0,0,2,2
46691,llevó,0,0,2,2
11086,नौकरी,0,0,2,2
46613,intrusion,0,0,2,2
4096,danneggiare,1,2,0,2
13141,heuristic,0,0,2,2
13140,специально,0,0,2,2
51050,registrerade,0,0,2,2
11087,générer,0,0,2,2
13136,laissé,0,0,2,2
13134,تاريخ,0,0,2,2
6274,mantenuta,1,2,0,2
4102,ritenute,1,2,0,2
4104,rivederti,1,2,0,2
13132,solicitações,0,0,2,2
4130,accattivante,1,2,0,2
6250,libere,1,2,0,2
47925,expected,0,0,2,2
51026,आक्रामक,0,0,2,2
51024,notícias,0,0,2,2
6222,concentrate,1,2,0,2
4164,composti,1,2,0,2
13067,uanset,0,0,2,2
47916,específicos,0,0,2,2
4186,progettare,1,2,0,2
46665,ചോദിച്ചാൽ,0,0,2,2
51023,αναθέσεις,0,0,2,2
13062,ويقولون,0,0,2,2
50191,sugeriu,0,0,2,2
6238,confondi,1,2,0,2
4168,clonazione,1,2,0,2
13060,உணவைப்,0,0,2,2
6237,gustoso,1,2,0,2
4170,dannoso,1,2,0,2
47914,rødder,0,0,2,2
13056,വെയിൽ‌സും,0,0,2,2
47913,wikilivros,0,0,2,2
13054,créateur,0,0,2,2
4171,kasparov,2,1,1,2
4181,wikipediano,1,2,0,2
4174,derivano,1,2,0,2
46672,ക്ഷമ,0,0,2,2
4175,espressi,1,2,0,2
13045,garden,0,0,2,2
46675,இனிமேல்,0,0,2,2
13042,bog,0,0,2,2
11144,mythes,0,0,2,2
13040,എളുപ്പമുള്ള,0,0,2,2
11136,leçons,0,0,2,2
46660,banklening,0,0,2,2
46645,ನಮಗೆ,0,0,2,2
13027,l’histoire,0,0,2,2
4134,fornite,1,2,0,2
4135,emissioni,1,2,0,2
11120,sandheder,0,0,2,2
51036,caused,0,0,2,2
6249,volontaria,1,2,0,2
4203,sociologo,1,2,0,2
51034,humaine »,0,0,2,2
13087,ಪದಗಳಲ್ಲಿ,0,0,2,2
11152,complain,0,0,2,2
4147,giudiziari,1,2,0,2
6216,britannici,1,2,0,2
13085,الويب،,0,0,2,2
13083,الأمريكيون,0,0,2,2
11125,κόρης,0,0,2,2
13019,rich,0,0,2,2
51031,അയാൾക്ക്,0,0,2,2
13021,aprecio,0,0,2,2
11127,deinen,0,0,2,2
4152,elegante,2,1,1,2
13022,gentille,0,0,2,2
13023,uppnås,0,0,2,2
50194,biodiversité,0,0,2,2
51028,böylece,0,0,2,2
11132,தயவுசெய்து,0,0,2,2
46656,الآراء,0,0,2,2
4191,mezza,1,2,0,2
47918,سؤال,0,0,2,2
51027,kullanıcı,0,0,2,2
6241,collisione,1,2,0,2
4217,perfezione,1,2,0,2
6214,vernice,1,2,0,2
3952,gpus,2,1,1,2
4238,valide,1,2,0,2
3993,swami,2,1,1,2
47975,criada,0,0,2,2
46519,உழைப்பது,0,0,2,2
12980,leis,0,0,2,2
4000,ooooo,2,1,1,2
47974,सके,0,0,2,2
51092,जुड़ा,0,0,2,2
4006,probabilistica,1,2,0,2
6341,esperimenti,1,2,0,2
47972,economy,0,0,2,2
4008,climi,1,2,0,2
46525,marked,0,0,2,2
4010,philip,2,1,1,2
13293,hautparleur,0,0,2,2
4237,frontend,2,1,1,2
13187,clásico,0,0,2,2
6204,conosciuti,1,2,0,2
11043,philosophers,0,0,2,2
4235,migrano,1,2,0,2
13289,climatic,0,0,2,2
4016,minore,1,2,0,2
13288,சிக்கியிருக்கிறேன்,0,0,2,2
4024,addestrate,1,2,0,2
6333,registra,2,1,1,2
12988,എപ്പോഴും,0,0,2,2
4026,albedo,2,1,1,2
6332,mailinglist,2,1,1,2
4028,programmare,1,2,0,2
4029,norwich,2,1,1,2
50994,говорили,0,0,2,2
13302,stade,0,0,2,2
13303,बिलकुल,0,0,2,2
4241,ulteriore,1,2,0,2
6342,dovesse,1,2,0,2
4249,biografici,1,2,0,2
3955,waffling,2,1,1,2
51107,व्यू,0,0,2,2
13327,l’a,0,0,2,2
11018,അറിയാം,0,0,2,2
3962,competitivo,1,2,0,2
46721,retomar,0,0,2,2
47985,kaldım,0,0,2,2
13323,irmãos,0,0,2,2
3968,ricarica,1,2,0,2
6356,ecologici,1,2,0,2
6354,esistente,1,2,0,2
50202,frequentes,0,0,2,2
3977,segnato,1,2,0,2
51102,«,0,0,2,2
11024,ತಪ್ಪಾಗಿ,0,0,2,2
6351,imitazione,1,2,0,2
46512,samarbetet,0,0,2,2
13314,borde,0,0,2,2
3980,incontrarmi,1,2,0,2
11179,ಕೇಳುತ್ತಿಲ್ಲ,0,0,2,2
13311,ക്രൂരമാണ്,0,0,2,2
46515,abarcaba,0,0,2,2
47980,introducir,0,0,2,2
3986,nasce,1,2,0,2
50141,plante,0,0,2,2
51098,ಭಯ,0,0,2,2
51097,olmaya,0,0,2,2
11174,γνωρίζω,0,0,2,2
47893,estará,0,0,2,2
46541,bloque,0,0,2,2
46542,ഉണ്ടെന്ന്,0,0,2,2
46563,novia,0,0,2,2
50159,решения,0,0,2,2
46700,licensierad,0,0,2,2
47957,pensais,0,0,2,2
46569,आइकन,0,0,2,2
13225,standards,0,0,2,2
11060,proper,0,0,2,2
11061,decirlo,0,0,2,2
4057,autorizzati,1,2,0,2
47956,funktioner,0,0,2,2
4226,pensa,1,2,0,2
13212,padrão,0,0,2,2
13211,पेज,0,0,2,2
46697,أحب,0,0,2,2
50164,நேச்சர்,0,0,2,2
13205,ತಾಯಿಯನ್ನು,0,0,2,2
13203,fichas,0,0,2,2
4223,xviii,1,2,0,2
4219,negoziabile,1,2,0,2
13201,ಸ್ವಾಗತ,0,0,2,2
51065,evitar,0,0,2,2
6213,interglaciali,1,2,0,2
46585,februar,0,0,2,2
4067,preferenze,1,2,0,2
51064,பார்த்து,0,0,2,2
13005,सिर्फ,0,0,2,2
11075,inspirée,0,0,2,2
47948,ആകാം,0,0,2,2
13192,tectonic,0,0,2,2
46593,devrais,0,0,2,2
46701,primært,0,0,2,2
6304,alimentati,1,2,0,2
12989,தரம்,0,0,2,2
4055,aggregati,1,2,0,2
46706,للمساعدة,0,0,2,2
46545,mahkemesi,0,0,2,2
46705,acercó,0,0,2,2
4230,dovute,1,2,0,2
13262,पुस्तकों,0,0,2,2
50198,comparten,0,0,2,2
11051,cobriam,0,0,2,2
12994,ऊपर,0,0,2,2
6206,introdotti,1,2,0,2
50154,gesteld,0,0,2,2
6319,mitologia,1,2,0,2
6314,nove,1,2,0,2
6313,efficaci,1,2,0,2
13251,ستحصل,0,0,2,2
13249,forces,0,0,2,2
6311, ×,2,1,1,2
51076,αστειεύεσαι,0,0,2,2
4050,dilbert,2,1,1,2
12995,zengin,0,0,2,2
13242,matemática,0,0,2,2
13241,ಬಂದರು,0,0,2,2
11164,सुझाव,0,0,2,2
6307,determinante,1,2,0,2
13240,جائع,0,0,2,2
6306,femminile,1,2,0,2
6305,capitoli,1,2,0,2
4054,aics,2,1,1,2
13236,lärt,0,0,2,2
6207,followup,2,1,1,2
13605,ಸರಿಯಾದ,0,0,2,2
47837,faveur,0,0,2,2
50055,നിഷ്പ്രയാസം,0,0,2,2
12749,ingilizce,0,0,2,2
50899,diagnosis,0,0,2,2
10640,utseende,0,0,2,2
46077,içeriği,0,0,2,2
50901,complexité,0,0,2,2
48236,धीरेधीरे,0,0,2,2
3252,kong,2,1,1,2
51381,ചെയ്യാത്ത,0,0,2,2
3257,stare,1,2,0,2
3258,udito,1,2,0,2
46081,öppna,0,0,2,2
46863,eftermiddagen,0,0,2,2
3260,diff,2,1,1,2
3263,voltaire,2,1,1,2
6759,considerava,2,1,1,2
6755,gordon,2,1,1,2
6779,attento,1,2,0,2
4467,validazione,1,2,0,2
3268,influenze,1,2,0,2
51376,बढ़ाने,0,0,2,2
13943,noticiário,0,0,2,2
3270,federale,1,2,0,2
48231,stuk,0,0,2,2
50902,liée,0,0,2,2
4464,religioso,1,2,0,2
4463,proposti,1,2,0,2
49983,அதிர்ஷ்டம்,0,0,2,2
11292,worried,0,0,2,2
11290,लैटिन,0,0,2,2
51368,ρωτάει,0,0,2,2
47806,занимались,0,0,2,2
48241,بهذا,0,0,2,2
4475,vince,1,2,0,2
12739,στόλλμαν,0,0,2,2
10632,aufgaben,0,0,2,2
48255,culturele,0,0,2,2
10614,gradiente,0,0,2,2
14002,broadest,0,0,2,2
3214,susningal,2,1,1,2
10615,willkommen,0,0,2,2
6045,russia,1,2,0,2
6773,«non,1,2,0,2
48251,formatting,0,0,2,2
10620,gefallen,0,0,2,2
46873,സ്കോർ‌,0,0,2,2
50898,aimé,0,0,2,2
6046,sostenibilità,1,2,0,2
46065,circulation,0,0,2,2
46066,каждая,0,0,2,2
13986,contextes,0,0,2,2
13984,gillade,0,0,2,2
4481,atteggiamento,1,2,0,2
13982,يخبرك,0,0,2,2
51397,hemma,0,0,2,2
47799,distribuir,0,0,2,2
6768,geologici,1,2,0,2
3230,ab,2,1,1,2
11303,сомнение,0,0,2,2
46869,templates,0,0,2,2
13974,научиться,0,0,2,2
13973,verbazingwekkende,0,0,2,2
49972,സാധാരണയായി,0,0,2,2
10629,constatou,0,0,2,2
10630,трафика,0,0,2,2
13935,muestras,0,0,2,2
49987,experimentos,0,0,2,2
48228,πιάσατε,0,0,2,2
13898,conocerte,0,0,2,2
46124,eigen,0,0,2,2
11287,ഒര്മയുല്ലപ്പം,0,0,2,2
3319,comunitario,2,1,1,2
3320,lavorano,1,2,0,2
4445,emisfero,1,2,0,2
46127,grow,0,0,2,2
13891,préoccupation,0,0,2,2
3322,semisupervisionato,1,2,0,2
6710,scene,2,1,1,2
48214,entscheidung,0,0,2,2
46130,confondues,0,0,2,2
3324,troll,1,2,0,2
4442,salinità,1,2,0,2
3328,solleva,1,2,0,2
13887,прекрасно,0,0,2,2
3330,enfasi,1,2,0,2
13885,significations,0,0,2,2
13884,gratis,0,0,2,2
46135,സ്ഥലത്താണ്,0,0,2,2
10677,worte,0,0,2,2
13879,intuición,0,0,2,2
46137,decreases,0,0,2,2
6702,sperimentale,1,2,0,2
13876,लाईसेन्स,0,0,2,2
46845,animados,0,0,2,2
51345,allá,0,0,2,2
49998,ende,0,0,2,2
46140,açısı,0,0,2,2
46141,noise,0,0,2,2
49993,natuurwetenschappelijke,0,0,2,2
13900,சரியாக,0,0,2,2
46101,உறுதிப்படுத்திக்,0,0,2,2
13901,afecta,0,0,2,2
3291,filosofie,1,2,0,2
6739,incorporate,2,1,1,2
48226,المعرضة,0,0,2,2
51360,molecules,0,0,2,2
13924,altavoz,0,0,2,2
6738,johansson sv,2,1,1,2
46108,понимаешь,0,0,2,2
12758,drygt,0,0,2,2
10661,технологического,0,0,2,2
12761,سميت,0,0,2,2
3305,scegliere,1,2,0,2
46852,gemakkelijke,0,0,2,2
49990,extensão,0,0,2,2
3307,hardcore,2,1,1,2
46111,भरोसा,0,0,2,2
6728,fetzer,2,1,1,2
13916,महल,0,0,2,2
3309,kennedy,2,1,1,2
6726,podcast,2,1,1,2
3311,uber,2,1,1,2
13910,"
निम्न",0,0,2,2
13909,administrador,0,0,2,2
10666,aim,0,0,2,2
50904,गुमनाम,0,0,2,2
46122,bebida,0,0,2,2
12765,увидите,0,0,2,2
13902,εικονίδιο,0,0,2,2
6720,assunzione,1,2,0,2
50262,bibliotheek,0,0,2,2
3212,bundestag,2,1,1,2
6782,prenderla,1,2,0,2
46315,εμφάνιση,0,0,2,2
3141,scientology,2,1,1,2
51444,locuteurs,0,0,2,2
45996,inscrit,0,0,2,2
45997,محمية,0,0,2,2
50274,неважно,0,0,2,2
12698,ideal,0,0,2,2
3132,studiato,1,2,0,2
50887,moteur,0,0,2,2
3135,oscenità,1,2,0,2
46003,surpresa,0,0,2,2
47787,ಮೆಲಿಸ್ಸಾ,0,0,2,2
49947,परस्पर,0,0,2,2
46004,എങ്കിലും,0,0,2,2
6831,incrociare,1,2,0,2
51439,ogen,0,0,2,2
51438,metres,0,0,2,2
6044,critico,1,2,0,2
46895,acusada,0,0,2,2
46007,herkesin,0,0,2,2
3145,riduzione,1,2,0,2
12701,observe,0,0,2,2
3150,influenzare,1,2,0,2
6827,percorsi,1,2,0,2
3153,problematiche,1,2,0,2
14080,appliqué,0,0,2,2
46015,brugeres,0,0,2,2
12702,ஆரம்ப,0,0,2,2
46016,सेकंड,0,0,2,2
46017,sécurité,0,0,2,2
10587,månaden,0,0,2,2
12703,útil,0,0,2,2
10582,thanking,0,0,2,2
10581,investigators,0,0,2,2
14105,saltet,0,0,2,2
6834,meccanicistica,1,2,0,2
3077,sottoposti,1,2,0,2
14134,anônimo,0,0,2,2
4538,rivela,1,2,0,2
4537,parziali,1,2,0,2
48295,मतभेद,0,0,2,2
4529,paper,2,1,1,2
51463,mısın,0,0,2,2
45981,baseado,0,0,2,2
49935,развития,0,0,2,2
48293,atribución,0,0,2,2
4528,capaci,1,2,0,2
10563,disent,0,0,2,2
46903,hører,0,0,2,2
45987,مستوى,0,0,2,2
12688,ಪ್ರಯತ್ನಿಸಿ,0,0,2,2
4526,dispone,2,1,1,2
50278,variation,0,0,2,2
14120,சரியான,0,0,2,2
10568,précédentes,0,0,2,2
45988,достигла,0,0,2,2
6849,cognitivi,1,2,0,2
10572,amaçlı,0,0,2,2
12697,graças,0,0,2,2
14115,decirme,0,0,2,2
3113,archiviare,1,2,0,2
3116,lionel,2,1,1,2
6838,sequenza,1,2,0,2
3121,«l,1,2,0,2
6025,impossibili,1,2,0,2
14066,ഉച്ചാരണം,0,0,2,2
3155,sotterranee,1,2,0,2
48276,astúrias,0,0,2,2
3177,jeanpierre,2,1,1,2
48266,espère,0,0,2,2
49961,pude,0,0,2,2
46038,αρχή,0,0,2,2
14036,perfekt,0,0,2,2
3187,conosciute,1,2,0,2
4512,esaminato,1,2,0,2
12720,şanslı,0,0,2,2
3188,tpr,2,1,1,2
10601,stellen,0,0,2,2
48264,etmeye,0,0,2,2
12721,dichas,0,0,2,2
51416,groundwater,0,0,2,2
14026,plane,0,0,2,2
14021,சொற்களஞ்சியத்தை,0,0,2,2
12723,regularmente,0,0,2,2
10606,elefante,0,0,2,2
14017,പ്രിയേ,0,0,2,2
46051,क्षमता,0,0,2,2
14014,செய்வேன்,0,0,2,2
6794,baikecom,2,1,1,2
46052,intervjun,0,0,2,2
4500,equilibrato,1,2,0,2
46053,leva,0,0,2,2
6790,raccolto,1,2,0,2
14008,जीवनी,0,0,2,2
6040,informale,1,2,0,2
6786,momenti,1,2,0,2
14005,अस्वीकार,0,0,2,2
50896,removidas,0,0,2,2
3181,etico,1,2,0,2
6034,carenti,1,2,0,2
3156,ripetizione,1,2,0,2
14040,νάρκισσα,0,0,2,2
6825,sostenere,1,2,0,2
49950,хорошими,0,0,2,2
46025,großartige,0,0,2,2
51430,കാഴ്ചപ്പാടുകളും,0,0,2,2
46027,niemand,0,0,2,2
14057,έφτασε,0,0,2,2
6817,troppe,1,2,0,2
50890,practical,0,0,2,2
46029,geri,0,0,2,2
4516,tematica,1,2,0,2
12708,hvilken,0,0,2,2
4513,monte,2,1,1,2
3171,finanziario,1,2,0,2
46889,വിലമതിക്കുന്നില്ല,0,0,2,2
14051,प्रावधान,0,0,2,2
48269,ಉಚ್ಚಾರಣೆಯನ್ನು,0,0,2,2
14050,"
azeri",0,0,2,2
46033,те,0,0,2,2
3172,specificità,1,2,0,2
51426,использовалась,0,0,2,2
14044,adjö,0,0,2,2
49957,schreef,0,0,2,2
14043,kullanmaktadır,0,0,2,2
46887,movies,0,0,2,2
6805,fpr,2,1,1,2
49960,herself,0,0,2,2
48267,dachte,0,0,2,2
46037,egoísta,0,0,2,2
6802,tipografia,1,2,0,2
13871,enheder,0,0,2,2
10682,eb,0,0,2,2
48208,miembros,0,0,2,2
3543,interpretativa,2,1,1,2
10783,balkon,0,0,2,2
3523,resistenza,1,2,0,2
46259,hjalmarsson,0,0,2,2
3526,berna,2,1,1,2
6099,direzione,1,2,0,2
10787,representatives,0,0,2,2
10788,tenham,0,0,2,2
46804,smaragder,0,0,2,2
10789,اكتشاف,0,0,2,2
3532,minacce,1,2,0,2
3534,decide,2,1,1,2
3535,dietro,1,2,0,2
4389,nostri,1,2,0,2
50041,நினைப்பீர்களா,0,0,2,2
13690,adaptan,0,0,2,2
12773,أغسطس,0,0,2,2
51271,suele,0,0,2,2
6585,ibmer,2,1,1,2
10791,environmental,0,0,2,2
47831,interesantes,0,0,2,2
48133,ваш,0,0,2,2
4387,rallentamento,1,2,0,2
3566,lamentarsi,1,2,0,2
4386,sintomi,1,2,0,2
3568,ebook,1,2,0,2
46801,brillants,0,0,2,2
10798,உருவாக்க,0,0,2,2
4382,realizzato,1,2,0,2
46276,publicamente,0,0,2,2
3579,svezia,1,2,0,2
46257,verici,0,0,2,2
13705,precisam,0,0,2,2
46805,grymma,0,0,2,2
46806,tropas,0,0,2,2
50923,forslag,0,0,2,2
47825,جادل,0,0,2,2
13741,philosophes,0,0,2,2
51290,достижения,0,0,2,2
10769,ಹೇಗೆ,0,0,2,2
46237,naturaliste,0,0,2,2
46238,estuviera,0,0,2,2
3486,passiva,1,2,0,2
3488,causato,1,2,0,2
46239,configuração,0,0,2,2
4398,portland,1,2,0,2
3496,operativamente,1,2,0,2
13728,ವಹಿಸಲು,0,0,2,2
51287,während,0,0,2,2
3501,costituzionali,1,2,0,2
46241,lateinische,0,0,2,2
13724,presented,0,0,2,2
50030,lutter,0,0,2,2
6613,marvin,1,2,0,2
46244,tıpkı,0,0,2,2
3508,poteva,1,2,0,2
6609,sguardo,1,2,0,2
6606,eliot,2,1,1,2
6603,quadrati,1,2,0,2
46249,explanation,0,0,2,2
10780,ಮಾತನಾಡಲು,0,0,2,2
3517,significative,1,2,0,2
3518,petrolio,1,2,0,2
50033,കഴിയില്ലെന്ന്,0,0,2,2
51259,campagne,0,0,2,2
10800,നാല്,0,0,2,2
10801,sociales,0,0,2,2
51244,resultaat,0,0,2,2
13641,വിഡ്,0,0,2,2
4373,miti,1,2,0,2
3637,wikificazione,1,2,0,2
6115,basco,1,2,0,2
10824,книге,0,0,2,2
48115,patrones,0,0,2,2
3640,aggiuntivi,1,2,0,2
13631,russe,0,0,2,2
13630,användargränssnitt,0,0,2,2
46300,doctors,0,0,2,2
12854,düşünebilirsiniz,0,0,2,2
46303,varied,0,0,2,2
6560,neuroscienze,1,2,0,2
3642,odf,2,1,1,2
3643,sacco,1,2,0,2
46305,précédente,0,0,2,2
48109,تريده,0,0,2,2
12857,forfærdelige,0,0,2,2
6554,pandemia,1,2,0,2
6552,crescere,1,2,0,2
6550,condotte,1,2,0,2
51237,indépendante,0,0,2,2
10843,extrameile,0,0,2,2
3652,marx,2,1,1,2
48101,ഉണ്ടെങ്കിൽ,0,0,2,2
3655,friedrich,2,1,1,2
6549,mangio,1,2,0,2
11244,électorale,0,0,2,2
11243,article »,0,0,2,2
6567,stampati,1,2,0,2
3631,ñiquipedia,2,1,1,2
4380,kamm,2,1,1,2
50931,இருந்தீர்கள்,0,0,2,2
13672,prêmios,0,0,2,2
3583,singolare,1,2,0,2
50048,quantrill,0,0,2,2
6575,confuse,2,1,1,2
3592,differenziati,1,2,0,2
46280,komplicerad,0,0,2,2
48126,क्रूर,0,0,2,2
13664,attempts,0,0,2,2
3598,operatore,1,2,0,2
10808,मिलना,0,0,2,2
6571,pressione,1,2,0,2
6570,mossa,1,2,0,2
51252,visàvis,0,0,2,2
6106,imparano,1,2,0,2
10814,définitions,0,0,2,2
10815,answered,0,0,2,2
10816,açıdır,0,0,2,2
13657,gitmeniz,0,0,2,2
3619,esigenza,1,2,0,2
46287,ಅವು,0,0,2,2
46289,посещаемости,0,0,2,2
51248,kapsamlı,0,0,2,2
10818,expand,0,0,2,2
6107,dotati,1,2,0,2
46292,αργό,0,0,2,2
6568,franceag,2,1,1,2
48118,hoffe,0,0,2,2
51246,expansión,0,0,2,2
13646,hypothetical,0,0,2,2
4406,polemiche,1,2,0,2
6088,sovrastante,1,2,0,2
4410,funzionali,1,2,0,2
3370,illustrare,1,2,0,2
50006,αναπτύσσεται,0,0,2,2
3374,white,2,1,1,2
50008,schelen,0,0,2,2
3375,cresce,2,1,1,2
3377,cinesi,1,2,0,2
46168,второй,0,0,2,2
46169,مستخدمو,0,0,2,2
6064,sbalorditiva,1,2,0,2
48188,val,0,0,2,2
3381,profit,2,1,1,2
6672,ˌwɪkɨˈpiːdiə,2,1,1,2
6671,tradotta,1,2,0,2
6065,bassi,1,2,0,2
6066,eccome,1,2,0,2
13822,دولار,0,0,2,2
6665,specificare,1,2,0,2
12796,വലിക്കുക,0,0,2,2
3391,volume,1,2,0,2
51324,التالي,0,0,2,2
12797,സഹായി,0,0,2,2
10723,maart,0,0,2,2
50013,കുറിച്ച്,0,0,2,2
6067,cittadino,1,2,0,2
46827,retains,0,0,2,2
50256,बनाए,0,0,2,2
3402,biotici,1,2,0,2
46186,sitzen,0,0,2,2
46188,ബന്ധപ്പെട്ട,0,0,2,2
13802,घटना,0,0,2,2
13838,fines,0,0,2,2
13841,épouser,0,0,2,2
3410,trascendentalismo,1,2,0,2
4432,combinata,1,2,0,2
47809,rekommenderar,0,0,2,2
12775,hermanos,0,0,2,2
51341,spil,0,0,2,2
13867,कंप्यूटर,0,0,2,2
11283,जॉन,0,0,2,2
13865,ändra,0,0,2,2
50907,montré,0,0,2,2
3343,espliciti,1,2,0,2
3347,corteggiatori,1,2,0,2
46147,शुक्र,0,0,2,2
3348,lavanderia,1,2,0,2
6053,peña,2,1,1,2
4438,oppone,1,2,0,2
3352,annuncio,1,2,0,2
6054,wifi,2,1,1,2
46841,lärande,0,0,2,2
50260,സാധിക്കുന്നു,0,0,2,2
3359,anime,2,1,1,2
48196,incite,0,0,2,2
46154,تلقت,0,0,2,2
6686,pensieri,1,2,0,2
3360,darà,1,2,0,2
6059,cinematch,2,1,1,2
10701,нарцисс,0,0,2,2
48193,expor,0,0,2,2
47812,особенностью,0,0,2,2
46839,«я,0,0,2,2
3365,alphazero,2,1,1,2
51331,induction,0,0,2,2
12805,ಚಿಂತೆ,0,0,2,2
11267,сервер,0,0,2,2
13746,générées,0,0,2,2
3451,mnist,2,1,1,2
6639,omogeneizzando,1,2,0,2
3454,significava,1,2,0,2
10748,wacht,0,0,2,2
46213,pu,0,0,2,2
6085,abbracciare,1,2,0,2
13767,επόμενο,0,0,2,2
13766,αργός,0,0,2,2
3456,industrializzati,1,2,0,2
10750,satire,0,0,2,2
50024,administratörer,0,0,2,2
3461,ipotizzato,1,2,0,2
12815,presentatie,0,0,2,2
13762,encyclopédie ,0,0,2,2
6633,chiarito,1,2,0,2
11262,assumptions,0,0,2,2
10756,ಹೆಚ್ಚಿನ,0,0,2,2
46815,cópia,0,0,2,2
46813,denn,0,0,2,2
3463,pragmatic,2,1,1,2
46221,desta,0,0,2,2
12823,krav,0,0,2,2
6630,concorrenza,1,2,0,2
46224,lucratif,0,0,2,2
48154,interrompre,0,0,2,2
6629,telegramma,1,2,0,2
3469,iniziamo,1,2,0,2
3472,rendeva,1,2,0,2
48153,rapide,0,0,2,2
51294,pouvais,0,0,2,2
50021,hypotheses,0,0,2,2
3450,addio,1,2,0,2
46195,crédit,0,0,2,2
46208,വേണ്ടെന്ന്,0,0,2,2
10729,serviços,0,0,2,2
51315,datadump,0,0,2,2
10732,çapraz,0,0,2,2
13793,मेली,0,0,2,2
46196,கையை,0,0,2,2
50918,periódicos,0,0,2,2
51313,ändringar,0,0,2,2
3417,sottorappresentati,1,2,0,2
3420,sostenuta,1,2,0,2
46198,видеть,0,0,2,2
6657,patrol,2,1,1,2
6655,neutre,2,1,1,2
3421,burn,2,1,1,2
10739,« décisions »,0,0,2,2
12807,atteindre,0,0,2,2
6652,fossile,1,2,0,2
51310,reposant,0,0,2,2
6650,pubblicitario,1,2,0,2
6649,robotica,1,2,0,2
6646,contrassegnato,1,2,0,2
12808,மொழிப்,0,0,2,2
6644,enciclopediche,1,2,0,2
3430,colpisce,1,2,0,2
12809,faim,0,0,2,2
51307,construir,0,0,2,2
4415,coraggio,1,2,0,2
4413,coordinare,1,2,0,2
6080,kathryn,2,1,1,2
13776,பணம்,0,0,2,2
51896,ροκ,0,0,2,2
15119,arabic,0,0,2,2
50713,egendom”,0,0,2,2
50454,suche,0,0,2,2
44488,forstod,0,0,2,2
777,rispettivo,1,2,0,2
8178,noam,2,1,1,2
11712,devletleri,0,0,2,2
50575,ولاري,0,0,2,2
52403,picked,0,0,2,2
16501,सोचा,0,0,2,2
16500,sayfa,0,0,2,2
780,approvati,1,2,0,2
781,automazione,1,2,0,2
52402,धीमे,0,0,2,2
16498,доступна,0,0,2,2
12026,higherdimensional,0,0,2,2
47338,conferences,0,0,2,2
16497,பயனர்கள்,0,0,2,2
806,abuso,2,1,1,2
47336,violación,0,0,2,2
8177,pitts,2,1,1,2
9097,metti,1,2,0,2
44493,വലിയൊരു,0,0,2,2
49448,തത്ത്വം,0,0,2,2
16492,καλοί,0,0,2,2
50453,readily,0,0,2,2
8172,verificare,1,2,0,2
12031,récord,0,0,2,2
11710,kräver,0,0,2,2
802,adorabili,1,2,0,2
9105,annunciata,1,2,0,2
44500,lykke,0,0,2,2
52389,തിരക്കിലാണ്,0,0,2,2
5337,elizabeth,2,1,1,2
9085,passate,1,2,0,2
8179,antielitarismo,1,2,0,2
5340,besançon,2,1,1,2
16531, modifications,0,0,2,2
52415,llamados,0,0,2,2
44474,åt,0,0,2,2
44476,prenumerationsknappen,0,0,2,2
8197,phu,2,1,1,2
44477,ब्रांड,0,0,2,2
44478,animaux,0,0,2,2
11718,зависимости,0,0,2,2
11716,ಹೆಸರು,0,0,2,2
16521,trevligt,0,0,2,2
742,gne,2,1,1,2
8189,estetica,1,2,0,2
8188,motivi,1,2,0,2
9078,ricordarti,1,2,0,2
52411,भूल,0,0,2,2
753,applicabili,1,2,0,2
16518,ಇಬ್ಬರು,0,0,2,2
8186,esibire,1,2,0,2
756,deposizione,1,2,0,2
5346,calotte,1,2,0,2
758,riparazione,1,2,0,2
759,webcomic,2,1,1,2
52408,menée,0,0,2,2
11713,متجاوزة,0,0,2,2
764,dadian,2,1,1,2
16510,ಹೋದರು,0,0,2,2
8185,elettronico,1,2,0,2
765,—letteralmente—,1,2,0,2
16509,sal,0,0,2,2
52388,digite,0,0,2,2
8169,semplificare,1,2,0,2
9072,yann,2,1,1,2
16434,mathematics,0,0,2,2
9145,correttore,1,2,0,2
47328,musun,0,0,2,2
16443,lägga,0,0,2,2
12045,diskuteras,0,0,2,2
847,linguistico,1,2,0,2
16441,ലേഖനത്തിന്റെ,0,0,2,2
9146,equatoriale,1,2,0,2
16439,skämt,0,0,2,2
52365,प्रमुख,0,0,2,2
44534,faut,0,0,2,2
16436,മാറ്റി,0,0,2,2
9147,notevoli,1,2,0,2
16435,resume,0,0,2,2
49064,extensas,0,0,2,2
5318,pezzi,1,2,0,2
12032,ಸವಾರಿ,0,0,2,2
50589,αντικειμενική,0,0,2,2
49062,خاصة,0,0,2,2
49061,prepared,0,0,2,2
47326,sit,0,0,2,2
49058,continual,0,0,2,2
16428,gagne,0,0,2,2
49057,petit,0,0,2,2
47325,savoirfaire,0,0,2,2
5311,documento,2,1,1,2
858,carina,1,2,0,2
44542,കഴിഞ്ഞ,0,0,2,2
12051,başlamak,0,0,2,2
8143,incompetente,1,2,0,2
12052,الحرة,0,0,2,2
49461,வெளியிட்டது,0,0,2,2
841,minuscola,1,2,0,2
9137,creatività,1,2,0,2
52371,тот,0,0,2,2
44504,الروسية,0,0,2,2
44505,numara,0,0,2,2
49082,pergunto,0,0,2,2
44508,improving,0,0,2,2
809,imprime,2,1,1,2
44509,tel,0,0,2,2
811,webaroo,2,1,1,2
16469,especialmente,0,0,2,2
5607,openai,2,1,1,2
11701,acto,0,0,2,2
49457,വിജ്ഞാനകോശത്തിന്റെ,0,0,2,2
16465,പറ്റിയെഴുതുന്നു,0,0,2,2
44515,enormt,0,0,2,2
5328,collège,2,1,1,2
9121,medicine,2,1,1,2
50451,enciclopédico,0,0,2,2
16462,devriez,0,0,2,2
49073,uppdrag,0,0,2,2
820,vegetabilia,2,1,1,2
5610,ergo,2,1,1,2
44519,soient,0,0,2,2
9128,classificazioni,1,2,0,2
9131,camera,1,2,0,2
9132,veelen,2,1,1,2
52374,sormak,0,0,2,2
831,regista,2,1,1,2
44525,αγοράσω,0,0,2,2
11696,способом,0,0,2,2
9135,cloud,2,1,1,2
12012,कस्टमनिर्मित,0,0,2,2
49101,ποιος,0,0,2,2
44547,лучшая,0,0,2,2
667,finiti,1,2,0,2
16623,ಪ್ರಶ್ನೆಯನ್ನು,0,0,2,2
9001,ales,2,1,1,2
50562,carácter,0,0,2,2
49421,median,0,0,2,2
49126,concernant,0,0,2,2
8250,cuba,2,1,1,2
11989,applicants,0,0,2,2
52455,περιγράφουν,0,0,2,2
650,mini,2,1,1,2
9012,riferendosi,1,2,0,2
50564,hungry,0,0,2,2
665,misurato,1,2,0,2
50461,oficiosas,0,0,2,2
5371,aral,2,1,1,2
52449,gärna,0,0,2,2
8233,commettono,1,2,0,2
16606,representar,0,0,2,2
44427,interior,0,0,2,2
5370,adottata,1,2,0,2
5365,alexnet,2,1,1,2
44428,friday,0,0,2,2
52447,drainage,0,0,2,2
673,falsi,1,2,0,2
9019,scelto,1,2,0,2
674,ricevendo,1,2,0,2
9020,risale,1,2,0,2
9023,vagamente,1,2,0,2
9027,dipenderà,1,2,0,2
16597,seasons,0,0,2,2
5364,mistero,1,2,0,2
640,incorporano,1,2,0,2
52461,passage,0,0,2,2
9000,priva,1,2,0,2
52462,slaat,0,0,2,2
8268,misto,1,2,0,2
16655,इतालवी,0,0,2,2
601,operava,2,1,1,2
8994,collezioni,1,2,0,2
16652,குறித்து,0,0,2,2
44395,directed,0,0,2,2
16647,reizen,0,0,2,2
8262,hsts,2,1,1,2
52470,syntes,0,0,2,2
49132,croisés,0,0,2,2
11979,hago,0,0,2,2
609,​​su,1,2,0,2
44399,contrôlant,0,0,2,2
611,rappresentativa,1,2,0,2
8996,integrata,1,2,0,2
11980,webbsidor,0,0,2,2
623,numeratori,1,2,0,2
624,fredda,1,2,0,2
44405,elements,0,0,2,2
11981,заняться,0,0,2,2
11982,systeem,0,0,2,2
8998,manifestante,1,2,0,2
8257,ripariale,1,2,0,2
16633,empezar,0,0,2,2
11988,sofistikeret,0,0,2,2
16632,സ്ഥലത്ത്,0,0,2,2
44408,användbara,0,0,2,2
16629,الليلة؟,0,0,2,2
44409,ελπίζω,0,0,2,2
9030,razionale,1,2,0,2
49429,விக்கி,0,0,2,2
736,consisteva,1,2,0,2
16553,न्यूट्रल,0,0,2,2
9059,atlantico,1,2,0,2
5596,argon,2,1,1,2
11721,sérieuse,0,0,2,2
12001,zugehört,0,0,2,2
49438,esposa,0,0,2,2
12003,hittar,0,0,2,2
8207,distruzione,1,2,0,2
52424,வெள்ளி,0,0,2,2
8206,massiccia,1,2,0,2
44458,ruimte,0,0,2,2
12004,étionsnous,0,0,2,2
16555,फ्री,0,0,2,2
49105,glaube,0,0,2,2
16554,abandonné,0,0,2,2
724,distribuibile,1,2,0,2
49116,ergens,0,0,2,2
44459,edges,0,0,2,2
5356,competenze,1,2,0,2
47355,dynamo,0,0,2,2
9066,elettriche,1,2,0,2
729,cartacee,1,2,0,2
9067,lacune,1,2,0,2
50457,فلوريدا،,0,0,2,2
47353,buscando,0,0,2,2
8201,recoba,1,2,0,2
731,blackberry,2,1,1,2
44467,മൂന്നു,0,0,2,2
50570,violation,0,0,2,2
5598,stanchi,1,2,0,2
734,svilupparono,1,2,0,2
11723,उदाहरणों,0,0,2,2
8214,vinod,2,1,1,2
50458,warte,0,0,2,2
706,mera,2,1,1,2
681,alfred,2,1,1,2
9034,arriva,1,2,0,2
49114,trendline,0,0,2,2
16591,afirmaba,0,0,2,2
16590,identique,0,0,2,2
9038,torto,1,2,0,2
9039,coinvolgere,1,2,0,2
684,confermato,1,2,0,2
8231,naturae,2,1,1,2
16588,சிறுவன்,0,0,2,2
688,sostituita,1,2,0,2
49430,perplexes,0,0,2,2
16585,öğle,0,0,2,2
16583,exactement,0,0,2,2
8223,protetto,1,2,0,2
52436,«la,0,0,2,2
693,verticale,2,1,1,2
44445,colonized,0,0,2,2
694,amministrative,1,2,0,2
696,installato,1,2,0,2
16575,approfondir,0,0,2,2
49112,видите,0,0,2,2
698,covid,2,1,1,2
16570,انت,0,0,2,2
5360,catena,1,2,0,2
16566,fondé,0,0,2,2
9052,selvaggio,1,2,0,2
11998,écrit,0,0,2,2
703,panslavon,2,1,1,2
859,attribuite,1,2,0,2
5617,validità,1,2,0,2
11668,oferecido,0,0,2,2
1060,aiuteresti,1,2,0,2
8072,geografica,1,2,0,2
48996,बढ़ती,0,0,2,2
52280,dedim,0,0,2,2
52279,குறிப்பிடலாம்,0,0,2,2
50437,πούμε,0,0,2,2
15263,amorality,0,0,2,2
48995,tratan,0,0,2,2
49504,അൽപ്പം,0,0,2,2
9333,clay,2,1,1,2
1053,fantastici,1,2,0,2
48992,наукам,0,0,2,2
16219,accessible,0,0,2,2
49507,miedo,0,0,2,2
1058,scritture,1,2,0,2
1063,ijsbrand,2,1,1,2
48986,flagged,0,0,2,2
8046,confusi,1,2,0,2
16217,bezeichnen,0,0,2,2
16214,nadruk,0,0,2,2
1071,infinito,2,1,1,2
48989,الأصابع,0,0,2,2
49508,ermee,0,0,2,2
8044,neri,1,2,0,2
9340,rakesh,2,1,1,2
16208,പ്രശ്നമല്ല,0,0,2,2
16206,kalde,0,0,2,2
8043,occidente,1,2,0,2
16204,bénéficie,0,0,2,2
5263,famose,1,2,0,2
5262,rivedere,1,2,0,2
48997,trolls,0,0,2,2
8076,intensive,2,1,1,2
49495,النصيحة,0,0,2,2
50605,تفهم,0,0,2,2
12095,araba,0,0,2,2
16279,tro,0,0,2,2
16278,coberto,0,0,2,2
44632,visitado,0,0,2,2
9302,vandalici,1,2,0,2
16272,свободно,0,0,2,2
44634,prevalent,0,0,2,2
52297,διαγραφεί,0,0,2,2
5276,contribuenti,1,2,0,2
1008,negativa,2,1,1,2
9305,bloccare,1,2,0,2
9309,segni,1,2,0,2
9312,favorire,1,2,0,2
52295,houve,0,0,2,2
52293,गतिविधियों,0,0,2,2
9313,selvatici,1,2,0,2
12101,الحلم,0,0,2,2
9316,techne,1,2,0,2
44648,milieux,0,0,2,2
8086,contenute,1,2,0,2
44650,ತಿಳಿದಿತ್ತು,0,0,2,2
49491,الجمال,0,0,2,2
52288,ടെറൻസ്,0,0,2,2
49492,produktiva,0,0,2,2
1028,farmaci,1,2,0,2
44655,literally,0,0,2,2
5643,privato,1,2,0,2
11680,صلاحيات,0,0,2,2
11678,collision,0,0,2,2
16199,αξίζω,0,0,2,2
44678,"

हालाँकि",0,0,2,2
1000,glaciali,1,2,0,2
8014,collaborazioni,1,2,0,2
5654,quo,2,1,1,2
8021,volessi,1,2,0,2
44706,ಭವ್ಯವಾದ,0,0,2,2
5256,imita,1,2,0,2
16156,καθυστέρησης,0,0,2,2
1104,ordinato,1,2,0,2
9357,tic,2,1,1,2
49514,artikels,0,0,2,2
44708,robe,0,0,2,2
9359,intenzionalmente,1,2,0,2
1109,agrawal,2,1,1,2
1110,visita,1,2,0,2
47558,formatação,0,0,2,2
9360,promozione,1,2,0,2
12132,санфранциско,0,0,2,2
8039,julien,2,1,1,2
16144,مشغول,0,0,2,2
50614,betekenis,0,0,2,2
16141,croissance,0,0,2,2
9364,visitatore,1,2,0,2
16139,kommentera,0,0,2,2
12137,incidentes,0,0,2,2
5240,denotare,1,2,0,2
1122,periodi,1,2,0,2
1123,sottocampo,1,2,0,2
8005,oviedo,2,1,1,2
8004,prendono,1,2,0,2
16132,எல்லாம்,0,0,2,2
9376,selvatiche,1,2,0,2
1129,diventati,1,2,0,2
1100,verrebbe,1,2,0,2
16162,دلالات,0,0,2,2
8022,leggibilità,1,2,0,2
16166,enfermedades,0,0,2,2
8037,identico,1,2,0,2
52264,baixas,0,0,2,2
47283,முடிவு,0,0,2,2
5651,altrettante,1,2,0,2
8030,costanti,1,2,0,2
12125,aparência,0,0,2,2
1087,kfoldcrossvalidation,2,1,1,2
44687,रह,0,0,2,2
16186,watercourse,0,0,2,2
47281,редактировать,0,0,2,2
8028,uscita,1,2,0,2
44691,ortográficas,0,0,2,2
8027,svanì,1,2,0,2
48981,bestaan,0,0,2,2
16180,πεινασμένος,0,0,2,2
9350,valido,1,2,0,2
12128,σάββατο,0,0,2,2
1091,adatte,1,2,0,2
1092,amnesty,2,1,1,2
44695,geeft,0,0,2,2
44696,ressaisistoi,0,0,2,2
9352,avviso,1,2,0,2
52259,الياقوت,0,0,2,2
16172,publicada,0,0,2,2
5261,ridere,1,2,0,2
9354,usaj,2,1,1,2
8023,stilistiche,1,2,0,2
1098,sverker,2,1,1,2
1099,riflette,1,2,0,2
9299, anni,1,2,0,2
5277,nilsson,2,1,1,2
44549,inferencias,0,0,2,2
44588,sexism,0,0,2,2
899,adattivo,1,2,0,2
9200,impiegate,1,2,0,2
9203,danese,1,2,0,2
901,amin,2,1,1,2
9207,alterare,1,2,0,2
8128,mandargli,1,2,0,2
52338,matters,0,0,2,2
47550,पुराने,0,0,2,2
12070,கனவுகளின்,0,0,2,2
49476,crowds,0,0,2,2
8121,combinate,1,2,0,2
9222,coordinate,2,1,1,2
16358,تمرير,0,0,2,2
9223,prenderti,1,2,0,2
920,arrabbiata,1,2,0,2
938,elogiato,1,2,0,2
8120,affidati,1,2,0,2
8117,amazon,2,1,1,2
9226,guscio,1,2,0,2
49033,hoppas,0,0,2,2
8115,officer,2,1,1,2
5300,americane,1,2,0,2
931,accedere,1,2,0,2
5295,secondario,1,2,0,2
16350,इंटरैक्टिव,0,0,2,2
9239,flooded,1,2,0,2
934,algoritmici,1,2,0,2
9244,backgammon,1,2,0,2
11685,myntat,0,0,2,2
9245,descrisse,1,2,0,2
44580,மாயாஜால,0,0,2,2
9199,interwiki,2,1,1,2
52343,xviiie siècle,0,0,2,2
49042,κάνουμε,0,0,2,2
860,consolidate,1,2,0,2
5307,cartello,1,2,0,2
50447,reducing,0,0,2,2
16406,डोमस्डे,0,0,2,2
52358,interconnected,0,0,2,2
869,permissivo,1,2,0,2
870,satira,1,2,0,2
16403,totalidad,0,0,2,2
9175,agente,2,1,1,2
47321,полной,0,0,2,2
11691,ಮನುಷ್ಯ,0,0,2,2
50445,indesejáveis,0,0,2,2
52353,نصف,0,0,2,2
12064,divin,0,0,2,2
879,minimizzare,1,2,0,2
9186,dispongono,1,2,0,2
8134,wikimini,2,1,1,2
16386,stum,0,0,2,2
5625,transfobia,1,2,0,2
49472,ساهم,0,0,2,2
882,isole,1,2,0,2
9188,segnalato,1,2,0,2
47548,تهدف,0,0,2,2
47315,असाइनमेंट,0,0,2,2
49044,minorités,0,0,2,2
9196,familiare,1,2,0,2
889,ba,2,1,1,2
891,preparati,1,2,0,2
52345,открытый,0,0,2,2
9246,disprezzo,1,2,0,2
12072,propriedade,0,0,2,2
8089,transport,2,1,1,2
49014,donationer,0,0,2,2
16316,enoje,0,0,2,2
16315,μαρμελάδα,0,0,2,2
16314,øg,0,0,2,2
972,piacimento,1,2,0,2
16312,kalla,0,0,2,2
974,pornografici,1,2,0,2
977,riconosciuta,1,2,0,2
16310,diamantes,0,0,2,2
16309,constituyen,0,0,2,2
47305,head,0,0,2,2
16306,ಇತ್ತೀಚಿನ,0,0,2,2
16305,opérateur,0,0,2,2
49015,oké,0,0,2,2
16302,esplanada,0,0,2,2
9282,nullius,2,1,1,2
9248,famosi,1,2,0,2
52308,റഫറൻസുകൾ,0,0,2,2
16297,ettim,0,0,2,2
44621,personnalités,0,0,2,2
5636,pkdd,2,1,1,2
9290,medicina,1,2,0,2
9291,sketch,2,1,1,2
16290,vandalizm,0,0,2,2
44623,فهمتك,0,0,2,2
44624,сервера,0,0,2,2
5638,correggerli,1,2,0,2
52306,ആകർഷണീയമായ,0,0,2,2
984,ottimale,1,2,0,2
44627,arabanın,0,0,2,2
5281,interagisce,1,2,0,2
5286,determinando,2,1,1,2
16317,дополнительный,0,0,2,2
16318,χρόνο,0,0,2,2
16319,değişikliklerin,0,0,2,2
52324,digam,0,0,2,2
44603,महसूस,0,0,2,2
8107,inviato,1,2,0,2
8105,compresa,1,2,0,2
9253,velozpedia,2,1,1,2
945,indirizza,1,2,0,2
44606,الجزء,0,0,2,2
12074,desse,0,0,2,2
49025,devagar,0,0,2,2
951,presi,1,2,0,2
8101,oi,2,1,1,2
52317,abajo,0,0,2,2
8100,eric,2,1,1,2
9267,chief,2,1,1,2
961,servono,1,2,0,2
8099,diffamazione,1,2,0,2
5629,selfie,2,1,1,2
16326,fortæl,0,0,2,2
964,bambina,1,2,0,2
9269,vicine,1,2,0,2
47551,мелисса,0,0,2,2
9271,corte,1,2,0,2
47552,conflicts,0,0,2,2
971,sistematico,1,2,0,2
9272,molecular,2,1,1,2
5288,requisito,2,1,1,2
16321,зарегистрированы,0,0,2,2
49487,источникам,0,0,2,2
9274,inquina,1,2,0,2
5587,primordiale,1,2,0,2
16658,progression,0,0,2,2
598,introdurre,1,2,0,2
17003,مضاء,0,0,2,2
11873,ταξίδι,0,0,2,2
17017,opiniones,0,0,2,2
5541,incontrarti,1,2,0,2
193,ellen,2,1,1,2
47426,versioner,0,0,2,2
44171,sidder,0,0,2,2
8504,metodologici,1,2,0,2
52623,சொற்றொடர்களை,0,0,2,2
44173,gerekiyor,0,0,2,2
212,bozze,1,2,0,2
52619,contienen,0,0,2,2
8502,accusandola,1,2,0,2
47425,перестань,0,0,2,2
8494,clubic,2,1,1,2
5471,turchia,1,2,0,2
243,cogito,2,1,1,2
17000,عبارات,0,0,2,2
52617,ಪರಿಸ್ಥಿತಿ,0,0,2,2
8721,orbita,1,2,0,2
224,ehud,2,1,1,2
8722,esistere,1,2,0,2
229,illustrazione,1,2,0,2
52614,документальный,0,0,2,2
236,umanistiche,1,2,0,2
8724,vikidia,2,1,1,2
8727,piracy,2,1,1,2
16993,xviie siècle,0,0,2,2
238,funzionano,1,2,0,2
239,erik,2,1,1,2
8731,comico,1,2,0,2
17019,ilk,0,0,2,2
5540,anticonsenso,2,1,1,2
11872,புகார்,0,0,2,2
187,antichi,1,2,0,2
8536,inghilterra,1,2,0,2
5538,amendment,2,1,1,2
49246,своего,0,0,2,2
17049,दर्जा,0,0,2,2
44148,inteira,0,0,2,2
8703,mettiti,1,2,0,2
17046,procurando,0,0,2,2
50508,berättar,0,0,2,2
11863,journaux,0,0,2,2
44150,d’algorithmes,0,0,2,2
47482,ancienne,0,0,2,2
49244,cooperação,0,0,2,2
11786,فبراير,0,0,2,2
11867, years,0,0,2,2
8709,tradizionalmente,1,2,0,2
8530,testuale,1,2,0,2
5478,convettivo,1,2,0,2
49321,μάτια,0,0,2,2
8710,candidati,1,2,0,2
52632,கொடுக்க,0,0,2,2
8712,tnr,2,1,1,2
17027,качество,0,0,2,2
17026,ley,0,0,2,2
180,cicerone,1,2,0,2
49241,daarna,0,0,2,2
181,greci,1,2,0,2
11870,επαναλάβει,0,0,2,2
44165,incorporating,0,0,2,2
44166,encyclopédiques,0,0,2,2
240,ripristinare,1,2,0,2
8733,rallegrare,1,2,0,2
8697,charles,2,1,1,2
16939,ಸಮಯದವರೆಗೆ,0,0,2,2
8751,divina,1,2,0,2
52597,üzere,0,0,2,2
8462,minsky,1,2,0,2
273,purché,1,2,0,2
8754,apprenderanno,1,2,0,2
8461,professori,1,2,0,2
52594,común,0,0,2,2
279,gangliaaf,2,1,1,2
44210,wortschatz,0,0,2,2
11778,huilt,0,0,2,2
49342,हुआ।,0,0,2,2
16944,distribuição,0,0,2,2
44211,concerne,0,0,2,2
47417,என்னவென்று,0,0,2,2
16938,रखती,0,0,2,2
16989,writes,0,0,2,2
47491,arme,0,0,2,2
8760,chatbot,2,1,1,2
44215,lært,0,0,2,2
47414,savoureux,0,0,2,2
16934,büyülü,0,0,2,2
49226,vemos,0,0,2,2
16932,νοιάζει,0,0,2,2
8768,sezionate,1,2,0,2
16930,connaissez,0,0,2,2
44219,ಪುನರಾವರ್ತಿಸಬಹುದೇ,0,0,2,2
300,convezione,1,2,0,2
49348,ഫ്ലംമോക്സ്,0,0,2,2
47413,المدرسة,0,0,2,2
44221,intensifique,0,0,2,2
5547,«per,1,2,0,2
11890,växer,0,0,2,2
16957,ചോദ്യം,0,0,2,2
47488,felaktigt,0,0,2,2
8734,optin,2,1,1,2
52610,ανανέωση,0,0,2,2
8738,substantia,2,1,1,2
16986,kararıyla,0,0,2,2
11883,глупый,0,0,2,2
52607,sormanın,0,0,2,2
52606,cognitives,0,0,2,2
8739,viveva,1,2,0,2
16982,discours,0,0,2,2
252,burocrati,1,2,0,2
16981,tendemos,0,0,2,2
8740,plos,2,1,1,2
16979,ഉള്ളത്,0,0,2,2
49234,सेक्शन,0,0,2,2
16977,компанией,0,0,2,2
16975,involve,0,0,2,2
8485,euro,1,2,0,2
16973,remedies,0,0,2,2
8479,wikitrust,2,1,1,2
16970,tomar,0,0,2,2
8478,lgbt,2,1,1,2
16969,पक्ष,0,0,2,2
16968,إخبار,0,0,2,2
11884,fifty,0,0,2,2
11885,வேலையைத்,0,0,2,2
260,informato,1,2,0,2
16964,interface,0,0,2,2
49231,londres,0,0,2,2
8748,annullare,1,2,0,2
17052,mudar,0,0,2,2
17054,consultée,0,0,2,2
44391,fuhr,0,0,2,2
8578,effettuano,1,2,0,2
49277,providers,0,0,2,2
30,cancellazione,1,2,0,2
17143,широкий,0,0,2,2
17140,suit,0,0,2,2
8593,principessa,1,2,0,2
36,straordinariamente,1,2,0,2
8592,intese,1,2,0,2
8634,possiede,1,2,0,2
44093,shifted,0,0,2,2
44,imbarazzante,1,2,0,2
17134,criticadas,0,0,2,2
47447,lectores,0,0,2,2
50489,ønske,0,0,2,2
17132,تعمل,0,0,2,2
5500,consapevoli,1,2,0,2
8650,epic,2,1,1,2
17129,bataklık,0,0,2,2
17128,lusófona,0,0,2,2
8577,sfruttando,1,2,0,2
52680,customer,0,0,2,2
44096,πήρατε,0,0,2,2
8642,fraile,2,1,1,2
60,attribuire,1,2,0,2
11844,funded,0,0,2,2
49298,çalışın,0,0,2,2
69,violazione,1,2,0,2
52673,تقدم,0,0,2,2
73,limita,1,2,0,2
50500,полностью,0,0,2,2
17120,equivocado,0,0,2,2
49292,mænd,0,0,2,2
29,profondità,1,2,0,2
11837,brillantes,0,0,2,2
17146,ordenou,0,0,2,2
17168,некоммерческая,0,0,2,2
5511,industriali,1,2,0,2
47454,kopf,0,0,2,2
8,repubblica,1,2,0,2
9,volto,1,2,0,2
8620,fluida,1,2,0,2
8604,cresceva,1,2,0,2
8603,supporti,1,2,0,2
47452,تعرفه,0,0,2,2
8623,premium,1,2,0,2
8625,referendum,2,1,1,2
49290,غالباً,0,0,2,2
14,lcs,2,1,1,2
44075,പ്രശ്‌നകരമായ,0,0,2,2
8598,picco,1,2,0,2
44076,corps,0,0,2,2
18,mensili,1,2,0,2
47451,பார்த்த,0,0,2,2
20,incorporava,2,1,1,2
8629,rivelato,1,2,0,2
44079,lidar,0,0,2,2
44081,distinguish,0,0,2,2
17155,τραπέζι,0,0,2,2
8631,basi,1,2,0,2
47450,منهم،,0,0,2,2
44086,attribuer,0,0,2,2
24,wikiexpertsus,2,1,1,2
25,raggiunse,1,2,0,2
52693,producido,0,0,2,2
5525,parliamo,1,2,0,2
82,pedofilia,2,1,1,2
17055,wurzel,0,0,2,2
8688,formalmente,2,1,1,2
8675,apparsa,1,2,0,2
44130,viser,0,0,2,2
47475,കാര്യനിർവ്വാഹകർ,0,0,2,2
8553,tornando,2,1,1,2
127,rimedi,1,2,0,2
8678,coronation,2,1,1,2
49308,accessibles,0,0,2,2
8550,venne,1,2,0,2
8548,rimangono,1,2,0,2
138,lander,2,1,1,2
139,finanziaria,1,2,0,2
11859,الإصدارات,0,0,2,2
8545,chelsea,2,1,1,2
47436,عدم,0,0,2,2
5482,battaglia,1,2,0,2
52669,पदार्थ,0,0,2,2
145,alex,2,1,1,2
148,rivoluzione,1,2,0,2
44140,gennem,0,0,2,2
50483,व्यक्तिगत,0,0,2,2
149,semplificato,1,2,0,2
49250,وجد,0,0,2,2
49313,попробуйте,0,0,2,2
49314,معي,0,0,2,2
8692,dinamo,1,2,0,2
8537,superiori,1,2,0,2
49248,руководства,0,0,2,2
152,affonda,1,2,0,2
49247,κάποια,0,0,2,2
155,inesattezze,1,2,0,2
17078,ту,0,0,2,2
44129,origins,0,0,2,2
8673,ormai,1,2,0,2
49258,अर्थात,0,0,2,2
8567,difetti,1,2,0,2
44105,ಹೆಲ್ಲರ್,0,0,2,2
8566,biasvariance,1,2,0,2
49265,इतनी,0,0,2,2
17112,ಸಣ್ಣ,0,0,2,2
93,stretto,1,2,0,2
95,riferiva,1,2,0,2
11851,செய்திருந்தால்,0,0,2,2
99,infanzia,1,2,0,2
17105,esforço,0,0,2,2
47443,सप्ताह,0,0,2,2
100,stupita,1,2,0,2
17104,σωστά,0,0,2,2
8661,interrotto,1,2,0,2
101,ripristina,1,2,0,2
52665,épico,0,0,2,2
5528,gemme,1,2,0,2
5529,bretone,1,2,0,2
52659,interacting,0,0,2,2
49304,المسؤولون,0,0,2,2
8562,valutato,1,2,0,2
8558,improbabile,1,2,0,2
117,coperto,1,2,0,2
11803,toplantı,0,0,2,2
17089,helhet,0,0,2,2
119,distribuzioni,1,2,0,2
17084,kızım,0,0,2,2
5489,metodologia,2,1,1,2
8671,cambia,1,2,0,2
44223,அனுப்ப,0,0,2,2
47492,motvalise,0,0,2,2
44224,قالوا,0,0,2,2
44343,chateada,0,0,2,2
499,portando,1,2,0,2
44334,sesgos,0,0,2,2
500,prevenzione,1,2,0,2
16757,зол,0,0,2,2
8898,georg,1,2,0,2
8900,attualità,1,2,0,2
501,spingendo,1,2,0,2
44337,أمريكي,0,0,2,2
49165,failed,0,0,2,2
504,pozze,1,2,0,2
11744,preocupaciones,0,0,2,2
5389,spettacolo,1,2,0,2
50554,stumpe,0,0,2,2
52510,determinado,0,0,2,2
510,erika,2,1,1,2
537,poesia,1,2,0,2
511,detenuto,1,2,0,2
516,insa,2,1,1,2
5387,volti,1,2,0,2
44346,звучит,0,0,2,2
47513,എവിടെയായിരുന്നുവെന്ന്,0,0,2,2
44347,kullandığı,0,0,2,2
44348,சமீபத்திய,0,0,2,2
5578,preelaborazione,1,2,0,2
8918,sostituiranno,1,2,0,2
11961,découvertes,0,0,2,2
8921,manderò,1,2,0,2
47373,soldaten,0,0,2,2
49157,restrictions,0,0,2,2
8305,tang,2,1,1,2
497,frances,2,1,1,2
8317,volumetria,1,2,0,2
495,dite,2,1,1,2
16763,إلي,0,0,2,2
47510,lowdimensional,0,0,2,2
47387,hosted,0,0,2,2
452,rimossi,1,2,0,2
454,oliver,2,1,1,2
44315,thinking,0,0,2,2
49181,motor,0,0,2,2
49180,മെച്ചപ്പെട്ട,0,0,2,2
458,scenario,2,1,1,2
11747,mariage,0,0,2,2
8869,joaquín,2,1,1,2
8332,philippe,2,1,1,2
8874,erbacce,1,2,0,2
49174,representações,0,0,2,2
11942,rol,0,0,2,2
16781,huske,0,0,2,2
473,phusika,2,1,1,2
44322,revealed,0,0,2,2
474,rimuovendo,1,2,0,2
476,infrazioni,1,2,0,2
8886,mediatiche,1,2,0,2
8330,elogiata,1,2,0,2
479,tsurko,2,1,1,2
8328,attribuiti,1,2,0,2
8887,sabatier,2,1,1,2
52519,feeling,0,0,2,2
5399,ovunque,1,2,0,2
5396,difetto,1,2,0,2
8327,scotland,2,1,1,2
16768,interrelated,0,0,2,2
8933,essenza,1,2,0,2
16735,essence,0,0,2,2
5450,profonda,1,2,0,2
16685,happening,0,0,2,2
5383,anarchism,2,1,1,2
50557,limitadas,0,0,2,2
8281,emersi,1,2,0,2
576,doppia,1,2,0,2
11738,hepsini,0,0,2,2
8975,vitalistica,1,2,0,2
586,cancellati,1,2,0,2
11973,المكان,0,0,2,2
47365,ρωτάτε,0,0,2,2
44378,pais,0,0,2,2
16692,ಮೂರು,0,0,2,2
16690,முழுவதும்,0,0,2,2
8980,lettere,1,2,0,2
11977,പ്രായം,0,0,2,2
591,calcolato,1,2,0,2
52496,amenaza,0,0,2,2
16681,ligger,0,0,2,2
16680,préféré,0,0,2,2
11978,വിശ്വസിക്കുന്നത്,0,0,2,2
8272,amical,2,1,1,2
16673,déjeuner,0,0,2,2
8983,ordinari,1,2,0,2
8984,credenziali,1,2,0,2
16671,limites,0,0,2,2
8987,apprendono,1,2,0,2
8991,plasma,2,1,1,2
8269,formati,1,2,0,2
596,denoising,2,1,1,2
16661,confirmed,0,0,2,2
16660,inspirado,0,0,2,2
52487,measures,0,0,2,2
52488,katalanska,0,0,2,2
8966,decisionali,1,2,0,2
563,scambio,1,2,0,2
44358,prises,0,0,2,2
541,plausibili,1,2,0,2
11964,ach,0,0,2,2
542,onore,1,2,0,2
8303,contestato,1,2,0,2
8934,partecipa,1,2,0,2
49154,தொகுக்க,0,0,2,2
44361,текстов,0,0,2,2
49153,etmenin,0,0,2,2
545,didier,2,1,1,2
8302,preciso,2,1,1,2
16723,telecomunicaciones,0,0,2,2
8299,mancante,1,2,0,2
49150,cebuanospråkiga,0,0,2,2
16717,förslag,0,0,2,2
554,darci,1,2,0,2
47515,formuleringen,0,0,2,2
555,largamente,1,2,0,2
16710,κομμάτια,0,0,2,2
8295,garry,2,1,1,2
49148,σένα,0,0,2,2
8950,locomozione,1,2,0,2
561,svilupparsi,1,2,0,2
8952,codici,1,2,0,2
8954,crude,2,1,1,2
8294,piangi,1,2,0,2
562,salati,1,2,0,2
8964,fotografie,1,2,0,2
49405,செய்யப்,0,0,2,2
44307,tilsammen,0,0,2,2
44306,broad,0,0,2,2
8857,cerimonia,1,2,0,2
44257,alltså,0,0,2,2
11765,നിന്നെ,0,0,2,2
49361,djupt,0,0,2,2
52570,منفرجة,0,0,2,2
8402,cardon,2,1,1,2
8401,shirky,2,1,1,2
50473,கேட்கலாம்,0,0,2,2
50532,voordat,0,0,2,2
8398,rodinia,2,1,1,2
49210,publient,0,0,2,2
16873,hakkındaki,0,0,2,2
8396,fitzerald,2,1,1,2
8394,manipolazione,1,2,0,2
8805,dicendomi,1,2,0,2
50533,medalhas,0,0,2,2
50535,desalienta,0,0,2,2
11937,ಒಪ್ಪುವುದಿಲ್ಲ,0,0,2,2
11913,binnen,0,0,2,2
52563,கொடுத்தார்,0,0,2,2
8392,ming,2,1,1,2
49364,memória,0,0,2,2
364,scena,1,2,0,2
44261,siècle,0,0,2,2
50537,allvar,0,0,2,2
16864,बढ़ने,0,0,2,2
5427,ricostruire,1,2,0,2
5563,completezza,1,2,0,2
5423,émilie,2,1,1,2
8386,vettoriali,1,2,0,2
11760,heavens,0,0,2,2
47503,allégorique,0,0,2,2
8792,progress,2,1,1,2
8791,lecun,2,1,1,2
16880,verdrinken,0,0,2,2
16882,nationalencyklopedin,0,0,2,2
52582,herkes,0,0,2,2
313,sbalordito,1,2,0,2
8436,"​
larry",2,1,1,2
8769,macro,2,1,1,2
314,jet,2,1,1,2
47411,presocratic,0,0,2,2
11773,orbit,0,0,2,2
44229,आशा,0,0,2,2
8434,wikiwikiweb—,2,1,1,2
316,vennero,1,2,0,2
16913,förstod,0,0,2,2
44232,biosphère,0,0,2,2
47494,heiraten,0,0,2,2
318,nessuna,1,2,0,2
8431,forze,1,2,0,2
8430,popolazioni,1,2,0,2
8780,roger,2,1,1,2
44236,حلمًا,0,0,2,2
44237,faits,0,0,2,2
323,filosofo,1,2,0,2
8425,adaptive,2,1,1,2
8416,giocare,1,2,0,2
52575,زيارة,0,0,2,2
16890,अभी,0,0,2,2
44245,ടീച്ചർ,0,0,2,2
50479,textuel,0,0,2,2
8410,otrs,2,1,1,2
16883,ಮಾಡುವುದನ್ನು,0,0,2,2
335,illustra,1,2,0,2
11920,मील,0,0,2,2
11921,visuais,0,0,2,2
8815,anima,2,1,1,2
16830,dicionário,0,0,2,2
50545,комуто,0,0,2,2
44284,rüyaydı,0,0,2,2
50468,centenas,0,0,2,2
44286,இருப்பதால்,0,0,2,2
49383,gümüş,0,0,2,2
16823,प्रदर्शन,0,0,2,2
8349,fattibilità,1,2,0,2
415,anmen,2,1,1,2
44291,उच्चतम,0,0,2,2
44292,personales,0,0,2,2
49190,constitue,0,0,2,2
5404,andata,1,2,0,2
49189,capazes,0,0,2,2
419,iscriviti,1,2,0,2
425,collegiale,2,1,1,2
49387,högskola,0,0,2,2
8339,antiche,1,2,0,2
8338,testimonianza,1,2,0,2
431,sostenendo,1,2,0,2
8849,flussi,1,2,0,2
8337,operato,1,2,0,2
435,wikiworld,2,1,1,2
44297,सदस्य,0,0,2,2
44299,icône,0,0,2,2
437,pratico,1,2,0,2
439,traccia,1,2,0,2
49388,entière,0,0,2,2
8852,finale,1,2,0,2
16800,represents,0,0,2,2
11750,beispielsätze,0,0,2,2
11928,الأخبار,0,0,2,2
16850,πληροφορίες,0,0,2,2
8842,coordinati,1,2,0,2
8379,stragrande,1,2,0,2
49373,reflects,0,0,2,2
8817,mari,1,2,0,2
49199,corrigir,0,0,2,2
8824,sapiens,2,1,1,2
44271,allows,0,0,2,2
374,concentrati,1,2,0,2
44273,yaptın,0,0,2,2
8371,logici,1,2,0,2
49196,återställa,0,0,2,2
16844,ошибка,0,0,2,2
8828,morso,1,2,0,2
8829,esistiti,1,2,0,2
8370,disinformazione,1,2,0,2
380,tratte,1,2,0,2
384,organizzano,1,2,0,2
47393,instruktioner,0,0,2,2
16838,ಬಡ,0,0,2,2
386,boyle,2,1,1,2
49195,പെട്ടെന്നുതന്നെ,0,0,2,2
8836,traduce,1,2,0,2
50470,எது,0,0,2,2
50469,efficient,0,0,2,2
8356,azzam,2,1,1,2
44280,तुमसे,0,0,2,2
11751,ವಾಕ್ಯಗಳನ್ನು,0,0,2,2
8841,interconnessi,1,2,0,2
16833,जादुई,0,0,2,2
407,odum,2,1,1,2
49520,ನಮ್ಮ,0,0,2,2
16230,portions,0,0,2,2
49522,grusom,0,0,2,2
1623,restante,2,1,1,2
9716,levantadas,0,0,2,2
1635,celesti,1,2,0,2
15627,betreft,0,0,2,2
9718,அபத்தமானது,0,0,2,2
45035,wikiprogramvaran,0,0,2,2
11593,diseases,0,0,2,2
52045,عزيزتي,0,0,2,2
9723,identities,0,0,2,2
1644,primati,1,2,0,2
45039,أجراها,0,0,2,2
45040,تعتقد,0,0,2,2
15618,iniciativa,0,0,2,2
1648,professionali,1,2,0,2
7685,attribuita,1,2,0,2
15613,пройти,0,0,2,2
1652,efficienti,1,2,0,2
50672,thumbs,0,0,2,2
1661,lipnet,2,1,1,2
15609,വിദഗ്ദ്ധന്മാർ,0,0,2,2
9726,ஏனெனில்,0,0,2,2
15601,beslut,0,0,2,2
49634,الجدد,0,0,2,2
1665,metabolismo,1,2,0,2
1667,changeux,2,1,1,2
45049,reverte,0,0,2,2
9730,дисков,0,0,2,2
47190,தெரியுமா,0,0,2,2
47189,cycle,0,0,2,2
48804,சோர்வாக,0,0,2,2
1624,consultabile,1,2,0,2
52049,puisque,0,0,2,2
1584,adotta,1,2,0,2
15632,எல்லோரும்,0,0,2,2
47193,காலமாக,0,0,2,2
7702,plucker,2,1,1,2
45010,sauvagerie,0,0,2,2
9705,geldiğini,0,0,2,2
52063,विकिक्वोट,0,0,2,2
52062,crescido,0,0,2,2
9706,بجدية,0,0,2,2
7701,imparerà,1,2,0,2
15658,உடன்படவில்லை,0,0,2,2
12263,audelà,0,0,2,2
45014,questioning,0,0,2,2
1601,deputati,1,2,0,2
15654,mujer,0,0,2,2
48820,നിങ്ങൾക്കറിയാമെന്ന്,0,0,2,2
15653,sens ,0,0,2,2
49625,पीढ़ी,0,0,2,2
49626,незамедлительно,0,0,2,2
7692,fascia,1,2,0,2
47619,modifiées,0,0,2,2
15645,gráfico,0,0,2,2
9712,pequeños,0,0,2,2
50670,corporativa,0,0,2,2
49629,déterminé,0,0,2,2
45023,തിരഞ്ഞെടുക്കുന്നു,0,0,2,2
1614,risatine,1,2,0,2
45029,considering,0,0,2,2
7687,mandato,1,2,0,2
52050,kartor,0,0,2,2
7686,framework,2,1,1,2
49637,sju,0,0,2,2
15591,jusqu’à,0,0,2,2
48802,موضوع,0,0,2,2
5743,presentati,1,2,0,2
15563,الجميلة,0,0,2,2
7659,idealmente,1,2,0,2
45074,yapalım,0,0,2,2
47180,அங்கீகரிக்கப்பட்ட,0,0,2,2
5058,poca,2,1,1,2
45075,imorgon,0,0,2,2
15559,faria,0,0,2,2
1711,coscienza,1,2,0,2
15557,soporte,0,0,2,2
52019,veräppeln,0,0,2,2
49646,سهل,0,0,2,2
45079,nachrichten,0,0,2,2
47179,скоро,0,0,2,2
47178,आने,0,0,2,2
48782,klicka,0,0,2,2
1715,lages,2,1,1,2
9770,സമവാക്യം,0,0,2,2
48781,помните,0,0,2,2
9774,بلغة,0,0,2,2
9779,gases,0,0,2,2
12283,tien,0,0,2,2
47177,مروعًا,0,0,2,2
45086,беспокойство,0,0,2,2
5749,scuole,1,2,0,2
15540,виды,0,0,2,2
49648,ಅದೃಷ್ಟವಂತರು,0,0,2,2
45089,prenez,0,0,2,2
15533,allonsy,0,0,2,2
47176,eigenlijk,0,0,2,2
48785,απαντήσετε,0,0,2,2
45071,ενεργειακό,0,0,2,2
15566,двигаться,0,0,2,2
52031,βοηθήσω,0,0,2,2
5075,phyla,2,1,1,2
15586,tidigt,0,0,2,2
15584,wij,0,0,2,2
1675,sacra,1,2,0,2
45058,grausame,0,0,2,2
45059,exemple ,0,0,2,2
49639,livros,0,0,2,2
1682,mh,2,1,1,2
9746,பிரகாசமான,0,0,2,2
50674,courantes,0,0,2,2
7674,efe,2,1,1,2
7671,soldato,1,2,0,2
45063,söt,0,0,2,2
7668,egoista,1,2,0,2
48788,تلتقط,0,0,2,2
45065,sistêmico,0,0,2,2
1690,famiglia,1,2,0,2
9749,запас,0,0,2,2
5745,considerevole,1,2,0,2
5746,prolungate,1,2,0,2
1693,hart,2,1,1,2
47185,υποθέτω,0,0,2,2
7667,intorno,1,2,0,2
47184,crossed,0,0,2,2
47182,humble,0,0,2,2
9757,besked,0,0,2,2
50678,ഒന്നും,0,0,2,2
15569,etou,0,0,2,2
7713,universitaria,2,1,1,2
52068,ಮಾರ್ಗಗಳನ್ನು,0,0,2,2
15796,économique,0,0,2,2
9659,assicurano,1,2,0,2
15759,biologie,0,0,2,2
7745,distribuiti,1,2,0,2
50411,ತಮಾಷೆ,0,0,2,2
5127,allevarli,1,2,0,2
9660,centri,1,2,0,2
9661,moderni,1,2,0,2
52105,pratade,0,0,2,2
44954,fjollet,0,0,2,2
44955,ಹೊಂದಿದೆ,0,0,2,2
1503,differiscono,1,2,0,2
9662,vincere,1,2,0,2
9663,condivide,1,2,0,2
5715,rotazione,1,2,0,2
52103,skiftede,0,0,2,2
52102,müssen,0,0,2,2
7742,parametri,1,2,0,2
52100,പ്രതീക്ഷിക്കുന്നു,0,0,2,2
12245,സാങറും,0,0,2,2
9667,camel,2,1,1,2
48846,كمشروع,0,0,2,2
15748,englishspeaking,0,0,2,2
5118,ragionamenti,1,2,0,2
15746,voyage,0,0,2,2
5116,magnetico,1,2,0,2
47605,authoritative,0,0,2,2
9673,encontrarse,0,0,2,2
52095,சொல்கிறார்கள்,0,0,2,2
44964,ವಾಕ್ಯಗಳು,0,0,2,2
1520,chartier,2,1,1,2
1495,vorresti,1,2,0,2
9657,causare,1,2,0,2
52070,முனை,0,0,2,2
1492,rappresentanza,1,2,0,2
7757,edward,2,1,1,2
9633,suonare,1,2,0,2
9635,basingstoke,2,1,1,2
48855,bioinformatics,0,0,2,2
1480,olanda,1,2,0,2
1481,inizia,1,2,0,2
7755,wikimedia—,2,1,1,2
7752,accurata,1,2,0,2
12230,birleşik,0,0,2,2
44939,доступ,0,0,2,2
12231,sociedad,0,0,2,2
7748,molecole,1,2,0,2
5706,presidenziali,1,2,0,2
12237,property,0,0,2,2
9644,dee,2,1,1,2
15780,herinde,0,0,2,2
9645,stretti,1,2,0,2
5707,dotato,1,2,0,2
15778,помощью,0,0,2,2
15777,समझ,0,0,2,2
1489,metafisico,1,2,0,2
47208,idiot,0,0,2,2
47207,désigne,0,0,2,2
9649,pseudonimo,1,2,0,2
48851,professionals,0,0,2,2
15769,silly,0,0,2,2
12242,loan,0,0,2,2
9654,decine,1,2,0,2
15766,γίνει,0,0,2,2
1521,preoccupa,1,2,0,2
52094,تحريرها,0,0,2,2
1523,distinte,1,2,0,2
1528,judea,2,1,1,2
7721,marcia,1,2,0,2
12257,sociaux,0,0,2,2
50403,arrasa,0,0,2,2
15699,веб,0,0,2,2
15698,ενοχλητική,0,0,2,2
1559,avvale,1,2,0,2
7719,connesse,1,2,0,2
15693,arkadaşınız,0,0,2,2
12258,almak,0,0,2,2
50667,ക്രോധ,0,0,2,2
15691,hjemme,0,0,2,2
9691,consultées,0,0,2,2
48830,spin,0,0,2,2
12259,negocio,0,0,2,2
9693,purpose,0,0,2,2
1569,union,2,1,1,2
15684,manque,0,0,2,2
15683,ചേർത്ത്,0,0,2,2
44997,buscas,0,0,2,2
15679,quantidade,0,0,2,2
1570,venduta,1,2,0,2
1573,limitata,1,2,0,2
5739,ted,2,1,1,2
9696,cicéron,0,0,2,2
47195,celuici,0,0,2,2
1576,graduale,1,2,0,2
5740,minimizzazione,1,2,0,2
49621,referat,0,0,2,2
45004,altered,0,0,2,2
5096,pace,2,1,1,2
9687,platform,0,0,2,2
1131,columbia,2,1,1,2
44981,tartışmalar,0,0,2,2
15733,påverkade,0,0,2,2
44969,tradicional,0,0,2,2
7737,assume,2,1,1,2
1532,frikipedia,2,1,1,2
5718,modificarli,1,2,0,2
5107,diventano,1,2,0,2
5722,minoranze,1,2,0,2
49612,estavam,0,0,2,2
1537,rif,1,2,0,2
48840,åsikt,0,0,2,2
1539,orologio,1,2,0,2
44977,examined,0,0,2,2
44980,humilde,0,0,2,2
50664,annual,0,0,2,2
49618,النقر,0,0,2,2
1540,subentrando,1,2,0,2
5728,corrisponde,1,2,0,2
47198,concevoir,0,0,2,2
5099,estu,2,1,1,2
7726,destinazione,1,2,0,2
9683,talking,0,0,2,2
15711,remonter,0,0,2,2
52082,otherwise,0,0,2,2
5736,abbonamento,1,2,0,2
11604,விளையாடுகிறீர்கள்,0,0,2,2
48836,actualiser,0,0,2,2
15708,बल्कि,0,0,2,2
44986,yollarını,0,0,2,2
5057,fornitori,1,2,0,2
12288,paradoxe,0,0,2,2
15526,نرجس,0,0,2,2
51936,atender,0,0,2,2
47141,richesses,0,0,2,2
1958,parziale,1,2,0,2
1960,siccome,1,2,0,2
51933,بعمل,0,0,2,2
15351,следовательно,0,0,2,2
15350,எங்கிருந்தோம்,0,0,2,2
12344,rötter,0,0,2,2
9879,sizi,0,0,2,2
50382,മലയാളമടക്കം,0,0,2,2
12352,artificiel,0,0,2,2
15346,publicações,0,0,2,2
45204,مشاهدات,0,0,2,2
15341,davantage,0,0,2,2
51927,darauf,0,0,2,2
1977,godere,1,2,0,2
45207,права,0,0,2,2
45208,रहना,0,0,2,2
15335,skärmar,0,0,2,2
1978,eseguono,1,2,0,2
15333,موقفًا,0,0,2,2
12356,modèles,0,0,2,2
45210,கீழ்,0,0,2,2
7545,cpus,2,1,1,2
1982,esaminate,1,2,0,2
48710,række,0,0,2,2
7541,lui»,1,2,0,2
4989,coloniale,2,1,1,2
45214,videos,0,0,2,2
49692,källhänvisningar,0,0,2,2
1951,scopi,1,2,0,2
1947,dialetti,1,2,0,2
15524,असंख्य,0,0,2,2
15358,الأمور؟,0,0,2,2
1887,tenuti,1,2,0,2
48725,bron,0,0,2,2
9864,eruditos,0,0,2,2
4994,riprendendo,1,2,0,2
1891,interventi,1,2,0,2
9866,politik,0,0,2,2
9868,kim,0,0,2,2
7564,utilità,1,2,0,2
1897,pannotia,2,1,1,2
51952,savaşlarına,0,0,2,2
1900,interrogazione,1,2,0,2
5784,negoziazione,1,2,0,2
45186,turisten,0,0,2,2
12338,തീരുമാനിക്കപ്പെടുന്നു,0,0,2,2
48720,específico,0,0,2,2
11566,diagram,0,0,2,2
7561,quick,2,1,1,2
9875,realiza,0,0,2,2
1924,perspectives,1,2,0,2
7557,graham,2,1,1,2
49688,parks,0,0,2,2
15367,премию,0,0,2,2
1935,connotazioni,1,2,0,2
7555,bisogna,1,2,0,2
15364,deverá,0,0,2,2
45193,constants,0,0,2,2
1944,altitudine,1,2,0,2
51937,рассылки,0,0,2,2
5786,scuoti,1,2,0,2
1991,alejandro,2,1,1,2
1992,pipa,2,1,1,2
7537,obs,2,1,1,2
7533,notabilità,1,2,0,2
48699,regels,0,0,2,2
2015,errati,1,2,0,2
11548,μυστικό,0,0,2,2
45241,assouline et,0,0,2,2
7522,didattica,1,2,0,2
47651,भीतर,0,0,2,2
2018,anticlaudianus,2,1,1,2
11544,اليابانية,0,0,2,2
2021,transazioni,1,2,0,2
15278,запросы,0,0,2,2
7518,essentia,2,1,1,2
5794,irs,2,1,1,2
45249,says,0,0,2,2
47128,soldier,0,0,2,2
9910,الجمل,0,0,2,2
51904,школе,0,0,2,2
15271,μέλισσα,0,0,2,2
4976,emendamento,1,2,0,2
7514,dama,1,2,0,2
4975,delega,2,1,1,2
51901,vergiss,0,0,2,2
49701,இணைய,0,0,2,2
51899,stumpfe,0,0,2,2
45256,kam,0,0,2,2
9914,ultimately,0,0,2,2
4974,compromesso,1,2,0,2
45257,ಇಲ್ಲಿಗೆ,0,0,2,2
4973,tratto,1,2,0,2
51897,декабря,0,0,2,2
4986,inedite,1,2,0,2
12364,süß,0,0,2,2
2013,grafema,2,1,1,2
2008,asteroide,1,2,0,2
7529,uruguay,2,1,1,2
12359,ilustraciones,0,0,2,2
7528,venuti,1,2,0,2
1996,focale,1,2,0,2
7526,desiderati,1,2,0,2
49696,കളിയാക്കണം,0,0,2,2
1998,decennio,1,2,0,2
45223,ögon,0,0,2,2
51915,klugen,0,0,2,2
15315,maktspel,0,0,2,2
51914,généraliste,0,0,2,2
2005,rese,1,2,0,2
7523,innata,1,2,0,2
51911,seeing,0,0,2,2
15290,academics,0,0,2,2
2012,privati,1,2,0,2
15305,letters,0,0,2,2
15304,dá,0,0,2,2
15302,വിജ്ഞാനകോശമാണ്,0,0,2,2
9897,falsos,0,0,2,2
15301,बनने,0,0,2,2
48703,الحين,0,0,2,2
9902,intelligenten,0,0,2,2
45236,gjorts,0,0,2,2
15294,रहती,0,0,2,2
45237,coordinated,0,0,2,2
15292,രാവിലെ,0,0,2,2
45238,καιρό,0,0,2,2
51955,myntades,0,0,2,2
45179,expérimentale,0,0,2,2
51956,വിവരങ്ങളും,0,0,2,2
1777,viquipedia,2,1,1,2
1752,folla,1,2,0,2
5753,opposte,1,2,0,2
7631,cinquanta,1,2,0,2
45118,بأكملها,0,0,2,2
15480,تخبرني,0,0,2,2
15479,reconnues,0,0,2,2
7626,labsresearch,2,1,1,2
5755,patocka,2,1,1,2
1757,canton,2,1,1,2
1758,giornaliere,1,2,0,2
50688,consistía,0,0,2,2
45121,ಮರೆಯಬೇಡಿ,0,0,2,2
48752,alleges,0,0,2,2
12301,സേവനങ്ങൾ,0,0,2,2
5756,uncyclopedia,2,1,1,2
52000,ತಿರುಗಿಸಿದೆ,0,0,2,2
47163,التحكيم,0,0,2,2
12305,mögen,0,0,2,2
5760,seicento,1,2,0,2
48745,följa,0,0,2,2
47632,منتصف,0,0,2,2
47158,വിക്കിപീഡിയക്കായി,0,0,2,2
50395,लिंक,0,0,2,2
15469,ανθρώπους,0,0,2,2
9831,hundred,0,0,2,2
49668,أخذ,0,0,2,2
45127,modernes,0,0,2,2
51990,المراكز,0,0,2,2
7603,filosofiche,1,2,0,2
47629,logiciel ,0,0,2,2
9810,വിവരം,0,0,2,2
52004,அவருடன்,0,0,2,2
48763,criticism,0,0,2,2
15522,வழியில்,0,0,2,2
7647,menzionati,1,2,0,2
15517,أحبك,0,0,2,2
47627,finds,0,0,2,2
45098,பயன்படுத்தி,0,0,2,2
1729,ispirazione,1,2,0,2
49655,रंग,0,0,2,2
45099,revisions,0,0,2,2
15511,பிடித்திருந்தால்,0,0,2,2
1731,eventualmente,1,2,0,2
47170,серверы,0,0,2,2
7643,batte,1,2,0,2
1734,pedìa,1,2,0,2
45102,ഉറപ്പാക്കുക,0,0,2,2
7633,cancro,1,2,0,2
7640,iescgeekcorpsmali,2,1,1,2
49656,இதனை,0,0,2,2
7635,effettuata,1,2,0,2
7634,duda,2,1,1,2
15499,interação,0,0,2,2
15497,पॉइंट,0,0,2,2
1739,sottoposto,1,2,0,2
11583,independently,0,0,2,2
5043,frank,2,1,1,2
12298,отправлю,0,0,2,2
15494,edities,0,0,2,2
1746,informatiche,1,2,0,2
1748,raffinato,1,2,0,2
45128,satt,0,0,2,2
12314,discovered,0,0,2,2
45178,felaktig,0,0,2,2
1781,teoricamente,1,2,0,2
15423,sorduğunda,0,0,2,2
15422,структура,0,0,2,2
1833,uuu,2,1,1,2
12323,tentando,0,0,2,2
1834,vive,1,2,0,2
49676,enjoy,0,0,2,2
15420,kardeş,0,0,2,2
48732,الموجودة,0,0,2,2
1840,vedendo,1,2,0,2
51969,തുടരുക,0,0,2,2
15413,огромных,0,0,2,2
1843,motivato,1,2,0,2
7578,sfuggono,1,2,0,2
1844,crisi,1,2,0,2
9858,പരസ്പരബഹുമാനവും,0,0,2,2
7577,caricato,1,2,0,2
7576,posteriori,2,1,1,2
1848,wordsworth,2,1,1,2
12329,обычных,0,0,2,2
1850,neuroscience,2,1,1,2
11574,kontakt,0,0,2,2
1863,ortografiche,1,2,0,2
5004,julius,2,1,1,2
1867,impazzito,1,2,0,2
51961,déconcertés,0,0,2,2
11573,aparición,0,0,2,2
11572,itibarıyla,0,0,2,2
47637,धीमा,0,0,2,2
1881,contestati,1,2,0,2
9847,conservation,0,0,2,2
15429,vandálicos,0,0,2,2
49673,பயன்படுத்தக்கூடாது,0,0,2,2
49670,révision,0,0,2,2
1783,proporre,1,2,0,2
15458,الخبراء,0,0,2,2
1784,stupro,1,2,0,2
7596,paesaggio,1,2,0,2
15456,ಬೆರಗುಗೊಳಿಸುವ,0,0,2,2
1789,sostenibile,1,2,0,2
5767,ultravioletta,1,2,0,2
48738,longue,0,0,2,2
9839,sinceramente,0,0,2,2
15453,spiser,0,0,2,2
5768,sud,2,1,1,2
9840,സംഭവിക്കുന്നതെന്ന്,0,0,2,2
11577,കരയുകയും,0,0,2,2
1811,mandiberg,2,1,1,2
1827,stupito,1,2,0,2
51980,அறிமுகப்படுத்தப்பட்டது,0,0,2,2
15445,математической,0,0,2,2
49671,puestos,0,0,2,2
1817,democratica,1,2,0,2
5009,oggettiva,1,2,0,2
7591,dualismo,1,2,0,2
15438,beginning,0,0,2,2
48734,realizar,0,0,2,2
7590,intenzionalità,1,2,0,2
5770,oscura,1,2,0,2
45148,fångade,0,0,2,2
1826,programmatori,1,2,0,2
7589,predizioni,1,2,0,2
52121,podemos,0,0,2,2
15704,البكاء,0,0,2,2
5140,parisnanterre,2,1,1,2
1285,pensato,1,2,0,2
9468,raggiungimento,1,2,0,2
11651,recogen,0,0,2,2
7877,imparassero,1,2,0,2
48928,arbitration,0,0,2,2
9479,mrs,2,1,1,2
48926,मित्र,0,0,2,2
44804,hield,0,0,2,2
7874,aspetti,1,2,0,2
48924,éditeurs,0,0,2,2
15990,имени,0,0,2,2
9483,dick,2,1,1,2
49561,пора,0,0,2,2
9489,decisive,2,1,1,2
44808,கலைக்களஞ்சியமாக,0,0,2,2
5188,ringraziandoti,1,2,0,2
44809,βάσης,0,0,2,2
1277,librepedia,2,1,1,2
5185,uiquipedia,2,1,1,2
9493,morale,1,2,0,2
5671,geometry,2,1,1,2
15981,ثلث,0,0,2,2
7857,minecraft,2,1,1,2
7856,avevi,1,2,0,2
15975,beraber,0,0,2,2
12177,förutom,0,0,2,2
1261,crowdsourcing,1,2,0,2
15995,flowing,0,0,2,2
50632,ശല്യപ്പെടുത്തുന്ന,0,0,2,2
7903,studiate,1,2,0,2
1246,consigliando,1,2,0,2
44781,caractère,0,0,2,2
5195,terziaria,1,2,0,2
16022,الهندسة,0,0,2,2
50426,கட்டுரைகளும்,0,0,2,2
52206,hoog,0,0,2,2
12167,resistance,0,0,2,2
5193,successive,1,2,0,2
5192,privata,2,1,1,2
7904,brutta,1,2,0,2
16014,tropical,0,0,2,2
1256,intervalli,1,2,0,2
7881,denis,2,1,1,2
44791,какоето,0,0,2,2
7902,dirla,1,2,0,2
44795,deel,0,0,2,2
16004,exploitation,0,0,2,2
9462,luoghi,1,2,0,2
9463,totalità,1,2,0,2
16001,известность,0,0,2,2
7886,vignetta,1,2,0,2
12171,anomalies,0,0,2,2
1259,limonpedia,2,1,1,2
7884,portavoce,1,2,0,2
5673,raymond,2,1,1,2
44817,graph,0,0,2,2
52174,planlar,0,0,2,2
9498,pianta,1,2,0,2
11642,zfs,0,0,2,2
5176,interstellare,1,2,0,2
44841,οποιαδήποτε,0,0,2,2
5683,uniforme,1,2,0,2
7832,álvaro,1,2,0,2
1326,riprendi,1,2,0,2
49575,हुह,0,0,2,2
44845,देखें,0,0,2,2
15921,ചെയ്യുന്നതും,0,0,2,2
1328,comportamentale,1,2,0,2
1329,menti,1,2,0,2
47242,alacağım,0,0,2,2
12186,zamanla,0,0,2,2
5686,svizzera,1,2,0,2
9533,riunione,1,2,0,2
1334,auc,2,1,1,2
11636,ndeki,0,0,2,2
12189,wikipédia ,0,0,2,2
7825,selvatica,1,2,0,2
5170,lati,1,2,0,2
47237,orientée,0,0,2,2
7816,sparso,1,2,0,2
1342,miglia,1,2,0,2
15910,أثناء,0,0,2,2
15909,imitation,0,0,2,2
52183,научными,0,0,2,2
15934,जनता,0,0,2,2
1315,desktop,1,2,0,2
1304,taha,2,1,1,2
49569,ಎಳೆಯಿರಿ,0,0,2,2
52191,τούτου,0,0,2,2
7847,trans,2,1,1,2
1292,realizzazione,1,2,0,2
5677,teme,1,2,0,2
15957,யார்,0,0,2,2
1294,sostanziali,1,2,0,2
15954,videonun,0,0,2,2
7841,aclu,2,1,1,2
48913,administrator,0,0,2,2
9516,disparità,1,2,0,2
7840,persi,1,2,0,2
9524,casualmente,1,2,0,2
9520,tony,2,1,1,2
12181,anser,0,0,2,2
1309,finirà,1,2,0,2
15946,wild,0,0,2,2
52185,rico,0,0,2,2
44832,ിത്തമാണ്,0,0,2,2
47582,contribuyentes,0,0,2,2
7835,credibilità,1,2,0,2
48910,sık,0,0,2,2
44834,humanity,0,0,2,2
15938,endişelendiğini,0,0,2,2
1245,ksvd,2,1,1,2
47256,فيديو,0,0,2,2
9452,costolo,2,1,1,2
49551,presentar,0,0,2,2
1175,consultati,1,2,0,2
16094,professeur,0,0,2,2
44747,arreglo,0,0,2,2
1176,prolog,2,1,1,2
7971,viola,2,1,1,2
44748,permiso,0,0,2,2
16090,soutenir,0,0,2,2
16089,birden,0,0,2,2
1177,correzioni,1,2,0,2
50624,halen,0,0,2,2
5218,consolidata,1,2,0,2
44750,maximize,0,0,2,2
16084,nadie,0,0,2,2
1181,ripreso,1,2,0,2
52230,கடன்,0,0,2,2
44752,ಹುಡುಗರಿಗೆ,0,0,2,2
1184,stimoli,1,2,0,2
1186,dominare,1,2,0,2
1189,separata,1,2,0,2
7965,autorevolezza,1,2,0,2
7963,animalia,2,1,1,2
5662,complessi,1,2,0,2
5214,occitano,1,2,0,2
7960,preparata,1,2,0,2
9412,temporaneo,1,2,0,2
9400,derivata,1,2,0,2
16097,groei,0,0,2,2
47265,principais,0,0,2,2
47564,taxa,0,0,2,2
1134,classi,1,2,0,2
1136,turistiche,1,2,0,2
16125,تشمل,0,0,2,2
7995,matematiche,1,2,0,2
16124,இணையத்தளத்தில்,0,0,2,2
49523,finding,0,0,2,2
52242,doğal,0,0,2,2
47274,மகிழ்ச்சியாக,0,0,2,2
7988,beeton,2,1,1,2
49527,slår,0,0,2,2
1146,oscurando,1,2,0,2
48961,alabilir,0,0,2,2
5661,congresso,1,2,0,2
47269,​​je,0,0,2,2
16111,andelen,0,0,2,2
47568,создан,0,0,2,2
16110,mention,0,0,2,2
7977,sospendere,1,2,0,2
1155,giudici,1,2,0,2
44739,أحد,0,0,2,2
16106,valid,0,0,2,2
5222,adeguata,1,2,0,2
9391,computazione,1,2,0,2
1167,corrispondenza,1,2,0,2
9415,philosophyak,2,1,1,2
1200,colonizzato,1,2,0,2
48948,задачах,0,0,2,2
44773,curtos,0,0,2,2
1231,archivio,1,2,0,2
50629,beleefd,0,0,2,2
44766,famous,0,0,2,2
1232,licenziati,1,2,0,2
7928,etimologia,1,2,0,2
48936,request,0,0,2,2
9446,velocipedia,2,1,1,2
9450,lamentarmi,1,2,0,2
16046,фильмов,0,0,2,2
16043,प्रकरणों,0,0,2,2
9451,bilico,1,2,0,2
16041,rompecabezas,0,0,2,2
49547,totalt,0,0,2,2
16040,dû,0,0,2,2
16039,prøv,0,0,2,2
52210,repos »,0,0,2,2
1235,pioniere,1,2,0,2
1236,unita,1,2,0,2
1238,conforme,2,1,1,2
7927,foucault,2,1,1,2
7926,immediate,2,1,1,2
16031,çalışmasını,0,0,2,2
16030,लेते,0,0,2,2
1243,australia,2,1,1,2
9439,osservando,1,2,0,2
11654,политику,0,0,2,2
9420,mainstream,2,1,1,2
9434,interpretabilità,1,2,0,2
50427,συνεχίσετε,0,0,2,2
16078,suivants ,0,0,2,2
9423,rightarrow,2,1,1,2
1205,corpora,2,1,1,2
16077,desarrollado,0,0,2,2
48946,inscrevem,0,0,2,2
5665,reddit,2,1,1,2
47260,fließend,0,0,2,2
16074,ಬ್ಯಾಂಕ್,0,0,2,2
16073,stom,0,0,2,2
12158,σελίδων,0,0,2,2
7942,contrasto,1,2,0,2
52213,άκουγα,0,0,2,2
9436,xvii,1,2,0,2
7941,volontà,1,2,0,2
9437,latini,1,2,0,2
1214,check,2,1,1,2
1216,arrabbiarsi,1,2,0,2
16060,climates,0,0,2,2
16059,vinner,0,0,2,2
1217,antica,1,2,0,2
1219,migrato,1,2,0,2
16057,ancient,0,0,2,2
1226,effettuate,1,2,0,2
12195,intitulé,0,0,2,2
44815,falsely,0,0,2,2
1366,ridistribuirlo,1,2,0,2
12225,changements,0,0,2,2
5694,riunire,1,2,0,2
44873,कुंद,0,0,2,2
5154,cosiddetta,1,2,0,2
1378,distu,2,1,1,2
1433,jacopo,2,1,1,2
11624,सो,0,0,2,2
15869,κορυφή,0,0,2,2
7765,comportamentali,1,2,0,2
48895,veja,0,0,2,2
1379,blois,2,1,1,2
7773,pieno,1,2,0,2
50651,pesado,0,0,2,2
9603,generato,1,2,0,2
1408,optout,2,1,1,2
5692,libreria,1,2,0,2
15849,raízes,0,0,2,2
5690,avvenimenti,1,2,0,2
9577,richiedeva,1,2,0,2
44890,quiere,0,0,2,2
49592,русская,0,0,2,2
15862,പ്രവർത്തിക്കുന്നു,0,0,2,2
44871,كتابة,0,0,2,2
7767,autorevoli,1,2,0,2
15889,interdire,0,0,2,2
9626,automatizzata,1,2,0,2
48859,celleci,0,0,2,2
15890,latinsk,0,0,2,2
15860,dansk,0,0,2,2
15818,protéger,0,0,2,2
9550,britannico,1,2,0,2
44920,capaces,0,0,2,2
44912,αμβλύ,0,0,2,2
1380,installate,1,2,0,2
5698,poesie,1,2,0,2
12207,dissesse,0,0,2,2
50650,आलोचक,0,0,2,2
12221,കേട്ടിട്ടുണ്ട്,0,0,2,2
49587,നാർസിസ്,0,0,2,2
52137,électroniques,0,0,2,2
7797,wikimedia…,2,1,1,2
52159,ಆಶ್ಚರ್ಯಕರವಾಗಿ,0,0,2,2
49594,pasó,0,0,2,2
9564,vaud,2,1,1,2
12217,απόψε,0,0,2,2
44906,звучать,0,0,2,2
15875,matin,0,0,2,2
44907,पत्रिका,0,0,2,2
9566,plagio,1,2,0,2
1448,lucidi,1,2,0,2
52145,varmt,0,0,2,2
7794,sobbalzò,1,2,0,2
48891,للطلاب,0,0,2,2
52133,milliards,0,0,2,2
5160,libresoft,2,1,1,2
49597,स्पेनिश,0,0,2,2
15879,hiring,0,0,2,2
52155,conclusiones,0,0,2,2
9615,superò,1,2,0,2
7807,linus,2,1,1,2
47227,balance,0,0,2,2
5165,abbandono,1,2,0,2
9555,wegener,2,1,1,2
1455,graffiti,2,1,1,2
5148,ˌwɪki,2,1,1,2
44877,டிகிரிக்கு,0,0,2,2
7811,bernard,2,1,1,2
15841,habertürk,0,0,2,2
5696,determinazione,1,2,0,2
15893,klockan,0,0,2,2
52146,связанных,0,0,2,2
1418,avanzate,1,2,0,2
9547,moatti,2,1,1,2
15810,ಪರಿಸ್ಥಿತಿಯಲ್ಲಿ,0,0,2,2
47236,وكيف,0,0,2,2
7786,oscuro,1,2,0,2
7762,infinitamente,2,1,1,2
15850,vermijden,0,0,2,2
15807,सुखद,0,0,2,2
15805,рекламы,0,0,2,2
44926,requer,0,0,2,2
15897,விரும்புகிறீர்களா,0,0,2,2
1421,entrata,1,2,0,2
48876,magisk,0,0,2,2
47223,quantités,0,0,2,2
44866,sebep,0,0,2,2
48873,обеспечения,0,0,2,2
9629,esclusa,2,1,1,2
52172,ordinary,0,0,2,2
9599,medioevo,1,2,0,2
15801,buch,0,0,2,2
7793,microsystems,2,1,1,2
5143,televisione,1,2,0,2
15811,holdout,0,0,2,2
12197,steps,0,0,2,2
1430,mescolati,1,2,0,2
1472,smeraldi,1,2,0,2
44858,देखी,0,0,2,2
44868,يتلقى,0,0,2,2
7787,personaggi,1,2,0,2
1474,vulcanica,1,2,0,2
15854,bromeando,0,0,2,2
7788,flahault,2,1,1,2
11619,ಬಳಸಲು,0,0,2,2
44927,здорово,0,0,2,2
44922,செய்தியை,0,0,2,2
36681,redistribute,0,0,1,1
36820,teneinde,0,0,1,1
36725,sølvbrød,0,0,1,1
36571,ولديك,0,0,1,1
36590,ഉദാഹരണ,0,0,1,1
36691,—u,0,0,1,1
50249,крест,0,0,1,1
36759,amie,0,0,1,1
36591,പ്രവൃത്തി,0,0,1,1
50374,любая,0,0,1,1
36755,ट्रस्ट,0,0,1,1
36572,llevan,0,0,1,1
50300,grundprinciper,0,0,1,1
50438,confidence,0,0,1,1
50375,simplifié,0,0,1,1
36568,നൽകണം,0,0,1,1
36499,поразительная,0,0,1,1
50197,interessant,0,0,1,1
50258,kede,0,0,1,1
36878,toulouse,0,0,1,1
36777,عظيم,0,0,1,1
50436,ಪ್ರಯಾಣಿಸುತ್ತಿದ್ದಾಗ,0,0,1,1
36761,ಯಾವುದರ,0,0,1,1
36532,yatağa,0,0,1,1
50245,industrielles,0,0,1,1
36498,ആക്യുറസി,0,0,1,1
50299,выборкой,0,0,1,1
36824,ಎಲ್ಲಿದೆ,0,0,1,1
50330,contraste,0,0,1,1
50408,fået,0,0,1,1
36573,machistas,0,0,1,1
36531,свете,0,0,1,1
50247,zamanım,0,0,1,1
50414,projetsa,0,0,1,1
36692,microcurrents,0,0,1,1
50388,एनर्जी,0,0,1,1
36617,combinées,0,0,1,1
50277,कृत्रिम,0,0,1,1
50329,വരുത്തുവാൻ,0,0,1,1
36758,designation,0,0,1,1
36781,εκπληρώνουν,0,0,1,1
50320,editarlos,0,0,1,1
50195,massivement,0,0,1,1
36685,ತೀವ್ರ,0,0,1,1
36594,составления,0,0,1,1
36504,delta,0,0,1,1
50386,lowerlevel,0,0,1,1
50246,comprueba,0,0,1,1
36651,taliban,0,0,1,1
50281,которого,0,0,1,1
50319,λόγια,0,0,1,1
36757,"
volapuque",0,0,1,1
50390,للإجابة,0,0,1,1
36566,bogstaveligt,0,0,1,1
36503,parliez,0,0,1,1
50482,சரியா,0,0,1,1
36882,i»,0,0,1,1
36686,отблагодарить,0,0,1,1
36726,rester,0,0,1,1
50259,தன்மையாலும்,0,0,1,1
36592,विशेषताएं,0,0,1,1
36567,экземпляре,0,0,1,1
36879,encantado,0,0,1,1
50481,eventually,0,0,1,1
36880,рейтинге,0,0,1,1
36593,gegeven,0,0,1,1
50409,användarnamn,0,0,1,1
50384,customers,0,0,1,1
50385,வாக்கிய,0,0,1,1
50371,afastandose,0,0,1,1
36756,criarlos,0,0,1,1
50276,زرع,0,0,1,1
36687,drukner,0,0,1,1
36500,региональных,0,0,1,1
36779,conmovido,0,0,1,1
36501,نائمة,0,0,1,1
36780,объяснениях,0,0,1,1
36624,save,0,0,1,1
36683,ഹോം,0,0,1,1
36688,intelectuais,0,0,1,1
36822,suscetível,0,0,1,1
50373,ವಾಸಿಸುತ್ತಿದ್ದಳು,0,0,1,1
36633,« dieu,0,0,1,1
36886,специальных,0,0,1,1
50189,становится,0,0,1,1
36763,похожим,0,0,1,1
36733,هائل,0,0,1,1
50288,sauvage,0,0,1,1
50254,colecciones,0,0,1,1
50459,ontwikkeld,0,0,1,1
50491,binnenstapte,0,0,1,1
36536,oneens,0,0,1,1
36770,hydrology,0,0,1,1
50293,والذكية,0,0,1,1
50490,rodord,0,0,1,1
36672,بصراحة,0,0,1,1
36771,இதிலுள்ள,0,0,1,1
36586,formulerer,0,0,1,1
36485,ίδρυση,0,0,1,1
50428,ταπεινή,0,0,1,1
36772,felen,0,0,1,1
50433,conspirar,0,0,1,1
36667,"
बास्क",0,0,1,1
36666,ortaya,0,0,1,1
36486,overturned,0,0,1,1
36487,flickvän,0,0,1,1
50488,aanrijden,0,0,1,1
36674,sparqlen,0,0,1,1
36488,voit,0,0,1,1
36665,instantáneamente,0,0,1,1
36664,multilinear,0,0,1,1
36814,beklemesini,0,0,1,1
50412,τηρούν,0,0,1,1
36585,ಹೆಂಗಸರ,0,0,1,1
36769,तकनीकी,0,0,1,1
36584,füße,0,0,1,1
36669,donnezlui,0,0,1,1
36732,"
polonêspolaco",0,0,1,1
36731,ഭാവിയിലെ,0,0,1,1
36894,സംസാരിക്കുന്നുണ്ടാകാം,0,0,1,1
36893,tercümelerine,0,0,1,1
36482,dismissed,0,0,1,1
36580,struktur,0,0,1,1
50430,ಏಕೈಕ,0,0,1,1
36765,ചോദ്യമാണ്,0,0,1,1
36668,hemos,0,0,1,1
50431,emphasizing,0,0,1,1
50429,engelsktalande,0,0,1,1
36892,yaklaşan,0,0,1,1
50432,centralized,0,0,1,1
36768,ஏற்படுத்தவில்லை,0,0,1,1
50251,producers,0,0,1,1
50379,agira,0,0,1,1
50291,знаменитой,0,0,1,1
36619,antworten,0,0,1,1
36582,kızdırdım,0,0,1,1
36578,أخبرت,0,0,1,1
36583,forfærdelse,0,0,1,1
50290,неявную,0,0,1,1
36764,resor,0,0,1,1
50192,पत्नी,0,0,1,1
36891,amsterdã,0,0,1,1
50253,eğilimindeyiz,0,0,1,1
50487,resultando,0,0,1,1
36675,acima,0,0,1,1
50298,selamlar,0,0,1,1
50285,οτιδήποτε,0,0,1,1
36659,فارس,0,0,1,1
50455,волнуйся,0,0,1,1
50381,كلية,0,0,1,1
36495,infantil​​,0,0,1,1
50434,أقسام,0,0,1,1
36534,القيمة,0,0,1,1
36576,ಪ್ರಶ್ನೆಗೆ,0,0,1,1
36496,оскорблением,0,0,1,1
36775,இதயத்திற்கு,0,0,1,1
36728,impulsado,0,0,1,1
36575,ಯೋಚಿಸಲು,0,0,1,1
36776,vues,0,0,1,1
50283,methodological,0,0,1,1
50377,encyclopédiet,0,0,1,1
50322,ಬೆಳೆಯುತ್ತಾಳೆ,0,0,1,1
36736,minoritaire,0,0,1,1
50435,landlocked,0,0,1,1
36680,بمجموعة,0,0,1,1
50297,"control ·
sustainability ·
പാഴ്വസ്തു",0,0,1,1
36811,obligada,0,0,1,1
36623,açısından,0,0,1,1
50321,விக்கிமீடியா,0,0,1,1
36656,verkozen,0,0,1,1
50250,συναντάς,0,0,1,1
50282,plattformar,0,0,1,1
36618,увидимся,0,0,1,1
50383,कहेंगे,0,0,1,1
36762,बोरिस,0,0,1,1
36887,vänsterpolitisk,0,0,1,1
36577,отношениях,0,0,1,1
36662,अनुकूल,0,0,1,1
36663,सूप,0,0,1,1
36773,artificiels,0,0,1,1
36676,neutraliteten,0,0,1,1
36491,difamálos,0,0,1,1
36819,enkla,0,0,1,1
50295,blokkeerde,0,0,1,1
36813,சஞ்சிகை,0,0,1,1
50326,haklısın,0,0,1,1
36889,ошибаются,0,0,1,1
50327,υπήρχε,0,0,1,1
36535,genoemde,0,0,1,1
36492,называется,0,0,1,1
36888,inform,0,0,1,1
50323,ψηφιακή,0,0,1,1
50380,rocken,0,0,1,1
36677,पी,0,0,1,1
50413,configurations,0,0,1,1
50255,വാക്യങ്ങൾ,0,0,1,1
50456,telefonsamtal,0,0,1,1
36678,intersektionalitet,0,0,1,1
50257,लक्षित,0,0,1,1
36660,maddesinin,0,0,1,1
50484,esclareceu,0,0,1,1
50378,വിരോധാഭാസം,0,0,1,1
36540,применений,0,0,1,1
36812,усыпана,0,0,1,1
36564,doğrudan,0,0,1,1
36874,tillod,0,0,1,1
36877,ಮುಳುಗಬಹುದು,0,0,1,1
36711,मुहावरा,0,0,1,1
50225,dialectos,0,0,1,1
50241,பெறுகிறேன்,0,0,1,1
36830,ತುದಿ,0,0,1,1
50400,запрашиваемых,0,0,1,1
50360,يكافئ,0,0,1,1
36611,üzereyseniz,0,0,1,1
36551,معلموا,0,0,1,1
50239,pronouncing,0,0,1,1
50359,afirmó,0,0,1,1
36797,അല്ലയോ,0,0,1,1
50422,ditesnous,0,0,1,1
50401,apprécie,0,0,1,1
36710,വന്നിട്ടുണ്ടെന്നും,0,0,1,1
50357,söylediği,0,0,1,1
50308,banklånet,0,0,1,1
50226,récurrentes,0,0,1,1
36559,தாருங்கள்,0,0,1,1
36558,ಕ್ಷಮೆಯನ್ನು,0,0,1,1
50449,أمستردام،,0,0,1,1
36557,dussintal,0,0,1,1
50309,பரபரப்பான,0,0,1,1
36843,പെർഫക്റ്റാവണം,0,0,1,1
50310,skruvat,0,0,1,1
36631,λέγοντας,0,0,1,1
36604,பதவி,0,0,1,1
36636,أندريا,0,0,1,1
50311,ചീത്തയാണോ,0,0,1,1
36831,اسمح,0,0,1,1
36630,kunskaper,0,0,1,1
36629,प्रदान,0,0,1,1
36832,മെയ്,0,0,1,1
36849,கண்,0,0,1,1
50223,basen,0,0,1,1
36639,gecultiveerd,0,0,1,1
36514,verket,0,0,1,1
50307,diariamente,0,0,1,1
50268,metodudur,0,0,1,1
36550,højttaler,0,0,1,1
50267,réflexion,0,0,1,1
36515,قفزت,0,0,1,1
50315,оскорбительное,0,0,1,1
36792,başbakanı,0,0,1,1
36852,счёт,0,0,1,1
50224,kultiverad,0,0,1,1
36850,प्रस्तावना,0,0,1,1
50424,ενότητα,0,0,1,1
36560,النظام،,0,0,1,1
50423,വിലമതിക്കാനാവാത്തത്,0,0,1,1
36516,"
फ़्रान्सीसी",0,0,1,1
50266,പകുതി,0,0,1,1
50471,पांचवीं,0,0,1,1
36517,on—the,0,0,1,1
36847,mükemmele,0,0,1,1
36707,uppträdde,0,0,1,1
50464,garoto,0,0,1,1
36846,आकाश,0,0,1,1
36708,обработки,0,0,1,1
36561,demek,0,0,1,1
36741,حقيقي,0,0,1,1
36518,ഇന്ന്‌,0,0,1,1
36804,بدء,0,0,1,1
50444,المغادرة,0,0,1,1
36748,കാഴ്ച്ചപ്പാട്,0,0,1,1
50348,подарок,0,0,1,1
36745,étonnante,0,0,1,1
50232,தேவையற்ற,0,0,1,1
36839,τρως,0,0,1,1
36522, k,0,0,1,1
50467,händelser,0,0,1,1
50466,எடுக்கப்பட்டது,0,0,1,1
36524,disais,0,0,1,1
36606,geliebt,0,0,1,1
50419,αντανάκλαση,0,0,1,1
36802,ಒಳ್ಳೆಯವನು,0,0,1,1
50402,vandaliserat,0,0,1,1
50234,പറഞ്ഞതായി,0,0,1,1
36835,gepatenteerde,0,0,1,1
50345,actionnaire,0,0,1,1
36521,sebebiyet,0,0,1,1
36553,archief,0,0,1,1
36803,проходит,0,0,1,1
50237,эксперимента,0,0,1,1
36609,lesma,0,0,1,1
50465,തുടങ്ങിയിട്ടില്ല,0,0,1,1
36607,nua,0,0,1,1
50344,ought,0,0,1,1
36608,ಸೋಲಿಸುತ್ತಾನೆ,0,0,1,1
50235,पानी,0,0,1,1
50418,ഉപയോഗിക്കും,0,0,1,1
50340,उत्कृष्टविरोधी,0,0,1,1
36744,utilizó,0,0,1,1
36719,politikasıdır,0,0,1,1
36746,duymak,0,0,1,1
36801,protista,0,0,1,1
36798,topical,0,0,1,1
36714,لتتعلم,0,0,1,1
36713,economie,0,0,1,1
50420,iyiyim,0,0,1,1
50265,لغتا,0,0,1,1
36610,favorisant,0,0,1,1
50354,filtrados,0,0,1,1
36842,منخفضة,0,0,1,1
36519,angebot,0,0,1,1
36552,tornadoes,0,0,1,1
36635,знай,0,0,1,1
50353,  €,0,0,1,1
50446,iğrençtir,0,0,1,1
36520,lättåtkomliga,0,0,1,1
50230,genstand,0,0,1,1
36715,natt,0,0,1,1
50339,भूलें,0,0,1,1
50337,कमयूनिटीस,0,0,1,1
36799,schwierigkeiten,0,0,1,1
50338,कैचिंग,0,0,1,1
50264,ग्रह,0,0,1,1
50417,savait,0,0,1,1
50352,ஓட்டங்கள்,0,0,1,1
36526,مصدري,0,0,1,1
50231,χαρούμε,0,0,1,1
50349,gutaussehender,0,0,1,1
50314,alamazsınız,0,0,1,1
36800,stavet,0,0,1,1
50238,jackson,0,0,1,1
36840,funktionen,0,0,1,1
36612,അതിശയകരമായത്,0,0,1,1
50399,شاهدها,0,0,1,1
50199,« passage,0,0,1,1
50273,авторы,0,0,1,1
50393,blacklist,0,0,1,1
36509,ஆடை,0,0,1,1
36870,mediafiler,0,0,1,1
50204,filtre,0,0,1,1
50317,sesin,0,0,1,1
36647,τέρρι,0,0,1,1
36646,ودعوا,0,0,1,1
36596,shells,0,0,1,1
50205,ಎಲ್ಲರೂ,0,0,1,1
36869,المشكلة,0,0,1,1
50331,ചോദിക്കുമ്പോൾ,0,0,1,1
50368,redistributions,0,0,1,1
50367,maximum,0,0,1,1
36597,astonishing,0,0,1,1
36530,desperté,0,0,1,1
50397,تذكره,0,0,1,1
50272,vannevar,0,0,1,1
36828,sixième,0,0,1,1
50206,восхищенные,0,0,1,1
50207,مقصود,0,0,1,1
36866,bulunma,0,0,1,1
50366,للقوات,0,0,1,1
36787,aangezien,0,0,1,1
50316,أنهم,0,0,1,1
36529,δυστυχισμένο,0,0,1,1
50271,drôle,0,0,1,1
36865,விரும்புகின்றனர்,0,0,1,1
50244,रही।,0,0,1,1
50440,consisting,0,0,1,1
36543,privilegiadas,0,0,1,1
36788,heartbroken,0,0,1,1
36507,இருவர்,0,0,1,1
36541,ಸೆಕೆಂಡಿಗೆ,0,0,1,1
50200,ort,0,0,1,1
50201,wiknic,0,0,1,1
36826,visait,0,0,1,1
50369,iyisi,0,0,1,1
36616,respondeu,0,0,1,1
36754,fremstille,0,0,1,1
36505,kollaborativa,0,0,1,1
36506,സന്നദ്ധസമൂഹം,0,0,1,1
36724,миру,0,0,1,1
36694,advances,0,0,1,1
36615,conflitantes,0,0,1,1
36875,அன்பான,0,0,1,1
50203,verdringen,0,0,1,1
36871,собираюсь,0,0,1,1
50407,подбодрить,0,0,1,1
36827,exemples ,0,0,1,1
36626,പൊതുജനങ്ങൾക്കെല്ലാം,0,0,1,1
50313,യന്ത്രപഠനത്തെ,0,0,1,1
36695,amusing,0,0,1,1
36508,الحيوية,0,0,1,1
50301,reden,0,0,1,1
36649,dropped,0,0,1,1
50406,கொடுத்த,0,0,1,1
36873,permettrait,0,0,1,1
36752,udgaven,0,0,1,1
36696,экономически,0,0,1,1
36872,adicionados,0,0,1,1
50441,roden,0,0,1,1
50304,χρονικό,0,0,1,1
50398,boğuşuyorum,0,0,1,1
36806,wiederholt,0,0,1,1
50474,hu •,0,0,1,1
36643,онлайнсотрудничества,0,0,1,1
36858,irão,0,0,1,1
50452,gelin,0,0,1,1
50462,серьёзных,0,0,1,1
36790,chegarem,0,0,1,1
36527,incluía,0,0,1,1
36599,frontières,0,0,1,1
36600,مرتبات،,0,0,1,1
36642,öğrencilerin,0,0,1,1
50416,ಪಾಸ್‌ವರ್ಡ್,0,0,1,1
36601,l’invention,0,0,1,1
50472,இதுபோன்ற,0,0,1,1
50219,مقالاته,0,0,1,1
50475,"
cebuano",0,0,1,1
36856,بطء,0,0,1,1
50252,والجدير,0,0,1,1
36855,εκτυπωθεί,0,0,1,1
50269,vidunderligt,0,0,1,1
36854,spelkonsoler,0,0,1,1
50463,गूंगा,0,0,1,1
36705,ഒബാമ,0,0,1,1
36641,troops,0,0,1,1
50220,ಬಂತು,0,0,1,1
36640,extraordinaire,0,0,1,1
36706,разработанный,0,0,1,1
50306,قواعده,0,0,1,1
36853,gråt,0,0,1,1
50363,eigenaar,0,0,1,1
36547,الخادمات,0,0,1,1
36545,விருப்பமான,0,0,1,1
36750,விற்றதை,0,0,1,1
50365,raul,0,0,1,1
36738,ಬೇಡವೆಂದು,0,0,1,1
36864,பெறப்பட்டது,0,0,1,1
36700,सलेक्शन,0,0,1,1
50333,d’intuition,0,0,1,1
36598,علاجاته,0,0,1,1
36863,مسؤولين,0,0,1,1
50210,wollte,0,0,1,1
50334,المرآة,0,0,1,1
36701,धीरे,0,0,1,1
50480,للقواعد,0,0,1,1
36546,aimais,0,0,1,1
50212,കുറിക്കാൻ,0,0,1,1
36749,είπα,0,0,1,1
50476,ζωντανό,0,0,1,1
36807,personligt,0,0,1,1
36510,ешь,0,0,1,1
36861,глагольная,0,0,1,1
50478,contribuant,0,0,1,1
36702,leider,0,0,1,1
36703,لكم,0,0,1,1
50477,ലഭിച്ചോ,0,0,1,1
50364,wapediamobi,0,0,1,1
50443,дочери,0,0,1,1
36644,walls,0,0,1,1
36511,utförs,0,0,1,1
50305,herhaalt,0,0,1,1
36859,"में।
इसके",0,0,1,1
50190,peːdɪa,0,0,1,1
44069,conexiones,0,0,1,1
50188,hatalı,0,0,1,1
37698,स्पॉट,0,0,1,1
37705,பயனற்றது,0,0,1,1
37704,bureaucratic,0,0,1,1
49613,üzerime,0,0,1,1
49614,vendo,0,0,1,1
37703,கணிப்பதில்,0,0,1,1
37702,независимости»,0,0,1,1
37701,உருவாக்கினர்,0,0,1,1
49615,أيًا,0,0,1,1
49617,പഠനത്തിന്,0,0,1,1
37689,garantizan,0,0,1,1
37697,изменчивое,0,0,1,1
37696,करोड़,0,0,1,1
37695,amazed,0,0,1,1
37694,பெயர்கள்,0,0,1,1
37693,उदघाटन,0,0,1,1
37692,एली,0,0,1,1
37691,étendra,0,0,1,1
37690,рекорд,0,0,1,1
37706,végétaux,0,0,1,1
49611,കാര്യം,0,0,1,1
49610,التراكمية,0,0,1,1
49609,disseminálo,0,0,1,1
49601,ಆಶ್ಚರ್ಯಚಕಿತರಾಗಲು,0,0,1,1
37728,للذهاب,0,0,1,1
37726,continuaba,0,0,1,1
37725,nooit,0,0,1,1
37723,aurez,0,0,1,1
37722,serez,0,0,1,1
49603,amateurastronoom,0,0,1,1
37720,നേടിയെടുക്കാവുന്നതേയുള്ളൂ,0,0,1,1
49604,house,0,0,1,1
37718,glockensymbol,0,0,1,1
37717,chato,0,0,1,1
37716,നുറുങ്ങ്,0,0,1,1
49605,absurdos,0,0,1,1
49607,τελειώσω,0,0,1,1
49608,फ्रांसिस्को,0,0,1,1
37712,ದ,0,0,1,1
37711,διαβάζω,0,0,1,1
49620,neuen,0,0,1,1
37688,சந்தித்ததில்,0,0,1,1
37730,étrangère,0,0,1,1
37658,ಪೋರ್ಟಲ್ಗೆ,0,0,1,1
49641,έκδοση,0,0,1,1
49642,developing,0,0,1,1
49643,opsummeringer,0,0,1,1
49644,ನಕಲಿ,0,0,1,1
37661,монографиями,0,0,1,1
49645,erstaunt,0,0,1,1
49647,പെരുമാറ്റവും,0,0,1,1
37659,любимым,0,0,1,1
37657,godkänt,0,0,1,1
49622,жарко,0,0,1,1
37656,actuación,0,0,1,1
49649,അൽഗോരിതം,0,0,1,1
37654,latinos,0,0,1,1
49651,glücklich,0,0,1,1
49652,åtgärder,0,0,1,1
37652,behandles,0,0,1,1
37651,accélérer,0,0,1,1
37650,autoproduction,0,0,1,1
37665,fry,0,0,1,1
37667,defendido,0,0,1,1
37668,élément,0,0,1,1
37669,perdiendo,0,0,1,1
49623,reisen,0,0,1,1
49624,reconnaissant,0,0,1,1
37686,kodning,0,0,1,1
37685,കൂടിയ,0,0,1,1
49628,ಕೃತ್ಯವನ್ನು,0,0,1,1
37683,ursprünge,0,0,1,1
49630,modificaron,0,0,1,1
37681,രാത്രിയിൽ,0,0,1,1
37680,facia,0,0,1,1
49633,précision,0,0,1,1
49636,марта,0,0,1,1
37678,knol —,0,0,1,1
37676,تتحرك,0,0,1,1
49638,poderes,0,0,1,1
37674,extinción,0,0,1,1
37673,ونحتاج,0,0,1,1
37670,"law ·
ഭൗതികശാസ്ത്രം ·
pollution",0,0,1,1
37729,dejaste,0,0,1,1
49600,αριθμού,0,0,1,1
49654,botanists,0,0,1,1
49571,وكلمات,0,0,1,1
49565,frecuencia,0,0,1,1
49566,науке,0,0,1,1
37783,पड़ा,0,0,1,1
37782,கொள்வாள்,0,0,1,1
49567,désacralisé,0,0,1,1
49568,sûrement,0,0,1,1
49570,المطولة,0,0,1,1
37779,wereldoorlog,0,0,1,1
37777,win,0,0,1,1
49577,ಪುನರಾರಂಭಿಸಿ,0,0,1,1
37776,ωστόσο,0,0,1,1
49573,уроке,0,0,1,1
37775,palast,0,0,1,1
37774,ಐಸ್,0,0,1,1
49574,അപ്രാപ്യമല്ല,0,0,1,1
37773,reads,0,0,1,1
37772,रोजेनजवीग,0,0,1,1
49576,ecologically,0,0,1,1
49564,marxiste,0,0,1,1
49562,belonged,0,0,1,1
37789,باستنتاج,0,0,1,1
37791,dépendent,0,0,1,1
49542,signifier,0,0,1,1
49543,desarrollados,0,0,1,1
49545,runoff,0,0,1,1
37803,parlant,0,0,1,1
49546,performances,0,0,1,1
49549,लव,0,0,1,1
49550,uzbekistan,0,0,1,1
49552,الستينيات,0,0,1,1
37801,जोड़ेंविकिपीडिया,0,0,1,1
37800,scholarly,0,0,1,1
49553,πρώτη,0,0,1,1
37799,ചിന്തിക്കുക,0,0,1,1
49554,وتعددت,0,0,1,1
37796,അത്‌,0,0,1,1
49556,saudações,0,0,1,1
37794,agricoles,0,0,1,1
49560,одежды,0,0,1,1
37770,डीलीट,0,0,1,1
37769,aceito,0,0,1,1
37731,ಎಲ್ಲವನ್ನೂ,0,0,1,1
37738,أنتما,0,0,1,1
37746,ಫಿಕ್ಸ್‌ನಲ್ಲಿ,0,0,1,1
37745,förstöra,0,0,1,1
37744,oluşturacak,0,0,1,1
37742,الالتزام,0,0,1,1
49588,repetiam,0,0,1,1
49590,हवाई,0,0,1,1
49591,originalartiklar,0,0,1,1
37739,разговор,0,0,1,1
49593,gemensamt,0,0,1,1
37768,desejar,0,0,1,1
37736,العربية,0,0,1,1
37735,kleidungssinn,0,0,1,1
49595,kafasını,0,0,1,1
49596,hitting,0,0,1,1
37734,मिलते,0,0,1,1
37733,"
वे",0,0,1,1
49598,متحيزة،,0,0,1,1
49599,ب,0,0,1,1
37747,onmiddellijk,0,0,1,1
37750,обращают,0,0,1,1
49585,प्रेरणा,0,0,1,1
49584,أمريكا,0,0,1,1
37767,twice,0,0,1,1
37766,പാഴ്‌മെയിലുകളെയും,0,0,1,1
37764,приготовилась,0,0,1,1
49578,φωνής,0,0,1,1
37762,eğitim,0,0,1,1
37761,ties,0,0,1,1
37760,désaccord,0,0,1,1
37759,хотела,0,0,1,1
49580,एसोसिएशन,0,0,1,1
37758,έναρξη,0,0,1,1
37757,разнообразию,0,0,1,1
49581,गले,0,0,1,1
37755,ಒಳಗೊಂಡಂತೆ,0,0,1,1
37753,exigindo,0,0,1,1
49582,articlep,0,0,1,1
37752,കാണുന്നില്ലെന്ന്‌,0,0,1,1
49583,കണ്ടെത്തൽ,0,0,1,1
49653,heavily,0,0,1,1
37648,construire,0,0,1,1
50187,connaissant,0,0,1,1
49729,விதிமுறைகள்,0,0,1,1
37545,கவனிப்பதில்லை,0,0,1,1
37544,skribenterna,0,0,1,1
37543,bazılarının,0,0,1,1
49726,सक्षम,0,0,1,1
37542,значительное,0,0,1,1
49727,erfahren,0,0,1,1
49728,аароном,0,0,1,1
37538,читаю,0,0,1,1
37537,നൽകുന്നുണ്ട്‌,0,0,1,1
49733,പങ്കെടുക്കുമ്പോൾ,0,0,1,1
37536,yemeğinde,0,0,1,1
37535,حزينة,0,0,1,1
49731,boisson,0,0,1,1
37534,பிரிட்டானிக்கா,0,0,1,1
37533,ಪ್ರಿಯತಮೆಯು,0,0,1,1
37532,kesmek,0,0,1,1
49732,lance,0,0,1,1
37531,beğen,0,0,1,1
49722,berømte,0,0,1,1
37546,ತೊಂದರೆಯಿಲ್ಲದ,0,0,1,1
49721,pests,0,0,1,1
37547,المجهولين,0,0,1,1
49709,ज्यामिति,0,0,1,1
37563,tapiz,0,0,1,1
37562,beteckna,0,0,1,1
49710,sitez,0,0,1,1
49711,imite,0,0,1,1
37561,ders,0,0,1,1
49712,എപ്പോൾ,0,0,1,1
37556,வழக்கத்தை,0,0,1,1
37555,wortnummer,0,0,1,1
37554,βιασμού,0,0,1,1
37553,divulgación,0,0,1,1
49716,σοβαρά,0,0,1,1
49717,stan,0,0,1,1
49718,criálos,0,0,1,1
37551,især,0,0,1,1
37549,registados,0,0,1,1
37548,feasible,0,0,1,1
37530,publicerats,0,0,1,1
49734,വലുതാണെന്ന്,0,0,1,1
37564,ವಾರಗಳು,0,0,1,1
37503,positionnement,0,0,1,1
37508,вандализирована,0,0,1,1
49751,ebartikel,0,0,1,1
49752,excited,0,0,1,1
37506,"
याकूत",0,0,1,1
49753,resimler,0,0,1,1
37505,simulan,0,0,1,1
49754,ترغب,0,0,1,1
37504,listed,0,0,1,1
49755,kalbe,0,0,1,1
49735,usædvanligt,0,0,1,1
49756,pourvus,0,0,1,1
37502,conflicto,0,0,1,1
37499,entschuldige,0,0,1,1
37498,الحكم,0,0,1,1
49759,madrid​,0,0,1,1
49760,wikiversidade,0,0,1,1
37497,കാര്യ,0,0,1,1
49761,bidragen,0,0,1,1
37509,falsa—,0,0,1,1
37510,schnellen,0,0,1,1
49748,fremstilles,0,0,1,1
37511,halve,0,0,1,1
37525,വിരലുകളിൽ,0,0,1,1
37524,चली,0,0,1,1
49736,gitmeme,0,0,1,1
37523,mapping,0,0,1,1
49738,സംസാരിക്കുന്നു,0,0,1,1
49739,croissant,0,0,1,1
49740,σταμάτησε,0,0,1,1
49741,compromis,0,0,1,1
49742,biliyorsanız,0,0,1,1
37518,കണ്ടുമുട്ടുന്നു,0,0,1,1
37517,மனைவியாக,0,0,1,1
49743,hielt,0,0,1,1
37516,enslashdot,0,0,1,1
49744,بحذف,0,0,1,1
49745,révisions,0,0,1,1
49747,« actif »,0,0,1,1
37512,नॉनफिक्शन,0,0,1,1
49708,निमंत्रण,0,0,1,1
37565,exposiciones,0,0,1,1
37647,लिखती,0,0,1,1
49678,മുന്നോട്ടുപോയില്ല,0,0,1,1
37625,ಒಪ್ಪಲು,0,0,1,1
37624,administração,0,0,1,1
37623,மறுத்துரைத்த,0,0,1,1
37622,ಆವಿಷ್ಕಾರ,0,0,1,1
37621,acheté,0,0,1,1
49672,högtalarikon,0,0,1,1
37618,salvo,0,0,1,1
49674,respecta,0,0,1,1
37616,مجلس,0,0,1,1
49686,fomentado,0,0,1,1
37615,« tapez,0,0,1,1
49680,качаетесь,0,0,1,1
37614,കൃത്യതയും,0,0,1,1
49681,делают,0,0,1,1
37612,meant,0,0,1,1
37611,τύχη,0,0,1,1
49683,modtager,0,0,1,1
37609,നിങ്ങൾക്കത്,0,0,1,1
37627,cancerous,0,0,1,1
49667,alayım,0,0,1,1
37629,végétales,0,0,1,1
37630,सुस्निंगनु,0,0,1,1
37645,presos,0,0,1,1
37642,हैकृपया,0,0,1,1
37641,sidetoside,0,0,1,1
37640,முகத்தில்,0,0,1,1
37639,تعافى,0,0,1,1
37637,ударилась,0,0,1,1
49657,stödja,0,0,1,1
49660,ذكر,0,0,1,1
49661,live,0,0,1,1
49662,ederek,0,0,1,1
49663,webpagina,0,0,1,1
49664,wars,0,0,1,1
37635,человечества,0,0,1,1
37634,inspiration,0,0,1,1
37633,heterogen,0,0,1,1
49665,അവലംബം,0,0,1,1
37631,ρωτήσω,0,0,1,1
49684,الحلزون,0,0,1,1
37608,validated,0,0,1,1
37566,transition,0,0,1,1
37570,птицы,0,0,1,1
49697,fragmented,0,0,1,1
37578,humorísticas,0,0,1,1
37577,häufiges,0,0,1,1
37576,araştırmayı,0,0,1,1
49698,hollanda,0,0,1,1
37573,واجه,0,0,1,1
49699,बधाई,0,0,1,1
37571,انظرويكيبيدياترجمة,0,0,1,1
49700,സൂര്യനിൽ,0,0,1,1
37606,şaşkınlık,0,0,1,1
49702,государственную,0,0,1,1
37569,فازت,0,0,1,1
37568,genoptage,0,0,1,1
49704,കഠിനമായ,0,0,1,1
37567,रिपोजिटरी,0,0,1,1
49705,மறைக்க,0,0,1,1
49706,texas,0,0,1,1
49707,частичная,0,0,1,1
37581,நடுநிலைமை,0,0,1,1
37582,davada,0,0,1,1
37583,суток,0,0,1,1
37585,yı,0,0,1,1
49687,« meilleures,0,0,1,1
37604,cultivée,0,0,1,1
37602,डूबना,0,0,1,1
37600,financieele,0,0,1,1
49689,поездку,0,0,1,1
37599,meewerken,0,0,1,1
37598,ആയിരക്കണക്കിനു,0,0,1,1
37597,faitesmoi,0,0,1,1
37596,vervangen,0,0,1,1
37595,sinken,0,0,1,1
49690,grubudur,0,0,1,1
49691,karısı,0,0,1,1
37592,التعليمات,0,0,1,1
37590,معقولة,0,0,1,1
37589,aprende,0,0,1,1
49693,கவலைப்பட்டார்,0,0,1,1
37586,  voitures,0,0,1,1
49541,lithify,0,0,1,1
49540,oturup,0,0,1,1
37808,handwritten,0,0,1,1
49381,ämnesområden,0,0,1,1
38038,പ്രകാരം,0,0,1,1
38037,parodique,0,0,1,1
38036,enfiar,0,0,1,1
49377,ουσιαστικό,0,0,1,1
49378,görüşmesinde,0,0,1,1
49379,arises,0,0,1,1
49380,parcs,0,0,1,1
38034,ನನಸಾದರೆ,0,0,1,1
49382,दुर्भाग्य,0,0,1,1
49391,multidimensional,0,0,1,1
38033,geoinformation,0,0,1,1
38032,december update,0,0,1,1
49385,kırmızı,0,0,1,1
38027,adorable,0,0,1,1
38026,എനർജി,0,0,1,1
38025,ммм,0,0,1,1
38024,affedersiniz,0,0,1,1
38023,destansı,0,0,1,1
49374,ಡಾಲರ್,0,0,1,1
49370,تصويره,0,0,1,1
49368,paz,0,0,1,1
38043,διότι,0,0,1,1
49359,സംഭാഷണത്തിൽ‌,0,0,1,1
38054,bibliograaf,0,0,1,1
49360,estrategia,0,0,1,1
38053,turkiets,0,0,1,1
38052,digitala,0,0,1,1
49362,إلكترونية,0,0,1,1
38051,ಪಡೆದುಕೊಂಡೆ,0,0,1,1
38049,പറയുമ്പോൾ,0,0,1,1
38048,αγαπημένο,0,0,1,1
49363,koning,0,0,1,1
38047,зачем,0,0,1,1
38046,películas,0,0,1,1
49365,жёстки,0,0,1,1
38045,கடவுச்சொல்லை,0,0,1,1
49366,coutumes,0,0,1,1
49367,sket,0,0,1,1
38044,используя,0,0,1,1
49390,لأمها,0,0,1,1
38019,традиционным,0,0,1,1
38056,profundo,0,0,1,1
37993,நம்பமுடியாத,0,0,1,1
49410,secretively,0,0,1,1
49411,inédites,0,0,1,1
38000,​​dem,0,0,1,1
49412,हिन्दी,0,0,1,1
49413,случаются,0,0,1,1
37998,происхождение,0,0,1,1
37997,ratios,0,0,1,1
37994,mencione,0,0,1,1
49415,απολυτο,0,0,1,1
38018,развивается,0,0,1,1
49416,βιβλιογραφία,0,0,1,1
37990,søster,0,0,1,1
49417,σπόρους,0,0,1,1
37988,நிறுத்த,0,0,1,1
49419,معضلة,0,0,1,1
37986,ശാസ്ത്രജ്ഞന്മാർ,0,0,1,1
49420,स्वाहा,0,0,1,1
49422,forcément,0,0,1,1
49408,ascendieron,0,0,1,1
49407,handhållna,0,0,1,1
49406,ومؤسس,0,0,1,1
38004,d’être,0,0,1,1
38017,irlandais,0,0,1,1
49394,معا,0,0,1,1
49396,desværre,0,0,1,1
38014,amerikalıların,0,0,1,1
49397,messages,0,0,1,1
49398,تبكي,0,0,1,1
38013,spännande,0,0,1,1
49399,bekämpar,0,0,1,1
38012,áustria,0,0,1,1
38011,uttal vɪkɪ,0,0,1,1
49400,uğrayan,0,0,1,1
49402,attrapé,0,0,1,1
38010,பழக்கவழக்கங்களால்,0,0,1,1
49403,മേഖലയെ,0,0,1,1
38008,soruyorsun,0,0,1,1
38007,άγγελος,0,0,1,1
38006,പോവുന്നത്,0,0,1,1
49358,anticonsensus,0,0,1,1
38057,brandit,0,0,1,1
49537,مشروعا,0,0,1,1
38101,вырастет,0,0,1,1
38108,girilerek,0,0,1,1
38107,sudcoréen,0,0,1,1
38106,vision‏,0,0,1,1
38105,هاواي,0,0,1,1
38104,терпеливо,0,0,1,1
49303,ಸರಿಯಾಗಿದ್ದೇನೆ,0,0,1,1
38103,préconisent,0,0,1,1
38102,compromise,0,0,1,1
49306,محتوياتها؛,0,0,1,1
49316,kararı,0,0,1,1
38100,aardappelen,0,0,1,1
38098,सुसाइड,0,0,1,1
49309,yanındaki,0,0,1,1
49311,ആശയക്കുഴപ്പത്തിലാകുന്നത്,0,0,1,1
49312,പുറത്തുള്ള,0,0,1,1
38095,സമർപ്പിക്കുക,0,0,1,1
38093,मीठी,0,0,1,1
38092,yavaştır,0,0,1,1
38110,atmosphere—within,0,0,1,1
38111,أعطيك,0,0,1,1
49302,« wiki »,0,0,1,1
49301,séparable,0,0,1,1
49288,inferences,0,0,1,1
38128,mueve,0,0,1,1
49289,പാട്ടുകളിൽ,0,0,1,1
38125,ورمز,0,0,1,1
38123,noncommercial,0,0,1,1
38122,capté,0,0,1,1
38121,implicaba,0,0,1,1
38119,distinctif,0,0,1,1
49293,providence,0,0,1,1
49294,elogios,0,0,1,1
49295,étend,0,0,1,1
38117,percept,0,0,1,1
38116,lourde,0,0,1,1
49297,تحديدًا,0,0,1,1
38114,unie,0,0,1,1
49299,ആരുണ്ടാക്കി,0,0,1,1
49300,खरीदूंगा,0,0,1,1
38091,ಬೆಲ್,0,0,1,1
38090,actuaciones,0,0,1,1
49356,матч,0,0,1,1
49344,hayali,0,0,1,1
49338,arquitetura,0,0,1,1
38071,redirecionar,0,0,1,1
38070,البحث,0,0,1,1
49339,publicitaires,0,0,1,1
49341,பெயரும்,0,0,1,1
38068,"
piemontês",0,0,1,1
38066,തണുത്തത്,0,0,1,1
49343,улыбаясь,0,0,1,1
49346,точку,0,0,1,1
38089,जड़ें,0,0,1,1
49347,figurant,0,0,1,1
49349,فكلمة,0,0,1,1
49350,dilden,0,0,1,1
49351,buluşmayı,0,0,1,1
38063,spacecraft,0,0,1,1
38062,citado,0,0,1,1
38060,வருகிறார்கள்,0,0,1,1
49355,hierarkisk,0,0,1,1
49335,éclairer,0,0,1,1
49334,rette,0,0,1,1
38074,വാക്യ,0,0,1,1
38075,implementatie,0,0,1,1
38088,demographic,0,0,1,1
49317,soruda,0,0,1,1
49324,സമ്പ്രദായത്തെ,0,0,1,1
49325,deceased,0,0,1,1
49326,कॉपीलेफ्ट,0,0,1,1
49327,citerad,0,0,1,1
49328,soucies,0,0,1,1
38084,الكريهة,0,0,1,1
38083,envoyezvous,0,0,1,1
38082,официально,0,0,1,1
49329,derniers,0,0,1,1
49330,faisons,0,0,1,1
38079,മനുഷ്യർക്കിടയിൽ,0,0,1,1
38078,ಉಲ್ಲೇಖಿಸಬೇಡಿ,0,0,1,1
38077,عاشت,0,0,1,1
49332,skewed,0,0,1,1
49333,путешествий,0,0,1,1
49423,refleksion,0,0,1,1
37984,confundem,0,0,1,1
37983,ownership,0,0,1,1
37870,​​அவர்,0,0,1,1
49489,disseminação,0,0,1,1
37879,patient,0,0,1,1
37878,يقوله,0,0,1,1
49490,услышите,0,0,1,1
37876,स्लेशडॉट,0,0,1,1
37873,ಜೋಚ್,0,0,1,1
49493,forskares,0,0,1,1
37871,s’accroissait,0,0,1,1
37869,brødbrød,0,0,1,1
49509,வாழ்க்கையிலும்,0,0,1,1
49498,structurantes,0,0,1,1
49499,حاليًا,0,0,1,1
37866,пойду,0,0,1,1
49501,أعارض,0,0,1,1
49502,l’entrainement,0,0,1,1
49503,enfants,0,0,1,1
37862,minimizing,0,0,1,1
37861,пальчиках,0,0,1,1
37880,என்பதற்குப்,0,0,1,1
37881,என்னுடன்,0,0,1,1
37883,muñeca,0,0,1,1
37884,londonien,0,0,1,1
49475,βικιταξίδια,0,0,1,1
37900,brugt,0,0,1,1
49477,finlandés,0,0,1,1
49478,aynada,0,0,1,1
49479,referenciadas,0,0,1,1
37895,nachdem,0,0,1,1
49482,agraciada,0,0,1,1
49483,maskiner,0,0,1,1
49485,aquifers,0,0,1,1
37891,делаю,0,0,1,1
37890,dermed,0,0,1,1
49486,évolutions,0,0,1,1
37888,внесением,0,0,1,1
49488,தொடங்க,0,0,1,1
37887,kontakten,0,0,1,1
37886,grootst,0,0,1,1
37885,palacio,0,0,1,1
37860,बोलने,0,0,1,1
37858,ಮೀರಿ,0,0,1,1
49424,получив,0,0,1,1
49529,எடுத்துக்காட்டாக,0,0,1,1
37830,தரக்கணிப்பீட்டு,0,0,1,1
49524,publicering,0,0,1,1
49526,fortsetzt,0,0,1,1
37828,ανακάλυψη,0,0,1,1
37826,ವಾಟ್ಸಾಪ್,0,0,1,1
37825,ثقيلة,0,0,1,1
37824,halftruth,0,0,1,1
49528,المتبقي,0,0,1,1
49531,vies,0,0,1,1
37857,whereby,0,0,1,1
37820,пределах,0,0,1,1
49533,«писатьправить,0,0,1,1
37818,sözcüğünden,0,0,1,1
37817,telefones,0,0,1,1
49534,വിദഗ്ദ്ധനുമായ,0,0,1,1
37815,atteignait,0,0,1,1
49536,подождать,0,0,1,1
37811,φίλη,0,0,1,1
49521,campaign,0,0,1,1
37834,privilegier,0,0,1,1
37835,الصعب,0,0,1,1
37836,fidedignas,0,0,1,1
37855,любого,0,0,1,1
49510,महिलाओं,0,0,1,1
37854,μεμονωμένο,0,0,1,1
37853,நர்சிஸாவைப்,0,0,1,1
37852,venez,0,0,1,1
49512,தண்ணீர்,0,0,1,1
37850,elimination,0,0,1,1
37848,grafemas,0,0,1,1
37847,ovenfra,0,0,1,1
49513,ускоряющийся,0,0,1,1
37843,dn,0,0,1,1
37841,ഏതു,0,0,1,1
49516,വശങ്ങളും,0,0,1,1
49517,வேளையில்,0,0,1,1
49518,വിക്കിപീഡിയകളായ,0,0,1,1
49519,ernaast,0,0,1,1
37837,அச்சுறுத்தல்,0,0,1,1
37901,истинность»,0,0,1,1
37902,സ്വരം,0,0,1,1
49474,fotoğrafları,0,0,1,1
37950,അവസാനം,0,0,1,1
37960,فحسب،,0,0,1,1
37959,etsem,0,0,1,1
37958,darunter,0,0,1,1
49442,بالعلوم,0,0,1,1
37957,чьи,0,0,1,1
49443,அறிவித்தார்,0,0,1,1
49444,ശ്രമിക്കുക,0,0,1,1
37951,yttrande,0,0,1,1
49446,değişik,0,0,1,1
37904,καταλάβω,0,0,1,1
37948,вебсерверов,0,0,1,1
37946,событиях,0,0,1,1
37945,pointed,0,0,1,1
37944,condemns,0,0,1,1
37943,hälsningar,0,0,1,1
37942,replicadas,0,0,1,1
37941,ويكي،,0,0,1,1
37940,തണുപ്പാണ്,0,0,1,1
49441,verlasse,0,0,1,1
37962,क्षति,0,0,1,1
49440,γωνία—αυτή,0,0,1,1
37964,தொகுக்கப்படக்,0,0,1,1
37982,gezicht,0,0,1,1
49425,ньюйорке,0,0,1,1
49426,oneerlijke,0,0,1,1
37979,viagens,0,0,1,1
37976,வலியுறுத்துவது,0,0,1,1
49431,confirmó,0,0,1,1
49432,eras,0,0,1,1
37974,fornærmelse,0,0,1,1
49433,ومرحبا,0,0,1,1
37972,сходных,0,0,1,1
49435,اقترح,0,0,1,1
37969,приходят,0,0,1,1
49436,materiales,0,0,1,1
49437,"
tailandês",0,0,1,1
37968,செல்வம்,0,0,1,1
49439,« dépourvus,0,0,1,1
37965,aquel,0,0,1,1
49447,filtres,0,0,1,1
37936,différences,0,0,1,1
37934,വെയർ,0,0,1,1
49465,anlayabilirsiniz,0,0,1,1
37918,anpassa,0,0,1,1
37917,polite,0,0,1,1
49466,anlayamadım,0,0,1,1
49467,മില്ല്യൺ,0,0,1,1
49468,kunstmatige,0,0,1,1
37914,الممارسة,0,0,1,1
37913,qu’elle,0,0,1,1
49469,estimado,0,0,1,1
37912,fangst,0,0,1,1
37911,пародируются,0,0,1,1
37910,plays,0,0,1,1
49470,fourthhighest,0,0,1,1
37909,удаление,0,0,1,1
37908,informó,0,0,1,1
37906,giydiğim,0,0,1,1
49473,kilometers,0,0,1,1
37905,concentrée,0,0,1,1
37919,قارات,0,0,1,1
37920,منظر,0,0,1,1
49449,magasin,0,0,1,1
49464,thriller,0,0,1,1
37933,تجميعها,0,0,1,1
37932,outnyttjade,0,0,1,1
49451,tweede,0,0,1,1
37930,offentlighed,0,0,1,1
49452,милой,0,0,1,1
49453,encontrará,0,0,1,1
49454,erziehen,0,0,1,1
49455,olhando,0,0,1,1
37928,نظرك,0,0,1,1
49458,máquina,0,0,1,1
37927,acusado,0,0,1,1
49459,تقوم,0,0,1,1
49460,фразам,0,0,1,1
37925,editörleri,0,0,1,1
37924,تنمو,0,0,1,1
37923,ഇല്ലായിരുന്നു,0,0,1,1
49463,δολάρια,0,0,1,1
49762,необходимых,0,0,1,1
37496,sänka,0,0,1,1
37495,чудовищный,0,0,1,1
50039,феврале,0,0,1,1
50032,تثبت,0,0,1,1
37090,внимательно,0,0,1,1
50034,பகுதிகளில்,0,0,1,1
37088,बोक्माल,0,0,1,1
37087,டோஃபிள்,0,0,1,1
50035,запущенная,0,0,1,1
50038,ഡിസന്റ്,0,0,1,1
37085,மங்கலான,0,0,1,1
50040,критиков,0,0,1,1
50049,dutch,0,0,1,1
50042,hilf,0,0,1,1
37081,റിപ്പബ്ലിക്ക്,0,0,1,1
50043,fördelade,0,0,1,1
37079,отличие,0,0,1,1
50046,glaciation,0,0,1,1
37078,ನಿಯಮಗಳನ್ನು,0,0,1,1
37077,enfrenta,0,0,1,1
50047,alltag,0,0,1,1
50031,ಪುನರಾರಂಭಿಸಲು,0,0,1,1
50029,merk,0,0,1,1
37094,अंग्रजी,0,0,1,1
37095,supposed,0,0,1,1
37108,citaträtten,0,0,1,1
50019,позицией,0,0,1,1
37106,ಮಧ್ಯಾಹ್ನದ,0,0,1,1
37105,സന്നദ്ധ,0,0,1,1
50020,الدينية,0,0,1,1
37104,رغم,0,0,1,1
50023,surpreender,0,0,1,1
37102,редактироваться,0,0,1,1
37101,λέγω,0,0,1,1
50025,fejlede,0,0,1,1
50026,النصف,0,0,1,1
37099,critique,0,0,1,1
37098,പെരുമാറിയത്,0,0,1,1
50027,അങ്ങനെയായിരിക്കും,0,0,1,1
37097,"
silesiano",0,0,1,1
37096,sorrir,0,0,1,1
50028,vertus,0,0,1,1
37075,inherited,0,0,1,1
37073,بليدًا,0,0,1,1
37112,virgil,0,0,1,1
50071,schloss,0,0,1,1
50064,собственность,0,0,1,1
50065,استندت,0,0,1,1
37053,अधीन,0,0,1,1
50066,klottrares,0,0,1,1
50067,rijksdienst,0,0,1,1
50068,evermore,0,0,1,1
50070,manche,0,0,1,1
37050,realworld,0,0,1,1
37049,hayranlarının,0,0,1,1
37072,पीटर,0,0,1,1
50072,tillåtna,0,0,1,1
37048,അഭിനയിക്കുന്നവരാരെല്ലാം,0,0,1,1
50073,security”,0,0,1,1
50074,prit,0,0,1,1
37045,الأوائل,0,0,1,1
50075,salads,0,0,1,1
37044,särskilda,0,0,1,1
37043,impossível,0,0,1,1
37055,technè,0,0,1,1
37056,ஆக்கங்கள்,0,0,1,1
37057,balanceamento,0,0,1,1
50063,bienvenido,0,0,1,1
50050,waved,0,0,1,1
37070,ناطقة,0,0,1,1
50051,ementas,0,0,1,1
50052,ഗ്രന്ഥങ്ങളും,0,0,1,1
37069,الخوف,0,0,1,1
50053,existia,0,0,1,1
37068,desnecessário,0,0,1,1
37067,probabiliste,0,0,1,1
37066,gostasse,0,0,1,1
37064,indicators,0,0,1,1
50054,privilégio,0,0,1,1
37061,rotulada,0,0,1,1
50056,l’intégrité,0,0,1,1
50057,adında,0,0,1,1
50059,reflexo,0,0,1,1
50060,സാധിക്കും,0,0,1,1
50061,biggest,0,0,1,1
50017,aptal,0,0,1,1
37113,susceptibles,0,0,1,1
37191,تزيد,0,0,1,1
49980,erkennen,0,0,1,1
37170,ചിഹ്നങ്ങളെയും,0,0,1,1
37169,langage,0,0,1,1
37168,ಮಾಡಲ್ಪಟ್ಟನು,0,0,1,1
37167,pojkvän,0,0,1,1
37166,servidas,0,0,1,1
49977,multidões,0,0,1,1
49979,этими,0,0,1,1
37163,formé,0,0,1,1
37161,mangez,0,0,1,1
37151,تشرفت,0,0,1,1
49981,कक्ष,0,0,1,1
49982,хорошие,0,0,1,1
49984,verificadores,0,0,1,1
49985,weinst,0,0,1,1
49986,ντυμένος,0,0,1,1
37156,gezegd,0,0,1,1
49988,«фазы,0,0,1,1
49989,actif,0,0,1,1
49976,requeria,0,0,1,1
49975,internetvrienden,0,0,1,1
37172,grupparbeten,0,0,1,1
37173,निर्दिष्ट,0,0,1,1
37189,применить,0,0,1,1
49964,करेगा,0,0,1,1
37187,വസ്തുതകളിലൂന്നിയുള്ള,0,0,1,1
37186,aangenaam,0,0,1,1
49965,உயரிய,0,0,1,1
37185,tadic,0,0,1,1
49968,أسئلة,0,0,1,1
37184,звонка,0,0,1,1
37183,transmit,0,0,1,1
37182,പിന്നിലുണ്ടെങ്കിലേ,0,0,1,1
37181,மூலத்தைப்,0,0,1,1
49970,тест,0,0,1,1
37179,‘சியாகோமோ,0,0,1,1
37178,egoistische,0,0,1,1
37177,llevaré,0,0,1,1
49973,israël,0,0,1,1
37174,متجهة,0,0,1,1
37152,schmecken,0,0,1,1
49991,ചോദ്യചിഹ്നത്തിലൂടെയും,0,0,1,1
37114,مليارات,0,0,1,1
37123,കണ്ണുനീരിന്,0,0,1,1
37130,മറാഠി,0,0,1,1
37129,alınarak,0,0,1,1
50009,necessário,0,0,1,1
50011,"
cazaque",0,0,1,1
37128,preparese,0,0,1,1
50012,അംഗീകരിക്കപ്പെട്ടിരിക്കുന്ന,0,0,1,1
37126,விக்கிப்பீடியாக்களில்,0,0,1,1
37125,görünmesini,0,0,1,1
37122,humide,0,0,1,1
49992,syntactic,0,0,1,1
37121,पैसों,0,0,1,1
37120,ചെയ്യുന്നതിനെക്കുറിച്ച്,0,0,1,1
37119,concentration,0,0,1,1
37118,syrie,0,0,1,1
37117,frokosten,0,0,1,1
50014,മകളായ,0,0,1,1
50015,jefe,0,0,1,1
37115,convencidas,0,0,1,1
37131,பதிப்பாக,0,0,1,1
37132,മായ്ച്ചുകളയാറുമുണ്ട്,0,0,1,1
37133,savunulmaktadır,0,0,1,1
37134,القرصنة,0,0,1,1
37148,ಪುರುಷರನ್ನು,0,0,1,1
49995,artful,0,0,1,1
49996,utsatt,0,0,1,1
49997,ännu,0,0,1,1
37144,deren,0,0,1,1
37142,overeenkomstige,0,0,1,1
49999,ضخمة,0,0,1,1
37141,morrendo,0,0,1,1
50000,stämmer,0,0,1,1
37139,السعي,0,0,1,1
37138,örneğinde,0,0,1,1
50001,ನಮ್ಮೊಂದಿಗೆ,0,0,1,1
50002,откусил,0,0,1,1
50003,добровольного,0,0,1,1
37137,ಯೋಜನೆ,0,0,1,1
37136,humoristiques,0,0,1,1
37135,ಬಳಸುತ್ತೇವೆ,0,0,1,1
50076,kindle,0,0,1,1
50077,обслужены,0,0,1,1
37041,وتطوير,0,0,1,1
36942,fordele,0,0,1,1
36948,heleboel,0,0,1,1
36947,décontenancée,0,0,1,1
50144,أصاب,0,0,1,1
50145,नार्सिसस,0,0,1,1
36945,முயற்சியானது,0,0,1,1
36944,accueille,0,0,1,1
50147,hilsner,0,0,1,1
50148,ومعظمها,0,0,1,1
36941,anthropique,0,0,1,1
36933,bedenker,0,0,1,1
50149,अचानक,0,0,1,1
36940,transgenre,0,0,1,1
50150,അവധി,0,0,1,1
50152,opposé,0,0,1,1
50153,ಅದೃಷ್ಟಶಾಲಿ,0,0,1,1
50156,databas,0,0,1,1
36935,décompté,0,0,1,1
36934,çılgın,0,0,1,1
36950,vanskelig,0,0,1,1
36951,masanın,0,0,1,1
36952,ideell,0,0,1,1
36953,இராணுவத்தால்,0,0,1,1
36969,стволовых,0,0,1,1
36968,fui,0,0,1,1
50132,سابق,0,0,1,1
36966,cape,0,0,1,1
50134,கொண்டிருந்தது,0,0,1,1
36965,vertrekken,0,0,1,1
36964,árbol,0,0,1,1
50135,ನಕಲಿಸಲು,0,0,1,1
50136,голосованиях,0,0,1,1
50138,consta,0,0,1,1
36960,vigtigste,0,0,1,1
50139,biyografi,0,0,1,1
50140,взволнованы,0,0,1,1
36958,περιμένει,0,0,1,1
36957,samentrekking,0,0,1,1
50142,беспокойтесь»,0,0,1,1
50143,इनका,0,0,1,1
50158,platonicien,0,0,1,1
36932,അവബോധം,0,0,1,1
50079,операционные,0,0,1,1
36905,трудно,0,0,1,1
50181,நண்பர்,0,0,1,1
36911,εκπληκτικά,0,0,1,1
36910,ಸಾಲ,0,0,1,1
50182,находящейся,0,0,1,1
50183,ಮಾಡದ,0,0,1,1
36908,perspective,0,0,1,1
36907,расскажет,0,0,1,1
36906,المضيفون،,0,0,1,1
36904,humanisme,0,0,1,1
36931,सुसंस्कृत,0,0,1,1
36903,популярный,0,0,1,1
36902,coule,0,0,1,1
50184,excluíu,0,0,1,1
50185,инцидент,0,0,1,1
36899,financée,0,0,1,1
36898,desacuerdo,0,0,1,1
50186,överdriva,0,0,1,1
36896,عاصفة,0,0,1,1
50177,тупого,0,0,1,1
36914,licencesf,0,0,1,1
36915,chevalier,0,0,1,1
36916,tegenovergestelde,0,0,1,1
50162,डॉइशलैंड,0,0,1,1
36929,പദ്ധതി,0,0,1,1
50165,requiring,0,0,1,1
50166,serbie,0,0,1,1
36927,السويدية،,0,0,1,1
50168,riesige,0,0,1,1
36926,optaria,0,0,1,1
50169,minister,0,0,1,1
36924,véhicule,0,0,1,1
50171,ميدياويكي،,0,0,1,1
50172,людьми»,0,0,1,1
36921,скажете,0,0,1,1
50173,sjunker,0,0,1,1
36919,صديقك,0,0,1,1
50174,പിറ്റേന്ന്,0,0,1,1
36917,बीबीसी,0,0,1,1
50175,globales,0,0,1,1
36970,وصبر,0,0,1,1
36971,"
हम",0,0,1,1
50131,beskrivit,0,0,1,1
50101,kronolojik,0,0,1,1
50096,ചുവടെയുള്ള,0,0,1,1
37021,pertinente,0,0,1,1
50097,"
ईडो",0,0,1,1
37019,ധനികനും,0,0,1,1
50098,uitdrukkelijk,0,0,1,1
37017,assuntos,0,0,1,1
50099,erişime,0,0,1,1
37015,chinois ,0,0,1,1
37014,கேட்காதபோது,0,0,1,1
50130,l’émergence,0,0,1,1
50102,التحريرية,0,0,1,1
50103,οποτεδήποτε,0,0,1,1
50107,അനാവശ്യ,0,0,1,1
50108,bozuldu,0,0,1,1
37011,जताया,0,0,1,1
50109,effectuer,0,0,1,1
37010,intentionally,0,0,1,1
37009,écologiques,0,0,1,1
37023,கேள்விக்கு,0,0,1,1
37025,stehen,0,0,1,1
37026,betygsätta,0,0,1,1
37027,hayan,0,0,1,1
50080,savezvous,0,0,1,1
37039,числе,0,0,1,1
50081,ettiğinizden,0,0,1,1
50082,codes,0,0,1,1
37038,ötesinde,0,0,1,1
37037,hvilke,0,0,1,1
37036,имею,0,0,1,1
50087,steam,0,0,1,1
37035,السرعة،,0,0,1,1
50088,differ,0,0,1,1
37032,ciencias,0,0,1,1
50090,जीटरेन,0,0,1,1
50091,поговорим,0,0,1,1
37031,basisgroeten,0,0,1,1
37030,ചാനലിലേക്ക്,0,0,1,1
50092,wikipediabron,0,0,1,1
50094,tendrá,0,0,1,1
37008,simplificadas,0,0,1,1
37007,viessem,0,0,1,1
37006,trataron,0,0,1,1
36984,சூடாக,0,0,1,1
50122,prinses,0,0,1,1
36982,традиционную,0,0,1,1
36981,anlamadım,0,0,1,1
36980,கடனைப்,0,0,1,1
36979,ужин,0,0,1,1
36978,мнению,0,0,1,1
50123,nécessitant,0,0,1,1
50124,ipucunu,0,0,1,1
36977,проснулся,0,0,1,1
36976,çıkardın,0,0,1,1
36975,பயனாளிகள்,0,0,1,1
50125,أوباما,0,0,1,1
50126,«βικιπαίδεια»,0,0,1,1
50127,ಶೆಲ್ನ,0,0,1,1
50128,bevara,0,0,1,1
36974,hänga,0,0,1,1
50129,dramatic,0,0,1,1
36983,pourrez,0,0,1,1
36985,miroitements,0,0,1,1
37005,observateurs,0,0,1,1
36986,ваша,0,0,1,1
37004,onmogelijke,0,0,1,1
37003,argument,0,0,1,1
37002,yapmaya,0,0,1,1
37000,rastrear,0,0,1,1
50110,absolut,0,0,1,1
36997,thereby,0,0,1,1
50112,colaborou,0,0,1,1
50113,szl •,0,0,1,1
50114,பக்கங்களை,0,0,1,1
50115,statement,0,0,1,1
50118,независимыми,0,0,1,1
36992,yapabilmek,0,0,1,1
36991,അർത്ഥമെന്താണെന്ന്,0,0,1,1
36990,पकड़ने,0,0,1,1
36989,написать,0,0,1,1
50120,operates,0,0,1,1
50121,tenir,0,0,1,1
49963,وتقنيات,0,0,1,1
37192,opbeuren,0,0,1,1
49764,tommelfingre,0,0,1,1
37389,जितने,0,0,1,1
37397,σχολίων,0,0,1,1
37396,förändra,0,0,1,1
37394,duplicating,0,0,1,1
37393,gebrochenem,0,0,1,1
37392,"
javanês",0,0,1,1
37391,forstår,0,0,1,1
49829,подкасты,0,0,1,1
37390,efterfølgende,0,0,1,1
37388,اقتباس,0,0,1,1
49842,wildness,0,0,1,1
37386,διαφορετικές,0,0,1,1
49830,الطاولة,0,0,1,1
49832,fördel,0,0,1,1
49834,നല്കേണ്ട,0,0,1,1
37385,gözleri,0,0,1,1
49836,raakte,0,0,1,1
37383,franse,0,0,1,1
49839,qualifier,0,0,1,1
37398,caracteres,0,0,1,1
37399,contato,0,0,1,1
37401,dbpedia,0,0,1,1
37403,matemáticos,0,0,1,1
37418,विधि,0,0,1,1
37417,έμοιαζε,0,0,1,1
37416,القمر،,0,0,1,1
49818,പിസ്സ,0,0,1,1
49819,listelerine,0,0,1,1
37415,δεξιά,0,0,1,1
49821,вебсервера,0,0,1,1
37413,corregir,0,0,1,1
37412,миллион,0,0,1,1
37410,uppslukad,0,0,1,1
49823,"
romeno",0,0,1,1
37409,projeler,0,0,1,1
37408,profondes »,0,0,1,1
37407,ढांचा,0,0,1,1
37405,globe,0,0,1,1
49826,للحظة؟,0,0,1,1
37404,संसदीय,0,0,1,1
37381,poderi,0,0,1,1
37379,يمتلك,0,0,1,1
49816,eye,0,0,1,1
37355,пояснении,0,0,1,1
37363,nãousuários,0,0,1,1
37362,psychologie,0,0,1,1
49857,éloignée,0,0,1,1
37360,طرق,0,0,1,1
37359,dúvidas,0,0,1,1
49859,μπερδέψεις,0,0,1,1
37356,நல்லவை,0,0,1,1
49860,கலைக்களஞ்சியங்களைப்,0,0,1,1
37354,recurso,0,0,1,1
37378,decirnos,0,0,1,1
37353,पता।,0,0,1,1
37352,"
francês",0,0,1,1
37351,plötsligt,0,0,1,1
37350,autorización,0,0,1,1
37349,« on,0,0,1,1
49861,références »,0,0,1,1
49862,müthiş,0,0,1,1
37347,கேட்கிறேன்,0,0,1,1
49855,πλούσιος,0,0,1,1
49854,ചേർക്കാനോ,0,0,1,1
37365,discurso,0,0,1,1
37366,şehit,0,0,1,1
49843,fracción,0,0,1,1
37377,computationally,0,0,1,1
37376,reprinted,0,0,1,1
49845,διαδίκτυο,0,0,1,1
49846,குளிர்,0,0,1,1
37374,τάξη,0,0,1,1
49847,intihal,0,0,1,1
49849,المحتوى،,0,0,1,1
49850,üzülme,0,0,1,1
37373,gittiğinde,0,0,1,1
37372,istersen,0,0,1,1
49851,உருவாக்கியிருப்பர்,0,0,1,1
37371,μηεγκυκλοπαιδικούς,0,0,1,1
49852,upright,0,0,1,1
37369,нобелевский,0,0,1,1
37368,будьте,0,0,1,1
37367,отзыв,0,0,1,1
49817,إضافات,0,0,1,1
49815,لذلك؟,0,0,1,1
37193,nouvel,0,0,1,1
37470,வியக்க,0,0,1,1
49777,പറഞ്ഞയച്ചത്,0,0,1,1
49778,deyim,0,0,1,1
37477,perçoit,0,0,1,1
37476,kopiere,0,0,1,1
37475,boneca,0,0,1,1
37474,تبحث,0,0,1,1
49779,diğerinin,0,0,1,1
37471,прощание,0,0,1,1
37469,mécanismes,0,0,1,1
49786,motivated,0,0,1,1
49780,равен,0,0,1,1
49781,discutido,0,0,1,1
49782,ऑक्सफ़ोर्ड,0,0,1,1
49783,வைக்கிறேன்,0,0,1,1
37467,aangepast,0,0,1,1
37466,ocasionalmente,0,0,1,1
37465,polis,0,0,1,1
49785,mantenido,0,0,1,1
37478,சோம்பலாகவோ,0,0,1,1
37479,entdeckung,0,0,1,1
49775,வழக்குரைஞர்கள்,0,0,1,1
49774,jupiter,0,0,1,1
49765,പശ്ചാത്തലത്തിൽ,0,0,1,1
37493,يدور,0,0,1,1
37492,vriendin,0,0,1,1
37491,issu,0,0,1,1
49766,hornear,0,0,1,1
49767,occitane,0,0,1,1
37489,ಕಡೆಗೆ,0,0,1,1
37488,διαγλωσσικές,0,0,1,1
49768,വർദ്ധച്ചുകൊണ്ടിരിക്കുന്ന,0,0,1,1
49770,mistaken,0,0,1,1
37486,bce,0,0,1,1
37485,contended,0,0,1,1
37484,wikipedista,0,0,1,1
49771,дворце,0,0,1,1
49772,unglück,0,0,1,1
37482,لاحقًا،,0,0,1,1
49773,تصبح,0,0,1,1
37464,detaljerat,0,0,1,1
37462,посещаемость,0,0,1,1
49814,милыми,0,0,1,1
37431,meningen,0,0,1,1
49800,qualify,0,0,1,1
49801,empregam,0,0,1,1
37437,नकली,0,0,1,1
49802,tapisseries,0,0,1,1
49803,partition,0,0,1,1
37435,alia,0,0,1,1
37434,—cuando,0,0,1,1
37432,интерфейс,0,0,1,1
49806,பதிக்கப்பட்டிருந்தது,0,0,1,1
37461,désinformation,0,0,1,1
49807,badly,0,0,1,1
37428,നിർത്താൻ,0,0,1,1
37427,बोल,0,0,1,1
37425,ಹೇಳಿದ್ದಳು,0,0,1,1
37424,தயங்குகிறது,0,0,1,1
37423,إدارة,0,0,1,1
49809,സത്യസന്ധമായി,0,0,1,1
37421,вызванных,0,0,1,1
49799,prestes,0,0,1,1
37441,bulunabilir,0,0,1,1
37442,derste,0,0,1,1
49798,lettres,0,0,1,1
49787,parlait,0,0,1,1
37459,മൂർച്ചയുള്ളതും,0,0,1,1
49788,ಮಾಡುವಂತೆ,0,0,1,1
37458,igualmente,0,0,1,1
37456,suporte,0,0,1,1
37455,yolculuk,0,0,1,1
37454,സംഭവിച്ച,0,0,1,1
37451,ведущие,0,0,1,1
49789,والنص,0,0,1,1
49791,разработки,0,0,1,1
49792,வெளியிடப்பட்டு,0,0,1,1
37449,الحمد,0,0,1,1
49793,deverão,0,0,1,1
49794,somado,0,0,1,1
37446,imagina»,0,0,1,1
37445,olign,0,0,1,1
49797,minimiza,0,0,1,1
37346,ಣಾತ್ಮಕವಾಗಿರಬಹುದು,0,0,1,1
49864,الغالب,0,0,1,1
37345,editan,0,0,1,1
49923,sohbette,0,0,1,1
49919,d’outils,0,0,1,1
37244,rastreado,0,0,1,1
37243,nie,0,0,1,1
49920,revise,0,0,1,1
37241,italienne,0,0,1,1
49921,«администратора»,0,0,1,1
37239,നന്ദിയുണ്ട്,0,0,1,1
37238,വീഡിയോയ്ക്ക്,0,0,1,1
49924,diyor,0,0,1,1
37228,övrigt,0,0,1,1
49925,skipped,0,0,1,1
37235,размещены,0,0,1,1
37234,बायोलोजी,0,0,1,1
49926,frankrijk,0,0,1,1
37232,pedaço,0,0,1,1
49927,المبادئ,0,0,1,1
37231,girlfriend,0,0,1,1
49928,различных,0,0,1,1
37246,സാദ്ധ്യതയുണ്ടാവാറുണ്ട്।,0,0,1,1
37247,privacidad,0,0,1,1
37248,discordando,0,0,1,1
49918,annars,0,0,1,1
37266,censure »,0,0,1,1
37265,salud,0,0,1,1
49909,المجانية,0,0,1,1
37263,leçon,0,0,1,1
49910,mangelhaft,0,0,1,1
37261,пользователь,0,0,1,1
37260,peerreview,0,0,1,1
37259,ongewild,0,0,1,1
37258,listor,0,0,1,1
49914,просмотренных,0,0,1,1
37254,сбитым,0,0,1,1
37253,الطلاب,0,0,1,1
49916,emeralds,0,0,1,1
37252,desinformation,0,0,1,1
37251,devia,0,0,1,1
37249,العزيز,0,0,1,1
49917,gazetesi,0,0,1,1
49930,запрещено,0,0,1,1
37227,χρησιμοποιηθούν,0,0,1,1
49866,प्लेट,0,0,1,1
37201,തിരുത്തിക്കോളും,0,0,1,1
37207,genome,0,0,1,1
49949,இதில்,0,0,1,1
49951,recourent,0,0,1,1
37204,misslyckanden,0,0,1,1
37203,distinctly,0,0,1,1
49952,"rely
heavily",0,0,1,1
49953,telefónica,0,0,1,1
49954,شخص،,0,0,1,1
37200,consideramse,0,0,1,1
49933,verbform,0,0,1,1
49955,salle,0,0,1,1
49956,ônibus,0,0,1,1
49958,ഡോളർ,0,0,1,1
37197,proíbem,0,0,1,1
37196,terço,0,0,1,1
37195,награды,0,0,1,1
49962,epost,0,0,1,1
37194,internacionales,0,0,1,1
37209,assinatura,0,0,1,1
49948,intensivo,0,0,1,1
37210,وذهب,0,0,1,1
37211,логистическому,0,0,1,1
37224,yanılıyorsun,0,0,1,1
49934,joueur,0,0,1,1
37222,രാജകുമാരൻ,0,0,1,1
37221,जुलती,0,0,1,1
37219,எனப்படும்,0,0,1,1
37218,ನಡವಳಿಕೆ,0,0,1,1
49936,biaisé,0,0,1,1
49937,англоязычного,0,0,1,1
37217,സാധ്യമല്ല,0,0,1,1
49940,habituel,0,0,1,1
37215,работах,0,0,1,1
49942,मेनवल,0,0,1,1
49943,vicinity,0,0,1,1
49944,ಬಳಸುತ್ತಿತ್ತು,0,0,1,1
49945,тематическому,0,0,1,1
37212,ತೋಟದಲ್ಲಿ,0,0,1,1
49946,വഴിക്കുള്ള,0,0,1,1
37267,φοβερό,0,0,1,1
37268,бурной,0,0,1,1
37269,verhalten,0,0,1,1
37322,prenant,0,0,1,1
49882,ಮೂಕ,0,0,1,1
37328,إتمام,0,0,1,1
37327,validation ,0,0,1,1
37326,aldığı,0,0,1,1
37325,"
हिब्रू",0,0,1,1
49883,maldonado ,0,0,1,1
37324,mixed,0,0,1,1
37323,καλιφόρνια,0,0,1,1
37321,strip,0,0,1,1
37270,urbaines,0,0,1,1
37319,desciclopédia,0,0,1,1
37318,bid,0,0,1,1
49884,ವೇಗದಲ್ಲಿರಲು,0,0,1,1
49885,londinense,0,0,1,1
37316,нетрадиционной,0,0,1,1
49888,பெறும்,0,0,1,1
37312,إعلانات،,0,0,1,1
37311,voormalig,0,0,1,1
49880,உதவியுடன்,0,0,1,1
49879,வர்த்தகம்,0,0,1,1
49878,المقاومة,0,0,1,1
49877,ആശയമാണെന്ന്,0,0,1,1
49867,récentes »,0,0,1,1
49868,പോയാൽ,0,0,1,1
37342,उत्पीड़क,0,0,1,1
37341,şikayetçi,0,0,1,1
37340,தும்மும்போது,0,0,1,1
37339,وحده,0,0,1,1
49870,вебсервер,0,0,1,1
49871,soldado,0,0,1,1
37335,மனம்,0,0,1,1
49873,ickehierarkisk,0,0,1,1
37334,ആവശ്യമാണെന്ന്,0,0,1,1
37333,doté,0,0,1,1
37332,proceeds,0,0,1,1
49875,αμφιβολίας,0,0,1,1
49876,सफलतापूर्वक,0,0,1,1
37330,πρότασή,0,0,1,1
37329,ಪಠ್ಯ,0,0,1,1
49889,granskade,0,0,1,1
49890,பிழைத்திருத்தத்திற்குப்,0,0,1,1
37308,galen,0,0,1,1
37289,கொண்டிருந்தால்,0,0,1,1
37287,tabağımda,0,0,1,1
37286,schat,0,0,1,1
37285,propress,0,0,1,1
37284,snail,0,0,1,1
37283,kvantiteten,0,0,1,1
37282,förhindrat,0,0,1,1
49900,structurées,0,0,1,1
49901,tidskrift,0,0,1,1
49902,damaging,0,0,1,1
49903,quarter,0,0,1,1
37277,വെള്ളം,0,0,1,1
49904,bağlamında,0,0,1,1
49905,hakikaten,0,0,1,1
37274,والسلج,0,0,1,1
37273,obtuviste,0,0,1,1
37272,formulation,0,0,1,1
49908,l’esquisse,0,0,1,1
37288,fokuseret,0,0,1,1
37290,ويكيبيديا؟,0,0,1,1
49892,insuffisances,0,0,1,1
37291,മഹാരാഷ്ട്രയും,0,0,1,1
49893,chrétien,0,0,1,1
37307,இக்,0,0,1,1
37306,patrón,0,0,1,1
37305,онлайнпроекта,0,0,1,1
49894,مقطعين,0,0,1,1
49896,الاجتماعي,0,0,1,1
37303,wikipedia»,0,0,1,1
37301,υπενθυμίσω,0,0,1,1
49897,μίλησε,0,0,1,1
37300,yanlışlar,0,0,1,1
37299,полезным,0,0,1,1
37298,கலைக்களஞ்சியத்தை,0,0,1,1
37297,localizados,0,0,1,1
49898,quotidiennes,0,0,1,1
37295,بعامين،,0,0,1,1
37294,onderzoeksveld,0,0,1,1
37292,والفكاهة,0,0,1,1
36481,لكنك,0,0,1,1
35849,yiyemediğim,0,0,1,1
36479,residence,0,0,1,1
51920,pedras,0,0,1,1
51954,زيادة,0,0,1,1
34529,observa,0,0,1,1
51957,तथा,0,0,1,1
51958,μπριτάννικα,0,0,1,1
51959,المكتبة؟,0,0,1,1
34527,proactifs,0,0,1,1
51960,ödmjuk,0,0,1,1
51962,ಹೋಗಬೇಕಾಗಿದೆ,0,0,1,1
51963,फिलोसोफी,0,0,1,1
51965,സന്നദ്ധരായവരെ,0,0,1,1
34522,κερδοσκοπικό,0,0,1,1
34521,സ്വർണ്ണമായും,0,0,1,1
34520,колеблясь,0,0,1,1
51968,matriz,0,0,1,1
34519,meilleurs,0,0,1,1
34518,uur,0,0,1,1
34516,शिक्षण,0,0,1,1
51970,существительное,0,0,1,1
51971,группе,0,0,1,1
34514,sends,0,0,1,1
34513,уравновешенным,0,0,1,1
34512,fundaram,0,0,1,1
51974,puppe,0,0,1,1
34531,quedaría,0,0,1,1
34532,سجل,0,0,1,1
51953,യാത്രയ്ക്കിടയിലോ,0,0,1,1
34542,وفهرسة,0,0,1,1
51923,massives,0,0,1,1
34552,سيبدو,0,0,1,1
51924,fakta,0,0,1,1
51925,وأعلن,0,0,1,1
51928,फ़्लैमिश,0,0,1,1
51929,ലേഖനങ്ങളെഴുതാനും,0,0,1,1
51931,पर्यटक,0,0,1,1
51932,wikitekniken,0,0,1,1
34548,стратегию,0,0,1,1
34545,stuck,0,0,1,1
51938,ηλεκτρονική,0,0,1,1
34533,காதலி,0,0,1,1
34540,inseriu,0,0,1,1
51940,påpekar,0,0,1,1
51943,еду,0,0,1,1
51944,gratuitement,0,0,1,1
51945,№ ,0,0,1,1
34537,ख़राब,0,0,1,1
51948,போக,0,0,1,1
51949,variétés,0,0,1,1
51951,وأيضًا,0,0,1,1
34536,tête,0,0,1,1
34510,இணைப்பை,0,0,1,1
34509,koyuyorum,0,0,1,1
34508,ചെയ്ത,0,0,1,1
34479,ägna,0,0,1,1
34490,ತಕ್ಷಣ,0,0,1,1
34489,நோக்கமற்றது,0,0,1,1
52001,hovedet,0,0,1,1
34487,ಮುಳುಗುವುದು,0,0,1,1
52002,ಸರಿಯೇ,0,0,1,1
34485,ισορροπημένες,0,0,1,1
52003,protestataire,0,0,1,1
34483,ಕಾರ್ಯನಿರ್ವಹಿಸದಿದ್ದರೆ,0,0,1,1
34482,தாயைக்,0,0,1,1
34480,ಮಾತನಾಡುತ್ತಿದ್ದರು,0,0,1,1
52005,βοηθήσει,0,0,1,1
51999,विक्शनरी,0,0,1,1
34477,inferencial,0,0,1,1
52007,فحص,0,0,1,1
34476,दयालु,0,0,1,1
34474,dudosos,0,0,1,1
52008,ಸಭ್ಯವಾಗಿರಲು,0,0,1,1
34473,foresee,0,0,1,1
34472,எவ்வாறு,0,0,1,1
34471,एफ़,0,0,1,1
34470,« est,0,0,1,1
34469,അതിനുമുമ്പും,0,0,1,1
34491,englischen,0,0,1,1
34492,déisme ,0,0,1,1
34507,മികച്ചതാണ്,0,0,1,1
34499,saw,0,0,1,1
51975,l’utilisateur,0,0,1,1
51977,enfocada,0,0,1,1
51978,ಶುಭಾಶಯಗಳು,0,0,1,1
51981,viajó,0,0,1,1
51982,яркие,0,0,1,1
34504,உரிமத்திற்கு,0,0,1,1
34503,போர்ட்டலுக்குள்,0,0,1,1
51983,éloigner,0,0,1,1
51985,владеющей,0,0,1,1
51986,paradoxa,0,0,1,1
51987,edemezsin,0,0,1,1
51998,தொனி,0,0,1,1
34497,oftare,0,0,1,1
51989,человеку,0,0,1,1
34496,പുറമേ,0,0,1,1
34495,vivante,0,0,1,1
51991,ಸಂಭಾಷಣೆಯ,0,0,1,1
51992,ആരംഭിക്കാം,0,0,1,1
51993,lutou,0,0,1,1
51995,движение,0,0,1,1
34493,gerektiği,0,0,1,1
51997,superfluo,0,0,1,1
51922,показывает,0,0,1,1
51919,fils,0,0,1,1
34466,اللذيذ,0,0,1,1
34557,accroître,0,0,1,1
34634,байесовские,0,0,1,1
34633,omfattande,0,0,1,1
34631,ക്രിയയായി,0,0,1,1
51882,ignorant,0,0,1,1
51883,вандализму,0,0,1,1
34630,mentionné,0,0,1,1
34629,ഓർമ്മിപ്പിക്കാൻ,0,0,1,1
51884,configuration,0,0,1,1
51885,mandar,0,0,1,1
34628,ബ്യൂറോക്രാറ്റുകളേയും,0,0,1,1
34626,subsurface,0,0,1,1
34625,gelişimini,0,0,1,1
34624,имеющее,0,0,1,1
34623,islas,0,0,1,1
51886,brister,0,0,1,1
34622,woke,0,0,1,1
51887,волнует,0,0,1,1
51888,"
माओरी",0,0,1,1
34619,olgudur,0,0,1,1
34618,crowdsourcing ,0,0,1,1
34616,никогда,0,0,1,1
34614,മെസഞ്ചർ,0,0,1,1
51890,காலையில்,0,0,1,1
34635,possuíam,0,0,1,1
51880,منقوشة,0,0,1,1
51879,fleste,0,0,1,1
51870,« en,0,0,1,1
51863,birisine,0,0,1,1
51864,plagiat,0,0,1,1
34648,doutorado,0,0,1,1
51866,സമ്പൂർണ്ണമാക്കുന്നതിനും,0,0,1,1
51867,laboral,0,0,1,1
34646,εκτιμώ,0,0,1,1
51868,inativado,0,0,1,1
51869,américaines,0,0,1,1
34644,деятельность,0,0,1,1
34643,plantera,0,0,1,1
51871,legislação,0,0,1,1
51878,kinderpornografie,0,0,1,1
34641,google​—,0,0,1,1
51872,адекватному,0,0,1,1
51873,weiteres,0,0,1,1
34639,wikimediaprojekten,0,0,1,1
34638,മീറ്റിംഗായിരുന്നു,0,0,1,1
34637,processen,0,0,1,1
51874,подходам,0,0,1,1
51875,ಮುಗಿಸಲಿ,0,0,1,1
51877,lykønske,0,0,1,1
34636,உடைந்தாள்,0,0,1,1
51891,மனித,0,0,1,1
34612,snavs,0,0,1,1
34611,مراجعته,0,0,1,1
34570,sahipse,0,0,1,1
34580,rir,0,0,1,1
34579,جامعيون,0,0,1,1
51909,ಸುಳಿವು,0,0,1,1
34578,الأحياء,0,0,1,1
34577,passés,0,0,1,1
34576,увидела,0,0,1,1
34575,обществом,0,0,1,1
34574,പോർട്ടലിലൂടെ,0,0,1,1
34573,ಸಂತೋಷಪಡುತ್ತೇನೆ,0,0,1,1
51913,agradável,0,0,1,1
51916,നാം,0,0,1,1
51908,сделала,0,0,1,1
34567,تتضمن,0,0,1,1
34566,betegne,0,0,1,1
34565,ರೂಪಿಸುತ್ತಿದ್ದೇನೆ,0,0,1,1
34564,recevant,0,0,1,1
34563,справочником,0,0,1,1
34562,​​sneetje,0,0,1,1
34561,explaining,0,0,1,1
51917,escargot,0,0,1,1
34559,सारी,0,0,1,1
34558,contrastando,0,0,1,1
34581,കൊട്ടാരത്തിൽ,0,0,1,1
51907,medieråd,0,0,1,1
34610,albümüdür,0,0,1,1
51895,reseñados,0,0,1,1
34609,المتحدة،,0,0,1,1
34608,европейском,0,0,1,1
51893,depleting,0,0,1,1
34604,χαιρετισμοί,0,0,1,1
34603,moléculas,0,0,1,1
51894,केमलकेस,0,0,1,1
34602,luidspreker,0,0,1,1
34601,desempenho,0,0,1,1
34600,आखिरी,0,0,1,1
34598,fondent,0,0,1,1
34594,शहर,0,0,1,1
51906,ब्रांडचैनलकॉम,0,0,1,1
34593,работающих,0,0,1,1
34592,रहने,0,0,1,1
51898,spekulerede,0,0,1,1
51900,க்மாட்டை,0,0,1,1
51902,tommelfingrene,0,0,1,1
51903,blockera,0,0,1,1
34588,സഹായിക്കുമോ,0,0,1,1
34587,maravilhada,0,0,1,1
51905,vrijwillige,0,0,1,1
34586,oportunista,0,0,1,1
34467,lagts,0,0,1,1
34465,maitrise,0,0,1,1
52157,boğulabilir,0,0,1,1
52081,übliche,0,0,1,1
52101,πρόσφατα,0,0,1,1
52104,விவரிக்கும்,0,0,1,1
34351,காபியை,0,0,1,1
34350,bulundukları,0,0,1,1
34347,ಬೆಳೆಸಲು,0,0,1,1
52107,git,0,0,1,1
52108,toegankelijke,0,0,1,1
52109,உரிமம்,0,0,1,1
52110,argumentaram,0,0,1,1
52112,ganhando,0,0,1,1
34344,собираемся,0,0,1,1
34343,المتداولة,0,0,1,1
52113,hæve,0,0,1,1
34342,fusión,0,0,1,1
34341,неразумным,0,0,1,1
34340,l’interprétabilité,0,0,1,1
34339,« vitaliste »,0,0,1,1
52115,बजे,0,0,1,1
52116,аннотируя,0,0,1,1
52117,الحادثة،,0,0,1,1
34335,ഘട്ടം,0,0,1,1
34334,आयोजन,0,0,1,1
34333,çıkmasını,0,0,1,1
34354,trials,0,0,1,1
34355,சந்தேகம்,0,0,1,1
34356,घूमते,0,0,1,1
52089,apariencias,0,0,1,1
52083,reborn,0,0,1,1
52084,additions,0,0,1,1
34374,ستنمو,0,0,1,1
52085,alimentado,0,0,1,1
34372,இக்கொள்கைகளிலும்,0,0,1,1
52086,haría,0,0,1,1
52087,relativos,0,0,1,1
34370,रूचि,0,0,1,1
34368,paternitépartage,0,0,1,1
52088,النطاقات,0,0,1,1
34364,vienes,0,0,1,1
52099,agents,0,0,1,1
34363,párrafo,0,0,1,1
52090,utsikt,0,0,1,1
34362,கூறும்போது,0,0,1,1
52091,إثارة,0,0,1,1
52092,sequência,0,0,1,1
52093,negligenciáveis,0,0,1,1
52096,« youtube »,0,0,1,1
52098,sardenberg,0,0,1,1
34358,rudely,0,0,1,1
34357,ஒன்றும்,0,0,1,1
34332,klibinde,0,0,1,1
34331,regularly,0,0,1,1
34330,சென்றால்,0,0,1,1
34298,изменяющими,0,0,1,1
52140,объявление,0,0,1,1
34304,grippe,0,0,1,1
34303,ಬಸವನ,0,0,1,1
52142,bakıyordu,0,0,1,1
52143,मणिपुरी,0,0,1,1
34302,entourent,0,0,1,1
52144,okulda,0,0,1,1
34301,eraan,0,0,1,1
34300,reemplazados,0,0,1,1
34299,reage,0,0,1,1
34297,joint,0,0,1,1
34307,قولها,0,0,1,1
52148,ചീത്തയായി,0,0,1,1
52150,പ്രിയങ്കരമെന്നും,0,0,1,1
34296,hatten,0,0,1,1
34295,théorique…,0,0,1,1
34294,d’autant,0,0,1,1
52151,ಮಾಡುತ್ತಿದ್ದೀಯಾ,0,0,1,1
34292,arrête,0,0,1,1
52152,işim,0,0,1,1
34291,march update,0,0,1,1
52153,الدعم,0,0,1,1
52139,galten,0,0,1,1
52136,كثيرا,0,0,1,1
52118,കഴിയാത്ത,0,0,1,1
34319,belonging,0,0,1,1
52119,automáticos»,0,0,1,1
52120,princesse,0,0,1,1
34326,மாதங்களில்,0,0,1,1
34325,забавное,0,0,1,1
34324,पोषण,0,0,1,1
52122,وسلبيًا,0,0,1,1
34322,பொருள்படும்,0,0,1,1
34321,d’individus,0,0,1,1
34320,நினைக்கிறீர்கள்,0,0,1,1
52123,“மைசீக்குவல்”,0,0,1,1
52124,prédiction,0,0,1,1
52134,gfdl —,0,0,1,1
34318,связи,0,0,1,1
34317,accordant,0,0,1,1
52126,finalmente,0,0,1,1
52127,bezoeker,0,0,1,1
52129,inhabited,0,0,1,1
52130,നാനാവിധ,0,0,1,1
34314,analyserade,0,0,1,1
52131,raros,0,0,1,1
34311,മാലാഖയാണ്,0,0,1,1
34310,olvide,0,0,1,1
34376,istisnalar,0,0,1,1
34377,ребенку,0,0,1,1
34464,coauteurs,0,0,1,1
52080,കഴിവനുസരിച്ച്,0,0,1,1
52025,مؤتمر,0,0,1,1
34441,gerenommeerde,0,0,1,1
34440,delante,0,0,1,1
34439,"
quirguiz",0,0,1,1
52026,بالإنترنت,0,0,1,1
34437,ಸಹಾಯಕ್ಕಾಗಿ,0,0,1,1
34436,nobelpristagare,0,0,1,1
52027,மறந்துவிடுகிறார்கள்,0,0,1,1
34435,consist,0,0,1,1
34433,acervo,0,0,1,1
52028,डिलीट,0,0,1,1
52029,wenig,0,0,1,1
34432,accesserna,0,0,1,1
52030,सोफे,0,0,1,1
34431,«trabajadores,0,0,1,1
34430,wortelwoorden,0,0,1,1
34429,ഇല്ലയോ,0,0,1,1
34428,noter,0,0,1,1
52032,अवलोकित,0,0,1,1
34426,മൂലം,0,0,1,1
34425,enhance,0,0,1,1
34424,الاصابع,0,0,1,1
34423,لطيفًا,0,0,1,1
52023,دكتوراه,0,0,1,1
52021,hegemonia,0,0,1,1
52020,equator,0,0,1,1
52014,relatados,0,0,1,1
34462,സംവൃതോകാരത്തിന്റെ,0,0,1,1
52009,caractérisait,0,0,1,1
52010,preguntando,0,0,1,1
52011,neşelendirmek,0,0,1,1
52012,சொல்கிறது,0,0,1,1
34457,divergem,0,0,1,1
34456,قليلة,0,0,1,1
34455,penis,0,0,1,1
34454,добровольцами,0,0,1,1
52013,தன்,0,0,1,1
34453,വിടപറഞ്ഞു,0,0,1,1
34444,diskutera,0,0,1,1
34452,പ്രശ്നമുള്ള,0,0,1,1
34451,അതത്,0,0,1,1
34450,reparar,0,0,1,1
52015,பயணித்தது,0,0,1,1
34449,മനസിലാക്കാൻ,0,0,1,1
52016,британской,0,0,1,1
34447,eetkamer,0,0,1,1
52017,ಹೆಜ್ಜೆ,0,0,1,1
52018,remark,0,0,1,1
34445,significando,0,0,1,1
52033,делал,0,0,1,1
52034,പഠിക്കുന്ന,0,0,1,1
52035,görmek,0,0,1,1
34387,"
उज़्बैक",0,0,1,1
34398,"
विशेष",0,0,1,1
52064,κανονικό,0,0,1,1
52065,augustus,0,0,1,1
52067,bøger,0,0,1,1
34395,நொடியில்,0,0,1,1
52071,«рандеву,0,0,1,1
52072,iguales,0,0,1,1
34391,assertion,0,0,1,1
34390,एसएमएस,0,0,1,1
52074,ഇതിഹാസം,0,0,1,1
34386,ನೆನಪಿಸಲು,0,0,1,1
52061,counterpart,0,0,1,1
52075,ಮಾಡಲಿದ್ದೀರಿ,0,0,1,1
34384,aptalca,0,0,1,1
52076,indexing,0,0,1,1
52077,semiformal,0,0,1,1
34383,बिलकुल।,0,0,1,1
52078,stickprov,0,0,1,1
34381,supernatural,0,0,1,1
34380,gallego,0,0,1,1
34379,formidable,0,0,1,1
52079,നിയോഗിച്ചിരിക്കുന്നു,0,0,1,1
34399,περίπτωσή,0,0,1,1
52060,underhållande,0,0,1,1
34421,минуту,0,0,1,1
34411,الطالب,0,0,1,1
34420,gefangene,0,0,1,1
34418,الفزع,0,0,1,1
52037,augustin,0,0,1,1
52039,беспокою,0,0,1,1
52042,tadı,0,0,1,1
52044,القلب,0,0,1,1
34415,ρίτσαρντ,0,0,1,1
52046,reconhecido,0,0,1,1
52047,"
georgiano",0,0,1,1
34412,भूमण्डल,0,0,1,1
34409,udnytte,0,0,1,1
52059,lethargic,0,0,1,1
52052,varelser,0,0,1,1
34408,repasse,0,0,1,1
52053,जीते।,0,0,1,1
52054,நடித்த,0,0,1,1
52055,வாதங்களையும்,0,0,1,1
52056,côtés,0,0,1,1
52057,exitosa,0,0,1,1
34403,koymayı,0,0,1,1
52058,sientes,0,0,1,1
34401,نتابع,0,0,1,1
34650,aprendiesen,0,0,1,1
51858,naber,0,0,1,1
51857,aspire,0,0,1,1
51657,réparé,0,0,1,1
51682,pancarte,0,0,1,1
34904,modifierd,0,0,1,1
34903,ಚೆನ್ನಾಗಿರುತ್ತೇನೆ,0,0,1,1
34902,रेवोलुशन,0,0,1,1
51683,абоненту,0,0,1,1
34900,пополните,0,0,1,1
34897,предыдущей,0,0,1,1
34896,ομιλητές,0,0,1,1
34895,figuram,0,0,1,1
51686,programmers,0,0,1,1
51687,devenus,0,0,1,1
51688,sentó,0,0,1,1
51690,goleiro,0,0,1,1
51691,concernés,0,0,1,1
34890,редакционных,0,0,1,1
34887,हैं।अमेरिकी,0,0,1,1
34886,neigen,0,0,1,1
51695,unterschiedlichen,0,0,1,1
51696,старые,0,0,1,1
51697,είτε,0,0,1,1
34881,sözünü,0,0,1,1
34880,ശരിയാക്കി,0,0,1,1
51698,പിന്തുണയോടെയാണ്,0,0,1,1
51681,monthly,0,0,1,1
34906,contenía,0,0,1,1
51680,öbeğini,0,0,1,1
34920,எழுந்தேன்,0,0,1,1
51659,ارى,0,0,1,1
34929,problematic,0,0,1,1
51660,bayer,0,0,1,1
51661,conservées,0,0,1,1
51662,للقلق,0,0,1,1
34927,переписывают,0,0,1,1
34926,വംശജരെക്കാളും,0,0,1,1
51665,وضميرًا,0,0,1,1
34922,estadounidense,0,0,1,1
34921,لمعلومات,0,0,1,1
51666,साथी,0,0,1,1
51679,projelerinde,0,0,1,1
51667,luister,0,0,1,1
34918,undesired,0,0,1,1
51668,ಓಬ್ಟೂಸ್,0,0,1,1
51670,означающей,0,0,1,1
34915,நிறுவனர்கள்,0,0,1,1
51671,formerly,0,0,1,1
51672,bones,0,0,1,1
51677,comencemos,0,0,1,1
34909,சதுப்புநிலமானது,0,0,1,1
34908,دموعك,0,0,1,1
51699,освещении,0,0,1,1
34876,फेडरल,0,0,1,1
51701,சொற்றொடராக,0,0,1,1
34839,आश्चर्यचकित,0,0,1,1
34849,bayésien,0,0,1,1
34848,politically,0,0,1,1
34847,ನಗಲು,0,0,1,1
51718,основного,0,0,1,1
34846,αισθάνεστε,0,0,1,1
34845,गुड़िया,0,0,1,1
51719,செய்தீர்கள்,0,0,1,1
34842,يتعلَّم,0,0,1,1
34841,türlü,0,0,1,1
34840,konuşabilir,0,0,1,1
51721,oförskämt,0,0,1,1
51716,partitions,0,0,1,1
34836,rettelse,0,0,1,1
51723,révolutions,0,0,1,1
34834,hænger,0,0,1,1
34832,erreichen,0,0,1,1
34831,anfragen,0,0,1,1
34829,citem,0,0,1,1
51725,balkongen,0,0,1,1
34828,வாழ்க்கையை,0,0,1,1
34827,worse,0,0,1,1
34826,അലക്കു,0,0,1,1
34850,freundin,0,0,1,1
51715,melisa,0,0,1,1
34874,എല്ലാവരികൾക്കും,0,0,1,1
34862,العلوم,0,0,1,1
34873,विकिन्यूज,0,0,1,1
51702,повторите,0,0,1,1
34870,normalement,0,0,1,1
34868,inträffade,0,0,1,1
51703,закрывают,0,0,1,1
34867,değiştirmesiyle,0,0,1,1
51704,easiest,0,0,1,1
34866,தேவதையாக,0,0,1,1
34865,காண்பீர்கள்,0,0,1,1
34864,هما,0,0,1,1
51707,licences,0,0,1,1
34852,olanların,0,0,1,1
34861,rebanada,0,0,1,1
51708,തീരുമാനമാണ്,0,0,1,1
51709,ಗದ್ದೆ,0,0,1,1
34859,المركز,0,0,1,1
51710,обходительный,0,0,1,1
34857,утонченным,0,0,1,1
51712,kramme,0,0,1,1
34855,കർഷകൻ,0,0,1,1
34854,पहुँचे,0,0,1,1
34853,transcendentalist,0,0,1,1
51658,explication,0,0,1,1
51656,nuire,0,0,1,1
51855,предложено,0,0,1,1
34931,pasan,0,0,1,1
35005,интересное,0,0,1,1
35004,பிடித்துக்,0,0,1,1
51624,perplexed,0,0,1,1
35002,министерств,0,0,1,1
51625,अश्लील,0,0,1,1
35001,beschikken,0,0,1,1
35000,ಒತ್ತಿ,0,0,1,1
34999,assert,0,0,1,1
34998,publique,0,0,1,1
34997,relacione,0,0,1,1
51626,programın,0,0,1,1
34996,അതിശക്തമായ,0,0,1,1
34995,സഹായിക്കാനായി,0,0,1,1
34994,kvalitetssäkring,0,0,1,1
34993,betarask •,0,0,1,1
34992,நிறுவனத்தால்,0,0,1,1
34991,symboliques,0,0,1,1
34989,placements,0,0,1,1
34987,مقالات،,0,0,1,1
34986,utilização,0,0,1,1
34985,"
ताजिक",0,0,1,1
34984,accountability,0,0,1,1
34983,تحديداً,0,0,1,1
35006,« featured,0,0,1,1
35007,alemãode,0,0,1,1
35008,nutzen,0,0,1,1
35016,bulacaksınız,0,0,1,1
51608,വേരുകൾ,0,0,1,1
51609,graphes,0,0,1,1
35023,minderårig,0,0,1,1
51610,പ്രാവീണ്യമുള്ളവരാകാനുള്ള,0,0,1,1
51612,kop,0,0,1,1
51613,fishing,0,0,1,1
35020,фигурами,0,0,1,1
35019,brandväggen,0,0,1,1
35018,الاحتجاجات,0,0,1,1
51616,വീട്ടിലെത്തിയതായും,0,0,1,1
35015,parar,0,0,1,1
35009,consideran,0,0,1,1
35014,вдохновлённые,0,0,1,1
35013,സമർപ്പിക്കപ്പെട്ടിരിക്കുന്നു,0,0,1,1
51618,സുഹൃത്തിനോട്,0,0,1,1
51619,வைத்திருப்பது,0,0,1,1
51620,superar,0,0,1,1
51621,finder,0,0,1,1
35012,يجعلني,0,0,1,1
35011,مخاوف,0,0,1,1
35010,exploitée,0,0,1,1
51623,brook,0,0,1,1
51627,извлечением,0,0,1,1
51628,neiging,0,0,1,1
34982,teceu,0,0,1,1
34946,brauche,0,0,1,1
34954,ஓர்,0,0,1,1
34953,ficam,0,0,1,1
34952,zwaaiden,0,0,1,1
51642,matière « chaque,0,0,1,1
34951,താൽപ്പര്യമില്ലെങ്കിൽ,0,0,1,1
51643,konusunda,0,0,1,1
34950,динамика,0,0,1,1
34949,التعليقات,0,0,1,1
34948,выпустить,0,0,1,1
34947,verdenskrig,0,0,1,1
51644,reptiles,0,0,1,1
34956,eliminação,0,0,1,1
34944,vikipedisine,0,0,1,1
34942,википедиях,0,0,1,1
34941,edilmiş,0,0,1,1
34940,تسمية,0,0,1,1
34939,respekterar,0,0,1,1
34937,vidare,0,0,1,1
34936,constara,0,0,1,1
34935,pricing,0,0,1,1
51652,observadores,0,0,1,1
34932,menge,0,0,1,1
34955,विकिज़नानी,0,0,1,1
34957,alimentar,0,0,1,1
34978,served,0,0,1,1
34968,generated,0,0,1,1
34977,versies,0,0,1,1
34976,كتابه,0,0,1,1
34975,creëren,0,0,1,1
34974,amusante,0,0,1,1
51631,akademisk,0,0,1,1
34972,introduzida,0,0,1,1
34971,அரண்மனையில்,0,0,1,1
34970,விடய,0,0,1,1
34969,आना,0,0,1,1
51632,പ്രവർത്തകർ,0,0,1,1
51634,явно,0,0,1,1
51641,ज़ेड,0,0,1,1
34966,moois,0,0,1,1
34965, ومؤسسة,0,0,1,1
34964,организацией,0,0,1,1
51637,eklenebilmesine,0,0,1,1
34963,deadnames,0,0,1,1
34962,diamonds,0,0,1,1
51639,innebar,0,0,1,1
34960,yanında,0,0,1,1
51640,rendueles,0,0,1,1
34958,semejanza,0,0,1,1
34825,værre,0,0,1,1
51727,तुम।,0,0,1,1
34824,doll,0,0,1,1
34823,мобильным,0,0,1,1
34718,совершённое,0,0,1,1
51811,tediosas,0,0,1,1
34717,‘இறங்கு,0,0,1,1
34716,robotics,0,0,1,1
34715,levebröd,0,0,1,1
34714,esbozo,0,0,1,1
51812,vedalaşmadan,0,0,1,1
51813,ಜೋಸೆಫ್,0,0,1,1
51814,ужасна,0,0,1,1
34711,binnenkort,0,0,1,1
34710,وهناك,0,0,1,1
51815,rotord,0,0,1,1
51816,ഹീബ്രു,0,0,1,1
34709,سيناريو,0,0,1,1
34708,kullanılabilir,0,0,1,1
34707,ஒப்புக்கொள்ள,0,0,1,1
51818,സെൽ,0,0,1,1
51819,sont ,0,0,1,1
51820,malo,0,0,1,1
34705,jugé,0,0,1,1
34703,checked,0,0,1,1
34702,அனுபவங்களைத்,0,0,1,1
34700,oficinas,0,0,1,1
34719,nerdy,0,0,1,1
34720,voorstel,0,0,1,1
34722,подкреплением,0,0,1,1
34733,ಉಸಿರಾಡಲು,0,0,1,1
34741,വിഷമിപ്പിക്കരുതെന്ന്,0,0,1,1
34740,däremot,0,0,1,1
51796,inovação,0,0,1,1
51797,पिला,0,0,1,1
51798,kæpheste,0,0,1,1
51799,ಬಯಸುವಿರಾ,0,0,1,1
34737,लेखकों,0,0,1,1
34734,общее,0,0,1,1
51801,صغيرًا,0,0,1,1
51803,identifique,0,0,1,1
34732,பெற்றுள்ளேன்,0,0,1,1
34723,halvautomatiserade,0,0,1,1
51805,californie,0,0,1,1
34730,അന്താരാഷ്ട്ര,0,0,1,1
34729,spécialisés,0,0,1,1
34728,நினைத்துப்,0,0,1,1
34727,rentré,0,0,1,1
51807,ю,0,0,1,1
51809,adivinara,0,0,1,1
34726,l’accessibilité,0,0,1,1
34725,sondage,0,0,1,1
34724,மூளையைச்,0,0,1,1
34699,ಆವರಿಸಬಹುದೇ,0,0,1,1
51821,сообщается,0,0,1,1
51825,votes,0,0,1,1
34666,investigaciones,0,0,1,1
51847,सतत,0,0,1,1
34674,അറിയാമെങ്കിൽ,0,0,1,1
34673,geluksvogel,0,0,1,1
34671,حديقتهم,0,0,1,1
51849,eleita,0,0,1,1
34670,izinli,0,0,1,1
34669,transmitiu,0,0,1,1
34668,സംഭവിക്കാം,0,0,1,1
34667,شئ,0,0,1,1
51850,pisar,0,0,1,1
34664,geophysiological,0,0,1,1
34675,overbrugt,0,0,1,1
34663,bilgilerden,0,0,1,1
34662,romantique,0,0,1,1
34661,lächeln,0,0,1,1
34660,χαρούμενος,0,0,1,1
51852,قبيح,0,0,1,1
34658,professionnelle,0,0,1,1
34657,köpek,0,0,1,1
34656,identitet,0,0,1,1
34654,யோசிக்கிறேன்,0,0,1,1
51854,रुके,0,0,1,1
51844,இரகசியமாக,0,0,1,1
34676,conduits,0,0,1,1
34697,målgruppe,0,0,1,1
51831,المذاق,0,0,1,1
51826,repris,0,0,1,1
51827,narcisini,0,0,1,1
34695,birisinin,0,0,1,1
34694,finalidade,0,0,1,1
34693,ക്ഷീണവും,0,0,1,1
34692,சொல்,0,0,1,1
51829,കൊടുക്കുന്നു,0,0,1,1
34690,ಪೋರ್ಟಲ್,0,0,1,1
51830,நினைத்தாள்,0,0,1,1
34689,объясните,0,0,1,1
51833,പ്രശ്നമില്ല,0,0,1,1
34677,ಕೊರತೆಯನ್ನು,0,0,1,1
51834,donantes,0,0,1,1
34686,புகழ்பெற்ற,0,0,1,1
51835,convergentes,0,0,1,1
34683,வேர்,0,0,1,1
51836,ತಮಾಷೆಯಾಗಿದೆ,0,0,1,1
51838,overdrijven,0,0,1,1
34679,ബന്ധങ്ങൾ,0,0,1,1
51840,комто,0,0,1,1
34678,contextualization,0,0,1,1
51842,uger,0,0,1,1
51794,помещаю,0,0,1,1
34742,paramètres,0,0,1,1
51792,wikiprogramvara,0,0,1,1
34795,إداريي,0,0,1,1
34804,avancerad,0,0,1,1
34803,réparations,0,0,1,1
34801,«сообщить,0,0,1,1
34800,تضمن,0,0,1,1
34799,skyldiga,0,0,1,1
34798,extensões,0,0,1,1
51746,spring,0,0,1,1
51747,престижны,0,0,1,1
51748,preguntaron,0,0,1,1
34796,أكله,0,0,1,1
34794,تخريب,0,0,1,1
51745,classificação,0,0,1,1
51749,эмбриональноподобное,0,0,1,1
34793,grundtankarna,0,0,1,1
34792,быстрые,0,0,1,1
34791,хихикала,0,0,1,1
34790,बोलियों,0,0,1,1
34789,theories,0,0,1,1
51751,ಅಸಮಾಧಾನಗೊಳ್ಳದಂತೆ,0,0,1,1
51753,لتعانق,0,0,1,1
34788,बॉक्स,0,0,1,1
51754,كائنات,0,0,1,1
34805,кластеры,0,0,1,1
51744,konservativa,0,0,1,1
51755,noyade,0,0,1,1
51735,ನಾರ್ಸಿಸಿಯ,0,0,1,1
51728,descobrem,0,0,1,1
51729,notskrift,0,0,1,1
34822,abd,0,0,1,1
34821,risques,0,0,1,1
34820,gérés,0,0,1,1
51730,misspellings,0,0,1,1
51731,tested,0,0,1,1
51732,enenciclopedia,0,0,1,1
51734,உயர்வு,0,0,1,1
34816,domestic,0,0,1,1
51739,autonomous,0,0,1,1
34806,ಅದ್ಭುತವಾಗಿ,0,0,1,1
34813,iseniz,0,0,1,1
34812,precedentes,0,0,1,1
34811,zweedstalige,0,0,1,1
51740,wikia,0,0,1,1
51741,выглядит,0,0,1,1
51743,ковариацией,0,0,1,1
34810,ಕುಳಿತಳು,0,0,1,1
34809,καροτσάκι,0,0,1,1
34808,gränssnitt,0,0,1,1
34807,ब्लॉक,0,0,1,1
34787,പാമരനും,0,0,1,1
34785,asien,0,0,1,1
51791,strenge,0,0,1,1
51782,तुम्हे,0,0,1,1
51775,നാമെല്ലാവരും,0,0,1,1
51776,comboio,0,0,1,1
51777,infinie,0,0,1,1
51778,missvisande,0,0,1,1
51779,сложную,0,0,1,1
34758,سن,0,0,1,1
51780,başlıca,0,0,1,1
51781,contribuciones,0,0,1,1
34755,dağıtılması,0,0,1,1
34754,நண்பர்களாக,0,0,1,1
34752,существенное,0,0,1,1
34762,seawater,0,0,1,1
34751,comentando,0,0,1,1
51785,arwid,0,0,1,1
51786,കോളിൽ,0,0,1,1
51788,weakly,0,0,1,1
51789,satisfactorios,0,0,1,1
34748,workaround,0,0,1,1
51790,சாதாரண,0,0,1,1
34746,británica»,0,0,1,1
34745,improvement,0,0,1,1
34744,duymuşsanız,0,0,1,1
51774,വിജ്ഞാനതൃഷ്ണയുമുള്ള,0,0,1,1
34763,espéranto,0,0,1,1
34783,निरंतर,0,0,1,1
34777,pudiendo,0,0,1,1
51758,изданием,0,0,1,1
34782,തിരികെ,0,0,1,1
51759,чей,0,0,1,1
51760,connectivity,0,0,1,1
51761,mercis,0,0,1,1
51762,ενημέρωσης,0,0,1,1
51763,obtén,0,0,1,1
34779,wijdde,0,0,1,1
51764,شكل,0,0,1,1
34778,ശ്വസിക്കാൻ,0,0,1,1
51767,hösten,0,0,1,1
34764,exhibiting,0,0,1,1
34774,الإجابة,0,0,1,1
51769,ലാബിൽ,0,0,1,1
34772,عليه,0,0,1,1
51771,einde,0,0,1,1
34770,നാർസിസയെക്കുറിച്ചും,0,0,1,1
34769,കാണപ്പെട്ടു,0,0,1,1
51772,مقتبساً,0,0,1,1
34767,पुरुषों,0,0,1,1
34766,uzatır,0,0,1,1
34765,உள்ளடக்கங்களையும்,0,0,1,1
34288,månader,0,0,1,1
52158,கருத்தொருமிப்பின்,0,0,1,1
36478,culminate,0,0,1,1
33816,mantidos,0,0,1,1
52511,syntaxiques,0,0,1,1
33791,ಸ್ನೇಹಿತನನ್ನು,0,0,1,1
33790,ചതുപ്പുനിലത്ത്,0,0,1,1
52512,mutación,0,0,1,1
33788,ميتشيل,0,0,1,1
33787,pertenecen,0,0,1,1
52513,ನಿಧಾನವಾಗಿರುತ್ತದೆ,0,0,1,1
52514,ഒരർത്ഥത്തിൽ,0,0,1,1
52515,overal,0,0,1,1
33782,fortsætter,0,0,1,1
52516,combien,0,0,1,1
33781,основными,0,0,1,1
33780,utiliza,0,0,1,1
33779,കൃത്രിമം,0,0,1,1
33778,grind,0,0,1,1
52520,skede,0,0,1,1
33777,kretsar,0,0,1,1
52521,relatada,0,0,1,1
33774,вашем,0,0,1,1
52522,считать,0,0,1,1
52523,എന്തൊരു,0,0,1,1
33771,avançados,0,0,1,1
33770,повторения,0,0,1,1
52508,неестественно,0,0,1,1
33794,ответами,0,0,1,1
52507,enregistré,0,0,1,1
33806,pretty,0,0,1,1
33814,تشجيعاً,0,0,1,1
33813,faktamässigt,0,0,1,1
52489,cosmic,0,0,1,1
52490,கட்டிப்பிடிக்க,0,0,1,1
52491,liberal,0,0,1,1
33809,ஐகானைக்,0,0,1,1
52492,lyden,0,0,1,1
52493,discutezen,0,0,1,1
52494,أجزاء,0,0,1,1
33807,brisés,0,0,1,1
33805,svagt,0,0,1,1
33796,للمحتوى,0,0,1,1
52495,searches,0,0,1,1
33803,somalí,0,0,1,1
52497,ушли,0,0,1,1
52498,phd,0,0,1,1
33798,belirterek,0,0,1,1
52499,स्वाभाविक,0,0,1,1
52500,gustaban,0,0,1,1
52504,circulação,0,0,1,1
52505,reconhecida,0,0,1,1
52506,supérieures,0,0,1,1
33769,तलाश,0,0,1,1
33768,intermingled,0,0,1,1
52524,wikieditáveis,0,0,1,1
33736,cuadro,0,0,1,1
33743,palats,0,0,1,1
33742,searching,0,0,1,1
52547,dérangetil,0,0,1,1
52548,quisieras,0,0,1,1
52549,செயல்களைப்,0,0,1,1
52552,നിങ്ങള്ക്ക്,0,0,1,1
33738,இன்,0,0,1,1
52553,planın,0,0,1,1
52554,ಜೈಲುಗಳಲ್ಲಿ,0,0,1,1
52555,।,0,0,1,1
33735,ಸಂಭವಿಸಿದ,0,0,1,1
52546,souhaiter,0,0,1,1
33734,klokkeikonet,0,0,1,1
33733,ಪಾಠದಲ್ಲಿ,0,0,1,1
52556,ಸೈನ್ಯವು,0,0,1,1
33732,കുറിച്ചും,0,0,1,1
33731,denir,0,0,1,1
33730,ಒಂದನ್ನು,0,0,1,1
33729,ಸಂದಿಗ್ಧತೆ,0,0,1,1
52557,older,0,0,1,1
33728,मच,0,0,1,1
33727,فالكلمة,0,0,1,1
33744,അവരിലൊരാളായി,0,0,1,1
52545,ಪೂರ್ತಿ,0,0,1,1
52525,coexistir,0,0,1,1
33757,depend,0,0,1,1
33767,spiegelbeeld,0,0,1,1
33766,bureaucracy,0,0,1,1
33764,முறையான,0,0,1,1
33763,diffèrent,0,0,1,1
52528,ज़र्मन,0,0,1,1
52532,wikifiera,0,0,1,1
33761,montant,0,0,1,1
33760,γνώριζε,0,0,1,1
52534,caller,0,0,1,1
52535,അതിഭീകരരായ,0,0,1,1
52536,शुक्रवार,0,0,1,1
33747,വിക്കിയിലേക്കും,0,0,1,1
52537,funkelnden,0,0,1,1
52540,fréquentesac,0,0,1,1
33755,construite,0,0,1,1
33754,referans,0,0,1,1
52541,undesirable,0,0,1,1
33752,necesaria,0,0,1,1
52542,onderkend,0,0,1,1
33750,المعرفية،,0,0,1,1
33749,पासवर्ड,0,0,1,1
33748,प्रासंगिक,0,0,1,1
33815,ഇംഗ്ലീഷിലാണ്,0,0,1,1
33817,grown,0,0,1,1
52559,دراسات,0,0,1,1
33818,wishes,0,0,1,1
33886,bero,0,0,1,1
52433,miembro»,0,0,1,1
33883,créateur ,0,0,1,1
33882,«антиэлитарность»,0,0,1,1
52434,optaram,0,0,1,1
33881,« modes,0,0,1,1
52435,auténtico,0,0,1,1
52437,drastic,0,0,1,1
52438,genèse,0,0,1,1
33877,matando,0,0,1,1
52439,ചപ്പും,0,0,1,1
33875,förutsättning,0,0,1,1
33874,திட்டமாக,0,0,1,1
52440,cognition,0,0,1,1
33873,et •,0,0,1,1
33872,mensuelles,0,0,1,1
33871,giyinmiş,0,0,1,1
52441,கிடைக்கவேண்டும்”,0,0,1,1
33870,nda,0,0,1,1
52442,«central»,0,0,1,1
33869,incompatíveis,0,0,1,1
52443,conservar,0,0,1,1
52444,geliştirin,0,0,1,1
33887,bomis ,0,0,1,1
52429,sampling,0,0,1,1
33888,ಕಾಣಬಹುದು,0,0,1,1
33897,समन्वित,0,0,1,1
33907,generalized,0,0,1,1
52414,удалена,0,0,1,1
33905,സൂക്ഷിച്ച്,0,0,1,1
52416,återgivningsrätt,0,0,1,1
33903,ಅಭಿಪ್ರಾಯವಿಲ್ಲ,0,0,1,1
33901,signalent,0,0,1,1
52417,недостоверной,0,0,1,1
33899,bibliothèques,0,0,1,1
52419,læser,0,0,1,1
33898,ജോർജ്ജ്,0,0,1,1
52420,попрактиковаться,0,0,1,1
52428,ಉಪಯುಕ್ತ,0,0,1,1
52421,sökverktyg,0,0,1,1
33895,സഹോദരിയേ,0,0,1,1
52423,¿podrías,0,0,1,1
33892,opgestart,0,0,1,1
33891,நேரமில்லை,0,0,1,1
52425,ಸರಿಯಾಗಿದೆ,0,0,1,1
52426,clés,0,0,1,1
52427,അതിനുപകരം,0,0,1,1
33890,burası,0,0,1,1
33889,divisée,0,0,1,1
52445,taber,0,0,1,1
33865,μιλούσε,0,0,1,1
52448,grundat,0,0,1,1
52478,apoiados,0,0,1,1
52473,toptijdschriften,0,0,1,1
33834,century,0,0,1,1
33833,подтверждает,0,0,1,1
52474,notoriedade,0,0,1,1
33831,accrue,0,0,1,1
33830,magisteruppsats,0,0,1,1
33829,pourcentages,0,0,1,1
52475,uitgespookt,0,0,1,1
52476,suivantes,0,0,1,1
33826,mediação,0,0,1,1
33825,reportaje,0,0,1,1
33835,intégralement,0,0,1,1
52479,percevait,0,0,1,1
52480,κοντά,0,0,1,1
33824,independência,0,0,1,1
52481,வங்கி,0,0,1,1
52482,പുതുക്കാറുണ്ട്,0,0,1,1
33823,தொலைதூரத்தில்,0,0,1,1
52484,inner,0,0,1,1
52485,साल,0,0,1,1
52486,ഫൗണ്ടേഷൻ,0,0,1,1
33819,crossvalidation,0,0,1,1
52472,கருத்துக்,0,0,1,1
33837,مقالة،,0,0,1,1
33862,έφερα,0,0,1,1
33851,നടത്തുന്നതിൽ,0,0,1,1
52450,theme,0,0,1,1
33859,издательство,0,0,1,1
33857,предпочел,0,0,1,1
52452,грантом,0,0,1,1
52453,réf,0,0,1,1
33855,consagrados,0,0,1,1
33854,сохранить,0,0,1,1
52456,വിത്തുകൾ,0,0,1,1
33853,हफ्ते,0,0,1,1
33852,ускорить,0,0,1,1
33850,appreciation,0,0,1,1
52471,दिशानिर्देशों,0,0,1,1
52463,tvätt,0,0,1,1
33848,rubin,0,0,1,1
52464,வெளியேறினேன்,0,0,1,1
52465,ρωτήσεις,0,0,1,1
52466,المزهرة,0,0,1,1
33845,தொலைபேசியில்,0,0,1,1
52468,professors,0,0,1,1
33843,ದುರಸ್ತಿ,0,0,1,1
33840,جمالها,0,0,1,1
33839,ബുഷ്,0,0,1,1
52558,knapphändigt,0,0,1,1
52560,obtendría,0,0,1,1
34286,ದಣಿದಿದ್ದರೆ,0,0,1,1
52629,höra,0,0,1,1
33614,വിശദീകരിക്കുക,0,0,1,1
33613,specify,0,0,1,1
52645,afogamento,0,0,1,1
33611,framsteg,0,0,1,1
33610,misinformation,0,0,1,1
52646,مسافة,0,0,1,1
33609,forgets,0,0,1,1
52648,ακούστε,0,0,1,1
52649,dayan,0,0,1,1
52650,विशेषाधिकार,0,0,1,1
52651,परिष्कृत।,0,0,1,1
52652,സംരക്ഷിക്കാൻ,0,0,1,1
52653,التحيز,0,0,1,1
33605,രീതിയിലേക്ക്,0,0,1,1
33604,автор,0,0,1,1
33603,ഉപയോഗത്തിനും,0,0,1,1
52654,ಮುಂದುವರೆಸು,0,0,1,1
52655,adorável,0,0,1,1
33602,ದೀರ್ಘಕಾಲ,0,0,1,1
33601,frikostigt,0,0,1,1
33600,ξαφνιασμένος,0,0,1,1
33599,இதையெல்லாம்,0,0,1,1
33598,பங்களிப்பின்,0,0,1,1
52644,declines,0,0,1,1
33615,التلاعب,0,0,1,1
33616,ನಿಲ್ಲಿಸಬಹುದೇ,0,0,1,1
33626,hunden,0,0,1,1
33634,dispostos,0,0,1,1
52631,يتوقف,0,0,1,1
52633,ateliers,0,0,1,1
33632,யோசனை,0,0,1,1
33631,صموئيل،,0,0,1,1
33630,методами,0,0,1,1
52634,bible,0,0,1,1
33629,d’idéalisme,0,0,1,1
33628,голодаю,0,0,1,1
52637,septième,0,0,1,1
52638,adicionais,0,0,1,1
33617,крайне,0,0,1,1
52639,ortnamn,0,0,1,1
33624,entendía,0,0,1,1
52640,கலந்துரையாடல்களுக்குப்,0,0,1,1
52641,nail,0,0,1,1
52642,ಕೋಷ್ಟಕಕ್ಕೆ,0,0,1,1
52643,wikipediaappar,0,0,1,1
33621,തന്നാൽ,0,0,1,1
33620,ನೋಡಬಹುದಾದ,0,0,1,1
33619,विकिआ,0,0,1,1
33618,objectif,0,0,1,1
33597,βασικοί,0,0,1,1
52657,خطا,0,0,1,1
52660,قطعة,0,0,1,1
33560,mutsuz,0,0,1,1
52688,nãoparcialidade,0,0,1,1
33571,கூட்டாகத்,0,0,1,1
52689,utsträckning,0,0,1,1
52692,afogar,0,0,1,1
33568,isimde,0,0,1,1
33567,इसी,0,0,1,1
33566,stilzwijgend,0,0,1,1
33564,désordre,0,0,1,1
33563,оптимизации,0,0,1,1
52694,droomde,0,0,1,1
52695,grupper,0,0,1,1
52683,போர்டல்,0,0,1,1
33558,forstyrret,0,0,1,1
52697,detectados,0,0,1,1
52698,கண்டறிந்ததோடு,0,0,1,1
33557,précondition,0,0,1,1
33556,विशेषाधिकृत,0,0,1,1
33555,бедной,0,0,1,1
52699,बताएं,0,0,1,1
52701,tutuklular,0,0,1,1
52702,приписывают,0,0,1,1
33552,unterwegs,0,0,1,1
52684,spørgsmålstegn,0,0,1,1
52682,"
usbeque",0,0,1,1
52662,aylardır,0,0,1,1
52672,ऑफ,0,0,1,1
33594,ظل,0,0,1,1
33593,വാഗ്ദാനം,0,0,1,1
33592,рыцаря,0,0,1,1
33590,kullanırlar,0,0,1,1
52667,l’accent,0,0,1,1
52668,deneyimi,0,0,1,1
33588,έμαθα,0,0,1,1
33587,complétés,0,0,1,1
33584,الرغبة,0,0,1,1
52671,ஆய்வொன்று,0,0,1,1
33583,definierade,0,0,1,1
33573,"
उदाहरण",0,0,1,1
52674,θυελλώδη,0,0,1,1
52676,adequação,0,0,1,1
52677,bs •,0,0,1,1
33578,gitme,0,0,1,1
33577,corrigées,0,0,1,1
52678,dépassant,0,0,1,1
52679,traditionella,0,0,1,1
33575,dilemmasmartwörter,0,0,1,1
33574,комментарий,0,0,1,1
52681,आजादी,0,0,1,1
33635,പാടേ,0,0,1,1
33636,rumano,0,0,1,1
33725,λειτουργεί,0,0,1,1
33637,gebrek,0,0,1,1
52572,тесте,0,0,1,1
52573,ഉറപ്പാക്കപ്പെടുന്നത്‌,0,0,1,1
33701,συνεχίσω,0,0,1,1
52574,ಅವುಗಳನ್ನು,0,0,1,1
33699,acenaram,0,0,1,1
33698,ευτυχισμένος,0,0,1,1
33697,nogensinde,0,0,1,1
33695,продвижении,0,0,1,1
52577,bindi,0,0,1,1
33694,bouleversé,0,0,1,1
33692,besøge,0,0,1,1
52578,δίνω,0,0,1,1
52579,denominan,0,0,1,1
52580,extracellular,0,0,1,1
33690,свадебном,0,0,1,1
52581,നിലനിൽക്കുന്നത്,0,0,1,1
33688,लूंगा।,0,0,1,1
33686,إحدى,0,0,1,1
33685,عمومًا،,0,0,1,1
52583,“change,0,0,1,1
52584,lingüística,0,0,1,1
52585,техническое,0,0,1,1
52586,κινείσαι,0,0,1,1
33702,refletir,0,0,1,1
33703,produziu,0,0,1,1
52571,períodos,0,0,1,1
33714,держала,0,0,1,1
33724,प्यू,0,0,1,1
33723,wikipédiag,0,0,1,1
33722,யோ,0,0,1,1
33721,தெரிந்தால்,0,0,1,1
52561,förrän,0,0,1,1
33718,disposez,0,0,1,1
33717,வழங்குகின்றன,0,0,1,1
52564,बेहतरीन,0,0,1,1
52565,katılmak,0,0,1,1
33715,yapmanın,0,0,1,1
33713,betaalde,0,0,1,1
33704,glimlachen,0,0,1,1
52566,يواجه,0,0,1,1
52567,सांस,0,0,1,1
33712,endangered,0,0,1,1
33711,tomaras,0,0,1,1
52568,duits,0,0,1,1
33709,décrivait,0,0,1,1
33708,beskrivningsrutan,0,0,1,1
33707,sitta,0,0,1,1
33706,dilerim,0,0,1,1
33705,energievoorbeeld,0,0,1,1
52587,ψάχνουμε,0,0,1,1
52588,maç,0,0,1,1
52589,paylaşılmaktadır,0,0,1,1
33647,والسؤال,0,0,1,1
52608,yanar,0,0,1,1
33660,l’on,0,0,1,1
52609,faktarutor,0,0,1,1
33657,получена,0,0,1,1
33656,réutiliser,0,0,1,1
33653,« préjudice,0,0,1,1
33651,пародий,0,0,1,1
33650,калифорнии,0,0,1,1
52611,aufhörte,0,0,1,1
52612,ಕಳುಹಿಸಿದ್ದೀರಿ,0,0,1,1
52615,filtreringen,0,0,1,1
52605,преобразования,0,0,1,1
52616,gathered,0,0,1,1
33644,ansågs,0,0,1,1
33643,wikiwoordenboek,0,0,1,1
33642,ಹೇಳಬೇಕಾಗಿದೆ,0,0,1,1
52618,விதிகளை,0,0,1,1
52625,வரையில்,0,0,1,1
52627,इलाज,0,0,1,1
33639,alcanzaba,0,0,1,1
52628,فيها،,0,0,1,1
33638,извиняюсь,0,0,1,1
33661,activation,0,0,1,1
33663,sorudan,0,0,1,1
52591,बगीचे,0,0,1,1
52599,roumain,0,0,1,1
52592,arm,0,0,1,1
33681,anlatabilirsiniz,0,0,1,1
33680,ಟೈಪ್,0,0,1,1
52593,தூங்கும்போது,0,0,1,1
33679,शराबी,0,0,1,1
33678,σχολιάστε,0,0,1,1
33677,drengen,0,0,1,1
33676,обнять,0,0,1,1
52596,மாற்றங்கள்’,0,0,1,1
52598,сидишь,0,0,1,1
33674,kazanmış,0,0,1,1
33664,skönheten,0,0,1,1
52600,interdit,0,0,1,1
52601,universiteit,0,0,1,1
33673,സൂപ്പിലോ,0,0,1,1
33672,weitere,0,0,1,1
52602,betegner,0,0,1,1
33669,भली,0,0,1,1
33668,cite,0,0,1,1
52603,siglo,0,0,1,1
33666,snowpacks,0,0,1,1
52604,ഇന്ത്യയിൽ,0,0,1,1
52413,konudaki,0,0,1,1
33909,çıkmasına,0,0,1,1
52412,receitas,0,0,1,1
34196,amou,0,0,1,1
52223,documentatie,0,0,1,1
52224,användarbefogenheter,0,0,1,1
52225,المسائل,0,0,1,1
52226,bredt,0,0,1,1
34170,συχνά,0,0,1,1
34169,« sociotechnique »,0,0,1,1
34168,года»,0,0,1,1
52227,zugeben,0,0,1,1
34166,commenting,0,0,1,1
52231,notada,0,0,1,1
52232,осознанном,0,0,1,1
34162,miró,0,0,1,1
34160,peaking,0,0,1,1
52234,aired,0,0,1,1
34159,എഴുതുന്നു,0,0,1,1
34158,hp,0,0,1,1
52235,incomegenerating,0,0,1,1
34156,participatória,0,0,1,1
52236,sorulduğunda,0,0,1,1
34154,vergelijkend,0,0,1,1
52237,российскую,0,0,1,1
34152,croises,0,0,1,1
34151,நாளைக்கு,0,0,1,1
52222,തിരുത്തി,0,0,1,1
34171,существительных,0,0,1,1
52221,anfangen,0,0,1,1
52212,tischmanieren,0,0,1,1
52209,accommodation,0,0,1,1
52211,nyare,0,0,1,1
34191,истинность,0,0,1,1
34190,итальянских,0,0,1,1
34189,അതിശയകരമായി,0,0,1,1
34188,vivia,0,0,1,1
34186,"
ucraniano",0,0,1,1
34185,கொண்டாட,0,0,1,1
34184,internetencyklopædi,0,0,1,1
34183,بمثل,0,0,1,1
52214,öyle,0,0,1,1
34173,théologicopolitique,0,0,1,1
52215,ചെയ്യുന്നതിനെ,0,0,1,1
34179,yenilerinin,0,0,1,1
34178,лично,0,0,1,1
34177,nuttig,0,0,1,1
34176,минимизировать,0,0,1,1
52216,défi ,0,0,1,1
52217,kökler,0,0,1,1
52219,necesarios,0,0,1,1
34175,الاقتباس,0,0,1,1
52220,yediğim,0,0,1,1
52238,trafik,0,0,1,1
34149,serverklustren,0,0,1,1
34148,ругательства,0,0,1,1
34108,« google »,0,0,1,1
34119,resúmenes,0,0,1,1
34118,resistência,0,0,1,1
34117,جديد,0,0,1,1
34116,glædeligt,0,0,1,1
34115,diplômes,0,0,1,1
34114,துறையில்,0,0,1,1
34112,عاديًا,0,0,1,1
34111,hörnet,0,0,1,1
52257,egotistical,0,0,1,1
52258,proporcionarle,0,0,1,1
34107,hundirse,0,0,1,1
34123,graines,0,0,1,1
34105,descripción,0,0,1,1
34104,conhecidos,0,0,1,1
34103,المجتمع،,0,0,1,1
34102,narcissushand,0,0,1,1
52261,памяти,0,0,1,1
34101,beweringen,0,0,1,1
52262,كريم؟,0,0,1,1
34099,désignées,0,0,1,1
34098,zeldzaamheid,0,0,1,1
34097,påpegede,0,0,1,1
52254,forked,0,0,1,1
52253,ನೋಡುತ್ತಾ,0,0,1,1
34147,dehşet,0,0,1,1
34135,stewards,0,0,1,1
52239,ಮಾರ್ಗದಲ್ಲಿ,0,0,1,1
34145,редактируемой,0,0,1,1
34144,trist,0,0,1,1
52240,технология,0,0,1,1
34142,labyrinthine,0,0,1,1
34141,júri,0,0,1,1
52245,complutense,0,0,1,1
52246,företeelsen,0,0,1,1
34137,basada,0,0,1,1
34136,« éviter,0,0,1,1
34134,സേവന,0,0,1,1
34125,энциклопедию,0,0,1,1
52247,linjeorganisationens,0,0,1,1
52248,ശബ്ദത്തിന്റെ,0,0,1,1
52249,சிவப்பு,0,0,1,1
34131,décident,0,0,1,1
34130,pornographically,0,0,1,1
52250,exacto,0,0,1,1
52251,задание,0,0,1,1
52252,مخالف,0,0,1,1
34127,മന്ദഗതിയിലായിരുന്നു,0,0,1,1
34126,assemblée,0,0,1,1
34194,വിഷയത്തിലെ,0,0,1,1
52208,пользовательского,0,0,1,1
33911,നേതാക്കന്മാരുടെ,0,0,1,1
34197,исходным,0,0,1,1
34263,സഹായിക്കുന്നതിൽ,0,0,1,1
34262,இம்முறைமையின்,0,0,1,1
34261,установлена,0,0,1,1
34260,schatz,0,0,1,1
34259,reflektion,0,0,1,1
34258,log,0,0,1,1
52178,tratamiento,0,0,1,1
52179,ഭാഗ്യവാനായ,0,0,1,1
34257,intentionnalité,0,0,1,1
34256,continuera,0,0,1,1
52180,habitées,0,0,1,1
34253,begik,0,0,1,1
34252,ജീവിതവും,0,0,1,1
34251,dybt,0,0,1,1
34250,stinkende,0,0,1,1
34249,ഒട്ടും,0,0,1,1
34248,collagen,0,0,1,1
34247,kalmaktadır,0,0,1,1
34246,يشغل,0,0,1,1
34245,vernuftig,0,0,1,1
34244,كاذبة,0,0,1,1
34243,fellow,0,0,1,1
52184,അംഗീകരിക്കാൻ,0,0,1,1
52176,விரும்புவீர்கள்,0,0,1,1
34265,coexistia,0,0,1,1
34266,gördüğünde,0,0,1,1
52165,माइस्पेस,0,0,1,1
52160,darin,0,0,1,1
52161,desirable,0,0,1,1
52162,ஒப்புக்கொள்கிறேன்,0,0,1,1
34285,harina,0,0,1,1
34284,nécessité,0,0,1,1
34283,webbliknande,0,0,1,1
52163,остального,0,0,1,1
34282,செயற்பாடு’,0,0,1,1
34281,हीरों,0,0,1,1
34280,ഭാഗ്യവാനാണെന്ന്,0,0,1,1
52166,anglaises,0,0,1,1
52175,redaktörer,0,0,1,1
34277,ألواح,0,0,1,1
34275,богатств,0,0,1,1
52167,expenses,0,0,1,1
52169,neerleggen,0,0,1,1
52170,قرض,0,0,1,1
52171,глобальной,0,0,1,1
34271,förutsatt,0,0,1,1
34270,«wikiality»,0,0,1,1
34269,ചോദിക്കാൻ‌,0,0,1,1
34268,கவனிக்க,0,0,1,1
34242,ಕುತೂಹಲಕಾರಿ,0,0,1,1
34241,annuaire,0,0,1,1
52186,ansigt,0,0,1,1
34207,supposons,0,0,1,1
34216,factibles,0,0,1,1
52202,المستخدمون,0,0,1,1
34215,refoulée,0,0,1,1
34214,tillförda,0,0,1,1
34213,ഐക്കണും,0,0,1,1
34212,silabarios,0,0,1,1
34211,بمصادر,0,0,1,1
34210,acontecido,0,0,1,1
34209,മത്സരം,0,0,1,1
34208,endeavor,0,0,1,1
34206,الإطلاق،,0,0,1,1
34217,haklarından,0,0,1,1
34205,«будущее,0,0,1,1
52203,கண்டுபிடிப்பு,0,0,1,1
34204,വിശ്വാസയോഗ്യമായ,0,0,1,1
52204,русскоязычной,0,0,1,1
34202,traeré,0,0,1,1
34201,wikimodellen,0,0,1,1
52205,vivaient,0,0,1,1
34200,программ,0,0,1,1
34198,sustantivo,0,0,1,1
52207,spitz,0,0,1,1
52200,أنا؟,0,0,1,1
52199,genéticos,0,0,1,1
52187,«espejos»—,0,0,1,1
34228,wiktionnaire,0,0,1,1
52188,l’occident,0,0,1,1
52189,göreceli,0,0,1,1
34237,detuvo,0,0,1,1
34235,aplicálas,0,0,1,1
34234,جاءت,0,0,1,1
34233,पूर्ण,0,0,1,1
52192,proportionnellement,0,0,1,1
34231,privileged,0,0,1,1
34230,influir,0,0,1,1
34229,المهمة,0,0,1,1
34227,civilisé,0,0,1,1
52198,verdrink,0,0,1,1
52193,പാവം,0,0,1,1
34225,الذاتية,0,0,1,1
34224,أبريل,0,0,1,1
52194,doméstico,0,0,1,1
34222,bidrage,0,0,1,1
34221,removing,0,0,1,1
34220,görüyorsunuz,0,0,1,1
52195,символ,0,0,1,1
34218,tust,0,0,1,1
52196,контентомкомм,0,0,1,1
52263,ಕಾಮೆಂಟ್,0,0,1,1
52266,സംഘം,0,0,1,1
52267,gmt,0,0,1,1
34095,moldar,0,0,1,1
33976,комитеты,0,0,1,1
33975,einkaufszentrum,0,0,1,1
33974,ಉದಾಹರಣೆಗಳನ್ನು,0,0,1,1
33973,verifiera,0,0,1,1
33972,بإغرائهم,0,0,1,1
52360,ошибок,0,0,1,1
33970,qu’on,0,0,1,1
52361,உருவாக்கினார்,0,0,1,1
33969,കാണിക്കാൻ,0,0,1,1
33968,plagieringar,0,0,1,1
33967,കണ്ണടച്ചു,0,0,1,1
33966,plaignants,0,0,1,1
52362,no—,0,0,1,1
52363,importara,0,0,1,1
33965,izquierdista,0,0,1,1
52364,sobrenome,0,0,1,1
33964,യാന്ത്രികമായാണ്,0,0,1,1
52366,шекманом,0,0,1,1
33962,опубликовали,0,0,1,1
52367,proíbe,0,0,1,1
52369,ಪ್ರಯತ್ನಿಸುವಾಗ,0,0,1,1
33961,eylem,0,0,1,1
33960,meertalige,0,0,1,1
52359,നടത്തിയ,0,0,1,1
33977,gevoel,0,0,1,1
52356,televisión,0,0,1,1
33990,otobüsümüz,0,0,1,1
52340,wikinoticias,0,0,1,1
34002,важнейших,0,0,1,1
52341,‎wikipidia‏؛,0,0,1,1
33999,inserida,0,0,1,1
52342,избранные,0,0,1,1
33996,militent,0,0,1,1
33993,« lois »,0,0,1,1
52346,объектов,0,0,1,1
33992,неэкспертами,0,0,1,1
33991,идеологической,0,0,1,1
52347,οδηγίες,0,0,1,1
52355,النشر,0,0,1,1
33988,ips,0,0,1,1
52349,любую,0,0,1,1
33985,نسوا,0,0,1,1
52350,tagits,0,0,1,1
33983,hergebruikt,0,0,1,1
52351,recognizing,0,0,1,1
52352,बचाव,0,0,1,1
52354,negativas,0,0,1,1
33980,ಪ್ರದೇಶವನ್ನು,0,0,1,1
33979,βγήκε,0,0,1,1
52370,femme,0,0,1,1
33959,congé,0,0,1,1
52372,bienfondé,0,0,1,1
52404,персоналом,0,0,1,1
52395,வெளியிடுவதாகவே,0,0,1,1
52396,правительственных,0,0,1,1
52397,совокупность,0,0,1,1
33929,популярное,0,0,1,1
52399,dağıtım,0,0,1,1
52400,uncertainty,0,0,1,1
52401,vocation,0,0,1,1
33926,കുഴഞ്ഞുമറിഞ്ഞ,0,0,1,1
33925,gaming,0,0,1,1
33924,പോലെയുള്ള,0,0,1,1
52405,ريتشارد,0,0,1,1
33932,ചാനലായ,0,0,1,1
52406,பெட்டியில்,0,0,1,1
33923,வகைப்படுத்தப்படும்,0,0,1,1
52407,cunhou,0,0,1,1
33922,വിക്കിപീഡിയരുണ്ട്,0,0,1,1
33920,rösttonen,0,0,1,1
52409,weggeschickt,0,0,1,1
33918,corresponding,0,0,1,1
33915,hävde,0,0,1,1
33914,தேவதூதருடன்,0,0,1,1
33913,تقولها,0,0,1,1
52392,skyldig,0,0,1,1
33933,மிகப்பெரும்,0,0,1,1
33958,പെരുവെള്ളം,0,0,1,1
33946,mata,0,0,1,1
33956,ocidental,0,0,1,1
52376,proclamé,0,0,1,1
52377,målet,0,0,1,1
52378,actives,0,0,1,1
33952,fantastic,0,0,1,1
52380,يحالف,0,0,1,1
52381,сложно,0,0,1,1
33949,enseignements,0,0,1,1
52382,ஸ்லாஷ்டாட்,0,0,1,1
33947,geträumt,0,0,1,1
52383,sängmamma,0,0,1,1
33934,உற்சாகமாக,0,0,1,1
52384,mêmes,0,0,1,1
33942,vermeiden,0,0,1,1
33941,χάσει,0,0,1,1
33940,σκοπός,0,0,1,1
33939,digestive,0,0,1,1
33938,மார்ச்,0,0,1,1
52387,नेगोशिएशन,0,0,1,1
33935,faisait,0,0,1,1
52390,prepubescent,0,0,1,1
52391,വേർതിരിക്കുന്നത്,0,0,1,1
52339,പേരുകേട്ടതാണ്,0,0,1,1
52337,разработанную,0,0,1,1
52336,ಹೇಳಿದೆ,0,0,1,1
34061,الانتقادات,0,0,1,1
52282,редактором,0,0,1,1
34069,financière,0,0,1,1
52283,ναρκίσσους,0,0,1,1
52284,mande,0,0,1,1
34067,ಮೇಲಿನಿಂದ,0,0,1,1
34066,സോഫ്റ്റ്,0,0,1,1
52285,പട്ടിണി,0,0,1,1
52287,continent,0,0,1,1
34063,liebes,0,0,1,1
52289,articlecreating,0,0,1,1
52290,olmayı,0,0,1,1
34070,corée,0,0,1,1
52291,teman,0,0,1,1
34059,написал,0,0,1,1
34058,religion,0,0,1,1
52296,ചേരുന്നവരെ,0,0,1,1
34056,δύσκολη,0,0,1,1
34054,oficiales,0,0,1,1
52298,« instruction »,0,0,1,1
52300,الأفارقة,0,0,1,1
34052,semantiska,0,0,1,1
34051,especificados,0,0,1,1
52281,एम्स्टरडाम,0,0,1,1
34071,automatique »,0,0,1,1
52304,ederiz,0,0,1,1
52268,பிரதிபலிப்பில்,0,0,1,1
34094,assisté,0,0,1,1
34093,exposer,0,0,1,1
34092,университет,0,0,1,1
34091,வேண்டுமானாலும்,0,0,1,1
34090,egípcio,0,0,1,1
34089,जी,0,0,1,1
34088,wilderness—wild,0,0,1,1
34087,”machine,0,0,1,1
34086,tidens,0,0,1,1
34085,saúde,0,0,1,1
34083,dime,0,0,1,1
34072,relación,0,0,1,1
34081,примерно,0,0,1,1
52274,cadeau,0,0,1,1
34078,ಹಣವಿದೆ,0,0,1,1
34077,lægge,0,0,1,1
34076,knowing,0,0,1,1
52275,voordeel,0,0,1,1
52276,διαδικτυακή,0,0,1,1
34075,википе́дия,0,0,1,1
52277,نومها,0,0,1,1
52278,செயல்படுகிறீர்களானால்,0,0,1,1
52303,semiprotected,0,0,1,1
34049,dimension,0,0,1,1
34006,ersättning,0,0,1,1
34015,النيويورك,0,0,1,1
52321,universitetsnivå,0,0,1,1
34025,termes,0,0,1,1
52322,ತೋರುತ್ತೇವೆ,0,0,1,1
52323,συμμετεχόντων,0,0,1,1
34022,sonraları,0,0,1,1
52325,brotbrot,0,0,1,1
34019,clasificado,0,0,1,1
34018,ಖಂಡಿತ,0,0,1,1
52327,дорогое,0,0,1,1
34016,ಶಿಕ್ಷಕನು,0,0,1,1
34014,المتباينة,0,0,1,1
52320,рисунками,0,0,1,1
52330,humanidad,0,0,1,1
52331,medlingsärenden,0,0,1,1
34013,ಕಿರುನಗೆ,0,0,1,1
52332,severos,0,0,1,1
52333,biophysique,0,0,1,1
34011,эпично,0,0,1,1
34009,planlıyorum,0,0,1,1
52334,cached,0,0,1,1
34008,accusant,0,0,1,1
52335,liminar,0,0,1,1
34026,equivocarse,0,0,1,1
52319,licenseനാൽ,0,0,1,1
52305,läste,0,0,1,1
34037, تم,0,0,1,1
52307,prevented,0,0,1,1
34047,कोवेन,0,0,1,1
34046,الشعبية,0,0,1,1
34045,entities,0,0,1,1
34044,മെല്ലിയെക്കുറിച്ച്,0,0,1,1
52309,வெளியேறுகிறேன்,0,0,1,1
34042,ನೆಡಲು,0,0,1,1
34041,slepend,0,0,1,1
34040,ലക്ഷത്തിൽ,0,0,1,1
34038,ನೋಡಲು,0,0,1,1
34036,обучаемой,0,0,1,1
34028,diagnostics,0,0,1,1
34035,διασχίζετε,0,0,1,1
34034,iniciada,0,0,1,1
34033,photography,0,0,1,1
52311,dört,0,0,1,1
52312,σ,0,0,1,1
52313,pas »,0,0,1,1
52314,forbi,0,0,1,1
52315,baker,0,0,1,1
34030,«уловка»,0,0,1,1
52316,വീട്ടിലെത്തിയപ്പോൾ,0,0,1,1
35025,κάστρο,0,0,1,1
51607,அமர்ந்திருக்கிறார்கள்,0,0,1,1
51606,ലഭിക്കുമ്പോൾ,0,0,1,1
50846,traduite,0,0,1,1
36015,स्तब्ध,0,0,1,1
36014,البيانات،,0,0,1,1
36013,quieras,0,0,1,1
50863,അവലംബങ്ങളുംഉരുൾപൊട്ടൽ,0,0,1,1
50865,disséquées,0,0,1,1
50866,مساء,0,0,1,1
50867,dagar,0,0,1,1
50868,gosto,0,0,1,1
36009,أهلاً,0,0,1,1
36008,कहे,0,0,1,1
36007,ιανουάριο,0,0,1,1
50870,பிரிந்து,0,0,1,1
36006,frais,0,0,1,1
50871,dağarcığınızı,0,0,1,1
36005,പോകുന്നുവെങ്കിൽ,0,0,1,1
36004,உணவுகள்,0,0,1,1
36003,संपर्क,0,0,1,1
50872,bekleyin,0,0,1,1
50874,forem,0,0,1,1
36002,families,0,0,1,1
50875,redirecionamento,0,0,1,1
35999,классифицировать,0,0,1,1
50876,нахожусь,0,0,1,1
50860,ಸಂಬಂಧವಿದೆ,0,0,1,1
50859,câncer,0,0,1,1
36018,acontece,0,0,1,1
36029,confiaron,0,0,1,1
36038,المال,0,0,1,1
36037,energiebeispiel,0,0,1,1
50848,atribuídos,0,0,1,1
36035,​​du,0,0,1,1
36034,katılım,0,0,1,1
36033,"
दुनिया",0,0,1,1
36032,ಪದ್ಧತಿಗಳಿಂದ,0,0,1,1
50849,سانجر،,0,0,1,1
36030,ഒറ്റ,0,0,1,1
50850,vagonun,0,0,1,1
36028,tilted,0,0,1,1
50858,contrebande,0,0,1,1
50851,inedible,0,0,1,1
36026,reject,0,0,1,1
36025,fängelser,0,0,1,1
36023,കാഴ്ചപ്പാടുകളെ,0,0,1,1
50853,correctoras,0,0,1,1
50855,ατόμου,0,0,1,1
50856,ക്രിയാപദം,0,0,1,1
36020,மைஸ்பேஸ்,0,0,1,1
36019,samtalet,0,0,1,1
50857,понятия,0,0,1,1
50877,hyldede,0,0,1,1
50878,d’administration,0,0,1,1
50879,frø,0,0,1,1
35957,veranderd,0,0,1,1
50897,توم,0,0,1,1
35970,спектр,0,0,1,1
35969,alemães,0,0,1,1
35968,многими,0,0,1,1
35967,defendem,0,0,1,1
35965,toetsing,0,0,1,1
35964,ബീഹാറി,0,0,1,1
35962,نقلاً,0,0,1,1
50900,имевшихся,0,0,1,1
35958,mümkündür,0,0,1,1
35956,fanger,0,0,1,1
35972,titeln,0,0,1,1
35955,bütün,0,0,1,1
35953,έσπασαν,0,0,1,1
50903,consciousness,0,0,1,1
35950,சொற்றொடர்களைப்,0,0,1,1
35949,confiance,0,0,1,1
35948,политической,0,0,1,1
35947,congratulating,0,0,1,1
35946,trykke,0,0,1,1
50905,आलू,0,0,1,1
50906,basado,0,0,1,1
50895,управление,0,0,1,1
35974,λατινικές,0,0,1,1
35996,opslagruimte,0,0,1,1
35986,tröskeln,0,0,1,1
50881,للعربية,0,0,1,1
35995,exportar,0,0,1,1
35994,प्रकरण,0,0,1,1
35993,l’automatisation,0,0,1,1
50883,كلي,0,0,1,1
50885,εξασκηθείτε,0,0,1,1
35990,bezighoudt,0,0,1,1
35989,προχωρήσεις,0,0,1,1
35988,മാർഗദർശിത,0,0,1,1
35987,"l
किसी",0,0,1,1
50886,разделом,0,0,1,1
50894,organic,0,0,1,1
35985,кодом,0,0,1,1
50888,somente,0,0,1,1
35983,பிட்,0,0,1,1
50889,മാർച്ച്,0,0,1,1
35981,ongelukkig,0,0,1,1
50891,ഉദാഹരണം,0,0,1,1
35978,noncollege,0,0,1,1
35977,"
फरवरी",0,0,1,1
35976,ζητήσει,0,0,1,1
50893,بمعلومات,0,0,1,1
36039,நன்றாகப்,0,0,1,1
36040,ρουμπίνια,0,0,1,1
35943,decisivas,0,0,1,1
50845,actors,0,0,1,1
36102,любила,0,0,1,1
50786,erfarenhet,0,0,1,1
50787,मैच,0,0,1,1
36100,geçmeniz,0,0,1,1
50793,förklara,0,0,1,1
36099,लेंग्वेज,0,0,1,1
50794,അളവിലുള്ള,0,0,1,1
50795,inscrits,0,0,1,1
36097,വെയ്കാനും,0,0,1,1
36096,அழைப்பில்,0,0,1,1
36095,eqdfw,0,0,1,1
50796,cherche,0,0,1,1
50798,принято,0,0,1,1
50799,stadt,0,0,1,1
36094,मिली,0,0,1,1
50801,الأيديولوجية,0,0,1,1
36092,matérielle,0,0,1,1
50804,ay,0,0,1,1
36091,வாக்கெடுப்பும்,0,0,1,1
50806,பானத்துடன்,0,0,1,1
36089,opkijken,0,0,1,1
36087,hierher,0,0,1,1
36086,haftalarca,0,0,1,1
50785,renforcement,0,0,1,1
36104,أتساءل,0,0,1,1
50784,وتحريك,0,0,1,1
50775,сну,0,0,1,1
50769,parlementaires,0,0,1,1
50770,dumt,0,0,1,1
50771,சிரிக்கத்,0,0,1,1
50772,hizo,0,0,1,1
36121,especializadas,0,0,1,1
36120,d’inclure,0,0,1,1
36119,document,0,0,1,1
36118,مفيدًا,0,0,1,1
36117,httpskryptering,0,0,1,1
50774,англоязычную,0,0,1,1
50777,إنترويكي،,0,0,1,1
50783,interpretive,0,0,1,1
50778,попросить,0,0,1,1
36113,репутацией,0,0,1,1
36112,построения,0,0,1,1
36111,उतने,0,0,1,1
50780,lustigen,0,0,1,1
36110,checking,0,0,1,1
50781,basit,0,0,1,1
36108,sıfatlar,0,0,1,1
36107,цитировано,0,0,1,1
50782,draft,0,0,1,1
36085,réparation,0,0,1,1
36084,ಗೆಳೆಯನಿಗೆ,0,0,1,1
36083,teklif,0,0,1,1
50840,verschilt,0,0,1,1
50833,വന്ന്,0,0,1,1
50836,विध्वंसप्रवण,0,0,1,1
50837,ಕೊನೆಯಲ್ಲಿ,0,0,1,1
36059,anger,0,0,1,1
36058,descubiertos,0,0,1,1
50838,élaboration,0,0,1,1
50839,initiating,0,0,1,1
36054,filtrering,0,0,1,1
36053,knolकृपया,0,0,1,1
36052,ನಡತೆ,0,0,1,1
36051,abertos,0,0,1,1
50830,formateret,0,0,1,1
36050,ஏற்றுக்கொள்ள,0,0,1,1
36049,disruptively,0,0,1,1
36048,μείνε,0,0,1,1
36047,sondés,0,0,1,1
50841,персонаж,0,0,1,1
36044,सम्नाक्ष,0,0,1,1
36043,matériels,0,0,1,1
50842,അയയ്ക്കും,0,0,1,1
50843,nylige,0,0,1,1
36041,invested,0,0,1,1
50831,physicians,0,0,1,1
50829,செல்வங்களுக்கு,0,0,1,1
36082,கூறுகிறது,0,0,1,1
36073,നാല്പത്തഞ്ച്,0,0,1,1
50808,sete,0,0,1,1
50809,ويصفون,0,0,1,1
50810,biografen,0,0,1,1
50811,سأخذه,0,0,1,1
50814,describing,0,0,1,1
50815,வைரங்களில்,0,0,1,1
36077,وجهي,0,0,1,1
36076,λογότυπο,0,0,1,1
50817,नोट,0,0,1,1
36074,സ്വാഭാവികമായും,0,0,1,1
36071,anonymity,0,0,1,1
50827,لطلب,0,0,1,1
36070,ಪಡೆದಾಗ,0,0,1,1
50819,പരുഷമായി,0,0,1,1
50820,beweerde,0,0,1,1
50821,ഇവർ,0,0,1,1
36069,موثوقة،,0,0,1,1
36068,codificación,0,0,1,1
36066,साक्षात्कार,0,0,1,1
50825,يكتبه,0,0,1,1
36064,φανταχτερά,0,0,1,1
50826,bokstavligen,0,0,1,1
35944,acelerou,0,0,1,1
35942,reminds,0,0,1,1
35027,இழுக்கவும்,0,0,1,1
35853,overdrive,0,0,1,1
35828,σιγουρευτείτε,0,0,1,1
35827,يخبار,0,0,1,1
35826,avslöjande,0,0,1,1
35825,கட்டுரையொன்றை,0,0,1,1
35824,рад,0,0,1,1
35822,caes,0,0,1,1
35821,wikiprocedurerne,0,0,1,1
50993,ayudarte,0,0,1,1
35817,ستعيش,0,0,1,1
50995,solle,0,0,1,1
35815,gemeten,0,0,1,1
50996,επιτύχει,0,0,1,1
50997,"
वेल्स",0,0,1,1
35813,владеет,0,0,1,1
35812,auktoriteten,0,0,1,1
50998,kæmpede,0,0,1,1
35811,encoding,0,0,1,1
35810,ακόμη,0,0,1,1
35808,எப்படியிருந்தாலும்,0,0,1,1
51001,prøver,0,0,1,1
51002,gjord,0,0,1,1
35807,пришел,0,0,1,1
51005,चुनौती,0,0,1,1
35829,കൃത്യമായൊരു,0,0,1,1
50990,ലൈബ്രറി,0,0,1,1
35830,aceptación,0,0,1,1
35841,ठंडी,0,0,1,1
50975,حاول,0,0,1,1
35850,objections,0,0,1,1
35848,gruppe,0,0,1,1
35847,πίτσα,0,0,1,1
35845,കർണ്ണാടകയും,0,0,1,1
50981,selección,0,0,1,1
35843,flow,0,0,1,1
35842,transmitir,0,0,1,1
50982,болота,0,0,1,1
50983,إصدار,0,0,1,1
50985,ವೀಡಿಯೊಗೆ,0,0,1,1
35831,долгое,0,0,1,1
35839,खत्म,0,0,1,1
35838,матерью,0,0,1,1
50986,потерянное,0,0,1,1
35837,τρομακτικά,0,0,1,1
35836,архитектуру,0,0,1,1
35835,leverde,0,0,1,1
50987,conflitos,0,0,1,1
35833,meatspace,0,0,1,1
50988,asegúrese,0,0,1,1
50989,technieken,0,0,1,1
35806,personally,0,0,1,1
51006,bicholim,0,0,1,1
51009,tries,0,0,1,1
35765,ومخيف,0,0,1,1
51025,उठाते,0,0,1,1
35776,приходите,0,0,1,1
35775,nickel,0,0,1,1
35773,ബുദ്ധിമുട്ടായിരുന്നു,0,0,1,1
35772,förändrats,0,0,1,1
35771,προς,0,0,1,1
51029,algorithmically,0,0,1,1
35769,journalister,0,0,1,1
35768,இருந்தாள்,0,0,1,1
51030,anthropologie,0,0,1,1
35764,odası,0,0,1,1
35779,perfekte,0,0,1,1
51032,kir,0,0,1,1
35763,señalar,0,0,1,1
35762,"
आलेमैनिक",0,0,1,1
35761,exceptionally,0,0,1,1
51035,discernible,0,0,1,1
51037,estímulo,0,0,1,1
51038,baseados,0,0,1,1
35756,ignoreallrules,0,0,1,1
35755,திட்டங்களையும்,0,0,1,1
35754,tayyip,0,0,1,1
35778,dolaylı,0,0,1,1
35780,μεταφορά,0,0,1,1
51010,beroemde,0,0,1,1
35794,التقليدية,0,0,1,1
51011,tarihindeki,0,0,1,1
51013,nahezu,0,0,1,1
35800,sammanfogats,0,0,1,1
35799,umulig,0,0,1,1
51014,sözlerim,0,0,1,1
35798,ദ്രുത,0,0,1,1
51018,அடித்தீர்கள்,0,0,1,1
35797,إليها,0,0,1,1
35796,telifi,0,0,1,1
35795,"
albanês",0,0,1,1
35793,предположим,0,0,1,1
35781,«википедия»,0,0,1,1
51019,regelbundna,0,0,1,1
51020,ποτέ,0,0,1,1
35789,चित्रमाला,0,0,1,1
35788,ಸಮತೋಲಿತ,0,0,1,1
35787,докладах,0,0,1,1
35786,δοκίμιό,0,0,1,1
35785,hi •,0,0,1,1
35784,beobachtete,0,0,1,1
51022,strengthened,0,0,1,1
35782,directives,0,0,1,1
35852,मानसिक,0,0,1,1
35854,caráter,0,0,1,1
35941,συνέχεια,0,0,1,1
35855,आर्टिकल,0,0,1,1
35914,साक्षात्कारों,0,0,1,1
50924,نقودًا,0,0,1,1
35911,cogitans »,0,0,1,1
35910,"
काशुबियाई",0,0,1,1
50926,bultin,0,0,1,1
35909,feasibility,0,0,1,1
35908,wikiprojeto,0,0,1,1
35907,ಕಳುಹಿಸುತ್ತೇನೆ,0,0,1,1
50927,ಮೊದಲನೆಯದನ್ನು,0,0,1,1
35906,tentar,0,0,1,1
35905,habido,0,0,1,1
50928,ವ್ಯವಹಾರವು,0,0,1,1
35904,γραμματική,0,0,1,1
35902,أفسدت,0,0,1,1
50929,совместного,0,0,1,1
35899,hilfreich,0,0,1,1
35898,حافزًا,0,0,1,1
50930,വരിക,0,0,1,1
35896,yapmanı,0,0,1,1
35895,geçmişinden,0,0,1,1
35894,minde,0,0,1,1
50932,αφού,0,0,1,1
35893,brugbarheden,0,0,1,1
50922,ಸೈರ್,0,0,1,1
35915,kultur,0,0,1,1
35916,commentary,0,0,1,1
50912,एस,0,0,1,1
50908,حار,0,0,1,1
35939,ಅನ್ವಯವಾಗುವ,0,0,1,1
35938,فلنتحدث,0,0,1,1
35937,şeye,0,0,1,1
50909,متردد,0,0,1,1
35934,göz,0,0,1,1
50910,redirection,0,0,1,1
35933,désignait,0,0,1,1
50911,सोचिए,0,0,1,1
35931,обращает,0,0,1,1
35929,tarjetas,0,0,1,1
50921,corresponsales,0,0,1,1
50914,λήμματά,0,0,1,1
50916,hæng,0,0,1,1
35926,succèdent,0,0,1,1
35925,"
अम्हारिक",0,0,1,1
50917,analyseren,0,0,1,1
35923,fortune,0,0,1,1
35921,выпуска,0,0,1,1
35920,integrando,0,0,1,1
35919,engaged,0,0,1,1
50920,clique,0,0,1,1
50933,voren,0,0,1,1
50935,strategies,0,0,1,1
50936,सांस्कृतिक,0,0,1,1
50962,سطح,0,0,1,1
35869,गूगल्स,0,0,1,1
50954,قبولًا,0,0,1,1
50955,selecionado,0,0,1,1
50956,πατώντας,0,0,1,1
35866,trubbigt,0,0,1,1
50957,gösterilmez,0,0,1,1
50958,الأقل,0,0,1,1
50959,ஒருபோதும்,0,0,1,1
35864,oluşur,0,0,1,1
50961,synthetic,0,0,1,1
50963,ഉറക്കത്തിൽ,0,0,1,1
35871,exposición,0,0,1,1
50965,risken,0,0,1,1
35860,publicasse,0,0,1,1
35859,பிரஞ்சு,0,0,1,1
35858,tackling,0,0,1,1
50967,видах,0,0,1,1
50968,персонажами,0,0,1,1
35857,sistémica,0,0,1,1
35856,bilindiğinden,0,0,1,1
50971,недавние,0,0,1,1
50973,среднем,0,0,1,1
50953,உள்ளதோடு,0,0,1,1
35872,അഴുക്ക്,0,0,1,1
35891,"
सार्डिनियाई",0,0,1,1
35881,fliken,0,0,1,1
50937,acadêmica,0,0,1,1
35889,википедистов,0,0,1,1
50938,beğenme,0,0,1,1
50940,marques,0,0,1,1
50941,siffror,0,0,1,1
35886,ബുദ്ധിമുട്ടാണെന്നകാര്യം,0,0,1,1
35885,autopromocionales,0,0,1,1
35884,çıldırdığımı,0,0,1,1
50945,muero,0,0,1,1
35882,conflicting,0,0,1,1
50946,biodiversity,0,0,1,1
50952,ಮನಸ್ಸು,0,0,1,1
35880,almam,0,0,1,1
50947,ortasındasın,0,0,1,1
35878,konuşulan,0,0,1,1
35877,வழக்கமான,0,0,1,1
50948,reivindicações,0,0,1,1
35876,¿y,0,0,1,1
35875,σοβαρή,0,0,1,1
50950,البيانية,0,0,1,1
35874,தொங்க,0,0,1,1
50951,culturelles,0,0,1,1
50768,programında,0,0,1,1
50766,കളയുന്നു,0,0,1,1
36125,cilalı,0,0,1,1
36396,நேர்மறை,0,0,1,1
50585,station,0,0,1,1
50586,ವರ್ಷ,0,0,1,1
50590,புதிதாக,0,0,1,1
50591,narsisa,0,0,1,1
36369,bataklıkta,0,0,1,1
36368,ikilem,0,0,1,1
50592,ബസ്,0,0,1,1
36366,strikser,0,0,1,1
36365,divergent,0,0,1,1
36364,بجانبها,0,0,1,1
36363,нравятся,0,0,1,1
50593,رموز,0,0,1,1
36361,ഒരുപക്ഷേ,0,0,1,1
50594,неудач,0,0,1,1
36359,υποδηλώνει,0,0,1,1
36358,καταπληκτικός,0,0,1,1
36357,profondément,0,0,1,1
50595,تلميحًا,0,0,1,1
36354,vandal,0,0,1,1
36353,நண்பரிடம்,0,0,1,1
50596,semiautomaticamente,0,0,1,1
50597,heet,0,0,1,1
50599,सॉफ़्टवेयर,0,0,1,1
36374,afirmações,0,0,1,1
50584,الفوضى,0,0,1,1
36375,daneben,0,0,1,1
50576,regardless,0,0,1,1
36394,мысленно,0,0,1,1
36393,വ്യാപിച്ചു,0,0,1,1
36391,пятой“,0,0,1,1
36390,afijo,0,0,1,1
36389,knop,0,0,1,1
50571,نفسه,0,0,1,1
50572,படையினருக்கு,0,0,1,1
50573,موافق,0,0,1,1
50574,accepteret,0,0,1,1
36386,حاسوبياً,0,0,1,1
36383,donald,0,0,1,1
50582,perceptibles,0,0,1,1
36382,bedank,0,0,1,1
50577,tracts,0,0,1,1
36380,prost,0,0,1,1
36379,पहुँचायी,0,0,1,1
36378,minderheidstalen,0,0,1,1
50578,violated,0,0,1,1
36377,ಮೂಲಗಳನ್ನು,0,0,1,1
50579,probeert,0,0,1,1
36376,discrepancy,0,0,1,1
50580,رسول,0,0,1,1
50600,ζώνης,0,0,1,1
36351,contrariée,0,0,1,1
50601,—dirigidas,0,0,1,1
50622,കൊണ്ടുപോകും,0,0,1,1
50619,ಖಚಿತವಾಗಿದೆ,0,0,1,1
50620,मूल्य,0,0,1,1
36325,википроектами,0,0,1,1
36324,actué,0,0,1,1
36323,barrage,0,0,1,1
36322,прошлой,0,0,1,1
50621,günümüz,0,0,1,1
36321,informella,0,0,1,1
36320,вечер,0,0,1,1
36319,inégalitaire,0,0,1,1
50625,initiate,0,0,1,1
50618,patent,0,0,1,1
50626,продавались,0,0,1,1
36315,लें,0,0,1,1
50627,espejo,0,0,1,1
36313,കുഴഞ്ഞുമറിഞ്ഞു,0,0,1,1
36312,beskytte,0,0,1,1
36311,mémoire,0,0,1,1
50628,takipsizliği,0,0,1,1
50630,soupe,0,0,1,1
50631,hoogkwalitatieve,0,0,1,1
36308,credenciados,0,0,1,1
36326,şatodan,0,0,1,1
36327,goldgoldenem,0,0,1,1
36349,lagunas,0,0,1,1
36341,olmayın,0,0,1,1
36348,güzelliğe,0,0,1,1
36347,подтверждения,0,0,1,1
50603,उद्धृत,0,0,1,1
36345,डॉङ्ग,0,0,1,1
36344,жаргоне,0,0,1,1
50604,korrelerat,0,0,1,1
36343,termijn,0,0,1,1
50606,брайдл,0,0,1,1
50607,बुनियादी,0,0,1,1
50608,anlamamı,0,0,1,1
36340,impossibles,0,0,1,1
36328,başta,0,0,1,1
36339,"
सोमाली",0,0,1,1
50609,കൊടുത്തിരുന്ന,0,0,1,1
36336,concluent,0,0,1,1
36335,rusa,0,0,1,1
36334,زاوية,0,0,1,1
36333,отключены,0,0,1,1
50610,مناقشة,0,0,1,1
50611,வரும்,0,0,1,1
50613,സംരക്ഷിക്കുക,0,0,1,1
50615,pseudovetenskap,0,0,1,1
36395,héberger,0,0,1,1
36397,lift,0,0,1,1
36126,costumamos,0,0,1,1
50569,meritsystem,0,0,1,1
50511,basket,0,0,1,1
36456,surveillés,0,0,1,1
50512,lenen,0,0,1,1
50513,slösa,0,0,1,1
36453,klaar,0,0,1,1
36452,руководствам,0,0,1,1
50514,மனச்சார்பு,0,0,1,1
50515,иллинойс,0,0,1,1
50516,writingclarification,0,0,1,1
50517,защиты,0,0,1,1
36451,என்பதில்,0,0,1,1
36450,arz •,0,0,1,1
36449,മൂലയിൽത്തന്നെ,0,0,1,1
50518,ஆரம்பித்து,0,0,1,1
50519,tedbir,0,0,1,1
50520,निर्माणात्मक,0,0,1,1
50521,магнусом,0,0,1,1
50523,ഇന്റലിജൻസ്,0,0,1,1
36446,barajando,0,0,1,1
50524,отправиться,0,0,1,1
36444,alleviate,0,0,1,1
50526,जितना,0,0,1,1
36443,demokratiske,0,0,1,1
50509,soto ,0,0,1,1
36458,trouverez,0,0,1,1
36459,ಓಡಿಹೋದಳು,0,0,1,1
36469,έστειλε,0,0,1,1
36477,நபரின்,0,0,1,1
36476,പെരുമഴയാവുകയാണ്,0,0,1,1
50493,conduisent,0,0,1,1
50495,आपराधिक,0,0,1,1
36474,чьюлибо,0,0,1,1
50498,ಆಲೂಗಡ್ಡೆಗಳನ್ನು,0,0,1,1
36472,erdoğan,0,0,1,1
36471,ilan,0,0,1,1
50499,versuchen,0,0,1,1
50501,ура,0,0,1,1
50502,സംഭാഷണവും,0,0,1,1
36460,свободных,0,0,1,1
50503,وتراجعت,0,0,1,1
36468,guise,0,0,1,1
36467,классную,0,0,1,1
36466,divulgar,0,0,1,1
50504,convite,0,0,1,1
36465,dénonçant,0,0,1,1
50505,علاوة,0,0,1,1
50506,महीने,0,0,1,1
36462,frågeställningarna,0,0,1,1
50507,fonde,0,0,1,1
36442,«cerrar,0,0,1,1
36441,précaution,0,0,1,1
50527,catégoriser,0,0,1,1
50559,vormen,0,0,1,1
50553,சொல்லை,0,0,1,1
36418,zweimal,0,0,1,1
36417,tends,0,0,1,1
36415,സ്വർണ്ണം,0,0,1,1
36414,रुचि,0,0,1,1
50555,இருக்கின்றன,0,0,1,1
36412,உருவாக்குதல்,0,0,1,1
36411,الامور؟,0,0,1,1
50556,reporters,0,0,1,1
50558,plagiar,0,0,1,1
36408,придется,0,0,1,1
50551,helped,0,0,1,1
36407,defended,0,0,1,1
36406,പന്തിരുകുലം,0,0,1,1
50560,போராடிய,0,0,1,1
50561,avser,0,0,1,1
36405,contest,0,0,1,1
50563,रीतिरिवाजों,0,0,1,1
36402,informático,0,0,1,1
36400,استقرارا,0,0,1,1
50567,forests,0,0,1,1
50568,बिल्टइन,0,0,1,1
50552,fortunes,0,0,1,1
50549,gelmesidir,0,0,1,1
50528,acepte,0,0,1,1
50539,φροντίζετε,0,0,1,1
36440,பார்த்தான்,0,0,1,1
36439,fahrt,0,0,1,1
50530,écrite,0,0,1,1
50531,предмета,0,0,1,1
50536,многоуровневую,0,0,1,1
36436,πούλησες,0,0,1,1
36435,स्वयंसेवक,0,0,1,1
36434,اكتسبت,0,0,1,1
36433,എന്നുപറയുക,0,0,1,1
50538,തമാശ,0,0,1,1
36432,politiskt,0,0,1,1
36422,составление,0,0,1,1
50540,logiquement,0,0,1,1
50541,utilization,0,0,1,1
50542,beiden,0,0,1,1
50543,contestada,0,0,1,1
50544,partagée,0,0,1,1
36427,ಮೈಲಿ,0,0,1,1
50546,helft,0,0,1,1
50548,ವಹಿಸಿ,0,0,1,1
36424,രത്നങ്ങളിലും,0,0,1,1
36423,électricité,0,0,1,1
36307,ചോദിക്കുക,0,0,1,1
36305,грязь,0,0,1,1
36304,ಬಂದಿತು,0,0,1,1
50633,infrequent,0,0,1,1
36190,médicos,0,0,1,1
36189,embaucher,0,0,1,1
36186,nachmittags,0,0,1,1
36185,·i,0,0,1,1
50714,levantou,0,0,1,1
36184,обозначает,0,0,1,1
36183,politikendk,0,0,1,1
50719,marinarkeologi,0,0,1,1
50721,предпочтение,0,0,1,1
50722,ക്രിക്കറ്റ്,0,0,1,1
50723,தாயைப்,0,0,1,1
36181,затопленный,0,0,1,1
36180,toegankelijk,0,0,1,1
50724,मॉडल,0,0,1,1
36178,ಕಂಡಿದೆ,0,0,1,1
36177,والمناقشات,0,0,1,1
50725,llore,0,0,1,1
50726,غيرت,0,0,1,1
50728,تُعرف,0,0,1,1
36175,الجنسين،,0,0,1,1
50729,presenteert,0,0,1,1
50730,seventh,0,0,1,1
36174,ستالمان,0,0,1,1
36191,« proches,0,0,1,1
50712,población,0,0,1,1
36192,ಮಾಂಸದ,0,0,1,1
36205,bristfällig,0,0,1,1
50700,செய்வதாகவும்,0,0,1,1
50701,компаниявладелец,0,0,1,1
50702,противоположностью,0,0,1,1
50703,siembra,0,0,1,1
36208,mantle,0,0,1,1
50704,dyr,0,0,1,1
36207,konsensussökande,0,0,1,1
50705,ونفس,0,0,1,1
50706,permaneceu,0,0,1,1
50707,ಬಣ್ಣದ್ದಾಗಿತ್ತು,0,0,1,1
36204,fourniture,0,0,1,1
36193,பயன்பாட்டிற்காகவும்,0,0,1,1
36203,benziyorsun,0,0,1,1
36202,çeviri,0,0,1,1
36201,соберись,0,0,1,1
36200,spams,0,0,1,1
36199,participating,0,0,1,1
36198,ken,0,0,1,1
50709,الإداريون,0,0,1,1
36196,nerviosos,0,0,1,1
36195,estrechamente,0,0,1,1
36194,குறுங்கட்டுரையாகவே,0,0,1,1
36173,തനിക്ക്,0,0,1,1
36172,पाँच,0,0,1,1
50732,mm,0,0,1,1
36138,framförs,0,0,1,1
50749,uttalar,0,0,1,1
36144,كجزء,0,0,1,1
50750,öppenheten,0,0,1,1
50752,ഒഴിവാക്കുന്നു,0,0,1,1
50753,വിക്കിപീഡിയകളിൽ,0,0,1,1
36142,நேரத்திலும்,0,0,1,1
50754,kopyalamaya,0,0,1,1
36141,البسيط,0,0,1,1
36140,dust,0,0,1,1
36139,படித்துக்கொண்டிருக்கிறேன்,0,0,1,1
50755,गंभीर,0,0,1,1
50746,prejudicial,0,0,1,1
50756,തെളിയിച്ചില്ലെങ്കിൽ,0,0,1,1
50757,التفرد,0,0,1,1
50760,вероятностей,0,0,1,1
36132,ونميل,0,0,1,1
50763,lyst,0,0,1,1
50764,படுக்கையில்,0,0,1,1
36130,बनाया,0,0,1,1
50765,प्रयत्न,0,0,1,1
36129,attacker,0,0,1,1
36127,hemligt,0,0,1,1
50747,likewise,0,0,1,1
50744,барак,0,0,1,1
36171,ബന്ധവും,0,0,1,1
50739,étroitement,0,0,1,1
36170,മുന്നോട്ടുപോകുന്നത്,0,0,1,1
36169,ಬದಲಾಯಿಸಿದಳು,0,0,1,1
50733,worldcat,0,0,1,1
36168,pride,0,0,1,1
50734,കുടുങ്ങുമ്പോൾ,0,0,1,1
36164,« pédia »,0,0,1,1
36163,подписаться,0,0,1,1
36161,சாதிக்காத,0,0,1,1
36160,നിലവിലുണ്ട്,0,0,1,1
36159,μοιάζεις,0,0,1,1
50740,grof,0,0,1,1
36146,subvenciones,0,0,1,1
50741,lehrer,0,0,1,1
36158,വിഭാഗങ്ങളായ്,0,0,1,1
36157,stage,0,0,1,1
36156,«проверяемость,0,0,1,1
36155,одинединственный,0,0,1,1
36154,общенаучных,0,0,1,1
36153,sacred,0,0,1,1
50742,ಸಿಕ್ಕಿದ್ದೇನೆ,0,0,1,1
36150,oc •,0,0,1,1
36147,പ്രവർത്തിക്കുമെന്ന്,0,0,1,1
50699,चुनूंगा,0,0,1,1
36211,priorité,0,0,1,1
36212,എന്നതുപോലെയല്ല,0,0,1,1
36271,ಬುದ್ಧಿವಂತಿಕೆಯು,0,0,1,1
50644,gesicht,0,0,1,1
50645,भौतिक,0,0,1,1
50646,بقدر,0,0,1,1
36278,ഓർമയോ,0,0,1,1
36277,hablemos,0,0,1,1
50647,kartoffeln,0,0,1,1
36275,vandrare,0,0,1,1
50648,uyar,0,0,1,1
36273,bouchée,0,0,1,1
50649,mordida,0,0,1,1
36268,حساب,0,0,1,1
36282,«the,0,0,1,1
36267,உதாரணத்திற்கு,0,0,1,1
36265,écouter,0,0,1,1
50653,moeilijker,0,0,1,1
50655,poll,0,0,1,1
50656,διάστημα,0,0,1,1
50657,تسويته,0,0,1,1
50659,शब्दजाल,0,0,1,1
36262,oriental,0,0,1,1
36261,அழுக்கு,0,0,1,1
36260,вклады,0,0,1,1
36281,कामों,0,0,1,1
36283,sætter,0,0,1,1
36258,банку,0,0,1,1
50637,transação,0,0,1,1
36302,يلقى,0,0,1,1
36301,autoorganisé,0,0,1,1
36300,reilly,0,0,1,1
36299,adicionam,0,0,1,1
50634,взял,0,0,1,1
50635,സംഭാഷണത്തിനിടയിലാണെങ്കിൽ,0,0,1,1
36298,mühen,0,0,1,1
36297,fastest,0,0,1,1
50636,फाउन्डिंग,0,0,1,1
36295,പേരിന്റെ,0,0,1,1
50639,διέσχισαν,0,0,1,1
50643,adhere,0,0,1,1
36292,hissediyorsanız,0,0,1,1
36291,modificações,0,0,1,1
50640,respectivas,0,0,1,1
50641,ഉള്ളവരായതിനാൽ,0,0,1,1
36290,olhou,0,0,1,1
36288,conhecer,0,0,1,1
36287,associadas,0,0,1,1
36286,lika,0,0,1,1
36285,kalmeer,0,0,1,1
50642,إضافي,0,0,1,1
50660,استخدم,0,0,1,1
50661,रीडायरेक्शन,0,0,1,1
36213,choro,0,0,1,1
50687,hesitating,0,0,1,1
50680,involved,0,0,1,1
50681,σχολιάζοντας,0,0,1,1
36226,நுபீடியாவிலிருந்து,0,0,1,1
50682,disposal,0,0,1,1
50683,ಹೋಗುವುದಿಲ್ಲ,0,0,1,1
36223,tempestuosa,0,0,1,1
36222,τρομερά,0,0,1,1
50684,yemekte,0,0,1,1
50685,ændret,0,0,1,1
50686,debatidos,0,0,1,1
50689,mettent,0,0,1,1
36230,ആവർത്തനം,0,0,1,1
50691,തെറ്റാണ്,0,0,1,1
50692,çevreleyen,0,0,1,1
50694,dens,0,0,1,1
36218,unbalanced,0,0,1,1
50696,incidents,0,0,1,1
36216,yapacaklarını,0,0,1,1
36215,uncertain,0,0,1,1
36214,அதிகமில்லை,0,0,1,1
50697,confina,0,0,1,1
50698,maden,0,0,1,1
36228,weggaf,0,0,1,1
36231,вкусно,0,0,1,1
36257,haag,0,0,1,1
50669,പേരും,0,0,1,1
36255,dieux,0,0,1,1
36254,våtmark,0,0,1,1
36252,bate,0,0,1,1
36251,بمحتوى,0,0,1,1
36250,gymnasieelever,0,0,1,1
50665,drömmamma,0,0,1,1
50666,ആശയക്കുഴപ്പമുണ്ടായാൽ,0,0,1,1
36248,miroirs,0,0,1,1
50668,охвату,0,0,1,1
36246,ಪಡೆದಿದ್ದೀರಾ,0,0,1,1
36244,indecisa,0,0,1,1
50679,ಚಲನಚಿತ್ರಗಳಿಗೆ,0,0,1,1
36243,formulated,0,0,1,1
36241,strikeslip,0,0,1,1
36240,veckotidskrift,0,0,1,1
50671,bestknown,0,0,1,1
50673,வாக்கியத்தைப்,0,0,1,1
36238,nãoespecialistas,0,0,1,1
50675,similares,0,0,1,1
50677,«какая,0,0,1,1
36235,specificity,0,0,1,1
36233,steder,0,0,1,1
35751,αλλάξει,0,0,1,1
35750,नवंबर,0,0,1,1
51041,vehicles,0,0,1,1
51393,stigmergic,0,0,1,1
51413,asteroid,0,0,1,1
51415,читатель,0,0,1,1
35276,jungs,0,0,1,1
35274,partit,0,0,1,1
35273,fouille,0,0,1,1
51417,expériences,0,0,1,1
35270,dejó,0,0,1,1
35269,ഭക്ഷണത്തെക്കുറിച്ച്,0,0,1,1
51418,etkin,0,0,1,1
51419,ಬಳಸಿದರೆ,0,0,1,1
51420,lesser,0,0,1,1
35264,مساهمون,0,0,1,1
51424,irmã,0,0,1,1
35263,уместно,0,0,1,1
35262,изобретений,0,0,1,1
35261,теме»,0,0,1,1
35260,remercie,0,0,1,1
51425,kosteloos,0,0,1,1
35257,sprang,0,0,1,1
35256,ಸೆಲ್,0,0,1,1
51427,ആക്കി,0,0,1,1
35254,прилагающаяся,0,0,1,1
35253,blanda,0,0,1,1
35278,characterized,0,0,1,1
51411,précisant ,0,0,1,1
35279,embark,0,0,1,1
35288,இறைச்சி,0,0,1,1
51396,செய்யவே,0,0,1,1
51398,négatif,0,0,1,1
51399,ऑफिस,0,0,1,1
35292,tänt,0,0,1,1
51400,கொண்டிருப்பதுடன்,0,0,1,1
51401,قهوتك,0,0,1,1
51402,intéressante,0,0,1,1
35290,hangi,0,0,1,1
51403,подвергавшихся,0,0,1,1
35289,irse,0,0,1,1
51404,отражении,0,0,1,1
35280,raderingspolicy,0,0,1,1
35287,எட்டப்படுகிறது,0,0,1,1
51405,يُنسب,0,0,1,1
51406,implícita,0,0,1,1
51407,содержащий,0,0,1,1
51408,åbent,0,0,1,1
51409,vahşet,0,0,1,1
51410,മാണിക്യ,0,0,1,1
35283,veelvoorkomend,0,0,1,1
35282,herinneren,0,0,1,1
35281,статистику,0,0,1,1
51428,பட்சத்தில்,0,0,1,1
35252,चलो।,0,0,1,1
51429,والمتغيرات,0,0,1,1
51459,biografias,0,0,1,1
51453,filipino,0,0,1,1
35225,yakışıklıydı,0,0,1,1
35224,كوب,0,0,1,1
35223,tercüme,0,0,1,1
51455,contributos,0,0,1,1
35222,प्रविष्टियां,0,0,1,1
35221,mentionnez,0,0,1,1
51456,لاستخدام,0,0,1,1
51457,reshaping,0,0,1,1
51458,décider,0,0,1,1
51461,kommentarsfält,0,0,1,1
35228,الاتجاه,0,0,1,1
35217,ಇಲ್ಲದಿದ್ದರೆ,0,0,1,1
35215,« robots »,0,0,1,1
51464,السينما,0,0,1,1
51465,разделах,0,0,1,1
51466,asuntos,0,0,1,1
35211,scaling,0,0,1,1
51468,πραγματική,0,0,1,1
35209,planetary,0,0,1,1
51469,സാക്ഷാത്കരിക്കുമെന്ന്,0,0,1,1
51470,поощряет,0,0,1,1
35227,ετοιμάστηκα,0,0,1,1
51452,euh,0,0,1,1
35250,सवार्त्ज़,0,0,1,1
51437,γυμνοσάλιαγκας,0,0,1,1
35249,السجناء,0,0,1,1
35248,உருவாக்கப்பட்டது,0,0,1,1
51431,jugar,0,0,1,1
51432,sporen,0,0,1,1
51433,hapşırdığında,0,0,1,1
35245,زيارات,0,0,1,1
35244,خلالها,0,0,1,1
35243,ಎಂಬುದನ್ನು,0,0,1,1
51434,reverses,0,0,1,1
51435,состоит,0,0,1,1
35241,conocidas,0,0,1,1
51448,inductively,0,0,1,1
51440,spåddes,0,0,1,1
35238,உட்பட,0,0,1,1
51441,விக்கிப்பீடியாகொம்,0,0,1,1
35237,sanmıyorum,0,0,1,1
35236,आटा,0,0,1,1
51443,ninetenths,0,0,1,1
35234,adressée,0,0,1,1
35233,മാസത്തിൽ,0,0,1,1
35232,rechtsboven,0,0,1,1
51445,testimde,0,0,1,1
35295,செயலை,0,0,1,1
51392,ciddiye,0,0,1,1
51319,choix,0,0,1,1
51391,argumentava,0,0,1,1
35359,мысль,0,0,1,1
35358,estuve,0,0,1,1
51334,"
अन्यथा",0,0,1,1
35355,ಎಲ್ಲೋ,0,0,1,1
51336,türden,0,0,1,1
51337,அனுப்பி,0,0,1,1
51338,شروط,0,0,1,1
51339,എത്തിച്ചേരേണ്ട,0,0,1,1
51340,replacement,0,0,1,1
35348,ಅವುಗಳ,0,0,1,1
35347,πλούτος,0,0,1,1
51342,ζεστό,0,0,1,1
51343,σκεφτείτε,0,0,1,1
51344,بالمائة،,0,0,1,1
35346,φυτέψω,0,0,1,1
35345,alcanzó,0,0,1,1
51346,clases,0,0,1,1
35343,تحتاج,0,0,1,1
51347,produits,0,0,1,1
35341,ذا,0,0,1,1
51350,மனிதன்,0,0,1,1
35340,തൽക്ഷണം,0,0,1,1
35339,проверить,0,0,1,1
35361,उँगलियों,0,0,1,1
35362,allvarligt,0,0,1,1
35363,erasmusprijs,0,0,1,1
35377,sınavınız,0,0,1,1
51321,पाऊँगी।,0,0,1,1
35384,نشرت,0,0,1,1
51322,examplestasks,0,0,1,1
35383,മറ്റേയാൾക്ക്,0,0,1,1
51323,gefällt,0,0,1,1
35382,переведённые,0,0,1,1
35381,saai,0,0,1,1
35380,biologiques,0,0,1,1
35379,presenterat,0,0,1,1
35378,ακούσω,0,0,1,1
51325,πότε,0,0,1,1
35364,uppsala,0,0,1,1
35375,elección,0,0,1,1
51327,finaste,0,0,1,1
35373,descubrimiento,0,0,1,1
51328,sağlar,0,0,1,1
35371,ustedes,0,0,1,1
35370,koncepten,0,0,1,1
51329,kafayı,0,0,1,1
51330,välmodig,0,0,1,1
35367,harbor,0,0,1,1
35365,يدين,0,0,1,1
35338,“controlada”,0,0,1,1
35336,கூடியனவாய்,0,0,1,1
51352,«история»,0,0,1,1
35303,​​en,0,0,1,1
35313,guild,0,0,1,1
51377,argentine,0,0,1,1
35311,لنا,0,0,1,1
35310,يعتقد,0,0,1,1
35309,stormigt,0,0,1,1
51378,mau,0,0,1,1
51379,posicionó,0,0,1,1
51380,лечатся,0,0,1,1
35307,والأوكرانية،,0,0,1,1
35306,mains,0,0,1,1
35302,vallely,0,0,1,1
35315,скомпрометировать,0,0,1,1
51382,éditoriaux,0,0,1,1
51384,പ്രശ്നത്തേക്കാൾ,0,0,1,1
51385,vikipediler,0,0,1,1
51386,வளர்ந்து,0,0,1,1
51388,दलित,0,0,1,1
35301,comenzado,0,0,1,1
35300,ಅವನಾಗಬಹುದು,0,0,1,1
51389,stoppade,0,0,1,1
51390,contextdependent,0,0,1,1
35299,πει,0,0,1,1
35314,പതിപ്പാണ്,0,0,1,1
35316,institutionnalisation,0,0,1,1
35335,cumprem,0,0,1,1
35323,الألمانية،,0,0,1,1
35334,സംവിധാനം,0,0,1,1
35333,¿tengo,0,0,1,1
35332,нарцису,0,0,1,1
51354,sınıfta,0,0,1,1
51355,tituló,0,0,1,1
35330,βλέπετε,0,0,1,1
35329,август,0,0,1,1
35327,computación,0,0,1,1
51358,«срезать,0,0,1,1
35324,forfait,0,0,1,1
35322,«кто,0,0,1,1
51375,глобальное,0,0,1,1
35321,britse,0,0,1,1
51361,ഇടുന്നു,0,0,1,1
51362,cidadãos,0,0,1,1
35319,слово»,0,0,1,1
35318,நபருக்கு,0,0,1,1
51366,solicitação,0,0,1,1
51369,ശ്രദ്ധിക്കുന്നില്ല,0,0,1,1
51370,تتعلق,0,0,1,1
51372,തിരയലിൽ,0,0,1,1
51374,"
अरबी",0,0,1,1
35208,സമൂഹമാണ്,0,0,1,1
35207,faydalı,0,0,1,1
35206,embarcarse,0,0,1,1
35205,conflits,0,0,1,1
35097,intressanta,0,0,1,1
51563,"modell
",0,0,1,1
35096,veda,0,0,1,1
51565,പൊതുവായതും,0,0,1,1
35094,modersmål,0,0,1,1
51566,collectif,0,0,1,1
35091,إشارة,0,0,1,1
35090,ഡ്രൈവ്വേയിൽ,0,0,1,1
35089,координации,0,0,1,1
35088,സൈന്യം,0,0,1,1
51567,«уборка»,0,0,1,1
35086,обнаружен,0,0,1,1
35084,ofrecerme,0,0,1,1
35083,inclusréf,0,0,1,1
51568,expresidente,0,0,1,1
35081,heimlich,0,0,1,1
35080,buysa,0,0,1,1
35078,ستفعل,0,0,1,1
35077,والجدال,0,0,1,1
51569,justifiée,0,0,1,1
35076,trip,0,0,1,1
35075,türban,0,0,1,1
51570,huit,0,0,1,1
35098,купить,0,0,1,1
51562,notorias,0,0,1,1
51561,ഉപേക്ഷിച്ചാൽ,0,0,1,1
51547,ಆಶ್ಚರ್ಯವಾದರೆ,0,0,1,1
51540,وتحريره,0,0,1,1
35118,illaluktande,0,0,1,1
35117,имеющейся,0,0,1,1
35116,långsam,0,0,1,1
35115,темы,0,0,1,1
51544,bookstores,0,0,1,1
51545,पैसा,0,0,1,1
51546,kolaylaştırmak,0,0,1,1
35112,يُنصح,0,0,1,1
35111,الأكبر,0,0,1,1
35110,biotope,0,0,1,1
51559,paysagères,0,0,1,1
35108,അടിച്ചു,0,0,1,1
35107,догадаются,0,0,1,1
35106,телефонного,0,0,1,1
35105,ಸಾಲವನ್ನು,0,0,1,1
51550,costumbres,0,0,1,1
51552,eerdere,0,0,1,1
51554,നോക്കട്ടെ,0,0,1,1
51555,raden,0,0,1,1
51556,திருத்தங்களைப்,0,0,1,1
35100,έδωσε,0,0,1,1
35074,читателя,0,0,1,1
35072,victorian,0,0,1,1
51571,privée,0,0,1,1
51595,bibliotheken,0,0,1,1
51587,ihlalleri,0,0,1,1
35046,وبالمثل،,0,0,1,1
35044,تغذية,0,0,1,1
35043,просить,0,0,1,1
35042,कुत्ते,0,0,1,1
51590,generating,0,0,1,1
51591,welldefined,0,0,1,1
51592,യന്ത്രത്തെ,0,0,1,1
51593,அவர்களுக்கு,0,0,1,1
35039,pictures,0,0,1,1
35038,للتغيير،,0,0,1,1
51586,comedor,0,0,1,1
51596,предполагающих,0,0,1,1
35036,stoppen,0,0,1,1
51598,enables,0,0,1,1
51600,δροσερό,0,0,1,1
35034,irgendetwas,0,0,1,1
51601,संबोधित,0,0,1,1
51602,lourd,0,0,1,1
51604,levensvatbare,0,0,1,1
35030,ബുദ്ധിശൂന്യതയാണെന്നാണ്,0,0,1,1
35028,conservador,0,0,1,1
35048,لكل,0,0,1,1
51585,stocker,0,0,1,1
35071,والمواقع,0,0,1,1
35061,mechanismref,0,0,1,1
51573,выводы,0,0,1,1
35069,automatizar,0,0,1,1
35068,imagination,0,0,1,1
51574,затмившей,0,0,1,1
51575,ஐபி,0,0,1,1
35066,يُسمح,0,0,1,1
51576,самый,0,0,1,1
51578,होफ्लिंग,0,0,1,1
51579,реализуют,0,0,1,1
35062,scharfe,0,0,1,1
35060,travels,0,0,1,1
35050,विकिपीडीयन्स,0,0,1,1
35059,inundação,0,0,1,1
51580,മോശമായ,0,0,1,1
51582,dissidents,0,0,1,1
35057,promoted,0,0,1,1
35056,gulfs,0,0,1,1
51583,ехали,0,0,1,1
35054,descumprem,0,0,1,1
35053,ಇಲ್ಲಿಯೇ,0,0,1,1
35052,leta,0,0,1,1
51584,dérange,0,0,1,1
35119,ناحية,0,0,1,1
35120,судейская,0,0,1,1
51539,ενθουσιασμένοι,0,0,1,1
51495,raderats,0,0,1,1
51488,обоката,0,0,1,1
51489,mottaglig,0,0,1,1
35175,चौथी,0,0,1,1
51490,contestée,0,0,1,1
51492,certifiquese,0,0,1,1
35174,आरोन,0,0,1,1
51494,rönt,0,0,1,1
35172,смотрел,0,0,1,1
35169,έπαιρνα,0,0,1,1
35168,declined,0,0,1,1
35167,стадии,0,0,1,1
51487,विकीवर्सिटी,0,0,1,1
35166,الكتب,0,0,1,1
35165,ejaculação,0,0,1,1
51496,ഇടയിൽ,0,0,1,1
51497,dergelijke,0,0,1,1
35163,ಸಿದ್ಧರಿದ್ದೀರಿ,0,0,1,1
51498,voici,0,0,1,1
51499,ಆಳವಾಗಿ,0,0,1,1
35161,meter,0,0,1,1
51500,tas,0,0,1,1
51502,botste,0,0,1,1
35178,ചുറ്റിപ്പറ്റിയുള്ള,0,0,1,1
35180,worstelde,0,0,1,1
51504,μαγική,0,0,1,1
51476,starte,0,0,1,1
35204,problematisera,0,0,1,1
35203,verkeerd,0,0,1,1
35202,funktionsprincip,0,0,1,1
35201,getirebilir,0,0,1,1
35200,setzen,0,0,1,1
51473,ഗ്രോഡിയന്റേ,0,0,1,1
51474,heette,0,0,1,1
35197,ashton,0,0,1,1
35196,അവബോധത്തോടെ,0,0,1,1
51475,ومتطور,0,0,1,1
35193,بعدم,0,0,1,1
35183,رخصة,0,0,1,1
35192,учётных,0,0,1,1
35191,സന്തുലിതമായ,0,0,1,1
51478,மோசமானது,0,0,1,1
35187,vorbei,0,0,1,1
35186,werkwoordsvorm,0,0,1,1
51480,അർത്ഥമില്ലാത്ത,0,0,1,1
51481,ஆகியவற்றுக்கு,0,0,1,1
51482,பயன்படுத்தித்,0,0,1,1
51483,reporting,0,0,1,1
35184,öğleden,0,0,1,1
51503,"
bengali",0,0,1,1
35156,находилась,0,0,1,1
51538,realizing,0,0,1,1
35126,υποστηρίζεται,0,0,1,1
35134,jaren,0,0,1,1
35133,തെറ്റായ,0,0,1,1
51522,مفارقة,0,0,1,1
51523,உதவிகரமாக,0,0,1,1
51524,bouleverser,0,0,1,1
35130,سينتهي,0,0,1,1
35129,venaient,0,0,1,1
35128,मुस्कुराने,0,0,1,1
35127,wint,0,0,1,1
51525,ilgilenmiyorum,0,0,1,1
51526,tombé,0,0,1,1
51520,έξι,0,0,1,1
51529,формул,0,0,1,1
51530,ಮೆಸೆಂಜರ್,0,0,1,1
51531,superieur,0,0,1,1
35124,बताओ।,0,0,1,1
51533,написаны,0,0,1,1
35122,فوقي,0,0,1,1
51534,llevo,0,0,1,1
51535,conjunctions,0,0,1,1
51536,geçide,0,0,1,1
51537,घटनाएं,0,0,1,1
51521,ifølge,0,0,1,1
51519,джеймс,0,0,1,1
51505,ангел,0,0,1,1
51510,தொடருங்கள்,0,0,1,1
35155,identificados,0,0,1,1
35154,nyheder,0,0,1,1
51506,identifiés,0,0,1,1
35153,سُئلت,0,0,1,1
35152,ലോകമെമ്പാടും,0,0,1,1
51507,heiß,0,0,1,1
35151,prouviez,0,0,1,1
51508,താൾ,0,0,1,1
51509,совсем,0,0,1,1
35149,എല്ലാക്കാലവും,0,0,1,1
35147,appui,0,0,1,1
35136,κόκκινο,0,0,1,1
35146,konsumerar,0,0,1,1
35145,confiança,0,0,1,1
51513,സമൂഹത്തെ,0,0,1,1
35143,χτυπάτε,0,0,1,1
51514,पार्टी,0,0,1,1
35141,dessus,0,0,1,1
51515,franskt,0,0,1,1
35139,kullanıcıları,0,0,1,1
35138,γεμάτη,0,0,1,1
35137,blockering,0,0,1,1
35386,ba •,0,0,1,1
35387,المتوسط,0,0,1,1
51042,பேண,0,0,1,1
51106,incubator,0,0,1,1
51120,ingick,0,0,1,1
51121,fruit—topics,0,0,1,1
35633,πληκτρολογήστε,0,0,1,1
35632,bijzijn,0,0,1,1
51122,controversée,0,0,1,1
35629,burger,0,0,1,1
51123,deneyim,0,0,1,1
51124,frequência,0,0,1,1
51125,appar,0,0,1,1
35627,επίσημη,0,0,1,1
51126,éditeur,0,0,1,1
35626,الأولى،,0,0,1,1
35625,представленного,0,0,1,1
51127,naturalité,0,0,1,1
51129,запрещённых,0,0,1,1
51130,—tal,0,0,1,1
35624,llegaron,0,0,1,1
35623,कंटेंट,0,0,1,1
51131,मार,0,0,1,1
35621,extinctions,0,0,1,1
51132,rencontre,0,0,1,1
35619,låtar,0,0,1,1
51135,τηλεφωνική,0,0,1,1
35635,центральных,0,0,1,1
35637,ಕಾಣಲು,0,0,1,1
51118,شهر,0,0,1,1
35653,« décrire,0,0,1,1
35661,unabated,0,0,1,1
35660,μιλήσετε,0,0,1,1
35659,salate,0,0,1,1
51109,ಲಾಂಡ್ರಿಗೆ,0,0,1,1
51110,hackernoon,0,0,1,1
35657,மன்னிப்பை,0,0,1,1
35656,judiciais,0,0,1,1
51112,végétale,0,0,1,1
51113,aprendendo,0,0,1,1
51114,देर,0,0,1,1
35651,contemporaine,0,0,1,1
35639,forbid,0,0,1,1
35650,« caractère,0,0,1,1
35649,días,0,0,1,1
51116,تكررها,0,0,1,1
35647,அண்ணளவாக,0,0,1,1
35646,licensen,0,0,1,1
35645,conhecêlo,0,0,1,1
35644,satisfactoria,0,0,1,1
35643,தொடர்பான,0,0,1,1
35642,vergadering,0,0,1,1
35641,etmelerini,0,0,1,1
51136,रहस्य,0,0,1,1
51139,сказано,0,0,1,1
35617,ടോഫൽ,0,0,1,1
51163,örnekler,0,0,1,1
35594,транспорте,0,0,1,1
35593,suscribirte,0,0,1,1
35592,ഇസ്രായേൽപാലസ്തീൻ,0,0,1,1
51159,καλούντα,0,0,1,1
35591,ஆண்கள்,0,0,1,1
35590,നിയമസംഹിതയോ,0,0,1,1
35589,اقبل,0,0,1,1
51160,выросла,0,0,1,1
51161,समय।,0,0,1,1
51162,ലേഖനങ്ങൾക്ക്‌,0,0,1,1
51164,الواحد,0,0,1,1
51156,المستقبلية,0,0,1,1
35586,förstör,0,0,1,1
51168,diyebileceğine,0,0,1,1
35583,stirrade,0,0,1,1
51169,geklickt,0,0,1,1
51170,anlattı,0,0,1,1
51171,ga •,0,0,1,1
51172,supérieur,0,0,1,1
35580,ansiklopediler,0,0,1,1
35579,baseret,0,0,1,1
51173,учтиво,0,0,1,1
51157,открытием,0,0,1,1
51154,udgiver,0,0,1,1
35616,உத்தியோகபூர்வ,0,0,1,1
35607,trouvent,0,0,1,1
35615,computation,0,0,1,1
35614,ರಜೆ,0,0,1,1
51143,l’action,0,0,1,1
51144,mélisse,0,0,1,1
35613,acceptere,0,0,1,1
51146,import,0,0,1,1
35611,sorabileceğin,0,0,1,1
35610,utilidade,0,0,1,1
35609,ξεκινήσετε,0,0,1,1
35608,rammer,0,0,1,1
51148,advantage,0,0,1,1
35595,கற்றுக்கொண்டோம்,0,0,1,1
35605,tabelldatafil,0,0,1,1
35604,മുൻ,0,0,1,1
51149,volvería,0,0,1,1
35603,ಬದಲಾಗಿ,0,0,1,1
35602,ritt,0,0,1,1
35601,ağlayarak,0,0,1,1
35600,nivelar,0,0,1,1
51151,calm,0,0,1,1
51153,அழுத்துவதன்,0,0,1,1
35596,abrió,0,0,1,1
35662,election,0,0,1,1
51104,julgamento,0,0,1,1
35388,yere,0,0,1,1
35664,çalışır,0,0,1,1
35729,passes,0,0,1,1
51056,lagar,0,0,1,1
51057,trabalhando,0,0,1,1
51058,risitas,0,0,1,1
51061,drømte,0,0,1,1
35727,गूढ़,0,0,1,1
51062,berlim,0,0,1,1
35725,revisionréf,0,0,1,1
35724,sinais,0,0,1,1
51066,resmi,0,0,1,1
51067,annenize,0,0,1,1
35722,êxtase,0,0,1,1
35721,cunhado,0,0,1,1
51068,göklerin,0,0,1,1
51069,நிறுத்தினோம்,0,0,1,1
51070,anglocêntrica,0,0,1,1
51071,factchallenged,0,0,1,1
35718,angleterre,0,0,1,1
35717,तीक्ष्ण,0,0,1,1
51072,sacaste,0,0,1,1
35716,taxas,0,0,1,1
35715,califórnia,0,0,1,1
35714,utgår,0,0,1,1
35730,clef,0,0,1,1
35731,обобщённое,0,0,1,1
35732,dérangerait,0,0,1,1
35742,«иракская,0,0,1,1
51043,αντιμετωπίζονται,0,0,1,1
51044,​​of,0,0,1,1
35747,froh,0,0,1,1
35746,دعم,0,0,1,1
35745,tvärt,0,0,1,1
51045,"സമൂഹമാണ്
വിക്കിപീഡിയരുടേത്",0,0,1,1
51046,हमला,0,0,1,1
35744,ನುಡಿಗಟ್ಟುಗಳ,0,0,1,1
51047,placés,0,0,1,1
35743,καλύπτει,0,0,1,1
51048,classent,0,0,1,1
35734,proposition,0,0,1,1
35741,confirma,0,0,1,1
35740,முடுக்கிவிடுங்கள்,0,0,1,1
35739,നിലനിൽക്കുന്നതായി,0,0,1,1
35737,gaseous,0,0,1,1
51049,ágil,0,0,1,1
51051,تسوية,0,0,1,1
51052,χαίρομαι,0,0,1,1
35736,достоянии,0,0,1,1
51054,تتلقى,0,0,1,1
35735,predictivo,0,0,1,1
35713,ವಾಕ್ಯ,0,0,1,1
35712,आठ,0,0,1,1
51073,يشمل,0,0,1,1
35677,страницам,0,0,1,1
51090,വേണ്ടി,0,0,1,1
35685,"
samarês",0,0,1,1
35684,உருளைக்கிழங்கை,0,0,1,1
51093,വാങ്ങാൻ,0,0,1,1
35681,indépendants,0,0,1,1
51094,reais,0,0,1,1
35680,gehaald,0,0,1,1
51095,مندهشة,0,0,1,1
35679,équilibrés,0,0,1,1
35678,sunuş,0,0,1,1
35675,приписывается,0,0,1,1
51088,específica,0,0,1,1
51099,വിഷമമുണ്ടെന്ന്,0,0,1,1
35673,écriture…,0,0,1,1
35672,köpcentret,0,0,1,1
51100,പറയുകയായിരുന്നു,0,0,1,1
51101,περνούσε,0,0,1,1
35670,allinclusive,0,0,1,1
35669,subtropical,0,0,1,1
35668,niña,0,0,1,1
35667,الوصف,0,0,1,1
51103,etmeden,0,0,1,1
51089,بخلاف,0,0,1,1
51087,अधिनियम,0,0,1,1
35710,encouraged,0,0,1,1
51081,вечеринке,0,0,1,1
51074,अर्स,0,0,1,1
35709,आपसी,0,0,1,1
51075,заморожен,0,0,1,1
35708,konsultera,0,0,1,1
51077,efficiently,0,0,1,1
51078,sneezed,0,0,1,1
51079,പാസ്‌വേഡ്,0,0,1,1
35706,engelen,0,0,1,1
35705,deli,0,0,1,1
51080,فيوجد,0,0,1,1
51083,പൊതുവായി,0,0,1,1
35690,chapter,0,0,1,1
35702,sufrió,0,0,1,1
35701,ஸ்டுபண்டஸ்,0,0,1,1
35700,विकिवर्सिटी,0,0,1,1
51084,विख्याति,0,0,1,1
35698,സഞ്ചരിച്ചിരുന്ന,0,0,1,1
35697,seslerin,0,0,1,1
35694,doublingtime,0,0,1,1
35693,mirrors,0,0,1,1
35692,aplicar,0,0,1,1
51085,представления,0,0,1,1
51174,англоязычной,0,0,1,1
51175,wikipediaträff,0,0,1,1
51178,vim,0,0,1,1
35578,хватает,0,0,1,1
51268,المشاريع،,0,0,1,1
51270,പ്രവർത്തനങ്ങളിലൂടെ,0,0,1,1
51272,comets,0,0,1,1
51273,saxe,0,0,1,1
51274,يحتوي,0,0,1,1
35458,ಫಿಕ್ಸ್‌ನಲ್ಲಿದ್ದೀರಿ,0,0,1,1
51275,κλαις,0,0,1,1
35456,raw,0,0,1,1
35455,диалекты,0,0,1,1
35454,искусствоведческой,0,0,1,1
51276,अगला,0,0,1,1
51277,mostraba,0,0,1,1
35450,insats,0,0,1,1
35449,eins,0,0,1,1
51278,தேர்ந்தெடுக்கப்பட்ட,0,0,1,1
35448,பொருளாதாரம்,0,0,1,1
51279,ресурсов,0,0,1,1
51281,ಉತ್ತಮವಾದದ್ದನ್ನು,0,0,1,1
35445,humanidade,0,0,1,1
35444,"
पैन्सिलवेनियाई",0,0,1,1
51282,polerad,0,0,1,1
51283,أقلل,0,0,1,1
35441,älskade,0,0,1,1
51267,темпе,0,0,1,1
35463,планов,0,0,1,1
35464,inkluderar,0,0,1,1
51257,autoaprentissage,0,0,1,1
35482,оскорбительными,0,0,1,1
35481,استعداد,0,0,1,1
51249,majoritaire,0,0,1,1
51251,çeken,0,0,1,1
35479,conservatrice,0,0,1,1
35478,keuzes,0,0,1,1
35476,എന്നതിനാൽ,0,0,1,1
51253,hayallerindeki,0,0,1,1
51254,dahil,0,0,1,1
51255,ταξιδιών,0,0,1,1
35471,سبب,0,0,1,1
51265,необходимости,0,0,1,1
35470,عارض,0,0,1,1
51258,αναφέρονται,0,0,1,1
35468,ಸ್ವಾತಂತ್ರ್ಯವಿಲ್ಲ,0,0,1,1
35467,செய்வதற்கான,0,0,1,1
35466,المصرفي,0,0,1,1
51260,straks,0,0,1,1
51261,നടത്തുന്നത്,0,0,1,1
51262,ജർമൻ,0,0,1,1
51263,agradables,0,0,1,1
51264,صالح,0,0,1,1
51284,karışmış,0,0,1,1
51285,सोसाइटी,0,0,1,1
35439,ಪ್ರಶಂಸಿಸುತ್ತೇನೆ,0,0,1,1
35400,edebilirler,0,0,1,1
51305,lessive,0,0,1,1
35409,പരീക്ഷിച്ചുനോക്കാൻ,0,0,1,1
51306,положительной,0,0,1,1
51308,दुविधा,0,0,1,1
35406,trem,0,0,1,1
35405,सहीसही,0,0,1,1
51309,വരുന്നുണ്ടെന്നും,0,0,1,1
35403,communes,0,0,1,1
35402,wenigen,0,0,1,1
35401,géologiques,0,0,1,1
35399,клетками,0,0,1,1
35413,carona,0,0,1,1
35398,puéril,0,0,1,1
35397,سأستخدمه,0,0,1,1
35396,controversy,0,0,1,1
35395,मानते,0,0,1,1
51311,nitrogen,0,0,1,1
35392,கண்டுபிடிப்பின்படி,0,0,1,1
51314,سكان,0,0,1,1
51317,القرض,0,0,1,1
35389,beräknades,0,0,1,1
51318,महिला,0,0,1,1
35411,काल्पनिक,0,0,1,1
51304,herrera,0,0,1,1
35438,दौड़ी,0,0,1,1
51299,responsibility”,0,0,1,1
35436,ശാസ്ത്രം,0,0,1,1
35435,एनलाइटएनमेंट,0,0,1,1
51291,отслеживать,0,0,1,1
35433,एलेक्सा,0,0,1,1
51292,അതു,0,0,1,1
35432,voorbereid,0,0,1,1
51293,envisager,0,0,1,1
51295,avancée,0,0,1,1
51297,intimidad,0,0,1,1
51298,написанное,0,0,1,1
35427,ತಿಳಿದಿರುವ,0,0,1,1
35415,cavalgando,0,0,1,1
35425,оторваться,0,0,1,1
35424,книги,0,0,1,1
35423,பேசினால்,0,0,1,1
35422,perfeita,0,0,1,1
51300,manifeste,0,0,1,1
35420,नरसी,0,0,1,1
35419,ചൈനീസ്,0,0,1,1
51302,webportaal,0,0,1,1
51303,susceptibilidad,0,0,1,1
35416,naaktslak,0,0,1,1
51247,intresserade,0,0,1,1
35483,китая,0,0,1,1
35485,قابلة,0,0,1,1
35542,bilgisayara,0,0,1,1
35550,tændt,0,0,1,1
35549,uyarılmaktadır,0,0,1,1
51199,രസകരമാണ്,0,0,1,1
35547,mbh,0,0,1,1
35546,किसने,0,0,1,1
51200,deixálos,0,0,1,1
35545,uniques,0,0,1,1
35544,severas,0,0,1,1
51201,വ്യാമോഹിതനാണ്,0,0,1,1
35543,speglade,0,0,1,1
35541,जाग,0,0,1,1
51198,примите,0,0,1,1
35540,closer,0,0,1,1
51202,entera,0,0,1,1
51203,"
वोरो",0,0,1,1
51204,حاولت,0,0,1,1
35536,funnits,0,0,1,1
51205,schätzen,0,0,1,1
51206,पोस्ट,0,0,1,1
35534,kullanıyoruz,0,0,1,1
51207,يجعل,0,0,1,1
35533,собой,0,0,1,1
35551,തോന്നുന്നുവെങ്കിൽ,0,0,1,1
35554,கிராமத்தில்,0,0,1,1
35530,προσπαθείτε,0,0,1,1
35569,وتلحن,0,0,1,1
35577,தந்தி,0,0,1,1
51179,в переводе,0,0,1,1
51180,இலாப,0,0,1,1
51181,നിർവചിക്കണം,0,0,1,1
51182,накормим,0,0,1,1
51184,tøjvask,0,0,1,1
35572,başlayalım,0,0,1,1
51186,сотрудничество,0,0,1,1
51187,voeren,0,0,1,1
51188,redigerar,0,0,1,1
35568,financiación,0,0,1,1
35555,resorted,0,0,1,1
35567,grandir,0,0,1,1
35566,हेलर,0,0,1,1
35565,strider,0,0,1,1
35564,apestosa,0,0,1,1
35563,memex,0,0,1,1
51191,implement,0,0,1,1
51192,svært,0,0,1,1
35560,дамами,0,0,1,1
51194,रेस्तरां,0,0,1,1
35557,டெல்லியில்,0,0,1,1
51208,fewer,0,0,1,1
51209,историк,0,0,1,1
35487,الجامعة,0,0,1,1
35499,denoting,0,0,1,1
35507,ನಿರ್ಧಾರ,0,0,1,1
35506,prévaut,0,0,1,1
35505,பிடிப்பு,0,0,1,1
35504,vinkede,0,0,1,1
35503,ведётся,0,0,1,1
35502,उठाये,0,0,1,1
35501,allait,0,0,1,1
51234,langsame,0,0,1,1
51236,interprétés,0,0,1,1
35500,ejes,0,0,1,1
35498,officiellt,0,0,1,1
51230,verstehe,0,0,1,1
35497,tons,0,0,1,1
51238,wilde,0,0,1,1
35495,tegenstrijdige,0,0,1,1
51239,hazlo,0,0,1,1
51241,leken,0,0,1,1
35492,dağıtma,0,0,1,1
51242,ثري,0,0,1,1
35490,guarantee,0,0,1,1
35489,والثروات,0,0,1,1
35488,underwater,0,0,1,1
51233,balkondan,0,0,1,1
35511,இன்றிரவு,0,0,1,1
35529,tribos,0,0,1,1
51217,ameliorating,0,0,1,1
51211,natur,0,0,1,1
35527,ഭാഷാസ്വാധീനമുണ്ടാവും,0,0,1,1
51214,"
baixo",0,0,1,1
35526,recherchons,0,0,1,1
35525,விளக்குங்கள்,0,0,1,1
35524,древней,0,0,1,1
35523,приятным,0,0,1,1
35522,spectre,0,0,1,1
51215,ಮೃದುವಾದ,0,0,1,1
51216,эффективным,0,0,1,1
51218,imprimables,0,0,1,1
51228,egoïstische,0,0,1,1
51219,söylediğinizi,0,0,1,1
35518,നൽകിയ,0,0,1,1
51221,परे,0,0,1,1
51222,φεύγω,0,0,1,1
51223,brandt,0,0,1,1
51224,«получение,0,0,1,1
35515,الساعة,0,0,1,1
51226,verstehen,0,0,1,1
35513,αποφεύγοντας,0,0,1,1
51227,λήθαργοι,0,0,1,1
49287,добавлять,0,0,1,1
48760,sociologer,0,0,1,1
49285,knappen,0,0,1,1
42054,செய்வதன்,0,0,1,1
45810,poliert,0,0,1,1
45811,വ്യക്തിയാണെന്നും,0,0,1,1
42061,neutraal,0,0,1,1
45812,formatering,0,0,1,1
42060,skikke,0,0,1,1
45814,sociales…,0,0,1,1
42059,pruebas,0,0,1,1
42056,emphasis,0,0,1,1
45815,konkurrens,0,0,1,1
45816,معطل,0,0,1,1
45817,leiden,0,0,1,1
42051,artificiell,0,0,1,1
45808,போலவும்,0,0,1,1
42050,министром,0,0,1,1
45819,അഭിനയിച്ചതിൽ,0,0,1,1
42048,läsarens,0,0,1,1
45820,പ്രശ്നങ്ങളെ,0,0,1,1
45821,disminuido,0,0,1,1
45822,noie,0,0,1,1
45823,traurig,0,0,1,1
45825,clásicas,0,0,1,1
45826,tillgängligt,0,0,1,1
45827,консультируются»,0,0,1,1
45828,tolke,0,0,1,1
42063,ಕೆಳಕ್ಕೆ,0,0,1,1
45807,haline,0,0,1,1
42043,готовы,0,0,1,1
45793,мюнхене,0,0,1,1
45785,ganz,0,0,1,1
45786,குறிப்பிடத்தக்க,0,0,1,1
42084,perceived,0,0,1,1
42083,πρώτο,0,0,1,1
45787,نتائج,0,0,1,1
45789,மரகதங்களின்,0,0,1,1
45790,autorité,0,0,1,1
42079,regulamentações,0,0,1,1
42078,மகளின்,0,0,1,1
45792,natuurwetenschap,0,0,1,1
42077,எடுத்து,0,0,1,1
42076,anlamakta,0,0,1,1
45804,സുന്ദരിയാകാൻ,0,0,1,1
45796,velocidade,0,0,1,1
42075,колледжа,0,0,1,1
45797,superó,0,0,1,1
42073,പരസ്പരബന്ധമില്ലാത്ത,0,0,1,1
42072,suretiyle,0,0,1,1
42071,شديد,0,0,1,1
45799,ഫോണ്ട്,0,0,1,1
45800,छोड़ने,0,0,1,1
42070,ഇന്റർനെറ്റുമായി,0,0,1,1
45803,juegos,0,0,1,1
42068,¿estaría,0,0,1,1
45829,bölümü,0,0,1,1
45835,rapides,0,0,1,1
42004,immune,0,0,1,1
42013,البرنامج،,0,0,1,1
42021,nomeados,0,0,1,1
45861,subfield,0,0,1,1
42019,resultant,0,0,1,1
42018,संबंधित,0,0,1,1
45863,dichotomy,0,0,1,1
45864,привлечь,0,0,1,1
42017,methoden,0,0,1,1
42016,threats,0,0,1,1
42015,investigan,0,0,1,1
42014,dactylographié,0,0,1,1
45865,olsa,0,0,1,1
42012,محفوظات,0,0,1,1
45859,comporte,0,0,1,1
42011,جوعا,0,0,1,1
42010,أخرى؟,0,0,1,1
42009,സ്വാഭാവികമായി,0,0,1,1
45867,visualisera,0,0,1,1
45869,ஆழமாக,0,0,1,1
42007,основатели,0,0,1,1
45870,sorvete,0,0,1,1
42006,frihed,0,0,1,1
45871,paseo,0,0,1,1
45872,मुहम्मद,0,0,1,1
45874,чертой,0,0,1,1
42022,ಕ್ರಿಯೆ,0,0,1,1
45858,टुकड़ा,0,0,1,1
45837,сложных,0,0,1,1
42035,குறிக்கப்,0,0,1,1
42042,гдето,0,0,1,1
45839,получивший,0,0,1,1
45840,प्रॉजेक्ट्स,0,0,1,1
45841,afluencia,0,0,1,1
45842,zinkt,0,0,1,1
45843,ಮಾಡಬಾರದು,0,0,1,1
42038,അഭിപ്രായങ്ങൾ,0,0,1,1
42037,tranen,0,0,1,1
42036,limiting,0,0,1,1
45845,ತಂದಿದ್ದೇನೆ,0,0,1,1
45847,aprendiendo,0,0,1,1
45848,androidenheder,0,0,1,1
45857,violant,0,0,1,1
45849,"
galego",0,0,1,1
42032,щелкнувший,0,0,1,1
45850,സ്വാതന്ത്ര്യമില്ല,0,0,1,1
42030,tratados,0,0,1,1
42029,அதிர்ஷ்டத்தின்,0,0,1,1
45852,daarbij,0,0,1,1
42027,dosyaları,0,0,1,1
42026,behagelig,0,0,1,1
45853,düğmesini,0,0,1,1
45854,ihtiyacım,0,0,1,1
45856,бора,0,0,1,1
42085,bildiğin,0,0,1,1
45783,interrogação,0,0,1,1
45782,« à,0,0,1,1
42140,framför,0,0,1,1
45721,mi‑,0,0,1,1
45722,weliswaar,0,0,1,1
42148,troupes,0,0,1,1
42147,sayede,0,0,1,1
45724,olanı,0,0,1,1
45725,പോകണമെന്ന്,0,0,1,1
45726,உங்களுக்குச்,0,0,1,1
42144,chapitre,0,0,1,1
42143,अनजाने,0,0,1,1
42142,atendidos,0,0,1,1
45728,deliberate,0,0,1,1
42139,denunció,0,0,1,1
42153,därigenom,0,0,1,1
42138,—al,0,0,1,1
42137,solitude,0,0,1,1
45729,தொடக்கத்திற்குப்,0,0,1,1
45731,περιστατικά,0,0,1,1
45733,деревушке,0,0,1,1
45734,schleppenden,0,0,1,1
45735,προετοιμαζόμουν,0,0,1,1
42135,обобщению,0,0,1,1
45737,mensajero,0,0,1,1
45738,exhibits,0,0,1,1
42134,cariño,0,0,1,1
42152,artikelförfattarna,0,0,1,1
42154,فربما,0,0,1,1
45781,வந்தன,0,0,1,1
45709,ആസ്പദമാക്കി,0,0,1,1
45704,hierarchy,0,0,1,1
42173,kişiye,0,0,1,1
42172,воплощение,0,0,1,1
42171,fermée,0,0,1,1
42170,instituida,0,0,1,1
45706,признал,0,0,1,1
42167,évolutif,0,0,1,1
45707,contido,0,0,1,1
45708,مساعدتي,0,0,1,1
42166,sock,0,0,1,1
42165,consequently,0,0,1,1
42164,απίστευτα,0,0,1,1
45720,avsluta,0,0,1,1
45710,« naturels »,0,0,1,1
45711,deberíamos,0,0,1,1
42161,cavalgou,0,0,1,1
42160,കെട്ടുറപ്പുള്ള,0,0,1,1
45712,entreolharam,0,0,1,1
42159,yapacağım,0,0,1,1
45716,funktionieren,0,0,1,1
45718,incrustar,0,0,1,1
45719,coexistieron,0,0,1,1
42156,urval,0,0,1,1
42155,désuets,0,0,1,1
42133,neerzet,0,0,1,1
42132,മാംസം,0,0,1,1
45739,verdrietig,0,0,1,1
45767,resolved,0,0,1,1
42107,histórico,0,0,1,1
42106,yaparım,0,0,1,1
42105,കണ്ണുകളും,0,0,1,1
42104,sensory,0,0,1,1
45759,notify,0,0,1,1
42103,ಭೇಟಿಯಾಗುತ್ತೀರಿ,0,0,1,1
45760,monument,0,0,1,1
42101,eukaryotes,0,0,1,1
42100,побудило,0,0,1,1
45764,ಕಲಿಕೆಯನ್ನು,0,0,1,1
45765,prenais,0,0,1,1
42096,ಸುಂದರವಾಗಿದ್ದಾಳೆಂದು,0,0,1,1
42131,logique ,0,0,1,1
42094,rigtighed,0,0,1,1
45770,thésaurus,0,0,1,1
42093,deskundigen,0,0,1,1
45775,ಕೋಪಗೊಂಡಿದ್ದಾರೆ,0,0,1,1
45776,अलाइक,0,0,1,1
45777,consultado,0,0,1,1
45778,привилегированных,0,0,1,1
45779,noiva,0,0,1,1
42089,hispana,0,0,1,1
45780,സാമാന്യം,0,0,1,1
42088,grundprincipen,0,0,1,1
45756,encyclopedia،,0,0,1,1
45753,ilegível,0,0,1,1
45752,ಬಳಕೆಗಾಗಿ,0,0,1,1
45751,assar,0,0,1,1
42130,ονειρεμένη,0,0,1,1
42129,hoge,0,0,1,1
42128,παντρεμένοι,0,0,1,1
45740,வழமையான,0,0,1,1
42126,gefängnissen,0,0,1,1
42125,planètes,0,0,1,1
42124,متحمسون,0,0,1,1
45741,"
स्पेनी",0,0,1,1
42122,लीब्रे,0,0,1,1
42121,confronter,0,0,1,1
45742,такова,0,0,1,1
45743,ഷെല്ലിന്റെ,0,0,1,1
42117,revision,0,0,1,1
42116,changea,0,0,1,1
45744,amid,0,0,1,1
45745,ബി,0,0,1,1
45746,conduzido,0,0,1,1
45748,पेशकश,0,0,1,1
42113,asturiëprijs,0,0,1,1
45749,निषिद्ध,0,0,1,1
42111,hüzünlü,0,0,1,1
42110,الفساتين,0,0,1,1
45750,l’inverse,0,0,1,1
45875,приступим,0,0,1,1
42003,تذكرها,0,0,1,1
42176,ηρεμήσεις,0,0,1,1
45998,obteve,0,0,1,1
41903,distribute,0,0,1,1
41901,moeilijke,0,0,1,1
45991,relacionadas,0,0,1,1
41899,fusão,0,0,1,1
45992,يقال,0,0,1,1
45993,calcified,0,0,1,1
41898,melekle,0,0,1,1
41897,ಹೊರಡುವ,0,0,1,1
41896,തിരുത്തുന്നു,0,0,1,1
45995,admites,0,0,1,1
41895,caja,0,0,1,1
45999,escritores,0,0,1,1
41904,языках,0,0,1,1
46000,demuestre,0,0,1,1
46001,подкреплены,0,0,1,1
46002,réaction,0,0,1,1
41890,навсегда,0,0,1,1
41889,आलसी,0,0,1,1
46005,tormentosa,0,0,1,1
41886,sorunu,0,0,1,1
46006,координационным,0,0,1,1
41885,intentan,0,0,1,1
41884,संक्षिप्त,0,0,1,1
46008,compreensiva,0,0,1,1
45990,κρεβάτι,0,0,1,1
41905,चित्र,0,0,1,1
46011,quejarse,0,0,1,1
45979,bloqueadas,0,0,1,1
41926,companhia,0,0,1,1
45973,الانقسام,0,0,1,1
41924,bräuchen,0,0,1,1
45974,украинскими,0,0,1,1
45975,വരാനുള്ള,0,0,1,1
41922,completos,0,0,1,1
41921,testet,0,0,1,1
41919,yerini,0,0,1,1
45976,citable,0,0,1,1
45978,जाये।,0,0,1,1
41917,ചങ്ങാതിമാരും,0,0,1,1
41916,ζητήσω,0,0,1,1
41907,ಥಂಬ್ಸ್,0,0,1,1
45980,പങ്കു,0,0,1,1
41915,trafic »,0,0,1,1
41914,फैंसी,0,0,1,1
45982,delegados,0,0,1,1
45983,ಮಾತನಾಡುತ್ತಿದ್ದೀರಿ,0,0,1,1
45985,residências,0,0,1,1
45986,bytes,0,0,1,1
41911,académicos—,0,0,1,1
41910,الكتابة,0,0,1,1
41909,découle,0,0,1,1
41908,وتحاول,0,0,1,1
41881,español—​,0,0,1,1
41879,önemlidir,0,0,1,1
42002,décrivant,0,0,1,1
46041,"
सर्बियाई",0,0,1,1
41848,सम्मेलनों,0,0,1,1
41847,ocultados,0,0,1,1
41845,ಕೇಳುತ್ತಿದೆ,0,0,1,1
41844,остановились,0,0,1,1
41843,ലേഖകസംഘം,0,0,1,1
41842,يقاس,0,0,1,1
41841,δρόμο,0,0,1,1
46039,eclipsando,0,0,1,1
41839,« philosophie,0,0,1,1
41838,μηbrainer,0,0,1,1
41837,ontmoeting,0,0,1,1
46043,ഗൂണാങ്കങ്ങളിൽ,0,0,1,1
46036, مليار,0,0,1,1
41835,cometer,0,0,1,1
46044,добровольных,0,0,1,1
46045,horreur,0,0,1,1
41833,أوائل,0,0,1,1
41832,«в,0,0,1,1
41831,blindtester,0,0,1,1
41829,administrateurs,0,0,1,1
41828,അന്ന്,0,0,1,1
41826,artigt,0,0,1,1
41825,femhundra,0,0,1,1
46054,ഉറക്കമുണർന്നു,0,0,1,1
41849,plagiarizing,0,0,1,1
41850,posent,0,0,1,1
46013,underpolicyer,0,0,1,1
41866,pratique ,0,0,1,1
41877,çalışabilir,0,0,1,1
46018,cliquear,0,0,1,1
46019,മലയാളത്തില്,0,0,1,1
46021,eons,0,0,1,1
41873,للهوية,0,0,1,1
46022,ದೌರ್ಜನ್ಯವನ್ನು,0,0,1,1
46023,ജീവൻ,0,0,1,1
46024,el •,0,0,1,1
41870,tectoniques,0,0,1,1
46026,entretanto,0,0,1,1
41868,بزيارة,0,0,1,1
46028,человеческий,0,0,1,1
41852,tillfälligt,0,0,1,1
41864,addressed,0,0,1,1
41863,‘குழுச்,0,0,1,1
41861,പ്രവർത്തിച്ചാണ്,0,0,1,1
41860,konst,0,0,1,1
41859,ağlıyorsa,0,0,1,1
41858,ಒಂದಕ್ಕಿಂತ,0,0,1,1
46030,vertegenwoordigers,0,0,1,1
46031,запретить,0,0,1,1
41856,manuales,0,0,1,1
41854,γαλλικός,0,0,1,1
46034,தொகுத்துள்ளார்,0,0,1,1
45972,kvinna,0,0,1,1
41928,ആദ്യ,0,0,1,1
45967,παρά,0,0,1,1
45911,मुस्कुरा,0,0,1,1
45900,waters,0,0,1,1
41979,çevrimiçi,0,0,1,1
41977,dependence,0,0,1,1
45902,propiciado,0,0,1,1
41976,pommes,0,0,1,1
45903,altında,0,0,1,1
45904,раскритиковано,0,0,1,1
41973,нагрузку,0,0,1,1
45905,doğrulanabilecek,0,0,1,1
45906,حلت,0,0,1,1
45908,universität,0,0,1,1
45913,مسيئة،,0,0,1,1
45899,emplaced,0,0,1,1
41971,σήμα,0,0,1,1
41970,bekostnad,0,0,1,1
45914,slak,0,0,1,1
45915,conventional,0,0,1,1
41969,सीमाओं,0,0,1,1
45917,assustador,0,0,1,1
41968,बनता,0,0,1,1
45918,يجعلها,0,0,1,1
41967,ಕುಳಿತಿದ್ದ,0,0,1,1
41965,американский,0,0,1,1
41964,grise,0,0,1,1
41980,നിയമങ്ങൾ,0,0,1,1
45898,sedimentary,0,0,1,1
41929,samenvatting,0,0,1,1
41993,சலுகைகள்,0,0,1,1
42001,pms •,0,0,1,1
45877,episk,0,0,1,1
41999,«criterios,0,0,1,1
45879,"
फ़िनिश",0,0,1,1
41998,stabilise,0,0,1,1
45883,прослеживает,0,0,1,1
41996,ಕುಳಿತಿದ್ದಾರೆ,0,0,1,1
45885,"
इस्परान्तो",0,0,1,1
45886,talloze,0,0,1,1
45887,опубликовавшими,0,0,1,1
41994,يرام,0,0,1,1
45890,குறைவான,0,0,1,1
41982,குறிக்கிறீர்கள்,0,0,1,1
45891,colocan,0,0,1,1
41992,السيرة,0,0,1,1
45892,middelen,0,0,1,1
41991,نمط,0,0,1,1
45895,medias,0,0,1,1
41988,efterfrågar,0,0,1,1
45896,umkreisen,0,0,1,1
45897,обычаями,0,0,1,1
41985,sohbet,0,0,1,1
41984,quedó,0,0,1,1
41983,взяла,0,0,1,1
45922,καταπληκτικού,0,0,1,1
41963,வங்கிக்,0,0,1,1
45923,ಅಲ್ಲಿರುವ,0,0,1,1
45959,grander,0,0,1,1
41943,ಪ್ರಯಾಣವನ್ನು,0,0,1,1
45952,zweifel,0,0,1,1
45953,exponentially,0,0,1,1
45954,undersöks,0,0,1,1
45955,تكتب,0,0,1,1
41942,imprima,0,0,1,1
41941,vereyim,0,0,1,1
41940,أرسل,0,0,1,1
41939,അൽഗോരിതങ്ങൾ,0,0,1,1
41937,الشهير,0,0,1,1
45957,killer—a,0,0,1,1
45960,borrando,0,0,1,1
45926,consideremos,0,0,1,1
45961,görande,0,0,1,1
41935,شخصا,0,0,1,1
45962,grym,0,0,1,1
41934,слубице,0,0,1,1
41933,tagit,0,0,1,1
45963,അവലംബമായി,0,0,1,1
41932,sindet,0,0,1,1
45965,« wikipedia,0,0,1,1
45966,личных,0,0,1,1
41931,« usage,0,0,1,1
41930,sümüklüböcek,0,0,1,1
41944,нозека,0,0,1,1
45951,അഹംഭാവമുള്ള,0,0,1,1
45950,inactivity,0,0,1,1
45949,ಪ್ರಶ್ನೆ,0,0,1,1
41961,arguably,0,0,1,1
41960,செய்யத்,0,0,1,1
41959,casheservrar,0,0,1,1
41958,avbryta,0,0,1,1
45928,oätligt,0,0,1,1
41957,skeçler,0,0,1,1
45929,indicates,0,0,1,1
41956,nærheden,0,0,1,1
45931,முன்னரே,0,0,1,1
41954,gældende,0,0,1,1
41953,sauvegarde,0,0,1,1
45933,officially,0,0,1,1
45934,എഴുതാൻപോരുന്നവരാ‍യാൽ,0,0,1,1
45935,virtually,0,0,1,1
45937,paquetes,0,0,1,1
41950,succinct,0,0,1,1
41949,μπορούν,0,0,1,1
45939,экспоненциально,0,0,1,1
41947,நடவடிக்கையின்,0,0,1,1
45941,géomagnétiqueréf,0,0,1,1
45943,yazdım,0,0,1,1
45947,وتبدو,0,0,1,1
45948,المجاني,0,0,1,1
42175,жаловаться,0,0,1,1
45698,"
arménio",0,0,1,1
41823,supin,0,0,1,1
42426,занимался,0,0,1,1
42436,mundial​,0,0,1,1
42435,bidragsgivarna,0,0,1,1
42434,maalesef,0,0,1,1
45475,προτού,0,0,1,1
42433,supervisionar,0,0,1,1
42432,البريد,0,0,1,1
42431,вежливым,0,0,1,1
45478,отражаться,0,0,1,1
42430,doneren,0,0,1,1
42429,emocionante,0,0,1,1
45479,undrade,0,0,1,1
45481,proposant,0,0,1,1
42438,വിഷയത്തിൽ,0,0,1,1
45482,திடீரென்று,0,0,1,1
45483,associé,0,0,1,1
42424,பொம்மை,0,0,1,1
42423,liberado,0,0,1,1
45485,sederna,0,0,1,1
45488,συμπεριλαμβανομένης,0,0,1,1
42422,kapitalistiska,0,0,1,1
42421,τρελό,0,0,1,1
45489,παντρευτώ,0,0,1,1
45491,japonaise,0,0,1,1
42418,പത്രങ്ങൾ,0,0,1,1
42437,parallèlement,0,0,1,1
45474,llama,0,0,1,1
42417,أتزوجك,0,0,1,1
45462,forestil,0,0,1,1
42458,liaison,0,0,1,1
45443,इयर,0,0,1,1
45444,subgrupos,0,0,1,1
42457,deltagande,0,0,1,1
45451,gillar,0,0,1,1
42455,frem,0,0,1,1
45453,серебряный,0,0,1,1
45455,persistaient,0,0,1,1
45456,رأيين,0,0,1,1
45457,nogmaals,0,0,1,1
45458,tief,0,0,1,1
45463,reverrais,0,0,1,1
42439,மாட்டீர்கள்,0,0,1,1
45464,റഷ്യൻ,0,0,1,1
45465,meşgulse,0,0,1,1
45469,engendrement,0,0,1,1
45470,iteration,0,0,1,1
42444,révèle,0,0,1,1
45471,complaint,0,0,1,1
42443,abdecken,0,0,1,1
42442,känsliga,0,0,1,1
42441,afterward,0,0,1,1
45472,comparaisons,0,0,1,1
42440,spitzen,0,0,1,1
45492,المجهولين،,0,0,1,1
45493,ursäkt,0,0,1,1
45536,παγκόσμια,0,0,1,1
42385,pick,0,0,1,1
45516,исключением,0,0,1,1
42393,الأَشغال,0,0,1,1
42392,просмотракомм,0,0,1,1
42390,camino,0,0,1,1
45519,horsligne,0,0,1,1
42389,प्रौद्योगिकी,0,0,1,1
45520,أعرفها,0,0,1,1
45521,ملياري,0,0,1,1
45522,контексте,0,0,1,1
45523,ونتيجة,0,0,1,1
42386,ангела,0,0,1,1
42383,conversar,0,0,1,1
45514,« portail »,0,0,1,1
45526,longstanding,0,0,1,1
45527,ændre,0,0,1,1
42382,ಒಪ್ಪಿಕೊಂಡರೆ,0,0,1,1
42381,ஆகியோரால்,0,0,1,1
42379,"
tártaro",0,0,1,1
45528,répercussions,0,0,1,1
45532,bevatten,0,0,1,1
45533,mécaniques,0,0,1,1
42377,маме,0,0,1,1
45534,saknat,0,0,1,1
45535,hiérarchique,0,0,1,1
42394,reversiones,0,0,1,1
45512,cruels,0,0,1,1
45494,призваны,0,0,1,1
42406,ознакомления,0,0,1,1
42415,formateras,0,0,1,1
45495,безумие,0,0,1,1
42414,ದಾಸಿಯರು,0,0,1,1
42413,fraudes,0,0,1,1
45496,χρειάζομαι,0,0,1,1
42412,télévisées,0,0,1,1
42411,revidera,0,0,1,1
42410,cuja,0,0,1,1
45497,ஆள்களப்,0,0,1,1
42407,trazia,0,0,1,1
45498,നെഗറ്റീവും,0,0,1,1
45502,escriba,0,0,1,1
42398,скачать,0,0,1,1
45503,surutilisé,0,0,1,1
42405,لشبكات,0,0,1,1
42404,renvoyé,0,0,1,1
45504,ligações,0,0,1,1
45505,മീറ്റിംഗിനും,0,0,1,1
42401,analys,0,0,1,1
45506,ಸೈನಿಕರಿಗೆ,0,0,1,1
45507,smaken,0,0,1,1
45508,kodeord,0,0,1,1
42399,சொற்களில்,0,0,1,1
45510,adını,0,0,1,1
45442,ഗുണാങ്കങ്ങൾക്ക്,0,0,1,1
42459,കണക്കുകൂട്ടൽ,0,0,1,1
42460,anlamsızca,0,0,1,1
45400,expertgranskning,0,0,1,1
42524,refinado,0,0,1,1
45396,واحصل,0,0,1,1
42522,مرخص,0,0,1,1
45397,underholdende,0,0,1,1
42521,wensen,0,0,1,1
45398,diste,0,0,1,1
42519,نقل,0,0,1,1
42518,المجالات,0,0,1,1
42517,massachusetts,0,0,1,1
45399,المفضل,0,0,1,1
42515,caras,0,0,1,1
42514,ടൈപ്പുചെയ്യുക,0,0,1,1
45395,üyelik,0,0,1,1
42513,يلجأ,0,0,1,1
45401,årevis,0,0,1,1
42512,région,0,0,1,1
42511,τείνουμε,0,0,1,1
45404,tellurique,0,0,1,1
42509,contraria,0,0,1,1
42507,திரைப்படங்களுக்குச்,0,0,1,1
45405,έργο,0,0,1,1
42505,plug,0,0,1,1
42504,interesadamente,0,0,1,1
45407,நிலை,0,0,1,1
42525,நடுநிலைமையை,0,0,1,1
42528,fart,0,0,1,1
45441,saken,0,0,1,1
45382,basándose,0,0,1,1
42549,abartmak,0,0,1,1
42548,تيرنس,0,0,1,1
45374,العقل,0,0,1,1
45377,sayfada,0,0,1,1
42544,korsar,0,0,1,1
45378,conoces,0,0,1,1
45379,தெரிவித்தது,0,0,1,1
45381,തോന്നുന്നതുപോലെ,0,0,1,1
42539,ποτήρι,0,0,1,1
42538,മാസങ്ങളിൽ,0,0,1,1
42537,ತಂಪಾಗಿರಲು,0,0,1,1
45383,afunda,0,0,1,1
45389,kwaad,0,0,1,1
42535,العظمى,0,0,1,1
45384,ಸೈನ್ಯದ,0,0,1,1
45385,ಗಾಡಿಯೊಂದಿಗೆ,0,0,1,1
42534,сотрудничеству,0,0,1,1
45386,språkgrupp,0,0,1,1
45387,stärka,0,0,1,1
45388,owned,0,0,1,1
42532,joueurs,0,0,1,1
42531,doneerde,0,0,1,1
42530,instantanément,0,0,1,1
42529,குறிப்பிட,0,0,1,1
45408,anciennes,0,0,1,1
45410,encyclopedically,0,0,1,1
42500,தொடர்வதற்கு,0,0,1,1
45433,spisebordet,0,0,1,1
45427,கொண்டிருந்தாலும்,0,0,1,1
42478,экономика,0,0,1,1
45430,arbejder,0,0,1,1
42477,gönüllülerin,0,0,1,1
42476,confusa,0,0,1,1
42475,ವಯಸ್ಸಿನ,0,0,1,1
42474,ಪಡೆಯಬೇಕು,0,0,1,1
42473,كومنز,0,0,1,1
45431,ചെയ്തിട്ടില്ലെങ്കിൽ,0,0,1,1
45432,പിന്നിലെ,0,0,1,1
42472,reclamando,0,0,1,1
42471,formuler,0,0,1,1
45411,ochtend,0,0,1,1
45436,ciência,0,0,1,1
42469,மூழ்கிவிடும்,0,0,1,1
42468,thick,0,0,1,1
45437,поддерживались,0,0,1,1
45438,മുൻപ്,0,0,1,1
45439,contaba,0,0,1,1
42467,değiştirebilir,0,0,1,1
42464,« rapide »,0,0,1,1
42463,டிசம்பர்,0,0,1,1
45440,matematiska,0,0,1,1
42461,ഭ്രാന്താണ്,0,0,1,1
42480,frightening,0,0,1,1
42481,espéronsle,0,0,1,1
45426,அறிவியல்,0,0,1,1
42482,категориям,0,0,1,1
45412,троллями,0,0,1,1
45413,tenga,0,0,1,1
42498,générales,0,0,1,1
42497,μαρμελάδες,0,0,1,1
42496,الجيش,0,0,1,1
42495,лидер,0,0,1,1
45417,നെഗറ്റീവ്,0,0,1,1
45418,fragezeichen,0,0,1,1
42494,migrés,0,0,1,1
42493,anónimos,0,0,1,1
45419,ಹೇಳಬಹುದಾದ,0,0,1,1
42491,hingekommen,0,0,1,1
42489,deeply,0,0,1,1
42488,"
जापानी",0,0,1,1
45421,copiaron,0,0,1,1
42487,അഭിനന്ദിക്കുന്നതിനുള്ള,0,0,1,1
42486,كافحت,0,0,1,1
42485,excelente,0,0,1,1
42484,ആളുകൾക്ക്,0,0,1,1
45422,databasserver,0,0,1,1
45423,drunkning,0,0,1,1
45424,waffling—encouraged,0,0,1,1
45425,ditesvous,0,0,1,1
42375,ചുട്ടെടുക്കാൻ,0,0,1,1
45537,"
मांक्स",0,0,1,1
42178,parciales,0,0,1,1
42234,بها،,0,0,1,1
45637,ഇതൊക്കെ,0,0,1,1
42247,ഗുജറാത്തി,0,0,1,1
45638,omitidas,0,0,1,1
45639,αγαπούσε,0,0,1,1
42244,nica en,0,0,1,1
42243,foutjes,0,0,1,1
42240,പുഞ്ചിരിച്ചു,0,0,1,1
42239,gewaltig,0,0,1,1
42238,dries,0,0,1,1
42237,шутите,0,0,1,1
42236,english،,0,0,1,1
45643,drawings,0,0,1,1
45635,твоей,0,0,1,1
42233,woordenboek,0,0,1,1
45644,soil,0,0,1,1
42232,erfgoed,0,0,1,1
42230,croyances,0,0,1,1
42229,damwikipediaorg,0,0,1,1
45646,θαυμαστικές,0,0,1,1
45647,sattığını,0,0,1,1
45649,года — »,0,0,1,1
42227,بإصلاح,0,0,1,1
42226,beresheet,0,0,1,1
45651,visualiseringsverktyg,0,0,1,1
42250,رحلاته,0,0,1,1
45634,ಸಂದರ್ಶನವೊಂದರಲ್ಲಿ,0,0,1,1
42223,സ്ത്രീകൾക്ക്,0,0,1,1
45624,لجميع,0,0,1,1
45618,motståndare,0,0,1,1
42272,अनुमान,0,0,1,1
42271,"
लग्ज़म्बर्गी",0,0,1,1
45619,القدرة,0,0,1,1
45620,കഴിക്കണം,0,0,1,1
45621,rød,0,0,1,1
42268,അങ്ങനെയുള്ള,0,0,1,1
45622,أخفقت,0,0,1,1
42266,werkwoord,0,0,1,1
45623,intrusions,0,0,1,1
42264,pular,0,0,1,1
45625,എന്നും,0,0,1,1
42253,cumplan,0,0,1,1
42263,heurísticas,0,0,1,1
42262,desanimadoras,0,0,1,1
45627,рода,0,0,1,1
45628,സിദ്ധാന്ത,0,0,1,1
42260,tarafsızlık,0,0,1,1
45631,ουδετερότητας,0,0,1,1
45632,обнаружить,0,0,1,1
42258,ಉತ್ತರಿಸಬಹುದು,0,0,1,1
42257,cravejada,0,0,1,1
42255,réglementant,0,0,1,1
42254,بيركمان,0,0,1,1
42224,mathebuch,0,0,1,1
42222,ಬದಲಾಗಿದ್ದಾಳೆ,0,0,1,1
42373,ബെൽ,0,0,1,1
45687,fortfahren,0,0,1,1
45675,ضخم,0,0,1,1
45676,grüße,0,0,1,1
45678,opponent,0,0,1,1
45679,periódico—,0,0,1,1
42195,tenant,0,0,1,1
45680,immediately,0,0,1,1
45682,göründüğünde,0,0,1,1
45684,сентябре,0,0,1,1
42191,magst,0,0,1,1
42190,മെയിൽ,0,0,1,1
45686,எப்படியாவது,0,0,1,1
45689,δώρο,0,0,1,1
42198,läroböcker,0,0,1,1
42187,enheten,0,0,1,1
45690,numériques,0,0,1,1
45692,ومشاريع,0,0,1,1
42185,удовольствием,0,0,1,1
45693,восемь,0,0,1,1
45694,sarayımda,0,0,1,1
42183,إضافيًا,0,0,1,1
42182,echte,0,0,1,1
45695,diferencias,0,0,1,1
45697,उपलब्धियों,0,0,1,1
42179,lunar,0,0,1,1
45674,veria,0,0,1,1
45673,फ़ाइलें,0,0,1,1
42221,groeien,0,0,1,1
45658,tropperne,0,0,1,1
45653,சொல்வதைச்,0,0,1,1
42219,personalizadas,0,0,1,1
42218,vollständig,0,0,1,1
42217,ಆವರಿಸಿಕೊಳ್ಳಬಹುದೇ,0,0,1,1
42216,पब्लिक,0,0,1,1
45654,darme,0,0,1,1
42214,القليلة,0,0,1,1
45655,جزء,0,0,1,1
45656,تفعل؟,0,0,1,1
42211,العودة,0,0,1,1
45657,girdi,0,0,1,1
45659,mecanismo,0,0,1,1
42200,consultam,0,0,1,1
45660,depicts,0,0,1,1
45661,reducir,0,0,1,1
42208,അത്തരത്തിൽ,0,0,1,1
45663,intimidating,0,0,1,1
42207,fluidos,0,0,1,1
45664,ಅಡ್ಡಿಪಡಿಸುವುದು,0,0,1,1
42206,നേടിയിട്ടുണ്ടെങ്കിൽ,0,0,1,1
42205,preferiría,0,0,1,1
45665,sérieux,0,0,1,1
45669,ενημερώστε,0,0,1,1
45671,contratarte,0,0,1,1
45617,recorde,0,0,1,1
42274,سلبية,0,0,1,1
45616,लिखें,0,0,1,1
45568,"
डैनिश",0,0,1,1
42350,قلعة,0,0,1,1
45560,ссылается,0,0,1,1
45562,teller,0,0,1,1
42346,ഇന്നും,0,0,1,1
45564,അടുത്തത്,0,0,1,1
42344,finir,0,0,1,1
45565,dotters,0,0,1,1
42342,narcissmamma,0,0,1,1
45566,वर्षों,0,0,1,1
42341,reprises,0,0,1,1
45567,продвижение,0,0,1,1
42340,ladies,0,0,1,1
45558,chats,0,0,1,1
45570,അല്ലാത്തവയെയും,0,0,1,1
42339,læsere,0,0,1,1
45571,conditionnant,0,0,1,1
42337,hartstikke,0,0,1,1
45572,പ്രവർത്തനത്തിലൂടെ,0,0,1,1
42336,nähe,0,0,1,1
42335,ഫലത്തിലെത്താൻ,0,0,1,1
42332,subdomínio,0,0,1,1
42331,"
occitano",0,0,1,1
42330,புளகாங்கிதம்,0,0,1,1
42329,δουλεύει,0,0,1,1
42351,دخل,0,0,1,1
45557,முழுமையானது,0,0,1,1
45615,balcony,0,0,1,1
42364,ഒരാൾക്ക്,0,0,1,1
42372,«cómo,0,0,1,1
42371,renginde,0,0,1,1
42370,similar—,0,0,1,1
45538,அச்சுவழிப்,0,0,1,1
42369,handlede,0,0,1,1
42368,permiten,0,0,1,1
45539,قائلاً،,0,0,1,1
45541,καθένας,0,0,1,1
45542,أتحدث,0,0,1,1
42366,webbaserad,0,0,1,1
42365,uygunluğu,0,0,1,1
45547,анализ,0,0,1,1
45556,وقال,0,0,1,1
42361,ಶ್ರೀಮಂತರು,0,0,1,1
45548,ಮನುಷ್ಯನಿಗೆ,0,0,1,1
42358,ಐದು,0,0,1,1
42357,செய்யப்படுகின்றன,0,0,1,1
45550,meleğe,0,0,1,1
45551,"
सिन्धी",0,0,1,1
45553,झुलस,0,0,1,1
42356,rends,0,0,1,1
42355,മൂല്യം,0,0,1,1
45554,structuur,0,0,1,1
45555,bekräftar,0,0,1,1
45576,सामना,0,0,1,1
42328,χίλια,0,0,1,1
45578,വാൻഡലിസത്തിന്,0,0,1,1
45603,frozen,0,0,1,1
42302,nefes,0,0,1,1
42301,«нейтральной,0,0,1,1
45598,турист,0,0,1,1
42300,लेन,0,0,1,1
45601,பள்ளியிலிருந்து,0,0,1,1
42298,ಬ್ರೆಡ್ನೊಂದಿಗೆ,0,0,1,1
42297,تعاملت,0,0,1,1
42296,middenin,0,0,1,1
42295,noem,0,0,1,1
42293,காண,0,0,1,1
42292,запрашивая,0,0,1,1
42287,صنف,0,0,1,1
45579,thousand,0,0,1,1
45606,voltar,0,0,1,1
45607,comente,0,0,1,1
45608,κολλήσετε,0,0,1,1
45610,அதிநவீனமாக,0,0,1,1
42283,تعلمنا,0,0,1,1
45611,skyldes,0,0,1,1
45612,deformational,0,0,1,1
45613,знак,0,0,1,1
42279,entendrez,0,0,1,1
42278,stabilizes,0,0,1,1
42277,permitida,0,0,1,1
45597,hızlandırın,0,0,1,1
42303,ഒന്ന്,0,0,1,1
42304,آرثر,0,0,1,1
42305,тарелке,0,0,1,1
42326,تقييم,0,0,1,1
45580,bakgrund,0,0,1,1
42325,interpretadas,0,0,1,1
45581,tivéssemos,0,0,1,1
45582,ökningen,0,0,1,1
42323,summarizing,0,0,1,1
42322,présentation,0,0,1,1
42321,ليه،,0,0,1,1
42320,hjärna,0,0,1,1
45584,formation,0,0,1,1
42318,çalışmalarda,0,0,1,1
45586,சேர்த்து,0,0,1,1
45587,youif,0,0,1,1
42316,сторону,0,0,1,1
42315,αποδέχομαι,0,0,1,1
45588,مدير,0,0,1,1
42314,ഉപേക്ഷിച്ചിട്ടുണ്ടെങ്കിൽ,0,0,1,1
42311,volop,0,0,1,1
45593,equilibrado,0,0,1,1
45594,soruyu,0,0,1,1
42308,attorney,0,0,1,1
45595,ഭൂമിക്ക്,0,0,1,1
42306,överflödigt,0,0,1,1
41824,وسعد,0,0,1,1
46055,killed,0,0,1,1
49284,местные,0,0,1,1
46503,aning,0,0,1,1
41347,право,0,0,1,1
46492,diretor,0,0,1,1
41345,pludselig,0,0,1,1
46493,forth,0,0,1,1
46494,magisches,0,0,1,1
46495,ഇവർക്ക്,0,0,1,1
41343,permisesx,0,0,1,1
41341,rundgång,0,0,1,1
41340,sortit,0,0,1,1
46500,providing,0,0,1,1
46501,mãos,0,0,1,1
46504,englischsprachigen,0,0,1,1
41350,administrados,0,0,1,1
46505,músico,0,0,1,1
41334,gungar,0,0,1,1
41333,originales,0,0,1,1
41332,elbiselerden,0,0,1,1
46506,proprietary,0,0,1,1
41329,പറയുന്നതുപോലെ,0,0,1,1
46508,simulationbased,0,0,1,1
41327,اتضح,0,0,1,1
41326,exaggerate,0,0,1,1
41325,olmuştu,0,0,1,1
46509,தொடர,0,0,1,1
41348,سر,0,0,1,1
46491,മാച്ചു,0,0,1,1
46511,reformed,0,0,1,1
41363,gosta,0,0,1,1
46475,democratic,0,0,1,1
41372,συνειδητοποιείς,0,0,1,1
46476,steady,0,0,1,1
41370,seçimler,0,0,1,1
41369,energidrik,0,0,1,1
46477,компетентным,0,0,1,1
41368,hydrogen,0,0,1,1
41366,जाए।,0,0,1,1
46478,распечатал,0,0,1,1
41364,excitant,0,0,1,1
46479,periodismo,0,0,1,1
46480,സാധ്യമാക്കുന്നത്,0,0,1,1
41351,wifetobe,0,0,1,1
46481,inskränkningar,0,0,1,1
46483,треть,0,0,1,1
41359,velocidad,0,0,1,1
41358,bulamadığın,0,0,1,1
41357,സുവേ,0,0,1,1
41356,ثانية,0,0,1,1
46486,ಇಮೇಲ್‌ನಲ್ಲಿ,0,0,1,1
41355,rejetés,0,0,1,1
41354,svårare,0,0,1,1
41353,पर्ल,0,0,1,1
46489,ptmobilewikipediaorg,0,0,1,1
46510,adición,0,0,1,1
41322,विनम्रता,0,0,1,1
46556,تتعرض,0,0,1,1
41289,squelette,0,0,1,1
46527,participe,0,0,1,1
46528,целью,0,0,1,1
41295,fou,0,0,1,1
41294,المادية,0,0,1,1
46529,rigtige,0,0,1,1
46531,préoccupations,0,0,1,1
46534,இணையத்தளம்,0,0,1,1
46535,διαφορετικούς,0,0,1,1
46537,சிக்கியிருப்பதை,0,0,1,1
41290,salz,0,0,1,1
46538,religiously,0,0,1,1
46539,القديم,0,0,1,1
41297,निष्क्रिय,0,0,1,1
46540,ευχαρίστησή,0,0,1,1
46543,tilbage,0,0,1,1
41286,predilecta,0,0,1,1
46546,பகுதிகளிலேயே,0,0,1,1
46548,δουλεύετε,0,0,1,1
41285,النظرية,0,0,1,1
46550,ಆದ,0,0,1,1
41284,الألعاب,0,0,1,1
46551,araştırmada,0,0,1,1
46553,பிரமாதத்திற்கு,0,0,1,1
46554,комментарием,0,0,1,1
46526,расширяется,0,0,1,1
41298,ಪರೀಕ್ಷೆ,0,0,1,1
46513,etiquetas,0,0,1,1
41311,créatures,0,0,1,1
46514,cargo,0,0,1,1
41320,قيودًا,0,0,1,1
41319,skapande,0,0,1,1
41318,dagelijkse,0,0,1,1
41317,oturan,0,0,1,1
41316,डेनियल,0,0,1,1
41315,máster,0,0,1,1
41314,brains,0,0,1,1
46516,опыт,0,0,1,1
41313,لهجات,0,0,1,1
41312,new •,0,0,1,1
46517,ആലിംഗനം,0,0,1,1
41300,മോശമാണ്,0,0,1,1
41308,manifestation,0,0,1,1
46518,жестокий,0,0,1,1
41307,svagheter,0,0,1,1
46521,sporters,0,0,1,1
46522,باردة,0,0,1,1
46523,parodiadas,0,0,1,1
41304,ജോലികൾക്കു,0,0,1,1
46524,கேட்கிறார்கள்,0,0,1,1
41303,wert,0,0,1,1
41302,baktı,0,0,1,1
41301,метод,0,0,1,1
41373,temario,0,0,1,1
41374,γράφεται,0,0,1,1
41375,இருந்தோம்,0,0,1,1
41435,ഏവർക്കുമറിവുള്ളതാണല്ലോ,0,0,1,1
46408,eenzijdiger,0,0,1,1
46409,правильнее,0,0,1,1
41440,ಇನ್ನು,0,0,1,1
46410,estáveis,0,0,1,1
41439,مستنقع,0,0,1,1
41438,αγγελιοφόρου,0,0,1,1
46411,сообщений,0,0,1,1
46412,количеству,0,0,1,1
46413,bölgeden,0,0,1,1
41437,शहरों,0,0,1,1
46414,όντα,0,0,1,1
46417,base ,0,0,1,1
46406,являлось,0,0,1,1
46418,нейронных,0,0,1,1
41432,ajustes,0,0,1,1
46421,revertidos,0,0,1,1
46423,isim,0,0,1,1
46424,toevallig,0,0,1,1
46425,ಅಳುತ್ತಿರುವ,0,0,1,1
41428,gözlerimi,0,0,1,1
46426,sudden,0,0,1,1
41426,ചതുപ്പിന്റെ,0,0,1,1
46427,"
bósnio",0,0,1,1
41424,e symposium,0,0,1,1
46407,regimes,0,0,1,1
41446,petição,0,0,1,1
41376,serieus,0,0,1,1
41457,excuser,0,0,1,1
41466,гриллини,0,0,1,1
41465,днем,0,0,1,1
41464,സുഖമാണോ,0,0,1,1
46393,കരുതുന്നില്ല,0,0,1,1
46394,كمقالات,0,0,1,1
41462,çalışmasının,0,0,1,1
41461,wiskundehuiswerk,0,0,1,1
46395,βάλτου,0,0,1,1
41459,подвержены,0,0,1,1
46397,சிரமமாக,0,0,1,1
41458,négatives,0,0,1,1
41456,paren,0,0,1,1
41447,jenny,0,0,1,1
46398,ficava,0,0,1,1
46399,continuamente,0,0,1,1
41454,संयोजन,0,0,1,1
46400,interdisciplinar,0,0,1,1
46401,всей,0,0,1,1
41452,belangrijke,0,0,1,1
46402,കൂടതൽ,0,0,1,1
41450,inclure,0,0,1,1
41449,പോർച്ചുഗീസ്,0,0,1,1
41448,bevarade,0,0,1,1
46403,stay,0,0,1,1
46428,ಹತ್ತು,0,0,1,1
41423,расстраиваться,0,0,1,1
46430,inconsistencias​,0,0,1,1
46464,निति,0,0,1,1
41399,incompatible,0,0,1,1
41398,lleve,0,0,1,1
41397,conspiracy,0,0,1,1
41396,motstridiga,0,0,1,1
41395,сладкого,0,0,1,1
41394,kullanarak,0,0,1,1
46458,colaboró,0,0,1,1
46459,ονείρων,0,0,1,1
46460,davranış,0,0,1,1
41392,felicitaciones,0,0,1,1
46462,വാട്ട്സ്ആപ്പ്,0,0,1,1
41389,جيدا,0,0,1,1
41422,corridors,0,0,1,1
41388,использовали,0,0,1,1
41387,देश,0,0,1,1
46465,ámsterdam,0,0,1,1
46466,oublie,0,0,1,1
46467,آمل,0,0,1,1
46469,इनके,0,0,1,1
46470,presidenciais,0,0,1,1
41379,resulte,0,0,1,1
46471,செய்தார்கள்,0,0,1,1
46472,oylamalarına,0,0,1,1
46473,उधार,0,0,1,1
46456,suspected,0,0,1,1
41400,шоу,0,0,1,1
41401,എങ്ങനെയിരിക്കും,0,0,1,1
41403,уставшим,0,0,1,1
46431,بنظام,0,0,1,1
46432,இலவசமா,0,0,1,1
41419,എവിടെയെങ്കിലും,0,0,1,1
41418,tome,0,0,1,1
41417,importar,0,0,1,1
46433,soussol,0,0,1,1
41414,صباح,0,0,1,1
46437,beispiele,0,0,1,1
41412,ноябре,0,0,1,1
46438,respectent,0,0,1,1
46440,عنك؟,0,0,1,1
41408,deberían,0,0,1,1
46441,besetzt,0,0,1,1
46445,ξεχνάει,0,0,1,1
46446,കത്തിക്കുന്നു,0,0,1,1
46447,owe,0,0,1,1
41405,böcker,0,0,1,1
46448,« or,0,0,1,1
46449,—tras,0,0,1,1
46451,vazgeçmektedir,0,0,1,1
46453,tropics,0,0,1,1
46454,cares,0,0,1,1
46455,പ്രവർത്തിച്ചവർ,0,0,1,1
46555,pointofsale,0,0,1,1
41281,пародировал,0,0,1,1
41468,классе,0,0,1,1
41163,защитной,0,0,1,1
41170,geïntensiveerd,0,0,1,1
46677,культуре,0,0,1,1
41169,répondu,0,0,1,1
41168,ಉತ್ಪ್ರೇಕ್ಷಿಸಲು,0,0,1,1
41167,ಒಬ್ಟ್ಯೂಸ್,0,0,1,1
41166,старому,0,0,1,1
46678,unbeschreiblich,0,0,1,1
46679,commencent,0,0,1,1
46680,سؤاله,0,0,1,1
46681,സംസാരിക്കാം,0,0,1,1
41164,kvinde,0,0,1,1
41161,"
प्रारंभ",0,0,1,1
46676,μεγαλώσετε,0,0,1,1
46684,indhold,0,0,1,1
41158,typografisk,0,0,1,1
41157,commandement,0,0,1,1
41156,localized,0,0,1,1
46686,resuméer,0,0,1,1
41155,αιτήματα,0,0,1,1
41154,sujetos,0,0,1,1
41153,дилемма,0,0,1,1
46690,захвачена,0,0,1,1
41151,நியூயார்க்கைச்,0,0,1,1
46692,feest,0,0,1,1
41171,интернетсправочником,0,0,1,1
41172,embodied,0,0,1,1
41147,போகும்,0,0,1,1
46664,refereras,0,0,1,1
41192,بالتعب,0,0,1,1
46659,ಸುದ್ದಿಯಲ್ಲಿ,0,0,1,1
41191,предыдущее,0,0,1,1
41190,ಇದಕ್ಕೆ,0,0,1,1
46661,viajando,0,0,1,1
41189,δέκα,0,0,1,1
46662,chargée,0,0,1,1
41188,lese,0,0,1,1
41186,карьеры,0,0,1,1
41185,ηχείου,0,0,1,1
46663,fitted,0,0,1,1
41184,civiles,0,0,1,1
46674,educativas,0,0,1,1
41183,concordar,0,0,1,1
41182,lusteloos,0,0,1,1
46666,cercana,0,0,1,1
41180,juge,0,0,1,1
46667,ansiktet,0,0,1,1
41179,oneself,0,0,1,1
41177,universitarios,0,0,1,1
46668,الرسوم,0,0,1,1
46669,അർബുദം,0,0,1,1
41174,சுவேவ்,0,0,1,1
46671,остановить,0,0,1,1
41148,kamu,0,0,1,1
46694,allezvous,0,0,1,1
46558,июля,0,0,1,1
41114,ಹಾಗಾಗಿ,0,0,1,1
46717,இறங்கினீர்கள்,0,0,1,1
46718,великобритании,0,0,1,1
46719,länders,0,0,1,1
46722,посетителям,0,0,1,1
46723,تأسيس,0,0,1,1
41118,mapa,0,0,1,1
41117,புன்னகைக்கிறாள்,0,0,1,1
46725,मेमोरियम,0,0,1,1
41115,تشاهد,0,0,1,1
46728,friere,0,0,1,1
46729,بيريشيت،,0,0,1,1
46730,исследовании,0,0,1,1
46715,coexisted,0,0,1,1
41112,продовольствие,0,0,1,1
41111,multas,0,0,1,1
41109,رأسه,0,0,1,1
46732,blockeras,0,0,1,1
41108,мышей,0,0,1,1
46733,geleerd,0,0,1,1
46734,intenta,0,0,1,1
46735,ಹೊಂದಿದ್ದರೆ,0,0,1,1
46736,mythologiques,0,0,1,1
46737,എല്ലാവരേയും,0,0,1,1
41104,أقرت,0,0,1,1
46716,realized,0,0,1,1
41122,попасть,0,0,1,1
41146,الفظيعة,0,0,1,1
41134,confrontés,0,0,1,1
46695,colectivamente—,0,0,1,1
46696,أخفيه,0,0,1,1
41143,groep,0,0,1,1
41142,консультируются,0,0,1,1
46698,ഗ്രാമത്തിൽ,0,0,1,1
46699,награду,0,0,1,1
46702,девушка,0,0,1,1
46703,—imprecisiones,0,0,1,1
41138,defendia,0,0,1,1
41137,oído,0,0,1,1
41136,années »,0,0,1,1
41133,genres,0,0,1,1
41123,moderering,0,0,1,1
41132,evidentes,0,0,1,1
46707,പ്രവൃത്തികളും,0,0,1,1
41130,дисках,0,0,1,1
46708,διεύθυνση,0,0,1,1
46709,especiais,0,0,1,1
46710,выучили,0,0,1,1
41127,لوصف,0,0,1,1
46712,напуган,0,0,1,1
41125,åldrarna,0,0,1,1
46713,buchstäblich,0,0,1,1
46714,colonisés,0,0,1,1
41193,merak,0,0,1,1
46657,diciéndome,0,0,1,1
41196,kaynakları,0,0,1,1
46602,общественном,0,0,1,1
46586,அறிந்திருக்க,0,0,1,1
41253,जानने,0,0,1,1
46587,ووالدتها,0,0,1,1
46589,तेज,0,0,1,1
46594,chaud,0,0,1,1
46595,vinklingarna,0,0,1,1
41249,"
lituano",0,0,1,1
46596,தங்கமாகவும்,0,0,1,1
46598,svåra,0,0,1,1
46599,അനുസരിച്ച്,0,0,1,1
46601,അമേരിക്കയിൽ,0,0,1,1
41246,passaram,0,0,1,1
46584,μεγάλο,0,0,1,1
41245,souriant,0,0,1,1
46604,conozco,0,0,1,1
41244,производных,0,0,1,1
46605,சொல்லான,0,0,1,1
46606,ஒருவராக,0,0,1,1
46607,ಬ್ರೆಡ್ನಿಂದ,0,0,1,1
46609,vio,0,0,1,1
41241,أمستردام,0,0,1,1
41240,vanwege,0,0,1,1
46612,proporcionaron,0,0,1,1
46614,принесу,0,0,1,1
41255,раза,0,0,1,1
41258,webbtrafik,0,0,1,1
46655,destinadas,0,0,1,1
46568,orsaker,0,0,1,1
46559,britisk,0,0,1,1
46560,vindicates,0,0,1,1
41279,diferencia,0,0,1,1
41278,гриффитом,0,0,1,1
41276,தாயும்,0,0,1,1
41275,ayrıntıya,0,0,1,1
46561,españa,0,0,1,1
46562,എട്ട്,0,0,1,1
41272,reconsideró,0,0,1,1
41271,έρχεται,0,0,1,1
46564,tier,0,0,1,1
41270,പ്രശ്നമല്ലെന്ന്,0,0,1,1
41259,നല്ലതാണെന്ന്,0,0,1,1
41269,التعليم,0,0,1,1
41268,अर्थव्यवस्था,0,0,1,1
46571,പാർട്ടിയിൽ,0,0,1,1
46575,يضيف,0,0,1,1
46579,polêmica,0,0,1,1
41265,inconsistência,0,0,1,1
41264,linguistic,0,0,1,1
46582,المقاطعة,0,0,1,1
41262,håndtere,0,0,1,1
41261,تشجيع,0,0,1,1
41260,hemsidan,0,0,1,1
41237,absorbing,0,0,1,1
46615,характера,0,0,1,1
46616,संदेशवाहक,0,0,1,1
46647,иду,0,0,1,1
41212,серьезной,0,0,1,1
41211,dépendant,0,0,1,1
46642,குழப்பமடைந்தால்,0,0,1,1
41210,pensamentos,0,0,1,1
46644,неточными,0,0,1,1
41209,gene,0,0,1,1
46646,അറിയില്ലെന്ന്,0,0,1,1
41208,ദക്ഷതയോടെ,0,0,1,1
41207,ಹಿಂದಿನ,0,0,1,1
41206,autorités,0,0,1,1
41205,abandonada,0,0,1,1
41204,vänder,0,0,1,1
41234,ಸ್ನೇಹಿತರಾಗಿದ್ದರು,0,0,1,1
46648,ಆಲಿಸಿ,0,0,1,1
41202,أسمع,0,0,1,1
46649,favorecer,0,0,1,1
46651,प्राधिकरण,0,0,1,1
41201,manieren,0,0,1,1
46652,visiteur,0,0,1,1
46653,шутку,0,0,1,1
46654,« doncosaque »,0,0,1,1
41199,вызван,0,0,1,1
41198,ചേർന്ന്,0,0,1,1
41197,deinem,0,0,1,1
41213,« machine,0,0,1,1
46639,വിജ്ഞാനശകലങ്ങൾ,0,0,1,1
41215,تمول,0,0,1,1
41216,أسرة,0,0,1,1
41233,décrit,0,0,1,1
46617,പരിശീലിപ്പിക്കാൻ,0,0,1,1
41231,pauvres,0,0,1,1
46618,والضحكات,0,0,1,1
46619,geldiğinizi,0,0,1,1
46620,valuing,0,0,1,1
46621,إحساسها,0,0,1,1
46622,ശിൽപ്പികൾ,0,0,1,1
46624,ряда,0,0,1,1
41226,implications,0,0,1,1
46626,ಮೆಲ್ಲೀ,0,0,1,1
46628,extensa »,0,0,1,1
41225,meddelelse,0,0,1,1
41224,foule,0,0,1,1
46630,അർഹനാണെന്ന്,0,0,1,1
46631,gidin,0,0,1,1
41221,gubernamentales,0,0,1,1
46632,vitesse,0,0,1,1
46635,ಕರೆದೊಯ್ಯಿರಿ,0,0,1,1
41219,keken,0,0,1,1
41218,और।,0,0,1,1
46637,démissionne,0,0,1,1
41217,écrits,0,0,1,1
46389,redistribution,0,0,1,1
46388,exceeds,0,0,1,1
41820,xvii°siècle,0,0,1,1
41701,ചേരാത്തതുമായ,0,0,1,1
46165,горем,0,0,1,1
46166,quebrou,0,0,1,1
41711,प्यारा,0,0,1,1
41710,ontem,0,0,1,1
46167,probabilidades,0,0,1,1
41708,öğreneceğiz,0,0,1,1
41707,trage,0,0,1,1
46171,യന്ത്രത്തിൻറെ,0,0,1,1
41704,مستقلة,0,0,1,1
41703,कोरिया,0,0,1,1
46172,японии,0,0,1,1
46175,तिहाई,0,0,1,1
46163,பங்களிப்பாளர்களையும்,0,0,1,1
41700,beperkte,0,0,1,1
41699,طويلة,0,0,1,1
41698,—cuya,0,0,1,1
46176,الصراع,0,0,1,1
46177,entrainement,0,0,1,1
41697,आंकडों,0,0,1,1
46178,ಮೇಲಿನ,0,0,1,1
41696,വ്യത്യസ്തമാവും,0,0,1,1
41695,graphies,0,0,1,1
46180,corrección,0,0,1,1
46181,определённое,0,0,1,1
46164,повседневного,0,0,1,1
46162,αντίθετο,0,0,1,1
46183,വിക്കിപീഡിയകൾ,0,0,1,1
41722,mover,0,0,1,1
46143,വിവാഹ,0,0,1,1
41730,farinha,0,0,1,1
41729,ipadress,0,0,1,1
41728,overstromen,0,0,1,1
46144,manually,0,0,1,1
46145,μόλις,0,0,1,1
46146,meinungen,0,0,1,1
41725,giggles,0,0,1,1
41723,कहेगा,0,0,1,1
46148,മീറ്റിംഗ്,0,0,1,1
46149,« livres »,0,0,1,1
46150,infieren,0,0,1,1
46161,cérebro,0,0,1,1
46151,"
ऑकिटन",0,0,1,1
46152,katı,0,0,1,1
46153,inger,0,0,1,1
41721,शो,0,0,1,1
41719,winked,0,0,1,1
41718,அவளை,0,0,1,1
41717,الطلبات,0,0,1,1
46156,derecede,0,0,1,1
46157,localizado,0,0,1,1
46158,إطلاقه,0,0,1,1
46160,محاولة,0,0,1,1
46182,рецензированы,0,0,1,1
41693,exército,0,0,1,1
41645,vardagligt,0,0,1,1
41655,prisões,0,0,1,1
46205,naked,0,0,1,1
41666,filer,0,0,1,1
41665,correta,0,0,1,1
41664,males,0,0,1,1
41663,കണ്ടെത്തുകയാണ്,0,0,1,1
46206,शुक्रिया,0,0,1,1
41661,angstaanjagenders,0,0,1,1
46209,hörde,0,0,1,1
46210,painting,0,0,1,1
41657,uncorrected,0,0,1,1
41656,wikiformat,0,0,1,1
41654,ouvrir,0,0,1,1
41669,blinkade,0,0,1,1
46214,उंगलियां,0,0,1,1
46216,grædende,0,0,1,1
41652,değiştirdi,0,0,1,1
46217,знаменитости,0,0,1,1
41651,точек,0,0,1,1
41650,казались,0,0,1,1
41648,overnemen,0,0,1,1
41647,comprovação,0,0,1,1
41646,wikizine,0,0,1,1
46218,തിരക്കിലായിരുന്നതിനാൽ,0,0,1,1
46219,implementará,0,0,1,1
41668,الكامل,0,0,1,1
41670,думать,0,0,1,1
41692,нужна,0,0,1,1
41682,tillträde,0,0,1,1
46187,goudgoud,0,0,1,1
46190,selfsustaining,0,0,1,1
41691,αγαπητοί,0,0,1,1
46192,прошли,0,0,1,1
46193,التنغيم,0,0,1,1
46194,großen,0,0,1,1
41688,ограничений,0,0,1,1
41687,قدم,0,0,1,1
41686,fötterna,0,0,1,1
46197,ബന്ധിപ്പിക്കുന്നു,0,0,1,1
41683,பயணத்தைத்,0,0,1,1
41681,publicitaireréf,0,0,1,1
41671,metadata,0,0,1,1
41680,consegue,0,0,1,1
46199,الابتسامات,0,0,1,1
46200,soulignées,0,0,1,1
41677,பிற்பகுதியில்,0,0,1,1
41676,вышел,0,0,1,1
41675,متزايد,0,0,1,1
46201,obtenido,0,0,1,1
46203,ഇവർക്കാണ്,0,0,1,1
46204,मान,0,0,1,1
41673,отображать,0,0,1,1
41672,lingüísticas,0,0,1,1
46142,revient,0,0,1,1
41732,الإضافة،,0,0,1,1
46139,надёжность,0,0,1,1
46080,d’intentionnalités,0,0,1,1
41796,ചെയ്യുന്നതെന്ന്,0,0,1,1
46073,gevangenissen,0,0,1,1
41794,выпустила,0,0,1,1
41793,sugieren,0,0,1,1
41792,merely,0,0,1,1
46074,कोक,0,0,1,1
46076,congratulations,0,0,1,1
41790,høje,0,0,1,1
46078,взглянуть,0,0,1,1
46079,ontbrak,0,0,1,1
41788,والخبز,0,0,1,1
41786,இருந்திருக்கிறேன்,0,0,1,1
41797,répartissent,0,0,1,1
41785,atordoado,0,0,1,1
46082,مبكرين,0,0,1,1
46084,மூலையில்,0,0,1,1
41784,താളുകൾ‍,0,0,1,1
46087,дням,0,0,1,1
41783,قائلا,0,0,1,1
41782,behoud,0,0,1,1
46088,γελάει,0,0,1,1
46089,complexiteit,0,0,1,1
41780,προωθήθηκα,0,0,1,1
46090,autonomie,0,0,1,1
46072,популярной,0,0,1,1
41798,تقاس,0,0,1,1
46138,gepolijst,0,0,1,1
46061,aldı,0,0,1,1
41819,ഉപയോക്താക്കളിൽ,0,0,1,1
46056,плагиат,0,0,1,1
46057,ತೊಂದರೆಗೊಳಿಸಿದ್ದಕ್ಕೆ,0,0,1,1
41817,stupéfiant,0,0,1,1
41816,—término,0,0,1,1
41815,ಅರ್ಥಗಳ,0,0,1,1
41814,обеспечивает,0,0,1,1
41813,दिमाग,0,0,1,1
46058,വിവരങ്ങളലൂടെ,0,0,1,1
41812,لسوء,0,0,1,1
46059,كمشتبه,0,0,1,1
46062,kullanmıyorsunuz,0,0,1,1
41799,existiam,0,0,1,1
41810,τόπο,0,0,1,1
46063,நடைமுறையை,0,0,1,1
46064,critic,0,0,1,1
41808,alimenter,0,0,1,1
46068,перейти,0,0,1,1
41805,şirketi,0,0,1,1
41804,முக்கியமாகத்,0,0,1,1
46069,പുതിയതായി,0,0,1,1
46070,beskrivs,0,0,1,1
41803,creerlo,0,0,1,1
41802,نصًا,0,0,1,1
46092,yakalayamadım,0,0,1,1
46093,starving,0,0,1,1
46094,описал,0,0,1,1
41747,hawaiano​,0,0,1,1
46116,urls,0,0,1,1
41757,épidémique,0,0,1,1
46121,redistribuição,0,0,1,1
41755,rejoignit,0,0,1,1
41754,decírselo,0,0,1,1
41753,valendo,0,0,1,1
41752,"
रोमान्श",0,0,1,1
41751,impacta,0,0,1,1
41749,judicial,0,0,1,1
46125,‘மென்பொருட்கள்’,0,0,1,1
46126,നിർവ്വചിക്കുന്നു,0,0,1,1
41746,sink,0,0,1,1
41779,développées,0,0,1,1
41745,धनवानों,0,0,1,1
46129,വെള്ളിയാഴ്ചയാണെന്ന്,0,0,1,1
41744,råka,0,0,1,1
46131,selfdriving,0,0,1,1
41742,أدى,0,0,1,1
41741,العلمي،,0,0,1,1
46132,بمقياس,0,0,1,1
41739,bred,0,0,1,1
41738,"
sérvio",0,0,1,1
41737,പരിഭ്രാന്തരായി,0,0,1,1
41736,entran,0,0,1,1
46115,الملحوظة،,0,0,1,1
46113,بموجب,0,0,1,1
46112,gruppen,0,0,1,1
41758,allés,0,0,1,1
46096,இருந்ததா,0,0,1,1
46097,إسرائيلية,0,0,1,1
46098,تكنولوجي,0,0,1,1
46099,ολόκληρη,0,0,1,1
41776,defecto,0,0,1,1
41775,золотом,0,0,1,1
41774,ಸಂತೋಷವಾಗಿದೆ,0,0,1,1
41773,experiências,0,0,1,1
41772,stimme,0,0,1,1
41771,குரலின்,0,0,1,1
46100,следующее,0,0,1,1
41768,وعملت,0,0,1,1
46102,എല്ലായ്‌പ്പോഴും,0,0,1,1
41767,cart,0,0,1,1
46104,implied,0,0,1,1
46106,புத்தகத்தில்,0,0,1,1
46107,கேட்டிருக்கலாம்,0,0,1,1
46109,arbetar,0,0,1,1
41762,действии,0,0,1,1
41761,بالتشعب,0,0,1,1
41760,hatırlayın,0,0,1,1
41759,പരിശീലിപ്പിക്കുക,0,0,1,1
46110,طلبت,0,0,1,1
46220,πάρτι,0,0,1,1
46222,gentemot,0,0,1,1
46387,задача,0,0,1,1
41527,confundido,0,0,1,1
46327,onderzoekers,0,0,1,1
41536,pedazo,0,0,1,1
41535,ajoutant,0,0,1,1
46328,بناءً,0,0,1,1
41534,ಏನಾಗುತ್ತದೆ,0,0,1,1
41533,voie,0,0,1,1
41532,erfolgreich,0,0,1,1
41531,orientadas,0,0,1,1
46330,लाद,0,0,1,1
46333,нарушениями,0,0,1,1
46335,labelliser,0,0,1,1
41526,enterarse,0,0,1,1
46325,согласия,0,0,1,1
46336,நுபீடியாவிற்கும்,0,0,1,1
41525,എന്നതിന്,0,0,1,1
46337,क्रिमसन,0,0,1,1
41523,aware,0,0,1,1
46339,φολιδωτή,0,0,1,1
46342,irait,0,0,1,1
41518,dénonce,0,0,1,1
41517,signing,0,0,1,1
41516,—ordenados,0,0,1,1
41515,exclure,0,0,1,1
41514,laissant,0,0,1,1
46326,ठहराते,0,0,1,1
46322,lembrálo,0,0,1,1
41512,boende,0,0,1,1
41551,एहसास,0,0,1,1
46307,commune,0,0,1,1
41557,проверку,0,0,1,1
46308,inconsistencias,0,0,1,1
46309,petits,0,0,1,1
41555,doigt,0,0,1,1
46310,रहें,0,0,1,1
46311,webs,0,0,1,1
41553,πηδήσω,0,0,1,1
41552,excessivo,0,0,1,1
46312,எளிமையான,0,0,1,1
46313,συμπλήρωμα,0,0,1,1
41550,വിജയിച്ചാൽ,0,0,1,1
41540,पीएचडी,0,0,1,1
46314,surgiu,0,0,1,1
46316,viveria,0,0,1,1
46317,policy—which,0,0,1,1
41547,oneindig,0,0,1,1
41546,demography,0,0,1,1
46319,lachend,0,0,1,1
41545,trumps,0,0,1,1
46320,compuesta,0,0,1,1
41543,твёрдым,0,0,1,1
41542,корреляцию,0,0,1,1
41541,confirmé,0,0,1,1
41513,حلم,0,0,1,1
41511,जबरदस्त,0,0,1,1
41644,onthouden,0,0,1,1
46370,क्रियाओं,0,0,1,1
46364,geçip,0,0,1,1
41486,citadas,0,0,1,1
41485,وارد,0,0,1,1
41484,«páginas,0,0,1,1
41483,لتأثير,0,0,1,1
46365,oroar,0,0,1,1
41482,தொகுக்கும்,0,0,1,1
46367,ulaşıp,0,0,1,1
41480,appelle,0,0,1,1
41479,തിരുത്തലുകളോട്,0,0,1,1
41478,hipotético,0,0,1,1
46372,inmediato,0,0,1,1
41489,contribution »,0,0,1,1
41477,vikipedist,0,0,1,1
41475,tapez,0,0,1,1
41474,التحقق،,0,0,1,1
46378,peace,0,0,1,1
46380,«андрушевской,0,0,1,1
41472,δανείσετε,0,0,1,1
41470,συμφωνήσω,0,0,1,1
46382,positif,0,0,1,1
46383,indexation,0,0,1,1
46385,brott,0,0,1,1
46386,dramatica,0,0,1,1
46363,falava,0,0,1,1
41490,begreep,0,0,1,1
41510,düşündüm,0,0,1,1
41498,tekrarı,0,0,1,1
41508,bear,0,0,1,1
46345,массовой,0,0,1,1
41507,mês,0,0,1,1
41506,തോന്നിയെന്നിരിക്കട്ടെ,0,0,1,1
46346,விக்கியை,0,0,1,1
46347,médiathèques,0,0,1,1
46348,yakalayana,0,0,1,1
41502,blanket,0,0,1,1
41501,gaaf,0,0,1,1
46350,deforestation,0,0,1,1
41500,detail,0,0,1,1
41497,korsade,0,0,1,1
46362,ആയിട്ടും,0,0,1,1
46354,காப்புரிமைத்,0,0,1,1
41496,veteranos,0,0,1,1
46356,नाराज,0,0,1,1
46357,kaleme,0,0,1,1
41494,cumulatively,0,0,1,1
46358,இடத்தைக்,0,0,1,1
46360,डिस्कशन,0,0,1,1
41493,tillämpliga,0,0,1,1
46361,—«bibliotecarios»—,0,0,1,1
41492,koltuğunuzda,0,0,1,1
41491,വെയറിന്റെ,0,0,1,1
41558,ಪುಸ್ತಕದಲ್ಲಿ,0,0,1,1
46306,waarschijnlijk,0,0,1,1
41560,største,0,0,1,1
46260,usability,0,0,1,1
46250,открытым,0,0,1,1
46251,прямое,0,0,1,1
41617,गिगल्स,0,0,1,1
46252,أضاف,0,0,1,1
46253,математика,0,0,1,1
46254,коммерческое,0,0,1,1
41615,للمقالات,0,0,1,1
46256,conventionally,0,0,1,1
46258,jardin,0,0,1,1
41612,período,0,0,1,1
41611,ಸಂದರ್ಭದಲ್ಲಿ,0,0,1,1
46261,etmekle,0,0,1,1
46248,توقفت,0,0,1,1
41609,fırtınalı,0,0,1,1
46262,nicer,0,0,1,1
41607,ಅವರನ್ನು,0,0,1,1
46263,يضم,0,0,1,1
41606,variant,0,0,1,1
46264,exercent,0,0,1,1
46265,περιλαμβάνουν,0,0,1,1
41605,proprietário,0,0,1,1
41604,sqlite,0,0,1,1
41603,atualizado,0,0,1,1
41602,جمالك,0,0,1,1
41620,അത്താഴത്തിന്,0,0,1,1
46247,உள்ள,0,0,1,1
46304,ಬಳಸುತ್ತೀರಿ,0,0,1,1
46234,സ്വേവ്,0,0,1,1
46225,wellordered,0,0,1,1
46226,besöka,0,0,1,1
46227,επανάληψη,0,0,1,1
41642,datters,0,0,1,1
46228,sostienen,0,0,1,1
41641,ಮಾಡುತ್ತೇನೆಂದರೆ,0,0,1,1
41640,vinkling,0,0,1,1
46229,займемся,0,0,1,1
46230,militär,0,0,1,1
41638,ಅವರೆಲ್ಲರನ್ನೂ,0,0,1,1
46231,ಮಲಗಿದ್ದಾಗ,0,0,1,1
46236,entraîne,0,0,1,1
46246,petition,0,0,1,1
41636,ашберн,0,0,1,1
41635,educated,0,0,1,1
41634,μάθηση,0,0,1,1
41633,ಹಾಸಿಗೆಯ,0,0,1,1
41631,разрешающими,0,0,1,1
41630,upptäcka,0,0,1,1
46242,"
crioulo",0,0,1,1
41626,rosto,0,0,1,1
41625,üçüncü,0,0,1,1
41623,تركت,0,0,1,1
46245,എല്ലാംതന്നെ,0,0,1,1
41601,syster,0,0,1,1
41600,católico,0,0,1,1
41599,führen,0,0,1,1
41570,catchsituatie,0,0,1,1
41582,sujeira,0,0,1,1
41581,avantage,0,0,1,1
41580,सीखें,0,0,1,1
41579,ಪ್ರಾಣಿ,0,0,1,1
41578,disant,0,0,1,1
46286,parents,0,0,1,1
46290,принципах,0,0,1,1
41574,sustenance,0,0,1,1
46291,കോളർ‌,0,0,1,1
41572,farkında,0,0,1,1
41571,союзе,0,0,1,1
41569,ബരാക്,0,0,1,1
46268,systémique,0,0,1,1
46293,significatif,0,0,1,1
46294,nederlandstalige,0,0,1,1
41568,coincé,0,0,1,1
46295,अहंकारी,0,0,1,1
46297,instrument,0,0,1,1
41566,ax,0,0,1,1
46298,independentlyrun,0,0,1,1
41565,phases,0,0,1,1
46299,красная,0,0,1,1
46301,ومنشورات,0,0,1,1
41561,nationaal,0,0,1,1
41583,ಮಾಣಿಕ್ಯಗಳ,0,0,1,1
41584,endless,0,0,1,1
46285,кэшем,0,0,1,1
46284,formaliserat,0,0,1,1
46269,incomuns,0,0,1,1
41598,أمرا,0,0,1,1
46270,വിശക്കുന്നു,0,0,1,1
41597,تتزوجني,0,0,1,1
46271,​​enkele,0,0,1,1
41595,дочерью,0,0,1,1
41594,μάθημα,0,0,1,1
46272,красивом,0,0,1,1
46273,kører,0,0,1,1
41592,confundí,0,0,1,1
46275,фурор,0,0,1,1
41591,inaktiv,0,0,1,1
41590,endowment,0,0,1,1
41589,चित्रwiki,0,0,1,1
41588,niesde,0,0,1,1
41587,كينيدي,0,0,1,1
41586,stipule,0,0,1,1
46277,rencontré,0,0,1,1
46278,немецких,0,0,1,1
46279,региональные,0,0,1,1
46281,kinderen,0,0,1,1
46282,കവിഞ്ഞു,0,0,1,1
46283,predeterminada,0,0,1,1
45373,dataskyddsförordningen,0,0,1,1
42550,جلست,0,0,1,1
42551,bemvindo,0,0,1,1
43546,தொகுக்கப்படும்,0,0,1,1
43555,المنخفضة,0,0,1,1
44484,ಪ್ರತಿಕ್ರಿಯಿಸಲು,0,0,1,1
44485,مشاهدي,0,0,1,1
43554,contribuem,0,0,1,1
43552,المسجلون,0,0,1,1
43551,entiendo,0,0,1,1
43549,geheim,0,0,1,1
43548,способов,0,0,1,1
44486,es •,0,0,1,1
44487,träumen,0,0,1,1
43547,connectionism,0,0,1,1
43545,eleştirmiştir,0,0,1,1
44481,ವಿವರಿಸಿ,0,0,1,1
43544,vanlig,0,0,1,1
44489,sources ,0,0,1,1
43543,പോലെയാണിവർ,0,0,1,1
43540,microsystem,0,0,1,1
43539,الأصليون,0,0,1,1
44490,formuleerde,0,0,1,1
43538,الشريحة,0,0,1,1
43537,durdurabilir,0,0,1,1
43536,sıklıkla,0,0,1,1
44491,preguiçosas,0,0,1,1
43534,ಹುಡುಗರಲ್ಲಿ,0,0,1,1
44482,—por,0,0,1,1
43557,لمقالة،,0,0,1,1
43533,«unos,0,0,1,1
43571,लॉ,0,0,1,1
43579,റെസ്റ്റോറന്റാണിത്,0,0,1,1
44464,απόψεων,0,0,1,1
44465,energydrink,0,0,1,1
43577,والماس,0,0,1,1
44468,ദീർഘനേരം,0,0,1,1
44470,gebruikmaakten,0,0,1,1
43575,belongs,0,0,1,1
44472,testte,0,0,1,1
43574,какихто,0,0,1,1
43573,кластерах,0,0,1,1
43572,b,0,0,1,1
43569,temporary,0,0,1,1
43558,publishes,0,0,1,1
43568,avdelning,0,0,1,1
43567,έκδοσή,0,0,1,1
44479,انطلق,0,0,1,1
43566,சுற்றி,0,0,1,1
43565,wijzigen,0,0,1,1
43564,ടെറൻസും,0,0,1,1
43563,بإرسال,0,0,1,1
44480,premières,0,0,1,1
43561,ditesleur,0,0,1,1
43560,greek,0,0,1,1
43559,stunning,0,0,1,1
44492,frontpage,0,0,1,1
43532,fondant,0,0,1,1
44537,विज्ञान,0,0,1,1
44528,lief,0,0,1,1
44522,formulerat,0,0,1,1
44523,ജീവനും,0,0,1,1
43507,وتوزيع,0,0,1,1
44524,كذلك؟,0,0,1,1
43506,aidezmoi,0,0,1,1
43505,primaires,0,0,1,1
43503,vayamos,0,0,1,1
43502,baas,0,0,1,1
43501,വിക്കിപീഡിയകളിലും,0,0,1,1
43500,aliens”,0,0,1,1
44527,مشروب,0,0,1,1
44529,fakir,0,0,1,1
43510,aceite,0,0,1,1
43496,ആവശ്യപ്പെടാത്തപ്പോൾ,0,0,1,1
44530,alimentés,0,0,1,1
44531,fóruns,0,0,1,1
43494,langages,0,0,1,1
43492,polysémique,0,0,1,1
43491,существовало,0,0,1,1
43489,reconstruction,0,0,1,1
43487,olmana,0,0,1,1
44535,തംബ്‌സ്,0,0,1,1
43486,setze,0,0,1,1
43485,apresentação,0,0,1,1
44521,weird,0,0,1,1
43511,subsidiaria,0,0,1,1
44494,anteriores,0,0,1,1
44503,« durabilité »,0,0,1,1
43531,يشبهونني,0,0,1,1
44496,équilibrer,0,0,1,1
43529,raakt,0,0,1,1
44497,جذرية,0,0,1,1
44498,constate,0,0,1,1
44499,देती,0,0,1,1
43526,إليهم,0,0,1,1
43525,investigador,0,0,1,1
44501,medeniyeti,0,0,1,1
43524,писатель,0,0,1,1
44502,ಅನುಭವವನ್ನು,0,0,1,1
43522,miradas,0,0,1,1
44518,nossas,0,0,1,1
43521,domination,0,0,1,1
44506,visie,0,0,1,1
43520,katılımcılar,0,0,1,1
44510,الدنا،,0,0,1,1
43519,ethvert,0,0,1,1
44512,ботами,0,0,1,1
43518,участника,0,0,1,1
44513,векторы,0,0,1,1
43515,palads,0,0,1,1
44516,பட்டியலில்,0,0,1,1
43513,علمية كتبت,0,0,1,1
44463,contract,0,0,1,1
44462,ಅದಕ್ಕಾಗಿ,0,0,1,1
43580,отклонила,0,0,1,1
44414,عدة,0,0,1,1
44407,tilskynder,0,0,1,1
43640,empiriques,0,0,1,1
43639,പ്രാവർത്തികമാക്കാനുള്ള,0,0,1,1
43637,organise,0,0,1,1
44410,«седьмой,0,0,1,1
43635,enkäten,0,0,1,1
43634,engelskspråkigt,0,0,1,1
44411,rythme,0,0,1,1
44413,टेलीविजन,0,0,1,1
43631,rejettent,0,0,1,1
43630,начнем,0,0,1,1
44415,ocurriendo,0,0,1,1
44406,நபர்களாக,0,0,1,1
44416,ಎತ್ತಿಕೊಳ್ಳಲಾಗಿದೆ,0,0,1,1
44419,mundiais,0,0,1,1
43628,hond,0,0,1,1
44420,wiederholung,0,0,1,1
43627,obscenities,0,0,1,1
43626,intet,0,0,1,1
44422,cloning,0,0,1,1
43624,endorse,0,0,1,1
44423,übertreiben,0,0,1,1
44424,ನಯವಾಗಿ,0,0,1,1
44426,pretendentes,0,0,1,1
43642,remnants,0,0,1,1
44404,चेतावनी,0,0,1,1
44461,öppnades,0,0,1,1
43656,l’entraînant,0,0,1,1
44383,techné« l,0,0,1,1
43667,avsaknad,0,0,1,1
44386,ಚೂಪಾದವು,0,0,1,1
43665,guidant,0,0,1,1
44387,opportunistic,0,0,1,1
44388,gewerkt,0,0,1,1
43663,«громадный»,0,0,1,1
44389,подмигнули,0,0,1,1
44390,kämpfte,0,0,1,1
43660,മൃഗമാണെന്നും,0,0,1,1
43658,« réseau,0,0,1,1
43655,taïwan,0,0,1,1
44403,varnande,0,0,1,1
44393,netter,0,0,1,1
44394,للإشارة,0,0,1,1
43653,lu,0,0,1,1
43651,ആശംസകൾ,0,0,1,1
43650,اجتماعية،,0,0,1,1
44397,അമിതമായി,0,0,1,1
43649,fizeram,0,0,1,1
44398,κλάμα,0,0,1,1
43647,nagedacht,0,0,1,1
43646,забывают,0,0,1,1
44402,iterative,0,0,1,1
43620,هدية,0,0,1,1
43619,af •,0,0,1,1
43618,téléversement,0,0,1,1
43589,типа,0,0,1,1
43597,comêlo,0,0,1,1
43596,ஒருங்கிணைப்பர்,0,0,1,1
44448,ಭಾವಿಸಿದೆ,0,0,1,1
44450,व्यवसाय,0,0,1,1
44451,बनाये,0,0,1,1
43594,nette,0,0,1,1
44452,freeknowledge,0,0,1,1
43593,islands,0,0,1,1
43592,survived,0,0,1,1
43591,diferenciada,0,0,1,1
43590,kommentarbereich,0,0,1,1
44454,bepaalde,0,0,1,1
44429,تنشأ,0,0,1,1
44455,regularization,0,0,1,1
43588,synes,0,0,1,1
44456,prestação,0,0,1,1
43587,ക്രൂരവും,0,0,1,1
43586,കുറിക്കുന്നു,0,0,1,1
43585,книгах,0,0,1,1
44457,omöjlig,0,0,1,1
43583,харуко,0,0,1,1
43582,nordpertinence,0,0,1,1
43581,largar,0,0,1,1
44460,citat,0,0,1,1
44447,تسألك,0,0,1,1
44446,concluíram,0,0,1,1
43598,فهناك,0,0,1,1
43600,journalisme,0,0,1,1
44430,المفضلة,0,0,1,1
44431,ούτε,0,0,1,1
43616,subspace,0,0,1,1
43615,voorstellen,0,0,1,1
44432,٬٬,0,0,1,1
44433,اعتذارى,0,0,1,1
43614,geheimzinnigs,0,0,1,1
43613,aufgehört,0,0,1,1
43612,കരയുന്ന,0,0,1,1
44434,κοίταξα,0,0,1,1
44435,கட்டமைப்பு”க்கு,0,0,1,1
43610,afortunada,0,0,1,1
44437,nãowiki,0,0,1,1
44438,épisode,0,0,1,1
43607,обычный,0,0,1,1
43606,luchadores,0,0,1,1
43605,oppose,0,0,1,1
44439,наш,0,0,1,1
43602,уэйлсом,0,0,1,1
44440,engellendi,0,0,1,1
43601,especie,0,0,1,1
44443,ignores,0,0,1,1
44444,dès,0,0,1,1
44536,التالية,0,0,1,1
43482,انتقد,0,0,1,1
44381,‘கணினிச்,0,0,1,1
43364,selbst,0,0,1,1
44645,تعيينك,0,0,1,1
44649,gevallen,0,0,1,1
43368,"
malaio",0,0,1,1
44651,kulağa,0,0,1,1
44652,எழுதப்படுகின்றன,0,0,1,1
44653,геометрии,0,0,1,1
43367,पकड़ा।,0,0,1,1
43366,مدى,0,0,1,1
44656,tafelmanieren,0,0,1,1
44657,atribuyen,0,0,1,1
43365,സ്വർണ്ണത്തിൽ,0,0,1,1
44658,recognizes,0,0,1,1
44641,сбывается,0,0,1,1
43362,പുസ്തകത്തിൽ,0,0,1,1
43361,hund,0,0,1,1
44659,बाढ़,0,0,1,1
44660,eenvoudigste,0,0,1,1
43359,"
स्कॉट्स",0,0,1,1
43358,боролась,0,0,1,1
44661,sunulmalıdır,0,0,1,1
44663,ತಿರುಗುತ್ತಾನೆ,0,0,1,1
43357,introduire,0,0,1,1
44664,தேடு,0,0,1,1
43356,statements,0,0,1,1
44644,kritiseret,0,0,1,1
43371,extrasolar,0,0,1,1
44666,للمنزل؟,0,0,1,1
43382,qu’une,0,0,1,1
43393,reflet,0,0,1,1
43392,düster,0,0,1,1
43390,மகளைப்,0,0,1,1
44622,eruit,0,0,1,1
43388,northeast,0,0,1,1
44625,transcendentalism,0,0,1,1
43387,ടൂറിസ്റ്റിലോ,0,0,1,1
44626,заставил,0,0,1,1
44628,المشاريع,0,0,1,1
43384,funny,0,0,1,1
43383,birth,0,0,1,1
44629,استراتيجية,0,0,1,1
43372,pourront,0,0,1,1
43381,draws,0,0,1,1
44630,важными,0,0,1,1
43380,классическим,0,0,1,1
44633,изменилась,0,0,1,1
43376,de •,0,0,1,1
44635,manuscrits,0,0,1,1
43375,बीस,0,0,1,1
44636,mutluyum,0,0,1,1
44637,ಬ್ರೆಡ್ನಲ್ಲಿ,0,0,1,1
43374,даниэлем,0,0,1,1
44638,марки,0,0,1,1
44665,influyendo,0,0,1,1
44667,suscripción,0,0,1,1
44538,धन,0,0,1,1
43312,stock,0,0,1,1
43323,diep,0,0,1,1
44690,dévie,0,0,1,1
43322,brødet,0,0,1,1
43321,скорости,0,0,1,1
43319,பிடிக்கவில்லையா,0,0,1,1
44694,طاولة,0,0,1,1
43318,الجماعي،,0,0,1,1
43317,வேறுபட்டிருப்பதைக்,0,0,1,1
44697,gedag,0,0,1,1
43314,condenou,0,0,1,1
44700,подготовился,0,0,1,1
43311,nærmede,0,0,1,1
44685,внесена,0,0,1,1
43310,серьезно,0,0,1,1
44701,förändrade,0,0,1,1
43309,autoritário,0,0,1,1
44703,усталым,0,0,1,1
43306,प्रोजेक्टों,0,0,1,1
44704,ആൾക്കാരെ,0,0,1,1
44705,ಗಂಟೆ,0,0,1,1
43305,zevkle,0,0,1,1
43304,rebellion,0,0,1,1
43303,englobando,0,0,1,1
43302,coupled,0,0,1,1
44686,പ്രവർത്തനം,0,0,1,1
44683,builtin,0,0,1,1
44668,следствием,0,0,1,1
43339,kaartsysteem,0,0,1,1
43352,വളർച്ച,0,0,1,1
43351,country,0,0,1,1
43350,vandt,0,0,1,1
43349,பயன்படுத்துவீர்கள்,0,0,1,1
43348,கவலைப்படுகிறாள்,0,0,1,1
43347,skall,0,0,1,1
44670,magnificent,0,0,1,1
44671,ക്രൂരമായിരുന്നു,0,0,1,1
43342,"
सोरानी",0,0,1,1
43341,çalış,0,0,1,1
43340,hermosos,0,0,1,1
43337,"
tagalo",0,0,1,1
43325,behandeld,0,0,1,1
44674,planétaires,0,0,1,1
43334,धीमी,0,0,1,1
43333,igual,0,0,1,1
44675,engelsksproget,0,0,1,1
44676,atingir,0,0,1,1
44677,schrijfstijl,0,0,1,1
43330,categorieën,0,0,1,1
43329,отрицательной,0,0,1,1
44680,ربحية,0,0,1,1
44682,anneyi,0,0,1,1
43326,delicados,0,0,1,1
43394,defienden,0,0,1,1
43396,«читать,0,0,1,1
44619,دوت,0,0,1,1
43452,ಮದುವೆಯಾದ,0,0,1,1
44569,efecto,0,0,1,1
43459,наука,0,0,1,1
44570,gösterilmiştir,0,0,1,1
44573,découlant,0,0,1,1
43457,soñaste,0,0,1,1
43456,wikípedo,0,0,1,1
44574,ಪ್ರವಾಹ,0,0,1,1
43454,تعاونيًا,0,0,1,1
44575,legt,0,0,1,1
44576,keeping,0,0,1,1
44577,واكتب,0,0,1,1
43451,астрономами,0,0,1,1
43461,ಶನಿವಾರದಂದು,0,0,1,1
43450,φέρεσαι,0,0,1,1
43449,जावानी,0,0,1,1
43448,réponses,0,0,1,1
43447,deltagarportalerna,0,0,1,1
44581,благом,0,0,1,1
43446,rewrite,0,0,1,1
44582,मेक्रो,0,0,1,1
43445,അതിശയിപ്പിച്ചു,0,0,1,1
44583,sayfayı,0,0,1,1
44584,ಪಡುತ್ತಿದ್ದೆ,0,0,1,1
44585,appalling,0,0,1,1
44566,fondations,0,0,1,1
43462,durdurduk,0,0,1,1
43398,உப்பு,0,0,1,1
44551,tomando,0,0,1,1
43480,ausgewogenen,0,0,1,1
44539,வாழ்க்கையைப்,0,0,1,1
44540,ذهبوا,0,0,1,1
44541,वेरिएबल्स,0,0,1,1
43478,ഉപവിഭാഗമാണ്,0,0,1,1
44543,brits,0,0,1,1
44544,operation,0,0,1,1
43476,şeklim,0,0,1,1
44548,പോകുന്നുവെന്നത്,0,0,1,1
44550,следовали,0,0,1,1
43472,descubrir,0,0,1,1
44552,पडेगा,0,0,1,1
44564,provenían,0,0,1,1
43470,ಚೀರ್ಸ್,0,0,1,1
43469,hydrocarbon,0,0,1,1
44553,τηλέφωνό,0,0,1,1
43468,işlere,0,0,1,1
44555,dotées,0,0,1,1
44556,कॉमस्कोर,0,0,1,1
43466,الفشل,0,0,1,1
43465,sleep,0,0,1,1
43464,insanlara,0,0,1,1
44558,stratégiquement,0,0,1,1
44559,தரப்பில்,0,0,1,1
43442,arayana,0,0,1,1
43441,satisfação,0,0,1,1
43440,çocuk,0,0,1,1
44613,motivation,0,0,1,1
43420,فكل,0,0,1,1
43419,المجموعة,0,0,1,1
43418,നിർവ്വാഹകർ,0,0,1,1
43417,لأطلب,0,0,1,1
44609,hosts,0,0,1,1
43415,одноимённым,0,0,1,1
43414,agreeing,0,0,1,1
44611,δάσκαλος,0,0,1,1
44612,подверженных,0,0,1,1
43411,presionando,0,0,1,1
43410,ужасном,0,0,1,1
44614,സബ്‌സ്‌ക്രൈബുചെയ്യാൻ,0,0,1,1
43439,dérivée,0,0,1,1
44615,വാശി,0,0,1,1
43407,управлялась,0,0,1,1
43406,سيول,0,0,1,1
43405,sistêmicos,0,0,1,1
44616,litteratur,0,0,1,1
44617,वापस,0,0,1,1
43403,подавляющее,0,0,1,1
43402,άνθρωποι,0,0,1,1
43401,समझना,0,0,1,1
44618,énervé,0,0,1,1
43399,generalizar,0,0,1,1
44608,പഠനത്തിലൂടെ,0,0,1,1
44607,tembel,0,0,1,1
43422,bat,0,0,1,1
43423,நபர்,0,0,1,1
44586,சொல்லுக்கு,0,0,1,1
43438,pouca,0,0,1,1
43437,terminará,0,0,1,1
43436,glücks,0,0,1,1
43435,anunciou,0,0,1,1
44589,réutilisations,0,0,1,1
44590,meegaan,0,0,1,1
44591,குறிப்பாக,0,0,1,1
44592,bett,0,0,1,1
43433,ಇಡೀ,0,0,1,1
43432,"​
sin",0,0,1,1
43431,consciemment,0,0,1,1
43430,affirmations,0,0,1,1
44594,ದೇಶಕ್ಕೆ,0,0,1,1
43428,ನೀರು,0,0,1,1
44595,erstaunlichste,0,0,1,1
44596,"
माज़न्दारिनी",0,0,1,1
44597,эмоциях,0,0,1,1
44599,straight,0,0,1,1
44600,mönster,0,0,1,1
44601,ತಾಯಿಯಾಗಲು,0,0,1,1
44604,பழைய,0,0,1,1
44605,повсюду,0,0,1,1
44382,пятым,0,0,1,1
44376,விளக்கும்,0,0,1,1
42552,ஆசிரியராகப்,0,0,1,1
44172,encontradas,0,0,1,1
43942,monde »,0,0,1,1
43941,« notes,0,0,1,1
44167,dictate,0,0,1,1
43938,ويحق,0,0,1,1
43937,очереди,0,0,1,1
43936,അഭിപ്രായമിടുന്നതിലൂടെ,0,0,1,1
43935,samarbetsprojekt,0,0,1,1
43933,vus,0,0,1,1
43931,jump,0,0,1,1
44170,"
बुगिनी",0,0,1,1
43930,concours,0,0,1,1
43929,anulada,0,0,1,1
44163,hittade,0,0,1,1
44175,смущенной,0,0,1,1
43928,bekende,0,0,1,1
44177,تنطبق,0,0,1,1
43926,próximas,0,0,1,1
43925,krypteringen,0,0,1,1
43924,nesse,0,0,1,1
44180,databasen,0,0,1,1
43922,представлять,0,0,1,1
43921,चलाये,0,0,1,1
43920,физической,0,0,1,1
43919,amérindiennes,0,0,1,1
43943,vueltas,0,0,1,1
43946,noisy,0,0,1,1
43917,يضيء,0,0,1,1
43954,والاستنتاجي,0,0,1,1
43967,qualitatif,0,0,1,1
43966,ಆಶ್ಚರ್ಯಚಕಿತರಾದರು,0,0,1,1
43965,биография,0,0,1,1
43964,suscité,0,0,1,1
44144,النهائية,0,0,1,1
44146,четвёртым,0,0,1,1
43960,forekommer,0,0,1,1
43959,ദിവസമാണെന്ന്,0,0,1,1
43958,teach,0,0,1,1
44147,произносить,0,0,1,1
43955,بقراءة,0,0,1,1
43953,échoué,0,0,1,1
44161,matta,0,0,1,1
43952,بعدد,0,0,1,1
44151,दोहराना,0,0,1,1
44153,yaşanırsa,0,0,1,1
44154,ಪಚ್ಚೆಗಳ,0,0,1,1
43951,effrayé,0,0,1,1
43950,kanunu,0,0,1,1
44155,बहक,0,0,1,1
44157,syllabi,0,0,1,1
44158,feliciteren,0,0,1,1
44159,допустил,0,0,1,1
44160,κεντρικής,0,0,1,1
43918,uhr,0,0,1,1
44181,حقا,0,0,1,1
43862,piecemeal,0,0,1,1
43877,सूत्रपात,0,0,1,1
44197,udføre,0,0,1,1
44198,yazarlarının,0,0,1,1
44199,vackraste,0,0,1,1
44201,கட்டுப்பாடில்லாத,0,0,1,1
43883,reír,0,0,1,1
43882,jederzeit,0,0,1,1
43881,சாப்பிடு,0,0,1,1
44204,échanger,0,0,1,1
43880,வெளியே,0,0,1,1
43879,desenvolver,0,0,1,1
43878,тадичем,0,0,1,1
44205,problématiques,0,0,1,1
44195,sítio,0,0,1,1
44208,lekkerste,0,0,1,1
44209,έφυγε,0,0,1,1
43875,regard,0,0,1,1
43874,ಇಲ್ಲದೆ,0,0,1,1
43871,yorker,0,0,1,1
44212,हेंडलिंग,0,0,1,1
44214,إقراضي,0,0,1,1
43868,التجارية,0,0,1,1
43867,lineares,0,0,1,1
44216,ആഗ്രഹിക്കുന്നുവെന്നും,0,0,1,1
44217,administrar,0,0,1,1
43887,невозможную,0,0,1,1
44194,വിക്കിവിരുദ്ധരെ,0,0,1,1
44182,mahvettim,0,0,1,1
44186,ಮಾಡುತ್ತೇನೆ,0,0,1,1
44183,yayımlanan,0,0,1,1
43914,umarmen,0,0,1,1
43913,помешал,0,0,1,1
43912,прерываю,0,0,1,1
43911,navegador,0,0,1,1
43910,ortasındaysanız,0,0,1,1
43909,skydda,0,0,1,1
44185,andamán,0,0,1,1
43908,"
कुर्द",0,0,1,1
43907,embarcar,0,0,1,1
43906,др,0,0,1,1
44187,beatles,0,0,1,1
43890,μάτι,0,0,1,1
43903,நிர்வாகக்,0,0,1,1
44188,«тупой»,0,0,1,1
44189,coexistiram,0,0,1,1
43901,especificar,0,0,1,1
43900,besleyelim,0,0,1,1
44190,"economics ·
environmental",0,0,1,1
44191,antártida,0,0,1,1
43897,çoğalmıştır,0,0,1,1
43895,propôs,0,0,1,1
43893,públicos—,0,0,1,1
43891,للامتحان,0,0,1,1
43968,тонет,0,0,1,1
43969,آخرين,0,0,1,1
44143,günden,0,0,1,1
44026,trouxe,0,0,1,1
44037,игру»,0,0,1,1
44036,оспорено,0,0,1,1
44091,migrent,0,0,1,1
44092,المعلقة,0,0,1,1
44034,ಬೀಜಗಳನ್ನು,0,0,1,1
44033,commis,0,0,1,1
44032,കാണപ്പെടുന്നത്,0,0,1,1
44030,வகுப்பில்,0,0,1,1
44029,ತಮಾಷೆಯ,0,0,1,1
44028,aniversário,0,0,1,1
44027,culto​​​,0,0,1,1
44025,ಕೂಡ,0,0,1,1
44089,لمواقع,0,0,1,1
44024,повторил,0,0,1,1
44023,സ്ക്കൂൾ,0,0,1,1
44097,лицом,0,0,1,1
44098,droger,0,0,1,1
44020,आंकडा,0,0,1,1
44019,prächtigen,0,0,1,1
44099,valde,0,0,1,1
44100,fungerer,0,0,1,1
44017,εμπορικό,0,0,1,1
44016,настоящем,0,0,1,1
44015,yaşamda,0,0,1,1
44040,புரியவில்லை,0,0,1,1
44088,huang,0,0,1,1
43971,volgt,0,0,1,1
44055,notoriété,0,0,1,1
44066,வியப்படைந்தாள்,0,0,1,1
44065,teams,0,0,1,1
44064,ошибаетесь,0,0,1,1
44071,publicerade,0,0,1,1
44062,എന്നിവയൊക്കെ,0,0,1,1
44061,ഭാഗമാണ്,0,0,1,1
44060,അവസ്ഥയിലായിരിക്കുക,0,0,1,1
44059,ألست,0,0,1,1
44073,téléchargéesae,0,0,1,1
44057,gözyaşlarına,0,0,1,1
44056,வரையறை,0,0,1,1
44074,declarações,0,0,1,1
44041,கூர்மையைக்,0,0,1,1
44052,θέα,0,0,1,1
44051,περιγράψετε,0,0,1,1
44050,giechelde,0,0,1,1
44077,المتوازنة,0,0,1,1
44078,പദമില്ലാത്തതിനാൽ,0,0,1,1
44083,visionen,0,0,1,1
44085,والاختلاف,0,0,1,1
44087,culturelles ,0,0,1,1
44045,வழமையாக,0,0,1,1
44044,عملها,0,0,1,1
44042,تنظر,0,0,1,1
44101,perdeu,0,0,1,1
44014,reed,0,0,1,1
44012,symbols,0,0,1,1
43981,grupparbetet,0,0,1,1
43993,permitirse,0,0,1,1
44125,ஹவாய்,0,0,1,1
44126,pretendientes,0,0,1,1
44127,düşünmüyorum,0,0,1,1
43988,actualisation,0,0,1,1
43987,någonsin,0,0,1,1
43986,desistir,0,0,1,1
43985,directivos,0,0,1,1
43984,അയയ്ക്കാനോ,0,0,1,1
44131,طورت,0,0,1,1
43982,बर्खास्त,0,0,1,1
44133,обзор,0,0,1,1
44011,nourris,0,0,1,1
43980,கட்டைவிரலைக்,0,0,1,1
43979,பேச்சாளர்கள்,0,0,1,1
44134,garantia,0,0,1,1
43978,определении,0,0,1,1
44135,grob,0,0,1,1
43977,—enero,0,0,1,1
44137,يصبحن,0,0,1,1
44138,நிரூபிக்காவிட்டால்,0,0,1,1
43974,ಹಲೋ,0,0,1,1
44139,எனப்,0,0,1,1
44142,sesgadas,0,0,1,1
44124,intrinsic,0,0,1,1
44120,ಹೇಳುವುದು,0,0,1,1
44118,естественно,0,0,1,1
43995,ವಿನಮ್ರ,0,0,1,1
44010,உதவுங்கள்,0,0,1,1
44009,പരാജയങ്ങൾക്ക്,0,0,1,1
44103,പാടുപെട്ട,0,0,1,1
44104,passerait,0,0,1,1
44106,keyfi,0,0,1,1
44107,ನೋಡುವಾಗ,0,0,1,1
44008,обучаться,0,0,1,1
44108,கட்டமைப்பும்,0,0,1,1
44007,identity,0,0,1,1
44109,पूर्वाग्रहों,0,0,1,1
44110,بماذا,0,0,1,1
44112,contentious,0,0,1,1
44003,ഡൈനിംഗ്,0,0,1,1
44002,ف,0,0,1,1
44113,выходной,0,0,1,1
44114,ಶಾಲೆಯಲ್ಲಿ,0,0,1,1
44000,ഉൽപത്തി,0,0,1,1
44115,മിശ്രശബ്ദമാണ്,0,0,1,1
44116,portales,0,0,1,1
44117,ചിന്തിക്കുകയായിരുന്നു,0,0,1,1
43998,базу,0,0,1,1
43997,வலைதளத்துக்கு,0,0,1,1
43996,kämpade,0,0,1,1
43863,حافلتنا,0,0,1,1
44220,productive,0,0,1,1
43670,நிலமாகக்,0,0,1,1
44331,ಸಲಹೆಯನ್ನು,0,0,1,1
43742,தளங்களுக்கான,0,0,1,1
43741,θετικό,0,0,1,1
33550,encyklopedin,0,0,1,1
43739,القاسي,0,0,1,1
43738,uspiselig,0,0,1,1
44327,അടിച്ചേൽപ്പിക്കാൻ,0,0,1,1
44328,societies,0,0,1,1
43736,अति,0,0,1,1
43734,concrétisation,0,0,1,1
44329,spins,0,0,1,1
44330,presentados,0,0,1,1
44332,siguieron,0,0,1,1
43744,confinée,0,0,1,1
44333,getirdim,0,0,1,1
43731,elektronisk,0,0,1,1
43729,sunmaya,0,0,1,1
44335,ಪ್ರಾಮಾಣಿಕವಾಗಿ,0,0,1,1
43728,büyütmek,0,0,1,1
44338,extinct,0,0,1,1
44339,ഉപയോഗിക്കരുത്,0,0,1,1
43726,തിരുത്തൽ,0,0,1,1
44340,tekrarlamanız,0,0,1,1
43724,സുന്ദരനാണെന്ന്,0,0,1,1
44341,பார்க்காதபோது,0,0,1,1
43743,placer,0,0,1,1
43745,ഉറവിടങ്ങളുണ്ട്,0,0,1,1
44344,поисковыми,0,0,1,1
44316,locomotion‏,0,0,1,1
44301,بأنك,0,0,1,1
44305,அனுப்புங்கள்,0,0,1,1
43763,السيدات,0,0,1,1
43762,adecuada,0,0,1,1
43761,измерения,0,0,1,1
43760,கட்டுரையையும்,0,0,1,1
44310,medverkan,0,0,1,1
43758,ആയിരുന്നോ,0,0,1,1
44312,attracting,0,0,1,1
44313,выдать,0,0,1,1
44314,"
बांग्ला",0,0,1,1
44317,plateau,0,0,1,1
44324,morse,0,0,1,1
44318,മൂക്കും,0,0,1,1
44319,stelle,0,0,1,1
44320,ಪ್ರೀತಿಸುತ್ತಿಲ್ಲ,0,0,1,1
43753,lekkers,0,0,1,1
43752,feed,0,0,1,1
43751,парадокс,0,0,1,1
43750,leer,0,0,1,1
43749,kullandıkları,0,0,1,1
44321,запутать,0,0,1,1
43746,fællesskab,0,0,1,1
44323,tirasse,0,0,1,1
43723,torsdag,0,0,1,1
43721,indícios,0,0,1,1
43859,ബിസിനസ്സ്,0,0,1,1
44373,philosophe,0,0,1,1
44367,akademisyenler,0,0,1,1
43690,utilisait,0,0,1,1
44368,καθρέφτη,0,0,1,1
44369,وعليك,0,0,1,1
43687,günüyse,0,0,1,1
43686,beschrieb,0,0,1,1
43685,யூடியூப்,0,0,1,1
43684,accounts,0,0,1,1
44370,filósofo,0,0,1,1
43683,"
islandês",0,0,1,1
44371,ethnologues,0,0,1,1
43680,рассмотрим,0,0,1,1
44366,надо,0,0,1,1
44374,kombination,0,0,1,1
43679,incompletas,0,0,1,1
43678,नियमित,0,0,1,1
43677,بياني,0,0,1,1
43676,olgulara,0,0,1,1
43675,recently,0,0,1,1
43674,nåd,0,0,1,1
44375,അപ്പോൾ,0,0,1,1
43673,கிடப்பேன்,0,0,1,1
43672,ವ್ಯಕ್ತಿಯು,0,0,1,1
43671,signs,0,0,1,1
43692,ün,0,0,1,1
43694,relectures,0,0,1,1
44345,ನಿಷ್ಪ್ರಯೋಜಕವಾಗಿದ್ದರಿಂದ,0,0,1,1
43710,votou,0,0,1,1
43718,açsın,0,0,1,1
44349,"
panjabi",0,0,1,1
43717,संदर्भ,0,0,1,1
44350,لمستخدمها,0,0,1,1
44351,δίκαιη,0,0,1,1
44352,förhållande,0,0,1,1
43714,urbaine,0,0,1,1
43713,inşa,0,0,1,1
43712,സമാനമായത്,0,0,1,1
44353,prétendants,0,0,1,1
43711,ಅನುಭವವಿಲ್ಲದೆ,0,0,1,1
44355,remerciant,0,0,1,1
44364,tendrás,0,0,1,1
44359,കാണുന്നില്ലെങ്കിൽ,0,0,1,1
43706,செயன்முறையின்,0,0,1,1
43705,جالسين,0,0,1,1
44360,отдельные,0,0,1,1
43703,semence ,0,0,1,1
43702,utvecklad,0,0,1,1
43700,مفتوحاً,0,0,1,1
43699,информатизация,0,0,1,1
43698,оптических,0,0,1,1
44362,பதிப்பில்,0,0,1,1
44363,"
विनैरे",0,0,1,1
43766,desearle,0,0,1,1
44296,വാക്യങ്ങളോ,0,0,1,1
43767,ομπάμα,0,0,1,1
44254,visitou,0,0,1,1
43836,battle,0,0,1,1
43835,vågnede,0,0,1,1
44251,pés,0,0,1,1
43834,scales,0,0,1,1
43833,accorder,0,0,1,1
43832,"
दूसरा",0,0,1,1
44252,सराहना,0,0,1,1
43830,guidance,0,0,1,1
44253,comentários,0,0,1,1
43829,sauriezvous,0,0,1,1
43828,colabora,0,0,1,1
44255,évoquer,0,0,1,1
43838,bakken,0,0,1,1
43826,gerektiğidir,0,0,1,1
43825,geliştireceği,0,0,1,1
43824,organisationen,0,0,1,1
44256,uppskattar,0,0,1,1
43821,எல்லாவற்றிற்கும்,0,0,1,1
43820,trophy,0,0,1,1
43819,« discussion »,0,0,1,1
43818,sayısı,0,0,1,1
44259,έως,0,0,1,1
44260,desconcertantemente,0,0,1,1
43816,classificados,0,0,1,1
43837,surprises,0,0,1,1
43840,meestal,0,0,1,1
43768,финансирование,0,0,1,1
43849,« immanente » ,0,0,1,1
43858,ഹെല്ലർ,0,0,1,1
44225,aurais,0,0,1,1
44226,filho,0,0,1,1
44227,esboço,0,0,1,1
43856,وعبارة,0,0,1,1
43855,நுபீடியாவும்,0,0,1,1
44228,συνεχίστε,0,0,1,1
43853,घिरे,0,0,1,1
43852,ಸಹಾಯಕವಾಗಿದೆಯೆ,0,0,1,1
44230,سياق,0,0,1,1
43850,entra,0,0,1,1
44234,irgendeine,0,0,1,1
43841,तूफानी,0,0,1,1
43848,mettant,0,0,1,1
43847,الاتفاق,0,0,1,1
44238,animó,0,0,1,1
43846,ifadelerine,0,0,1,1
44239,märkbart,0,0,1,1
44242,novelties,0,0,1,1
44244,jobbet,0,0,1,1
43843,jehová,0,0,1,1
44247,കണ്ടെത്തലുകളും,0,0,1,1
44248,товарного,0,0,1,1
44249,علامة,0,0,1,1
44262,farine,0,0,1,1
44263,ocultas,0,0,1,1
44264,zhyue •,0,0,1,1
43779,مقالاً,0,0,1,1
43791,கூர்மையானது,0,0,1,1
43790,владелец,0,0,1,1
43789,പോലെയാണ്,0,0,1,1
44279,hours,0,0,1,1
43787,المنطقي,0,0,1,1
44281,undergone,0,0,1,1
43785,reaching,0,0,1,1
44282,balansgång,0,0,1,1
43783,اهتمامك,0,0,1,1
44283,defendida,0,0,1,1
43780,extend,0,0,1,1
43778,русском,0,0,1,1
44265,kennst,0,0,1,1
44287,fingern,0,0,1,1
44288,yaparsınız,0,0,1,1
44290,ತೊಂದರೆಯುಂಟುಮಾಡುವ,0,0,1,1
43775,राष्ट्रीय,0,0,1,1
44293,früheres,0,0,1,1
43774,الغداء,0,0,1,1
44294,volverse,0,0,1,1
44295,المستقل,0,0,1,1
43771,cèdent,0,0,1,1
43770,«откатить,0,0,1,1
43769,bewegt,0,0,1,1
43792,ഉപയോക്താവിനെ,0,0,1,1
43793,περιέγραφε,0,0,1,1
43794,sitter,0,0,1,1
43795,tereddüt,0,0,1,1
43813,कार्यक्षमता,0,0,1,1
43812,நத்தை,0,0,1,1
43811,betrof,0,0,1,1
44266,wezens,0,0,1,1
43809,godzijdank,0,0,1,1
44267,chics,0,0,1,1
43808,முதன்மைக்,0,0,1,1
43807,satisfacer,0,0,1,1
43806,propriété,0,0,1,1
44269,بلاد,0,0,1,1
43804,करेगी,0,0,1,1
43803,проведено,0,0,1,1
44270,imposible,0,0,1,1
44272,वेबसाइट्स,0,0,1,1
43801,உள்ளடக்க,0,0,1,1
43800,المجتمع,0,0,1,1
44274,ഒറിയ,0,0,1,1
44275,தோற்றங்களைக்,0,0,1,1
44276,selectie,0,0,1,1
44277,önceki,0,0,1,1
43797,ಎಲ್ಲಿಂದ,0,0,1,1
44278,alın,0,0,1,1
43796,memnuniyet,0,0,1,1
44709,izliyorsunuz,0,0,1,1
43299,"
वैस्पियाई",0,0,1,1
44710,تشير,0,0,1,1
42786,estructuras,0,0,1,1
45135,löpande,0,0,1,1
45136,ключевым,0,0,1,1
42791,funktion,0,0,1,1
45137,പഴയ,0,0,1,1
45140,metal,0,0,1,1
42789,широкую,0,0,1,1
42788,eclat,0,0,1,1
45141,refléter,0,0,1,1
45144,höfling en,0,0,1,1
42787,ulaşamadı,0,0,1,1
45147,vibber,0,0,1,1
42785,tanrıya,0,0,1,1
45133,ಫಿಕ್ಸ್‌ನಲ್ಲಿದ್ದಾಗ,0,0,1,1
45149,ελαφρώς,0,0,1,1
42783,хабрахабр,0,0,1,1
42782,ഉണ്ടാക്കുമെന്ന്,0,0,1,1
45150,gentileza,0,0,1,1
45155,всему,0,0,1,1
42779,rahatsızlık,0,0,1,1
42778,السادس,0,0,1,1
45156,artikelform,0,0,1,1
42777,castillo,0,0,1,1
42775,ಅಭಿನಂದಿಸುವ,0,0,1,1
45157,واجهته,0,0,1,1
45134,नवीन,0,0,1,1
42793,anoche,0,0,1,1
42774,denen,0,0,1,1
45126,классифицирующий,0,0,1,1
45123,admiratifs,0,0,1,1
42812,atemberaubend,0,0,1,1
42811,menschen,0,0,1,1
45124,وسيأتي,0,0,1,1
42810,отсеиваются,0,0,1,1
42809,போதிய,0,0,1,1
45125,blokere,0,0,1,1
42808,பிடித்த,0,0,1,1
42807,εξέταση,0,0,1,1
42806,membres,0,0,1,1
42805,capture,0,0,1,1
42804,побежала,0,0,1,1
42794,كامل،,0,0,1,1
42803,opt,0,0,1,1
42802,fing,0,0,1,1
42800,censurera,0,0,1,1
42799,biriyle,0,0,1,1
45129,лауреат,0,0,1,1
45131,propelling,0,0,1,1
42798,programação,0,0,1,1
42797,கிளாசிக்கல்,0,0,1,1
42796,കുറവുള്ള,0,0,1,1
42795,wereld,0,0,1,1
45132,വിജ്ഞാന,0,0,1,1
45158,ഒരൊറ്റ,0,0,1,1
45159,സ്തംഭിച്ചുപോകുന്നത്,0,0,1,1
42736,χρόνια,0,0,1,1
42746,säkerställda,0,0,1,1
45182,questionada,0,0,1,1
45183,güzelliğinden,0,0,1,1
45184,otlet,0,0,1,1
42752,illiterate,0,0,1,1
42751,myntas,0,0,1,1
42750,repérer ,0,0,1,1
45185,rubi,0,0,1,1
45187,stopped,0,0,1,1
42748,الجنساني,0,0,1,1
45188,ಪ್ರತಿಯೊಬ್ಬರೂ,0,0,1,1
45189,« naturelle »,0,0,1,1
42745,meteorite,0,0,1,1
42753,pænere,0,0,1,1
42744,вверху,0,0,1,1
45190,подобного,0,0,1,1
42743,"
अस्तूरियाई",0,0,1,1
45192,platenhoes,0,0,1,1
42742,intonatie,0,0,1,1
42740,conjunction,0,0,1,1
45194,मीडियन,0,0,1,1
42739,ನೋಡಬೇಡಿ,0,0,1,1
45195,foundation”,0,0,1,1
42737,озаглавленная,0,0,1,1
45197,opportunités,0,0,1,1
45181,atribuíram,0,0,1,1
45180,sensiz,0,0,1,1
45160,ejaculation,0,0,1,1
45171,заключенные,0,0,1,1
45161,استفهام,0,0,1,1
45162,dokümanların,0,0,1,1
42770,anglosajón,0,0,1,1
45164,പറയിപെറ്റ,0,0,1,1
42769,«спасибо,0,0,1,1
45165,española,0,0,1,1
42768,ചേർക്കാനാണ്,0,0,1,1
42767,externas,0,0,1,1
45166,проверены,0,0,1,1
45169,анализа,0,0,1,1
45170,वही,0,0,1,1
42763,duitse,0,0,1,1
42755,allmänheten,0,0,1,1
42762,föreställer,0,0,1,1
45172,ευφυή,0,0,1,1
45173,næse,0,0,1,1
45174,d’enseignement ,0,0,1,1
45175,إِلى,0,0,1,1
45176,roles,0,0,1,1
45177,சுட,0,0,1,1
42759,ഗ്ലാസ്,0,0,1,1
42758,പണമുണ്ടെന്ന്,0,0,1,1
42757,شاهد,0,0,1,1
42756,tidskriftsartiklar,0,0,1,1
45122,εγκέφαλό,0,0,1,1
42813,prinsen,0,0,1,1
45119,substitutions,0,0,1,1
42868,خوارزميات,0,0,1,1
42879,anthropomorphisme »,0,0,1,1
42878,φάσμα,0,0,1,1
42877,podrá,0,0,1,1
42876,нужен,0,0,1,1
45064,antonino,0,0,1,1
42874,respetar,0,0,1,1
42872,ಅವುಗಳಲ್ಲಿ,0,0,1,1
45066,التكنولوجيا,0,0,1,1
42871,artikelskrivandet,0,0,1,1
42870,εκπλαγείτε,0,0,1,1
42869,parou,0,0,1,1
42867,compléter,0,0,1,1
45061,personnesai,0,0,1,1
45067,നിന്നെക്കുറിച്ച്,0,0,1,1
42866,verrichten,0,0,1,1
45068,മാതൃ,0,0,1,1
45069,totémisme,0,0,1,1
42865,المطاف,0,0,1,1
45070,gebrauch,0,0,1,1
45072,ubrugeligt,0,0,1,1
42863,καλές,0,0,1,1
45073,"
अल्बानियाई",0,0,1,1
42862,africans,0,0,1,1
42861,بعلامة,0,0,1,1
45062,vådområde,0,0,1,1
45060,cuyo,0,0,1,1
42814,monta,0,0,1,1
45044,ಟಿ,0,0,1,1
45033,öneriler,0,0,1,1
42902,ತದನಂತರ,0,0,1,1
42901,knutna,0,0,1,1
45036,necesidades,0,0,1,1
42900,revenue,0,0,1,1
45038,мэттьюс,0,0,1,1
42897,راي,0,0,1,1
42896,يُعرف,0,0,1,1
45042,"
तेलुगू",0,0,1,1
42894,الادعاءات,0,0,1,1
45043,engines‏,0,0,1,1
42891,escasa,0,0,1,1
42882,narzissa,0,0,1,1
45047,किताब,0,0,1,1
45048,मैक्स,0,0,1,1
45050,damos,0,0,1,1
45051,mogelijk,0,0,1,1
45052,moedertaalsprekers,0,0,1,1
45053,поступок,0,0,1,1
42889,​​από,0,0,1,1
42887,ಪರಿಣಾಮವನ್ನು,0,0,1,1
45054,заведомо,0,0,1,1
45055,mínima,0,0,1,1
42884,மாணவர்களுக்கான,0,0,1,1
45076,கோணமாகும்,0,0,1,1
45077,economische,0,0,1,1
45078,يظن,0,0,1,1
45110,попали,0,0,1,1
42832,شخصياتها,0,0,1,1
45101,égalitaire,0,0,1,1
42831,perceptrones,0,0,1,1
45103,removal,0,0,1,1
45104,ஏற்றுக்கொள்கிறேன்,0,0,1,1
42828,ലിങ്ക്,0,0,1,1
42827,desfazer,0,0,1,1
45107,возражаете,0,0,1,1
42825,поездки,0,0,1,1
45109,amerikansk,0,0,1,1
42823,gwh,0,0,1,1
42822,ettiğin,0,0,1,1
42856,informativos,0,0,1,1
45111,vinklade,0,0,1,1
45112,dolarımı,0,0,1,1
42820,clavo,0,0,1,1
45114,വിളിക്കാൻ,0,0,1,1
45115,इलेक्ट्रोनिका,0,0,1,1
45116,encorajada,0,0,1,1
42818,κύριας,0,0,1,1
45117,vivrait,0,0,1,1
42817,пределами,0,0,1,1
42816,парламента,0,0,1,1
42815,eligió,0,0,1,1
45100,decomposition,0,0,1,1
42833,queries,0,0,1,1
42834,абстрактного,0,0,1,1
42835,loi,0,0,1,1
45080,используемый,0,0,1,1
45081,обо,0,0,1,1
42855,visites,0,0,1,1
45082,electric,0,0,1,1
45083,أخطاء,0,0,1,1
42853,വലിച്ചിടുക,0,0,1,1
42852,schlief,0,0,1,1
42851,നടത്തേണ്ടതുണ്ടെന്നും,0,0,1,1
45085,അതുകൊണ്ട്‌,0,0,1,1
42849,crudivorismo,0,0,1,1
45087,kız,0,0,1,1
45091,ದಾಳಿಕೋರರು,0,0,1,1
42845,عمليات,0,0,1,1
42844,продолжай,0,0,1,1
45093,acercando,0,0,1,1
45094,krydser,0,0,1,1
45095,столе,0,0,1,1
45097,தளையறு,0,0,1,1
42841,году»,0,0,1,1
42840,тон,0,0,1,1
42838,αδελφά,0,0,1,1
42837,biomedical,0,0,1,1
42836,شاركت,0,0,1,1
45199,pássaro,0,0,1,1
42735,torne,0,0,1,1
44711,criba,0,0,1,1
42611,المجتمعية،,0,0,1,1
45313,esthétique,0,0,1,1
42620,medelåldern,0,0,1,1
42619,loudest,0,0,1,1
45314,αγγλικές,0,0,1,1
45315,научной,0,0,1,1
45317,உயர்ந்தது,0,0,1,1
42617,стороны —,0,0,1,1
42616,إستوحت,0,0,1,1
42615,editathons,0,0,1,1
45320,tandis,0,0,1,1
45321,interativo,0,0,1,1
45322,popularisés,0,0,1,1
45311,africarelated,0,0,1,1
45324,incluyen,0,0,1,1
45326,exhaustivo,0,0,1,1
45327,representam,0,0,1,1
45328,måneder,0,0,1,1
45329,നോക്കുമ്പോൾ,0,0,1,1
42607,doğa,0,0,1,1
45331,supported,0,0,1,1
42605,августе,0,0,1,1
42604,सेवी,0,0,1,1
45332,pose,0,0,1,1
45333,கூறுகிறார்,0,0,1,1
45312,humorista,0,0,1,1
45310,смотрела,0,0,1,1
45336,यो,0,0,1,1
42631,sædvanlige,0,0,1,1
45295,sobreviveu,0,0,1,1
45297,διάσημο,0,0,1,1
42639,atteint,0,0,1,1
42638,входного,0,0,1,1
45299,liedjes,0,0,1,1
45300,wpartikel,0,0,1,1
42637,விளங்கிய,0,0,1,1
45301,«bibliotecarios»,0,0,1,1
42634,visuelle,0,0,1,1
45303,झिझक,0,0,1,1
45304,défauts,0,0,1,1
42630,सामी,0,0,1,1
42622,милые,0,0,1,1
45305,напечатаны,0,0,1,1
42629,finaliste,0,0,1,1
45306,encorajar,0,0,1,1
42628,أمير,0,0,1,1
45307,künt,0,0,1,1
45308,gubernamental,0,0,1,1
42627,disposent,0,0,1,1
42626,പുറത്തുവന്ന്,0,0,1,1
45309,læse,0,0,1,1
42625,മാനദണ്ഡങ്ങൾ,0,0,1,1
42624,स्मृति,0,0,1,1
45334,lyfta,0,0,1,1
45337,சரியில்லை,0,0,1,1
42734,fictitious,0,0,1,1
42566,ഫൗണ്ടേഷന്റെ,0,0,1,1
45360,озаглавленный,0,0,1,1
45361,शैक्षणिक,0,0,1,1
45362,aplicado,0,0,1,1
42573,വിശ്വസിക്കാൻ,0,0,1,1
45363,« naître »,0,0,1,1
42572,beğenerek,0,0,1,1
42571,yavaşça,0,0,1,1
42570,ആരംഭിച്ചപ്പോഴാണ്,0,0,1,1
42569,obligation,0,0,1,1
42568,toepassing,0,0,1,1
45364,учитель,0,0,1,1
42565,определённым,0,0,1,1
45359,ними,0,0,1,1
42564,секрет,0,0,1,1
42563,लिंग,0,0,1,1
45367,görünmek,0,0,1,1
42561,دورية,0,0,1,1
45368,ಆಗಲು,0,0,1,1
45369,ഹായ്,0,0,1,1
42557,baktığında,0,0,1,1
42555,случайно,0,0,1,1
42554,रीस्टोर,0,0,1,1
45371,denkst,0,0,1,1
45372,παρανόηση,0,0,1,1
42578,prisioneiros,0,0,1,1
45357,кампании,0,0,1,1
45339,zoet,0,0,1,1
42590,கொடுக்கப்,0,0,1,1
45340,kıyafet,0,0,1,1
45341,croatia,0,0,1,1
42598,exhibir,0,0,1,1
42597,ஒரேயளவினதாய்,0,0,1,1
42596,resultaram,0,0,1,1
42595,middel,0,0,1,1
45342,بلودجيت,0,0,1,1
45343,ей,0,0,1,1
45345,ഗുണാങ്കങ്ങളുടെ,0,0,1,1
45346,هنا؟,0,0,1,1
45347,verhungern,0,0,1,1
45348,подготовка,0,0,1,1
45356,yiyecekler,0,0,1,1
42588,rappelé,0,0,1,1
45350,"
esloveno",0,0,1,1
45352,undgår,0,0,1,1
42587,hakkı,0,0,1,1
45354,guían,0,0,1,1
42585,umursamıyorsun,0,0,1,1
42584,മുകളിലുള്ള,0,0,1,1
45355,നിർബന്ധമില്ല,0,0,1,1
42582,ಅಕ್ಷರಶಃ,0,0,1,1
42581,korku,0,0,1,1
42580,forberedt,0,0,1,1
42645,остановка,0,0,1,1
45293,consécutifs,0,0,1,1
45292,facettes,0,0,1,1
45229,ಮಾಡಬೇಕಾದದ್ದು,0,0,1,1
45219,indicada,0,0,1,1
45220,ситуации,0,0,1,1
45221,voyageaient,0,0,1,1
45222,ضعيف,0,0,1,1
42706,wesen,0,0,1,1
45224,kone,0,0,1,1
42704,intégré,0,0,1,1
45225,கிடைத்தால்,0,0,1,1
45226,താഴെയുമാണ്,0,0,1,1
45227,trouvait,0,0,1,1
45228,അവർക്ക്,0,0,1,1
45230,antielitismo,0,0,1,1
42710,मिले,0,0,1,1
45231,реакций,0,0,1,1
45232,landform,0,0,1,1
42700,boş,0,0,1,1
45233,संध्या।,0,0,1,1
42699,wäsche,0,0,1,1
42696,parisien,0,0,1,1
42695,tıklanan,0,0,1,1
42694,nyheter,0,0,1,1
45239,engendré,0,0,1,1
42693,physics—the,0,0,1,1
42692,jams,0,0,1,1
42709,parallèle,0,0,1,1
42711,நுட்பக்,0,0,1,1
45291,معاديًا,0,0,1,1
42721,அவருக்கு,0,0,1,1
42733,incidenter,0,0,1,1
45200,estricto,0,0,1,1
45201,ഓപ്റ്റിക്കൽ,0,0,1,1
42730,tendency,0,0,1,1
42729,eveneens,0,0,1,1
42727,sahen,0,0,1,1
42725,comenzaba,0,0,1,1
42724,yasaklanmasını,0,0,1,1
45205,blijven,0,0,1,1
45209,amoralidade,0,0,1,1
42722,exceto,0,0,1,1
45211,santiago,0,0,1,1
45218,இருக்கிறாள்,0,0,1,1
42719,anglais ,0,0,1,1
45212,avsiktligen,0,0,1,1
45213,bahsetme,0,0,1,1
42718,छोटा,0,0,1,1
45215,n’héritent,0,0,1,1
42716,பக்கத்தின்,0,0,1,1
42715,zware,0,0,1,1
42714,fbi,0,0,1,1
45216,दबाव,0,0,1,1
45217,teori,0,0,1,1
42713,hazırlanan,0,0,1,1
45244,angår,0,0,1,1
42690,கலாச்சார,0,0,1,1
42689,കിടക്ക,0,0,1,1
42656,публично,0,0,1,1
42665,varanda,0,0,1,1
45273,avanços,0,0,1,1
45274,atrapado,0,0,1,1
42664,улыбалась,0,0,1,1
45275,requereu,0,0,1,1
42662,أفاد,0,0,1,1
45277,रुकें।,0,0,1,1
42660,разговора,0,0,1,1
45279,உட்பட்டுவரும்,0,0,1,1
42658,billeder,0,0,1,1
45280,uyandım,0,0,1,1
45281,controversé,0,0,1,1
42688,gratulieren,0,0,1,1
45282,commit,0,0,1,1
45283,प्रबल,0,0,1,1
42655,vengera,0,0,1,1
45284,നേരിട്ട്,0,0,1,1
42653,அகங்காரமான,0,0,1,1
45285,gems,0,0,1,1
42652,lb •,0,0,1,1
42650,ആണി,0,0,1,1
45286,знания,0,0,1,1
42649,derhen,0,0,1,1
45287,wikipediaartikler,0,0,1,1
45269,अचंभित,0,0,1,1
45268,trupperna,0,0,1,1
45267,розенцвейг,0,0,1,1
45266,ansiklopedilerindeki,0,0,1,1
42687,müstakbel,0,0,1,1
42685,telefônica,0,0,1,1
45248,brisé,0,0,1,1
45250,أتناوله,0,0,1,1
42683,fotograf,0,0,1,1
42682,biliyor,0,0,1,1
45252,astéroïde,0,0,1,1
45253,устраняются,0,0,1,1
45255,πίστευε,0,0,1,1
42680,prédéterminées,0,0,1,1
42679,ಡಿಗ್ರಿಗಿಂತ,0,0,1,1
42678,bahçelerinde,0,0,1,1
42677,galeries,0,0,1,1
42676,cujas,0,0,1,1
45258,स्थल,0,0,1,1
42675,traduzidos,0,0,1,1
45259,convenues,0,0,1,1
45260,översättning,0,0,1,1
45261,tecavüz,0,0,1,1
42671,preguntarte,0,0,1,1
45262,സ്പീക്കർ,0,0,1,1
45263,escravos,0,0,1,1
42670,concepten,0,0,1,1
45032,أعلن,0,0,1,1
45031,vigtige,0,0,1,1
42906,أتمنى,0,0,1,1
43154,ganado,0,0,1,1
43164,தூண்டுகிறது,0,0,1,1
43163,originalomslaget,0,0,1,1
44803,surgiram,0,0,1,1
43162,собственных,0,0,1,1
43161,impossibilité,0,0,1,1
43160,πλήρως,0,0,1,1
43159,interdisciplinära,0,0,1,1
44805,mets,0,0,1,1
44806,sucedido,0,0,1,1
44807,ಹೊಂದುವ,0,0,1,1
43156,ingetrokken,0,0,1,1
43153,edip,0,0,1,1
43166,brittiska,0,0,1,1
43152,συνέβαινε,0,0,1,1
43151,ബോക്സിൽ,0,0,1,1
44810,रहना।,0,0,1,1
43150,sinks,0,0,1,1
44811,descoberta,0,0,1,1
44813,respirer,0,0,1,1
44816,இயலாது,0,0,1,1
43146,policiam,0,0,1,1
43145,bildiğim,0,0,1,1
43144,consideration,0,0,1,1
43143,totais,0,0,1,1
44802,உனக்கு,0,0,1,1
44801,இருந்து,0,0,1,1
44819,польская,0,0,1,1
43180,गैरविकी,0,0,1,1
43187,univers »,0,0,1,1
43186,examensrapporter,0,0,1,1
43185,балкона,0,0,1,1
43184,combinou,0,0,1,1
44779,மனமார்ந்த,0,0,1,1
44780,«сообщество»,0,0,1,1
44783,gizlice,0,0,1,1
44784,конфликтам,0,0,1,1
44785,المحظوظ,0,0,1,1
44787,إل,0,0,1,1
44788,qualitéh,0,0,1,1
43179,защита,0,0,1,1
43168,tafel,0,0,1,1
43177,семена,0,0,1,1
44790,παραπονεθεί,0,0,1,1
44792,başarısız,0,0,1,1
44793,उपस्थिति,0,0,1,1
44796,खिलाते,0,0,1,1
43173,ideological,0,0,1,1
44797,ms •,0,0,1,1
44798,внести,0,0,1,1
43171,ouais,0,0,1,1
44799,passada,0,0,1,1
44800,implausible,0,0,1,1
44818,позиционирует,0,0,1,1
43141,отличная,0,0,1,1
42907,reparler,0,0,1,1
43108,istediğini,0,0,1,1
44844,saniye,0,0,1,1
44847,téléchargeables,0,0,1,1
43115,prato,0,0,1,1
43114,கைதிகள்,0,0,1,1
43113,árabe,0,0,1,1
43112,بالأرقام,0,0,1,1
44848,oprit,0,0,1,1
44849,verwende,0,0,1,1
44850,atone,0,0,1,1
43110,war •,0,0,1,1
43109,insistent,0,0,1,1
43107,некоммерческого,0,0,1,1
43120,ആളുകളുടെ,0,0,1,1
44851,продал,0,0,1,1
43106,ഓയെപ്പോലെയാണ്,0,0,1,1
44853,остановилась,0,0,1,1
44854,கட்டுரைக்குமான,0,0,1,1
44855,sorular,0,0,1,1
43103,auktoriteter,0,0,1,1
44857,reemplazo,0,0,1,1
43101,பக்கம்’,0,0,1,1
44859,relatórios,0,0,1,1
44860,solapa,0,0,1,1
43098,i̇ngilizcede,0,0,1,1
44843,нечисловыми,0,0,1,1
44842,"
हक्का",0,0,1,1
44821,parodiler,0,0,1,1
44830,godaste,0,0,1,1
43140,ഉപയോഗിച്ചാൽ,0,0,1,1
44822,أَنَّ,0,0,1,1
44823,müzik,0,0,1,1
44825,veriyorum,0,0,1,1
43139,σωστό,0,0,1,1
44827,gobbling,0,0,1,1
44828,высшим,0,0,1,1
43135,sonraki,0,0,1,1
43134,ഉപയോക്താക്കളും,0,0,1,1
43133,корпораций,0,0,1,1
43132,сообществом,0,0,1,1
43131,fann,0,0,1,1
43122,ഉറപ്പുവരുത്തുന്നതിന്,0,0,1,1
44831,تتبعهم،,0,0,1,1
43130,واللغات,0,0,1,1
44833,"
मंगोलियाई",0,0,1,1
43128,अपेक्षाकृत,0,0,1,1
43127,genders,0,0,1,1
44837,атрибутированием,0,0,1,1
43126,الرهيب,0,0,1,1
43125,затраты,0,0,1,1
44838,അനുവാദം,0,0,1,1
43123,ತಲೆಗೆ,0,0,1,1
44839,categorization,0,0,1,1
44778,മരിയനെ,0,0,1,1
44777,دمج,0,0,1,1
44776,homossexual,0,0,1,1
43260,യന്ത്രപഠനത്തിനു,0,0,1,1
44732,papers,0,0,1,1
43270,processeurs,0,0,1,1
44733,tankerne,0,0,1,1
44735,ಅನುಮಾನಕ್ಕೆ,0,0,1,1
43268,قناتي,0,0,1,1
43267,namiddag,0,0,1,1
43266,demandais,0,0,1,1
43265,podían,0,0,1,1
44736,attirée,0,0,1,1
43263,വരെ,0,0,1,1
43262,filosofen,0,0,1,1
44738,publicaron,0,0,1,1
44728,vinklad,0,0,1,1
43259,πατάτες,0,0,1,1
44740,reliée,0,0,1,1
43256,είδε,0,0,1,1
44741,оставался,0,0,1,1
44742,lagged,0,0,1,1
44744,സ്വതന്ത്രമായ,0,0,1,1
43253,famílias,0,0,1,1
44745,rik,0,0,1,1
44746,succesvol,0,0,1,1
43250,sammanfattade,0,0,1,1
43248,مبدأ,0,0,1,1
44731,stresses,0,0,1,1
43274,executes,0,0,1,1
44774,disagreements,0,0,1,1
43286,chain,0,0,1,1
43296,கேள்விப்பட்டிருக்கிறேன்,0,0,1,1
43295,obscenity,0,0,1,1
44714,мамой,0,0,1,1
44715,ദിവസേന,0,0,1,1
43293,inexplorable,0,0,1,1
44716,विरले,0,0,1,1
43290,утверждения,0,0,1,1
44717,énormément,0,0,1,1
43288,ശ്രദ്ധിക്കാൻ,0,0,1,1
43287,tristeza,0,0,1,1
44718,cayó,0,0,1,1
44719,semenciers,0,0,1,1
43275,कायम,0,0,1,1
44720,origines,0,0,1,1
44722,американской,0,0,1,1
44723,الكيميائية،,0,0,1,1
44724,nebula,0,0,1,1
44725,robótica,0,0,1,1
43281,enkätsvaren,0,0,1,1
44726,plage,0,0,1,1
43279,സ്റ്റഫ്,0,0,1,1
43278,ശരിയാണെന്ന്,0,0,1,1
44727,chiffrer,0,0,1,1
43276,centrar,0,0,1,1
43247,модификации,0,0,1,1
43245,ತಿಳಿದಿದ್ದರೆ,0,0,1,1
44749,ചെയ്യാത്തത്,0,0,1,1
43206,വരുത്തുക,0,0,1,1
44761,canadiennes,0,0,1,1
44762,വിടുകയാണെന്ന്,0,0,1,1
44763,programmoduler,0,0,1,1
43213,förvirra,0,0,1,1
43212,προσέχεις,0,0,1,1
43211,perdon,0,0,1,1
44764,ಕೊಡುವಷ್ಟು,0,0,1,1
43210,recordarte,0,0,1,1
44765,limitações,0,0,1,1
43208,collaboratives,0,0,1,1
43207,reliance,0,0,1,1
43205,redistribuer,0,0,1,1
43243,​​कि,0,0,1,1
43204,практически,0,0,1,1
43203,собственностинеавторитетный,0,0,1,1
44767,സ്വപ്നമായിരുന്നു,0,0,1,1
44768,ingresan,0,0,1,1
43200,uz •,0,0,1,1
44770,kurallarından,0,0,1,1
43198,bezaaid,0,0,1,1
43197,दिनप्रतिदिन,0,0,1,1
43195,ಸ್ಪಾಟ್,0,0,1,1
43194,"
italiano",0,0,1,1
43193,trustees,0,0,1,1
44760,prompted,0,0,1,1
43216,confère »,0,0,1,1
43217,mall,0,0,1,1
43218,തെളിവുകളുണ്ടാകണം,0,0,1,1
44751,இற்றைப்படுத்தப்படும்,0,0,1,1
43240,அதைக்,0,0,1,1
43239,исходят,0,0,1,1
43238,katıldığını,0,0,1,1
44753,rádio,0,0,1,1
43236,slid,0,0,1,1
43235,ressources,0,0,1,1
43234,αξιόπιστης,0,0,1,1
43233,математического,0,0,1,1
44754,paciente,0,0,1,1
43231,ചെയ്യുന്നില്ല,0,0,1,1
44755,மாற்றமடையும்,0,0,1,1
43229,ಅಳಬೇಡ,0,0,1,1
43228,बनाना,0,0,1,1
43227,« print,0,0,1,1
43226,noting,0,0,1,1
43224,ಕಲಿಯಿರಿ,0,0,1,1
43223,آراء,0,0,1,1
43222,ആയിരം,0,0,1,1
43221,communityproduced,0,0,1,1
44756,hastigt,0,0,1,1
44757,spitzer,0,0,1,1
43219,вышла,0,0,1,1
44862,கற்றலைத்,0,0,1,1
44864,reklamer,0,0,1,1
44867,قلت,0,0,1,1
44976,сбитых,0,0,1,1
44970,بقائمة,0,0,1,1
42976,forskningsstandarder,0,0,1,1
42975,χρήσιμο,0,0,1,1
42974,güisquipedia,0,0,1,1
44971,sumarse,0,0,1,1
44972,çalışma,0,0,1,1
44973,الخلاف,0,0,1,1
42971,അറിയപ്പെട്ടിരുന്നെങ്കിലും,0,0,1,1
42970,inblandning,0,0,1,1
42969,videnskabeligt,0,0,1,1
42968,वैश्विक,0,0,1,1
42966,elevar,0,0,1,1
44967,mångspråkig,0,0,1,1
42965,consultationsmodifications,0,0,1,1
42964,iniciar,0,0,1,1
44982,glatt,0,0,1,1
42963,implémentation,0,0,1,1
42962,rappelezvous,0,0,1,1
44983,gidelim,0,0,1,1
42961,ödevlerle,0,0,1,1
42960,ಮಾಡುವವರಿಗೆ,0,0,1,1
42959,smilende,0,0,1,1
42958,jouait,0,0,1,1
44984,tokio,0,0,1,1
44968,påverka,0,0,1,1
42978,مخزنة,0,0,1,1
44952,apparaten,0,0,1,1
42988,sabrosas,0,0,1,1
42999,overskuelighed,0,0,1,1
42998,inteiramente,0,0,1,1
42997,reichtümer,0,0,1,1
42996,англоязычный,0,0,1,1
42995,duidt,0,0,1,1
42994,κάθισε,0,0,1,1
42992,копии,0,0,1,1
42991,بامتلاك,0,0,1,1
44956,şarkılarda,0,0,1,1
44957,ساعدني,0,0,1,1
42989,panciera,0,0,1,1
44959,wikiscanninghistorien,0,0,1,1
44966,ശബ്‌ദം,0,0,1,1
42986,descargar,0,0,1,1
44961,ಹೊಂದಿರಬೇಕು,0,0,1,1
42985,يصف,0,0,1,1
42984,ಮಾಡಬೇಕೆಂಬುದನ್ನು,0,0,1,1
42983,encyclopédique,0,0,1,1
42982,afviste,0,0,1,1
42981,அறிவிக்கப்பட்டது,0,0,1,1
42980,solvable,0,0,1,1
42979,പതിപ്പാണ്‌,0,0,1,1
44963,postings,0,0,1,1
44965,umursamıyordu,0,0,1,1
44985,സ്രോതസ്സിന്റെ,0,0,1,1
42956,സാർവത്രികമായി,0,0,1,1
44987,исследованиями,0,0,1,1
45016,ursprungliga,0,0,1,1
42928,കഴിക്കുന്നതിനേക്കാൾ,0,0,1,1
45009,روعة,0,0,1,1
45011,ಭಾಗವನ್ನು,0,0,1,1
45012,الصلة,0,0,1,1
42924,കണ്ടിട്ട്,0,0,1,1
42923,acrescentou,0,0,1,1
45013,ഏകഗ്രഹമാണ്,0,0,1,1
42921,والمحللون,0,0,1,1
42920,ಹೇಳುವಂತೆ,0,0,1,1
42919,breaks”,0,0,1,1
42918,επαφή,0,0,1,1
45017,जानवर,0,0,1,1
42953,permanecessem,0,0,1,1
45018,αντέξτε,0,0,1,1
45019,страх,0,0,1,1
42916,charges,0,0,1,1
45021,counting,0,0,1,1
45022,falantes,0,0,1,1
45027,cotidiana,0,0,1,1
45028,stötande,0,0,1,1
42911,tætskrevne,0,0,1,1
42910,delats,0,0,1,1
45030,bijdragers,0,0,1,1
42909,अनुवादित,0,0,1,1
45007,ಹೆಚ್ಚಿಸಿ,0,0,1,1
45006,neredeydik,0,0,1,1
42930,قالت,0,0,1,1
42931,surgem,0,0,1,1
44989,мясо,0,0,1,1
42951,لنبدأ,0,0,1,1
42950,வழக்கப்படியான,0,0,1,1
44991,applying,0,0,1,1
42947,वॉचलिस्ट,0,0,1,1
44992,بمصدر،,0,0,1,1
42944,تقليدية,0,0,1,1
42943,дышать,0,0,1,1
44994,dilemmes,0,0,1,1
44995,benutzt,0,0,1,1
42941,favorisée,0,0,1,1
42940,применена,0,0,1,1
44996,educadamente,0,0,1,1
42938,культура,0,0,1,1
42937,ಪ್ರಾರಂಭಿಸಲಿದ್ದರೆ,0,0,1,1
44999,മാനദണ്ഡങ്ങളുപയോഗിച്ചാണ്,0,0,1,1
42936,automates,0,0,1,1
45000,എസ്എംഎസ്,0,0,1,1
42935,lacunes,0,0,1,1
45001,arrêtés,0,0,1,1
45002,establishes,0,0,1,1
45005,adéquation,0,0,1,1
42932,pudiste,0,0,1,1
43000,varsayılmaktadır,0,0,1,1
44951,فروع,0,0,1,1
43096,амстердаме,0,0,1,1
44894,ಬರುವುದಿಲ್ಲ,0,0,1,1
44886,aprenden,0,0,1,1
44888,محررو,0,0,1,1
43068,pedagogos,0,0,1,1
43067,ಸ್ಥಳವಿಲ್ಲ,0,0,1,1
44891,беспокоюсь,0,0,1,1
43065,بمواصلة,0,0,1,1
43064,sprankelende,0,0,1,1
43063,दोषी,0,0,1,1
44892,klädd,0,0,1,1
43062,collaborateurs,0,0,1,1
44893,histories,0,0,1,1
43060,حياتها,0,0,1,1
44885,جميلًا,0,0,1,1
43059,многократно,0,0,1,1
44895,goza,0,0,1,1
43057,കാലാന്തരത്തിൽ,0,0,1,1
44896,व्यस्तता,0,0,1,1
43056,javascript,0,0,1,1
43055,anzugeben,0,0,1,1
43054,ошибке»,0,0,1,1
43052,ഒഴിവാക്കാറുണ്ട്,0,0,1,1
44897,judiciaires,0,0,1,1
44899,mobiles,0,0,1,1
44900,दर्पण,0,0,1,1
43071,compraria,0,0,1,1
44884,മുറിച്ചുകടക്കുമെന്നും,0,0,1,1
44950,بالتالي,0,0,1,1
43084,aufhalten,0,0,1,1
43095,undertiden,0,0,1,1
43094,th •,0,0,1,1
43093,physicien,0,0,1,1
43090,civility,0,0,1,1
43089,elefantes,0,0,1,1
43088,behandelt,0,0,1,1
44872,പരീക്ഷകൾ,0,0,1,1
43087,ഒരോ,0,0,1,1
44874,φυσικό,0,0,1,1
44875,தகவல்களைக்,0,0,1,1
44876,contracción,0,0,1,1
43083,γουικιπίντια,0,0,1,1
44883,near,0,0,1,1
43082,invoerdata,0,0,1,1
43081,detecting,0,0,1,1
43080,सेलेब्रेट्स,0,0,1,1
43079,crítico,0,0,1,1
44878,никак,0,0,1,1
44879,freezing,0,0,1,1
44880,സൃഷ്ടിച്ച്,0,0,1,1
43076,പരിശോധനാ,0,0,1,1
43075,വളരെയധികമില്ല,0,0,1,1
43073,ಅತೃಪ್ತಿಯನ್ನು,0,0,1,1
44881,propietario,0,0,1,1
43051,കുട്ടി,0,0,1,1
43050,شوارتز,0,0,1,1
44902,görkemli,0,0,1,1
44942,enojes,0,0,1,1
43020,تكميلي,0,0,1,1
44931,топология,0,0,1,1
44932,unes,0,0,1,1
44933,ஆண்களை,0,0,1,1
43018,онлайнсправочников,0,0,1,1
44934,excesiva,0,0,1,1
44936,trouvé,0,0,1,1
44937,bedekken,0,0,1,1
43015,مجاني,0,0,1,1
43014,забавный,0,0,1,1
44940,distinctifs,0,0,1,1
43012,प्रारम्भ,0,0,1,1
43049,danmark,0,0,1,1
43011,επιλογές,0,0,1,1
44943,ثمل,0,0,1,1
44944,улыбнуться,0,0,1,1
43009,yapmasına,0,0,1,1
43006,томах,0,0,1,1
44945,avsiktlig,0,0,1,1
43005,كوم,0,0,1,1
44946,numarasını,0,0,1,1
44948,സൗന്ദര്യമല്ലാതെ,0,0,1,1
43003,संकलित,0,0,1,1
44949,ziyarete,0,0,1,1
43021,burocracia,0,0,1,1
43023,låne,0,0,1,1
44930,ಪ್ರತಿಬಿಂಬದಲ್ಲಿ,0,0,1,1
44929,tausend,0,0,1,1
43048,ಹಳೆಯ,0,0,1,1
43046,खोये,0,0,1,1
43045,ಜಿಗಿದರೆ,0,0,1,1
44903,dier,0,0,1,1
43042,minimize,0,0,1,1
43041,government,0,0,1,1
44909,bulk,0,0,1,1
44910,الإشارة,0,0,1,1
43040,"
दिवेही",0,0,1,1
44911,உணர்கிறேன்,0,0,1,1
44913,المجتمع ,0,0,1,1
43037,hänvisning,0,0,1,1
44914,दें।,0,0,1,1
44915,ziyaretçilerinin,0,0,1,1
43036,കീഴിൽ,0,0,1,1
44917,relaties,0,0,1,1
44918,ortasındayken,0,0,1,1
43033,wikiform,0,0,1,1
43031,alison,0,0,1,1
44921,nadenken,0,0,1,1
43030,solzhenitsyn,0,0,1,1
44923,ಬಯಸಿದ,0,0,1,1
44928,التكرار,0,0,1,1
41103,بمرور,0,0,1,1
46739,besökares,0,0,1,1
41102,velsmagende,0,0,1,1
39134,مناسبًا,0,0,1,1
48460,mücadeleyi,0,0,1,1
48462,отклонениям,0,0,1,1
48463,sevgili,0,0,1,1
39140,பதிப்பிடக்கூடிய,0,0,1,1
48464,മൊത്തത്തിൽ,0,0,1,1
39139,पड़ाव,0,0,1,1
39138,ചെയ്തതിന്,0,0,1,1
48465,ಸುಸ್ತಾಗಿಲ್ಲ,0,0,1,1
39136,courts,0,0,1,1
39135,സുഖമായിരിക്കും,0,0,1,1
48466,summary,0,0,1,1
48467,internetanvändarna,0,0,1,1
39143,annuelle,0,0,1,1
48468,omslaget,0,0,1,1
48469,källa behövs,0,0,1,1
48470,situada,0,0,1,1
39132,xviiie siècles,0,0,1,1
48471,недостоверность,0,0,1,1
39129,uitpraten,0,0,1,1
39128,சுதந்திரம்,0,0,1,1
48472,मुख्यालय,0,0,1,1
39127,தொடங்குவதற்கு,0,0,1,1
48473,कोरियाई,0,0,1,1
48474,walmart,0,0,1,1
39142,étymologique,0,0,1,1
39144,disparidad,0,0,1,1
48476,studerende,0,0,1,1
48451,förstående,0,0,1,1
39164,forvirrede,0,0,1,1
48443,pollueurpayeur,0,0,1,1
39162,minam,0,0,1,1
48445,étranger,0,0,1,1
48446,समन्वय,0,0,1,1
48447,lilla,0,0,1,1
39159,sake,0,0,1,1
48448,يجادل,0,0,1,1
48449,начинается,0,0,1,1
39157,отклику,0,0,1,1
39156,வழங்கியது,0,0,1,1
48452,تضر,0,0,1,1
39145,معروف,0,0,1,1
39155,ತೆಗೆದುಕೊಂಡರೆ,0,0,1,1
39154,ಸಾಮಾನ್ಯಕ್ಕಿಂತ,0,0,1,1
39153,remplacé,0,0,1,1
48453,उल्लंघन,0,0,1,1
39152,erbjudande,0,0,1,1
48454,написанием,0,0,1,1
48455,valuation,0,0,1,1
48456,ενοχλητικής,0,0,1,1
39149,destes,0,0,1,1
39148,legibilidade,0,0,1,1
39146,υποτονική,0,0,1,1
48475,simbólicos,0,0,1,1
39125,"
birmanês",0,0,1,1
48511,объявлено,0,0,1,1
48503,dagblad,0,0,1,1
39102,intelectual —,0,0,1,1
48497,ulaştığını,0,0,1,1
39100,decimotercer,0,0,1,1
39099,എന്നതിനെക്കുറിച്ചും,0,0,1,1
39097,medir,0,0,1,1
48499,கலைக்களஞ்சியம்,0,0,1,1
48500,weint,0,0,1,1
39095,kullanılarak,0,0,1,1
39094,courant,0,0,1,1
39092,телефону,0,0,1,1
48502,coopératif »,0,0,1,1
48506,പൂരകസംവിധാനമായി,0,0,1,1
39104,مكرسة,0,0,1,1
39090,damerne,0,0,1,1
39089,الكسل,0,0,1,1
39088,iron,0,0,1,1
39087,niveles,0,0,1,1
39086,رسالتي,0,0,1,1
39085,consultations,0,0,1,1
39084,सीमित,0,0,1,1
39083,പുനരാരംഭിക്കാൻ‌,0,0,1,1
39082,പാദത്തിൽ,0,0,1,1
48508,المتزايد,0,0,1,1
48509,normer,0,0,1,1
48496,கருத்தொருமிப்புப்,0,0,1,1
48495,kurulmuştur,0,0,1,1
39124,dettaförtydliga,0,0,1,1
48484,bois,0,0,1,1
39123,telaffuzumu,0,0,1,1
39122,ρόλους,0,0,1,1
39121,cultivated,0,0,1,1
48478,പരിശീലിക്കാനുള്ള,0,0,1,1
39119,للاستفادة,0,0,1,1
39118,नवीनतम,0,0,1,1
48479,revolution,0,0,1,1
48480,türk,0,0,1,1
39116,specialistische,0,0,1,1
39115,पैमाने,0,0,1,1
48481,musste,0,0,1,1
39113,numéricos,0,0,1,1
39105,شيركي،,0,0,1,1
39112,httpwwwwikipediade,0,0,1,1
48485,പരമാവധി,0,0,1,1
48486,இவற்றோடு,0,0,1,1
39110,seguridad,0,0,1,1
39109,डाउन,0,0,1,1
39108,ojo,0,0,1,1
48489,വിളിക്കാം,0,0,1,1
48491,complémentaires,0,0,1,1
48492,elmaslarla,0,0,1,1
48493,envision,0,0,1,1
48494,tr •,0,0,1,1
39165,açıldı,0,0,1,1
39166,burro,0,0,1,1
39169,playing,0,0,1,1
39221,evrimi,0,0,1,1
48367,പ്രവർത്തിക്കുന്നുണ്ടെങ്കിൽ,0,0,1,1
39229,azb •,0,0,1,1
48368,وقبل,0,0,1,1
48370,വൃദ്ധനായ,0,0,1,1
48371,تغيير,0,0,1,1
48374,typographic,0,0,1,1
39226,comptant,0,0,1,1
48376,ವಾರಾಂತ್ಯದ,0,0,1,1
39224,escritura,0,0,1,1
48377,फ़िक्स,0,0,1,1
48378,поновому»,0,0,1,1
39220,deem,0,0,1,1
39230,ക്യാരക്റ്റർ,0,0,1,1
48379,engelskspråkig,0,0,1,1
39219,έβγαλα,0,0,1,1
48380,läxor,0,0,1,1
48381,планет»,0,0,1,1
48383,σελίδες,0,0,1,1
48385,προτίμησης,0,0,1,1
39215,τυχαίνει,0,0,1,1
48387,штате,0,0,1,1
48389,ನಗುತ್ತಾ,0,0,1,1
48391,ಮಾತನಾಡಬಲ್ಲಿರಾ,0,0,1,1
39211,profite,0,0,1,1
48365,vetting,0,0,1,1
39231,resimlerin,0,0,1,1
48439,اختباري,0,0,1,1
39245,وبدون,0,0,1,1
48348,ಕ್ಷಣದಲ್ಲಿ,0,0,1,1
39254,"
सिलीसियाई",0,0,1,1
39253,ahogarse,0,0,1,1
48349,живём,0,0,1,1
39251,ستستخدمها,0,0,1,1
48350,форма,0,0,1,1
39250,хлебом,0,0,1,1
48351,сбалансированные,0,0,1,1
48353,användargenererat,0,0,1,1
39248,பெரியதும்,0,0,1,1
48354,wait,0,0,1,1
48355,sökningen,0,0,1,1
39233,killing,0,0,1,1
39243,cultureel,0,0,1,1
48358,choses ,0,0,1,1
39242,molestia,0,0,1,1
39241,അനുകൂല,0,0,1,1
39240,slag,0,0,1,1
39239,bulunabilmesi,0,0,1,1
39238,अणुओं,0,0,1,1
39237,malodorante,0,0,1,1
48360,preguntado,0,0,1,1
48363,ചേർക്കുന്നതും,0,0,1,1
39235,gedachtegoed,0,0,1,1
39210,pareciam,0,0,1,1
48392,αυτής,0,0,1,1
48393,focalicen,0,0,1,1
48425,problemáticos,0,0,1,1
48417,உங்களுடைய,0,0,1,1
39187,annorlunda,0,0,1,1
48418,"
आर्मिनियाई",0,0,1,1
48420,ജോലിയുടെ,0,0,1,1
48421,അർഹതയുണ്ടെന്ന്,0,0,1,1
39183,ಅಮೆರಿಕಾದಲ್ಲಿ,0,0,1,1
48422,editar»,0,0,1,1
39181,espirrou,0,0,1,1
48423,inland,0,0,1,1
48424,satirizou,0,0,1,1
39179,திட்டங்கள்,0,0,1,1
48426,zeneca,0,0,1,1
48394,итальянский,0,0,1,1
48429,подойди,0,0,1,1
39176,സ്വതന്ത്രനാണ്,0,0,1,1
48433,assistir,0,0,1,1
39175,présentés,0,0,1,1
48434,enfatizando,0,0,1,1
39174,विकिपिडियन,0,0,1,1
39173,പതിച്ചിരുന്നു,0,0,1,1
39172,entropy,0,0,1,1
39171,demandant,0,0,1,1
48435,التجارب,0,0,1,1
48436,введите,0,0,1,1
48416,softwares,0,0,1,1
39188,finite,0,0,1,1
48413,buggy,0,0,1,1
48412,νοιάζεσαι,0,0,1,1
48396,vitalist,0,0,1,1
39209,robijnrode,0,0,1,1
39207,klarer,0,0,1,1
48399,असत्यापित,0,0,1,1
39205,klickt,0,0,1,1
39204,кэше,0,0,1,1
39203,puedas,0,0,1,1
48400,ശ്രമകരമായിത്തോന്നാം,0,0,1,1
39201,ими,0,0,1,1
39200,zoophilia,0,0,1,1
39199,identifierade,0,0,1,1
48401,referenceværk,0,0,1,1
48402,sløv,0,0,1,1
48403,biografieën,0,0,1,1
48404,diyorlar,0,0,1,1
48406,المشكلات,0,0,1,1
39197,மேலிருந்து,0,0,1,1
39196,longo,0,0,1,1
48408,portuguese,0,0,1,1
48409,photographie,0,0,1,1
48410,sistem,0,0,1,1
39192,wirtschaft,0,0,1,1
39191,amerikanerne,0,0,1,1
39081,रूपों,0,0,1,1
39080,जड़ी,0,0,1,1
48347,المصروفات,0,0,1,1
38958,देंगे।,0,0,1,1
48625,utomstående,0,0,1,1
38966,fühle,0,0,1,1
38965,présidentielles,0,0,1,1
38964,estagnação,0,0,1,1
38963,ഹിന്ദി,0,0,1,1
38962,മധുരമുള്ളതുമായ,0,0,1,1
48628,correcto,0,0,1,1
48629,ஆரம்பமானது,0,0,1,1
48630,подожди,0,0,1,1
38961,seem,0,0,1,1
38959,guiñaron,0,0,1,1
48631,программному,0,0,1,1
38967,klikke,0,0,1,1
48632,semelhanças,0,0,1,1
48633,energiedrank,0,0,1,1
48634,projeye,0,0,1,1
48635,heerlijk,0,0,1,1
38955,pouce,0,0,1,1
38954,sugiriendo,0,0,1,1
48640,करायेगा।,0,0,1,1
48641,பேச்சுப்பக்கத்தைப்,0,0,1,1
38951,вызванной,0,0,1,1
38950,பட்டியல்,0,0,1,1
38949,വാർത്തയിൽ,0,0,1,1
48624,ಮರೆತುಬಿಡುತ್ತಾರೆ,0,0,1,1
38968,​​als,0,0,1,1
38946,ayer,0,0,1,1
38983,démarches,0,0,1,1
38990,அமெரிக்காவில்,0,0,1,1
48603,تواجه,0,0,1,1
38989,assumption,0,0,1,1
38988,redistributing,0,0,1,1
38986,επομένως,0,0,1,1
38985,böyle,0,0,1,1
48605,ifadenin,0,0,1,1
48607,एडिटोरिअल,0,0,1,1
48608,touriste,0,0,1,1
48610,almacén,0,0,1,1
48611,ಮುಸುಕಿನ,0,0,1,1
48613,चाइना,0,0,1,1
48622,confirming,0,0,1,1
38980,disait,0,0,1,1
38978,தட்டச்சு,0,0,1,1
48614,datas,0,0,1,1
48615,sevdiğini,0,0,1,1
38976,ಕಳೆದ,0,0,1,1
38975,kunskap,0,0,1,1
48616,håll,0,0,1,1
48618,activas—,0,0,1,1
38973,milyonlarca,0,0,1,1
38970,नोब्रेनर,0,0,1,1
38969,войны,0,0,1,1
38948,peerreviewed,0,0,1,1
48644,rubinen,0,0,1,1
48513,അസ്വസ്ഥനാകുന്നത്,0,0,1,1
38907,ಕಲಿಯುತ್ತಿದ್ದರೆ,0,0,1,1
38919,называемая,0,0,1,1
48661,«pequeño,0,0,1,1
48662,польском,0,0,1,1
38915,полезно,0,0,1,1
38914,συναντήσει,0,0,1,1
38913,konuklar,0,0,1,1
38912,hemmelighed,0,0,1,1
38911,zorgelijke,0,0,1,1
38910,கட்டுப்பாடுகளைக்,0,0,1,1
38909,proved,0,0,1,1
48664,ativos,0,0,1,1
48666,استخدامه,0,0,1,1
48660,impulsando,0,0,1,1
48668,темам,0,0,1,1
38906,logrado,0,0,1,1
48669,حوادث,0,0,1,1
38904,moldavequoi ,0,0,1,1
38902,ಶಕ್ತಿಯ,0,0,1,1
38901,stemmetone,0,0,1,1
38900,schools,0,0,1,1
48670,rätta,0,0,1,1
38899,प्राप्ति,0,0,1,1
38898,onvoldoende,0,0,1,1
48673,wikimedia ,0,0,1,1
38920,விக்கிப்பீடியாவானது,0,0,1,1
38921,rejecting,0,0,1,1
48646,“பல்நிலை,0,0,1,1
38934,informative,0,0,1,1
48647,σκληρός,0,0,1,1
48648,schienen,0,0,1,1
38942,vikipedistler,0,0,1,1
48650,образовался,0,0,1,1
38940,имел,0,0,1,1
38939,قانون,0,0,1,1
38938,ремонтом,0,0,1,1
38937,slutningen,0,0,1,1
38936,üzülmeyin,0,0,1,1
38935,புத்தகமான,0,0,1,1
48651,tane,0,0,1,1
38933,incompetentes,0,0,1,1
48659,créateurs,0,0,1,1
48653,प्रतिदिन,0,0,1,1
48654,ειδήσεις,0,0,1,1
38932,persoonlijk,0,0,1,1
38928,universele,0,0,1,1
38927,mensualmente,0,0,1,1
38926,ഗുണാങ്കങ്ങൾ,0,0,1,1
48655,ανοικτής,0,0,1,1
48656,நாசீசஸின்,0,0,1,1
38923,இணைப்பாக,0,0,1,1
48657,troca,0,0,1,1
48658,март,0,0,1,1
38991,génome,0,0,1,1
48601,يعتبر,0,0,1,1
48600,നിങ്ങൾക്കറിയാമെങ്കിൽ,0,0,1,1
48548,ഹലോ,0,0,1,1
39057,confundidos,0,0,1,1
48543,κρύο,0,0,1,1
39055,अभियोगपत्र,0,0,1,1
39054,ಉದಾಹರಣೆಯೆಂದರೆ,0,0,1,1
48544,tunisien,0,0,1,1
48546,dördü,0,0,1,1
39053,повторила,0,0,1,1
39052,جعلني,0,0,1,1
39051,självklart,0,0,1,1
39050,supieran,0,0,1,1
39049,verwijst,0,0,1,1
39046,«„википедия“ —,0,0,1,1
48538,verilmez,0,0,1,1
48549,presentan,0,0,1,1
48550,encantada,0,0,1,1
39045,пароль,0,0,1,1
48551,udvise,0,0,1,1
48552,ಟೇಬಲ್,0,0,1,1
39044,özgürlüğüm,0,0,1,1
48554,செல்லத்,0,0,1,1
48555,പദങ്ങളോ,0,0,1,1
39043,température,0,0,1,1
48556,ಯಶಸ್ವಿಯಾದರೆ,0,0,1,1
48557,permitidas,0,0,1,1
48539,ಭಾಷಿಕರು,0,0,1,1
48537,абзацев,0,0,1,1
38992,boede,0,0,1,1
39070,koffie,0,0,1,1
48514,consultables,0,0,1,1
48516,trompent,0,0,1,1
48517,noticia,0,0,1,1
39074,surrounded,0,0,1,1
39073,செல்கிறோம்,0,0,1,1
48518,ஒழுங்குபடுத்தப்பட்டிருக்கும்,0,0,1,1
48519,मांगने,0,0,1,1
48521,geestdriftige,0,0,1,1
39071,ಮಗುವಿಗೆ,0,0,1,1
48522,வழியாக,0,0,1,1
48525,റിക്ക്,0,0,1,1
48526,चिड़िया,0,0,1,1
48536,широкому,0,0,1,1
48527,كاليفورنيا,0,0,1,1
48528,بوضوح,0,0,1,1
39067,hierarchical,0,0,1,1
48530,manteau,0,0,1,1
48531,toparla,0,0,1,1
39065,മറ്റുള്ളവരോട്,0,0,1,1
39064,തടയാറുണ്ട്,0,0,1,1
39062,durabilité,0,0,1,1
39061,எங்கள்,0,0,1,1
48533,पृष्ट,0,0,1,1
48534,convenciones,0,0,1,1
39040,скотт,0,0,1,1
39039,slug,0,0,1,1
48559,ஐ,0,0,1,1
48589,ஆங்கிலச்,0,0,1,1
48583,वास्तविक,0,0,1,1
39013,onions,0,0,1,1
39012,verspreiding,0,0,1,1
48584,descartan,0,0,1,1
48585,ಸಾಲವಾಗಿ,0,0,1,1
48586,βελτιώστε,0,0,1,1
39010,ವಿವರಣಾ,0,0,1,1
48587,கட்டுரையிலும்,0,0,1,1
39008,innovations,0,0,1,1
48588,bardakçı,0,0,1,1
39005,вкладчиков,0,0,1,1
39004,spill,0,0,1,1
48560,गम,0,0,1,1
48590,удачного,0,0,1,1
48592,texter,0,0,1,1
48593,المختلفة,0,0,1,1
39002,mediantid,0,0,1,1
48594,múltiple,0,0,1,1
39000,مئات,0,0,1,1
48596,actualizó,0,0,1,1
38996,तय,0,0,1,1
38995,تسعة,0,0,1,1
38994,batido,0,0,1,1
48597,программы,0,0,1,1
39015,aimeriez,0,0,1,1
39016,hawaii,0,0,1,1
48581,strategisk,0,0,1,1
39019,shell—including,0,0,1,1
39037,« vandalismes »,0,0,1,1
39036,बढ़ेगा,0,0,1,1
39035,oturmak,0,0,1,1
48561,ilginç,0,0,1,1
39034,trampar,0,0,1,1
39033,frivilligt,0,0,1,1
39032,नाक,0,0,1,1
48562,ojämn,0,0,1,1
48566,promotional,0,0,1,1
48567,αγόρασαν,0,0,1,1
48568,विवरण,0,0,1,1
39030,ರೆಸ್ಟೋರೆಂಟ್,0,0,1,1
48573,ലോകം,0,0,1,1
39026,implementations,0,0,1,1
48574,грамматика,0,0,1,1
39023,difíceis,0,0,1,1
48575,högt,0,0,1,1
48576,تطبقه,0,0,1,1
48577,underartiklar,0,0,1,1
39022,ny,0,0,1,1
48579,circulando,0,0,1,1
48580,эразма,0,0,1,1
39020,"
कोमीपेर्मायक",0,0,1,1
39255,сети,0,0,1,1
48346,ಅರಮನೆಯಲ್ಲಿ,0,0,1,1
48015,بالضبط,0,0,1,1
48134,movida,0,0,1,1
48123,സ്വപ്നങ്ങളുടെ,0,0,1,1
48125,مبتسمين,0,0,1,1
48127,زائر،,0,0,1,1
39512,என்பதற்கு,0,0,1,1
48128,καλύτερη,0,0,1,1
39510,произведён,0,0,1,1
39509,logistique,0,0,1,1
39508,åtminstone,0,0,1,1
39507,அணிந்திருந்தார்,0,0,1,1
48130,للتنفس,0,0,1,1
39506,tırnağa,0,0,1,1
39502,affect,0,0,1,1
39515,والكتالونية,0,0,1,1
39501,പറയാമോ,0,0,1,1
39500,पुनः,0,0,1,1
48135,صديقان,0,0,1,1
39498,"हों।
इन",0,0,1,1
39496,نشطة,0,0,1,1
48137,acknowledged,0,0,1,1
48138,select,0,0,1,1
39493,vorschlag,0,0,1,1
39492,fedorenta,0,0,1,1
48139,താനും,0,0,1,1
39491,തികഞ്ഞ,0,0,1,1
48122,مصرفي,0,0,1,1
39516,الإذن,0,0,1,1
48141,അവയിൽ‌,0,0,1,1
48102,позволить,0,0,1,1
39541,хорошего,0,0,1,1
39540,cujos,0,0,1,1
39538,spegeln,0,0,1,1
39537,dedikerede,0,0,1,1
48095,vackra,0,0,1,1
48096,подлог,0,0,1,1
48097,gisteren,0,0,1,1
39535,വായനക്കാരന്റെ,0,0,1,1
39534,cycles,0,0,1,1
48098,tenías,0,0,1,1
48100,parfait,0,0,1,1
39532,féminines,0,0,1,1
39521,панорамы,0,0,1,1
48103,centradas,0,0,1,1
48105,предложениям,0,0,1,1
48107,ventajas,0,0,1,1
39530,कार्यकारी,0,0,1,1
48111,जोनाथन,0,0,1,1
48112,βαρετό,0,0,1,1
39525,tomarse,0,0,1,1
39524,esboços,0,0,1,1
39523,डार्टमाउथ,0,0,1,1
48117,empirique,0,0,1,1
48119,ऑस्ट्रिया,0,0,1,1
48140,registro,0,0,1,1
39488,മോശമായ,0,0,1,1
39448,beroepsschrijvers,0,0,1,1
39458,basarak,0,0,1,1
39467,violents,0,0,1,1
39466,högervinkling,0,0,1,1
48169,ഓർമ്മിക്കുകയും,0,0,1,1
39465,കൃഷിയെപറ്റിയുള്ള,0,0,1,1
39464,എന്ത്,0,0,1,1
39463,внесёнными,0,0,1,1
39462,debía,0,0,1,1
39461,entraînement »,0,0,1,1
39460,الإجتماعيين,0,0,1,1
39459,skillnaden,0,0,1,1
48170,ανακρίβεια,0,0,1,1
48171,ഫോണിൽ,0,0,1,1
48166,ಕೇಳಿದ್ದೇವೆ,0,0,1,1
48172,kurallar,0,0,1,1
48175,ridande,0,0,1,1
39455,يرتكب,0,0,1,1
48176,snowball,0,0,1,1
39454,बोट्स,0,0,1,1
39453,المراجعة,0,0,1,1
48177,yoksa,0,0,1,1
39452,idéalement,0,0,1,1
48178,färdigheter,0,0,1,1
39451,exercício,0,0,1,1
39450,متخصصين،,0,0,1,1
48168,internetencyclopedie,0,0,1,1
48164,deems,0,0,1,1
48142,dini,0,0,1,1
39480,ऊर्जा,0,0,1,1
39487,minuscule,0,0,1,1
39486,inräknade,0,0,1,1
48143,انتهي,0,0,1,1
48145,"
भोजपुरी",0,0,1,1
39485,høfligt,0,0,1,1
39484,பக்கம்,0,0,1,1
39483,السجون,0,0,1,1
39482,nutshell,0,0,1,1
48146,jerarquía,0,0,1,1
48147,väl,0,0,1,1
48151,उदासीन,0,0,1,1
48155,scientist,0,0,1,1
39471,പദ്ധതിയിടുന്നു,0,0,1,1
48156,തടയേണ്ട,0,0,1,1
39478,ಒಬ್ಬರು,0,0,1,1
39477,பட்டியலைப்,0,0,1,1
39476,τουρίστας,0,0,1,1
48157,disposait,0,0,1,1
39473,поставил,0,0,1,1
48159,dégustation,0,0,1,1
48160,നിരന്തരമായ,0,0,1,1
48161,alternativos,0,0,1,1
48162,dyka,0,0,1,1
39472,macrolinguagem,0,0,1,1
39542,திருத்தங்களைக்,0,0,1,1
48091,تدور,0,0,1,1
48090,heterotrophic,0,0,1,1
48036,медалью,0,0,1,1
39603,напиток,0,0,1,1
39602,πολύτιμους,0,0,1,1
48030,hazırsınız,0,0,1,1
48031,springs,0,0,1,1
39600,adlı,0,0,1,1
48033,അമേരിക്കക്കാരനായ,0,0,1,1
48034,subtropicaleréf,0,0,1,1
48035,καφέ,0,0,1,1
39598,tareas,0,0,1,1
39597,convention,0,0,1,1
39596,الواردة,0,0,1,1
39594,विकियात्रा,0,0,1,1
39605,оплачиваемых,0,0,1,1
39593,للتغيير,0,0,1,1
48037,telegramm,0,0,1,1
48040,നിർവഹിക്കാൻ,0,0,1,1
39592,quejas,0,0,1,1
39591,institutions,0,0,1,1
48043,ಉತ್ಸುಕರಾಗಿದ್ದೇವೆ,0,0,1,1
39589,ائتمانًا,0,0,1,1
39588,«wikipedistas»,0,0,1,1
48045,wasser,0,0,1,1
48047,تسأله,0,0,1,1
39586,volontairement,0,0,1,1
39604,அருமையானவை,0,0,1,1
39606,बाद।,0,0,1,1
48088,παρακολούθηση,0,0,1,1
48024,compañero,0,0,1,1
48018,ieee,0,0,1,1
39625,plate,0,0,1,1
39624,«„википедия“,0,0,1,1
48019,المال؟,0,0,1,1
39622,vestimentaire,0,0,1,1
39621,siga,0,0,1,1
39620,لطريقة,0,0,1,1
39619,grammar,0,0,1,1
48021,своим,0,0,1,1
39617,ಸಲಹೆಗಳು,0,0,1,1
48022,ನಂಬಲು,0,0,1,1
39615,øverst,0,0,1,1
39607,sunulmasındaki,0,0,1,1
39614,ಶಬ್ದವಾಗಿದೆ,0,0,1,1
48025,kopieren,0,0,1,1
39613,κατάλαβα,0,0,1,1
48026,participer,0,0,1,1
48027,—no,0,0,1,1
48028,üstteki,0,0,1,1
39611,ചവറും,0,0,1,1
39610,инкубаторе,0,0,1,1
39609,vänstermarginal,0,0,1,1
39608,സമീപനത്തിന്,0,0,1,1
48029,reconheceu,0,0,1,1
39585,wikificere,0,0,1,1
39583,твоя,0,0,1,1
48048,principios,0,0,1,1
39556,homework,0,0,1,1
48072,издаётся,0,0,1,1
39564,ertoe,0,0,1,1
48073,androidenheter,0,0,1,1
39562,ayaklarımı,0,0,1,1
48074,ziyaret,0,0,1,1
48076,രൂപവും,0,0,1,1
48077,«народная,0,0,1,1
39559,programmeur,0,0,1,1
48078,நிறுவனமான,0,0,1,1
39557,सबसेट,0,0,1,1
48079,ತಾಯಿಯಾಗಿದ್ದು,0,0,1,1
48081,блокирование,0,0,1,1
39580,uzmanlık,0,0,1,1
39555,l’occasion,0,0,1,1
48082,urging,0,0,1,1
48083,ಒಳ್ಳೆಯವರಾಗಿದ್ದರು,0,0,1,1
39554,beundrande,0,0,1,1
48084,birleşiminden,0,0,1,1
48085,şerefe,0,0,1,1
48086,വെള്ളപ്പൊക്കം,0,0,1,1
39550,நூலகம்,0,0,1,1
39549,följde,0,0,1,1
39547,негибко,0,0,1,1
39546,backpropagated,0,0,1,1
39566,preparé,0,0,1,1
48070,kaffee,0,0,1,1
39567,studentuppsatser,0,0,1,1
48069,رحلتهم,0,0,1,1
48051,அழ,0,0,1,1
48054,yield,0,0,1,1
48055,constantemente,0,0,1,1
39578,கேட்கிறீர்கள்,0,0,1,1
39577,‘இணைய,0,0,1,1
48056,kk •,0,0,1,1
39576,вещь,0,0,1,1
48057,ಅವನೊಂದಿಗೆ,0,0,1,1
39575,cassés,0,0,1,1
39574,flummoxte,0,0,1,1
48060,بأوسمة,0,0,1,1
48061,ശൈലി,0,0,1,1
39573,confondu,0,0,1,1
48062,settle,0,0,1,1
48063,analyseras,0,0,1,1
39572,система,0,0,1,1
48064,सात,0,0,1,1
39571,verbazingwekkends,0,0,1,1
48065,ഉൾപ്പെടെ,0,0,1,1
48067,excluílas,0,0,1,1
39569,enkelte,0,0,1,1
39568,تلو,0,0,1,1
48068,acción,0,0,1,1
39449,filiations,0,0,1,1
39447,coolen,0,0,1,1
48345,heather,0,0,1,1
48294,ولطيفة,0,0,1,1
48284,حرب,0,0,1,1
48285,الكهولة,0,0,1,1
48286,पायी,0,0,1,1
39324,намерения,0,0,1,1
39323,escolar,0,0,1,1
39322,commentant,0,0,1,1
48289,planejando,0,0,1,1
48291,второе,0,0,1,1
39321,byen,0,0,1,1
48292,ನಿಮ್ಮಂತೆಯೇ,0,0,1,1
39318,dietitian,0,0,1,1
39316,उदास,0,0,1,1
48282,imediatamente,0,0,1,1
48296,செய்துள்ளீர்கள்,0,0,1,1
39314,intimement,0,0,1,1
39313,ಕಲಿಯಲಿದ್ದೇವೆ,0,0,1,1
39312,എഴുതുന്നുണ്ട്,0,0,1,1
48297,pollueur,0,0,1,1
48298,ഏറി,0,0,1,1
39310,originalforskning,0,0,1,1
48299,engendra,0,0,1,1
48300,edelstenen,0,0,1,1
48301,directe,0,0,1,1
48303,formam,0,0,1,1
48283,prévois,0,0,1,1
39328,lasting,0,0,1,1
39306,ناقدة,0,0,1,1
48274,техники,0,0,1,1
48270,மெர்ரி,0,0,1,1
39347,столетия,0,0,1,1
39346,fournie,0,0,1,1
39345,ಸೀನುವಾಗ,0,0,1,1
48271,malintencionadas,0,0,1,1
48272,nævner,0,0,1,1
48273,cdi,0,0,1,1
39343,contacted,0,0,1,1
39342,buydu,0,0,1,1
39341,drogs,0,0,1,1
39340,الخلافات,0,0,1,1
48275,ಹೇಳಿದ್ದೇನೆಂದರೆ,0,0,1,1
39329,обращается,0,0,1,1
48277,bewijst,0,0,1,1
48278,synker,0,0,1,1
39338,люблю,0,0,1,1
48279,исправить,0,0,1,1
39336,vanligen,0,0,1,1
48280,samspel,0,0,1,1
39335,parodi,0,0,1,1
39334,boşum,0,0,1,1
48281,tenían,0,0,1,1
39332,بعضهما,0,0,1,1
39331,எவராலும்,0,0,1,1
39307,televisão,0,0,1,1
39305,varsayalım,0,0,1,1
48181,görebildiğim,0,0,1,1
39267,covering,0,0,1,1
39276,categorisation,0,0,1,1
39275,ಸವಾರಿಯ,0,0,1,1
39274,பிரச்சினைகள்,0,0,1,1
39273,trails,0,0,1,1
48327, millions d,0,0,1,1
48329,astra,0,0,1,1
39270,nyttige,0,0,1,1
48330,hastily,0,0,1,1
48332,statisticians,0,0,1,1
48333,новой,0,0,1,1
39268,സ്ഥാപനമാണ്,0,0,1,1
39266,olmasın,0,0,1,1
39279,compraron,0,0,1,1
48336,mesafede,0,0,1,1
48337,meldden,0,0,1,1
39263,வரவேற்பு,0,0,1,1
48339,autoencoders,0,0,1,1
48340,labs,0,0,1,1
39261,hazırlayıp,0,0,1,1
39260,behalve,0,0,1,1
39259,couramment,0,0,1,1
39257,lignende,0,0,1,1
39256,kelimelerinin,0,0,1,1
48343,ومتوازنًا,0,0,1,1
48322,merkezinde,0,0,1,1
39280,المنزلي,0,0,1,1
39304,ومحركات,0,0,1,1
39294,bio,0,0,1,1
39303,पत्रकारों,0,0,1,1
48306,δώσουμε,0,0,1,1
39302,woordnummer,0,0,1,1
48308,എഴുതുന്നത്‌,0,0,1,1
39298,burnu,0,0,1,1
39297,wordpresscom,0,0,1,1
48310,souris,0,0,1,1
48311,succinctes,0,0,1,1
48312,tiempo—,0,0,1,1
48314,американская,0,0,1,1
48315,şifresini,0,0,1,1
39293,красоты,0,0,1,1
48321,kökü,0,0,1,1
39292,многослойный,0,0,1,1
39291,இவற்றின்,0,0,1,1
39289,emnet,0,0,1,1
39288,மூளை,0,0,1,1
39287,والدة,0,0,1,1
39286,कर।,0,0,1,1
39285,തമാശകളും,0,0,1,1
39284,framtida,0,0,1,1
39283,അമ്പരന്നു,0,0,1,1
48319,கூட்டாக,0,0,1,1
48320,uitgestorven,0,0,1,1
39349,ಅಭ್ಯಾಸ,0,0,1,1
39350,suciedad,0,0,1,1
48268,jahr,0,0,1,1
39419,medlemmarna,0,0,1,1
48212,presidentdirecteur,0,0,1,1
48213,librarianship,0,0,1,1
39425,suchen,0,0,1,1
48215,razones,0,0,1,1
39424,vaticano,0,0,1,1
48216,apaixonadamente,0,0,1,1
48217,حر،,0,0,1,1
39422,constantly,0,0,1,1
48218,ನೋಡಿ,0,0,1,1
48219,மரியனை,0,0,1,1
39421,सेवा,0,0,1,1
39418,содержал,0,0,1,1
39428,ടെസ്റ്റിലെ,0,0,1,1
48220,bulmuştur,0,0,1,1
39417,παρέα,0,0,1,1
39416,पुस्तकें,0,0,1,1
48221,haklarında,0,0,1,1
48224,möjliggjorde,0,0,1,1
48225,emulated,0,0,1,1
48227,ಪಡೆಯುವುದಿಲ್ಲ,0,0,1,1
39410,ресторан,0,0,1,1
39409,പേരുടെ,0,0,1,1
39408,νόημα,0,0,1,1
39407,पिछले,0,0,1,1
48211,tanınıyor,0,0,1,1
48210,gillat,0,0,1,1
39352,reshaped,0,0,1,1
48192,winzigen,0,0,1,1
39446,ഭാഷയുമായി,0,0,1,1
48183,ബന്ധപ്പെടുത്തിയ,0,0,1,1
48184,deviendra,0,0,1,1
48185,internetentreprenören,0,0,1,1
48187,explícitamente,0,0,1,1
48189,träffat,0,0,1,1
39442,broadly,0,0,1,1
48190,schönen,0,0,1,1
39440,cep,0,0,1,1
39439,யூடியூபில்,0,0,1,1
48191,умышленно,0,0,1,1
39437,özrümü,0,0,1,1
48206,бесчисленное,0,0,1,1
48194,kalırsa,0,0,1,1
48195,yaşadığı,0,0,1,1
48197,milliarder,0,0,1,1
39435,buss,0,0,1,1
39434,поживаешь,0,0,1,1
39433,verlagsgesellschaft,0,0,1,1
48200,rike,0,0,1,1
48202,ഞങ്ങളുമായി,0,0,1,1
39432,adverte,0,0,1,1
48204,danés,0,0,1,1
48205,പിടിച്ചില്ലെന്ന്,0,0,1,1
39406,विवाद,0,0,1,1
39405,entregue,0,0,1,1
39404,suitors,0,0,1,1
48260,सवालों,0,0,1,1
48252,sökbar,0,0,1,1
48254,hazırlanırken,0,0,1,1
39374,dediğinizde,0,0,1,1
48256,d’indifférenciation,0,0,1,1
39373,imparcialidad,0,0,1,1
48257,streefde,0,0,1,1
48258,позволяло,0,0,1,1
39370,lapso,0,0,1,1
48259,diskussionssida,0,0,1,1
39368,ох,0,0,1,1
39367,кислоту —,0,0,1,1
48261,femme ,0,0,1,1
39403,abonnere,0,0,1,1
39364,डबल,0,0,1,1
39363,ederseniz,0,0,1,1
48262,semestermånader,0,0,1,1
39361,ingeniero,0,0,1,1
48263,متنوع،,0,0,1,1
48265,poorer,0,0,1,1
39358,уловкой,0,0,1,1
39357,браках,0,0,1,1
39356,ശ്രദ്ധയിൽ,0,0,1,1
39354,fatores,0,0,1,1
39353,പ്രിയപ്പെട്ടവനാണ്,0,0,1,1
48250,freecontent,0,0,1,1
48249,códigos,0,0,1,1
39379,نصها,0,0,1,1
48248,hurtig,0,0,1,1
48229,സ്വപ്നത്തെക്കുറിച്ച്,0,0,1,1
39402,неполными,0,0,1,1
39401,sinemaya,0,0,1,1
39400,ξεκινήσουμε,0,0,1,1
48232,terem,0,0,1,1
48233,великолепного,0,0,1,1
39397,concourent,0,0,1,1
39396,deprived,0,0,1,1
48234,ατρόμητη,0,0,1,1
48235,turned,0,0,1,1
39394,fashion,0,0,1,1
39392,barnstars,0,0,1,1
48237,ήρεμος,0,0,1,1
39390,rangés,0,0,1,1
48238,أصدق,0,0,1,1
39388,ओपन,0,0,1,1
48243,görünmesine,0,0,1,1
39384,douradas,0,0,1,1
39383,gällande,0,0,1,1
39382,заданий,0,0,1,1
48245,സാഹചര്യമാണ്,0,0,1,1
48246,représenter,0,0,1,1
48247,эмпирически,0,0,1,1
38896,yapmadığınız,0,0,1,1
38895,προφέρετε,0,0,1,1
38894,കടിയെടുത്തു,0,0,1,1
49098,exercise,0,0,1,1
49094,καταπληκτικά,0,0,1,1
38408,foods,0,0,1,1
49095,perdu,0,0,1,1
49096,inclusief,0,0,1,1
38406,ಹೇಳದೆ,0,0,1,1
49097,выпуск,0,0,1,1
38405,ಸಿಲುಕಿಕೊಂಡಿದ್ದೀರಿ,0,0,1,1
38403,yakalayıp,0,0,1,1
38402,الذكاء,0,0,1,1
38401,ಇದುವರೆಗೆ,0,0,1,1
38400,മങ്ങിയ,0,0,1,1
38399,இயல்பாக,0,0,1,1
49093,समुच्चय,0,0,1,1
38398,skrivstugor,0,0,1,1
38397,montrer,0,0,1,1
49099,oxfordsystemet,0,0,1,1
38395,википедисты,0,0,1,1
49102,διάφορα,0,0,1,1
38394,बढ़ें,0,0,1,1
49103,يحمل,0,0,1,1
38392,വിക്കിയിൽ,0,0,1,1
38390,lagra,0,0,1,1
38389,μεγαλώσει,0,0,1,1
38387,commons —,0,0,1,1
38409,ചെയ്തെടുക്കുന്നു,0,0,1,1
38411,sunduğu,0,0,1,1
49106,образования,0,0,1,1
49084,kaybettim,0,0,1,1
49072,personalizar,0,0,1,1
49074,medicate,0,0,1,1
49075,yolunu,0,0,1,1
38426,وتساءلوا,0,0,1,1
49077,ईमानदारी,0,0,1,1
49078,وأنواع,0,0,1,1
49080,லிப்ரேவை,0,0,1,1
49083,fluvial,0,0,1,1
38423,manquant,0,0,1,1
38422,basura,0,0,1,1
38421,"
todos",0,0,1,1
38420,d’accident,0,0,1,1
49092,rejeitando,0,0,1,1
38419,anlama,0,0,1,1
38418,groupes,0,0,1,1
49085,ناقصا,0,0,1,1
49086,வடிவம்,0,0,1,1
49087,domestiques,0,0,1,1
38416,entropía,0,0,1,1
49089,rechazó,0,0,1,1
49090,பங்களிப்பையும்,0,0,1,1
38414,reversión,0,0,1,1
38413,cabeça,0,0,1,1
38412,दृश्य,0,0,1,1
38386,miroir,0,0,1,1
38384,εθελοντές,0,0,1,1
38332,salvar,0,0,1,1
38342,ноябрь,0,0,1,1
38355,глубоко,0,0,1,1
38354,संज्ञाओं,0,0,1,1
49131,adoptado,0,0,1,1
38351,cümleler,0,0,1,1
38350,وcebuano،,0,0,1,1
38349,ونأمل,0,0,1,1
38347,gidiyorsa,0,0,1,1
38345,endişelenmeyin,0,0,1,1
49133,النخبوية,0,0,1,1
49134,освещения,0,0,1,1
38343,getrouwd,0,0,1,1
38341,alentar,0,0,1,1
38357,интернетакомм,0,0,1,1
38339,ஒன்றுக்கு,0,0,1,1
38338,الرطبة,0,0,1,1
49135,δουλέψτε,0,0,1,1
38337,الفرعي,0,0,1,1
49136,σμαράγδια,0,0,1,1
49137,maatschappij,0,0,1,1
49138,λεωφορείο,0,0,1,1
49139,ചെയ്യപ്പെടുന്നു,0,0,1,1
49140,தரப்பும்,0,0,1,1
49141,tiver,0,0,1,1
49142,kaydı,0,0,1,1
49127,add,0,0,1,1
38358,ಹಾಳುಮಾಡಿದೆ,0,0,1,1
49107,लिखित,0,0,1,1
38372,மெருகூட்டப்பட்டவராகவும்,0,0,1,1
49108,போகிறதென்றால்,0,0,1,1
38382,sprecher,0,0,1,1
38381,disruptive,0,0,1,1
38379,innovateurs,0,0,1,1
38378,superprotection,0,0,1,1
38377,tightening,0,0,1,1
49109,sırrı,0,0,1,1
49110,तुम्हारे,0,0,1,1
38374,μαθηματικό,0,0,1,1
49111,particuliers,0,0,1,1
38373,läraren,0,0,1,1
49113,pangaea,0,0,1,1
38359,اثني,0,0,1,1
38370,فاجئك,0,0,1,1
38367,erop,0,0,1,1
49117,garagem,0,0,1,1
49118,geboden,0,0,1,1
49119,горничные,0,0,1,1
38363,எதிரான,0,0,1,1
49121,അമ്മയെക്കുറിച്ച്,0,0,1,1
38362,förutsättningarna,0,0,1,1
38361,esams,0,0,1,1
38360,имеющая,0,0,1,1
49122,elaborado,0,0,1,1
49070,मेज,0,0,1,1
38428,parcialidad,0,0,1,1
49069,ومعظم,0,0,1,1
38487,मीट,0,0,1,1
38497,മൂർച്ചയെ,0,0,1,1
38496,pertenece,0,0,1,1
48998,டெர்ரியைப்,0,0,1,1
38495,മറ്റേയാൾ,0,0,1,1
38494,tuin,0,0,1,1
48999,noemde,0,0,1,1
49000,विजित,0,0,1,1
38492,ارتباط,0,0,1,1
38491,doncellas,0,0,1,1
49001,kunsttalen,0,0,1,1
49002,délicates,0,0,1,1
49004,потребность,0,0,1,1
38499,glittrande,0,0,1,1
38484,wonder,0,0,1,1
49006,συνομιλίας,0,0,1,1
38483, mo,0,0,1,1
49007,хороши,0,0,1,1
49008,गैरलाभ,0,0,1,1
49009,ಹೊಳೆಯುವ,0,0,1,1
49011,toxic,0,0,1,1
38478,ξύπνησα,0,0,1,1
38477,ധരിച്ചിട്ടുണ്ടെന്നും,0,0,1,1
49016,ഇന്നുള്ള,0,0,1,1
38476,kandidatexamen,0,0,1,1
38498,genehmigung,0,0,1,1
38500,burocratas,0,0,1,1
49066,davam,0,0,1,1
38512,вышло,0,0,1,1
38520,редактируется,0,0,1,1
38519,ಎಲ್ಲದಕ್ಕೂ,0,0,1,1
38518,μοντέλο,0,0,1,1
48982,europe »,0,0,1,1
48983,διανεμηθεί,0,0,1,1
38517,νωθρός,0,0,1,1
38516,soep,0,0,1,1
48984,मैनर्स,0,0,1,1
48985,ಪರೀಕ್ಷೆಗೆ,0,0,1,1
48987,narciss,0,0,1,1
38513,ശാന്തമാക്കുക,0,0,1,1
38511,للمشروع,0,0,1,1
38502,güney,0,0,1,1
48988,"science ·
ഹൈഡ്രോളജി",0,0,1,1
38510,волновалась,0,0,1,1
38509,älskling,0,0,1,1
38508,philippines,0,0,1,1
48990,plateformes,0,0,1,1
48991,зрения»,0,0,1,1
48993,færre,0,0,1,1
38506,diskussionssidan,0,0,1,1
48994,étape,0,0,1,1
38504,जेन्नी,0,0,1,1
38503,സുഹൃത്തുക്കളോട്,0,0,1,1
38475,وول,0,0,1,1
49017,d’extrapolation,0,0,1,1
38474,definerer,0,0,1,1
49051,dönük,0,0,1,1
49047,പദ്ധതിക്ക്,0,0,1,1
38452,итогов,0,0,1,1
38451,overreported,0,0,1,1
38450,casper,0,0,1,1
38449,സ്വതന്ത്രവിജ്ഞാനകോശം,0,0,1,1
49048,confundes,0,0,1,1
38448,imprimir,0,0,1,1
38447,sueca,0,0,1,1
38445,റഫറൻസുകളുമായി,0,0,1,1
38444,يساهم,0,0,1,1
38443,студент,0,0,1,1
38441,கடைப்பிடிக்கப்படுகிறது,0,0,1,1
49018,определенному,0,0,1,1
49053,populära,0,0,1,1
49054,بسلامة,0,0,1,1
38439,dialects,0,0,1,1
49055,ಹಿಡಿದಿಡಬಹುದೇ,0,0,1,1
49056,சியர்ஸ்,0,0,1,1
49059,employees,0,0,1,1
38435,mühim,0,0,1,1
49063,ഉള്ളൂവെന്നും,0,0,1,1
38434,pete,0,0,1,1
38433,användaridentitet,0,0,1,1
49065,നയിക്കും,0,0,1,1
49046,önümüzdeki,0,0,1,1
38454,erreichte,0,0,1,1
38455,desacreditarlo,0,0,1,1
49043,وثقافة,0,0,1,1
49019,‎ˌwɪkiˈpidiə‏,0,0,1,1
38473,википроектов,0,0,1,1
49020,escucha,0,0,1,1
49021,hediye,0,0,1,1
38470,टेबल,0,0,1,1
38469,opgevangen,0,0,1,1
49026,пропустить,0,0,1,1
49027,aanvullend,0,0,1,1
38468,പുഞ്ചിരിയായിരുന്നു,0,0,1,1
38467,identifiant,0,0,1,1
49030,mönstret,0,0,1,1
38465,இருப்பதாகவும்,0,0,1,1
38464,ಆಹಾರದ,0,0,1,1
38463,ಬೇರುಗಳನ್ನು,0,0,1,1
49035,historikern,0,0,1,1
49036,وسيم,0,0,1,1
38462,εκλεπτυσμένη,0,0,1,1
49037,yalan,0,0,1,1
38460,التهنئة,0,0,1,1
49038,لوح,0,0,1,1
49040,ചിലരാകട്ടെ,0,0,1,1
38459,drunknar,0,0,1,1
38456,dolan,0,0,1,1
49143,ಬೆಳ್ಳಿ,0,0,1,1
49146,basque,0,0,1,1
48674,ಅಲ್ಲವೇ,0,0,1,1
38191,soumis,0,0,1,1
38202,mötesplats,0,0,1,1
38201,mirent,0,0,1,1
49240,ಬಿಸಿಯಾಗಿರುತ್ತದೆ,0,0,1,1
38199,важную,0,0,1,1
38198,« appels »,0,0,1,1
38197,källförteckningen,0,0,1,1
38196,الهائلة,0,0,1,1
38195,culture »,0,0,1,1
38194,തിരിച്ചറിയാൻ,0,0,1,1
49243,ಚಾನಲ್,0,0,1,1
38192,جورنال,0,0,1,1
38190,vereiste,0,0,1,1
49239,değerlendirilir,0,0,1,1
38189,uyuşuk,0,0,1,1
38187,sandım,0,0,1,1
38186,النتيجة,0,0,1,1
38185,källkod,0,0,1,1
38184,udbrød,0,0,1,1
49245,идею,0,0,1,1
38181,पेटेंट,0,0,1,1
38180,ಸುಸೇವ್,0,0,1,1
38178,cavalgada,0,0,1,1
49249,techniek,0,0,1,1
38177,genomineerd,0,0,1,1
38203,​​vraag,0,0,1,1
38205,بروابط,0,0,1,1
38174,سيئًا,0,0,1,1
38222,anónimo,0,0,1,1
38233,repeating,0,0,1,1
49227,कहें,0,0,1,1
49228,niveaux ,0,0,1,1
38231,прачечную,0,0,1,1
38230,réussit,0,0,1,1
49229,editável,0,0,1,1
38228,bekler,0,0,1,1
38227,πες,0,0,1,1
49230,testament,0,0,1,1
38224,прекрасна,0,0,1,1
38223,coletar,0,0,1,1
38221,comprarte,0,0,1,1
49238,redacción,0,0,1,1
49232,queixa,0,0,1,1
38220,uninformed,0,0,1,1
38219,ickevinstinriktade,0,0,1,1
38218,recommandations,0,0,1,1
49233,klaarmaken,0,0,1,1
38216,littéral,0,0,1,1
38213,kalkylprogram,0,0,1,1
38212,illimité,0,0,1,1
38209,इंक,0,0,1,1
49237,ജോലിഭാരം,0,0,1,1
38207,exclusivity,0,0,1,1
38175,ترجمة,0,0,1,1
49253,bird,0,0,1,1
49147,regulate,0,0,1,1
38142,beeldmateriaal,0,0,1,1
38154,técnica,0,0,1,1
38153,klas,0,0,1,1
49270,иными,0,0,1,1
38151,реляционную,0,0,1,1
38150,computerprogramma,0,0,1,1
49273,τονισμό,0,0,1,1
38148,ordnade,0,0,1,1
49274,الجامعات،,0,0,1,1
49275,narzissen,0,0,1,1
38145,നിയമവിരുദ്ധരെ,0,0,1,1
38143,تنسى,0,0,1,1
38141,muscles,0,0,1,1
49269,deselegante,0,0,1,1
38140,damaged,0,0,1,1
38139,calúnia,0,0,1,1
49278,முழுவதுமாகப்,0,0,1,1
49279,مطعم,0,0,1,1
49280,അതിനായി,0,0,1,1
38135,επιθετικό,0,0,1,1
38134,organizadas,0,0,1,1
49282,лицензированная,0,0,1,1
38133,ನೀಡುತ್ತಿದೆ,0,0,1,1
49283,dits,0,0,1,1
38131,ημέρα,0,0,1,1
38155,yazdıklarının,0,0,1,1
38156,κύρια,0,0,1,1
38173,शिक्षा,0,0,1,1
49261,പരസ്പരവിരുദ്ധമായ,0,0,1,1
38172,ampliaría,0,0,1,1
38171,выражая,0,0,1,1
49254,holder,0,0,1,1
49255,bursts,0,0,1,1
38170,പോസിറ്റീവും,0,0,1,1
49256,εκτεθούν,0,0,1,1
49257,ursäkta,0,0,1,1
38169,işlerin,0,0,1,1
49259,nanotechnologies,0,0,1,1
38167,प्रसारण,0,0,1,1
38166,sürümleri,0,0,1,1
49262,sprechersymbol,0,0,1,1
38157,تكشف,0,0,1,1
38165,waterways,0,0,1,1
49263,полная,0,0,1,1
38164,βασίζεται,0,0,1,1
38162,والإندونيسية,0,0,1,1
49264,للتماسك،,0,0,1,1
38161,مرصعة,0,0,1,1
49267,universally,0,0,1,1
38160,golpea,0,0,1,1
49268,फ़ाइलों,0,0,1,1
38159,पहने,0,0,1,1
38158,olagligt,0,0,1,1
38235,takes,0,0,1,1
38237,neatly,0,0,1,1
38238,abriljunio,0,0,1,1
49187,ağlamayı,0,0,1,1
49172,открытость,0,0,1,1
38300,التبرعات,0,0,1,1
49177,മാറുന്നു,0,0,1,1
49178,tartışılır,0,0,1,1
38297,fyr,0,0,1,1
38296,alegam,0,0,1,1
38295,കരച്ചിൽ,0,0,1,1
49183,للحظة,0,0,1,1
49185,söylediğinde,0,0,1,1
38293,mantente,0,0,1,1
49186,snabbare,0,0,1,1
38292,осознание,0,0,1,1
38303,aportar,0,0,1,1
38291,ഹൃദയത്തിലേക്ക്,0,0,1,1
38290,empoderar,0,0,1,1
38289,relational,0,0,1,1
38288,качаешь,0,0,1,1
38287,"
वेल्श",0,0,1,1
49191,portavoz,0,0,1,1
38286,vacilando,0,0,1,1
49192,ilgilenmiyorsan,0,0,1,1
49193,adquirir,0,0,1,1
38284,ബഹിരാകാശം,0,0,1,1
38283,dialectique ,0,0,1,1
38302,டெர்சி,0,0,1,1
49170,baserat,0,0,1,1
38239,दोहराएंगे,0,0,1,1
38316,varié,0,0,1,1
49149,एल,0,0,1,1
38327,അപേക്ഷിച്ച്,0,0,1,1
38326,испанская —,0,0,1,1
49152,drop,0,0,1,1
38322,संज्ञा,0,0,1,1
38321,സംശയത്തിന്,0,0,1,1
38320,функциями,0,0,1,1
49156,எங்காவது,0,0,1,1
38318,ernstige,0,0,1,1
49158,inúmeras,0,0,1,1
49159,επικριθεί,0,0,1,1
38315,fylld,0,0,1,1
49169,udsigt,0,0,1,1
38314,ρωτήθηκε,0,0,1,1
49162,grafo,0,0,1,1
38313,cartas,0,0,1,1
49163,anges,0,0,1,1
38311,residentes,0,0,1,1
49168,ನಿಧಾನಗೊಳಿಸುತ್ತದೆ,0,0,1,1
38310,خطأك,0,0,1,1
38309,जताई।,0,0,1,1
38308,modstridende,0,0,1,1
38307,ಗೊಂಬೆ,0,0,1,1
38306,sloot,0,0,1,1
49194,lesson,0,0,1,1
38281,επινοήθηκε,0,0,1,1
38280,oudengels,0,0,1,1
38250,besøgende,0,0,1,1
49212,برقية,0,0,1,1
38257,adéquat,0,0,1,1
38256,förtal,0,0,1,1
38255,அன்றிலிருந்து,0,0,1,1
49213,मांसके,0,0,1,1
49214,வேலையுடன்,0,0,1,1
38253,microwave,0,0,1,1
38252,علق,0,0,1,1
49215,എന്താണെന്ന്‌,0,0,1,1
38251,संसाधन,0,0,1,1
49219,ഫെബ്രുവരിയിൽ‍,0,0,1,1
38249,പോലീസോ,0,0,1,1
38279,sucinta,0,0,1,1
38248,വിക്കിപീഡിയയ്ക്ക്,0,0,1,1
49220,manipulates,0,0,1,1
38246,afirmando,0,0,1,1
38244,janis,0,0,1,1
38243,ಬಸ್,0,0,1,1
38242,ഗെയിം,0,0,1,1
49221,корневые,0,0,1,1
49222,oil,0,0,1,1
49223,‎wikibidija‏,0,0,1,1
38241,тону,0,0,1,1
38240,"
chinês",0,0,1,1
38258,görmediğinizde,0,0,1,1
49211,seid,0,0,1,1
38259,المعادي,0,0,1,1
49209,التسويف,0,0,1,1
38278,लगेगी।,0,0,1,1
38277,décomptant,0,0,1,1
49197,opère,0,0,1,1
38275,ಚಿಂತಿಸಬೇಡ,0,0,1,1
49200,publiken,0,0,1,1
38274,« é »,0,0,1,1
38273,संपादकीय,0,0,1,1
49201,titta,0,0,1,1
38271,إداريو,0,0,1,1
38270,объекта,0,0,1,1
38269,كيو,0,0,1,1
49203,आते,0,0,1,1
38267,أستراليون,0,0,1,1
49204,множественного,0,0,1,1
38266,கட்டுரைகளான,0,0,1,1
49205,النص,0,0,1,1
38265,encima,0,0,1,1
38264,женщина,0,0,1,1
38263,विफलताओं,0,0,1,1
38262,തരാം,0,0,1,1
38261,huvudstad,0,0,1,1
49206,onzichtbaar,0,0,1,1
49208,tappar,0,0,1,1
38521,δούμε,0,0,1,1
38522,rig,0,0,1,1
38524,estatísticos,0,0,1,1
48775,мужчин,0,0,1,1
38775,tuzu,0,0,1,1
48767,страны,0,0,1,1
38774,bijeenkomst,0,0,1,1
48769,अनुमति।,0,0,1,1
38773,amateurwetenschappers,0,0,1,1
48770,delivers,0,0,1,1
38772,omarbetats,0,0,1,1
48771,ബംഗാളി,0,0,1,1
48772,raciste,0,0,1,1
48773,dragging,0,0,1,1
48774,ಉಲ್ಲೇಖಿಸಿಲ್ಲ,0,0,1,1
48776,deposunda,0,0,1,1
48765,pflanzen,0,0,1,1
48777,بالعربية,0,0,1,1
48778,"
vi",0,0,1,1
48783,meegebracht,0,0,1,1
38767,प्रतिक्रिया,0,0,1,1
48784,முந்தையவை,0,0,1,1
38765,निगरानी,0,0,1,1
38764,новых,0,0,1,1
38763,προγράμματα,0,0,1,1
38762,ദൈവത്തെപ്പോലെ,0,0,1,1
38761,upptäckte,0,0,1,1
38760,nationalities,0,0,1,1
48766,பயன்படுத்தப்பட்டது,0,0,1,1
48764,телеграмму,0,0,1,1
48790,следы,0,0,1,1
38788,متعدد,0,0,1,1
38798,تقطع,0,0,1,1
48743,занимала,0,0,1,1
38796,l’âge,0,0,1,1
38794,افترض,0,0,1,1
38793,narcissen,0,0,1,1
48746,ينسى,0,0,1,1
48748,возьму,0,0,1,1
48749,okunulacak,0,0,1,1
48751,tachonado,0,0,1,1
38790,aka,0,0,1,1
48754,afstemninger,0,0,1,1
38787,cablegate,0,0,1,1
38778,obscenidade,0,0,1,1
48756,அழகையும்,0,0,1,1
38785,accent,0,0,1,1
48757,справочника,0,0,1,1
38784,الأراضي,0,0,1,1
48758,isimli,0,0,1,1
48759,masiva»,0,0,1,1
38781,ಬಂದಿದೆಯೆಂದರೆ,0,0,1,1
38780,favoriniz,0,0,1,1
44070,dvs,0,0,1,1
38779,தேர்வில்,0,0,1,1
48762,integrated,0,0,1,1
48789,gelinliğimi,0,0,1,1
38757,कैसी,0,0,1,1
48980,acceptée,0,0,1,1
48829,популярность,0,0,1,1
38731,स्टोरी,0,0,1,1
38730,لصحيفة,0,0,1,1
48821,escrevem,0,0,1,1
48822,விரும்புவதன்,0,0,1,1
48824,νιώθω,0,0,1,1
38726,നല്കുന്ന,0,0,1,1
38725,للنوم,0,0,1,1
48825,руководствуются,0,0,1,1
48826,ಅಷ್ಟಾಗಿ,0,0,1,1
48827,संगोष्ठी,0,0,1,1
48828,technologically,0,0,1,1
38719,தகுதியானவன்,0,0,1,1
38734,وجهت,0,0,1,1
48831,hauteur,0,0,1,1
38717,législation,0,0,1,1
38716,chiffré,0,0,1,1
38715,जयादा,0,0,1,1
48832,வரிசை’யில்,0,0,1,1
38713,uitgebreider,0,0,1,1
48833,distribuida,0,0,1,1
48834,desordenado,0,0,1,1
38711,llamaba,0,0,1,1
38710,relies,0,0,1,1
48837,असंगतियों,0,0,1,1
38733,​​dette,0,0,1,1
48819,thailand,0,0,1,1
38756,आँसुओं,0,0,1,1
48803,accepteert,0,0,1,1
48792,listou,0,0,1,1
48794,ಹೆಸರನ್ನು,0,0,1,1
48795,фантастические,0,0,1,1
38754,современных,0,0,1,1
48796,тех,0,0,1,1
38753,παραπονεθώ,0,0,1,1
38752,gedroeg,0,0,1,1
48797,deleting,0,0,1,1
48798,vrijers,0,0,1,1
48799,forskere,0,0,1,1
48800,équitable,0,0,1,1
48806,"
letão",0,0,1,1
38735,​​tag,0,0,1,1
48807,विचारविमर्श,0,0,1,1
48809,बेनाम,0,0,1,1
48810,religieuse,0,0,1,1
48811,affirmait,0,0,1,1
48812,становиться,0,0,1,1
38741,"
विकिमीडिया",0,0,1,1
38740,стакан,0,0,1,1
38739,चेहरे,0,0,1,1
48816,accurately,0,0,1,1
48817,तिमाही,0,0,1,1
48818,—aunque,0,0,1,1
38799,abraçar,0,0,1,1
48742,ειδήσεων,0,0,1,1
38801,"
गिलाकी",0,0,1,1
38855,encyclonl,0,0,1,1
38867,ficaria,0,0,1,1
38866,परत,0,0,1,1
48695,amatör,0,0,1,1
48696,مجهودك,0,0,1,1
38864,ಹೊರಟರು,0,0,1,1
48697,المكونات,0,0,1,1
38862,controversés,0,0,1,1
48700,майкл,0,0,1,1
38858,создавать,0,0,1,1
38857,संपदा,0,0,1,1
38856,विज्ञापनपर,0,0,1,1
48705,ήχο,0,0,1,1
48693,ஆய்வாளரின்,0,0,1,1
48706,suck,0,0,1,1
38854,முறையை,0,0,1,1
38853,coréenne,0,0,1,1
38852,تتصدر,0,0,1,1
48707,फुल्का,0,0,1,1
48708,опираться,0,0,1,1
38850,பயணம்,0,0,1,1
48709,administrative,0,0,1,1
38849,schlecht,0,0,1,1
38848,karin,0,0,1,1
38847,fondée,0,0,1,1
48694,söyleyebilirim,0,0,1,1
38869,الذهبية,0,0,1,1
38802,softwareinterface,0,0,1,1
38882,«неудобных»,0,0,1,1
38893,financiers,0,0,1,1
38892,والمتألقة,0,0,1,1
48676,ranches,0,0,1,1
38891,fødder,0,0,1,1
48678,രാജ്യത്തേക്ക്,0,0,1,1
38890,tillhandahålls,0,0,1,1
38888,reconoce,0,0,1,1
48681,وأطلقت,0,0,1,1
38886,ലാഭേച്ഛകൂടാതെ,0,0,1,1
38885,ذوي,0,0,1,1
38884,apelaram,0,0,1,1
38881,realizadas,0,0,1,1
48692,കൂട്ടായ്മയിൽ,0,0,1,1
48683,ofensivas,0,0,1,1
38880,lições,0,0,1,1
48684,réunie,0,0,1,1
48685,forståelig,0,0,1,1
38877,مولاي,0,0,1,1
38876,zweiten,0,0,1,1
48686,சம்பிரதாயத்துக்காக,0,0,1,1
38873,diferença,0,0,1,1
48689,വ്യവസ്ഥിതിയാണ്,0,0,1,1
48690,teorier,0,0,1,1
48691,documentary,0,0,1,1
38846,muddled,0,0,1,1
38845,tags,0,0,1,1
48711,amper,0,0,1,1
38813,поймешь,0,0,1,1
38822,"
estoniano",0,0,1,1
48728,mængde,0,0,1,1
38821,நேரத்திலிருந்து,0,0,1,1
48730,ومثقف,0,0,1,1
38819,ставить,0,0,1,1
48731,katılamadım,0,0,1,1
38817,നടക്കുന്നത്,0,0,1,1
48733,picarde,0,0,1,1
38816,impreso,0,0,1,1
38815,असंगति,0,0,1,1
38814,polyvalente,0,0,1,1
38812,ahí,0,0,1,1
48712,choices,0,0,1,1
48735,defect,0,0,1,1
48736,अशिष्टता,0,0,1,1
38809,acompanha,0,0,1,1
38808,பயனர்களின்,0,0,1,1
48737,υπέρμαχο,0,0,1,1
38806,verständnisvoller,0,0,1,1
48739,responding,0,0,1,1
48740,haces,0,0,1,1
38804,скопирована,0,0,1,1
38803,ವಿವರಿಸುವ,0,0,1,1
48741,роли,0,0,1,1
38823,framgår,0,0,1,1
38824,помахали,0,0,1,1
38825,textonly,0,0,1,1
48727,tricky,0,0,1,1
38843,tomos—,0,0,1,1
48713,aktiviteten,0,0,1,1
48714,японская —,0,0,1,1
48715,travelling,0,0,1,1
38842,succession,0,0,1,1
38841,radiostation,0,0,1,1
38840,initiativet,0,0,1,1
48716,ytterligare,0,0,1,1
38839,söylemesi,0,0,1,1
38838,صوت,0,0,1,1
38837,கொடுங்கள்,0,0,1,1
48718,universelle »,0,0,1,1
38836,உருவாக்கத்திற்கான,0,0,1,1
38834,ವಿಶೇಷವಾಗಿ,0,0,1,1
48719,इनक्यूबेटर,0,0,1,1
38833,إطار,0,0,1,1
48721,आशंका,0,0,1,1
48722,графов,0,0,1,1
38829,ചിലരെ,0,0,1,1
38828,ونرجسية,0,0,1,1
38827,crop,0,0,1,1
48726,उपडोमेन,0,0,1,1
38826,höfliche,0,0,1,1
38709,interagem,0,0,1,1
48838,confusion,0,0,1,1
48839,βιβλία,0,0,1,1
38580,unnecessary,0,0,1,1
38587,какихлибо,0,0,1,1
38586,കണ്ടെത്തുക,0,0,1,1
48932,httpdewikipediaorg,0,0,1,1
38585,pnb •,0,0,1,1
48933,musée,0,0,1,1
38584,поднять,0,0,1,1
38583,editörü,0,0,1,1
48934,smage,0,0,1,1
48935,فيولا,0,0,1,1
38582,முனைப்பான,0,0,1,1
38581,shortening,0,0,1,1
38579,putting,0,0,1,1
38589,κοιμόταν,0,0,1,1
38578,impidiendo,0,0,1,1
48937,uppfattar,0,0,1,1
38575,tiers,0,0,1,1
48938,бьет,0,0,1,1
38573,выйдете,0,0,1,1
48939,demeç,0,0,1,1
38572,hädelse,0,0,1,1
38571,медицинским,0,0,1,1
38570,പദത്തിന്,0,0,1,1
38569,ಸ್ಥಳೀಯ,0,0,1,1
38568,deletionism,0,0,1,1
48931,lembramse,0,0,1,1
48930,கோட்டை,0,0,1,1
38615,tappat,0,0,1,1
38602,антиэлитаризм,0,0,1,1
38613,διοικούνται,0,0,1,1
48912,применялись,0,0,1,1
48914,memnun,0,0,1,1
48916,yeah,0,0,1,1
38609,ಸಂಗತಿಯಿದೆ,0,0,1,1
38608,atıp,0,0,1,1
48917,votar,0,0,1,1
38606,historiska,0,0,1,1
38604,défendent,0,0,1,1
48919,മറയ്‌ക്കാൻ‌,0,0,1,1
38603,അക്ഷരങ്ങളെയും,0,0,1,1
38601,αμερική,0,0,1,1
38590,холодным,0,0,1,1
48920,nådde,0,0,1,1
48921,स्लाइस,0,0,1,1
48922,കുറ്റകരമായ,0,0,1,1
38598,haarlem,0,0,1,1
38597,ubicó,0,0,1,1
48923,integrating,0,0,1,1
48925,d’interprétabilité,0,0,1,1
48927,kredisini,0,0,1,1
38593,"होगी।
ये",0,0,1,1
48929,утонуть,0,0,1,1
38591,parlamentar,0,0,1,1
48940,tidningen,0,0,1,1
48943,klockikonen,0,0,1,1
48944,ഇൻപുട്ടുകൾ,0,0,1,1
38536,बलात्कार,0,0,1,1
48966,للموسوعة,0,0,1,1
48967,صنع,0,0,1,1
48968,பத்து,0,0,1,1
38543,പക്ഷപാതിത്വം,0,0,1,1
48970,triviais,0,0,1,1
38541,behövs,0,0,1,1
48971,robotisées,0,0,1,1
38540,அழைப்பாளருக்கோ,0,0,1,1
48974,центра,0,0,1,1
38538,débats,0,0,1,1
38537,كطباعة,0,0,1,1
48975,outlaw,0,0,1,1
48945,gebeurde,0,0,1,1
38534,ಹುಡುಕುತ್ತಿದ್ದೇವೆ,0,0,1,1
48976,أية,0,0,1,1
38533,geomorphology,0,0,1,1
38532,grusomt,0,0,1,1
48977,حياديتها،,0,0,1,1
38530,påminna,0,0,1,1
38529,udgav,0,0,1,1
38528,ചിത്രങ്ങളും,0,0,1,1
38527,ഉറപ്പായിട്ടും,0,0,1,1
48979,eventuella,0,0,1,1
38526,automatisation,0,0,1,1
48965,നട്ടുപിടിപ്പിക്കാൻ,0,0,1,1
48964,«страница,0,0,1,1
38546,fonctionnent,0,0,1,1
38547,அவதூறான,0,0,1,1
48947,करना।,0,0,1,1
38562,осознать,0,0,1,1
48951,categorize,0,0,1,1
48952,ändamålet,0,0,1,1
38560,مقابلات,0,0,1,1
38559,समविष्टि,0,0,1,1
48953,مشغولاً,0,0,1,1
38557,aralık,0,0,1,1
38556,चीजों,0,0,1,1
38555,سؤالك,0,0,1,1
48955,execute,0,0,1,1
48957,أسألك,0,0,1,1
48958,comestible,0,0,1,1
48959,elbiseyle,0,0,1,1
38553,எட்டு,0,0,1,1
38552,"navnet
",0,0,1,1
48960,इंडीपेनडेंस,0,0,1,1
38551,empirisme,0,0,1,1
48962,ലക്ഷത്തിനടുത്ത്,0,0,1,1
48963,befördert,0,0,1,1
38550,വിവരണം,0,0,1,1
38549,பறவையைப்,0,0,1,1
38548,httpenwikipediaorg,0,0,1,1
48911,frecuente,0,0,1,1
38616,ಸ್ನೇಹಿತರಿಗೆ,0,0,1,1
38708,മാതൃകയിലുള്ള,0,0,1,1
38666,ചിലതിന്,0,0,1,1
38678,traiter,0,0,1,1
38677,barnet,0,0,1,1
48854,दें,0,0,1,1
38676,тематики,0,0,1,1
38675,welt,0,0,1,1
38673,partis,0,0,1,1
48857,ഗ്നൂ,0,0,1,1
38672,подобная,0,0,1,1
38671,movido,0,0,1,1
38670,provision,0,0,1,1
48858,sexton,0,0,1,1
48860,bloquées,0,0,1,1
38680,تتعلم,0,0,1,1
48861,scenes,0,0,1,1
48864,artikelredigering,0,0,1,1
38664,raisonnable »,0,0,1,1
38663,प्राधिकारी,0,0,1,1
38662,قصة,0,0,1,1
48865,إدارتها,0,0,1,1
38661,bryter,0,0,1,1
38660,эпохи,0,0,1,1
48866,серьёзно,0,0,1,1
48867,ಆಶಾದಾಯಕವಾಗಿ,0,0,1,1
48868,ക്ലസ്റ്ററിംഗ്,0,0,1,1
38679,βαρύ,0,0,1,1
38681,relating,0,0,1,1
38617,द्वितीय,0,0,1,1
48845,impulsó,0,0,1,1
38707,ದಣಿದಿದ್ದೀರಾ,0,0,1,1
38706,αστεροειδών,0,0,1,1
38705,प्रकाशनों,0,0,1,1
38704,forlader,0,0,1,1
48841,formais,0,0,1,1
38703,المتمثل,0,0,1,1
38702,kalmasını,0,0,1,1
48842,upphovsrättsdirektivet,0,0,1,1
38701,импактфактор,0,0,1,1
38700,perpetuidad,0,0,1,1
48843,والتحيزات,0,0,1,1
38697,publicitaire,0,0,1,1
38684,செய்முறைப்படி,0,0,1,1
38696,nuttige,0,0,1,1
48847,”the,0,0,1,1
38695,иерархическая,0,0,1,1
48848,журналистов,0,0,1,1
38694,detailed,0,0,1,1
38692,yapılmış,0,0,1,1
38691,സാദ്ധ്യതയുണ്ട്,0,0,1,1
38690,preguiçoso,0,0,1,1
38687,സൗന്ദര്യത്തെയും,0,0,1,1
48852,"दिया।
विकिपीडिया",0,0,1,1
48853,ಗೆಳೆಯ,0,0,1,1
48869,fatih,0,0,1,1
48870,إلا,0,0,1,1
48871,ведомства,0,0,1,1
48904,وسأراكم,0,0,1,1
38634,idari,0,0,1,1
38633,synke,0,0,1,1
48898,பட்டியலூடாக,0,0,1,1
38632,तभी,0,0,1,1
38631,karikatüründe,0,0,1,1
48899,kabuğumun,0,0,1,1
48900,exclusão,0,0,1,1
48901,ശ്രദ്ധപുലർത്തുന്നു,0,0,1,1
48902,hayranlık,0,0,1,1
48903,മാലാഖയെപ്പോലെയാണ്,0,0,1,1
38628,примечательно,0,0,1,1
38626,encontramos,0,0,1,1
38654,attitudes,0,0,1,1
38625,mijlpaal,0,0,1,1
48905,عطس,0,0,1,1
48906,വസ്ത്രങ്ങൾ,0,0,1,1
38622,elegantes,0,0,1,1
38621,push,0,0,1,1
48907,inspirer,0,0,1,1
48908,basée,0,0,1,1
38620,फ्यूचर,0,0,1,1
48909,nonsexual,0,0,1,1
38619,സ്വതന്ത്രമല്ലാത്ത,0,0,1,1
38618,violates,0,0,1,1
48897,norteamericana,0,0,1,1
38635,टुडे,0,0,1,1
38636,مذهولًا,0,0,1,1
48896,« encyclopédie,0,0,1,1
38653,spectroscopy,0,0,1,1
48872,zout,0,0,1,1
38650,cometió,0,0,1,1
38649,हास्यपूर्ण,0,0,1,1
48874,isterse,0,0,1,1
48877,ನೆಚ್ಚಿನದು,0,0,1,1
48880,பள்ளியில்,0,0,1,1
48881,ದೇವದೂತರೊಂದಿಗೆ,0,0,1,1
48882,manned,0,0,1,1
48883,മനസ്സിലായി,0,0,1,1
38646,признать,0,0,1,1
48885,ஒருமுறை,0,0,1,1
48886,गर्म,0,0,1,1
38644,ml •,0,0,1,1
48887,praktijk,0,0,1,1
38642,καναπέ,0,0,1,1
48888,borta,0,0,1,1
48889,india,0,0,1,1
48892,ændrede,0,0,1,1
38640,உசாத்துணைப்,0,0,1,1
48893,görünüyor,0,0,1,1
38639,évaluant,0,0,1,1
38638,وثالث,0,0,1,1
48016,பிரச்சனை,0,0,1,1
39627,வருத்தப்படுகிறீர்கள்,0,0,1,1
41101,доминирующей,0,0,1,1
47169,pointforpoint,0,0,1,1
47159,alternative »,0,0,1,1
47161,nordkorea,0,0,1,1
47162,संकेतबद्ध,0,0,1,1
47164,πρόταση,0,0,1,1
40612,identifiable,0,0,1,1
47165,εγχειρίδια,0,0,1,1
47166,новостях,0,0,1,1
40610,പോലും,0,0,1,1
47167,quitte,0,0,1,1
47168,bitmiş,0,0,1,1
40608,likeknop,0,0,1,1
47171,لنذهب,0,0,1,1
40614,исследователь,0,0,1,1
40606,தூண்டுதலால்,0,0,1,1
40605,السياسة,0,0,1,1
40604,குறுக்கிட்டதற்கு,0,0,1,1
40603,താൽ‌പ്പര്യപ്പെടുന്നെങ്കിൽ‌,0,0,1,1
47173,സൂചിപ്പിക്കുന്ന,0,0,1,1
47174,τρελαθεί,0,0,1,1
47175,وبكلمات,0,0,1,1
40600,matsalen,0,0,1,1
40599,remoção,0,0,1,1
47181,ficticio,0,0,1,1
40598,"
ज़ाज़ाकी",0,0,1,1
47156,précipitations,0,0,1,1
40615,"
क्वैचुआ",0,0,1,1
40595,معاكسة,0,0,1,1
40627,thermal,0,0,1,1
47137,internetföretag,0,0,1,1
40637,கண்ணாடியில்,0,0,1,1
40636,написан,0,0,1,1
40635,встретить,0,0,1,1
40634,latinska,0,0,1,1
40632,verifieras,0,0,1,1
40631,détecter,0,0,1,1
40630,наличием,0,0,1,1
47144,போட்டி,0,0,1,1
47145,அல்லவா,0,0,1,1
40628,توداي,0,0,1,1
47146,ಹೊರತುಪಡಿಸಿ,0,0,1,1
40616,tekstpassages,0,0,1,1
47147,borró,0,0,1,1
40624,pedophilia,0,0,1,1
47148,froid,0,0,1,1
47149,narcismoeder,0,0,1,1
40621,dessin,0,0,1,1
47150,regardait,0,0,1,1
40619,åtta,0,0,1,1
47151,nonprobabilistic,0,0,1,1
47152,penalidades,0,0,1,1
47154,réalités,0,0,1,1
47155,enganado,0,0,1,1
40597,जरूरतों,0,0,1,1
40594,voces,0,0,1,1
47220,mecaniste,0,0,1,1
47209,sosyal,0,0,1,1
40563,introduit,0,0,1,1
47202,motivations,0,0,1,1
40561,beliefs,0,0,1,1
47203,seite,0,0,1,1
40559,året,0,0,1,1
47204,"
लिथुआनियाई",0,0,1,1
40558,bemærke,0,0,1,1
40556,operational,0,0,1,1
47205, milhões,0,0,1,1
40554,fixes,0,0,1,1
40553,копилефтлицензиями,0,0,1,1
47211,والعبارات,0,0,1,1
40565,wann,0,0,1,1
47213,bilgileri,0,0,1,1
40546,criminal,0,0,1,1
40545,fa •,0,0,1,1
40544,മതിയായ,0,0,1,1
47214,ശരിയായി,0,0,1,1
47215,production ,0,0,1,1
40541,سيطرة,0,0,1,1
40540,pojke,0,0,1,1
47216,bröllopsklänning,0,0,1,1
47217,எசுப்பானிய,0,0,1,1
47218,terá,0,0,1,1
47201,удивительной,0,0,1,1
40566,ύπνο,0,0,1,1
47186,εσένα,0,0,1,1
40580,vikipedileri,0,0,1,1
40593,félicitations,0,0,1,1
40592,trait,0,0,1,1
47187,وضعت,0,0,1,1
40591,खिलाफ,0,0,1,1
40589,projetada,0,0,1,1
47191,التنفيذي,0,0,1,1
40587,içeriğe,0,0,1,1
40586,establece,0,0,1,1
47192,ಇಷ್ಟಪಟ್ಟಿದ್ದೀರಿ,0,0,1,1
40584,التحرير،,0,0,1,1
40583,редакторских,0,0,1,1
40579,выглядел,0,0,1,1
40567,சாப்பாட்டு,0,0,1,1
47194,ethnicities,0,0,1,1
40576,disminuir,0,0,1,1
40575,представителя,0,0,1,1
40574,paradigms,0,0,1,1
47196,expressou,0,0,1,1
40573,ஆணியை,0,0,1,1
40572,fria,0,0,1,1
40571,cinquième,0,0,1,1
40570,batalha,0,0,1,1
47197,डालने,0,0,1,1
47200,wikimedia​,0,0,1,1
40639,ಒಪ್ಪಿಕೊಳ್ಳಿ,0,0,1,1
47135,നര്ചിഷ,0,0,1,1
40640,ಬರಲಿದೆ,0,0,1,1
40697,திருத்தங்கள்,0,0,1,1
47078,archipelagos,0,0,1,1
47079,വാഹന,0,0,1,1
47080,großartig,0,0,1,1
40702,kenne,0,0,1,1
47081,eigenen,0,0,1,1
47082,ശ്രദ്ധിക്കുക,0,0,1,1
40701,förslaget,0,0,1,1
40700,кэша,0,0,1,1
40699,suggérait,0,0,1,1
47084,выше,0,0,1,1
40698,postagens,0,0,1,1
40696,പറയാതെ,0,0,1,1
40705,manners,0,0,1,1
40695,assembled,0,0,1,1
40694,യന്ത്രപഠനമാണ്,0,0,1,1
47087,« même,0,0,1,1
40692,vader,0,0,1,1
40691,يحاول,0,0,1,1
40690,søde,0,0,1,1
40689,அழுத்திப்,0,0,1,1
47088,dagligen,0,0,1,1
47089,omfattning,0,0,1,1
47092,عيني,0,0,1,1
40686,yayımlanmış,0,0,1,1
47077,eserler,0,0,1,1
40706,கட்டுரைத்,0,0,1,1
47134,developers,0,0,1,1
40716,umarım,0,0,1,1
40726,concentre,0,0,1,1
47064,طويلًا,0,0,1,1
47065,विघटनकारी,0,0,1,1
40723,définir,0,0,1,1
47066,विस्मयित,0,0,1,1
40721,ervaring,0,0,1,1
40720,ಪೋಯ್ಸ್ಡ್,0,0,1,1
47068,femininas,0,0,1,1
47069,поддающимися,0,0,1,1
47070,расследования,0,0,1,1
47071,counts,0,0,1,1
47073,universeel,0,0,1,1
47076,natuur,0,0,1,1
40715,ಸ್ನೇಹಿತ,0,0,1,1
40714,travail »,0,0,1,1
40713,घुस,0,0,1,1
47074,نستخدم,0,0,1,1
40712,yapamayacak,0,0,1,1
40711,maldonado​,0,0,1,1
40710,غيغابايت,0,0,1,1
47075,അടിസ്ഥാനമാക്കിയാണ്,0,0,1,1
40709,energía,0,0,1,1
40708,gekruist,0,0,1,1
40707,jornalista,0,0,1,1
47094,localidades,0,0,1,1
40685,overemphasis,0,0,1,1
47095,overleden,0,0,1,1
40654,अन्तरजाल,0,0,1,1
47120,affärer,0,0,1,1
40662,отпустила,0,0,1,1
40661,غبي,0,0,1,1
40660,wealth,0,0,1,1
47123,datats,0,0,1,1
47124,kæmpe,0,0,1,1
40659,fejler,0,0,1,1
47125,dificultades,0,0,1,1
47127,ഉപയോഗിച്ചുകൊണ്ട്,0,0,1,1
40656,இதற்கான,0,0,1,1
40655,viennent,0,0,1,1
47129,arctic,0,0,1,1
40684,aposentado,0,0,1,1
40652,угрозами,0,0,1,1
40651,മന്ദഗതിയിലാണ്,0,0,1,1
40650,sinophones,0,0,1,1
47130,التطبيق,0,0,1,1
47132,μη,0,0,1,1
40647,δεδομένου,0,0,1,1
40646,приехал,0,0,1,1
40645,злотых,0,0,1,1
40644,arrive,0,0,1,1
40643,ro,0,0,1,1
40642,предмету,0,0,1,1
40664,കഴിക്കേണ്ടതുണ്ട്,0,0,1,1
40665,புரியாத,0,0,1,1
47118,eyaleti,0,0,1,1
47117,bakıcısı,0,0,1,1
40683,الكوكب,0,0,1,1
47097,نيوبيديا،,0,0,1,1
40681,заказ,0,0,1,1
47099,haveria,0,0,1,1
40679,bilgiyi,0,0,1,1
40678,المنازعات,0,0,1,1
40676,aftes,0,0,1,1
47101,buurt,0,0,1,1
47102,இடம்பெற,0,0,1,1
47104,secrète,0,0,1,1
40675,يتلاعب,0,0,1,1
47107,historik,0,0,1,1
40674,gebruikmaakte,0,0,1,1
40673,മന്ദഗതിയിലാക്കുന്നു,0,0,1,1
47110,mining‏,0,0,1,1
40671,okuldan,0,0,1,1
47112,zelfstandig,0,0,1,1
40670,provet,0,0,1,1
40669,deserved,0,0,1,1
47115,hâlen,0,0,1,1
40668,внутреннего,0,0,1,1
47116,разработанная,0,0,1,1
40667,ർജ്ജ,0,0,1,1
40538,ആഗ്രഹിക്കുന്നതെന്തും,0,0,1,1
40536,seeking,0,0,1,1
40728,داعي,0,0,1,1
47332,probieren,0,0,1,1
40427,தடுக்கவும்,0,0,1,1
47327,تمتد,0,0,1,1
40424,unterhaltung,0,0,1,1
47330,الأمور,0,0,1,1
40422,inseridas,0,0,1,1
40421,мухаммеда,0,0,1,1
47331,βανδαλισμός,0,0,1,1
40420,دائما,0,0,1,1
40419,performansı,0,0,1,1
40418,يسألك,0,0,1,1
40417,простая,0,0,1,1
40416,carrying,0,0,1,1
47322,transformations,0,0,1,1
47333,upphovsrättsbrott,0,0,1,1
40415,favoriet,0,0,1,1
40414,guardaredes,0,0,1,1
40413,concordando,0,0,1,1
40412,الإضافة,0,0,1,1
40411,μιλήσεις,0,0,1,1
47335,വ്യവസ്ഥിതികളുടെയും,0,0,1,1
47337,अधिकतर,0,0,1,1
40407,pekala,0,0,1,1
47339,adotada,0,0,1,1
40406,βικιεπιστήμιο,0,0,1,1
47324,συνέντευξη,0,0,1,1
40429,kuralları,0,0,1,1
47344,« bonnes »,0,0,1,1
47313,velden,0,0,1,1
47304,actuelles,0,0,1,1
40445,historietas,0,0,1,1
47306,lineales,0,0,1,1
47307,—mediante,0,0,1,1
40444,സ്റ്റം‌പൻ‌ഡസിനുപകരം,0,0,1,1
47308,comemora,0,0,1,1
47310,പാർട്ടികളെക്കുറിച്ചുള്ള,0,0,1,1
40443,предвзятость,0,0,1,1
47312,ಮಾಡಿದರೆ,0,0,1,1
40441,lie,0,0,1,1
40440,النظر،,0,0,1,1
40438,achtergelaten,0,0,1,1
40430,الجميع,0,0,1,1
40437,فستان,0,0,1,1
40436,laugh,0,0,1,1
40435,suponga,0,0,1,1
40434,abusive,0,0,1,1
40433,oavsett,0,0,1,1
47316,amerikaanse,0,0,1,1
47318,சாயங்காலம்,0,0,1,1
47319,ಅವನಿಗೆ,0,0,1,1
40432,göremeyeceğimi,0,0,1,1
47320,помимо,0,0,1,1
40431,ಅಲಂಕಾರಿಕ,0,0,1,1
47341,πρόκειται,0,0,1,1
47345,ಆಹ್ಲಾದಕರ,0,0,1,1
47221,मिलन,0,0,1,1
40370,razão,0,0,1,1
40379,läsbarhet,0,0,1,1
40378,slut,0,0,1,1
40377,έχεις,0,0,1,1
47366,hubo,0,0,1,1
47367,exceptionellt,0,0,1,1
40375,olycklig,0,0,1,1
47368,ledigt,0,0,1,1
40373,marrons,0,0,1,1
47369,leckersten,0,0,1,1
47371,പ്ലേറ്റിൽ,0,0,1,1
47372,رسمي,0,0,1,1
47374,såväl,0,0,1,1
47363,нейтральная,0,0,1,1
47375,drukne,0,0,1,1
40367,duimen,0,0,1,1
47377,matthews,0,0,1,1
47380,ومصداقيتها,0,0,1,1
40366,материнарциссе,0,0,1,1
40365,anna,0,0,1,1
47381,irresponsible,0,0,1,1
40363,escuchar,0,0,1,1
40362,manzara,0,0,1,1
47383,repræsenteret,0,0,1,1
47384,onderbreek,0,0,1,1
40380,आर्द्रभूमि,0,0,1,1
40381,ligar,0,0,1,1
40402,estritas,0,0,1,1
47358,reviendra,0,0,1,1
47347,redactores,0,0,1,1
40401,voyager,0,0,1,1
40400,ഒരാളുടെ,0,0,1,1
47348,évoquant,0,0,1,1
47349,फेसबुक,0,0,1,1
47351,updates,0,0,1,1
47352,pugilat,0,0,1,1
40396,karakter,0,0,1,1
40394,വാക്യങ്ങളും,0,0,1,1
40392,ஐகானையும்,0,0,1,1
47357,somehow,0,0,1,1
40391,للحواسيب,0,0,1,1
40382,पकड़ना,0,0,1,1
40390,milhares,0,0,1,1
47359,olmuştur,0,0,1,1
40389,denying,0,0,1,1
47360,gravity,0,0,1,1
40387,الفلبين,0,0,1,1
40386,علي,0,0,1,1
40385,привилегий,0,0,1,1
40384,mücevherler,0,0,1,1
40383,tensor,0,0,1,1
47361,ഉറവിടം,0,0,1,1
47362,ошеломленным,0,0,1,1
40446,விஞ்சி,0,0,1,1
40447,besat,0,0,1,1
47303,പ്ലാനിങ്,0,0,1,1
40503,കണ്ടിട്ടില്ലെന്നാണ്,0,0,1,1
40511,empêchant,0,0,1,1
40510,விக்கிபீடியாவின்,0,0,1,1
47246,മഹായുദ്ധസമയത്ത്,0,0,1,1
40509,concebida,0,0,1,1
40508,estructura,0,0,1,1
40506,அப்பட்டமானதைக்,0,0,1,1
40505,углу,0,0,1,1
47248,गैरलाभकारी,0,0,1,1
47249,ಇಳಿಸಿದರೆ,0,0,1,1
47250,s’avérer,0,0,1,1
47251,maddesinden,0,0,1,1
40502,தூதர்,0,0,1,1
40512,emprestar,0,0,1,1
40501,സൈനികർക്ക്,0,0,1,1
40499,weeks,0,0,1,1
40498,представьте,0,0,1,1
47253,lämnar,0,0,1,1
40497,உலாவியையும்,0,0,1,1
47255,ஒலிக்கிறோம்,0,0,1,1
40495,ಯಾರೋ,0,0,1,1
40493,जनरल,0,0,1,1
40492,öğrendim,0,0,1,1
40491,لموقع,0,0,1,1
40490,രെക്കഗ്നിഷൻ,0,0,1,1
47244,köyde,0,0,1,1
40513,begrip,0,0,1,1
47302,എന്നിവയാണ്,0,0,1,1
47235,மின்னஞ்சலில்,0,0,1,1
47222,appuyez,0,0,1,1
40535,definir,0,0,1,1
40534,ısırık,0,0,1,1
47224,söyleyebileceğinizden,0,0,1,1
40531,укрепить,0,0,1,1
40530,encargado,0,0,1,1
47229,encoded,0,0,1,1
40529,mantuvo,0,0,1,1
40528,വിയോജിക്കുകയും,0,0,1,1
47230,सशक्त,0,0,1,1
47233,exposure,0,0,1,1
40526,synvinkel,0,0,1,1
40514,جعلتها,0,0,1,1
40525,depende,0,0,1,1
40524,l’esprit,0,0,1,1
40523,слышать,0,0,1,1
40522,vann,0,0,1,1
47239,erstaunlicher,0,0,1,1
40520,രണ്ടാം,0,0,1,1
47240,informal,0,0,1,1
47241,ouvrage,0,0,1,1
40517,retrace,0,0,1,1
47243,nonavian,0,0,1,1
40515,بوميس،,0,0,1,1
47257,espagnole,0,0,1,1
40489,ബാങ്കിങ്,0,0,1,1
47259,datagenerating,0,0,1,1
47289,coutumières,0,0,1,1
40466,utilidad,0,0,1,1
40465,lister,0,0,1,1
47282,ನಿಲ್ಲಿಸಿ,0,0,1,1
47284,доступных,0,0,1,1
47285,കുറവുമുള്ളതായി,0,0,1,1
47286,irc,0,0,1,1
40462,найдете,0,0,1,1
40461,confusos,0,0,1,1
40460,ಸುಸ್ತಾಗುವುದಿಲ್ಲ,0,0,1,1
47287,studenters,0,0,1,1
47288,asesino,0,0,1,1
47291,familie,0,0,1,1
47261,landscape,0,0,1,1
40459,بالكسل,0,0,1,1
47293,higherlevel,0,0,1,1
40458,uppmärksammades,0,0,1,1
40457,bienvenidos,0,0,1,1
47294,stemden,0,0,1,1
47296,австрии,0,0,1,1
47297,ತುಂಬಿಸಲು,0,0,1,1
40454,inancıyla,0,0,1,1
47298,காலம்வரை,0,0,1,1
47299,tebrikleri,0,0,1,1
40450,എക്സ്ക്യൂസ്,0,0,1,1
47280,μάθω,0,0,1,1
47279,πόδια,0,0,1,1
40468,aanstootgevend,0,0,1,1
47277,identifie,0,0,1,1
47262,gegaan,0,0,1,1
47263,europeisk,0,0,1,1
47264,zurückwies,0,0,1,1
40484,കണ്ടതിൽ,0,0,1,1
40483,riche,0,0,1,1
47266,لطفاء,0,0,1,1
47267,tanıştığıma,0,0,1,1
47268,चलाया,0,0,1,1
40480,reutilização,0,0,1,1
40479,அவரை,0,0,1,1
47270,александрийской,0,0,1,1
47271,തൂപ്പുകാരുമാണ്,0,0,1,1
40475,الجمهور,0,0,1,1
47272,görünüyorlardı,0,0,1,1
47273,tornarmos,0,0,1,1
40474,telefoongesprek,0,0,1,1
47275,"
क्रोएशियाई",0,0,1,1
40473,ينوي,0,0,1,1
40472,chamou,0,0,1,1
40471,breed,0,0,1,1
40470,ലഭിച്ചത്,0,0,1,1
40469,याचिका,0,0,1,1
47276,δίπλα,0,0,1,1
40727,hoch,0,0,1,1
40729,efficiency,0,0,1,1
48014,yazıyı,0,0,1,1
46846,facteur,0,0,1,1
40989,amatörer,0,0,1,1
46836,நகரும்,0,0,1,1
40988,telgraf,0,0,1,1
46840,χρυσός,0,0,1,1
40986,smaka,0,0,1,1
46842,variadas,0,0,1,1
40984,seguido,0,0,1,1
40983,أرتدي,0,0,1,1
46843,begrijpen,0,0,1,1
40981,°′″n,0,0,1,1
46844,البعض،,0,0,1,1
40977,"
telugu",0,0,1,1
40990,"
तागलोग",0,0,1,1
46847,ആളുണ്ടെന്നർഥം,0,0,1,1
46849,falsedad,0,0,1,1
40975,hjemmesiden,0,0,1,1
40974,sonríe,0,0,1,1
46850,لبعض,0,0,1,1
40973,rob,0,0,1,1
40971,ಮುರಿದುಬಿದ್ದಿದೆ,0,0,1,1
46854,ഒരുപോലെ,0,0,1,1
46855,dol,0,0,1,1
40969,oublient,0,0,1,1
46857,förfrågningar,0,0,1,1
46832,respecter,0,0,1,1
46829,desconcertar,0,0,1,1
46859,estilísticas,0,0,1,1
41001,ವಾಕ್ಯದಲ್ಲಿ,0,0,1,1
46809,hawaiiaans,0,0,1,1
46810,விரல்களில்,0,0,1,1
46811,paralelos,0,0,1,1
41008,görmemişsinizdir,0,0,1,1
46812,útiles,0,0,1,1
46816,adiós,0,0,1,1
41004,أكتوبر,0,0,1,1
46818,الاقتباسات،,0,0,1,1
41003,intentional,0,0,1,1
46819,associações,0,0,1,1
46820,salió,0,0,1,1
41000,своем,0,0,1,1
46828,ಜನರು,0,0,1,1
40999,teaching,0,0,1,1
40998,beland,0,0,1,1
40997,تنوي,0,0,1,1
46821,الربح,0,0,1,1
46822,grecque,0,0,1,1
46823,неделю —,0,0,1,1
46824,отдельный,0,0,1,1
46825,பெண்கள்,0,0,1,1
40994,woordenschat,0,0,1,1
40993,preservar,0,0,1,1
40991,المواد,0,0,1,1
46858,mauvaise,0,0,1,1
46860,എമ്മിൽ,0,0,1,1
46909,adopta,0,0,1,1
40935,എന്തുചെയ്യും,0,0,1,1
40948,ചേരുന്നതും,0,0,1,1
40947,marknadsundersökningsföretag,0,0,1,1
46890,spéciale,0,0,1,1
40944,എന്നതുപോലുള്ള,0,0,1,1
46891,chegaram,0,0,1,1
46892,otomatik,0,0,1,1
40943,δέξου,0,0,1,1
46893,مطلوبة,0,0,1,1
40938,insistant,0,0,1,1
40937,subjectives,0,0,1,1
40936,महाकाव्य,0,0,1,1
40934,deixa,0,0,1,1
46882,voices,0,0,1,1
46896,особо,0,0,1,1
40933,ನೀಡಿ,0,0,1,1
46898,officiële,0,0,1,1
46901,печатного,0,0,1,1
40930,مرتين,0,0,1,1
46904,"
português",0,0,1,1
40928,заявив,0,0,1,1
40927,διεθνής,0,0,1,1
46905,bundan,0,0,1,1
40925,forhåbentlig,0,0,1,1
46906,மந்தமாக்குகிறது,0,0,1,1
46885,காத்திருப்பு,0,0,1,1
46881,ഉച്ചകഴിഞ്ഞ്,0,0,1,1
40967,ഇരിക്കുന്നതായും,0,0,1,1
46871,musées,0,0,1,1
40966,bâtiments,0,0,1,1
46861,undersökningsgruppen,0,0,1,1
40964,rechazada,0,0,1,1
40963,ഭൂരിപക്ഷം,0,0,1,1
40962,compararam,0,0,1,1
46864,ரீதியில்,0,0,1,1
46865,होना।,0,0,1,1
46866,elskede,0,0,1,1
46867,enfados,0,0,1,1
40960,«истории»,0,0,1,1
46870,çıkaracak,0,0,1,1
40958,коллектив,0,0,1,1
40951,سرا,0,0,1,1
46872,d’extrapoler,0,0,1,1
40957,драгоценными,0,0,1,1
40956,produtivos,0,0,1,1
46874,λυπημένη,0,0,1,1
46875,التهجئة،,0,0,1,1
40955,തിരുത്തലുകൾക്കൊടുവിൽ,0,0,1,1
46877,ஆச்சரியமாகக்,0,0,1,1
46878,suscribirse,0,0,1,1
46879,يومًا,0,0,1,1
40954,describir,0,0,1,1
46880,அமைதிப்படுத்திக்,0,0,1,1
41009,tips,0,0,1,1
41010,habían,0,0,1,1
46808,traduit,0,0,1,1
41071,comparación,0,0,1,1
46758,உணர்த்தியது,0,0,1,1
41080,المجلات,0,0,1,1
46759,опытов,0,0,1,1
41079,tornarse,0,0,1,1
41078,esfuerzos,0,0,1,1
41077,കാണില്ലെന്ന്,0,0,1,1
41076,كاثرين,0,0,1,1
41075,proving,0,0,1,1
41074,уме,0,0,1,1
41073,मामलों,0,0,1,1
46760,hobbes,0,0,1,1
41070,உள்ளடக்கப்பட்ட,0,0,1,1
46757,وتعترف,0,0,1,1
41069,गाने,0,0,1,1
41067,ತಲುಪಲು,0,0,1,1
46761,نشأتها,0,0,1,1
46762,respectivamente,0,0,1,1
41065,एजेंसीयों,0,0,1,1
46765,suspicions,0,0,1,1
41063,ಹಸಿವಿನಿಂದ,0,0,1,1
41062,πορεία,0,0,1,1
41061,மிகப்,0,0,1,1
41060,കരച്ചിലും,0,0,1,1
46766,suppressions,0,0,1,1
41081,cortésmente,0,0,1,1
41083,brincam,0,0,1,1
46807,historians,0,0,1,1
41094,separately,0,0,1,1
41100,herşey,0,0,1,1
46741,"
minangkabau",0,0,1,1
41098,britannique,0,0,1,1
46742,மாறிவிட்டாள்,0,0,1,1
46745,президентские,0,0,1,1
41097,लक्ष्य,0,0,1,1
41096,uppdateras,0,0,1,1
41095,restriktioner,0,0,1,1
46747,എന്തുണ്ട്,0,0,1,1
46748,padronizado,0,0,1,1
46749,പാഴ്‌മെയിലാണോയെന്ന്,0,0,1,1
41093,samtal,0,0,1,1
46755,collaborativement,0,0,1,1
46750,descrevendo,0,0,1,1
46751,استئناف,0,0,1,1
41090,förhoppningsvis,0,0,1,1
46752,மாணிக்கங்களில்,0,0,1,1
41089,ಶೀತವಾಗಿದೆ,0,0,1,1
41088,ಬರಾಕ್,0,0,1,1
46753,​​denne,0,0,1,1
41087,تسحب,0,0,1,1
41086,préfère,0,0,1,1
46754,सकूं,0,0,1,1
41085,arrivent,0,0,1,1
41058,engajar,0,0,1,1
46769,undergoing,0,0,1,1
46770,മിനുസമുള്ളതുമാണ്,0,0,1,1
41023,leg,0,0,1,1
41033,saisies,0,0,1,1
46790,എഞ്ചിനിയർ,0,0,1,1
46795,பாடத்தில்,0,0,1,1
41030,”can,0,0,1,1
46796,vi •,0,0,1,1
41028,kızınızın,0,0,1,1
46797,традиционных,0,0,1,1
46799,मीडियाविकी,0,0,1,1
46800,الرحلة,0,0,1,1
41025,നിർമ്മാണപഠന,0,0,1,1
41024,«площадкой»,0,0,1,1
41022,dinle,0,0,1,1
46771,поддерживаемые,0,0,1,1
46802,reemplazada,0,0,1,1
46803,motivera,0,0,1,1
41021,скобок,0,0,1,1
41020,πόλεμο,0,0,1,1
41019,языком,0,0,1,1
41018,தலைமை,0,0,1,1
41017,والإجراءات,0,0,1,1
41016,மாற்றங்களுக்கான,0,0,1,1
41015,coding,0,0,1,1
41012,അവിശ്വസനീയമാംവിധം,0,0,1,1
41011,استخدامًا،,0,0,1,1
41034,سفراء,0,0,1,1
46789,எளிதில்,0,0,1,1
41035,pareces,0,0,1,1
46787,physiques,0,0,1,1
46772,ಮುಳುಗಿಸುವುದು,0,0,1,1
46773,வலை,0,0,1,1
46774,desactualización,0,0,1,1
41052,grine,0,0,1,1
41051,പരിശീലിപ്പിക്കുകയാണെങ്കിൽ,0,0,1,1
41050,அதிர்ச்சியடைந்தாள்,0,0,1,1
41049,उत्साहित,0,0,1,1
46775,എന്നിവർ,0,0,1,1
41047,inanimate,0,0,1,1
46776,தகவல்களின்,0,0,1,1
46777,an ,0,0,1,1
41046,entonación,0,0,1,1
46778,вставлять,0,0,1,1
41044,δικαιοδοσίας,0,0,1,1
41043,principen,0,0,1,1
41042,eqord,0,0,1,1
46779,കാണിച്ചു,0,0,1,1
46780,présidentielle,0,0,1,1
46782,സ്വകാര്യലാഭത്തിനു,0,0,1,1
41039,"
galês",0,0,1,1
46784,ನಾರ್ಸಿಸಾಳನ್ನು,0,0,1,1
46785,هاتفك,0,0,1,1
46786,ಗಣಿತ,0,0,1,1
46907,داخلية,0,0,1,1
46910,suivi »,0,0,1,1
40730,அறிக்கையையும்,0,0,1,1
40792,تسلسلات,0,0,1,1
40801,  imagesk,0,0,1,1
47005,ആധികാരിക,0,0,1,1
47006,वाशिंगटन,0,0,1,1
40799,stellte,0,0,1,1
47007,ആസ്വദിക്കും,0,0,1,1
40797,renaissance,0,0,1,1
47008,débit,0,0,1,1
40795,பரிசைக்,0,0,1,1
40794,വിലയിരുത്തൽ,0,0,1,1
40793,labores,0,0,1,1
47009,оценочный,0,0,1,1
40791,работников,0,0,1,1
47002,modernos,0,0,1,1
40790,fictício,0,0,1,1
40789,lida,0,0,1,1
40788,टी,0,0,1,1
40787,spektrum,0,0,1,1
40786,लगाते,0,0,1,1
40785,неприятную,0,0,1,1
40784,ಬಾಲ್ಕನಿಯಲ್ಲಿ,0,0,1,1
40783,сделана,0,0,1,1
47010,нежелательными,0,0,1,1
47011,चूँकि,0,0,1,1
40781,champion,0,0,1,1
47003,arkivversionen,0,0,1,1
40803,отдельных,0,0,1,1
47014,rot,0,0,1,1
46991,ಅಧಿಕೃತ,0,0,1,1
40828,çorbada,0,0,1,1
40827,acepto,0,0,1,1
40826,selfreplication,0,0,1,1
40825,случаю,0,0,1,1
46983,försumbara,0,0,1,1
40824,légèrement,0,0,1,1
46986,skratta,0,0,1,1
40822,холодно,0,0,1,1
46988,bloquaient,0,0,1,1
46989,absolutely,0,0,1,1
46990,മകളേ,0,0,1,1
40819,självmord,0,0,1,1
47001,fornece,0,0,1,1
40818,गुजरते,0,0,1,1
46993,உருவாக்கி,0,0,1,1
46996,touristiques,0,0,1,1
40812,നല്ലതുപോലെയാണ്,0,0,1,1
40811,പിടിച്ചില്ലേ,0,0,1,1
40810,« liste,0,0,1,1
46998,olduktan,0,0,1,1
46999,ಹುಚ್ಚನಾಗಿದ್ದೇನೆ,0,0,1,1
40808,dividido,0,0,1,1
40807,aire,0,0,1,1
40806,absoluta,0,0,1,1
47012,организацию»,0,0,1,1
40779,aristotle,0,0,1,1
40924,parentes,0,0,1,1
40740,childcare,0,0,1,1
47047,اعتبارا,0,0,1,1
40753,"
tajique",0,0,1,1
40752,பார்வையிட,0,0,1,1
40750,تستغرق,0,0,1,1
47048,கண்ணீருக்கு,0,0,1,1
40748, millions de fichiers,0,0,1,1
40746,"
उदमुर्त",0,0,1,1
47050,участие,0,0,1,1
40743,nez,0,0,1,1
47052,إرباك,0,0,1,1
40741,χρησιμοποιήσεις,0,0,1,1
47057,മീറ്റിംഗിന്,0,0,1,1
40755,तुरंत,0,0,1,1
47059,والصربية,0,0,1,1
47061,saldırıya,0,0,1,1
40739,demostrarse,0,0,1,1
40738,оценок,0,0,1,1
40737,вопросах,0,0,1,1
47062,ned,0,0,1,1
40735,doel,0,0,1,1
40734,предоставлением,0,0,1,1
47063,aconteceu,0,0,1,1
40732,alınmaz,0,0,1,1
40731,ಮೆದುಳನ್ನು,0,0,1,1
47046,قراءة,0,0,1,1
47043,കട്ടിലിൽ,0,0,1,1
47016,بملكية,0,0,1,1
40765,escritor,0,0,1,1
47017,дисперсией,0,0,1,1
40776,வழங்கப்போகிறேன்,0,0,1,1
40775,المشاركون,0,0,1,1
40774,заставило,0,0,1,1
40773,instruções,0,0,1,1
40772,asombrosa,0,0,1,1
47018,facultades,0,0,1,1
40767,tremendos,0,0,1,1
47021,عشوائية,0,0,1,1
47023,ಮಹಾಯುದ್ಧದ,0,0,1,1
47025,cuides,0,0,1,1
40764,dankeschöns,0,0,1,1
47040,asistentes,0,0,1,1
47026,ശ്രദ്ധിക്കൂ,0,0,1,1
40763,quelles,0,0,1,1
40762,yttrandefrihet,0,0,1,1
47027,tradução,0,0,1,1
47028,உட்கார்ந்திருப்பதைப்,0,0,1,1
40759,அதிலிருந்து,0,0,1,1
47033,gelmeyen,0,0,1,1
47034,reviewer,0,0,1,1
40757,constituted,0,0,1,1
47038,season,0,0,1,1
40756,اعترض,0,0,1,1
46982,magiska,0,0,1,1
46980,beheerd,0,0,1,1
46979,സമ്മതിക്കുന്നുവെന്ന്,0,0,1,1
40892,engraçado,0,0,1,1
46930,recebido,0,0,1,1
40901,വാർത്ത,0,0,1,1
46931,entertainment,0,0,1,1
40899,прогнала,0,0,1,1
40898,എന്നറിയുവാൻ,0,0,1,1
40897,mitigation,0,0,1,1
46932,لمحاولات,0,0,1,1
46933,producen,0,0,1,1
46934,onéreusement,0,0,1,1
40895,kerel,0,0,1,1
40894,laissent,0,0,1,1
40891,തീരുമാനിച്ച്,0,0,1,1
46927,partagés,0,0,1,1
40890,paradoxo,0,0,1,1
46936,styrke,0,0,1,1
46937,offrira,0,0,1,1
40887,വിനീതവും,0,0,1,1
40886,découvertes »,0,0,1,1
40885,utvecklingen,0,0,1,1
40883,مشيرة,0,0,1,1
46938,étiquettes,0,0,1,1
40881,приобретала,0,0,1,1
40880,erfaring,0,0,1,1
40879,envió,0,0,1,1
46928,وكلمة,0,0,1,1
40903,सतर्क,0,0,1,1
40829,våren,0,0,1,1
46919,üst,0,0,1,1
40923,censée,0,0,1,1
40922,belgeleme,0,0,1,1
40921,സത്യം,0,0,1,1
40919,précieuses,0,0,1,1
40918,kende,0,0,1,1
46912,vetenskaplig,0,0,1,1
46913,وجه,0,0,1,1
46914,délicieux,0,0,1,1
40914,indkørslen,0,0,1,1
46916,الويكيبيديات،,0,0,1,1
46918,упоминающимся,0,0,1,1
40912,നടത്തുവാൻ,0,0,1,1
46925,graça,0,0,1,1
40911,hará,0,0,1,1
40910,synapses,0,0,1,1
40909,используем,0,0,1,1
46920,വിക്കിപീഡിയരിൽ,0,0,1,1
46921,sterker,0,0,1,1
46922,çocuğa,0,0,1,1
46923,أمره,0,0,1,1
40908,kriteriet,0,0,1,1
40907,comprenez,0,0,1,1
40906,അക്ഷരാർത്ഥത്തിൽ,0,0,1,1
40905,المشرقة,0,0,1,1
40878,interdisciplinary,0,0,1,1
40877,ಹೆದರುತ್ತಿದ್ದೆ,0,0,1,1
46939,братские,0,0,1,1
46965,chimiste,0,0,1,1
40850,complete,0,0,1,1
46959,rechtes,0,0,1,1
46960,நன்றாகத்,0,0,1,1
40848,காப்புரிமை,0,0,1,1
40847,وقانون,0,0,1,1
46961,wikipedia »,0,0,1,1
40846,совместно,0,0,1,1
40845,المطور,0,0,1,1
40844,يبتسم,0,0,1,1
40843,ലഭ്യമല്ലെങ്കിൽ,0,0,1,1
46963,உள்ளீர்கள்,0,0,1,1
40838,ആവേശകരവും,0,0,1,1
40876,convenait,0,0,1,1
40837,gevolgen,0,0,1,1
46970,disculparse,0,0,1,1
40835,opgemerkt,0,0,1,1
46972,digesting,0,0,1,1
46974,icat,0,0,1,1
46975,disfavor,0,0,1,1
46976,circumstances,0,0,1,1
46977,крокером,0,0,1,1
46978,тексты,0,0,1,1
40831,hemsk,0,0,1,1
40830,άλλους,0,0,1,1
40851,ഓളം,0,0,1,1
40852,നിർമ്മിച്ചതാണ്,0,0,1,1
46957,vectors,0,0,1,1
40853,பொறுமையாகவும்,0,0,1,1
40875,συνεχίσεις,0,0,1,1
46943,bloodthirsty,0,0,1,1
46944,pouviez,0,0,1,1
46945,മധ്യമാ‍ർഗത്തിനേ,0,0,1,1
40870,ಗೂಗಲ್‌ಗೆ,0,0,1,1
46946,निर्देशों,0,0,1,1
40868,hoşsunuz,0,0,1,1
40867,பரீட்சைக்கு,0,0,1,1
40866,zorunluluğu,0,0,1,1
40865,réussite,0,0,1,1
40864,énumérées,0,0,1,1
40863,prisoners,0,0,1,1
46947,لدراسة,0,0,1,1
46949,mücadele,0,0,1,1
40861,irgendwie,0,0,1,1
46950,ആഗ്രഹിക്കുന്നത്,0,0,1,1
40860,incrivelmente,0,0,1,1
40859,இவ்விணையப்,0,0,1,1
46952,ценю,0,0,1,1
46953,chemical,0,0,1,1
40857,അഥവാ,0,0,1,1
40856,bijdraagt,0,0,1,1
40855,ಅರ್ಪಿಸಿದ್ದಕ್ಕಾಗಿ,0,0,1,1
47385,répartition,0,0,1,1
40358,functionality,0,0,1,1
40357,пишет,0,0,1,1
39853,announcement,0,0,1,1
39865,heurística,0,0,1,1
39864,videodaki,0,0,1,1
47802,இரு,0,0,1,1
39863,prérogatives,0,0,1,1
39862,resultados​,0,0,1,1
47807,अमृत,0,0,1,1
39859,versus,0,0,1,1
39858,русская —,0,0,1,1
47808,உருவாக்கப்பட்ட,0,0,1,1
47811,δάγκωμα,0,0,1,1
39854,утром,0,0,1,1
39852,visioenen,0,0,1,1
39866,envergure,0,0,1,1
39851,assassination,0,0,1,1
47813,funciona,0,0,1,1
47814,öğrenin,0,0,1,1
39849,lyt,0,0,1,1
39848,பேச்சுவழக்கு,0,0,1,1
39847,sensacional,0,0,1,1
47815,superan,0,0,1,1
39846,κυρίες,0,0,1,1
47816,இப்போதே,0,0,1,1
47817,doctrines,0,0,1,1
47818,imprecisas,0,0,1,1
47801,praktiken,0,0,1,1
47800,ismine,0,0,1,1
47820,shapes,0,0,1,1
47791,alunos,0,0,1,1
47779,aburrido,0,0,1,1
47780,крутятся,0,0,1,1
47781,enteros,0,0,1,1
47782,definitivt,0,0,1,1
47783,potatis,0,0,1,1
39880,солдатам,0,0,1,1
39879,हिसाब,0,0,1,1
47784,അവസാനിച്ചിട്ടില്ല,0,0,1,1
39878,τραπεζιού,0,0,1,1
47789,proje,0,0,1,1
47790,balans,0,0,1,1
47792,طفلي,0,0,1,1
47798,vald,0,0,1,1
39876,studded,0,0,1,1
39875,успех,0,0,1,1
39874,κρατήσουμε,0,0,1,1
39873,കാര്യങ്ങളെല്ലാം,0,0,1,1
39872,siquiera,0,0,1,1
39871,പ്രവർത്തനങ്ങളിൽ,0,0,1,1
47794,biographical,0,0,1,1
47795,interrogación,0,0,1,1
47796,अंगूठा,0,0,1,1
47797,gætter,0,0,1,1
39868,ചെയ്യപ്പെട്ടു,0,0,1,1
47819,محررون,0,0,1,1
47821,landed,0,0,1,1
39803,увидеть,0,0,1,1
47847,chile,0,0,1,1
47840,bugle,0,0,1,1
47841,εξυπηρετούν,0,0,1,1
39818,കോട്ട,0,0,1,1
47842,поисковых,0,0,1,1
39817,ಹಿಡಿಯಲಿಲ್ಲವೇ,0,0,1,1
47843,ζητά,0,0,1,1
39815,ubicación,0,0,1,1
39814,παλάτι,0,0,1,1
47844,verloop,0,0,1,1
47845,यू॰एस॰,0,0,1,1
39812,difamación,0,0,1,1
47849,sparkly,0,0,1,1
47839,apprentissage »,0,0,1,1
47850,acompanhamento,0,0,1,1
39809,concepteurs,0,0,1,1
47852,إنسايدر,0,0,1,1
47853,صحتها،,0,0,1,1
47854,بلغ,0,0,1,1
39807,أخيرًا،,0,0,1,1
47855,എന്തും,0,0,1,1
47856,perda,0,0,1,1
47857,βικιφθέγματα,0,0,1,1
47861,bahsederken,0,0,1,1
39805,ёсики,0,0,1,1
39821,ലഭിക്കും,0,0,1,1
39823,kritiska,0,0,1,1
47822,valet,0,0,1,1
39834,sq •,0,0,1,1
39843,للتكرار,0,0,1,1
39842,avoid,0,0,1,1
39841,«список,0,0,1,1
39840,trouwjurk,0,0,1,1
39839,finish,0,0,1,1
39838,engraved,0,0,1,1
47826,угрожают,0,0,1,1
47827,vraie,0,0,1,1
39836,карьере»,0,0,1,1
47829,भेजते,0,0,1,1
39835,demasiada,0,0,1,1
39833,الأفراد,0,0,1,1
47836,കശ്മീർ,0,0,1,1
47830,düşünmeye,0,0,1,1
39832,sémantiques,0,0,1,1
39830,информацию,0,0,1,1
47832,ಮಾಡಬೇಕಾಗಿದೆ,0,0,1,1
47833,மொழிக்,0,0,1,1
39827,mineral,0,0,1,1
47834,വീഡിയോയിലെ,0,0,1,1
47835,interativa,0,0,1,1
39826,προχώρα,0,0,1,1
39825,specialevenemang,0,0,1,1
39824,parlamentosu,0,0,1,1
39881,ഉപയോഗിക്കാവുന്ന,0,0,1,1
39883,bibliotek,0,0,1,1
39884,ಕಳುಹಿಸಲು,0,0,1,1
39946,canınızı,0,0,1,1
47723,لتسوية,0,0,1,1
39954,ficará,0,0,1,1
39953,ದುರದೃಷ್ಟವಶಾತ್,0,0,1,1
47727,वित्तीय,0,0,1,1
47728,അവയെ,0,0,1,1
39952,ബന്ധത്തെക്കുറിച്ച്,0,0,1,1
47729,vente,0,0,1,1
39951,regularities,0,0,1,1
39950,முன்னதான,0,0,1,1
39949,உள்ளதாகத்,0,0,1,1
39947,உணவகம்,0,0,1,1
39945,frans,0,0,1,1
39958,மனரீதியாகக்,0,0,1,1
47732,viviría,0,0,1,1
47734,«новости»,0,0,1,1
47735,общим,0,0,1,1
47737,ifrågasatts,0,0,1,1
47738,ലഭിക്കുന്ന,0,0,1,1
47739,வழங்கப்பட்டுக்,0,0,1,1
39940,kinesiska,0,0,1,1
47740,системным,0,0,1,1
39938,τεράστια,0,0,1,1
39937,beğenmeyi,0,0,1,1
47741,പണ്ഡിതനും,0,0,1,1
47722,المناسبة،note,0,0,1,1
47721,unterricht,0,0,1,1
39885,உதவிக்குறிப்பை,0,0,1,1
47710,politiques ,0,0,1,1
47701,συστήματα,0,0,1,1
47703,cultiver,0,0,1,1
39981,पाठों,0,0,1,1
39980,cent,0,0,1,1
39979,ವಿಶ್ವವಿದ್ಯಾನಿಲಯಕ್ಕೆ,0,0,1,1
47704,செய்தாலன்றி,0,0,1,1
39977,cobrir,0,0,1,1
47705,millimetre,0,0,1,1
47707,"
coreano",0,0,1,1
47708,الإصدارات،,0,0,1,1
39974,बोलचाल,0,0,1,1
39973,உச்சரிப்பை,0,0,1,1
47719,betecknar,0,0,1,1
47711,instancias,0,0,1,1
47713,hemispheres,0,0,1,1
47714,rivulet,0,0,1,1
39969,отрасли,0,0,1,1
47715,desarrolla,0,0,1,1
39966,வெறித்தனமாக,0,0,1,1
39965,பின்னரே,0,0,1,1
39964,ഇവരും,0,0,1,1
47716,blur,0,0,1,1
47718,emploient ,0,0,1,1
39961,borttaget,0,0,1,1
47744,utvärderade,0,0,1,1
39934,sevimlisin,0,0,1,1
39933,परियोजनाएं,0,0,1,1
39900,soyons,0,0,1,1
47767,yazarı,0,0,1,1
39907,സംബന്ധിച്ചുണ്ടായ,0,0,1,1
47769,reliées,0,0,1,1
39906,voorbij,0,0,1,1
47771,offres,0,0,1,1
39905,expertgenererat,0,0,1,1
39904,“border,0,0,1,1
39903,söta,0,0,1,1
39902,deductief,0,0,1,1
47772,avaliação,0,0,1,1
39901,debris,0,0,1,1
47773,مدخلات,0,0,1,1
39932,ആശ്ചര്യപ്പെടുത്തുന്നതാണ്,0,0,1,1
47774,तरीकों,0,0,1,1
39898,fantastiques,0,0,1,1
39897,génie,0,0,1,1
39896,αποκτήσετε,0,0,1,1
39895,വശമാണ്,0,0,1,1
39894,myxozoa,0,0,1,1
39893,франции,0,0,1,1
39892,ചിയേഴ്സ്,0,0,1,1
39888,बताती,0,0,1,1
39887,reprints,0,0,1,1
39886,editado,0,0,1,1
47764,juridiques,0,0,1,1
47763,välmenade,0,0,1,1
39908,பொருட்படுத்தவில்லை,0,0,1,1
39909,bulunmaktadır,0,0,1,1
47747,βασικούς,0,0,1,1
47748,dispensés,0,0,1,1
47749,وجهات,0,0,1,1
47750,ഇന്റർനെറ്റിൽ,0,0,1,1
39928,பாங்கு,0,0,1,1
47751,വേണമെങ്കിൽ,0,0,1,1
39927,catastrophe,0,0,1,1
47752,högskolestudier,0,0,1,1
39925,yakalayamadıysan,0,0,1,1
39924,plastic,0,0,1,1
39923,απέρριψε,0,0,1,1
39922,സ്വതന്ത്രനാണോ,0,0,1,1
47753,bordssätt,0,0,1,1
39921,cezaevlerinde,0,0,1,1
47754,durable »,0,0,1,1
47755,முடிவுகளில்,0,0,1,1
47758,ναρκίσια,0,0,1,1
47759,förstasidan,0,0,1,1
39916,biblique,0,0,1,1
39913,fint,0,0,1,1
39912,tillstånd,0,0,1,1
39911,والمساهمين,0,0,1,1
47761,ademen,0,0,1,1
39804,أدوات,0,0,1,1
39802,forskningsartiklar,0,0,1,1
47386,മാർഗമാണിത്,0,0,1,1
39676,publicarse,0,0,1,1
39683,desinformar,0,0,1,1
39682,zijd,0,0,1,1
39681,galet,0,0,1,1
47961,പ്രസിദ്ധീകരണാനുമതി,0,0,1,1
39680,уровню,0,0,1,1
39679,developmental,0,0,1,1
47962,സ്രോതസ്സുകളെയും,0,0,1,1
39678,registrado,0,0,1,1
47963,وطريقة,0,0,1,1
47964,exacta,0,0,1,1
47965,boken,0,0,1,1
39675,processing‏,0,0,1,1
47960,discussed,0,0,1,1
47966,génération,0,0,1,1
39674,television—how,0,0,1,1
39673,терминами,0,0,1,1
47967,pasas,0,0,1,1
39671,ajudaria,0,0,1,1
47968,इमारतों,0,0,1,1
39670,സമവായത്തിലൂടെ,0,0,1,1
47970,växla,0,0,1,1
47971,ஒழுங்கமைக்கப்பட்டிருக்கும்,0,0,1,1
47973,മലയാളീകരണമാണ്,0,0,1,1
39667,yapmamız,0,0,1,1
39684,ನೀವೇ,0,0,1,1
39685,hypothétique,0,0,1,1
39665,addresses,0,0,1,1
47951,анализом,0,0,1,1
39710,repair,0,0,1,1
39709,بترتيب,0,0,1,1
39708,போகிறது,0,0,1,1
47943,ಚಿಂತೆಯಿಲ್ಲ,0,0,1,1
47945,παρακολουθώντας,0,0,1,1
39705,contrasted,0,0,1,1
39703,« chaque,0,0,1,1
39702,distinct,0,0,1,1
47947,राज्य,0,0,1,1
47949,efterladt,0,0,1,1
47950,ежегодном,0,0,1,1
47952,shooting,0,0,1,1
39686, milliards,0,0,1,1
47953,intensives,0,0,1,1
47954,scared,0,0,1,1
39697,accredited,0,0,1,1
47955,ಮಾನಸಿಕವಾಗಿ,0,0,1,1
39695,ऑप्टिकल,0,0,1,1
39691,sökmotorer,0,0,1,1
39690,ಜೀವಿಗಳು,0,0,1,1
39689,ostenten,0,0,1,1
47958,φανταστείτε,0,0,1,1
39688,തൂങ്ങുക,0,0,1,1
47959,مقياس,0,0,1,1
39666,toma,0,0,1,1
47977,aménagés,0,0,1,1
39801,obviamente,0,0,1,1
48002,people ,0,0,1,1
47998,войну,0,0,1,1
47999,classifications,0,0,1,1
39643,fylla,0,0,1,1
39642,applicables,0,0,1,1
39641,eronder,0,0,1,1
39640,rannte,0,0,1,1
39639,encantadora,0,0,1,1
39638,ficaram,0,0,1,1
48000,"
पाश्चात्य",0,0,1,1
39637,soumise,0,0,1,1
48001,kutusuna,0,0,1,1
48003,retener,0,0,1,1
39646,petit »,0,0,1,1
48005,कूद,0,0,1,1
39635,"
पीड्मॉण्टी",0,0,1,1
39634,അദ്ദേഹത്തിന്റെ,0,0,1,1
39633,விளக்க,0,0,1,1
48007,കഴിഞ്ഞത്,0,0,1,1
39631,സൗരയൂഥത്തിൽ,0,0,1,1
48008,τρώω,0,0,1,1
48011,discussions etc,0,0,1,1
48012,செய்துவிட்டதாகவும்,0,0,1,1
48013,alışveriş,0,0,1,1
39628,lançamento,0,0,1,1
47997,मल्टिपल,0,0,1,1
39647,عينة,0,0,1,1
39664,parabenizar,0,0,1,1
39656,വേണ്ടത്ര,0,0,1,1
47978,huwelijk,0,0,1,1
47979,вмешивается,0,0,1,1
39662,homonymes,0,0,1,1
47981,friedman,0,0,1,1
47982,ഒരാളെ,0,0,1,1
39661,hepsi,0,0,1,1
39660,weed,0,0,1,1
39659,मुख्यधारा,0,0,1,1
39658,ಅಷ್ಟೇನೂ,0,0,1,1
47983,കർത്തവ്യം,0,0,1,1
39657,விரும்புவதில்லை,0,0,1,1
47984,exceptions—most,0,0,1,1
47996,muttersprachler,0,0,1,1
39655,sizable,0,0,1,1
47986,olhada,0,0,1,1
47990,ശബ്ദമാണ്,0,0,1,1
39652,exposed,0,0,1,1
47991,மொழியில்,0,0,1,1
39650,еде,0,0,1,1
47992,arkadaşı,0,0,1,1
39649,surveiller,0,0,1,1
47994,kontinuerligt,0,0,1,1
47995,blicke,0,0,1,1
39648,ನೀಡೋಣ,0,0,1,1
39711,narsisizm,0,0,1,1
39712,sliep,0,0,1,1
47941,ilustrador,0,0,1,1
47885,hittas,0,0,1,1
47877,തരംതിരിക്കാൻ,0,0,1,1
47879,dağıtılmasına,0,0,1,1
39776,ocensurerade,0,0,1,1
47880,temporarily,0,0,1,1
47881,varsågod,0,0,1,1
39773,ediyordum,0,0,1,1
39772,comprobado,0,0,1,1
39771,microscopic,0,0,1,1
47882,namnrymder,0,0,1,1
47883,kişilerden,0,0,1,1
47884,fortytwo,0,0,1,1
47887,blinkede,0,0,1,1
39781,ರುಚಿ,0,0,1,1
47888,desfazem,0,0,1,1
47889,تتخطى,0,0,1,1
39767,piecewise,0,0,1,1
39766,جرب,0,0,1,1
47891,violés,0,0,1,1
39764,onehalf,0,0,1,1
47894,erronées,0,0,1,1
47895,eklerler,0,0,1,1
39761,ತೊಂದರೆಗೊಳಗಾಗಿದ್ದೇನೆ,0,0,1,1
47897,الفضل,0,0,1,1
39760,выиграла,0,0,1,1
39780,initiales,0,0,1,1
47876,ситуация,0,0,1,1
39715,വിതരണം,0,0,1,1
39791,statistique,0,0,1,1
39800,вскоре,0,0,1,1
47862,gigantesques,0,0,1,1
47865,освещение,0,0,1,1
39797,заблокировать,0,0,1,1
47867,сборы,0,0,1,1
39796,επαναλάβεις,0,0,1,1
39795,constater,0,0,1,1
39794,தொடங்கியது,0,0,1,1
47868,verschijnen,0,0,1,1
39793,оставили,0,0,1,1
39792,stupide,0,0,1,1
47869,embaixo,0,0,1,1
39782,മര്യാദ,0,0,1,1
39789,corrections,0,0,1,1
47870,paraît,0,0,1,1
47871,وانفتاحًا,0,0,1,1
39788,εγκυκλοπαίδειες,0,0,1,1
47872,udenfor,0,0,1,1
39787,بوقاحة,0,0,1,1
39786,ascending,0,0,1,1
39785,entités,0,0,1,1
47873,காட்டாது,0,0,1,1
47874,октябре,0,0,1,1
47875,λίθους,0,0,1,1
47898,hurtige,0,0,1,1
39759,tt •,0,0,1,1
47899,fared,0,0,1,1
47926,ತಪ್ಪಾದ,0,0,1,1
39735,siguiendo,0,0,1,1
47919,werkervaring,0,0,1,1
39734,renseignement,0,0,1,1
47920,substitui,0,0,1,1
39732,satmanı,0,0,1,1
39730,جنولينكس,0,0,1,1
39729,الدروس,0,0,1,1
39728,reaches,0,0,1,1
39727,divisant,0,0,1,1
39726,grubun,0,0,1,1
47922,चक्कर,0,0,1,1
39725,लेखन,0,0,1,1
47900,turísticas,0,0,1,1
39723,estaría,0,0,1,1
47931,bilmiyorsunuz,0,0,1,1
47932,quejan,0,0,1,1
47934,nagel,0,0,1,1
39721,« bon,0,0,1,1
47936,fodre,0,0,1,1
39720,trabalhado,0,0,1,1
47938,происходило,0,0,1,1
39718,വിദ്യാ‍ഭ്യാസത്തിന്റെ,0,0,1,1
39717,большим,0,0,1,1
39716,राजनितिक,0,0,1,1
39736,légitimes,0,0,1,1
47917,durmiendo,0,0,1,1
39737,rockez,0,0,1,1
39738,cruzas,0,0,1,1
39757,والدتي,0,0,1,1
47903,meşguldün,0,0,1,1
39755,войск,0,0,1,1
39754,verdadeiras,0,0,1,1
39753,pub,0,0,1,1
39752,தீர்வில்,0,0,1,1
39751,هاتفية,0,0,1,1
47905,центре,0,0,1,1
39749,atende,0,0,1,1
39748,koblet,0,0,1,1
39747,secondaire,0,0,1,1
47906,ഗെയിമിനെ,0,0,1,1
47907,कॉपीराईट,0,0,1,1
47911,atribuído,0,0,1,1
39746,फैसले,0,0,1,1
47912,regroupe,0,0,1,1
39745,بمراجعة,0,0,1,1
39744,μύτη,0,0,1,1
39743,migrado,0,0,1,1
39742,كمتمم,0,0,1,1
47915,sorundan,0,0,1,1
39740,ಒಳ್ಳೆಯವರಾಗಿರಿ,0,0,1,1
39739,நம்ப,0,0,1,1
39982,أعطى,0,0,1,1
47700,studentens,0,0,1,1
47699,फरवरी,0,0,1,1
47509,"
basco",0,0,1,1
40239,встречаетесь,0,0,1,1
40238,norvégien,0,0,1,1
40237,mids,0,0,1,1
47504,översättningar,0,0,1,1
47505,സ്റ്റാൾമാൻ,0,0,1,1
47506,посещаемых,0,0,1,1
47507,estadístico,0,0,1,1
40235,supprimée,0,0,1,1
40234,αποδείξετε,0,0,1,1
47508,lees,0,0,1,1
40233,рунете —,0,0,1,1
40229,durable,0,0,1,1
47500,പരിഹാരത്തിലായിരിക്കുമ്പോൾ,0,0,1,1
40228,aşar,0,0,1,1
47511,യഥാർത്ഥ,0,0,1,1
40226,सभा,0,0,1,1
40225,antidühring ,0,0,1,1
47512,sorgulanabilir,0,0,1,1
40224,prohíbe,0,0,1,1
40222,consertar,0,0,1,1
47514,لصديقهما,0,0,1,1
40221,തയ്യാറായി,0,0,1,1
47516,élections,0,0,1,1
40220,teklifler,0,0,1,1
47501,интеллектуальным,0,0,1,1
47498,agreed,0,0,1,1
47520,conference,0,0,1,1
40253,içerdiğini,0,0,1,1
47476,നടപ്പിലാക്കാമെന്ന,0,0,1,1
40262,പിറക്കുന്നു,0,0,1,1
47478,"
टोंगीयाई",0,0,1,1
40260,مضى,0,0,1,1
47483,arriba,0,0,1,1
40259,надёжным,0,0,1,1
40258,έτρεξε,0,0,1,1
40257,благодарю,0,0,1,1
40256,दिखायी,0,0,1,1
47484,vandalized,0,0,1,1
40254,ವಿಧಾನವೆಂದರೆ,0,0,1,1
40252,vêlo,0,0,1,1
40242,ευρύ,0,0,1,1
47485,கண்டீர்கள்,0,0,1,1
47486,friare,0,0,1,1
47487,துடிக்கிறது,0,0,1,1
40249,பார்த்தபோது,0,0,1,1
47489,işiniz,0,0,1,1
47490,بمعايير,0,0,1,1
40245,نافياً,0,0,1,1
47496,press,0,0,1,1
47497,supprimer,0,0,1,1
40244,изменила,0,0,1,1
40243,veckor,0,0,1,1
47519,humor,0,0,1,1
47521,администраторам,0,0,1,1
39985,boven,0,0,1,1
47549,meritsystemverktyg,0,0,1,1
47542,தொகுப்பானது,0,0,1,1
47543,oförenligt,0,0,1,1
40190,بي،,0,0,1,1
40189,путешествовала,0,0,1,1
40188,തുടക്കംകുറിച്ചത്,0,0,1,1
47544,collecte,0,0,1,1
47546,pointant,0,0,1,1
40185,прыгну,0,0,1,1
47547,åsikter,0,0,1,1
40183,basıma,0,0,1,1
40182,различного,0,0,1,1
40180,illustrée,0,0,1,1
47540,"
अंतर",0,0,1,1
40179,دليل,0,0,1,1
40178,wikinotícias,0,0,1,1
40177,блестящие,0,0,1,1
40175,antecedência,0,0,1,1
47553,بالنقر,0,0,1,1
47554,ಸಮಸ್ಯೆಯಾಗಿದೆ,0,0,1,1
40172,придерживаются,0,0,1,1
40171,téléphonie,0,0,1,1
40170,μοναδικό,0,0,1,1
40169,pornografía,0,0,1,1
40168,doctorandos,0,0,1,1
47541,catedral,0,0,1,1
47539,hésitant,0,0,1,1
47522,girdiyse,0,0,1,1
47529,betonen,0,0,1,1
40217,vurgulamanın,0,0,1,1
40216,περίμενε,0,0,1,1
40215,текстом,0,0,1,1
47524,അഡ്മിന്മാർ,0,0,1,1
47525,webosbased,0,0,1,1
47526,പ്രദേശത്ത്,0,0,1,1
40213,γυρίζει,0,0,1,1
47527,réduit,0,0,1,1
40211,"
आइसलैण्डी",0,0,1,1
40209,ನೀಡಲಾಗುತ್ತದೆ,0,0,1,1
47528,compañeros,0,0,1,1
40206,arbitraire,0,0,1,1
47538,"
सुन्दा",0,0,1,1
40205,aimait,0,0,1,1
47530,تشكل,0,0,1,1
47533,değiştirmesini,0,0,1,1
40202,nació,0,0,1,1
40201,बिनालाभार्जन,0,0,1,1
40200,написания,0,0,1,1
40199,notified,0,0,1,1
40198,кажется,0,0,1,1
40197,dictionaries,0,0,1,1
47534,ഗംഭീരവുമായ,0,0,1,1
40196,ತಯಾರಿಸಲು,0,0,1,1
47473,നഷ്‌ടപ്പെട്ടു,0,0,1,1
47471,поговорить,0,0,1,1
47470,ويدعو,0,0,1,1
47415,ευχαριστήσετε,0,0,1,1
40334,والعالم،,0,0,1,1
47407,organization—though,0,0,1,1
47408,construit,0,0,1,1
40332,wikibased,0,0,1,1
47409,ilícita,0,0,1,1
40331,المدهشة,0,0,1,1
40330,wunderschön,0,0,1,1
40329,специалистам,0,0,1,1
47410,года —,0,0,1,1
40326,خارجية،,0,0,1,1
47412,الثانية،,0,0,1,1
47416,navigateur,0,0,1,1
40335,apresentou,0,0,1,1
40320,востребованным»,0,0,1,1
40319,редакционном,0,0,1,1
47418,neuronal,0,0,1,1
40318,sitej,0,0,1,1
40317,அர்த்தமாகும்,0,0,1,1
40316,കൂടിക്കാഴ്ചയ്ക്ക്,0,0,1,1
47419,viss,0,0,1,1
40313,interaccionar,0,0,1,1
47422,некорректным,0,0,1,1
47423,σύγχυση,0,0,1,1
47424,فتى,0,0,1,1
47405,intervention ,0,0,1,1
40336,sonar,0,0,1,1
47469,exibir,0,0,1,1
47395,willemalexander,0,0,1,1
40356,prêter,0,0,1,1
47388,veuillez,0,0,1,1
47389,викимедиа» —,0,0,1,1
47391,συγχαρητήρια,0,0,1,1
47392,क्रोकर,0,0,1,1
40352,ഗുണനിലവാരം,0,0,1,1
40351,продуктов,0,0,1,1
40350,apropriado,0,0,1,1
40349,χρησιμότητα,0,0,1,1
40348,—de,0,0,1,1
47394,palm,0,0,1,1
47397,أقدم,0,0,1,1
40337,götürürüm,0,0,1,1
40347,പ്രവർത്തിക്കുന്നില്ലെങ്കിൽ,0,0,1,1
40345,ബട്ടണും,0,0,1,1
40344,freude,0,0,1,1
47398,сестра,0,0,1,1
47399,खुली,0,0,1,1
47400,സമ്പദ്‌വ്യവസ്ഥ,0,0,1,1
47401,закончится,0,0,1,1
47402,kullanabilirler,0,0,1,1
40340,lugna,0,0,1,1
47403,നിഷ്കളങ്കമായി,0,0,1,1
47404,ಇಬ್ಬರಿಗೂ,0,0,1,1
40311,животное,0,0,1,1
47427,nacheinander,0,0,1,1
40309,discouraged,0,0,1,1
47458,djupintervjuer,0,0,1,1
40285,рубиновое,0,0,1,1
40284,गाँव,0,0,1,1
40283,modifiable,0,0,1,1
47448,функций,0,0,1,1
47449,ಒಲವು,0,0,1,1
40279,usualmente,0,0,1,1
47455,करूं,0,0,1,1
40278,jugements,0,0,1,1
47456,прокат,0,0,1,1
40276,இணையக்,0,0,1,1
47457,நிர்வாகிகளினால்,0,0,1,1
47460,exacte,0,0,1,1
40308,dueños,0,0,1,1
47462,mètres,0,0,1,1
40273,säkerhetstjänst,0,0,1,1
47464,vendue,0,0,1,1
47465,progresiva,0,0,1,1
40271,uiteindelijk,0,0,1,1
40270,सिम्बल,0,0,1,1
47466,മേശപ്പുറത്ത്,0,0,1,1
40269,cruelle,0,0,1,1
40268,офисы,0,0,1,1
47467,wikipediawebbgränssnitt,0,0,1,1
40267,медицине,0,0,1,1
40286,especializados,0,0,1,1
40287,воспользуюсь,0,0,1,1
40288,ಹಿಡಿದುಕೊಳ್ಳಿ,0,0,1,1
47446,المجال,0,0,1,1
47428,ലേഖനങ്ങളിലും,0,0,1,1
40307,séparent,0,0,1,1
47429,esclarecido,0,0,1,1
47430,تتجسد,0,0,1,1
40304,yasaklı,0,0,1,1
47431,hatırlatmak,0,0,1,1
40302,informationskällor,0,0,1,1
47434,внешнему,0,0,1,1
40300,"
कॉर्सिकाई",0,0,1,1
47435,daquele,0,0,1,1
47437,يستطع,0,0,1,1
40298,instaladas,0,0,1,1
40297,fungera,0,0,1,1
40296,kısık,0,0,1,1
47441,കിട്ടുന്ന,0,0,1,1
40294,aspects,0,0,1,1
47442,nodes,0,0,1,1
40293,posicionado,0,0,1,1
40292,பயிற்சி,0,0,1,1
40290,ஆவார்,0,0,1,1
47444,هكذا,0,0,1,1
47445,വെബ്സൈറ്റ്,0,0,1,1
40289,نجت,0,0,1,1
47555,ಅವರೊಂದಿಗೆ,0,0,1,1
40167,விதைகளை,0,0,1,1
40166,téléspectateurs,0,0,1,1
40039,प्रवक्ता,0,0,1,1
40047,panne,0,0,1,1
47645,bedraagt,0,0,1,1
47647,സാധ്യമാ‍വുകയുള്ളൂ,0,0,1,1
47648,bandet,0,0,1,1
40045,товарный,0,0,1,1
40044,rape,0,0,1,1
47650,språklänkar,0,0,1,1
40042,casarme,0,0,1,1
47652,qualified,0,0,1,1
40041,wells,0,0,1,1
40040,मॉम,0,0,1,1
40038,விவரிக்கப்,0,0,1,1
47644,measurement,0,0,1,1
47654,possíveis,0,0,1,1
47655,любыми,0,0,1,1
40037,auffahrt,0,0,1,1
40036,законов,0,0,1,1
40035,maître,0,0,1,1
47657,assurent,0,0,1,1
47659,நெடு,0,0,1,1
47660,ಗೊತ್ತು,0,0,1,1
47661,impressionante,0,0,1,1
40033,யோசித்துக்கொண்டிருந்தேன்,0,0,1,1
40032,நிர்வாகிகள்,0,0,1,1
40048,weniger,0,0,1,1
47643,முடிவை,0,0,1,1
40072,beschrijvingsvak,0,0,1,1
40062,τρομερή,0,0,1,1
47628,है।कनाडा,0,0,1,1
40070,стивен,0,0,1,1
47630,കാമുകിയോ,0,0,1,1
47631,destacados,0,0,1,1
40069,ഭ്രാന്തൻ,0,0,1,1
40068,ονειρευόσασταν,0,0,1,1
40067,constituyeron,0,0,1,1
40066,രേഖീയസമവാക്യമായിരിക്കണോ,0,0,1,1
40065,ചെയ്യാമെന്ന്,0,0,1,1
40064,chiffre,0,0,1,1
40063,secrètement,0,0,1,1
40061,tendência,0,0,1,1
47642,glada,0,0,1,1
47633,تتجاهل,0,0,1,1
47634,ಮಹಿಳೆ,0,0,1,1
40058,ತ್ವರಿತ,0,0,1,1
40057,സമ്മതിച്ചാൽ,0,0,1,1
40056,കണ്ടുപിടിക്കലാണ്,0,0,1,1
47635,illustrera,0,0,1,1
40053,தொகுப்பதன்,0,0,1,1
40052,bereiken,0,0,1,1
47638,ഉപയോഗിച്ച,0,0,1,1
47639,dışarıdayken,0,0,1,1
40050,concentrated,0,0,1,1
40031,spirit,0,0,1,1
40030,ಒಪ್ಪುವುದು,0,0,1,1
47664,röd,0,0,1,1
39996,ஐந்து,0,0,1,1
47683,heltäckande,0,0,1,1
47684,राष्ट्रपति,0,0,1,1
47685,moda,0,0,1,1
40003,dozens,0,0,1,1
47686,permitindo,0,0,1,1
40001,bakayım,0,0,1,1
39999,تمضي,0,0,1,1
39998,resourceconsuming,0,0,1,1
47688,uddannede,0,0,1,1
47689,connaître,0,0,1,1
47690,அழகை,0,0,1,1
39995,revelam,0,0,1,1
40029,ചെറുതുള്ളികൾ,0,0,1,1
47691,vogel,0,0,1,1
47692,отведу,0,0,1,1
47693,sentez,0,0,1,1
39992,yazı,0,0,1,1
47694,tonlamayı,0,0,1,1
47695,¿cuáles,0,0,1,1
47696,provocerande,0,0,1,1
39987,abandoned,0,0,1,1
39986,وخوادم,0,0,1,1
47697,صحة,0,0,1,1
47698,doğrultusunda,0,0,1,1
47682,circuits,0,0,1,1
47681,baktığım,0,0,1,1
47680,fatos,0,0,1,1
40008,"
hindi",0,0,1,1
47665,cameron,0,0,1,1
40028,redistribución,0,0,1,1
47667,efendim,0,0,1,1
47668,espuria,0,0,1,1
40024,अचरज,0,0,1,1
47669,generalizados,0,0,1,1
47670,hiermee,0,0,1,1
47671,зданий,0,0,1,1
47672,acudirse,0,0,1,1
40022,utsätts,0,0,1,1
40021,dirt,0,0,1,1
40020,innegociable,0,0,1,1
40019,bulunmuştur,0,0,1,1
47674,« ville,0,0,1,1
47675,tebrik,0,0,1,1
47677,imagen—,0,0,1,1
40015,تدرب,0,0,1,1
47678,efetuou,0,0,1,1
40013,μέσω,0,0,1,1
40012,poleret,0,0,1,1
40011,solutions,0,0,1,1
40010,bachelet,0,0,1,1
47679,മികച്ചതാക്കുക,0,0,1,1
40071,captaste,0,0,1,1
47626,divulgado,0,0,1,1
40165,noticiado,0,0,1,1
47579,പ്രാധാന്യമുണ്ട്,0,0,1,1
40137,wetenschappen,0,0,1,1
47574,energetic,0,0,1,1
40136,живая,0,0,1,1
47575,внезапно,0,0,1,1
47576,priority ,0,0,1,1
40133,soğuk,0,0,1,1
40132,repeated,0,0,1,1
47577,விக்கித்திட்டம்,0,0,1,1
40130,ഉറപ്പാണോ,0,0,1,1
40129,плачете,0,0,1,1
47578,небольшую,0,0,1,1
47580,وغيرت,0,0,1,1
40139,mencionarse,0,0,1,1
47581,satirique,0,0,1,1
40127,உட்கார்ந்திருந்த,0,0,1,1
40126,diyelim,0,0,1,1
40125,ஆகியவையும்,0,0,1,1
47583,तीखे,0,0,1,1
47584,प्रोग्रामिंग,0,0,1,1
47586,sauvages,0,0,1,1
47587,കാര്യനിർവ്വാഹകരെ,0,0,1,1
40118,harsh,0,0,1,1
47588,brudekjole,0,0,1,1
47589,wikiprincipen,0,0,1,1
47571,axis,0,0,1,1
47570,следующих,0,0,1,1
40075,articler,0,0,1,1
47559,برنامجا,0,0,1,1
40164,romaine,0,0,1,1
40163,linking,0,0,1,1
47556,smelly,0,0,1,1
40162,λείπει,0,0,1,1
40161,என்பதைச்,0,0,1,1
40160,الإدارية,0,0,1,1
40159,вирджилом,0,0,1,1
40158,jesucristo,0,0,1,1
47557,الرائع,0,0,1,1
40157,découlent,0,0,1,1
40156,സർവ്വകലാശാലയിൽ,0,0,1,1
40154,consistem,0,0,1,1
40141,compenser »,0,0,1,1
47560,التوفل,0,0,1,1
47561,alternativ,0,0,1,1
47562,ننتقل,0,0,1,1
40149,supportemoi,0,0,1,1
47563,kaynaklarla,0,0,1,1
40147,موقعًا,0,0,1,1
40146,معيبة,0,0,1,1
47565,newer,0,0,1,1
40144,préhistoire,0,0,1,1
47569,गाइडस्टार,0,0,1,1
40142,ಪಡೆದರೆ,0,0,1,1
47590,فوجئت,0,0,1,1
40117,pleure,0,0,1,1
40116,λατινική,0,0,1,1
47620,compréhensive,0,0,1,1
47611,schmutz,0,0,1,1
40095,वेंबेर्गेर,0,0,1,1
40094,வங்கிக்கு,0,0,1,1
40093,മുന്നോട്ടുപോകുക,0,0,1,1
40092,गतिविधियाँ,0,0,1,1
40090,yemeklerden,0,0,1,1
47614,معاملة,0,0,1,1
47616,чувство,0,0,1,1
47617,mote,0,0,1,1
47618,turc,0,0,1,1
40087,lointain,0,0,1,1
40085,वैद्यता,0,0,1,1
47591,loyal,0,0,1,1
47621,asociado,0,0,1,1
40083,amérique,0,0,1,1
40082,metadados,0,0,1,1
40081,« ne,0,0,1,1
40080,accessas,0,0,1,1
47622,لمقطع,0,0,1,1
40079,формы,0,0,1,1
40078,ಭಾವಿಸಬಹುದು,0,0,1,1
47623,introduces,0,0,1,1
47625,घोंघे,0,0,1,1
40076,മായ്ച്ചുകളയുന്നതും,0,0,1,1
47610,anlayışlı,0,0,1,1
47609,veritabanından,0,0,1,1
47608,चिन्हित,0,0,1,1
47606,قفل,0,0,1,1
40115,നാണ്‌,0,0,1,1
47592,hoparlör,0,0,1,1
40114,likheter,0,0,1,1
40113,ആവുന്നതിനു,0,0,1,1
47595,അന്നുകണ്ട,0,0,1,1
47596,لصدفة,0,0,1,1
47597,pueblo,0,0,1,1
40111,towards,0,0,1,1
47598,journey,0,0,1,1
40110,emulados,0,0,1,1
40109,കടന്നുപോകാം,0,0,1,1
40108,त्वरित,0,0,1,1
47599,diecisiete,0,0,1,1
40107,திரைப்படங்கள்,0,0,1,1
40106,शेयर,0,0,1,1
40105,"
estamos",0,0,1,1
40104,носящего,0,0,1,1
40103,liberty,0,0,1,1
47602,luck,0,0,1,1
40101,conectados,0,0,1,1
47603,conheço,0,0,1,1
40100,endişeye,0,0,1,1
40099,കുലുങ്ങുന്നു,0,0,1,1
44326,ध्वजांकित,0,0,1,1
26352,fomenta,0,0,1,1
33549,grandissante,0,0,1,1
13595,sinnet,0,0,1,1
13597,recherche ,0,0,1,1
13598,levende,0,0,1,1
13599,optimize,0,0,1,1
13601,ağlıyorsun,0,0,1,1
13603,äktenskap,0,0,1,1
13604,​​​​,0,0,1,1
13606,impresión,0,0,1,1
13607,anställa,0,0,1,1
13609,لvice,0,0,1,1
13611,rápida,0,0,1,1
13613,χωριό,0,0,1,1
13614,बाहरी,0,0,1,1
13616,സുന്ദരനായിരുന്നു,0,0,1,1
13617,शूट,0,0,1,1
13618,модные,0,0,1,1
13596,γειά,0,0,1,1
13594,sebeple,0,0,1,1
13559,documentos,0,0,1,1
13592,fivethirtyeight,0,0,1,1
13563,captó,0,0,1,1
13564,सलेक्ट,0,0,1,1
13565,отвергла,0,0,1,1
13566,identidad,0,0,1,1
13568,പ്രാപ്തിയാക്കുകയും,0,0,1,1
13570,кино,0,0,1,1
13571,χαρείτε,0,0,1,1
13573,بنهاية,0,0,1,1
13574,ligt,0,0,1,1
13578,ഉപജ്ഞാതാവ്,0,0,1,1
13579,bias–variance,0,0,1,1
13580,பஸ்,0,0,1,1
13586,rechten,0,0,1,1
13589,التصدي,0,0,1,1
13591,أخافت,0,0,1,1
13619,huil,0,0,1,1
13620,uzmanların,0,0,1,1
13621,ವಿಷಯವಲ್ಲ,0,0,1,1
13622,விளம்பரங்களின்,0,0,1,1
13656,സാമുവൽ,0,0,1,1
13658,"





o
n
i
o
n
s

p
o
t
a
t
o
e
s


⇒


b
u
r
g
e
r




displaystyle",0,0,1,1
13659,evner,0,0,1,1
13660,días—,0,0,1,1
13663,bilmiyorsun,0,0,1,1
13666,സന്തോഷ,0,0,1,1
13668,வந்தாள்,0,0,1,1
13669,честно,0,0,1,1
13670,ಉಪ್ಪು,0,0,1,1
13671,violado,0,0,1,1
13673,സുഹൃത്തുക്കളും,0,0,1,1
13674,tarefas,0,0,1,1
13676,βλέπεις,0,0,1,1
13677,χαμογελούν,0,0,1,1
13678,تشديد,0,0,1,1
13655,contraseña,0,0,1,1
13653,práctica,0,0,1,1
13650,recopier,0,0,1,1
13634,உருவாக்கியவரோ,0,0,1,1
13623,solicitud,0,0,1,1
13624,открыта,0,0,1,1
13625,nachzudenken,0,0,1,1
13627,വസ്ത്രധാരണരീതി,0,0,1,1
13629,problème »,0,0,1,1
13633,verzamelen,0,0,1,1
13637,സൃഷ്ടികളേയും,0,0,1,1
13649,എഡിറ്റുകളെല്ലാം,0,0,1,1
13638,الكريمة,0,0,1,1
13640,одиночный,0,0,1,1
13642,dillerde,0,0,1,1
13645,избирательной,0,0,1,1
13647,ಪ್ರತಿಕ್ರಿಯೆಯೊಂದಿಗೆ,0,0,1,1
13648,necessity,0,0,1,1
13560,etmek”,0,0,1,1
13557,« victimes »,0,0,1,1
13683,വിറ്റതെന്ന്,0,0,1,1
13488,cumpliesen,0,0,1,1
13492,собравшей,0,0,1,1
13493,соответствующей,0,0,1,1
13494,onglets,0,0,1,1
13495,مستويين,0,0,1,1
13496,artikelmaterial,0,0,1,1
13497,verloren,0,0,1,1
13499,annoncent,0,0,1,1
13500,fühlen,0,0,1,1
13501,agreeable,0,0,1,1
13502,تامبا،,0,0,1,1
13503,definição,0,0,1,1
13504,замуж,0,0,1,1
13505,чикаго,0,0,1,1
13506,beroende,0,0,1,1
13508,nelson,0,0,1,1
13491,contextualização,0,0,1,1
13487,கோரிக்கைகளை,0,0,1,1
13555,collecté,0,0,1,1
13485,ആശയത്തിനെ,0,0,1,1
13463,wikiproyectos,0,0,1,1
13465,betroffen,0,0,1,1
13466,front,0,0,1,1
13468,adapt,0,0,1,1
13469,കഴിയാത്തതിനാൽ,0,0,1,1
13470,transcendantalistes,0,0,1,1
13471,dynamiques,0,0,1,1
13472,kød,0,0,1,1
13473,نتعلم,0,0,1,1
13474,brute,0,0,1,1
13478,combine,0,0,1,1
13480,കാര്യത്തെക്കുറിച്ച്,0,0,1,1
13481,gabinete,0,0,1,1
13483,triffst,0,0,1,1
13484,എഴുതുന്നത്,0,0,1,1
13509,cunt,0,0,1,1
13510,„википедии“,0,0,1,1
13511,lisent,0,0,1,1
13512,diagnósticos,0,0,1,1
13537,estudiante​,0,0,1,1
13538,рассказ,0,0,1,1
13539,одолжить,0,0,1,1
13540,തിരുത്തുന്നതിനും,0,0,1,1
13541,кэширующих,0,0,1,1
13542,जागरूकता,0,0,1,1
13545,φορέματα,0,0,1,1
13546,hébergent,0,0,1,1
13547,haus,0,0,1,1
13548,പരിഹാരത്തിലാണെന്ന്,0,0,1,1
13549,reinventions,0,0,1,1
13550,destinados,0,0,1,1
13551,«активизируйте,0,0,1,1
13553,indonesio,0,0,1,1
13554,rundt,0,0,1,1
13536,identifies,0,0,1,1
13535,albumet,0,0,1,1
13533,تعايش,0,0,1,1
13520,ഉപയോഗം,0,0,1,1
13513,fængsler,0,0,1,1
13515,seeds,0,0,1,1
13516,admettez,0,0,1,1
13517,smakprov,0,0,1,1
13518,beyler,0,0,1,1
13519,extremt,0,0,1,1
13521,अंक,0,0,1,1
13532,смеяться,0,0,1,1
13522,objectivement,0,0,1,1
13524,പത്ത്,0,0,1,1
13525,ayuda,0,0,1,1
13526,enviar,0,0,1,1
13528,вялой,0,0,1,1
13531,وعدم,0,0,1,1
13679,എഡിറ്റ്,0,0,1,1
13686,പ്രവർത്തിക്കണമെന്ന്,0,0,1,1
13906,truppen,0,0,1,1
13825,жестокое,0,0,1,1
13829,necessary,0,0,1,1
13830,ذكيًا,0,0,1,1
13831,वित्त,0,0,1,1
13832,πηγής,0,0,1,1
13834,നിരൂപണങ്ങൾ,0,0,1,1
13835,opzetten,0,0,1,1
13836,zihinde,0,0,1,1
13837,பொருத்தவரை,0,0,1,1
13839,geheimnisvolles,0,0,1,1
13842,gekauft,0,0,1,1
13843,tese,0,0,1,1
13844,supervisor,0,0,1,1
13845,பயனரோ,0,0,1,1
13847,feiten,0,0,1,1
13848,कराते,0,0,1,1
13827,تعديلات،,0,0,1,1
13821,போலி,0,0,1,1
13796,لتشمل,0,0,1,1
13820,கலைக்களஞ்சியத்,0,0,1,1
13798,gebaseerd,0,0,1,1
13799,‘பேச்சுப்,0,0,1,1
13800,iii»,0,0,1,1
13801,gozar,0,0,1,1
13803,systematically,0,0,1,1
13804,टेलीग्राम,0,0,1,1
13806,transcendantalisme,0,0,1,1
13807,донизу,0,0,1,1
13809,അസൈൻമെന്റുകൾ,0,0,1,1
13810,ಯಾವುವು,0,0,1,1
13811,terres,0,0,1,1
13815,दूं,0,0,1,1
13816,hängst,0,0,1,1
13818,ചെയ്യണമെന്ന്,0,0,1,1
13819,तीनों,0,0,1,1
13849,व्हाट्सएप,0,0,1,1
13850,karşısında,0,0,1,1
13851,coopération,0,0,1,1
13853,вкуса,0,0,1,1
13880,കണ്ടെത്തുന്ന,0,0,1,1
13881,ужасными,0,0,1,1
13882,cavaleiro,0,0,1,1
13883,dependência,0,0,1,1
13886,eksisteret,0,0,1,1
13888,políglota,0,0,1,1
13889,റിച്ചാർഡ്,0,0,1,1
13890,واسترجاعها،,0,0,1,1
13892,"
तिब्बती",0,0,1,1
13894,редакционным,0,0,1,1
13895,ഗ്നു,0,0,1,1
13896,замене,0,0,1,1
13897,uppgift,0,0,1,1
13899,يمرر,0,0,1,1
13904,അർത്ഥമാക്കുന്നതിന്,0,0,1,1
13878,panela,0,0,1,1
13875,unimportant,0,0,1,1
13874,görüşmek,0,0,1,1
13860,ಇನ್ನಷ್ಟು,0,0,1,1
13854,திட்டமாகவும்,0,0,1,1
13855,يحرره،,0,0,1,1
13856,مثلك,0,0,1,1
13857,ಯಾವುದೇ,0,0,1,1
13858,الحساسة,0,0,1,1
13859,தெரிவிக்க,0,0,1,1
13862,multilayer,0,0,1,1
13873,अनावश्यक,0,0,1,1
13863,argumentée,0,0,1,1
13864,maestro,0,0,1,1
13866,актов,0,0,1,1
13868,evaluating,0,0,1,1
13870,conceitos,0,0,1,1
13872,பாருங்கள்,0,0,1,1
13797,yeterlilik,0,0,1,1
13795,ചരിത്രവും,0,0,1,1
13687,कम्पनी,0,0,1,1
13712,explicabilité,0,0,1,1
13717,அவர்களில்,0,0,1,1
13718,inkl,0,0,1,1
13720,ಸಿದ್ಧವಾಗಿದೆ,0,0,1,1
13721,ഏതുസമയത്തും,0,0,1,1
13722,vand,0,0,1,1
13725,oprettes,0,0,1,1
13726,synder,0,0,1,1
13727,അതൊട്ട്‌,0,0,1,1
13730,karmaşa,0,0,1,1
13732,removido,0,0,1,1
13733,व्यवहार,0,0,1,1
13735,diyorum,0,0,1,1
13736,தொடங்குங்கள்,0,0,1,1
13737,மயங்கிவிட்டேன்,0,0,1,1
13738,முதன்மைச்,0,0,1,1
13714,مستاء,0,0,1,1
13711,ഒന്നുമല്ല,0,0,1,1
13792,ವಿಷಯವನ್ನು,0,0,1,1
13710,psalms,0,0,1,1
13688,ಕಾಣಿಸುತ್ತಾನೆ,0,0,1,1
13689,destacando,0,0,1,1
13691,ಸಂತೋಷವಾಗಿದ್ದೇನೆ,0,0,1,1
13693,alemana,0,0,1,1
13695,kızgınım,0,0,1,1
13697,normdatei,0,0,1,1
13698,refereed,0,0,1,1
13699,toevoegen,0,0,1,1
13700,चर्चा,0,0,1,1
13701,presentador,0,0,1,1
13704,alberto,0,0,1,1
13706,நிலமானது,0,0,1,1
13707,amplio,0,0,1,1
13708,kadın,0,0,1,1
13709,достать,0,0,1,1
13739,inclusionismo,0,0,1,1
13742,"
ख्मेर",0,0,1,1
13743,لكتاباتهم،,0,0,1,1
13744,radikalt,0,0,1,1
13772,суде,0,0,1,1
13773,hjärtskadad,0,0,1,1
13774,titel,0,0,1,1
13775,спала,0,0,1,1
13777,അവയ്ക്ക്,0,0,1,1
13778,ದಣಿದ,0,0,1,1
13779,ಕೋನವಾಗಿದೆ,0,0,1,1
13780,incierto,0,0,1,1
13782,அழகைத்,0,0,1,1
13783,plato,0,0,1,1
13786,zaden,0,0,1,1
13787,prachtig,0,0,1,1
13788,கிடைக்காதபோது,0,0,1,1
13789,направляются,0,0,1,1
13791,glycoproteins,0,0,1,1
13771,وجودة,0,0,1,1
13770,flicka,0,0,1,1
13769,fornøjelse,0,0,1,1
13754,framfört,0,0,1,1
13745,எப்போதுமே,0,0,1,1
13748,carolina,0,0,1,1
13750,είμαστε,0,0,1,1
13751,narsis,0,0,1,1
13752,proche,0,0,1,1
13753,chiffrement,0,0,1,1
13755,उत्प्रेरक,0,0,1,1
13768,quaisquer,0,0,1,1
13757,излагались,0,0,1,1
13758,aulas,0,0,1,1
13759,smartmobiler,0,0,1,1
13760,morges,0,0,1,1
13763,anımsattıkları”,0,0,1,1
13764,amérindiens,0,0,1,1
13462,لطبيعة,0,0,1,1
13461,wonders,0,0,1,1
13460,voir ,0,0,1,1
13123,causadas,0,0,1,1
13125,penses,0,0,1,1
13126,acabará,0,0,1,1
13127,bretonne,0,0,1,1
13129,anrufer,0,0,1,1
13130,temperatures,0,0,1,1
13133,meningsverschillen,0,0,1,1
13137,φόρεμα,0,0,1,1
13139,المشارك,0,0,1,1
13142,अर्थशास्त्री,0,0,1,1
13146,ഇക്കാരണം,0,0,1,1
13147,ന്നിപ്പറയുന്നത്,0,0,1,1
13149,bretón,0,0,1,1
13151,kvalitetsbrister,0,0,1,1
13153,oprichters,0,0,1,1
13155,والسياسية,0,0,1,1
13124,बनाता,0,0,1,1
13121,способствовало,0,0,1,1
13094,κορυφαίες,0,0,1,1
13120,ligeglad,0,0,1,1
13098,കാലുകൾ,0,0,1,1
13099,உங்களால்,0,0,1,1
13100,reinforcing,0,0,1,1
13102,நினைத்திருந்தது,0,0,1,1
13103,കർമ്മ,0,0,1,1
13105,αποθήκη,0,0,1,1
13106,izleyebilirler,0,0,1,1
13109,சொல்வதாகவும்,0,0,1,1
13110,añadidura,0,0,1,1
13111,مجهول,0,0,1,1
13113,eventuellt,0,0,1,1
13114,ausgeglichen,0,0,1,1
13115,ಮಹಾಕಾವ್ಯವನ್ನು,0,0,1,1
13116,remplazada,0,0,1,1
13118,qualité ,0,0,1,1
13156,verspreid,0,0,1,1
13158,άμαξας,0,0,1,1
13162,çarpıcı,0,0,1,1
13165,fréquentation,0,0,1,1
13198,питтсбурга,0,0,1,1
13199,« alphago »,0,0,1,1
13207,ಸ್ಥಗಿತಗೊಳಿಸಿ,0,0,1,1
13208,ருசிக்கும்,0,0,1,1
13209,отображена,0,0,1,1
13210,kontrol,0,0,1,1
13213,cortos,0,0,1,1
13214,ನಿಲ್ಲಿಸಿದ್ದೇವೆ,0,0,1,1
13216,yüzüme,0,0,1,1
13217,moeilijk,0,0,1,1
13218,ليدعم,0,0,1,1
13220,diverged,0,0,1,1
13221,oversvømmelse,0,0,1,1
13222,நகரத்தின்,0,0,1,1
13223,interviennent,0,0,1,1
13197,الدمية,0,0,1,1
13196,देखूंगा।,0,0,1,1
13195,romantic,0,0,1,1
13181,മുങ്ങാം,0,0,1,1
13169,تمثيلا,0,0,1,1
13170,betterwritten,0,0,1,1
13171,нильса,0,0,1,1
13172,समारोह,0,0,1,1
13174,turistin,0,0,1,1
13178,höjde,0,0,1,1
13183,habilidade,0,0,1,1
13193,hunde,0,0,1,1
13184,अस्थिर,0,0,1,1
13186,geotechnical,0,0,1,1
13188,réunis,0,0,1,1
13189,لزيارة,0,0,1,1
13190,opkalder,0,0,1,1
13191,الفكرية,0,0,1,1
13095,सुनते,0,0,1,1
13093,കേരള,0,0,1,1
13458,plötzlich,0,0,1,1
13000,değiştirme,0,0,1,1
13002,entretenimiento,0,0,1,1
13003,அழகானவர்,0,0,1,1
13004,المنتجين,0,0,1,1
13006,indivíduos,0,0,1,1
13007,corollaire,0,0,1,1
13008,സൈനികർക്കായി,0,0,1,1
13009,φόρμας,0,0,1,1
13010,aldığınızda,0,0,1,1
13012,അവസാനത്തിലും,0,0,1,1
13013,arbetslivserfarenhet,0,0,1,1
13015,cuantas,0,0,1,1
13017,cometí,0,0,1,1
13018,pequenas,0,0,1,1
13025,തെറ്റിദ്ധരിക്കുന്ന,0,0,1,1
13031,സ്ഥാപിതമായതും,0,0,1,1
13001,अल्पकालिक,0,0,1,1
12999,cometidos,0,0,1,1
13091,брендом,0,0,1,1
12998,энергетический,0,0,1,1
12973,visitor,0,0,1,1
12974,messager,0,0,1,1
12975,μυρωδιά,0,0,1,1
12977,procrastination,0,0,1,1
12978,совершила,0,0,1,1
12979,museum,0,0,1,1
12983,اختبار,0,0,1,1
12984,बहन,0,0,1,1
12985,imposé,0,0,1,1
12987,использовал,0,0,1,1
12991,ಒಬ್ಬರನ್ನೊಬ್ಬರು,0,0,1,1
12992,librei,0,0,1,1
12993,defensores,0,0,1,1
12996,métawiki,0,0,1,1
12997,höll,0,0,1,1
13033,ಘಟನೆಗಳು,0,0,1,1
13034,ലഭ്യമായിരിക്കണം,0,0,1,1
13035,ಗುದ್ದಾಟ,0,0,1,1
13036,കാലിഫോർണിയയിൽ,0,0,1,1
13070,macht,0,0,1,1
13072,ijsje,0,0,1,1
13073,φράσεων,0,0,1,1
13074,“விக்கிமீடீயா”,0,0,1,1
13075,வழங்கிகள்,0,0,1,1
13076,publiek,0,0,1,1
13077,சாப்பிடலாமா,0,0,1,1
13078,construída,0,0,1,1
13079,suggérant,0,0,1,1
13080,electronicawedstrijd,0,0,1,1
13081,المصدر,0,0,1,1
13082,kültürlü,0,0,1,1
13086,രണ്ടാമത്തെ,0,0,1,1
13089,generalizable,0,0,1,1
13090,பெரும்பாலான,0,0,1,1
13069,suffisamment,0,0,1,1
13068,കുഴപ്പമുണ്ടോ,0,0,1,1
13066,പരിഹരിക്കപ്പെടുമെന്നാണ്,0,0,1,1
13048,imiter,0,0,1,1
13038,அழுத்தவும்,0,0,1,1
13039,താല്പര്യമില്ല,0,0,1,1
13041,السماء,0,0,1,1
13044,നോക്കിയ,0,0,1,1
13046,thirdgeneration,0,0,1,1
13047,लाइब्रेरी,0,0,1,1
13049,நகைச்சுவை,0,0,1,1
13064,அழுவதைப்,0,0,1,1
13050,ഡൽഹിയിൽ,0,0,1,1
13052,حاد,0,0,1,1
13055,mesclamse,0,0,1,1
13059,doter,0,0,1,1
13061,innate,0,0,1,1
13063,educativos,0,0,1,1
13224,нынешнюю,0,0,1,1
13226,എന്നല്ല,0,0,1,1
13228,பீட்சா,0,0,1,1
13374,immédiates,0,0,1,1
13377,القانونية،,0,0,1,1
13378,среда,0,0,1,1
13380,máximo,0,0,1,1
13381,mobilisent,0,0,1,1
13383,elogiou,0,0,1,1
13385,exercer,0,0,1,1
13386,सटीकता,0,0,1,1
13387,nämnt,0,0,1,1
13389,கொள்ளாதீர்கள்,0,0,1,1
13393,plotseling,0,0,1,1
13394,appointment,0,0,1,1
13395,ഹിച്ചാലും,0,0,1,1
13396,നേറ്റീവ്,0,0,1,1
13398,നാർസിസയെ,0,0,1,1
13399,भूलें।,0,0,1,1
13375,достоверности,0,0,1,1
13373,الجانب,0,0,1,1
13229,கூட,0,0,1,1
13372,typographie,0,0,1,1
13342,ഭാഗമായി,0,0,1,1
13348,confirmaba,0,0,1,1
13350,traducido,0,0,1,1
13351,açıklar,0,0,1,1
13352,തടസ്സപ്പെടുത്തിയതിൽ,0,0,1,1
13353,knopf,0,0,1,1
13355,frågetecken,0,0,1,1
13357,tumor,0,0,1,1
13358,wikienciclopédias,0,0,1,1
13360,océans,0,0,1,1
13362,തിരിയുന്നു,0,0,1,1
13364,sidde,0,0,1,1
13365,ஐஸ்கிரீம்,0,0,1,1
13366,constitué,0,0,1,1
13367,ஷெல்லின்,0,0,1,1
13400,ಇದ್ದವು,0,0,1,1
13405,फ्लुमॉक्स,0,0,1,1
13406,incentiva,0,0,1,1
13409,individualiste,0,0,1,1
13436,нидерландов,0,0,1,1
13438,бегло,0,0,1,1
13439,കാര്യനിർവ്വാഹർക്കുണ്ട്,0,0,1,1
13440,parenthèses,0,0,1,1
13443,cinéma,0,0,1,1
13446,apparut,0,0,1,1
13447,pertencente,0,0,1,1
13448,ξεφλουδίστηκε,0,0,1,1
13450,ഡിസംബർ,0,0,1,1
13452,confundirse,0,0,1,1
13453,evaluar,0,0,1,1
13454,அனைவருக்கும்,0,0,1,1
13455,editem,0,0,1,1
13456,fließender,0,0,1,1
13457,insana,0,0,1,1
13435,предприняты,0,0,1,1
13434,πάρουν,0,0,1,1
13431,مسكين,0,0,1,1
13421,zes,0,0,1,1
13410,एव्रीथिंग,0,0,1,1
13411,шварцем,0,0,1,1
13413,παράδοξη,0,0,1,1
13415,വരികയാണ്,0,0,1,1
13416,التفكير,0,0,1,1
13419,ಮಗು,0,0,1,1
13422,ಮೂಲೆಯಲ್ಲಿಯೇ,0,0,1,1
13430,பார்க்கும்,0,0,1,1
13423,കാണുമ്പോൾ,0,0,1,1
13425,parcourant,0,0,1,1
13426,rejser,0,0,1,1
13427,вандализирующими,0,0,1,1
13428,மாவு,0,0,1,1
13429,rumpelte,0,0,1,1
13341,തുമ്മുമ്പോൾ,0,0,1,1
13338,kısmının,0,0,1,1
13336,frihetens,0,0,1,1
13284,സ്കൂൾ,0,0,1,1
13264,tg •,0,0,1,1
13266,tersi,0,0,1,1
13267,fazerem,0,0,1,1
13268,neus,0,0,1,1
13269,dilemenin,0,0,1,1
13271,responsável,0,0,1,1
13272,ಮಟ್ಟಿಗೆ,0,0,1,1
13273,guia,0,0,1,1
13274,mandou,0,0,1,1
13275,رائعا،,0,0,1,1
13277,रेटिंग्स,0,0,1,1
13278,والبرتغالية,0,0,1,1
13279,പ്രശ്നത്തിന്റേയും,0,0,1,1
13280,août,0,0,1,1
13282,sofa,0,0,1,1
13263,വിയോജിക്കുന്നു,0,0,1,1
13260,almennyttig,0,0,1,1
13259,paradoxes,0,0,1,1
13244,perdí,0,0,1,1
13230,വാക്യത്തിന്റെ,0,0,1,1
13231,angenehmes,0,0,1,1
13232,controverses,0,0,1,1
13233,toets,0,0,1,1
13235,ಸುಂದರವಾಗಿದ್ದೀರಿ,0,0,1,1
13237,सेबुआनो,0,0,1,1
13245,πνιγμό,0,0,1,1
13257,écosystémiques ,0,0,1,1
13247,ставились,0,0,1,1
13250,lanserat,0,0,1,1
13253,popcultuur,0,0,1,1
13254,erudita,0,0,1,1
13255,τύπος,0,0,1,1
13256,தேடுகிறோம்,0,0,1,1
13283,даю,0,0,1,1
13285,ചാനൽ,0,0,1,1
13335,konversation,0,0,1,1
13286,الاعتماد،,0,0,1,1
13316,التعاوني،,0,0,1,1
13318,ويقوم,0,0,1,1
13320,εβδομάδες,0,0,1,1
13321,behandlede,0,0,1,1
13322,couler,0,0,1,1
13324,fêtes,0,0,1,1
13325,لتحرير,0,0,1,1
13326,concordamos,0,0,1,1
13328,ಬರುತ್ತಾರೆ,0,0,1,1
13329,بإمكان,0,0,1,1
13330,coordinación,0,0,1,1
13331,друга,0,0,1,1
13332,çoğunluğu,0,0,1,1
13333,wedding,0,0,1,1
13334,onaylanmış,0,0,1,1
13315,partide,0,0,1,1
13313,συνάντησε,0,0,1,1
13312,correu,0,0,1,1
13296,ഭക്ഷ്യയോഗ്യമല്ലാത്ത,0,0,1,1
13287,rättvis,0,0,1,1
13290,fate,0,0,1,1
13291,oficina,0,0,1,1
13292,turkiet,0,0,1,1
13294,çocuklar,0,0,1,1
13295,besuchen,0,0,1,1
13297,संवेदनशील,0,0,1,1
13310,ஹலோ,0,0,1,1
13298,atteinte,0,0,1,1
13299,основателей,0,0,1,1
13300,benadrukken,0,0,1,1
13301,beantwoorden,0,0,1,1
13304,تطبيق,0,0,1,1
13309,opencollaborative,0,0,1,1
13905,данной,0,0,1,1
13907,لكشف,0,0,1,1
11139,υπομονετικά,0,0,1,1
14495,طبيعي,0,0,1,1
14497,بتعديل,0,0,1,1
14498,égoïste,0,0,1,1
14499,والإحصاء,0,0,1,1
14500,κλπ,0,0,1,1
14502,tabulated,0,0,1,1
14503,şahsen,0,0,1,1
14504,adopción,0,0,1,1
14505,ಪೆಟ್ಟಿಗೆಯಲ್ಲಿ,0,0,1,1
14507,interchange,0,0,1,1
14508,yazan,0,0,1,1
14512,نسخها,0,0,1,1
14513,textbased,0,0,1,1
14515,வழிமுறைகள்,0,0,1,1
14517,medier,0,0,1,1
14518,μικρά,0,0,1,1
14496,wegwerken,0,0,1,1
14494,ഉറുമ്പുകൂട്ടത്തെ,0,0,1,1
14457,compartilhados,0,0,1,1
14493,पुनर्वितरण,0,0,1,1
14460,faydasızdı,0,0,1,1
14462,apareció,0,0,1,1
14466,numerical,0,0,1,1
14467,saati,0,0,1,1
14471,சுவாரஸ்யமான,0,0,1,1
14473,voel,0,0,1,1
14474,أداة,0,0,1,1
14477,എൻസൈക്ലോപീഡിയ,0,0,1,1
14478,ഘട്ടമാണിത്,0,0,1,1
14483,knight,0,0,1,1
14484,പഠിക്കുന്നുണ്ടെങ്കിൽ‌,0,0,1,1
14486,لكى,0,0,1,1
14487,gebeurtenissen,0,0,1,1
14488,മുഴുകിയിരിക്കുന്നു,0,0,1,1
14490,kalınarak,0,0,1,1
14519,rato»,0,0,1,1
14520,αλεύρι,0,0,1,1
14521,län,0,0,1,1
14522,fotnoter,0,0,1,1
14551,nysade,0,0,1,1
14553,fingrarna,0,0,1,1
14554,ശാഖയുടെ,0,0,1,1
14555,actuales,0,0,1,1
14556,norteamericano,0,0,1,1
14558,പരീക്ഷയിൽ,0,0,1,1
14560,frygt,0,0,1,1
14561,മനുഷ്യന്,0,0,1,1
14562,weitergab,0,0,1,1
14564,παραδώσει,0,0,1,1
14565,adressen,0,0,1,1
14566,decentralizing,0,0,1,1
14567,olacaktır,0,0,1,1
14568,parodian,0,0,1,1
14569,kopyalamasını,0,0,1,1
14550,добрые,0,0,1,1
14549,அடிப்படையில்,0,0,1,1
14547,கடுமையான,0,0,1,1
14532,delecionismo,0,0,1,1
14523,субботних,0,0,1,1
14524,ഗ്രന്ഥങ്ങളെയും,0,0,1,1
14525,шекмана,0,0,1,1
14526,அழுவதையும்,0,0,1,1
14528,schlimmes,0,0,1,1
14530,tanıyorsunuz,0,0,1,1
14533,ನಿಮಿಷದಲ್ಲಿ,0,0,1,1
14543,datacenter,0,0,1,1
14536,orageuse,0,0,1,1
14537,misleidende,0,0,1,1
14538,பயன்படுத்துவதன்,0,0,1,1
14539,постоянно,0,0,1,1
14540,ayudarme,0,0,1,1
14541,arkadaşlarına,0,0,1,1
14459,وهؤلاء,0,0,1,1
14456,bataklığın,0,0,1,1
14573,गोपनीयता,0,0,1,1
14383,cantonales,0,0,1,1
14385,بالحيرة,0,0,1,1
14386,лицензии,0,0,1,1
14387,لجنة,0,0,1,1
14388,ರಹಸ್ಯವನ್ನು,0,0,1,1
14389,regardons,0,0,1,1
14391,என்பதைப்,0,0,1,1
14392,قريب,0,0,1,1
14393,ഇതൊരു,0,0,1,1
14395,democráticamente,0,0,1,1
14396,dotée,0,0,1,1
14397,associée,0,0,1,1
14398,competir,0,0,1,1
14399,ಸುಸಂಸ್ಕೃತ,0,0,1,1
14401,городах,0,0,1,1
14402,ಜನರಿಗೆ,0,0,1,1
14384,скопировать,0,0,1,1
14382,appearances,0,0,1,1
14455,şimdiye,0,0,1,1
14381,ämne,0,0,1,1
14357,organisés,0,0,1,1
14360,ഉടൻ,0,0,1,1
14361,whom,0,0,1,1
14362,ವೈಫಲ್ಯಗಳ,0,0,1,1
14366,картофеля,0,0,1,1
14368,рок,0,0,1,1
14370,கட்டுரைகளைப்,0,0,1,1
14372,правка,0,0,1,1
14374,ವಿರೋಧಾಭಾಸ,0,0,1,1
14375,المساعدة,0,0,1,1
14376,gives,0,0,1,1
14377,просит,0,0,1,1
14378,वीलेन,0,0,1,1
14379,conterem,0,0,1,1
14380,concluait,0,0,1,1
14403,मंदव्यंजित,0,0,1,1
14404,équipés,0,0,1,1
14407,जाऊँगा।,0,0,1,1
14408,cambiado,0,0,1,1
14432,व्यंग्य,0,0,1,1
14434,ಬಳಲುತ್ತಿದ್ದೇನೆ,0,0,1,1
14437,dissected,0,0,1,1
14438,நுபீடியாவை,0,0,1,1
14441,couche,0,0,1,1
14442,zorunluğu,0,0,1,1
14443,implementar,0,0,1,1
14444,simgesine,0,0,1,1
14446,ಟಿಪ್,0,0,1,1
14447,திட்டமாகச்,0,0,1,1
14448,diante,0,0,1,1
14449,vatten,0,0,1,1
14450,بالضحك,0,0,1,1
14452,खो,0,0,1,1
14454,مهذب,0,0,1,1
14431,художник,0,0,1,1
14429,trae,0,0,1,1
14428,influencia,0,0,1,1
14417,formado,0,0,1,1
14409,aziz,0,0,1,1
14410,പതിവിലും,0,0,1,1
14411,rulelearning,0,0,1,1
14412,أكبرها،,0,0,1,1
14414,avons,0,0,1,1
14416,inspirera,0,0,1,1
14418,beantworten,0,0,1,1
14427,distribuídas,0,0,1,1
14419,конкретным,0,0,1,1
14420,équatoriale,0,0,1,1
14421,armee,0,0,1,1
14424,izing,0,0,1,1
14425,columnist,0,0,1,1
14426,rituais,0,0,1,1
14570,contribue,0,0,1,1
14574,اللغة،,0,0,1,1
13908,ಕರೆದೊಯ್ಯುತ್ತೇನೆ,0,0,1,1
14725,требованиям,0,0,1,1
14727,aumentarem,0,0,1,1
14728,تشكيل,0,0,1,1
14730,mejorar,0,0,1,1
14731,текста,0,0,1,1
14733,ramené,0,0,1,1
14734,shakespeare,0,0,1,1
14738,நிகழும்,0,0,1,1
14739,википедия —,0,0,1,1
14740,வேகத்தில்,0,0,1,1
14744,हैंडसम,0,0,1,1
14746,onani,0,0,1,1
14750,natureculture,0,0,1,1
14752,camada,0,0,1,1
14753,mutuas,0,0,1,1
14754,ಬೇಕಾಗಿಲ್ಲ,0,0,1,1
14726,scruté,0,0,1,1
14724,σταυρωμένα,0,0,1,1
14701,المظهر,0,0,1,1
14723,обязательно,0,0,1,1
14703,سيئة,0,0,1,1
14704,«obra,0,0,1,1
14705,någonstans,0,0,1,1
14709,المعاملات,0,0,1,1
14710,നല്ലവനായിരുന്നു,0,0,1,1
14711,அருகில்,0,0,1,1
14712,दाईं,0,0,1,1
14713,பங்களிப்புக்களை,0,0,1,1
14714,novio,0,0,1,1
14715,yanına,0,0,1,1
14717,ವೀಡಿಯೊ,0,0,1,1
14718,namely,0,0,1,1
14719,ஏற்படுத்துவதைத்,0,0,1,1
14721,informaticien,0,0,1,1
14722,yazın,0,0,1,1
14756,ದೂರದವರೆಗೆ,0,0,1,1
14762,dira,0,0,1,1
14763,aplicadas,0,0,1,1
14764,വായിക്കുന്നു,0,0,1,1
14803,téléverser,0,0,1,1
14805,بنصب,0,0,1,1
14806,μαγικά,0,0,1,1
14807,المطبقة,0,0,1,1
14808,ಅನಿಸುತ್ತದೆ,0,0,1,1
14810,verdelen,0,0,1,1
14811,ξεχνούν,0,0,1,1
14812,inné »,0,0,1,1
14814,отнести,0,0,1,1
14817,لحل,0,0,1,1
14820,பணிவுடன்,0,0,1,1
14821,registrar,0,0,1,1
14822,जानी,0,0,1,1
14823,noted,0,0,1,1
14824,എങ്ങനെയുണ്ട്,0,0,1,1
14802,контакты,0,0,1,1
14800,والكورية،,0,0,1,1
14796,confidencialmente,0,0,1,1
14784,"
बान्युमासन",0,0,1,1
14766,οπτική,0,0,1,1
14769,snegleeksempel,0,0,1,1
14774,uttal,0,0,1,1
14777,resulta,0,0,1,1
14778,правило,0,0,1,1
14779,الأوساخ,0,0,1,1
14785,اتخذتها,0,0,1,1
14795,പോകുന്നുവെന്ന്,0,0,1,1
14786,fertig,0,0,1,1
14788,மாட்டாள்,0,0,1,1
14789,αναπνεύσω,0,0,1,1
14790,fixed,0,0,1,1
14791,patatas,0,0,1,1
14792,баллотироваться,0,0,1,1
14702,estratégia,0,0,1,1
14700,الأمر،,0,0,1,1
14576,circling,0,0,1,1
14608,βικειπαιδιας,0,0,1,1
14613,цифровой,0,0,1,1
14614,somewhere,0,0,1,1
14615,nieste,0,0,1,1
14616,permitiendo,0,0,1,1
14617,ग्रिल्लिनी,0,0,1,1
14618,écrivit,0,0,1,1
14619,interesado,0,0,1,1
14621,diferenciación,0,0,1,1
14624,intends,0,0,1,1
14625,parabéns,0,0,1,1
14631,править —,0,0,1,1
14633,stapte,0,0,1,1
14634,சவாரிக்குப்,0,0,1,1
14636,initiatieven,0,0,1,1
14638,स्टेटस,0,0,1,1
14612,unlike,0,0,1,1
14605,फ्रीडम,0,0,1,1
14698,quadrinhos,0,0,1,1
14603,الاختبار,0,0,1,1
14577,méritais,0,0,1,1
14579,ministre,0,0,1,1
14580,अन्यभाषाओं,0,0,1,1
14582,disambiguation,0,0,1,1
14584,سوبود,0,0,1,1
14585,നിർമാതാവും,0,0,1,1
14586,suffit,0,0,1,1
14587,antik,0,0,1,1
14590,взаимодействию,0,0,1,1
14594,—correcciones,0,0,1,1
14595,freakade,0,0,1,1
14596,stilmallar,0,0,1,1
14598,விடுமுறை,0,0,1,1
14599,பற்றிய,0,0,1,1
14600,compraría,0,0,1,1
14639,kontorskonto,0,0,1,1
14640,बदले,0,0,1,1
14641,ചതുപ്പ്,0,0,1,1
14642,कंजर्वापीडिया,0,0,1,1
14667,olmadı,0,0,1,1
14670,respetarla,0,0,1,1
14671,hyperlink,0,0,1,1
14673,judaïque,0,0,1,1
14674,överraskat,0,0,1,1
14681,отсюда,0,0,1,1
14683,الحادث,0,0,1,1
14686,attenuates,0,0,1,1
14687,yenmez,0,0,1,1
14689,находитесь,0,0,1,1
14691,καν,0,0,1,1
14693,cultivé,0,0,1,1
14694,krama,0,0,1,1
14696,λίγα,0,0,1,1
14697,interrumpirte,0,0,1,1
14665,måtte,0,0,1,1
14664,टिप्पणीकारों,0,0,1,1
14663,सा,0,0,1,1
14652,genişti,0,0,1,1
14644,eserin,0,0,1,1
14645,compositeur,0,0,1,1
14646,capacidad,0,0,1,1
14648,« guerres,0,0,1,1
14649,вошла,0,0,1,1
14650,fiquei,0,0,1,1
14654,സിസോപ്പുകൾ,0,0,1,1
14662,सीखा,0,0,1,1
14655,géométrie,0,0,1,1
14656,प्राथमिकता,0,0,1,1
14657,πνίγω,0,0,1,1
14658,çıktı,0,0,1,1
14660,анонсирована,0,0,1,1
14661,nationale,0,0,1,1
14355,president,0,0,1,1
14354,നിർദ്ദേശിച്ചിട്ടുള്ള,0,0,1,1
14353,தோற்றமளிக்கிறீர்கள்,0,0,1,1
14061,ಭೀಕರ,0,0,1,1
14063,interestingness,0,0,1,1
14064,онлайнголосований,0,0,1,1
14065,editálos,0,0,1,1
14068,συντάκτες,0,0,1,1
14072,idioma»,0,0,1,1
14073,коннотацией,0,0,1,1
14076,الحيرة,0,0,1,1
14077,polished,0,0,1,1
14078,tercih,0,0,1,1
14079,schauen,0,0,1,1
14081,اتهم,0,0,1,1
14082,°′″w﻿,0,0,1,1
14083,узнаваемы,0,0,1,1
14084,lyssna,0,0,1,1
14085,parodies,0,0,1,1
14062,crearles,0,0,1,1
14059,religionskritik,0,0,1,1
14029,хранятся,0,0,1,1
14058,telaffuz,0,0,1,1
14033,итоге,0,0,1,1
14034,hemmeligt,0,0,1,1
14035,reikte,0,0,1,1
14037,lisanslanmaktadır,0,0,1,1
14038,avènement,0,0,1,1
14041,اعتن,0,0,1,1
14042,touristen,0,0,1,1
14046,—மீக்கா,0,0,1,1
14047,diverge,0,0,1,1
14048,‘வழங்கி’யில்,0,0,1,1
14049,pojken,0,0,1,1
14052,ίση,0,0,1,1
14053,sunmuştur,0,0,1,1
14054,аналитически,0,0,1,1
14056,uddybende,0,0,1,1
14086,مربى,0,0,1,1
14087,цитируемых,0,0,1,1
14088,substantivo,0,0,1,1
14089,विश्वास,0,0,1,1
14122,naturally,0,0,1,1
14123,describen,0,0,1,1
14124,sidans,0,0,1,1
14125,അനുഭവപ്പെട്ടേക്കാം,0,0,1,1
14126,requérant,0,0,1,1
14127,ಮುಳುಗುತ್ತಿದ್ದೇನೆ,0,0,1,1
14129,protest,0,0,1,1
14130,பதிலளிக்க,0,0,1,1
14131,κάπως,0,0,1,1
14132,llegan,0,0,1,1
14133,വെബ്‌,0,0,1,1
14135,salladığın,0,0,1,1
14136,réelles,0,0,1,1
14137,şaka,0,0,1,1
14138,presumiblemente,0,0,1,1
14121,mountainous,0,0,1,1
14118,വിക്കിസോഫ്റ്റ്,0,0,1,1
14117,एजेंसियों,0,0,1,1
14099,lock,0,0,1,1
14091,போலல்லாது,0,0,1,1
14092,fluentes,0,0,1,1
14093,ನನಸಾಗುತ್ತದೆ,0,0,1,1
14094,тупыми,0,0,1,1
14096,behandelde,0,0,1,1
14098,abrazar,0,0,1,1
14100,percentage,0,0,1,1
14116,ಭಾವಿಸಿದ್ದೀರಿ,0,0,1,1
14101,ಚಿನ್ನವನ್ನು,0,0,1,1
14103,deliberately,0,0,1,1
14106,يونجل,0,0,1,1
14109,alternativt,0,0,1,1
14113,изложением,0,0,1,1
14114,tänk,0,0,1,1
14032,créées,0,0,1,1
14028,sexist,0,0,1,1
14352,¿verdad,0,0,1,1
13932,autorrevisores,0,0,1,1
13938,autobús,0,0,1,1
13939,saute,0,0,1,1
13940,μαθηματικά,0,0,1,1
13941,घबराए,0,0,1,1
13942,goods,0,0,1,1
13944,trente,0,0,1,1
13945,تخبره,0,0,1,1
13947,bezighouden,0,0,1,1
13948,ذاهب,0,0,1,1
13949,contestados,0,0,1,1
13951,bekle,0,0,1,1
13952,பிடிக்க,0,0,1,1
13953,egyptian,0,0,1,1
13955,enverrai,0,0,1,1
13956,wwwwikipediacom،,0,0,1,1
13937,atmospheres,0,0,1,1
13931,फ्रेंको,0,0,1,1
14027,daterad,0,0,1,1
13929,renewable,0,0,1,1
13911,அமர்த்த,0,0,1,1
13912,выборки —,0,0,1,1
13913,actualisée,0,0,1,1
13914,canapé,0,0,1,1
13915,parity,0,0,1,1
13917,plaatsen,0,0,1,1
13918,ஆவர்,0,0,1,1
13919,தினசரி,0,0,1,1
13920,வைத்து,0,0,1,1
13922,"
चेक",0,0,1,1
13923,ಕರೆಯಲ್ಲಿ,0,0,1,1
13925,ellesmêmes,0,0,1,1
13926,ಟವು,0,0,1,1
13927,संघर्ष,0,0,1,1
13928,tevens,0,0,1,1
13957,நோக்கற்ற,0,0,1,1
13960,подрывает,0,0,1,1
13961,ശൈശവാവസ്ഥയിലാണ്,0,0,1,1
13962,ವಹಿಸಲಿಲ್ಲ,0,0,1,1
13994,restricciones,0,0,1,1
13995,controverse ,0,0,1,1
13997,അഭ്യർത്ഥനകൾ,0,0,1,1
14000,semantisk,0,0,1,1
14003,μπαλκόνι,0,0,1,1
14004,"
सिंहला",0,0,1,1
14006,दिलाया,0,0,1,1
14009,encontrase,0,0,1,1
14010,اثنين,0,0,1,1
14013,dependendo,0,0,1,1
14016,व्याकरण,0,0,1,1
14018,பதிப்புக்களில்,0,0,1,1
14019,införandet,0,0,1,1
14022,ಹಳ್ಳಿಯಲ್ಲಿ,0,0,1,1
14025,låna,0,0,1,1
13992,запутаетесь,0,0,1,1
13991,ഒപ്റ്റിമൈസേഷൻ,0,0,1,1
13989,cirkler,0,0,1,1
13970,lægger,0,0,1,1
13963,முன்னிறுத்தப்பட்டது,0,0,1,1
13964,அவற்றில்,0,0,1,1
13965,сайты,0,0,1,1
13966,ഭാ‍ഷകളിലെ,0,0,1,1
13968,begrijp,0,0,1,1
13969,удивлена,0,0,1,1
13972,சுவைக்கும்,0,0,1,1
13988,diamants,0,0,1,1
13976,ഒരുപാട്,0,0,1,1
13980,lenteur,0,0,1,1
13981,«anónima»,0,0,1,1
13983,medtaget,0,0,1,1
13985,вниз,0,0,1,1
13987,prefixo,0,0,1,1
14139,प्रतिनिधित्व,0,0,1,1
14140,valued,0,0,1,1
14143,начале,0,0,1,1
14271,renunciou,0,0,1,1
14274,требовал,0,0,1,1
14277,இவற்றுள்,0,0,1,1
14278,primario,0,0,1,1
14279,korkmuştu,0,0,1,1
14281,नमस्ते,0,0,1,1
14282,вторичных,0,0,1,1
14285,"
सैटरलैण्ड",0,0,1,1
14286,утро,0,0,1,1
14287,установил,0,0,1,1
14288,कर्मचारियों,0,0,1,1
14291,மூக்கைக்,0,0,1,1
14293,ülkeye,0,0,1,1
14295,afirmam,0,0,1,1
14296,umduğum,0,0,1,1
14297,başlayacak,0,0,1,1
14273,conocía,0,0,1,1
14270,нанять,0,0,1,1
14144,серверах,0,0,1,1
14267,اليكم,0,0,1,1
14244,​​det,0,0,1,1
14245,அரைப்,0,0,1,1
14246,hunting,0,0,1,1
14248,hunnit,0,0,1,1
14249,ചെയ്യുകയായിരുന്നു,0,0,1,1
14250,المنسقة,0,0,1,1
14253,uitzonderlijk,0,0,1,1
14254,ഐസ്ക്രീമുകളുടെ,0,0,1,1
14256,associëren,0,0,1,1
14257,عليهم,0,0,1,1
14258,വിക്കിപീഡിയരും,0,0,1,1
14261,التاريخية,0,0,1,1
14262,bloqueando,0,0,1,1
14265,fonctionner,0,0,1,1
14266,ഉപ്പ്,0,0,1,1
14298,odasına,0,0,1,1
14301,sønderknust,0,0,1,1
14302,château,0,0,1,1
14304,yansıtmaya,0,0,1,1
14333,nonfree,0,0,1,1
14334,incompetent,0,0,1,1
14335,remuneradas,0,0,1,1
14336,marionetter,0,0,1,1
14338,ആൾ,0,0,1,1
14339,нуждаются,0,0,1,1
14340,dosyalar,0,0,1,1
14341,tolka,0,0,1,1
14342,wikipediaprojektets,0,0,1,1
14344,टेलीफोन,0,0,1,1
14345,permissão,0,0,1,1
14346,fond,0,0,1,1
14347,ponctuellement,0,0,1,1
14349,عزا,0,0,1,1
14351,chimiques,0,0,1,1
14331,πέσεις,0,0,1,1
14329,metne,0,0,1,1
14328,cálmate,0,0,1,1
14316,συνηθισμένη,0,0,1,1
14306,வழங்கியதற்கு,0,0,1,1
14310,объективно,0,0,1,1
14311,shipments,0,0,1,1
14312,போன்றன,0,0,1,1
14314,தவிர்ப்பது,0,0,1,1
14315,وابنتها,0,0,1,1
14317,πιστεύετε,0,0,1,1
14327,അഞ്ച്,0,0,1,1
14319,technological,0,0,1,1
14320,lades,0,0,1,1
14322,dépassées,0,0,1,1
14324,തുടക്കത്തിനുശേഷം,0,0,1,1
14325,ಮೇಜಿನ,0,0,1,1
14326,وأريد,0,0,1,1
14242,vastu,0,0,1,1
14241,εισαι,0,0,1,1
14240,تصعيد,0,0,1,1
14188,откликов,0,0,1,1
14170,പരീക്ഷിക്കുക,0,0,1,1
14171,εκθέτει,0,0,1,1
14172,erbjuder,0,0,1,1
14173,tenido,0,0,1,1
14174,«подписаться»,0,0,1,1
14175,മാതൃവെബ്സൈറ്റിനെയും,0,0,1,1
14176,ವಜ್ರಗಳಿಂದ,0,0,1,1
14177,रोचक,0,0,1,1
14178,इंतजार,0,0,1,1
14179,reddettiğinden,0,0,1,1
14180,saladas,0,0,1,1
14181,अपरंपरागत,0,0,1,1
14183,अनुवाद,0,0,1,1
14184,विकिपीडियाने,0,0,1,1
14185,ஆறாவது,0,0,1,1
14169,காரணம்,0,0,1,1
14168,определение,0,0,1,1
14167,crossbow,0,0,1,1
14154,slaap,0,0,1,1
14145,henüz,0,0,1,1
14148,visually,0,0,1,1
14149,staten,0,0,1,1
14150,وجمالها,0,0,1,1
14151,mätningar,0,0,1,1
14153,apropiado,0,0,1,1
14155,திட்டத்தை,0,0,1,1
14166,negotiation»,0,0,1,1
14157,προσπαθήστε,0,0,1,1
14158,നിയോഗിക്കുന്ന,0,0,1,1
14160,نرسيسا,0,0,1,1
14161,restrições,0,0,1,1
14164,لاحقا,0,0,1,1
14165,hindra,0,0,1,1
14186,خطأ,0,0,1,1
14190,intervalle,0,0,1,1
14239,recevoir,0,0,1,1
14191,garten,0,0,1,1
14219,professional,0,0,1,1
14220,премии,0,0,1,1
14222,اللاحق,0,0,1,1
14223,сэнгера,0,0,1,1
14224,yrkeskategorier,0,0,1,1
14225,listade,0,0,1,1
14226,மொழிப்பதிப்புகளில்,0,0,1,1
14227,démagogie,0,0,1,1
14230,injuste,0,0,1,1
14231,yansımasına,0,0,1,1
14233,upphovsrätt,0,0,1,1
14234,conjectured,0,0,1,1
14235,imprécis,0,0,1,1
14236,turkije,0,0,1,1
14237,സമ്പത്ത്,0,0,1,1
14218,webbversionen,0,0,1,1
14217,itibaren,0,0,1,1
14216,count,0,0,1,1
14201,отправлении,0,0,1,1
14192,spreche,0,0,1,1
14194,partisanes »,0,0,1,1
14195,опасения,0,0,1,1
14197,anförts,0,0,1,1
14198,ഔദ്യോഗിക,0,0,1,1
14200,begreppet,0,0,1,1
14202,traveled,0,0,1,1
14215,δικιο,0,0,1,1
14205,പ്രവചിക്കുന്ന,0,0,1,1
14207,വരുന്ന,0,0,1,1
14211,rendra,0,0,1,1
14212,ml —,0,0,1,1
14213,pedagogiskt,0,0,1,1
14214,nietbestaande,0,0,1,1
12972,مرجعية,0,0,1,1
12971,nobody,0,0,1,1
12969,скажешь,0,0,1,1
11731,distinguant,0,0,1,1
11733,γλύφους,0,0,1,1
11735,shut,0,0,1,1
11737,água,0,0,1,1
11739,нами,0,0,1,1
11740,"
catalão",0,0,1,1
11741,بتلميحات,0,0,1,1
11742,പറയുന്നതായും,0,0,1,1
11743,tamir,0,0,1,1
11745,comedian,0,0,1,1
11746,mythique,0,0,1,1
11748,سألتقي,0,0,1,1
11749,πλάι,0,0,1,1
11752,создают,0,0,1,1
11753,движется,0,0,1,1
11754,ننظر,0,0,1,1
11732,garanderen,0,0,1,1
11730,ദീർഘനാളായി,0,0,1,1
11698,relecture,0,0,1,1
11728,​​beetje,0,0,1,1
11700,рыночную,0,0,1,1
11702,أتضور,0,0,1,1
11703,borrar,0,0,1,1
11706,скачивания,0,0,1,1
11707,தாண்டின,0,0,1,1
11708,പതിപ്പുകളിൽ,0,0,1,1
11711,tarihinde,0,0,1,1
11714,സംബന്ധിക്കുന്ന,0,0,1,1
11715,avråder,0,0,1,1
11717,«wiki,0,0,1,1
11719,singlecelled,0,0,1,1
11720,aspekter,0,0,1,1
11724,liknandeknappen,0,0,1,1
11726,culte,0,0,1,1
11727,reparos,0,0,1,1
11755,தனித்து,0,0,1,1
11756,cedido,0,0,1,1
11757,blackbody,0,0,1,1
11759,маленький,0,0,1,1
11785,occupée…,0,0,1,1
11787,maddelerdir,0,0,1,1
11788,firent,0,0,1,1
11789,прецедентов —,0,0,1,1
11790,definitive,0,0,1,1
11792,повысили,0,0,1,1
11795,aleatória,0,0,1,1
11796,diepbedroefd,0,0,1,1
11798,блюд,0,0,1,1
11799,ಅಭ್ಯಾಸವನ್ನು,0,0,1,1
11800,للمجتمع,0,0,1,1
11805,ಕಾರ್ಯಯೋಜನೆಗಳಿವೆ,0,0,1,1
11808,funcionalidad,0,0,1,1
11810,ಕೋಪಗೊಂಡಿದೆ,0,0,1,1
11811,sujetb,0,0,1,1
11784,interrupt,0,0,1,1
11783,concluding,0,0,1,1
11782,«зверство»,0,0,1,1
11769,وfrench،,0,0,1,1
11761,kalitesi,0,0,1,1
11762,جادًا,0,0,1,1
11763,«ссылки,0,0,1,1
11764,exponencial,0,0,1,1
11767,zazaki,0,0,1,1
11768,cerebro,0,0,1,1
11770,goldman,0,0,1,1
11781,motsätter,0,0,1,1
11772,iletişimde,0,0,1,1
11775,программное,0,0,1,1
11776,instantáneo,0,0,1,1
11777,indispensables,0,0,1,1
11779,பார்ப்பேன்,0,0,1,1
11780,отбора,0,0,1,1
11699,عفوا؟,0,0,1,1
11697,clean,0,0,1,1
11813,outcomes,0,0,1,1
11623,hicieras,0,0,1,1
11626,installations,0,0,1,1
11627,ದೂರವಾಣಿ,0,0,1,1
11628,നിർത്തിയപ്പോൾ,0,0,1,1
11629,ತಟ್ಟೆಯಲ್ಲಿ,0,0,1,1
11630,argumentou,0,0,1,1
11632,காட்டவும்,0,0,1,1
11633,डिलीवरी,0,0,1,1
11634,paradigm,0,0,1,1
11637,suddenly,0,0,1,1
11638,prachtige,0,0,1,1
11639,bankaya,0,0,1,1
11641,guider,0,0,1,1
11643,webbgränssnitt,0,0,1,1
11644,darnos,0,0,1,1
11646,adeus,0,0,1,1
11625,താൽപ്പര്യമില്ല,0,0,1,1
11621,സൗകര്യം,0,0,1,1
11694,மனிதனும்,0,0,1,1
11620,değildir,0,0,1,1
11602,úteis,0,0,1,1
11603,колокольчика,0,0,1,1
11605,буквально,0,0,1,1
11606,πουλί,0,0,1,1
11608,பசியாக,0,0,1,1
11609,lösta,0,0,1,1
11610,antigüedad,0,0,1,1
11611,ದೂರು,0,0,1,1
11612,knepig,0,0,1,1
11613,ग्रिफ़िथ,0,0,1,1
11614,asegúrate,0,0,1,1
11615,പിന്നിൽ,0,0,1,1
11616,tillförlitligheten,0,0,1,1
11617,segredo,0,0,1,1
11618,riesigen,0,0,1,1
11647,¿de,0,0,1,1
11648,المقالة،,0,0,1,1
11649,издательством,0,0,1,1
11650,gåva,0,0,1,1
11675,théoriques,0,0,1,1
11676,κάνατε,0,0,1,1
11677,exprimées,0,0,1,1
11679,maintaining,0,0,1,1
11681,வைத்தீர்கள்,0,0,1,1
11682,главной,0,0,1,1
11683,emblématique,0,0,1,1
11684,chansons,0,0,1,1
11686,भारी,0,0,1,1
11687,opgezet,0,0,1,1
11688,ഇതിനായി,0,0,1,1
11689,envolvidas,0,0,1,1
11690,وولاية,0,0,1,1
11692,ignora,0,0,1,1
11693,स्कोप,0,0,1,1
11673,—en,0,0,1,1
11671,guerras,0,0,1,1
11670,absolument,0,0,1,1
11659,நாட்டிற்கு,0,0,1,1
11652,உதாரணமாகச்,0,0,1,1
11653,"
espanhol",0,0,1,1
11655,وصُفت,0,0,1,1
11656,വെട്ടി,0,0,1,1
11657,ദുഷ്പ്രവൃത്തി,0,0,1,1
11658,législationsu,0,0,1,1
11660,çarptığı,0,0,1,1
11669,സവിശേഷതയാണ്,0,0,1,1
11661,snabba,0,0,1,1
11662,مواضيع,0,0,1,1
11663,rasgos,0,0,1,1
11664,priority,0,0,1,1
11665,काट,0,0,1,1
11667,probations,0,0,1,1
11812,истина»,0,0,1,1
11814,weekendontdekking,0,0,1,1
12968,bètawetenschapper,0,0,1,1
11963,square,0,0,1,1
11966,ناه,0,0,1,1
11968,उर्फ,0,0,1,1
11969,للتدرب,0,0,1,1
11971,выпустило,0,0,1,1
11972,نقاش,0,0,1,1
11974,fédérales,0,0,1,1
11975,അസാധ്യമായ,0,0,1,1
11987,вручении,0,0,1,1
11991,பேசலாம்,0,0,1,1
11992,fondamental,0,0,1,1
11993,behandlade,0,0,1,1
11994,angives,0,0,1,1
11999,весело»,0,0,1,1
12000,lebender,0,0,1,1
12002,وثلاثة,0,0,1,1
11965,elk,0,0,1,1
11962,nyhetsmedia,0,0,1,1
11932,harboring,0,0,1,1
11959,borç,0,0,1,1
11934,κεφάλι,0,0,1,1
11936,publiceras,0,0,1,1
11938,انتقل,0,0,1,1
11939,оставайтесь,0,0,1,1
11943,apropriada,0,0,1,1
11944,preferences,0,0,1,1
11946,pornografiska,0,0,1,1
11948,اللازم,0,0,1,1
11950,jornada,0,0,1,1
11951,fniser,0,0,1,1
11952,nat,0,0,1,1
11953,sølv,0,0,1,1
11956,i̇çeriğinin,0,0,1,1
11957,благонамеренных,0,0,1,1
11958,fundamentalmente,0,0,1,1
12005,exception,0,0,1,1
12006,معنا,0,0,1,1
12007,टोफेल,0,0,1,1
12008,والآخر,0,0,1,1
12034,அனைவரையும்,0,0,1,1
12035,hayal,0,0,1,1
12036,اصطدمت,0,0,1,1
12037,одну,0,0,1,1
12038,çevrilmiş,0,0,1,1
12040,lorsqu,0,0,1,1
12046,статистическим,0,0,1,1
12047,förklaringen,0,0,1,1
12048,sahte,0,0,1,1
12049,historiens »,0,0,1,1
12053,വിശാലവും,0,0,1,1
12054,இக்கட்டுரைகளில்,0,0,1,1
12057,corridor,0,0,1,1
12060,padronizações,0,0,1,1
12061,εγγενείς,0,0,1,1
12033,berömmet,0,0,1,1
12030,βυθίζεται,0,0,1,1
12029,søgningen,0,0,1,1
12017,umgangssprachlich,0,0,1,1
12009,webbserver,0,0,1,1
12011,വിക്കിപീഡിയൻ,0,0,1,1
12013,articulação,0,0,1,1
12014,pequeno,0,0,1,1
12015,ഡാറ്റയാണ്,0,0,1,1
12016,descrever,0,0,1,1
12018,التنسيق,0,0,1,1
12028,floride,0,0,1,1
12020,περιοχή,0,0,1,1
12022,¿quién,0,0,1,1
12023,πέντε,0,0,1,1
12024,rapporterade,0,0,1,1
12025,inégalités,0,0,1,1
12027,തത്ത്വത്തിലാണ്,0,0,1,1
11933,archieven,0,0,1,1
11930,ചോദിക്കണമെങ്കിൽ,0,0,1,1
11815,ماء؟,0,0,1,1
11841,territoires,0,0,1,1
11848,puinhoop,0,0,1,1
11849,oradan,0,0,1,1
11852,στρατιώτες,0,0,1,1
11853,probabilidad,0,0,1,1
11854,vriendinnen,0,0,1,1
11855,ekleyerek,0,0,1,1
11856,hellen,0,0,1,1
11857,starting,0,0,1,1
11858,मर्दानी,0,0,1,1
11860,ಹಾಕಿದರೆ,0,0,1,1
11861,telefoneren,0,0,1,1
11862,அறிவுள்ள,0,0,1,1
11864,μπράβο,0,0,1,1
11865,والصحفي,0,0,1,1
11866,ദേഷ്യപ്പെടുന്നു,0,0,1,1
11846,பிப்ரவரியில்,0,0,1,1
11839,расширений,0,0,1,1
11927,emenda,0,0,1,1
11838,rencontrez,0,0,1,1
11816,französische,0,0,1,1
11817,hug,0,0,1,1
11818,طرف,0,0,1,1
11819,odds,0,0,1,1
11820,vandálicas,0,0,1,1
11821,bulundurur,0,0,1,1
11822,uitwezen,0,0,1,1
11823,parmaklarımda,0,0,1,1
11828,istemeyeceğini,0,0,1,1
11829,yiyemiyorum,0,0,1,1
11831,போகலாம்,0,0,1,1
11832,perfil,0,0,1,1
11833,نوعًا,0,0,1,1
11834,تحطمت,0,0,1,1
11835,träna,0,0,1,1
11868,rörde,0,0,1,1
11869,മാനഭംഗക്കേസുകളിൽ,0,0,1,1
11871,uykusunda,0,0,1,1
11874,brev,0,0,1,1
11905,encantaría,0,0,1,1
11906,deletion,0,0,1,1
11907,مستهلك,0,0,1,1
11908,ईमेल,0,0,1,1
11910,ദുസ്വപ്നം,0,0,1,1
11911,διακόπτει,0,0,1,1
11912,കന്നഡ,0,0,1,1
11914,ഇക്കാലത്ത്,0,0,1,1
11917,atrás,0,0,1,1
11918,وبين موسوعة,0,0,1,1
11919,id •,0,0,1,1
11922,चुपके,0,0,1,1
11923,evitan,0,0,1,1
11924,relaterede,0,0,1,1
11925,друзьям,0,0,1,1
11904,agrupan,0,0,1,1
11903,åttonde,0,0,1,1
11902,تدريجية,0,0,1,1
11886,കൊണ്ടിരുന്ന,0,0,1,1
11876,χάος,0,0,1,1
11877,ലഭിക്കില്ല,0,0,1,1
11879,моей,0,0,1,1
11880,ética,0,0,1,1
11881,направляемых,0,0,1,1
11882,புளூமாக்ஸாக,0,0,1,1
11887,ഉത്തരം,0,0,1,1
11901,crystallize,0,0,1,1
11891,sauvegardes,0,0,1,1
11892,seriøst,0,0,1,1
11894,utbildning,0,0,1,1
11896,സവാരിക്ക്,0,0,1,1
11897,вправе,0,0,1,1
11898,നിർമ്മിക്കുവാനുള്ള,0,0,1,1
11601,порнографическими,0,0,1,1
11600,لمنتدى,0,0,1,1
11599,bitecek,0,0,1,1
11266,منزعج,0,0,1,1
11269,ಒಳ್ಳೆಯವರಂತೆ,0,0,1,1
11270,точный,0,0,1,1
11271,acarrearía,0,0,1,1
11274,terfi,0,0,1,1
11275,instalaciones,0,0,1,1
11277,отрицательное,0,0,1,1
11278,"
वैनितियाई",0,0,1,1
11279,परिभाषायें,0,0,1,1
11280,jardim,0,0,1,1
11281,passede,0,0,1,1
11285,éditoriale ,0,0,1,1
11286,« modifications,0,0,1,1
11288,isologo,0,0,1,1
11289,إضافية,0,0,1,1
11291,ಕರೆಯಲು,0,0,1,1
11268,married,0,0,1,1
11264,ഉദ്യമമായി,0,0,1,1
11239,baja,0,0,1,1
11263,recommends,0,0,1,1
11241,soluciones,0,0,1,1
11242,desastrosas,0,0,1,1
11245,μπερδέψα,0,0,1,1
11246,ಮಾಡಲ್ಪಟ್ಟಿದೆ,0,0,1,1
11247,fastslog,0,0,1,1
11249,ஒருவரைச்,0,0,1,1
11250,ändrat,0,0,1,1
11251,poses,0,0,1,1
11252,idi,0,0,1,1
11253,estime,0,0,1,1
11254,testar,0,0,1,1
11255,gebe,0,0,1,1
11259,बेस्ट,0,0,1,1
11260,udtale,0,0,1,1
11261,естественнонаучной,0,0,1,1
11294,färdade,0,0,1,1
11295,புரிந்துகொண்டிருந்தால்,0,0,1,1
11296,പ്രത്യേകതയാണ്,0,0,1,1
11299,merveilleux,0,0,1,1
11330,environnementales,0,0,1,1
11331,expanding,0,0,1,1
11332,ಉತ್ತರಿಸಲು,0,0,1,1
11335,ayúdame,0,0,1,1
11337,التأثير,0,0,1,1
11338,louco,0,0,1,1
11343,рэнди,0,0,1,1
11347,desistindo,0,0,1,1
11349,adaptable,0,0,1,1
11350,सइबरआर्ट्स,0,0,1,1
11351,"
dinamarquês",0,0,1,1
11352,såvitt,0,0,1,1
11354,zur,0,0,1,1
11356,prometteuses,0,0,1,1
11358,aniden,0,0,1,1
11329,opportunity,0,0,1,1
11328,خاصةً,0,0,1,1
11327,forneça,0,0,1,1
11312,supplies,0,0,1,1
11301,portugais,0,0,1,1
11304,لديهما,0,0,1,1
11306,ακούτε,0,0,1,1
11307,castle,0,0,1,1
11310,pesquisando,0,0,1,1
11311,основных,0,0,1,1
11316,occurrences,0,0,1,1
11326,ಕೈದಿಗಳಿಗೆ,0,0,1,1
11317,beundrende,0,0,1,1
11318,ചെയ്യുന്നതായി,0,0,1,1
11321,некоммерческим,0,0,1,1
11322,packen,0,0,1,1
11323,норманом,0,0,1,1
11324,التحليلات,0,0,1,1
11240,br •,0,0,1,1
11238,attribuent,0,0,1,1
11598,pişirmeme,0,0,1,1
11165,மென்மையாகவும்,0,0,1,1
11167,моих,0,0,1,1
11168,därefter,0,0,1,1
11169,exposition,0,0,1,1
11171,vinkade,0,0,1,1
11173,econômica,0,0,1,1
11175,discordo,0,0,1,1
11176,åkte,0,0,1,1
11177,पर्सन,0,0,1,1
11181,പടയാളികളും,0,0,1,1
11182,bedecken,0,0,1,1
11183,zukam,0,0,1,1
11184,ಸರಿಯಾಗಿರುತ್ತೇನೆ,0,0,1,1
11185,легче,0,0,1,1
11186,waarbij,0,0,1,1
11187,هيلر,0,0,1,1
11166,ситуаций,0,0,1,1
11163,geçiyor,0,0,1,1
11236,وقف,0,0,1,1
11162,saint,0,0,1,1
11142,därifrån,0,0,1,1
11143,uninitiated,0,0,1,1
11145,കാണാത്തപ്പോൾ‌,0,0,1,1
11146,evolucionan,0,0,1,1
11147,zamanlarda,0,0,1,1
11148,നിർഭാഗ്യവശാൽ,0,0,1,1
11149,അഭിനന്ദനങ്ങൾ,0,0,1,1
11150,"है।
हालाँकि",0,0,1,1
11151,قوانين,0,0,1,1
11153,annotera,0,0,1,1
11155,غمرني,0,0,1,1
11157,geological,0,0,1,1
11158,മാനസികമായി,0,0,1,1
11159,قادم,0,0,1,1
11160,استطعت,0,0,1,1
11188,couches ,0,0,1,1
11190,shelf,0,0,1,1
11191,ಹೆಣಗಾಡುತ್ತಿದ್ದ,0,0,1,1
11193,اختصار,0,0,1,1
11218,மனிதர்களாக,0,0,1,1
11219,"
रूसी",0,0,1,1
11220,kaynaklı,0,0,1,1
11222,автобус,0,0,1,1
11223,avsevärt,0,0,1,1
11224,центром,0,0,1,1
11225,изменяется,0,0,1,1
11226,وتحرير,0,0,1,1
11228,divulgada,0,0,1,1
11229,demostró,0,0,1,1
11231,compliquée,0,0,1,1
11232,упоминай,0,0,1,1
11233,ستعجبك,0,0,1,1
11234,сделан,0,0,1,1
11235,appropriée,0,0,1,1
11217,gebrauchen,0,0,1,1
11215,fysiska,0,0,1,1
11214,состоящих,0,0,1,1
11203,licensor,0,0,1,1
11194,नीतियां।,0,0,1,1
11196,புயல்,0,0,1,1
11199,indian,0,0,1,1
11200,tvivl,0,0,1,1
11201,iran,0,0,1,1
11202,поддерживающей,0,0,1,1
11204,இல்லாது,0,0,1,1
11213,evidencia,0,0,1,1
11206,coğrafyada,0,0,1,1
11207,വരുമ്പോൾ,0,0,1,1
11208,classé,0,0,1,1
11209,wikifika,0,0,1,1
11210,hegemony,0,0,1,1
11211,underbar,0,0,1,1
11359,impureza,0,0,1,1
11360,organisée,0,0,1,1
11361,opeten,0,0,1,1
11514,climatique,0,0,1,1
11516,skapades,0,0,1,1
11517,العلوم في,0,0,1,1
11519,nono,0,0,1,1
11521,soruyorsa,0,0,1,1
11522,fortsætte,0,0,1,1
11524,गिलास,0,0,1,1
11525,relevantes,0,0,1,1
11526,நலமாக,0,0,1,1
11527,विकिमिडिया,0,0,1,1
11528,‘மைக்கேல்,0,0,1,1
11529,وصيغة,0,0,1,1
11531,apoiam,0,0,1,1
11532,ನೋಡಿಕೊಳ್ಳಿ,0,0,1,1
11533,விளைவிக்கக்கூடிய,0,0,1,1
11536,செயற்படுகிறது,0,0,1,1
11515,مهذبًا,0,0,1,1
11512,celebrates,0,0,1,1
11363,يصفون,0,0,1,1
11511,योग्यता,0,0,1,1
11487,общедоступная,0,0,1,1
11489,guldgyldent,0,0,1,1
11490,renvoie,0,0,1,1
11491,tribunais,0,0,1,1
11492,bovendien,0,0,1,1
11493,"ശാസ്ത്രം ·
geosciences ·
soil",0,0,1,1
11494,dérangeraitil,0,0,1,1
11497,extractos,0,0,1,1
11499,исследованиях,0,0,1,1
11500,gyldent,0,0,1,1
11501,géré,0,0,1,1
11502,pologne,0,0,1,1
11507,interwikilänkar,0,0,1,1
11509,अपमान,0,0,1,1
11510,ಡ್ರೈವಾಲ್,0,0,1,1
11537,organismes,0,0,1,1
11538,mécaniste,0,0,1,1
11539,أدرك,0,0,1,1
11540,végétal,0,0,1,1
11576,zangado,0,0,1,1
11578,hızlıca,0,0,1,1
11579,soutenue,0,0,1,1
11580,बिग,0,0,1,1
11582,språkupplagan,0,0,1,1
11584,adivinhar,0,0,1,1
11585,कैलीफ़ोर्निया,0,0,1,1
11586,välkommen,0,0,1,1
11587,والرجل,0,0,1,1
11588,وديسمبر,0,0,1,1
11589,красивый,0,0,1,1
11590,üzgün,0,0,1,1
11591,സമ്പർക്കം,0,0,1,1
11594,aconsejando,0,0,1,1
11596,πολιτική,0,0,1,1
11575,yakalanma,0,0,1,1
11570,journée,0,0,1,1
11569,greetings,0,0,1,1
11555,μάθουμε,0,0,1,1
11545,riskerar,0,0,1,1
11550,γνωστό,0,0,1,1
11551,താഴെയാണ്,0,0,1,1
11552,تعليقات,0,0,1,1
11553,குனூ,0,0,1,1
11554,അസ്വസ്ഥനാകരുതെന്ന്,0,0,1,1
11556,chanceuse,0,0,1,1
11567,foreslå,0,0,1,1
11557,cerveaumachine ,0,0,1,1
11560,internetbaserede,0,0,1,1
11561,плачешь,0,0,1,1
11562,negras,0,0,1,1
11564,calculated,0,0,1,1
11565,പരിഹാരത്തിനുപകരം,0,0,1,1
11485,dürüst,0,0,1,1
11480,വിഷയങ്ങളിലുള്ള,0,0,1,1
11479,colloquial,0,0,1,1
11420,sétimo,0,0,1,1
11391,cifras,0,0,1,1
11394,parecían,0,0,1,1
11396,contém,0,0,1,1
11397,consultar,0,0,1,1
11399,fiables»,0,0,1,1
11401,quantity,0,0,1,1
11402,ζητήσετε,0,0,1,1
11403,أعداد,0,0,1,1
11406,سترى,0,0,1,1
11407,israeli,0,0,1,1
11408,tekniske,0,0,1,1
11410,niche,0,0,1,1
11411,varken,0,0,1,1
11413,biotechnologies,0,0,1,1
11416,contraditórias,0,0,1,1
11389,diciéndola,0,0,1,1
11388,அழுகிறீர்கள்,0,0,1,1
11387,البيتزا,0,0,1,1
11376,sevmesiydi,0,0,1,1
11364,ಎರಡನೆಯ,0,0,1,1
11367,прощения,0,0,1,1
11368,​​het,0,0,1,1
11372,εξηγήστε,0,0,1,1
11374,ഉച്ചഭക്ഷണത്തിന്,0,0,1,1
11375,ограничиваются,0,0,1,1
11377,offensantes,0,0,1,1
11385,بأدوار,0,0,1,1
11378,classificatie,0,0,1,1
11380,semantics,0,0,1,1
11381,dukker,0,0,1,1
11382,kullanılmak,0,0,1,1
11383,minimum,0,0,1,1
11384,بثبات,0,0,1,1
11417,зависит,0,0,1,1
11421,موجودة,0,0,1,1
11477,नॉर्वेजियाई,0,0,1,1
11422,تحته,0,0,1,1
11454,marche,0,0,1,1
11455,ಮೂವರು,0,0,1,1
11456,крупный,0,0,1,1
11457,kartofler,0,0,1,1
11458,τραγούδια,0,0,1,1
11460,höger,0,0,1,1
11461,conversely,0,0,1,1
11462,accepteres,0,0,1,1
11463,ചതുപ്പുനിലത്തിന്,0,0,1,1
11464,aprendido,0,0,1,1
11467,donaties,0,0,1,1
11468,رابطًا,0,0,1,1
11470,uzlaşamamasına,0,0,1,1
11472,அழகிய,0,0,1,1
11473,തങ്ങൾക്ക്,0,0,1,1
11453,البلدان,0,0,1,1
11450,جئت,0,0,1,1
11449,allgemeinen,0,0,1,1
11434,сайтов,0,0,1,1
11425,அழகு,0,0,1,1
11426,διάφορες,0,0,1,1
11427,achte,0,0,1,1
11429,nämns,0,0,1,1
11432,ανοικτό,0,0,1,1
11433,использует,0,0,1,1
11436,mejores,0,0,1,1
11448,μάθει,0,0,1,1
11438,νοιαζόταν,0,0,1,1
11441,தனி,0,0,1,1
11442,सौ,0,0,1,1
11444,बुलाया,0,0,1,1
11445,изучали,0,0,1,1
11446,"
लाडिनो",0,0,1,1
12065,spain,0,0,1,1
12066,профессионализму,0,0,1,1
12067,ಪ್ರಕಾರ,0,0,1,1
12666,beds,0,0,1,1
12668,"
नाहुआतल",0,0,1,1
12669,എന്നെഴുതുന്നു,0,0,1,1
12670,வகையை,0,0,1,1
12671,apesar,0,0,1,1
12672,dizerme,0,0,1,1
12673,cömert,0,0,1,1
12674,utformad,0,0,1,1
12675,ഓർഗനൈസേഷൻ,0,0,1,1
12676,ieder,0,0,1,1
12677,negotiating,0,0,1,1
12679,intentado,0,0,1,1
12680,بحجب,0,0,1,1
12681,salyangoz,0,0,1,1
12682,çıkarmaktadır,0,0,1,1
12683,neutralt,0,0,1,1
12667,separation,0,0,1,1
12665,recaudación,0,0,1,1
12634,normaal,0,0,1,1
12664,erwähne,0,0,1,1
12640,kinesisk,0,0,1,1
12642,ഫാൻസി,0,0,1,1
12644,واجب,0,0,1,1
12647,zenginliği,0,0,1,1
12648,बिन्दु,0,0,1,1
12650,التصنيف,0,0,1,1
12652,arborescente,0,0,1,1
12653,вечера,0,0,1,1
12654,кофе,0,0,1,1
12656,ഏറെ,0,0,1,1
12657,"
पंजाबी",0,0,1,1
12659,знака,0,0,1,1
12660,asustado,0,0,1,1
12661,ledere,0,0,1,1
12663,opdoen,0,0,1,1
12684,bake,0,0,1,1
12685,единственным,0,0,1,1
12686,пошли,0,0,1,1
12687,yapın,0,0,1,1
12715,ಇದೀಗ,0,0,1,1
12716,ഓണത്തെപ്പറ്റി,0,0,1,1
12717,ondernemer,0,0,1,1
12719,egenintresse,0,0,1,1
12724,описанные,0,0,1,1
12725,diyorsun,0,0,1,1
12726,سريعة,0,0,1,1
12728,figures,0,0,1,1
12729,بإصدارات,0,0,1,1
12730,вернуться,0,0,1,1
12731,utgivningsbevis,0,0,1,1
12732,связаны,0,0,1,1
12734,എടുത്താൽ,0,0,1,1
12735,соль,0,0,1,1
12736,निर्देशांक,0,0,1,1
12714,latijn,0,0,1,1
12713,ಸುಂದರವಾಗಿದ್ದರು,0,0,1,1
12712,ಮೈಲಿಗೆ,0,0,1,1
12696,ನಿದ್ರೆಯಲ್ಲಿ,0,0,1,1
12689,frågades,0,0,1,1
12691,rein,0,0,1,1
12692,нос,0,0,1,1
12693,genomsnitt,0,0,1,1
12694,الرابع,0,0,1,1
12695,συνδυασμό,0,0,1,1
12699,ನೆಚ್ಚಿನ,0,0,1,1
12711,augmenter,0,0,1,1
12700,beğeneceğinizi,0,0,1,1
12704,traînes,0,0,1,1
12705,artikelsidan,0,0,1,1
12706,rigorosos,0,0,1,1
12707,hänvisningar,0,0,1,1
12709,സമീപകാല,0,0,1,1
12639,arkadaşların,0,0,1,1
12632,gestionar,0,0,1,1
12523,नवाचार,0,0,1,1
12547,gamle,0,0,1,1
12552,ಎಸ್‌ಎಂಎಸ್,0,0,1,1
12553,ഘട്ടത്തിലും,0,0,1,1
12554,pájaro,0,0,1,1
12556,ആദ്യത്തേത്,0,0,1,1
12557,επαγγελματική,0,0,1,1
12558,fournit,0,0,1,1
12559,étonnée,0,0,1,1
12560,autopromoción»​,0,0,1,1
12561,"
सर्बोक्रोएशियाई",0,0,1,1
12562,descentralizada,0,0,1,1
12563,uppnå,0,0,1,1
12564,suites,0,0,1,1
12566,நுபீடியாவானது,0,0,1,1
12567,വന്നത്,0,0,1,1
12569,voudrais,0,0,1,1
12551,गारंटी,0,0,1,1
12546,партнёрства,0,0,1,1
12631,обеспечению,0,0,1,1
12545,retain,0,0,1,1
12525,assistants,0,0,1,1
12526,упомянули,0,0,1,1
12527,pior,0,0,1,1
12529,opérationnelle,0,0,1,1
12530,sprogversion,0,0,1,1
12531,conquistas,0,0,1,1
12534,mechanisms,0,0,1,1
12535,ancestry,0,0,1,1
12536,аналогична,0,0,1,1
12537,tide,0,0,1,1
12538,stöd,0,0,1,1
12539,gekichert,0,0,1,1
12540,മാളിൽ,0,0,1,1
12541,bilda,0,0,1,1
12543,cbn,0,0,1,1
12570,naviguer,0,0,1,1
12572,неделю,0,0,1,1
12573,утонченный,0,0,1,1
12574,।flummoxed,0,0,1,1
12599,ölüyorum,0,0,1,1
12601,choice,0,0,1,1
12606,കേട്ടിരിക്കാം,0,0,1,1
12607,prétentieux,0,0,1,1
12609,கொள்கையாக,0,0,1,1
12612,déclaré,0,0,1,1
12615,സേർച്ച്,0,0,1,1
12616,مذهلًا,0,0,1,1
12617,സംവിധാനമാണ്‌,0,0,1,1
12618,nn •,0,0,1,1
12621,folga,0,0,1,1
12622,«мне,0,0,1,1
12623,dolu,0,0,1,1
12629,lagstiftning,0,0,1,1
12630,مختلف,0,0,1,1
12597,पूछना,0,0,1,1
12596,handlung,0,0,1,1
12595,جزءًا,0,0,1,1
12582,socio,0,0,1,1
12575,föremål,0,0,1,1
12576,medicinal,0,0,1,1
12577,viu,0,0,1,1
12578,καθένα,0,0,1,1
12579,النقاد,0,0,1,1
12580,öğreniyorsan,0,0,1,1
12584,لتبدو,0,0,1,1
12593,cinste,0,0,1,1
12585,rato,0,0,1,1
12586,olun,0,0,1,1
12588,ಕಾಫಿಯನ್ನು,0,0,1,1
12590,ontzagwekkende,0,0,1,1
12591,γεμίσουμε,0,0,1,1
12592,अलेक्सा,0,0,1,1
12737,урегулирования,0,0,1,1
12738,premiada,0,0,1,1
12741,ரொட்டியுடன்,0,0,1,1
12884,uhøfligt,0,0,1,1
12887,ipadressen,0,0,1,1
12888,forming,0,0,1,1
12890,principios​,0,0,1,1
12894,компьютерные,0,0,1,1
12895,добровольцев»,0,0,1,1
12896,ಪುರುಷರು,0,0,1,1
12898,sözcüğü,0,0,1,1
12900,specialized,0,0,1,1
12902,wakker,0,0,1,1
12903,имеется,0,0,1,1
12904,docka,0,0,1,1
12905,القادم؟,0,0,1,1
12908,gruwelijk,0,0,1,1
12909,влиятельных,0,0,1,1
12910,silber,0,0,1,1
12886,nachts,0,0,1,1
12882,sendes,0,0,1,1
12742,death,0,0,1,1
12878,necesaria—,0,0,1,1
12856,presenterats,0,0,1,1
12858,bogen,0,0,1,1
12860,ചെയ്തതുമായ,0,0,1,1
12863,जाएगी।,0,0,1,1
12864,hongrois,0,0,1,1
12865,വിലകൾക്ക്,0,0,1,1
12866,आलोचनाओं,0,0,1,1
12868,einschließlich,0,0,1,1
12869,tim,0,0,1,1
12871,μνηστήρες,0,0,1,1
12872,adicionou,0,0,1,1
12873,ചോദിക്കുന്നുണ്ടെങ്കിൽ,0,0,1,1
12874,библиотека,0,0,1,1
12875,अभिवादन,0,0,1,1
12877,முரட்டுத்தனமாக,0,0,1,1
12911,asiáticas,0,0,1,1
12912,விருந்தில்,0,0,1,1
12914,اللحظة,0,0,1,1
12916,faune,0,0,1,1
12942,altruista—,0,0,1,1
12943,espalhar,0,0,1,1
12944,manifestant,0,0,1,1
12946,ബാങ്കിനോട്,0,0,1,1
12950,पैसे,0,0,1,1
12952,സാധ്യമാക്കുന്ന,0,0,1,1
12954,يتعاونون,0,0,1,1
12955,namorada,0,0,1,1
12958,மற்றொன்று,0,0,1,1
12960,നാണ്,0,0,1,1
12961,helpful,0,0,1,1
12962,ബുദ്ധിശൂന്യമാണെന്ന്,0,0,1,1
12963,declining,0,0,1,1
12964,kurallarında,0,0,1,1
12966,ಪದಗಳಿಗಿಂತ,0,0,1,1
12941,повсеместная,0,0,1,1
12940,ahogamiento,0,0,1,1
12938,பாரம்பரியக்,0,0,1,1
12927,تقتصر,0,0,1,1
12917,बेकार,0,0,1,1
12918,"
योरूबा",0,0,1,1
12920,estabelecida,0,0,1,1
12922,söylemeyi,0,0,1,1
12924,मिलेंगे।,0,0,1,1
12925,ಹೊರಬಂದು,0,0,1,1
12928,vardığında,0,0,1,1
12937,основанием,0,0,1,1
12930,मेटाविकी,0,0,1,1
12931,тобой,0,0,1,1
12933,குறிக்க,0,0,1,1
12934,σκεφτώ,0,0,1,1
12935,soumises,0,0,1,1
12936,encontrarme,0,0,1,1
12853,sponges,0,0,1,1
12852,palais,0,0,1,1
12851,когонибудь,0,0,1,1
12789,أصليًا,0,0,1,1
12769,образовательном,0,0,1,1
12770,கொண்டுள்ளேன்,0,0,1,1
12772,πρώτος,0,0,1,1
12774,"
basquir",0,0,1,1
12776,നിങ്ങൾക്കാവശ്യമുള്ളതെന്തും,0,0,1,1
12777,satírico,0,0,1,1
12778,fairness,0,0,1,1
12779,காலை,0,0,1,1
12780,sœur,0,0,1,1
12781,والآراء,0,0,1,1
12783,ആവേശത്തിലാണ്,0,0,1,1
12784,скромной,0,0,1,1
12785,cartes,0,0,1,1
12786,достоинств,0,0,1,1
12787,salutations,0,0,1,1
12767,தலையில்,0,0,1,1
12766,अकाउंट,0,0,1,1
12764,அறிவும்,0,0,1,1
12751,subversivos,0,0,1,1
12743,stad,0,0,1,1
12744,нарциссизм,0,0,1,1
12746,وإزالة,0,0,1,1
12747,"വിക്കി
",0,0,1,1
12748,அண்மையில்,0,0,1,1
12750,erste,0,0,1,1
12752,κάποτε,0,0,1,1
12763,fahre,0,0,1,1
12753,detektere,0,0,1,1
12754,இத்திட்டத்தின்,0,0,1,1
12755,kloonwebsites,0,0,1,1
12756,анонимного,0,0,1,1
12759,intrinsically,0,0,1,1
12762,നിങ്ങളെപ്പോലെ,0,0,1,1
12788,gösterenlerin,0,0,1,1
12791,نيويورك،,0,0,1,1
12848,மனிதர்,0,0,1,1
12793,ಪ್ರಸ್ತಾಪವನ್ನು,0,0,1,1
12826,राजनीतिक,0,0,1,1
12827,ಕೇಳುತ್ತಿರಲಿಲ್ಲ,0,0,1,1
12828,symbolicknowledgebased,0,0,1,1
12832,அமைப்பதாக,0,0,1,1
12834,ربطها,0,0,1,1
12835,ತಿನ್ನು,0,0,1,1
12836,выполняя,0,0,1,1
12838,nudity,0,0,1,1
12839,discernir,0,0,1,1
12840,geoinformação,0,0,1,1
12841,топологий,0,0,1,1
12842,متعارضين,0,0,1,1
12844,contacto,0,0,1,1
12845,ಬಂದಿದ್ದರು,0,0,1,1
12846,kaba,0,0,1,1
12825,எங்கே,0,0,1,1
12822,incorporación,0,0,1,1
12821,കൊണ്ട്,0,0,1,1
12804,κέρδισε,0,0,1,1
12795,референдум,0,0,1,1
12798,alternates,0,0,1,1
12799,ബുദ്ധിശൂന്യമോ,0,0,1,1
12800,syftar,0,0,1,1
12801,successives,0,0,1,1
12802,квартале,0,0,1,1
12806,ecstatic,0,0,1,1
12820,defendam,0,0,1,1
12810,dalaïlamaréf,0,0,1,1
12811,வீட்டுப்பாடம்,0,0,1,1
12813,corroborado,0,0,1,1
12814,كويكب،,0,0,1,1
12816,английского,0,0,1,1
12818,மகிழ்ச்சியற்றதையும்,0,0,1,1
12524,ചിലമേഖലകളെ,0,0,1,1
12517,metamorphosed,0,0,1,1
12068,menino,0,0,1,1
12214,seriously,0,0,1,1
12216,aispecific,0,0,1,1
12218,வேலையும்,0,0,1,1
12219,അനാശാസ്യമായ,0,0,1,1
12220,άλλαξε,0,0,1,1
12222,تلتقي,0,0,1,1
12223,maravilloso,0,0,1,1
12227,двенадцатитомное,0,0,1,1
12228,അസന്തുഷ്ടിയും,0,0,1,1
12232,ಎದೆಗುಂದಿದಳು,0,0,1,1
12233,идете,0,0,1,1
12236,ciencia,0,0,1,1
12239,попадете,0,0,1,1
12240,βάση,0,0,1,1
12241,ydmyg,0,0,1,1
12243,преуспевать,0,0,1,1
12215,объёмов,0,0,1,1
12213,എന്നില്ല,0,0,1,1
12187,dinî,0,0,1,1
12211,أتفق,0,0,1,1
12191,epostadress,0,0,1,1
12193,catalyst,0,0,1,1
12194,funciones—,0,0,1,1
12196,طاقة,0,0,1,1
12198,sabırla,0,0,1,1
12199,assumed,0,0,1,1
12200,മലയാളത്തിൽ,0,0,1,1
12201,கீழேயுள்ள,0,0,1,1
12203,filtrerades,0,0,1,1
12204,abiertas,0,0,1,1
12205,произведённых,0,0,1,1
12206,പരിപാലിക്കുക,0,0,1,1
12208,« article,0,0,1,1
12209,relaterade,0,0,1,1
12210,βυθιστεί,0,0,1,1
12244,എഴുത്തുകാരുടേയും,0,0,1,1
12247,сотрудничестве,0,0,1,1
12248,purposefully,0,0,1,1
12249,tilbud,0,0,1,1
12276,редакционную,0,0,1,1
12277,ತಿರಸ್ಕರಿಸಿದಳು,0,0,1,1
12279,outre,0,0,1,1
12280,acıktım,0,0,1,1
12281,apprenant,0,0,1,1
12282,للزواج,0,0,1,1
12284,instalado,0,0,1,1
12285,μαρίνα,0,0,1,1
12286,യു,0,0,1,1
12287,नोल,0,0,1,1
12289,physicochimiques,0,0,1,1
12291,conformada,0,0,1,1
12292,ಟೆಲಿಗ್ರಾಮ್,0,0,1,1
12293,பிரமாதமாக,0,0,1,1
12294,mr •,0,0,1,1
12275,அழைக்க,0,0,1,1
12274,خططًا,0,0,1,1
12273,onları,0,0,1,1
12260,portrayals,0,0,1,1
12250,beweisen,0,0,1,1
12251,ಪ್ರಜ್ಞೆಯು,0,0,1,1
12252,galardones,0,0,1,1
12253,skickade,0,0,1,1
12254,snygga,0,0,1,1
12255,entgegen,0,0,1,1
12261,istemediğimde,0,0,1,1
12271,aussprechen,0,0,1,1
12262,föreslår,0,0,1,1
12265,n’existait,0,0,1,1
12266,الفظة,0,0,1,1
12267,cuidas,0,0,1,1
12268,problemas​,0,0,1,1
12270,होमवर्क,0,0,1,1
12190,tab,0,0,1,1
12185,recht,0,0,1,1
12516,asociación,0,0,1,1
12102,прогнозирования,0,0,1,1
12105,التجاري,0,0,1,1
12106,പുരുഷന്മാർ,0,0,1,1
12107,классические,0,0,1,1
12108,разочарованием,0,0,1,1
12110,reconocía,0,0,1,1
12112,ನಿಲ್ಲಿಸಿದಂತೆ,0,0,1,1
12113,dê,0,0,1,1
12115,soudainement,0,0,1,1
12117,भागीदार,0,0,1,1
12118,состояние,0,0,1,1
12119,başlangıçtan,0,0,1,1
12121,signera,0,0,1,1
12123,உற்சாகமான,0,0,1,1
12124,உணவிற்கு,0,0,1,1
12126,spejlet,0,0,1,1
12104,लगाती,0,0,1,1
12099,gerou,0,0,1,1
12184,compartilhada,0,0,1,1
12098,இருவருக்கும்,0,0,1,1
12069,περιλαμβάνει,0,0,1,1
12071,intellectuel,0,0,1,1
12075,cut,0,0,1,1
12079,visent,0,0,1,1
12080,façam,0,0,1,1
12082,seixas,0,0,1,1
12083,अवरुद्ध,0,0,1,1
12084,процессу,0,0,1,1
12087,européens,0,0,1,1
12090,अच्छा।,0,0,1,1
12091,yeterince,0,0,1,1
12092,தோட்டத்தில்,0,0,1,1
12093,volvió,0,0,1,1
12096,ζώο,0,0,1,1
12097,ಹೇಳುತ್ತದೆ,0,0,1,1
12129,تطوّر,0,0,1,1
12131,impedir,0,0,1,1
12133,planning,0,0,1,1
12134,بكونها,0,0,1,1
12160,meningsfulla,0,0,1,1
12161,يقتصر,0,0,1,1
12164,ചെയ്തിരിക്കുന്ന,0,0,1,1
12165,igennem,0,0,1,1
12166,injurieuse,0,0,1,1
12168,ನಾಮಪದವಾಗಿ,0,0,1,1
12169,λειτουργήσει,0,0,1,1
12172,discuta,0,0,1,1
12173,colonies,0,0,1,1
12175,കൊള്ളാം,0,0,1,1
12176,talihlerin,0,0,1,1
12178,nécessite,0,0,1,1
12179,يهدف,0,0,1,1
12180,ആകസ്‌മിക,0,0,1,1
12183,vaguely,0,0,1,1
12159,பயமாக,0,0,1,1
12157,вкратце,0,0,1,1
12155,திருமண,0,0,1,1
12144,berömda,0,0,1,1
12136,வினை,0,0,1,1
12138,préoccupe,0,0,1,1
12139,medfølgende,0,0,1,1
12140,ശ്രദ്ധിക്കുന്നു,0,0,1,1
12141,brugernavne,0,0,1,1
12142,énumère,0,0,1,1
12145,marmeladen,0,0,1,1
12154,الحلو,0,0,1,1
12146,gekleed,0,0,1,1
12147,caixa,0,0,1,1
12149,approfondie,0,0,1,1
12150,retoma,0,0,1,1
12151,ஊமை,0,0,1,1
12153,بقليل,0,0,1,1
12295,reservado,0,0,1,1
12296,ordem,0,0,1,1
12299,परिप्रेक्ष्य,0,0,1,1
12441,مؤقتًا,0,0,1,1
12443,قريبًا,0,0,1,1
12444,ನಿಯೋಜನೆಗಳೊಂದಿಗೆ,0,0,1,1
12445,tears,0,0,1,1
12446,civiques,0,0,1,1
12447,aback,0,0,1,1
12448,affectations,0,0,1,1
12449,stylistic,0,0,1,1
12450,مقاطعتك,0,0,1,1
12452,இழுப்பதாகவோ,0,0,1,1
12455,طعام,0,0,1,1
12456,πρόσωπό,0,0,1,1
12457,ickeengelska,0,0,1,1
12458,aklınızda,0,0,1,1
12459,"हैं।
विशेष",0,0,1,1
12460,gebrekkig,0,0,1,1
12442,hörs,0,0,1,1
12439,gebräuchliche,0,0,1,1
12300,sujeta,0,0,1,1
12438,يترجموا,0,0,1,1
12421,इंडेक्सिंग।,0,0,1,1
12422,familiares,0,0,1,1
12424,المستخدم،,0,0,1,1
12425,contemporain,0,0,1,1
12426,للمقالة،,0,0,1,1
12427,தட்டில்,0,0,1,1
12429,समाज,0,0,1,1
12430,έννοιες,0,0,1,1
12431,startsidan,0,0,1,1
12432,концепцию,0,0,1,1
12433,ಆಸಕ್ತಿ,0,0,1,1
12434,katkıların,0,0,1,1
12435,lithosphere,0,0,1,1
12436,habitude,0,0,1,1
12437,afripédia,0,0,1,1
12461,теста,0,0,1,1
12462,αγενή,0,0,1,1
12464,похожи,0,0,1,1
12466,centralt,0,0,1,1
12492,pédia,0,0,1,1
12495,ediyorsun,0,0,1,1
12496,« six,0,0,1,1
12497,தங்கமாக,0,0,1,1
12498,analisado,0,0,1,1
12499,خائفًا,0,0,1,1
12502,നല്കിയിരിക്കുന്നു,0,0,1,1
12503,கட்டுரையைத்,0,0,1,1
12505,cevap,0,0,1,1
12506,سلطات,0,0,1,1
12507,நிராகரித்தாள்,0,0,1,1
12509,sexuais,0,0,1,1
12510,когдато,0,0,1,1
12513,cosmological,0,0,1,1
12515,bereikt,0,0,1,1
12491,yemeği,0,0,1,1
12490,செய்துள்ளேன்,0,0,1,1
12489,molten,0,0,1,1
12475,ينبغي,0,0,1,1
12467,एनसायक्लोपीडिया,0,0,1,1
12469,giderse,0,0,1,1
12470,запутал,0,0,1,1
12471,директор,0,0,1,1
12472,ನೀವಿರಿ,0,0,1,1
12474,"
नॉर्वेजियाई",0,0,1,1
12476,действие,0,0,1,1
12486,अंतर्गत,0,0,1,1
12478,oprichtte,0,0,1,1
12480,ಚತುರನಾಗಿದ್ದನು,0,0,1,1
12481,πρόσωπο,0,0,1,1
12482,ağlamaya,0,0,1,1
12483,disruptivas,0,0,1,1
12485,flourish,0,0,1,1
12420,ಕಲಿಕೆ,0,0,1,1
12419,pensantes,0,0,1,1
12417,videodur,0,0,1,1
12367,"
तमिल",0,0,1,1
12331,köpte,0,0,1,1
12332,fugles,0,0,1,1
12333,αποχαιρετήσει,0,0,1,1
12339,policydrivet,0,0,1,1
12341,വിവിധഘട്ടങ്ങളെ,0,0,1,1
12342,comportementaux,0,0,1,1
12343,αντιφατικούς,0,0,1,1
12348,troisième,0,0,1,1
12350,söyleme,0,0,1,1
12351,ലോസ്സ്,0,0,1,1
12353,разговорная,0,0,1,1
12355,sådant,0,0,1,1
12357,obtuvo,0,0,1,1
12361,സംരംഭമാണ്,0,0,1,1
12362,ಆಕ್ರಮಣಕಾರಿ,0,0,1,1
12330,ilgisizlik,0,0,1,1
12326,അവതരിപ്പിക്കുമ്പോൾ,0,0,1,1
12325,rapporterats,0,0,1,1
12311,"
अफ़्रीकान्स",0,0,1,1
12302,davrandığının,0,0,1,1
12303,kolaylıkla,0,0,1,1
12304,özensizlik,0,0,1,1
12306,obligados,0,0,1,1
12309,orientados,0,0,1,1
12310,frotté,0,0,1,1
12312,aktive,0,0,1,1
12322,spiegelbild,0,0,1,1
12313,ambicioso,0,0,1,1
12315,web ,0,0,1,1
12318,obtengas,0,0,1,1
12319,zhminnan •,0,0,1,1
12320,—número,0,0,1,1
12321,غالباً،,0,0,1,1
12363,insan,0,0,1,1
12368,vary,0,0,1,1
12416,ഓടി,0,0,1,1
12369,немецкой,0,0,1,1
12394,കൃത്യമായി,0,0,1,1
12395,ദൂരവ്യാപകമായി,0,0,1,1
12396,ಪದವೆಂದರೆ,0,0,1,1
12397,ek,0,0,1,1
12399,gesamte,0,0,1,1
12400,ഉദാഹരണങ്ങളിലെ,0,0,1,1
12401,incentivos,0,0,1,1
12402,inletts,0,0,1,1
12404,videnskabsetik,0,0,1,1
12408,δροσερός,0,0,1,1
12409,ജ്ഞാനമല്ല,0,0,1,1
12410,mythologies,0,0,1,1
12411,vardera,0,0,1,1
12412,ചുവന്ന,0,0,1,1
12413,behulp,0,0,1,1
12392,തടയുന്നില്ല,0,0,1,1
12391,flummoxade,0,0,1,1
12390,κανένα,0,0,1,1
12378,enige,0,0,1,1
12370,इट,0,0,1,1
12372,متعددة,0,0,1,1
12373,إتش,0,0,1,1
12374,fera,0,0,1,1
12375,استوحت,0,0,1,1
12376,tirar,0,0,1,1
12379,точка,0,0,1,1
12389,"
indonésio",0,0,1,1
12383,सह,0,0,1,1
12384,வார்த்தைகளுக்கு,0,0,1,1
12385,corrija,0,0,1,1
12386,dileyebilirsiniz,0,0,1,1
12387,«интервики»ссылки,0,0,1,1
12388,"
japonês",0,0,1,1
14825,μπερδεμένοι,0,0,1,1
14826,universitet,0,0,1,1
14828,وسري,0,0,1,1
17364,importo,0,0,1,1
17370,​​opmerking,0,0,1,1
17371,بأدب,0,0,1,1
17372,рендеринг,0,0,1,1
17373,மூலமாக,0,0,1,1
17375,അപ്പം,0,0,1,1
17377,असहमति,0,0,1,1
17378,വേണ്ടത്,0,0,1,1
17379,résume,0,0,1,1
17380,he •,0,0,1,1
17381,dresse,0,0,1,1
17382,paradojas,0,0,1,1
17383,выучите,0,0,1,1
17384,αμφισβητούμενο,0,0,1,1
17386,cryptologue,0,0,1,1
17387,inférieur,0,0,1,1
17367,للتعلم,0,0,1,1
17362,tedavi,0,0,1,1
17341,القياسي,0,0,1,1
17361,forretning,0,0,1,1
17344,castelhana,0,0,1,1
17345,individu,0,0,1,1
17346,важно,0,0,1,1
17347,presencia,0,0,1,1
17349,одет,0,0,1,1
17350,valeurs…,0,0,1,1
17351,രാജകുമാരനെയോ,0,0,1,1
17353,sr •,0,0,1,1
17354,promotie,0,0,1,1
17355,« tentatives,0,0,1,1
17356,foreslået,0,0,1,1
17357,fejltagelse,0,0,1,1
17358,protegido,0,0,1,1
17359,"
neerlandês",0,0,1,1
17360,правосудия,0,0,1,1
17388,gemeenschappen,0,0,1,1
17390,περίπτωση,0,0,1,1
17391,emocionamos,0,0,1,1
17392,subnational,0,0,1,1
17421,lagstiftningen,0,0,1,1
17422,édition »,0,0,1,1
17423,—que,0,0,1,1
17424,chercheuse,0,0,1,1
17425,airspace,0,0,1,1
17426,smakend,0,0,1,1
17427,चयन,0,0,1,1
17428,υπερβάλλετε,0,0,1,1
17432,முறைமை,0,0,1,1
17433,traditionallycompiled,0,0,1,1
17434,remanescentes,0,0,1,1
17436,மறுப்புக்களுக்கான,0,0,1,1
17437,concurrent,0,0,1,1
17438,extensiones,0,0,1,1
17439,வில்லை,0,0,1,1
17419,revistos,0,0,1,1
17418,негативной,0,0,1,1
17417,نشاطاً،,0,0,1,1
17402,rival,0,0,1,1
17393,أدخلت,0,0,1,1
17395,والفيتنامية,0,0,1,1
17397,exclusively,0,0,1,1
17398,المحررون,0,0,1,1
17400,hasard,0,0,1,1
17401,كلهم,0,0,1,1
17403,proveito,0,0,1,1
17416,grameri,0,0,1,1
17405,devras,0,0,1,1
17407,﻿°n,0,0,1,1
17409,नाय्नोर्स्क,0,0,1,1
17413,известны,0,0,1,1
17414,ಕಾರ್ಯನಿರತರಾಗಿರಬಹುದು,0,0,1,1
17415,tasty,0,0,1,1
17342,الطبيعية,0,0,1,1
17338,महाद्वीपों,0,0,1,1
17444,fassiez,0,0,1,1
17261,decrease,0,0,1,1
17263,വജ്രങ്ങളിലും,0,0,1,1
17264,elogiando,0,0,1,1
17265,yararlanmasına,0,0,1,1
17268,योजनाओं,0,0,1,1
17271,hemlighetsfullt,0,0,1,1
17272,ethnographique,0,0,1,1
17273,culpable,0,0,1,1
17274,даллас,0,0,1,1
17275,കളികൾ,0,0,1,1
17277,بجامعة,0,0,1,1
17281,εγκυκλοπαίδεια»,0,0,1,1
17282,универсальной,0,0,1,1
17283,salataları,0,0,1,1
17284,പോകുകയാണെങ്കിൽ,0,0,1,1
17285,felicitaties,0,0,1,1
17262,suajili,0,0,1,1
17260,participative,0,0,1,1
17337,custos,0,0,1,1
17258,ಕೋನವಾಗಿದ್ದು,0,0,1,1
17234,possède,0,0,1,1
17235,sucré,0,0,1,1
17236,ஆண்டில்,0,0,1,1
17237,ಒಳ್ಳೆಯವರು,0,0,1,1
17239,havlu,0,0,1,1
17240,cerveau,0,0,1,1
17241,publikation,0,0,1,1
17242,supermarket,0,0,1,1
17244,modtog,0,0,1,1
17245,kans,0,0,1,1
17246,gittiler,0,0,1,1
17247,لوحي,0,0,1,1
17248,selfreplicating,0,0,1,1
17249,إهانة,0,0,1,1
17255,डूबने,0,0,1,1
17287,negou,0,0,1,1
17289,ಸುದ್ದಿ,0,0,1,1
17290,devez,0,0,1,1
17291,enfaticamente,0,0,1,1
17314,ರುಚಿಯ,0,0,1,1
17315,saborosa,0,0,1,1
17316,spijker,0,0,1,1
17317,conçue,0,0,1,1
17318,ಕೋಪಗೊಂಡಿದ್ದೇನೆ,0,0,1,1
17319,переводные,0,0,1,1
17321,vorschläge,0,0,1,1
17323,necesita,0,0,1,1
17324,curtindo,0,0,1,1
17325,internetbaserade,0,0,1,1
17326,computertijdschrift,0,0,1,1
17328,فرد,0,0,1,1
17330,احتمالية,0,0,1,1
17331,duração,0,0,1,1
17333,évidente,0,0,1,1
17313,recognition،,0,0,1,1
17312,semaines,0,0,1,1
17311,рассказал,0,0,1,1
17300,ˌwɪkiˈpiːdiə —,0,0,1,1
17292,جماعيا،,0,0,1,1
17293,övergett,0,0,1,1
17294,enlever,0,0,1,1
17295,rentrant,0,0,1,1
17297,hjerne,0,0,1,1
17298,ekmeme,0,0,1,1
17302,المدينة,0,0,1,1
17310,ஏறினாள்,0,0,1,1
17303,declínio,0,0,1,1
17304,самим,0,0,1,1
17305,değiştirmekte,0,0,1,1
17306,وسيمًا,0,0,1,1
17308,doisje,0,0,1,1
17309,community ,0,0,1,1
17440,mismo—​​,0,0,1,1
17445,планировалось,0,0,1,1
16778,décennies,0,0,1,1
17584,batatas,0,0,1,1
17587,विवादों,0,0,1,1
17589,κοίταζαν,0,0,1,1
17592,cumhuriyeti,0,0,1,1
17595,ekmekle,0,0,1,1
17597,सीख,0,0,1,1
17598,séparée,0,0,1,1
17599,karaktäriseras,0,0,1,1
17600,വൃത്തിയാക്കൽ,0,0,1,1
17601,момента,0,0,1,1
17602,echten,0,0,1,1
17603,recomenda,0,0,1,1
17604,planter,0,0,1,1
17606,délicate,0,0,1,1
17607,ಒಳ್ಳೆಯವರಾಗಿದ್ದಾರೆ,0,0,1,1
17609,удаляют,0,0,1,1
17585,изменяют,0,0,1,1
17583,хранилища,0,0,1,1
17560,apresentados,0,0,1,1
17582,söylenmeyecek,0,0,1,1
17563,للمعرفة,0,0,1,1
17565,principper,0,0,1,1
17566,baixa,0,0,1,1
17567,تراكمت,0,0,1,1
17569,பார்க்கும்போது,0,0,1,1
17570,asigna,0,0,1,1
17571,riktlinjerna,0,0,1,1
17572,législatives,0,0,1,1
17573,ആശ്ചര്യപ്പെടുത്തുന്ന,0,0,1,1
17574,നിരസിച്ചു,0,0,1,1
17575,birbirinden,0,0,1,1
17577,लिखने,0,0,1,1
17578,«нупедии» —,0,0,1,1
17579,വിശദീകരിക്കുന്ന,0,0,1,1
17581,грустная,0,0,1,1
17611,artig,0,0,1,1
17612,ಒಬಾಮಾ,0,0,1,1
17614,stoppet,0,0,1,1
17615,تجري,0,0,1,1
17644,σταματήσαμε,0,0,1,1
17645,lyckas,0,0,1,1
17646,sucedidas,0,0,1,1
17647,adelantarse,0,0,1,1
17649,ಅದೃಷ್ಟವಂತ,0,0,1,1
17650,ತೆಗೆದುಕೊಂಡನು,0,0,1,1
17651,noncompliant,0,0,1,1
17652,рассказала,0,0,1,1
17653,ನಿರರ್ಗಳವಾಗಲು,0,0,1,1
17656,instalan,0,0,1,1
17660,excesivo,0,0,1,1
17661,schönes,0,0,1,1
17662,வர்த்தக,0,0,1,1
17664,गेब्रियल,0,0,1,1
17665,പത്രമാസികകളും,0,0,1,1
17643,распределённом,0,0,1,1
17642,положительных,0,0,1,1
17641,vererek,0,0,1,1
17629,ज़रूर,0,0,1,1
17618,подборку,0,0,1,1
17619,കാലങ്ങളായി,0,0,1,1
17622,menselijke,0,0,1,1
17626,γλυκιάς,0,0,1,1
17627,கருத்தை,0,0,1,1
17628,afternoon,0,0,1,1
17630,generelt,0,0,1,1
17640,vienne,0,0,1,1
17631,primeiras,0,0,1,1
17632,hot,0,0,1,1
17633,участвуют,0,0,1,1
17634,удивительного,0,0,1,1
17635,gevaar,0,0,1,1
17637,replied,0,0,1,1
17561,ಬಯಸಿದ್ದರು,0,0,1,1
17557,αγκαλιάσει,0,0,1,1
17446,pioneer,0,0,1,1
17474,مراجعات,0,0,1,1
17476,décoder,0,0,1,1
17478,المصنوع,0,0,1,1
17479,لدولة,0,0,1,1
17482,τόνο,0,0,1,1
17483,استثنائي,0,0,1,1
17485,liabilities,0,0,1,1
17486,хеллером,0,0,1,1
17490,डेविड,0,0,1,1
17491,simple •,0,0,1,1
17495,اراك,0,0,1,1
17496,ಕೇವಲ,0,0,1,1
17498,birgitta,0,0,1,1
17501,ranges,0,0,1,1
17502,submeterse,0,0,1,1
17504,волшебными,0,0,1,1
17475,hazır,0,0,1,1
17473,ಸಂಪೂರ್ಣ,0,0,1,1
17556,الشكوك,0,0,1,1
17471,geheimnis,0,0,1,1
17447,സമൂഹത്തിന്,0,0,1,1
17448,échappentréf,0,0,1,1
17451,പരാതിപ്പെടാൻ,0,0,1,1
17452,swallow,0,0,1,1
17453,esquece,0,0,1,1
17455,другим»,0,0,1,1
17458,kullanıma,0,0,1,1
17459,النزاعات،,0,0,1,1
17461,मस्तिष्क,0,0,1,1
17462,düşünmeme,0,0,1,1
17463,fournissent,0,0,1,1
17464,palace,0,0,1,1
17465,ποιότητα,0,0,1,1
17467,joplin,0,0,1,1
17469,وذهبا,0,0,1,1
17505,പദങ്ങൾക്കും,0,0,1,1
17506,नशा,0,0,1,1
17507,finalités,0,0,1,1
17508,sufrido,0,0,1,1
17532,argumenta,0,0,1,1
17536,कदम,0,0,1,1
17538,limitaría,0,0,1,1
17539,moverse,0,0,1,1
17540,gördüğünden,0,0,1,1
17541,librenota,0,0,1,1
17542,ന്യൂപീഡിയ,0,0,1,1
17543,потерял,0,0,1,1
17545,கலைக்களஞ்சியமாகும்,0,0,1,1
17547,सेवाओ,0,0,1,1
17548,வெற்றிகரமாக,0,0,1,1
17549,tamamlanmış,0,0,1,1
17550,tonu,0,0,1,1
17551,متقاطعة,0,0,1,1
17553,फीडर,0,0,1,1
17530,catholiques,0,0,1,1
17529,الإتمامِ,0,0,1,1
17528,പരിശീലനം,0,0,1,1
17517,ಭೇಟಿ,0,0,1,1
17510,háganme,0,0,1,1
17511,«усилия,0,0,1,1
17512,africano,0,0,1,1
17513,наверное,0,0,1,1
17514,हमलों,0,0,1,1
17516,amplia,0,0,1,1
17519,minst,0,0,1,1
17527,today’s,0,0,1,1
17521,والبولندية,0,0,1,1
17522,hiperligações,0,0,1,1
17523,gebruikersbijdragen,0,0,1,1
17524,беспорядке,0,0,1,1
17525,contributrices,0,0,1,1
17526,மாண்டி’,0,0,1,1
17233,நேர்மையாக,0,0,1,1
17231,bekijkt,0,0,1,1
17230,प्रतिबिंब,0,0,1,1
16916,граффити,0,0,1,1
16919,देंगे,0,0,1,1
16921,നിർവചനത്തെയാണ്,0,0,1,1
16922,ट्रांसक्लुजन,0,0,1,1
16923,திருமணத்தில்,0,0,1,1
16924,robijnen,0,0,1,1
16925,améliorez,0,0,1,1
16926,ദർശനം,0,0,1,1
16927,euros,0,0,1,1
16928,ممل,0,0,1,1
16929,கட்டுரைகளுக்கு,0,0,1,1
16931,michelle,0,0,1,1
16933,maravilhoso,0,0,1,1
16935,break,0,0,1,1
16937,الأخطاء,0,0,1,1
16940,κουδούνι,0,0,1,1
16917,redigeringsgränssnitt,0,0,1,1
16915,sufixo,0,0,1,1
16885,kritiek,0,0,1,1
16911,olsaydın,0,0,1,1
16887,прикладных,0,0,1,1
16889,oke,0,0,1,1
16892,восприимчивость,0,0,1,1
16893,storslået,0,0,1,1
16894,inlägg,0,0,1,1
16895,maladies,0,0,1,1
16896,होगी,0,0,1,1
16898,carencia,0,0,1,1
16904,നിഷ്പക്ഷമായ,0,0,1,1
16905,entonação,0,0,1,1
16906,ortak,0,0,1,1
16907,toekomst,0,0,1,1
16908,बताएं।,0,0,1,1
16909,klassische,0,0,1,1
16910,te •,0,0,1,1
16941,illustrative,0,0,1,1
16943,дартмутского,0,0,1,1
16947,ತರಬಹುದೇ,0,0,1,1
16948,ಕಲಿತಿದ್ದೇವೆ,0,0,1,1
16980,النموذج,0,0,1,1
16984,mérite,0,0,1,1
16985,रिपब्लिक,0,0,1,1
16987,patiently,0,0,1,1
16988,ceasing,0,0,1,1
16990,événements,0,0,1,1
16991,ಪಟ್ಟಣದ,0,0,1,1
16994,cogna,0,0,1,1
16996,έδαφος,0,0,1,1
16998,farms,0,0,1,1
16999,включения,0,0,1,1
17001,uppifrån,0,0,1,1
17004,ഉച്ചഭക്ഷണം,0,0,1,1
17005,சந்திப்பிற்கும்,0,0,1,1
17006,पैरों,0,0,1,1
16978,respondem,0,0,1,1
16976,tröga,0,0,1,1
16974,பிடித்தது,0,0,1,1
16958,argumentó,0,0,1,1
16950,achèterais,0,0,1,1
16951,беспорядок,0,0,1,1
16953,återställdes,0,0,1,1
16954,لبعضهما,0,0,1,1
16955,cierto,0,0,1,1
16956,wikipedianerna,0,0,1,1
16959,τυχερό,0,0,1,1
16967,utiliseriez,0,0,1,1
16960,helado,0,0,1,1
16961,yansır,0,0,1,1
16962,próprias,0,0,1,1
16963,presidencial,0,0,1,1
16965,متى,0,0,1,1
16966,genotypes,0,0,1,1
16886,trentaine,0,0,1,1
16884,"
लातवियाई",0,0,1,1
17227,достоверность,0,0,1,1
16803,ഹാംഗ്,0,0,1,1
16805,வினைச்சொல்லாக,0,0,1,1
16807,ತೊರೆಯುತ್ತಿದ್ದೇನೆ,0,0,1,1
16808,रोजमर्रा,0,0,1,1
16809,ನಾರ್ಸಿಸಾದ,0,0,1,1
16810,ಮಾತನಾಡೋಣ,0,0,1,1
16813,convergent,0,0,1,1
16814,लोड,0,0,1,1
16815,weinberger en,0,0,1,1
16816,croyait,0,0,1,1
16817,المنشأة,0,0,1,1
16818,consacrés,0,0,1,1
16819,yazılan,0,0,1,1
16820,വസ്തുതകളോട്,0,0,1,1
16821,discourage,0,0,1,1
16822,निंदन,0,0,1,1
16804,inscreverse,0,0,1,1
16801,title,0,0,1,1
16881,innehållsdrivet,0,0,1,1
16799,முயற்சித்தது,0,0,1,1
16780,fotos,0,0,1,1
16782,لتخبره,0,0,1,1
16783,içeceği,0,0,1,1
16784,nonsensical,0,0,1,1
16787,antigua,0,0,1,1
16788,الفكرة,0,0,1,1
16789,sofra,0,0,1,1
16790,nås,0,0,1,1
16791,θυμάστε,0,0,1,1
16792,şirket,0,0,1,1
16793,forsøgte,0,0,1,1
16794,frivillig,0,0,1,1
16795,альтернатива,0,0,1,1
16797,«nuestra,0,0,1,1
16798,«значимой»,0,0,1,1
16824,arbetsflöden,0,0,1,1
16825,θαλασσωσα,0,0,1,1
16826,worthy,0,0,1,1
16827,напугала,0,0,1,1
16858,синонимами,0,0,1,1
16861,കണ്ടെത്തിയാൽ,0,0,1,1
16863,سلسلة,0,0,1,1
16865,kalın,0,0,1,1
16866,फर्जी,0,0,1,1
16867,ಕ್ಷಮೆಯಾಚಿಸುತ್ತಿದೆ,0,0,1,1
16868,മാതൃകാ,0,0,1,1
16869,പേർക്കും,0,0,1,1
16870,atelle,0,0,1,1
16872,പറയണം,0,0,1,1
16874,जीता,0,0,1,1
16875,الفيضان,0,0,1,1
16876,wikipediadag,0,0,1,1
16877,invalidated,0,0,1,1
16878,gouvernée,0,0,1,1
16856,പറ്റുമോ,0,0,1,1
16853,ഒന്നിച്ച്,0,0,1,1
16851,канады,0,0,1,1
16840,согласиться,0,0,1,1
16831,குழுசேர,0,0,1,1
16832,ursprungligen,0,0,1,1
16835,exagerar,0,0,1,1
16836,kanıdır,0,0,1,1
16837,απουσιάζουν,0,0,1,1
16839,മുന്നോട്ടു,0,0,1,1
16841,മൂർച്ചയുള്ളവയെ,0,0,1,1
16849,включают,0,0,1,1
16842,akilleshäl,0,0,1,1
16843,περιγραφής,0,0,1,1
16845,préjugés,0,0,1,1
16846,statistiquement,0,0,1,1
16847,tabiki,0,0,1,1
16848,importantly—it,0,0,1,1
17007,zihinsel,0,0,1,1
17008,servantes,0,0,1,1
17009,புதியகட்டுரை,0,0,1,1
17157,mentalement,0,0,1,1
17160,വിഭാഗത്തിൽ,0,0,1,1
17161,युद्ध,0,0,1,1
17162,медленном,0,0,1,1
17163,antologin,0,0,1,1
17164,cobrindo,0,0,1,1
17165,einverstanden,0,0,1,1
17166,തടയുന്നു,0,0,1,1
17167,affamé,0,0,1,1
17170,bedøvet,0,0,1,1
17171,licensors,0,0,1,1
17173,objects—the,0,0,1,1
17174,“எச்டிஎம்எல்”,0,0,1,1
17176,فلست,0,0,1,1
17177,எதிர்,0,0,1,1
17178,bestempeld,0,0,1,1
17159,jobs,0,0,1,1
17156,октябрю,0,0,1,1
17011,شجع,0,0,1,1
17154,растущего,0,0,1,1
17126,സൂചിപ്പിക്കുന്നു,0,0,1,1
17127,divulgou,0,0,1,1
17130,डेल्ही,0,0,1,1
17131,observandoa,0,0,1,1
17135,மேற்பார்வையின்,0,0,1,1
17138,എടുക്കുന്നു,0,0,1,1
17139,പ്രയോഗിച്ചുകൊണ്ടാണ്,0,0,1,1
17142,أفكر,0,0,1,1
17144,अतिरंजित,0,0,1,1
17145,வேலைக்கு,0,0,1,1
17147,koninkrijk,0,0,1,1
17148,vergeten,0,0,1,1
17149,कहीं,0,0,1,1
17150,познавательной,0,0,1,1
17151,разведывательного,0,0,1,1
17179,klassieke,0,0,1,1
17180,kültürel,0,0,1,1
17181,smuts,0,0,1,1
17182,туристической,0,0,1,1
17207,журналистике,0,0,1,1
17210,belirtmek,0,0,1,1
17211,δημιουργικής,0,0,1,1
17212,sorabilirsiniz,0,0,1,1
17213,författad,0,0,1,1
17214,marginaux,0,0,1,1
17216,официальной,0,0,1,1
17217,hechas,0,0,1,1
17219,ക്ഷീണിതനാണോ,0,0,1,1
17220,retirado,0,0,1,1
17221,slave,0,0,1,1
17222,χρειάζεστε,0,0,1,1
17223,десятка»,0,0,1,1
17225,версиях,0,0,1,1
17226,знала,0,0,1,1
17206,förbryllade,0,0,1,1
17205,forçait,0,0,1,1
17204,заимствовано,0,0,1,1
17189,விரும்பத்தகாத,0,0,1,1
17183,സൂചിപ്പിക്കുന്നതിന്,0,0,1,1
17184,hazırlandığını,0,0,1,1
17185,indirilmesi,0,0,1,1
17186,desafortunadamente,0,0,1,1
17187,കൊണ്ടുവരട്ടെ,0,0,1,1
17188,proyecto​,0,0,1,1
17190,ومعترف,0,0,1,1
17203,başkalarına,0,0,1,1
17192,ಉತ್ತಮಗೊಳಿಸುವುದು,0,0,1,1
17193,प्रगति,0,0,1,1
17195,متحيزًا,0,0,1,1
17196,partnered,0,0,1,1
17199,சுவாசிக்க,0,0,1,1
17201,debattörer,0,0,1,1
17125,zevkti,0,0,1,1
17124,nergisli,0,0,1,1
17122,بالنساء,0,0,1,1
17068,mitigate,0,0,1,1
17040,relire,0,0,1,1
17041,kırıldı,0,0,1,1
17042,recognition‏،,0,0,1,1
17043,drunkna,0,0,1,1
17047,yaparsın,0,0,1,1
17048,प्रभावी,0,0,1,1
17050,kazandı,0,0,1,1
17056,чисто,0,0,1,1
17059,награждения,0,0,1,1
17060,осуществляет,0,0,1,1
17061,новая,0,0,1,1
17062,salientou,0,0,1,1
17063,förändras,0,0,1,1
17065,ബാങ്കിന്റെ,0,0,1,1
17066,« un,0,0,1,1
17039,författats,0,0,1,1
17038,heraus,0,0,1,1
17037,доктриной,0,0,1,1
17022,acessíveis,0,0,1,1
17012,comparatif,0,0,1,1
17013,البرمجية،,0,0,1,1
17016,بلغات,0,0,1,1
17018,bereikte,0,0,1,1
17020,نذهب,0,0,1,1
17021,உச்சரிப்பைக்,0,0,1,1
17023,штата,0,0,1,1
17036,validade,0,0,1,1
17024,الطبي,0,0,1,1
17029,تواصل,0,0,1,1
17030,ilgilerini,0,0,1,1
17032,കൂട്ടിച്ചേർത്തോളും,0,0,1,1
17033,arriverez,0,0,1,1
17035,ई,0,0,1,1
17067,klassiska,0,0,1,1
17069,थोडा,0,0,1,1
17121,it’s,0,0,1,1
17070,particles,0,0,1,1
17096,компьютерным,0,0,1,1
17097,إجازة,0,0,1,1
17098,encouraging,0,0,1,1
17099,എത്തിച്ചേരുകയാണ്,0,0,1,1
17106,ಹಹ್,0,0,1,1
17107,zufällig,0,0,1,1
17108,autorisation,0,0,1,1
17109,ಕಾರ್ಯನಿರತವಾಗಿದೆ,0,0,1,1
17111,вероятностью,0,0,1,1
17113,traditionnelle,0,0,1,1
17114,маленькие,0,0,1,1
17115,kontakter,0,0,1,1
17116,डायरेक्टर,0,0,1,1
17118,കൃത്രിമ,0,0,1,1
17119,complejidad,0,0,1,1
17095,apport,0,0,1,1
17094,widersprüchliche,0,0,1,1
17093,париже,0,0,1,1
17080,anmodninger,0,0,1,1
17071,ladda,0,0,1,1
17072,формируемого,0,0,1,1
17073,pronoun,0,0,1,1
17076,вебсайт,0,0,1,1
17077,sammeln,0,0,1,1
17079,கண்டறியப்பட்டது,0,0,1,1
17081,социологическое,0,0,1,1
17091,bedava,0,0,1,1
17082,spills,0,0,1,1
17083,şarkı,0,0,1,1
17085,पंथ,0,0,1,1
17087,أحدًا,0,0,1,1
17088,géants,0,0,1,1
17090,ноги,0,0,1,1
17668,fotografias,0,0,1,1
17669,саду,0,0,1,1
17670,geologic,0,0,1,1
18275,mängd,0,0,1,1
18279,luidsprekerpictogram,0,0,1,1
18280,உருவாக்கியுள்ளது,0,0,1,1
18281,мировой,0,0,1,1
18282,foton,0,0,1,1
18283,atuais,0,0,1,1
18287,transparency ,0,0,1,1
18289,gelmesi,0,0,1,1
18292,stunned,0,0,1,1
18293,варианта,0,0,1,1
18294,பங்களிப்பாளர்கள்,0,0,1,1
18295,സാങർ,0,0,1,1
18297,lekkere,0,0,1,1
18298,låst,0,0,1,1
18299,സുപ്രധാനനേട്ടവും,0,0,1,1
18300,estudiante,0,0,1,1
18278,smiling,0,0,1,1
18274,acalmese,0,0,1,1
18254,खरीदा,0,0,1,1
18272,eleştirilerine,0,0,1,1
18256,trovärdig,0,0,1,1
18257,тупоумный,0,0,1,1
18258,komik,0,0,1,1
18259,عصفور,0,0,1,1
18260,incommensurables,0,0,1,1
18261,subió,0,0,1,1
18262,лишена,0,0,1,1
18263,bissen,0,0,1,1
18264,ಹಾಕುತ್ತಿದ್ದೇನೆ,0,0,1,1
18266,работ,0,0,1,1
18267,справа,0,0,1,1
18268,يتحدث,0,0,1,1
18269,женихи,0,0,1,1
18270,groß,0,0,1,1
18271,மீளப்பெறவோ,0,0,1,1
18302,ಪರಿಪೂರ್ಣವಾದ,0,0,1,1
18303,λέγατε,0,0,1,1
18305,tallrik,0,0,1,1
18306,കണക്കാക്കുന്നത്,0,0,1,1
18334,समस्याएं,0,0,1,1
18335,évolué,0,0,1,1
18336,«знание»,0,0,1,1
18337,péjorative,0,0,1,1
18338,മനസ്സിലാക്കുന്നത്,0,0,1,1
18339,отца,0,0,1,1
18341,leihen,0,0,1,1
18342,നീക്കം,0,0,1,1
18344,сайте,0,0,1,1
18346,bodde,0,0,1,1
18348,அங்குள்ள,0,0,1,1
18349,حصل,0,0,1,1
18350,échappent,0,0,1,1
18351,régionales,0,0,1,1
18352,pending,0,0,1,1
18332,പൊതുഅവലംബ,0,0,1,1
18331,சிறந்தவர்,0,0,1,1
18328,constitutional,0,0,1,1
18319,qu’en,0,0,1,1
18307,παρουσίαση,0,0,1,1
18309,സാഹചര്യത്തെ,0,0,1,1
18311,divinité,0,0,1,1
18312,ചെയ്തത്,0,0,1,1
18313,legitimidad,0,0,1,1
18317,торговом,0,0,1,1
18320,ಸಮಯಕ್ಕೆ,0,0,1,1
18327,كبيراً,0,0,1,1
18321,அதிநவீன,0,0,1,1
18322,étions,0,0,1,1
18323,grusomme,0,0,1,1
18324,nan,0,0,1,1
18325,അഭിപ്രായമിടാൻ,0,0,1,1
18326,göstermektedir,0,0,1,1
18255,بكتابة,0,0,1,1
18253,ಪುನರಾವರ್ತಿಸಬೇಕೆಂದು,0,0,1,1
18126,വാക്യത്തിൽ‌,0,0,1,1
18154,വസ്തുക്കളുടെ,0,0,1,1
18158,ca,0,0,1,1
18159,вебпорталом,0,0,1,1
18163,κλήση,0,0,1,1
18167,exponencialmente,0,0,1,1
18168,reparação,0,0,1,1
18170,potentiële,0,0,1,1
18171,لنصبح,0,0,1,1
18175,الخمس,0,0,1,1
18177,അനായാസമായ,0,0,1,1
18178,βάλτε,0,0,1,1
18179,адресу,0,0,1,1
18180,ಪರಿಸ್ಥಿತಿಯಲ್ಲಿರಬೇಕು,0,0,1,1
18181,« conservation,0,0,1,1
18182,провели,0,0,1,1
18184,validity,0,0,1,1
18155,ιστό,0,0,1,1
18153,izlerken,0,0,1,1
18251,maximale,0,0,1,1
18152,slogan ,0,0,1,1
18133,ilerlemek,0,0,1,1
18134,wikiprojects,0,0,1,1
18135,принц,0,0,1,1
18138,மகிழ்ச்சி,0,0,1,1
18139,splits,0,0,1,1
18140,kurslitteraturen,0,0,1,1
18141,besproken,0,0,1,1
18142,aanleidinggevend,0,0,1,1
18143,chico,0,0,1,1
18144,pelarna,0,0,1,1
18145,الدراسة,0,0,1,1
18146,eliminador,0,0,1,1
18148,pies,0,0,1,1
18149,kalırsınız,0,0,1,1
18151,எல்லோருக்கும்,0,0,1,1
18185,طلاقة,0,0,1,1
18186,питтсбургского,0,0,1,1
18191,gütmeyen,0,0,1,1
18192,приводит,0,0,1,1
18228,эпизод,0,0,1,1
18229,«invirtió,0,0,1,1
18232,taraškievica,0,0,1,1
18233,wikiversité,0,0,1,1
18234,meelmeisjes,0,0,1,1
18235,geolocation,0,0,1,1
18236,पीडिया,0,0,1,1
18237,artifice,0,0,1,1
18239,üçü,0,0,1,1
18240,пополнит,0,0,1,1
18244,"
सिसलीयाई",0,0,1,1
18246,tendent,0,0,1,1
18247,artikelrekommendation,0,0,1,1
18249,السهل,0,0,1,1
18250,ಅಳುತ್ತಿದ್ದೀರಿ,0,0,1,1
18223,siglos,0,0,1,1
18222,ativistas,0,0,1,1
18221,exagérer,0,0,1,1
18202,للحديث,0,0,1,1
18193,embotado,0,0,1,1
18195,vurgulamakta,0,0,1,1
18196,derhâl,0,0,1,1
18197,усилия,0,0,1,1
18199,minimization,0,0,1,1
18201,γυναίκα,0,0,1,1
18204,storbritanniens,0,0,1,1
18216,defines,0,0,1,1
18206,autocensuró,0,0,1,1
18208,оказаться,0,0,1,1
18210,tillykke,0,0,1,1
18213,golpes,0,0,1,1
18214,gætte,0,0,1,1
18215,வடிவியல்,0,0,1,1
18353,it •,0,0,1,1
18354,وبنائها,0,0,1,1
18356,içerikli,0,0,1,1
18480,умным,0,0,1,1
18486,hice,0,0,1,1
18487,والمجتمع,0,0,1,1
18488,ακολουθούν,0,0,1,1
18489,आधुनिक,0,0,1,1
18490,ആഴത്തിൽ,0,0,1,1
18492,जिनका,0,0,1,1
18495,متصل,0,0,1,1
18497,männen,0,0,1,1
18498,intégrale,0,0,1,1
18501,taux,0,0,1,1
18502,المتعددة,0,0,1,1
18503,fuese,0,0,1,1
18504,notoires,0,0,1,1
18505,aldıkları,0,0,1,1
18507,tijdlang,0,0,1,1
18484,ഭയമായിരുന്നു,0,0,1,1
18479,bescheiden,0,0,1,1
18357,ನೀವು,0,0,1,1
18476,വച്ച്,0,0,1,1
18455,цитируются,0,0,1,1
18456,görüşemedik,0,0,1,1
18457,macroecosystem,0,0,1,1
18459,താഴേക്കും,0,0,1,1
18460,physicists,0,0,1,1
18465,पृष्टों,0,0,1,1
18466,da •,0,0,1,1
18467,ansætte,0,0,1,1
18468,ищете,0,0,1,1
18469,samfundsvidenskab,0,0,1,1
18470,لطيفان,0,0,1,1
18471,forvirre,0,0,1,1
18473,нас,0,0,1,1
18474,δημοφιλούς,0,0,1,1
18475,ड्राइववे,0,0,1,1
18508,dönüşüyor,0,0,1,1
18509,belgique,0,0,1,1
18510,contestarte,0,0,1,1
18512,சந்திப்பேன்,0,0,1,1
18539,fausses,0,0,1,1
18540,медленный,0,0,1,1
18543,kibarca,0,0,1,1
18545,пожаловаться,0,0,1,1
18550,onderzoeken,0,0,1,1
18551,விதத்தில்,0,0,1,1
18552,хорошей,0,0,1,1
18553,κοχύλι,0,0,1,1
18554,விக்கிப்பீடியாவினுள்,0,0,1,1
18555,இருக்கவும்,0,0,1,1
18556,världskriget,0,0,1,1
18557,geradeaus,0,0,1,1
18559,للوصول,0,0,1,1
18562,തിരഞ്ഞെടുത്ത്,0,0,1,1
18563,फ़रवरी,0,0,1,1
18538,maskinöversatts,0,0,1,1
18537,kökenine,0,0,1,1
18535,tutabilmek,0,0,1,1
18522,लेती,0,0,1,1
18513,dinin,0,0,1,1
18514,ಉದಾಹರಣೆಗಳು,0,0,1,1
18516,heredó,0,0,1,1
18518,ವಿಷಯಗಳನ್ನು,0,0,1,1
18520,الفاكهة,0,0,1,1
18521,численных,0,0,1,1
18523,kunniga,0,0,1,1
18534,admiración,0,0,1,1
18525,सैन,0,0,1,1
18526,compitieron,0,0,1,1
18527,everybodywiki,0,0,1,1
18529,флорида,0,0,1,1
18530,बनायी,0,0,1,1
18531,"
मिनांगकाबाउ",0,0,1,1
18454,координируются,0,0,1,1
18453,इन्सटाल,0,0,1,1
18452,lis,0,0,1,1
18404,seviyede,0,0,1,1
18381,raises,0,0,1,1
18382,bedömningen,0,0,1,1
18384,wonderful,0,0,1,1
18385,tillåta,0,0,1,1
18387,frön,0,0,1,1
18388,हालांकि,0,0,1,1
18389,подпадает,0,0,1,1
18391,kultiveret,0,0,1,1
18392,நிபுணர்களால்,0,0,1,1
18394,vecteurs,0,0,1,1
18396,australiskt,0,0,1,1
18397,bedövad,0,0,1,1
18398,зарегистрированный,0,0,1,1
18399,മാജിക്,0,0,1,1
18400,ಅದ್ಭುತವಾಗಿದ್ದೀರಿ,0,0,1,1
18380,"
sundanês",0,0,1,1
18378,"
malgaxe",0,0,1,1
18377,кругу,0,0,1,1
18366,grattis,0,0,1,1
18358,கொண்டிருந்தாள்,0,0,1,1
18359,acrescentando,0,0,1,1
18361,முறையே,0,0,1,1
18362,vándalos,0,0,1,1
18363,сидят,0,0,1,1
18365,टैग,0,0,1,1
18367,സമർപ്പിക്കപ്പെടുന്ന,0,0,1,1
18376,liberar,0,0,1,1
18368,frança,0,0,1,1
18369,ledig,0,0,1,1
18370,получала,0,0,1,1
18371,engelsksprogede,0,0,1,1
18372,glitrende,0,0,1,1
18373,portals,0,0,1,1
18402,فسوف,0,0,1,1
18405,menos—,0,0,1,1
18450,பொருந்தக்கூடிய,0,0,1,1
18406,மன்னிப்பு,0,0,1,1
18429,ഇംഗ്ലീഷിലെ,0,0,1,1
18430,результатов,0,0,1,1
18431,война,0,0,1,1
18432,lyckades,0,0,1,1
18435,हतोत्साहित,0,0,1,1
18438,"
लातिन",0,0,1,1
18439,ಭಾರೀ,0,0,1,1
18440,leuke,0,0,1,1
18442,larmes,0,0,1,1
18443,challenged,0,0,1,1
18445,χώρος,0,0,1,1
18446,opretholde,0,0,1,1
18447,holistique,0,0,1,1
18448,wegen,0,0,1,1
18449,കാമ്പ്,0,0,1,1
18428,कोने,0,0,1,1
18426,செய்யப்பட்டுள்ளன,0,0,1,1
18423,spite,0,0,1,1
18413,ಕೋಪಗೊಂಡಿದ್ದೀರಿ,0,0,1,1
18407,понимающей,0,0,1,1
18408,русск»,0,0,1,1
18409,സാധിച്ചു,0,0,1,1
18410,നാമപദമായി,0,0,1,1
18411,отмечены,0,0,1,1
18412,व्युत्पन्न,0,0,1,1
18414,решались,0,0,1,1
18422,combining,0,0,1,1
18415,pladsen,0,0,1,1
18416,रुचियों,0,0,1,1
18417,فعلت,0,0,1,1
18418,concluye,0,0,1,1
18419,gøres,0,0,1,1
18420,സാങ്കേതികവിദ്യയിൽ,0,0,1,1
18130,rojo,0,0,1,1
18125,starka,0,0,1,1
17673,lecturers,0,0,1,1
17804,preferindo,0,0,1,1
17809,ज़ोर,0,0,1,1
17811,важной,0,0,1,1
17812,​​உங்கள்,0,0,1,1
17813,ومفيدة,0,0,1,1
17814,relationerna,0,0,1,1
17815,cümleye,0,0,1,1
17817,"
तुर्क",0,0,1,1
17819,enfades,0,0,1,1
17820,வைக்கிறது,0,0,1,1
17821,freut,0,0,1,1
17823,gemensamma,0,0,1,1
17825,× kilograms,0,0,1,1
17827,utges,0,0,1,1
17828,assignment,0,0,1,1
17832,مسؤولون,0,0,1,1
17807,переплётом,0,0,1,1
17803,synnerhet,0,0,1,1
17777,refuse,0,0,1,1
17802,l’élection,0,0,1,1
17780,düğme,0,0,1,1
17781,ترتبط,0,0,1,1
17782,பரந்த,0,0,1,1
17783,hesitando,0,0,1,1
17786,हास्यास्पद,0,0,1,1
17787,temores,0,0,1,1
17788,aldın,0,0,1,1
17789,« passeur »,0,0,1,1
17790,κρατήσετε,0,0,1,1
17791,jeux,0,0,1,1
17792,وبراون،,0,0,1,1
17793,disagreeing,0,0,1,1
17798,समझा,0,0,1,1
17799,abstengan,0,0,1,1
17801,تعيينه,0,0,1,1
17833,وكذلك,0,0,1,1
17834,விக்கிப்பீடியாவிலிருந்து,0,0,1,1
17836,критику,0,0,1,1
17837,весь,0,0,1,1
17871,поздравить,0,0,1,1
17872,റോമൻ,0,0,1,1
17873,തെളിവുകൾ,0,0,1,1
17876,ಯೋಚಿಸಿ,0,0,1,1
17878,révélant,0,0,1,1
17879,fungere,0,0,1,1
17880,ആശ്വസിപ്പിക്കാൻ,0,0,1,1
17882,φάει,0,0,1,1
17883,اعتذر,0,0,1,1
17885,பயணி,0,0,1,1
17888,telefonda,0,0,1,1
17892,сломался,0,0,1,1
17895,കൊണ്ടുവന്നിട്ടുണ്ട്,0,0,1,1
17897,afogando,0,0,1,1
17898,—incluidos,0,0,1,1
17870,articulation,0,0,1,1
17869,aims,0,0,1,1
17867,attributes,0,0,1,1
17846,مدققو,0,0,1,1
17838,швеции,0,0,1,1
17841,പ്രത്യേകിച്ച്,0,0,1,1
17842,gravitation,0,0,1,1
17843,सपने,0,0,1,1
17844,discrepó,0,0,1,1
17845,undécimo,0,0,1,1
17847,уроки,0,0,1,1
17864,началась,0,0,1,1
17849,நாசீசஸ்,0,0,1,1
17854,jurk,0,0,1,1
17855,deciden,0,0,1,1
17856,диване,0,0,1,1
17860,nun,0,0,1,1
17862,dergelijks,0,0,1,1
17778,tómate,0,0,1,1
17775,تقريبًا،,0,0,1,1
18124,സുഹൃത്തുക്കളായിരുന്നു,0,0,1,1
17697,प्रेमी,0,0,1,1
17699,langue »,0,0,1,1
17700,pouvoirs,0,0,1,1
17701,സ്പീക്കറുകൾ,0,0,1,1
17702,voeden,0,0,1,1
17703,ولكي,0,0,1,1
17704,proost,0,0,1,1
17707,recebem,0,0,1,1
17708,купили,0,0,1,1
17709,bandeaux,0,0,1,1
17710,всемирная,0,0,1,1
17712,mentaal,0,0,1,1
17713,ಗಂಭೀರವಾದ,0,0,1,1
17714,авторское,0,0,1,1
17715,устарел,0,0,1,1
17716,assuré,0,0,1,1
17698,дальнейшее,0,0,1,1
17696,zusammenhang,0,0,1,1
17774,посчитает,0,0,1,1
17695,nede,0,0,1,1
17674,διανομή,0,0,1,1
17675,nytt,0,0,1,1
17676,approuvés,0,0,1,1
17677,keşfi,0,0,1,1
17678,motsvarade,0,0,1,1
17682,அதே,0,0,1,1
17683,tipografía,0,0,1,1
17685,eklemeler,0,0,1,1
17686,सरकारी,0,0,1,1
17687,ഗുണമേന്മയ്ക്കു,0,0,1,1
17688,definan,0,0,1,1
17690,fuerza,0,0,1,1
17691,yoluna,0,0,1,1
17693,story,0,0,1,1
17694,டிகிரிக்குக்,0,0,1,1
17717,noruego,0,0,1,1
17718,खबर,0,0,1,1
17719,έθιμα,0,0,1,1
17720,manglende,0,0,1,1
17751,रणनीति,0,0,1,1
17752,tranche,0,0,1,1
17755,recuperó,0,0,1,1
17756,неплохо,0,0,1,1
17757,पीपुल्स,0,0,1,1
17758,മാറ്റുക,0,0,1,1
17759,столько,0,0,1,1
17760,vandalizada,0,0,1,1
17763,"
हंगेरियाई",0,0,1,1
17764,"
संस्कृत",0,0,1,1
17765,permise,0,0,1,1
17766,என்பதோடு,0,0,1,1
17769,mixture,0,0,1,1
17770,ആഴ്ചകളോ,0,0,1,1
17773,столом,0,0,1,1
17749,दस्तावेजों,0,0,1,1
17746,असंभव,0,0,1,1
17745,snegl,0,0,1,1
17729,anlamadıysa,0,0,1,1
17721,செய்யலாம்,0,0,1,1
17723,neglen,0,0,1,1
17724,തമിഴ്,0,0,1,1
17725,التقليدية،,0,0,1,1
17726,länkas,0,0,1,1
17728,моего,0,0,1,1
17730,nonliving,0,0,1,1
17738,αντιγράψετε,0,0,1,1
17731,மீறல்,0,0,1,1
17732,ಕಣ್ಣೀರಿಗೆ,0,0,1,1
17733,доступен,0,0,1,1
17735,migration,0,0,1,1
17736,operação,0,0,1,1
17737,spontanément,0,0,1,1
17900,ಮಾಡುತ್ತೀರಾ,0,0,1,1
17902,lezers,0,0,1,1
17904,asturies,0,0,1,1
18041,പ്രപഞ്ചത്തെയും,0,0,1,1
18044,eden,0,0,1,1
18048,ಜಾಗದಲ್ಲಿ,0,0,1,1
18050,التطبيقات,0,0,1,1
18051,ജയിലുകളിൽ,0,0,1,1
18052,nederlandse,0,0,1,1
18053,featureartikler,0,0,1,1
18054,учителя,0,0,1,1
18056,पकड़,0,0,1,1
18059,стилистических,0,0,1,1
18060,randevunuz,0,0,1,1
18061,أطلب,0,0,1,1
18064,médiathèque,0,0,1,1
18066,soldiers,0,0,1,1
18067,chamador,0,0,1,1
18068,يضربني,0,0,1,1
18043,सांख्यिकीय,0,0,1,1
18040,вопросами,0,0,1,1
17905,pregunte,0,0,1,1
18039,autoconfirmed,0,0,1,1
18018,vilseledande,0,0,1,1
18019,βαθιά,0,0,1,1
18020,garantiza,0,0,1,1
18022,പ്രതിഭാസങ്ങളെയും,0,0,1,1
18024,सम्पूर्ण,0,0,1,1
18025,glückwünsche,0,0,1,1
18026,reichtum,0,0,1,1
18028,educacional,0,0,1,1
18030,உலகின்,0,0,1,1
18031,opôsse,0,0,1,1
18032,frit,0,0,1,1
18033,relate,0,0,1,1
18036,hébergeur,0,0,1,1
18037,ವಿವಾಹದ,0,0,1,1
18038,മുന്നിൽ,0,0,1,1
18069,objectivity,0,0,1,1
18072,വാക്കിനെക്കുറിച്ച്,0,0,1,1
18073,dialetos,0,0,1,1
18075,chiste,0,0,1,1
18102,сформулировало,0,0,1,1
18103,anpassas,0,0,1,1
18104,begins,0,0,1,1
18105,qualifié,0,0,1,1
18108,placed,0,0,1,1
18110,"
alemão",0,0,1,1
18111,повторяется,0,0,1,1
18112,سيفوليلي,0,0,1,1
18114,flotte,0,0,1,1
18117,tá,0,0,1,1
18118,mistet,0,0,1,1
18120,excessivamente,0,0,1,1
18121,звук,0,0,1,1
18122,палец,0,0,1,1
18123,efectos,0,0,1,1
18101,solucionar,0,0,1,1
18100,incompréhensible,0,0,1,1
18098,രഹസ്യവുമായ,0,0,1,1
18084,स्टाप,0,0,1,1
18077,existieron,0,0,1,1
18078,подчеркнуть,0,0,1,1
18080,الخبرة,0,0,1,1
18081,ohyou,0,0,1,1
18082,സിന്ധൂനദീതടസംസ്കാരം,0,0,1,1
18083,lagrade,0,0,1,1
18085,appelées,0,0,1,1
18096,دلهي,0,0,1,1
18088,എടുക്കരുത്,0,0,1,1
18089,விஷயங்களை,0,0,1,1
18090,noyer,0,0,1,1
18091,κάποιες,0,0,1,1
18093,ஏனைய,0,0,1,1
18094,германии,0,0,1,1
18017,பெறும்போது,0,0,1,1
18016,दिलाना,0,0,1,1
18015,ओक्स्फोर्ड,0,0,1,1
17956,обама,0,0,1,1
17934,вебсайта,0,0,1,1
17935,obsession,0,0,1,1
17936,adoraria,0,0,1,1
17937,influencées,0,0,1,1
17938,управления,0,0,1,1
17939,എന്നതുപോലെയാണ്,0,0,1,1
17940,schaut,0,0,1,1
17944,içerik,0,0,1,1
17945,பொத்தானைக்,0,0,1,1
17946,ಬಂದಿದ್ದೇನೆ,0,0,1,1
17947,foradalei,0,0,1,1
17949,"
वोलापूक",0,0,1,1
17950,yüksek,0,0,1,1
17951,താൽപ്പര്യമുണ്ടെന്ന്,0,0,1,1
17952,uppmanar,0,0,1,1
17931,ക്രോസ്സ്,0,0,1,1
17929,وخسرت,0,0,1,1
17928,حقول,0,0,1,1
17917,vecka,0,0,1,1
17906,тонуть,0,0,1,1
17908,relatif,0,0,1,1
17909,കുട്ടിക്ക്,0,0,1,1
17910,picture,0,0,1,1
17912,ഭാര്യയായിരിക്കേണ്ട,0,0,1,1
17913,opted,0,0,1,1
17918,​​med,0,0,1,1
17927,esforços,0,0,1,1
17920,الطفولة،,0,0,1,1
17921,afbryder,0,0,1,1
17922,ihtiyacınız,0,0,1,1
17923,ಕಣ್ಣು,0,0,1,1
17924,overzicht,0,0,1,1
17925,kitaplarda,0,0,1,1
17953,upprörda,0,0,1,1
17957,заинтересованы,0,0,1,1
18014,colores,0,0,1,1
17958,ക്ഷമയോടെ,0,0,1,1
17994,gemiddelde,0,0,1,1
17995,കനത്ത,0,0,1,1
17997,soy,0,0,1,1
17998,മറികടന്നുവെന്നും,0,0,1,1
17999,anomalous,0,0,1,1
18000,descubierto,0,0,1,1
18002,kommentere,0,0,1,1
18003,ರೀತಿಯ,0,0,1,1
18004,उपसमुच्चय,0,0,1,1
18005,متباينة،,0,0,1,1
18008,الفعل,0,0,1,1
18010,restricted,0,0,1,1
18011,suitable,0,0,1,1
18012,moderação,0,0,1,1
18013,स्टेवर्डशिप,0,0,1,1
17993,recettes,0,0,1,1
17991,respond,0,0,1,1
17987,comienzos,0,0,1,1
17970,गहराई,0,0,1,1
17960,கேள்விப்பட்டிருக்கிறீர்கள்,0,0,1,1
17961,fantaisistes,0,0,1,1
17963,सुविधाओं,0,0,1,1
17965,அட்டூழியம்,0,0,1,1
17968,προσλάβουμε,0,0,1,1
17969,σχετική,0,0,1,1
17971,sohbetin,0,0,1,1
17984,courte,0,0,1,1
17972,återställs,0,0,1,1
17975,invite,0,0,1,1
17976,помоги,0,0,1,1
17978,orkanen,0,0,1,1
17981,afspiegeling,0,0,1,1
17983,confie,0,0,1,1
16779,общедоступным,0,0,1,1
16777,ആക്റ്റിവിസത്തിന്റെ,0,0,1,1
14831,trabalhista,0,0,1,1
15467,totally,0,0,1,1
15470,pre,0,0,1,1
15472,ووصلت,0,0,1,1
15473,എന്തുകൊണ്ടെന്ന്,0,0,1,1
15474,brevetage,0,0,1,1
15476,العد،,0,0,1,1
15477,bornes,0,0,1,1
15478,licorne,0,0,1,1
15482,versucht,0,0,1,1
15483,கட்டுரைகளை,0,0,1,1
15486,നിന്നുള്ള,0,0,1,1
15488,ನಿಧಾನಗತಿಯಲ್ಲಿ,0,0,1,1
15489,actualités,0,0,1,1
15490,interplanetary,0,0,1,1
15491,lujo,0,0,1,1
15492,разрабатывались,0,0,1,1
15468,низкокачественные,0,0,1,1
15466,bewundernden,0,0,1,1
15437,തോന്നുന്ന,0,0,1,1
15463,çalışmanız,0,0,1,1
15441,ഉപയോഗിക്കാനുള്ള,0,0,1,1
15442,aşağıya,0,0,1,1
15443,φέτα,0,0,1,1
15444,paulo,0,0,1,1
15446,ouça,0,0,1,1
15447,പ്രവൃത്തിയാണെന്ന്,0,0,1,1
15449,redistribuílo,0,0,1,1
15450,probable,0,0,1,1
15451,sürdürmelerini,0,0,1,1
15452,തുടങ്ങുന്നത്,0,0,1,1
15454,uttalet,0,0,1,1
15455,പറയുന്ന,0,0,1,1
15457,açıktır,0,0,1,1
15460,ചേർക്കുമ്പോൾ,0,0,1,1
15461,gerenommeerd,0,0,1,1
15495,комментируя,0,0,1,1
15496,støttes,0,0,1,1
15498,vokse,0,0,1,1
15500,ಹಂತವನ್ನು,0,0,1,1
15538,പരിഗണിക്കുന്നു,0,0,1,1
15539,arcaísmo,0,0,1,1
15541,inheritable,0,0,1,1
15542,hochzeitskleid,0,0,1,1
15544,seng,0,0,1,1
15545,എന്നതിനർത്ഥം,0,0,1,1
15546,पठन,0,0,1,1
15547,inició,0,0,1,1
15549,γεννηθεί,0,0,1,1
15553,സ്താനാർബുദം,0,0,1,1
15554,stiftelsens,0,0,1,1
15555,टाटर,0,0,1,1
15558,الطب,0,0,1,1
15560,estaria,0,0,1,1
15561,распределяются,0,0,1,1
15534,والذي,0,0,1,1
15532,തീര്ച്ചയായും,0,0,1,1
15531,udgaver,0,0,1,1
15509,peticiones,0,0,1,1
15501,مرعوب,0,0,1,1
15502,fotográfica,0,0,1,1
15503,красивая,0,0,1,1
15504,"
कन्नड़",0,0,1,1
15505,reacts,0,0,1,1
15507,zehn,0,0,1,1
15512,notablemente,0,0,1,1
15528,bizimle,0,0,1,1
15515,chegado,0,0,1,1
15518,zeiden,0,0,1,1
15521,बालकनी,0,0,1,1
15523,bereikbaar,0,0,1,1
15525,donatorer,0,0,1,1
15527,etikettregler,0,0,1,1
15439,учётом,0,0,1,1
15436,atmosphère,0,0,1,1
15564,ಬೇಕಾದುದಾದರೆ,0,0,1,1
15347,പരിശോധിച്ച,0,0,1,1
15349,liking,0,0,1,1
15352,ಹೆಂಡತಿಯಾಗಿರಬೇಕು,0,0,1,1
15353,велась,0,0,1,1
15356,potencial,0,0,1,1
15360,தொடரச்,0,0,1,1
15361,ಸಮಾಚಾರ,0,0,1,1
15362,"
हिन्दी",0,0,1,1
15363,ഡബ്ല്യു,0,0,1,1
15365,بالمشاهدة,0,0,1,1
15369,jv •,0,0,1,1
15370,ഇമെയിൽ,0,0,1,1
15372,घूर,0,0,1,1
15373,"
min",0,0,1,1
15375,प्रेमिका,0,0,1,1
15376,ಆಶ್ಚರ್ಯಪಟ್ಟರು,0,0,1,1
15348,användarkonto,0,0,1,1
15345,fingrene,0,0,1,1
15435,للموارد,0,0,1,1
15342,സഞ്ചരിക്കുന്ന,0,0,1,1
15321,تعلمون,0,0,1,1
15322,المضحك,0,0,1,1
15323,anglófona,0,0,1,1
15324,пообщаться,0,0,1,1
15325,underground,0,0,1,1
15326,fixe ,0,0,1,1
15328,rejection,0,0,1,1
15330,കേൾക്കുക,0,0,1,1
15331,explicar,0,0,1,1
15332,ಬಂದನು,0,0,1,1
15334,பன்மொழி,0,0,1,1
15336,معاداة,0,0,1,1
15337,gentagelse,0,0,1,1
15339,последних,0,0,1,1
15340,обеспечение,0,0,1,1
15377,массовых,0,0,1,1
15378,producerar,0,0,1,1
15379,genellikle,0,0,1,1
15380,பயன்படுத்துவது,0,0,1,1
15401,admiring,0,0,1,1
15402,स्लेव,0,0,1,1
15403,ವಿವರಿಸಲು,0,0,1,1
15411,حين,0,0,1,1
15414,falhas,0,0,1,1
15416,falsehoods,0,0,1,1
15417,قبول,0,0,1,1
15421,ഇഷ്ടപ്പെടുകയും,0,0,1,1
15426,wikipedian,0,0,1,1
15427,efectúan,0,0,1,1
15428,உரைக்கு,0,0,1,1
15430,टाडिक,0,0,1,1
15432,primære,0,0,1,1
15433,ದೀರ್ಘಕಾಲದವರೆಗೆ,0,0,1,1
15434,yiyemiyorsan,0,0,1,1
15400,особенных,0,0,1,1
15399,психолога,0,0,1,1
15398,grants,0,0,1,1
15388,محرريها,0,0,1,1
15381,artikelredigeringar,0,0,1,1
15382,handwriting,0,0,1,1
15383,basmadıysanız,0,0,1,1
15385,ದೊಡ್ಡವಳು,0,0,1,1
15386,altas,0,0,1,1
15387,задаваемых,0,0,1,1
15389,hospedados,0,0,1,1
15397,السابقة,0,0,1,1
15390,opmerken,0,0,1,1
15391,جعل,0,0,1,1
15392,விதிவிலக்காக,0,0,1,1
15394,стрессовых,0,0,1,1
15395,nomeadamente,0,0,1,1
15396,aufzumuntern,0,0,1,1
15562,красоту,0,0,1,1
15565,lämnat,0,0,1,1
16775,quitaría,0,0,1,1
15719,ಪಾದಗಳನ್ನು,0,0,1,1
15722,beynimizi,0,0,1,1
15724,plet,0,0,1,1
15725,produjo,0,0,1,1
15726,ahogando,0,0,1,1
15727,πέρα,0,0,1,1
15731,ಖಾತ್ರಿಯಿಲ್ಲ,0,0,1,1
15732,είπαν,0,0,1,1
15734,छींक,0,0,1,1
15736,பிரச்சனையும்,0,0,1,1
15738,rağmen,0,0,1,1
15739,editando,0,0,1,1
15742,الشأن,0,0,1,1
15744,ஏற்படுத்தப்பட்டுள்ள,0,0,1,1
15745,ಹಾಡುಗಳಲ್ಲಿ,0,0,1,1
15749,clássicas,0,0,1,1
15720,السلام,0,0,1,1
15718,almadınız,0,0,1,1
15687,kalbi,0,0,1,1
15717,innecesarios,0,0,1,1
15690,அதையே,0,0,1,1
15696,antiguo,0,0,1,1
15697,وحشيًا,0,0,1,1
15700,ويكيبديا،,0,0,1,1
15701,race,0,0,1,1
15702,ಪಂದ್ಯವನ್ನು,0,0,1,1
15703,utilizadores,0,0,1,1
15706,αναστατωθεί,0,0,1,1
15707,weerlegging,0,0,1,1
15709,förolämpning,0,0,1,1
15710,ಟಾಪ್,0,0,1,1
15712,none,0,0,1,1
15713,établies,0,0,1,1
15714,wachsen,0,0,1,1
15715,ويليز,0,0,1,1
15750,tilgå,0,0,1,1
15751,artikelhistorik,0,0,1,1
15752,δυστυχώς,0,0,1,1
15753,spændende,0,0,1,1
15787,obeying,0,0,1,1
15788,தேர்வுகள்,0,0,1,1
15789,തിരുത്താനും,0,0,1,1
15790,сообщества,0,0,1,1
15792,angebote,0,0,1,1
15793,événement,0,0,1,1
15794,suisseah,0,0,1,1
15795,estamos,0,0,1,1
15797,ракушка,0,0,1,1
15798,paysage,0,0,1,1
15799,சொல்லக்கூடிய,0,0,1,1
15800,அலெக்சா,0,0,1,1
15802,corner,0,0,1,1
15803,dönmüş,0,0,1,1
15804,وأخذت,0,0,1,1
15785,تماما,0,0,1,1
15784,وتخصصهم,0,0,1,1
15783,interesa,0,0,1,1
15765,syltetøj,0,0,1,1
15755,ओपनसोलारिस,0,0,1,1
15756,keskinliği,0,0,1,1
15757,soruyorsunuz,0,0,1,1
15760,ljudet,0,0,1,1
15762,άδεια,0,0,1,1
15763,bråkdel,0,0,1,1
15767,underutilized,0,0,1,1
15782,രുചിയുടെ,0,0,1,1
15772,substantial,0,0,1,1
15774,العادات,0,0,1,1
15775,hermana,0,0,1,1
15776,húngaro,0,0,1,1
15779,startede,0,0,1,1
15781,вобрал,0,0,1,1
15688,wikipedia”,0,0,1,1
15681,datorer,0,0,1,1
15568,inconsistencia,0,0,1,1
15594,jämförbar,0,0,1,1
15596,idéologies,0,0,1,1
15598,योगदानकर्ताज्ञान,0,0,1,1
15599,खरीदना,0,0,1,1
15600,ബേക്കർ,0,0,1,1
15603,സ്ത്രീ,0,0,1,1
15604,formu,0,0,1,1
15608,främjas,0,0,1,1
15610,гавайского,0,0,1,1
15612,kapatılmasını,0,0,1,1
15615,ദയാലുവാണ്,0,0,1,1
15619,культурный,0,0,1,1
15621,தம்முள்,0,0,1,1
15623,മനുഷ്യനും,0,0,1,1
15624,പോകുക,0,0,1,1
15625,بل,0,0,1,1
15595,இருப்பதைக்,0,0,1,1
15593,أصابعي,0,0,1,1
15680,കൃത്രിമബുദ്ധിയുടെ,0,0,1,1
15589,describía,0,0,1,1
15570,подвез,0,0,1,1
15571,compactamiento,0,0,1,1
15573,ikisinde,0,0,1,1
15574,redigeringssammanfattningar,0,0,1,1
15576,photo,0,0,1,1
15577,sacolejou,0,0,1,1
15578,clúster,0,0,1,1
15579,yazdıklarını,0,0,1,1
15580,التعليمية,0,0,1,1
15581,prehistory,0,0,1,1
15582,desfrutam,0,0,1,1
15583,servrarna,0,0,1,1
15585,germanlanguage,0,0,1,1
15587,hervatten,0,0,1,1
15588,aesthetic,0,0,1,1
15626,supports,0,0,1,1
15628,вреда,0,0,1,1
15629,schlimmer,0,0,1,1
15630,البحث،,0,0,1,1
15659,പ്രക്രിയയിലൂടെ,0,0,1,1
15660,கற்கள்,0,0,1,1
15661,vanvittigt,0,0,1,1
15662,corrigen,0,0,1,1
15663,поддержанию,0,0,1,1
15664,« violation,0,0,1,1
15666,surprised,0,0,1,1
15667,ಹೋಗಬಹುದು,0,0,1,1
15669,όμορφα,0,0,1,1
15670,статьями,0,0,1,1
15671,проведённое,0,0,1,1
15672,surprise,0,0,1,1
15674,exato,0,0,1,1
15677,എവിടെയാണെന്ന്,0,0,1,1
15678,instante,0,0,1,1
15656,retirada,0,0,1,1
15655,temse,0,0,1,1
15652,सुविचारित,0,0,1,1
15639,stripfiguren,0,0,1,1
15631,croisée,0,0,1,1
15633,भावना,0,0,1,1
15634,данная,0,0,1,1
15635,ಸಿದ್ಧಪಡಿಸಿದ್ದೇನೆ,0,0,1,1
15637,αδύνατη,0,0,1,1
15638,அடைந்தது,0,0,1,1
15640,basması,0,0,1,1
15651,வாக்கியத்தில்,0,0,1,1
15642,ψήσω,0,0,1,1
15643,ಕನಸನ್ನು,0,0,1,1
15644,புன்னகைக்கச்,0,0,1,1
15646,المعرفة،,0,0,1,1
15647,suavizando,0,0,1,1
15650,könnten,0,0,1,1
15320,ಹಿಸಿದರೂ,0,0,1,1
15319,വിഷമിക്കുന്നുവെന്നും,0,0,1,1
15318,limace,0,0,1,1
14986,поняли,0,0,1,1
14990,ásia,0,0,1,1
14991,tohumları,0,0,1,1
14993,വായിച്ച്,0,0,1,1
14995,besteht,0,0,1,1
14997,sjunka,0,0,1,1
14998,"
रूसिन",0,0,1,1
14999,ಮಾಡಬಲ್ಲೆ,0,0,1,1
15000,ಹಾಸ್ಯವನ್ನು,0,0,1,1
15003,ക്രൂരതയും,0,0,1,1
15004,trouvant,0,0,1,1
15005,​​lange,0,0,1,1
15006,വിചാരിക്കുന്നത്,0,0,1,1
15007,stopte,0,0,1,1
15008,ತಲುಪಿತು,0,0,1,1
15009,listo,0,0,1,1
14989,плакал,0,0,1,1
14985,الحق,0,0,1,1
14952,betrekkelijk,0,0,1,1
14984,تحسينات,0,0,1,1
14954,விளையாட்டை,0,0,1,1
14956,kendileri,0,0,1,1
14959,machine »,0,0,1,1
14960,réseau »,0,0,1,1
14964,കടത്തി,0,0,1,1
14968,സമ്പത്തും,0,0,1,1
14969,انتحالًا,0,0,1,1
14970,cuídate,0,0,1,1
14971,இல்லாத,0,0,1,1
14972,ದೌರ್ಜನ್ಯದ,0,0,1,1
14976,nupedias,0,0,1,1
14978,universités,0,0,1,1
14979,distributing,0,0,1,1
14980,studier,0,0,1,1
14982,அவளைப்,0,0,1,1
15010,प्रविष्ट,0,0,1,1
15013,œuvres,0,0,1,1
15015,gemeinsame,0,0,1,1
15017,தமக்கு,0,0,1,1
15049,تي,0,0,1,1
15050,उबाऊ,0,0,1,1
15051,eu •,0,0,1,1
15052,"गया।
जुलाई",0,0,1,1
15053,contredite,0,0,1,1
15054,tatien,0,0,1,1
15055,காரியத்தைச்,0,0,1,1
15057,أمس,0,0,1,1
15061,точность,0,0,1,1
15062,arkadaşlar,0,0,1,1
15063,nära,0,0,1,1
15066,contenues,0,0,1,1
15068,presently,0,0,1,1
15069,bone,0,0,1,1
15071,humanmade,0,0,1,1
15048,origem,0,0,1,1
15044,χώρα,0,0,1,1
15043,hayvandır,0,0,1,1
15030,instantly,0,0,1,1
15018,élaboré,0,0,1,1
15020,बेवकूफी,0,0,1,1
15023,cyberspace,0,0,1,1
15026,accepte,0,0,1,1
15027,دعنى,0,0,1,1
15029,تحديد,0,0,1,1
15031,неприятной,0,0,1,1
15042,ആശയം,0,0,1,1
15032,ಸಂತೋಷದಿಂದ,0,0,1,1
15033,wikipub,0,0,1,1
15034,andas,0,0,1,1
15039,artistic,0,0,1,1
15040,ಹಿಂಜರಿಯುತ್ತಿದೆ,0,0,1,1
15041,δομημένων,0,0,1,1
14953,proliferate,0,0,1,1
14951,prononcez,0,0,1,1
15317,denuncias,0,0,1,1
14857,sıkışıp,0,0,1,1
14860,الآخرون,0,0,1,1
14862,nessas,0,0,1,1
14863,വ്യവസ്ഥിതിയുടെ,0,0,1,1
14868,utgångspunkt,0,0,1,1
14870,விடயங்கள்,0,0,1,1
14871,egentliga,0,0,1,1
14872,«lo,0,0,1,1
14874,reenters,0,0,1,1
14875,exercice,0,0,1,1
14877,отчасти,0,0,1,1
14878,φοβερού,0,0,1,1
14879,സ്റ്റോപ്പ്,0,0,1,1
14880,«fuentes,0,0,1,1
14882,ورائعًا,0,0,1,1
14883,hepimiz,0,0,1,1
14859,اللوحات,0,0,1,1
14856,المحتمل,0,0,1,1
14946,तारास्कीविका,0,0,1,1
14855,сработает,0,0,1,1
14832,volontaire,0,0,1,1
14833,dormait,0,0,1,1
14836,collabore,0,0,1,1
14838,wikiviajes,0,0,1,1
14840,enregistrées,0,0,1,1
14841,लंबा,0,0,1,1
14842,göstermiştir,0,0,1,1
14844,réalisable,0,0,1,1
14845,república,0,0,1,1
14847,klassiske,0,0,1,1
14848,företeelse,0,0,1,1
14849,معانيها,0,0,1,1
14850,искусственного,0,0,1,1
14852,içeriklerinde,0,0,1,1
14854,நடக்காத,0,0,1,1
14885,comienzo,0,0,1,1
14887,أقبل,0,0,1,1
14888,எனவும்,0,0,1,1
14890,aventures,0,0,1,1
14923,chances,0,0,1,1
14924,للقاء,0,0,1,1
14925,ethnologie,0,0,1,1
14926, ˌwɪkɨˈpiːdiə,0,0,1,1
14927,indonésie,0,0,1,1
14929,grouping,0,0,1,1
14930,pierda,0,0,1,1
14932,estrategias,0,0,1,1
14934,продолжите,0,0,1,1
14935,മണമുള്ള,0,0,1,1
14937,பெறுவேன்,0,0,1,1
14938,ydi,0,0,1,1
14939,loosely,0,0,1,1
14941,теоретическим,0,0,1,1
14945,चीज़,0,0,1,1
14922,തിരഞ്ഞെടുക്കാൻ,0,0,1,1
14919,"
बिकोल",0,0,1,1
14918,aplicáveis,0,0,1,1
14903,eğilimindedir,0,0,1,1
14893,универсальная,0,0,1,1
14894,smartphones,0,0,1,1
14895,sostenida,0,0,1,1
14896,demitidos,0,0,1,1
14900,استهدفت,0,0,1,1
14901,​​aos,0,0,1,1
14907,bence,0,0,1,1
14916,نبحث,0,0,1,1
14908,jurken,0,0,1,1
14909,وكأنه,0,0,1,1
14910,αίσθηση,0,0,1,1
14911,نول,0,0,1,1
14912,கொண்டார்,0,0,1,1
14914,boğuluyorum,0,0,1,1
15072,uitgebalanceerde,0,0,1,1
15073,ಪ್ರವಾಸಿಗನು,0,0,1,1
15075,certainement,0,0,1,1
15236,إذ,0,0,1,1
15239,δεύτερο,0,0,1,1
15240,प्रेक्षण,0,0,1,1
15241,connectée,0,0,1,1
15242,tonfalls,0,0,1,1
15243,"
checo",0,0,1,1
15244,வேலைக்காரிகள்,0,0,1,1
15245,denote,0,0,1,1
15246,uppfyller,0,0,1,1
15248,أمام,0,0,1,1
15249,hayas,0,0,1,1
15252,മനസ്സും,0,0,1,1
15253,istediğiniz,0,0,1,1
15254,continuarmos,0,0,1,1
15257,superou,0,0,1,1
15258,logístico,0,0,1,1
15237,symbiantelefoner,0,0,1,1
15235,സംഭവിക്കാത്ത,0,0,1,1
15078,commençait,0,0,1,1
15234,умного,0,0,1,1
15208,magisch,0,0,1,1
15209,ಸಮಸ್ಯೆಗಿಂತ,0,0,1,1
15211,"
नीपोलिटाई",0,0,1,1
15212,oplossing,0,0,1,1
15213,voortbouwen,0,0,1,1
15217,സ്ഥാനക്കയറ്റം,0,0,1,1
15218,ravi,0,0,1,1
15220,entero,0,0,1,1
15221,εύκολα,0,0,1,1
15225,வாசகர்களையும்,0,0,1,1
15226,обед,0,0,1,1
15228,polarisering,0,0,1,1
15230,"
मिंग्रिलियाई",0,0,1,1
15231,बीजों,0,0,1,1
15232,പരിശീലന,0,0,1,1
15259,discuter,0,0,1,1
15261,சதுப்புநிலம்,0,0,1,1
15264,øje,0,0,1,1
15265,esquecem,0,0,1,1
15291,procès,0,0,1,1
15293,silinebilir,0,0,1,1
15295,ഉള്ളവരായിരിക്കും,0,0,1,1
15296,parlak,0,0,1,1
15298,اختصاص،,0,0,1,1
15300,högerperspektiv,0,0,1,1
15307,финансировании,0,0,1,1
15308,verwarren,0,0,1,1
15309,बदलने,0,0,1,1
15310,avancement,0,0,1,1
15311,teria,0,0,1,1
15312,какието,0,0,1,1
15313,piltangenter,0,0,1,1
15314,أخبرتك,0,0,1,1
15316,arbitrage,0,0,1,1
15288,elske,0,0,1,1
15287,സമ്മതിക്കുകയും,0,0,1,1
15285,வீடியோவுக்கு,0,0,1,1
15273,mordisco,0,0,1,1
15266,ചാടിയാൽ,0,0,1,1
15267,bære,0,0,1,1
15268,chapters,0,0,1,1
15269,hundreds,0,0,1,1
15270,geográfica,0,0,1,1
15272,españolas,0,0,1,1
15274,sizes,0,0,1,1
15284,रॉय,0,0,1,1
15275,μοναδική,0,0,1,1
15276,ಫಲಿತಾಂಶವನ್ನು,0,0,1,1
15277,खाने,0,0,1,1
15281,ടെസ്റ്റു,0,0,1,1
15282,يفعله,0,0,1,1
15283,erweitern,0,0,1,1
15206,constitutionnels,0,0,1,1
15202,सर्वाधिक,0,0,1,1
15197,ಶ್ರಮವಹಿಸಬೇಕೆಂದು,0,0,1,1
15140,bedacht,0,0,1,1
15114,empty,0,0,1,1
15115,золотым,0,0,1,1
15116,quieren,0,0,1,1
15118,группу,0,0,1,1
15121,babosa,0,0,1,1
15128,attribué,0,0,1,1
15129,practica,0,0,1,1
15130,ಕುದುರೆಯಂತಹ,0,0,1,1
15131,gesprochen,0,0,1,1
15133,ஏற்கவும்,0,0,1,1
15134,éducatif,0,0,1,1
15135,administrativos,0,0,1,1
15136,ಖರೀದಿಸಲು,0,0,1,1
15137,ആകർഷകവും,0,0,1,1
15138,உதவிக்காக,0,0,1,1
15113,lexicografische,0,0,1,1
15111,واستضافة,0,0,1,1
15110,failures,0,0,1,1
15095,heritage,0,0,1,1
15082,bölümünde,0,0,1,1
15084,अन्तर्राष्ट्रीय,0,0,1,1
15085,prominent,0,0,1,1
15086,ಉಚ್ಚರಿಸುತ್ತಿದ್ದೀರಿ,0,0,1,1
15088,juridiquement,0,0,1,1
15094,fallacieuse,0,0,1,1
15097,talimatları,0,0,1,1
15109,abonneren,0,0,1,1
15100,contrôles,0,0,1,1
15102,നിർത്തുക,0,0,1,1
15103,ಅಪ್,0,0,1,1
15104,baseren,0,0,1,1
15105,ಒತ್ತುವ,0,0,1,1
15106,mystery,0,0,1,1
15139,ഭാഷാപരമായ,0,0,1,1
15142,ósseo,0,0,1,1
15195,hersenen,0,0,1,1
15143,تمكنهم,0,0,1,1
15171,catalisador,0,0,1,1
15173,ദയനീയമാണെന്ന്,0,0,1,1
15174,अन्तर्गत,0,0,1,1
15176,såklart,0,0,1,1
15179,मधुर,0,0,1,1
15180,determined,0,0,1,1
15181,الظروف,0,0,1,1
15184,fear,0,0,1,1
15185,пройдёт,0,0,1,1
15186,knappe,0,0,1,1
15187,buscan,0,0,1,1
15190,aménageurs,0,0,1,1
15191,sv •,0,0,1,1
15193,കമ്പ്യൂട്ടറുകളെ,0,0,1,1
15194,rangeret,0,0,1,1
15170,خاملة,0,0,1,1
15169,المتضاربين،,0,0,1,1
15168,suffisent,0,0,1,1
15152,посмотрел,0,0,1,1
15144,presidential,0,0,1,1
15145,поздравления,0,0,1,1
15146,ಹೋಗುವಾಗ,0,0,1,1
15147,ложной,0,0,1,1
15149,எதிர்மறை,0,0,1,1
15151,slovaque,0,0,1,1
15153,wochen,0,0,1,1
15167,मास्टर,0,0,1,1
15154,yılında,0,0,1,1
15156,произошло,0,0,1,1
15159,intervals,0,0,1,1
15162,представляют,0,0,1,1
15164,yaptığınız,0,0,1,1
15166,настройка,0,0,1,1
15808,äußersten,0,0,1,1
15812,उठाया।,0,0,1,1
15814,campanha,0,0,1,1
16448,ρωτήσει,0,0,1,1
16450,venant,0,0,1,1
16451,cohesiveness,0,0,1,1
16452,"design ·
environmental",0,0,1,1
16453,secretos,0,0,1,1
16454,अंतरों,0,0,1,1
16456,catalane,0,0,1,1
16457,omhelzen,0,0,1,1
16459,നന്നാക്കുന്നതിലൂടെ,0,0,1,1
16460,disasters,0,0,1,1
16461,meleğiyim,0,0,1,1
16463,vänta,0,0,1,1
16464,rattachée,0,0,1,1
16466,"
कॉर्निश",0,0,1,1
16467,выяснила,0,0,1,1
16468,благодарен,0,0,1,1
16449,picante,0,0,1,1
16447,chair,0,0,1,1
16411,hususlar,0,0,1,1
16444,снилось,0,0,1,1
16416,arabasına,0,0,1,1
16417,levande,0,0,1,1
16418,ervoor,0,0,1,1
16420,вкусной,0,0,1,1
16422,وبالنسبة,0,0,1,1
16423,"വിജ്ഞാനശകലങ്ങൾ
ചേർക്കുന്നവർക്കുണ്ടായേക്കാവുന്ന",0,0,1,1
16426,grundskoleexamen,0,0,1,1
16427,opmaak,0,0,1,1
16430,aplicações,0,0,1,1
16431,تجعلني,0,0,1,1
16433,ash,0,0,1,1
16437,विर्गील,0,0,1,1
16438,squares,0,0,1,1
16440,forced,0,0,1,1
16442,klass,0,0,1,1
16471,വസ്ത്രധാരണത്തിൽ,0,0,1,1
16472,விக்கியைப்,0,0,1,1
16473,признаете,0,0,1,1
16474,πια,0,0,1,1
16504,sketches,0,0,1,1
16505,états,0,0,1,1
16506,kahraman,0,0,1,1
16507,"
वर्तमान",0,0,1,1
16512,mislukkingen,0,0,1,1
16513,പിടിച്ചുനിൽക്കാമോ,0,0,1,1
16515,ayudarías,0,0,1,1
16516,zomer,0,0,1,1
16517,vistas,0,0,1,1
16519,பழக்கவழக்கங்கள்,0,0,1,1
16523,sexta,0,0,1,1
16524,agradecerles,0,0,1,1
16526,inicio,0,0,1,1
16528,everyday,0,0,1,1
16529,النظرات,0,0,1,1
16499,inversement,0,0,1,1
16495,தம்மிடையேயான,0,0,1,1
16494,взгляды,0,0,1,1
16481,enyongle,0,0,1,1
16475,индексации,0,0,1,1
16476,bardakçı’nın,0,0,1,1
16477,realizando,0,0,1,1
16478,élever,0,0,1,1
16479,ചെയ്യുന്നതിലൂടെയാണ്,0,0,1,1
16480,tids,0,0,1,1
16483,aceptados,0,0,1,1
16493,obtaining,0,0,1,1
16484,കാണാത്ത,0,0,1,1
16485,grijze,0,0,1,1
16487,നാർസിസിന്റെ,0,0,1,1
16488,bilmelisin,0,0,1,1
16489,பங்களிப்பாளர்களுக்கு,0,0,1,1
16490,விட்டுவிட்டால்,0,0,1,1
16415,ക്ലസ്റ്ററിംഗിലൂടെ,0,0,1,1
16410,സമ്പൂർണ്ണലേഖനം,0,0,1,1
16291,τακτικά,0,0,1,1
16338,importância,0,0,1,1
16341,tollen,0,0,1,1
16342,последняя,0,0,1,1
16343,ನಂಬಲಾಗದ,0,0,1,1
16344,ಸಂಪತ್ತು,0,0,1,1
16345,distribuciones,0,0,1,1
16346,reich,0,0,1,1
16347,отмечено,0,0,1,1
16348,respectivement,0,0,1,1
16349,நிமிடத்தில்,0,0,1,1
16351,şeyleri,0,0,1,1
16353,no»,0,0,1,1
16354,geuit,0,0,1,1
16355,പ്രസിദ്ധീകരണങ്ങളും,0,0,1,1
16356,മൂന്നും,0,0,1,1
16357,solicitaron,0,0,1,1
16339,சிமிட்டினர்,0,0,1,1
16337,dismoi,0,0,1,1
16409,hverdag,0,0,1,1
16336,ಚತುರನಾಗಿರುತ್ತೇನೆ,0,0,1,1
16298,оксфордского,0,0,1,1
16308,وبسبب,0,0,1,1
16311,கொண்டுவரலாம்,0,0,1,1
16320,tamam,0,0,1,1
16322,compared,0,0,1,1
16323,തണ്ണീർത്തടമാണ്,0,0,1,1
16324,supportée,0,0,1,1
16325,விருத்தி,0,0,1,1
16327,soruyor,0,0,1,1
16328,പാർട്ടിപ്രവർത്തകൻ,0,0,1,1
16329,முக்கிய,0,0,1,1
16330,oudste,0,0,1,1
16331,llanto,0,0,1,1
16332,убита,0,0,1,1
16333,चाहता।,0,0,1,1
16359,récente,0,0,1,1
16361,घंटी,0,0,1,1
16362,கொண்டிருந்தீர்கள்,0,0,1,1
16364,αμηχανία,0,0,1,1
16388,എഡിറ്റർമാർ,0,0,1,1
16389,errónea,0,0,1,1
16391,अकार्डिंग,0,0,1,1
16392,ಮೊದಲಿಗೆ,0,0,1,1
16394,software​,0,0,1,1
16395,редактора,0,0,1,1
16396,nécessitent,0,0,1,1
16398,многих,0,0,1,1
16399,"
किर्घिज़",0,0,1,1
16400,ഒന്നു,0,0,1,1
16401,गढ़ा,0,0,1,1
16404,பாதுகாக்கப்பட்டுள்ளன,0,0,1,1
16405,usálo,0,0,1,1
16407,readable,0,0,1,1
16408,வார்த்தையைத்,0,0,1,1
16387,reverta,0,0,1,1
16385,പരിചയപ്പെടാം,0,0,1,1
16384,सबस्क्रिप्शनओनली,0,0,1,1
16373,raciales,0,0,1,1
16365,ಉದಾಹರಣೆಯಲ್ಲಿ,0,0,1,1
16366,conceptions,0,0,1,1
16368,प्राणी,0,0,1,1
16370,ஆச்சரியப்பட்டாள்,0,0,1,1
16371,preguiçosos,0,0,1,1
16372,ഉചിതമല്ല,0,0,1,1
16375,கட்டுரை,0,0,1,1
16383,atomic,0,0,1,1
16376,ovanför,0,0,1,1
16377,scheibe,0,0,1,1
16378,ವಾರ,0,0,1,1
16380,"
asturiano",0,0,1,1
16381,compréhension,0,0,1,1
16382,ആവശ്യത്തിന്,0,0,1,1
16530,comprends,0,0,1,1
16533,mirada,0,0,1,1
16534,cheaper,0,0,1,1
16695,താക്കീതു,0,0,1,1
16698,sorts,0,0,1,1
16699,takılmıyorsun,0,0,1,1
16700,الغربية,0,0,1,1
16702,नरसिंह,0,0,1,1
16703,hanımların,0,0,1,1
16704,entorpecen,0,0,1,1
16705,traîner,0,0,1,1
16706,नियम,0,0,1,1
16707,देगा,0,0,1,1
16708,coração,0,0,1,1
16709,disentangles,0,0,1,1
16711,ജോലിയുണ്ട്,0,0,1,1
16712,förekommande,0,0,1,1
16713,بشأنه,0,0,1,1
16720,wikipédiameta,0,0,1,1
16697,rubies,0,0,1,1
16694,സ്ലഗ്,0,0,1,1
16535,طفل,0,0,1,1
16689,verebilirsin,0,0,1,1
16649,yüzlerce,0,0,1,1
16651,sensíveis,0,0,1,1
16654,dérive,0,0,1,1
16656,பிரமிக்க,0,0,1,1
16657,ಕೆಲವೇ,0,0,1,1
16659,persönlich,0,0,1,1
16662,разрешение,0,0,1,1
16667,للإنترنت,0,0,1,1
16669,doublé ,0,0,1,1
16672,قناة,0,0,1,1
16674,porn,0,0,1,1
16678,millennium,0,0,1,1
16682,വിജയിച്ചു,0,0,1,1
16683,mått,0,0,1,1
16688,fría,0,0,1,1
16722,pionnier,0,0,1,1
16724,kore,0,0,1,1
16728,выборе,0,0,1,1
16729,combinée,0,0,1,1
16750,задал,0,0,1,1
16751,تملك,0,0,1,1
16752,لإخبار,0,0,1,1
16753,alumnos,0,0,1,1
16754,kullanılmasını,0,0,1,1
16755,തണുത്തവരായിരിക്കാൻ,0,0,1,1
16758,создававшихся,0,0,1,1
16759,suscite,0,0,1,1
16760,tyckte,0,0,1,1
16761,despidieron,0,0,1,1
16762,связана,0,0,1,1
16767,ökade,0,0,1,1
16770,تدوين,0,0,1,1
16771,matéria,0,0,1,1
16774,संतुलित,0,0,1,1
16749,planering,0,0,1,1
16748,السلوك,0,0,1,1
16747,arkadaşım,0,0,1,1
16738,மொத்தக்,0,0,1,1
16730,घोषित,0,0,1,1
16732,belediging,0,0,1,1
16733,स्थानान्तरण,0,0,1,1
16734,dessous,0,0,1,1
16736,പൂർത്തിയാക്കട്ടെ,0,0,1,1
16737,proyectos​,0,0,1,1
16739,ಉಡುಗೊರೆಯನ್ನು,0,0,1,1
16746,convoluted,0,0,1,1
16740,ಹಸಿದಿದ್ದೇನೆ,0,0,1,1
16741,svensk,0,0,1,1
16742,personuppgifter,0,0,1,1
16743,filmlerde,0,0,1,1
16744,وتعتمد,0,0,1,1
16745,ಅವನನ್ನು,0,0,1,1
16646,проектами,0,0,1,1
16645,terugkomen,0,0,1,1
16644,പെരുപ്പിച്ചു,0,0,1,1
16594,включала,0,0,1,1
16563,hoor,0,0,1,1
16564,distant,0,0,1,1
16567,yunglo,0,0,1,1
16568,autoconfirmados,0,0,1,1
16569,reparieren,0,0,1,1
16571,perfecta,0,0,1,1
16576,llegaste,0,0,1,1
16577,morceau,0,0,1,1
16579,beslutsgång,0,0,1,1
16580,அறியப்பட்ட,0,0,1,1
16581,çapında,0,0,1,1
16582,وريجل,0,0,1,1
16587,karışırsa,0,0,1,1
16589,ലേർണിങ്machine,0,0,1,1
16592,autrui,0,0,1,1
16561,oude,0,0,1,1
16560,реализованная,0,0,1,1
16559,edilmez,0,0,1,1
16546,полагается,0,0,1,1
16536,திட்டமிட்டுள்ளேன்,0,0,1,1
16537,kennisgevingen,0,0,1,1
16539,ucraniano,0,0,1,1
16540,mk •,0,0,1,1
16541,встречаюсь,0,0,1,1
16545,sales,0,0,1,1
16547,heyecanlanıyoruz,0,0,1,1
16558,sendos,0,0,1,1
16548,நிறுத்தம்,0,0,1,1
16549,lustres,0,0,1,1
16550,disharmoni,0,0,1,1
16551,ಅರ್ಥಮಾಡಿಕೊಳ್ಳಲು,0,0,1,1
16556,faux,0,0,1,1
16557,проверке,0,0,1,1
16593,basculer,0,0,1,1
16595,définit,0,0,1,1
16642,„ахиллесовой,0,0,1,1
16596,confeccionar,0,0,1,1
16619,secretive,0,0,1,1
16620,балансирующие,0,0,1,1
16621,märka,0,0,1,1
16622,പൂന്തോട്ടത്തിൽ,0,0,1,1
16624,heraclitus,0,0,1,1
16627,estender,0,0,1,1
16628,olamazsın,0,0,1,1
16630,reisde,0,0,1,1
16634,«написание,0,0,1,1
16635,renovable,0,0,1,1
16636,ಎಲ್ಲವು,0,0,1,1
16638,xixe,0,0,1,1
16639,ड्राफ्ट,0,0,1,1
16640,punhado,0,0,1,1
16641,reemplazado,0,0,1,1
16618,مجهولون,0,0,1,1
16617,ранней,0,0,1,1
16616,fenomenet,0,0,1,1
16605,സഹായത്തിനായി,0,0,1,1
16598,behaves,0,0,1,1
16599,εκείνους,0,0,1,1
16600,bevisar,0,0,1,1
16601,உழைக்க,0,0,1,1
16602,stumt,0,0,1,1
16603,заявлении,0,0,1,1
16607,violent,0,0,1,1
16615,interpretada,0,0,1,1
16608,पंजाबी,0,0,1,1
16609,confitures,0,0,1,1
16611,antissociais,0,0,1,1
16612,caracteriza,0,0,1,1
16613,журналом,0,0,1,1
16614,constitution,0,0,1,1
16295,trading,0,0,1,1
16288,fantastik,0,0,1,1
15815,missnöje,0,0,1,1
15952,بالمحتوى,0,0,1,1
15960,propuestas,0,0,1,1
15962,fark,0,0,1,1
15963,அச்சத்தினாலும்,0,0,1,1
15964,تعديلها,0,0,1,1
15965,उन्हने,0,0,1,1
15967,ಮನೆಯ,0,0,1,1
15968,американских,0,0,1,1
15971,കഴിയുന്നില്ലെങ്കിൽ,0,0,1,1
15974,spredt,0,0,1,1
15976,κανόνα—αλλά,0,0,1,1
15978,restent,0,0,1,1
15980,çuvalladım,0,0,1,1
15982,оригинальные,0,0,1,1
15983,ξαφνικά,0,0,1,1
15984,incógnito,0,0,1,1
15953,வாரம்,0,0,1,1
15951,amené,0,0,1,1
15922,curta,0,0,1,1
15950,houden,0,0,1,1
15926,visões,0,0,1,1
15927,cruza,0,0,1,1
15928,hittat,0,0,1,1
15929,ഉപയോഗശൂന്യമായിരുന്നു,0,0,1,1
15930,развитии,0,0,1,1
15931,wikeepeedeeə,0,0,1,1
15933,созданы,0,0,1,1
15935,vrijgave,0,0,1,1
15936,сингапура,0,0,1,1
15939,inclui,0,0,1,1
15941,exercée,0,0,1,1
15942,ಮುಕ್ತನಾಗಿದ್ದೇನೆ,0,0,1,1
15944,inquiétude,0,0,1,1
15945,massive,0,0,1,1
15947,расположена,0,0,1,1
15985,ιανουαρίου,0,0,1,1
15986,ഭാഗവും,0,0,1,1
15987,envis,0,0,1,1
15988,endorheic,0,0,1,1
16017,العرض,0,0,1,1
16018,vinculado,0,0,1,1
16019,бейзингстоке,0,0,1,1
16020,இருவருமே,0,0,1,1
16021,forneçam,0,0,1,1
16024,തിരഞ്ഞെടുക്കുന്നതാണ്,0,0,1,1
16025,എഴുതുമ്പോൾ,0,0,1,1
16026,oposto,0,0,1,1
16027,dildeki,0,0,1,1
16028,மேலதிகமாக,0,0,1,1
16032,bidragydere,0,0,1,1
16034,tegenkwam,0,0,1,1
16036,balcon,0,0,1,1
16037,последующим,0,0,1,1
16038,brydde,0,0,1,1
16016,benden,0,0,1,1
16013,expertas,0,0,1,1
16012,smukkeste,0,0,1,1
15997,абсолютно,0,0,1,1
15989,créative,0,0,1,1
15991,инноваторству,0,0,1,1
15992,பையன்,0,0,1,1
15993,വിലയിരുത്തുന്നു,0,0,1,1
15994,su •,0,0,1,1
15996,istemiyorsa,0,0,1,1
15998,ಗಣಿತದ,0,0,1,1
16011,rommelig,0,0,1,1
15999,заболоченный,0,0,1,1
16002,أحضرت,0,0,1,1
16003,nacional,0,0,1,1
16005,sonhou,0,0,1,1
16007,недостатков,0,0,1,1
16008,yüce,0,0,1,1
15924,какуюлибо,0,0,1,1
15920,modales,0,0,1,1
16287,schwester,0,0,1,1
15842,attendues ,0,0,1,1
15844,नामक,0,0,1,1
15846,நகலெடுக்க,0,0,1,1
15847,ödevi,0,0,1,1
15848,clarified,0,0,1,1
15851,fullaste,0,0,1,1
15853,وإحلال,0,0,1,1
15855,empregava,0,0,1,1
15856,definirse,0,0,1,1
15857,ಭಾವಿಸಿದ್ದಳು,0,0,1,1
15858,ужасный,0,0,1,1
15863,संकेत,0,0,1,1
15864,സ്വർണ്ണനിറത്തിലായിരുന്നപ്പോൾ,0,0,1,1
15865,especulou,0,0,1,1
15866,السؤال,0,0,1,1
15868,ओ,0,0,1,1
15843,مليوني,0,0,1,1
15839,constructivos,0,0,1,1
15919,locura»,0,0,1,1
15837,conozcas,0,0,1,1
15817,подвергаться,0,0,1,1
15820,unintelligen,0,0,1,1
15821,സ്വപ്ന,0,0,1,1
15822,meridional,0,0,1,1
15823,അസൈൻമെന്റുകളിൽ,0,0,1,1
15824,ಮಾಹಿತಿಗಾಗಿ,0,0,1,1
15825,yoludur,0,0,1,1
15826,ameaças,0,0,1,1
15827,bemerken,0,0,1,1
15828,lisanslama,0,0,1,1
15830,begränsades,0,0,1,1
15832,"हैं।
",0,0,1,1
15833,προσφορές,0,0,1,1
15834,الشرفة,0,0,1,1
15835,zoekopdracht,0,0,1,1
15870,ಸ್ಲಗ್,0,0,1,1
15871,ಎಂಬುದರಂತೆ,0,0,1,1
15872,sumado,0,0,1,1
15873,ويشكو,0,0,1,1
15901,kenmerkend,0,0,1,1
15902,воспроизведение,0,0,1,1
15903,போவது,0,0,1,1
15904,barely,0,0,1,1
15906,sürü,0,0,1,1
15907,மற்றவர்களிடம்,0,0,1,1
15908,exemplifierar,0,0,1,1
15911,തയ്യാറാക്കുന്നത്,0,0,1,1
15912,അഭിപ്രായ,0,0,1,1
15913,मुद्दा,0,0,1,1
15914,ಪ್ರವಾಸವನ್ನು,0,0,1,1
15915,കാണാനായതിൽ,0,0,1,1
15916,flavio,0,0,1,1
15917,الجميل,0,0,1,1
15918,карету,0,0,1,1
15900,сильны,0,0,1,1
15899,ಜೀವಂತವಾಗಿದ್ದ,0,0,1,1
15898,любимое,0,0,1,1
15882,बिन्दुओं,0,0,1,1
15874,internetsajter,0,0,1,1
15876,afbryde,0,0,1,1
15877,minnettarım,0,0,1,1
15878,discontinued,0,0,1,1
15880,गोर्मनने,0,0,1,1
15881,experiments,0,0,1,1
15883,intelligens,0,0,1,1
15894,desea,0,0,1,1
15884,وgerman،,0,0,1,1
15885,предполагает,0,0,1,1
15886,വിജ്ഞാനതൃഷ്ണയും,0,0,1,1
15887,ரகசியம்,0,0,1,1
15891,للمجتمع،,0,0,1,1
15892,bakışları,0,0,1,1
16042,ಎಲ್ಲೀ,0,0,1,1
16047,gleiche,0,0,1,1
16048,पड़ता।,0,0,1,1
16196,الأنواع,0,0,1,1
16198,உதவும்,0,0,1,1
16201,kedeligt,0,0,1,1
16202,очевидной,0,0,1,1
16203,salladın,0,0,1,1
16209,голосов,0,0,1,1
16210,എടുത്തു,0,0,1,1
16212,conserving,0,0,1,1
16213,обоих,0,0,1,1
16221,adivinhado,0,0,1,1
16224,ഒന്നാം,0,0,1,1
16225,dumpen,0,0,1,1
16226,réductible,0,0,1,1
16227,принести,0,0,1,1
16228,напоминает,0,0,1,1
16229,उम्र,0,0,1,1
16197,കടം,0,0,1,1
16195,constituents,0,0,1,1
16050,idéologique,0,0,1,1
16194,പ്രാധാന്യം,0,0,1,1
16175,stcentury,0,0,1,1
16176,étapes,0,0,1,1
16177,इंगित,0,0,1,1
16178,انخفضت,0,0,1,1
16181,خطأي,0,0,1,1
16182,утверждение,0,0,1,1
16183,löst,0,0,1,1
16184,istemezdim,0,0,1,1
16187,الأخرى،,0,0,1,1
16188,٪,0,0,1,1
16189,adamların,0,0,1,1
16190,ledde,0,0,1,1
16191,acontecimientos,0,0,1,1
16192,dumb,0,0,1,1
16193,bijgewerkt,0,0,1,1
16231,entières,0,0,1,1
16232,உலகம்,0,0,1,1
16233,demografie,0,0,1,1
16234,exagerarla,0,0,1,1
16262,نتيجة,0,0,1,1
16263,वस्तुओं,0,0,1,1
16264,"
मिस्री",0,0,1,1
16267,அழுகிற,0,0,1,1
16269,анонсировала,0,0,1,1
16271,उल्लेखनीय,0,0,1,1
16274,അന്തരം,0,0,1,1
16276,accélérée,0,0,1,1
16280,സാഹചര്യത്തിലായിരിക്കുക,0,0,1,1
16281,salater,0,0,1,1
16282,geometría,0,0,1,1
16283,organizar,0,0,1,1
16284,compensaban,0,0,1,1
16285,historiques,0,0,1,1
16286,saborosas,0,0,1,1
16261,claros,0,0,1,1
16260,votos,0,0,1,1
16259,combined,0,0,1,1
16243,repetidos,0,0,1,1
16236,продолжим,0,0,1,1
16237,bakalım,0,0,1,1
16238,ഇടമില്ല,0,0,1,1
16239,ανεβάζετε,0,0,1,1
16240,anlayabileceği,0,0,1,1
16241,ilustrativa,0,0,1,1
16244,"
ऑसिशियाई",0,0,1,1
16257,– million,0,0,1,1
16246,fracaso,0,0,1,1
16249,بالضغط,0,0,1,1
16250,ಕಾಣುತ್ತಿದ್ದೀರಿ,0,0,1,1
16252,diles,0,0,1,1
16254,crust,0,0,1,1
16255,indsats,0,0,1,1
16174,ഞങ്ങൾക്ക്,0,0,1,1
16173,havaiana,0,0,1,1
16170,drukning,0,0,1,1
16114,editoras,0,0,1,1
16083,starrten,0,0,1,1
16086,संवेदनशीलता,0,0,1,1
16087,tests,0,0,1,1
16092,εγγραφείτε,0,0,1,1
16093,இதனைப்,0,0,1,1
16096,verbeter,0,0,1,1
16098,kullanılan,0,0,1,1
16099,learnt,0,0,1,1
16100,anunciaram,0,0,1,1
16103,visitante,0,0,1,1
16104,åldrar,0,0,1,1
16105,katkıda,0,0,1,1
16107,zinken,0,0,1,1
16108,συμμετέχοντες,0,0,1,1
16112,solicitado,0,0,1,1
16082,bevæge,0,0,1,1
16081,установило,0,0,1,1
16080,trasfondo,0,0,1,1
16062,capturing,0,0,1,1
16051,repentinamente,0,0,1,1
16052,feelings,0,0,1,1
16053,والفرنسية,0,0,1,1
16055,படையினருக்கான,0,0,1,1
16056,dédié,0,0,1,1
16058,போதுமானதாக,0,0,1,1
16064,shell,0,0,1,1
16079,प्रारूप,0,0,1,1
16065,conseguirás,0,0,1,1
16066,bedt,0,0,1,1
16067,ஆரம்பிக்கப்பட்டது,0,0,1,1
16068,заботился,0,0,1,1
16072,немецкая —,0,0,1,1
16076,ähm,0,0,1,1
16113,återanvändas,0,0,1,1
16115,своему,0,0,1,1
16169,modificado,0,0,1,1
16116,—familiar,0,0,1,1
16145,ಪದಕ್ಕೆ,0,0,1,1
16146,തുല്യമായ,0,0,1,1
16148,الماضية,0,0,1,1
16149,അരികിലിരുന്നു,0,0,1,1
16153,υπηρέτησε,0,0,1,1
16154,ക്ലിക്കുചെയ്ത്,0,0,1,1
16155,generel,0,0,1,1
16157,அமைப்புகளையும்,0,0,1,1
16159,indfødte,0,0,1,1
16160,расширена,0,0,1,1
16161,movie,0,0,1,1
16163,சலிப்பாக,0,0,1,1
16165,ശ്രമം,0,0,1,1
16167,design,0,0,1,1
16168,silverbröd,0,0,1,1
16142,cultured,0,0,1,1
16140,likelihood,0,0,1,1
16138,anual,0,0,1,1
16127,возможны,0,0,1,1
16117,wijziging,0,0,1,1
16119,вопроса,0,0,1,1
16121,وتركز,0,0,1,1
16122,الى,0,0,1,1
16123,schnecke,0,0,1,1
16126,sonrisas,0,0,1,1
16128,tusind,0,0,1,1
16137,الخاطبين,0,0,1,1
16129,küçücük,0,0,1,1
16130,عربته,0,0,1,1
16133,использующие,0,0,1,1
16134,தொடங்கப்பட்டது,0,0,1,1
16135,amoreel,0,0,1,1
16136,продолжился,0,0,1,1
11141,soulevé,0,0,1,1
11138,dejar,0,0,1,1
33548,artiklen,0,0,1,1
3942,microcluster,1,1,0,1
3946,fredde,1,1,0,1
3947,archiviate,1,1,0,1
3953,misurati,1,1,0,1
3954,adeani,1,1,0,1
3957,complotto,1,1,0,1
3961,francofono,1,1,0,1
3965,caratterizzare,1,1,0,1
3970,persistevano,1,1,0,1
3973,stimolando,1,1,0,1
3975,altrove,1,1,0,1
3979,immessi,1,1,0,1
3981,vietato,1,1,0,1
3985,ˈviki,1,1,0,1
3987,applicativo,1,1,0,1
3988,consentiti,1,1,0,1
3945,combinatoria,1,1,0,1
3941,fotosintesi,1,1,0,1
3903,caricamento,1,1,0,1
3939,finanziamenti,1,1,0,1
3906,occupava,1,1,0,1
3907,interpretazioni,1,1,0,1
3908,religioni,1,1,0,1
3915,causasse,1,1,0,1
3916,pareggiare,1,1,0,1
3917,tropici,1,1,0,1
3920,riorganizzato,1,1,0,1
3924,erudizione,1,1,0,1
3925,strade,1,1,0,1
3927,probabilisticamente,1,1,0,1
3930,muovono,1,1,0,1
3932,uscendo,1,1,0,1
3933,esplorazione,1,1,0,1
3934,goliardiche,1,1,0,1
3937,possedevano,1,1,0,1
3991,scoraggiata,1,1,0,1
3994,frode,1,1,0,1
3996,giorni—,1,1,0,1
3998,risiede,1,1,0,1
4051,suscettibili,1,1,0,1
4052,perde,1,1,0,1
4053,consentita,1,1,0,1
4056,chimico,1,1,0,1
4058,trattiene,1,1,0,1
4059,transizione,1,1,0,1
4060,influenzano,1,1,0,1
4061,scapito,1,1,0,1
4063,ingegnerizzazione,1,1,0,1
4064,superprotezione,1,1,0,1
4065,rivendichi,1,1,0,1
4069,ottimali,1,1,0,1
4070,estatiche,1,1,0,1
4071,consapevole,1,1,0,1
4073,elencare,1,1,0,1
4049,acquista,1,1,0,1
4048,pronome,1,1,0,1
4046,preoccuparsi,1,1,0,1
4015,predominava,1,1,0,1
4001,malefatta,1,1,0,1
4003,contenente,1,1,0,1
4004,focalizza,1,1,0,1
4011,definisce,1,1,0,1
4012,rinascimento,1,1,0,1
4013,vandali,1,1,0,1
4023,setta,1,1,0,1
4041,equatore,1,1,0,1
4025,gettare,1,1,0,1
4031,salvaguardia,1,1,0,1
4032,decidono,1,1,0,1
4033,qualificano,1,1,0,1
4035,burocratica,1,1,0,1
4038,conclusa,1,1,0,1
3904,accennano,1,1,0,1
3902,seguirono,1,1,0,1
4076,contrassegnata,1,1,0,1
3766,desidera,1,1,0,1
3770,dilemmi,1,1,0,1
3772,accettazione,1,1,0,1
3774,distacco,1,1,0,1
3776,trenta,1,1,0,1
3778,insegnamento,1,1,0,1
3779,cristallizzano,1,1,0,1
3781,sinistra,1,1,0,1
3784,cosmici,1,1,0,1
3786,fruttuoso,1,1,0,1
3790,ingombrante,1,1,0,1
3792,esaminare,1,1,0,1
3793,metro,1,1,0,1
3795,inattività,1,1,0,1
3799,creature,1,1,0,1
3800,sottorappresentata,1,1,0,1
3768,aumentato,1,1,0,1
3765,disuguaglianze,1,1,0,1
3901,staff,1,1,0,1
3763,euristica,1,1,0,1
3716,formica,1,1,0,1
3717,alleviare,1,1,0,1
3719,pluricellulari,1,1,0,1
3720,richiamata,1,1,0,1
3722,pregiudizievoli,1,1,0,1
3728,ossa,1,1,0,1
3732,coscienziosi,1,1,0,1
3740,ceduto,1,1,0,1
3742,assegnando,1,1,0,1
3744,riprodursi,1,1,0,1
3749,fuoriuscite,1,1,0,1
3753,predominanza,1,1,0,1
3754,preventivo,1,1,0,1
3757,dibattiti,1,1,0,1
3761,ricaverà,1,1,0,1
3803,simulata,1,1,0,1
3806,guadagnare,1,1,0,1
3810,vendicherà,1,1,0,1
3812,servite,1,1,0,1
3852,anormale,1,1,0,1
3858,comunità un,1,1,0,1
3863,tutt,1,1,0,1
3871,avanzare,1,1,0,1
3881,orizzontalmente,1,1,0,1
3884,sanitari,1,1,0,1
3885,impiega,1,1,0,1
3886,incarnati,1,1,0,1
3891,impostare,1,1,0,1
3893,rinunciano,1,1,0,1
3896,occidentali,1,1,0,1
3897,autorizza,1,1,0,1
3898,riorganizzate,1,1,0,1
3899,riscrivono,1,1,0,1
3900,realizzata,1,1,0,1
3850,parzialmente,1,1,0,1
3848,apportati,1,1,0,1
3846,scoraggiando,1,1,0,1
3830,divenendo,1,1,0,1
3816,percepiamo,1,1,0,1
3818,percepite,1,1,0,1
3820,deforestazione,1,1,0,1
3824,guisquipedia,1,1,0,1
3825,apprenda,1,1,0,1
3829,isolate,1,1,0,1
3831,parli,1,1,0,1
3844,fiacca,1,1,0,1
3832,dozzina,1,1,0,1
3833,riparazioni,1,1,0,1
3834,cercava,1,1,0,1
3839,veneto,1,1,0,1
3840,ingrandisci,1,1,0,1
3842,italiam,1,1,0,1
4075,dottorandi,1,1,0,1
4077,esprimono,1,1,0,1
4433,replicato,1,1,0,1
4298,hawaiana,1,1,0,1
4300,trofica,1,1,0,1
4303,saggi,1,1,0,1
4304,web»,1,1,0,1
4306,giustificata,1,1,0,1
4307,sproporzionatamente,1,1,0,1
4308,divisi,1,1,0,1
4311,ampliamento,1,1,0,1
4314,lodando,1,1,0,1
4315,accadrà,1,1,0,1
4318,bielorusso,1,1,0,1
4320,preceduta,1,1,0,1
4321,ribaltate,1,1,0,1
4322,vivaci,1,1,0,1
4324,killer—un,1,1,0,1
4325,prestabiliti,1,1,0,1
4299,vitale,1,1,0,1
4297,malevole,1,1,0,1
4255,dipendono,1,1,0,1
4296,commutazione,1,1,0,1
4259,retropropagazione,1,1,0,1
4261,astenersi,1,1,0,1
4262,wikiinfo,1,1,0,1
4263,sentimenti,1,1,0,1
4270,allegata,1,1,0,1
4271,trasclusione,1,1,0,1
4272,attrae,1,1,0,1
4275,creatori,1,1,0,1
4281,pappas,1,1,0,1
4282,crudeli,1,1,0,1
4283,alanturing,1,1,0,1
4284,senses,1,1,0,1
4287,dalailamaref,1,1,0,1
4292,crediti,1,1,0,1
4293,ricorreva,1,1,0,1
4329,doppio,1,1,0,1
4332,acquisita,1,1,0,1
4335,sposi,1,1,0,1
4336,monumento,1,1,0,1
4400,affidato,1,1,0,1
4401,felici,1,1,0,1
4404,distolse,1,1,0,1
4411,rilievo,1,1,0,1
4412,sbloccata,1,1,0,1
4416,rimanenti,1,1,0,1
4417,impedendo,1,1,0,1
4418,sprovvista,1,1,0,1
4419,concludono,1,1,0,1
4420,esperto,1,1,0,1
4421,proteste,1,1,0,1
4422,fissione,1,1,0,1
4423,turbato,1,1,0,1
4424,consultate,1,1,0,1
4425,differenziato,1,1,0,1
4393,parodiati,1,1,0,1
4390,olistica,1,1,0,1
4388,cervelli,1,1,0,1
4363,convenzionale,1,1,0,1
4340,rispettarla,1,1,0,1
4341,ricevitore,1,1,0,1
4342,pubblicava,1,1,0,1
4347,assistere,1,1,0,1
4354,aziendale,1,1,0,1
4356,terze,1,1,0,1
4364,accelerata,1,1,0,1
4378,giudizio,1,1,0,1
4365,parallelismo,1,1,0,1
4366,oceanografia,1,1,0,1
4367,accelerare,1,1,0,1
4370,offensivi,1,1,0,1
4375,—soprattutto,1,1,0,1
4377,elettricità,1,1,0,1
4256,rappresentandoli,1,1,0,1
4254,riportata,1,1,0,1
4079,illustrata,1,1,0,1
4128,cortesemente,1,1,0,1
4138,decidessero,1,1,0,1
4140,acquifere,1,1,0,1
4141,privilegio,1,1,0,1
4142,geolocalizzazione,1,1,0,1
4145,speranza»,1,1,0,1
4149,lunedì,1,1,0,1
4150,frammentario,1,1,0,1
4151,uccelli,1,1,0,1
4154,salvarsi,1,1,0,1
4156,omissioni,1,1,0,1
4157,amava,1,1,0,1
4159,dedicano,1,1,0,1
4161,giuria,1,1,0,1
4163,vivevano,1,1,0,1
4165,appoggia,1,1,0,1
4132,—nell,1,1,0,1
4126,microonde,1,1,0,1
4252,cristiano,1,1,0,1
4121,microsistema,1,1,0,1
4081,giocoso,1,1,0,1
4083,polisemia,1,1,0,1
4090,sottomarina,1,1,0,1
4093,sociologicoculturale,1,1,0,1
4095,cosiddette,1,1,0,1
4099,prenderai,1,1,0,1
4100,cenere,1,1,0,1
4101,dimostrata,1,1,0,1
4105,europei,1,1,0,1
4107,coinvolgente,1,1,0,1
4110,ideale,1,1,0,1
4112,descrivevano,1,1,0,1
4114,plastico,1,1,0,1
4115,asiatiche,1,1,0,1
4120,aggiornato,1,1,0,1
4167,confrontare,1,1,0,1
4172,parigino,1,1,0,1
4176,psicologia,1,1,0,1
4177,ondulatoria,1,1,0,1
4220,inclinazione,1,1,0,1
4224,guarda,1,1,0,1
4225,limitare,1,1,0,1
4227,racchiuderne,1,1,0,1
4229,giocato,1,1,0,1
4231,soddisfatto,1,1,0,1
4234,arriverai,1,1,0,1
4236,veicolo,1,1,0,1
4239,conoscendo,1,1,0,1
4240,riuscendo,1,1,0,1
4242,metamorfosate,1,1,0,1
4246,poté,1,1,0,1
4247,riutilizzi,1,1,0,1
4250,inconsistenze,1,1,0,1
4251,scaturisce,1,1,0,1
4213,inseriti,1,1,0,1
4212,cipollepatate,1,1,0,1
4211,possesso,1,1,0,1
4192,decoro,1,1,0,1
4178,deceduto,1,1,0,1
4179,pazzo,1,1,0,1
4182,scorsa,1,1,0,1
4183,prega,1,1,0,1
4184,restituirà,1,1,0,1
4190,conferma,1,1,0,1
4193,univa,1,1,0,1
4209,caricate,1,1,0,1
4195,civiche,1,1,0,1
4196,multiagente,1,1,0,1
4197,demagogia,1,1,0,1
4199,sistematici,1,1,0,1
4206,detengono,1,1,0,1
4207,estrema,1,1,0,1
3714,appartenenza,1,1,0,1
3712,artico,1,1,0,1
3709,galilea,1,1,0,1
3201,conferito,1,1,0,1
3203,convincendo,1,1,0,1
3205,prodotte,1,1,0,1
3206,uichipèdia,1,1,0,1
3207,concordate,1,1,0,1
3209,subtropicaleref,1,1,0,1
3210,matematicamente,1,1,0,1
3211,statico,1,1,0,1
3213,realizzano,1,1,0,1
3216,indisponibilità,1,1,0,1
3218,contraddittori,1,1,0,1
3220,appellativo,1,1,0,1
3222,riparare,1,1,0,1
3223,polacca,1,1,0,1
3224,ragionata,1,1,0,1
3225,neoproterozoica,1,1,0,1
3202,assomigliano,1,1,0,1
3199,combinandosi,1,1,0,1
3161,autoimpegno,1,1,0,1
3193,valorizzazione,1,1,0,1
3164,disc,1,1,0,1
3165,ritrae,1,1,0,1
3168,formulata,1,1,0,1
3170,concentrazione,1,1,0,1
3173,obbligatoria,1,1,0,1
3174,ascia,1,1,0,1
3176,ritagliata,1,1,0,1
3178,oceanica,1,1,0,1
3179,abitata,1,1,0,1
3180,vincitore,1,1,0,1
3183,coperta,1,1,0,1
3185,attraversando,1,1,0,1
3186,navigazione,1,1,0,1
3189,premiazione,1,1,0,1
3191,tattiche,1,1,0,1
3226,raffreddato,1,1,0,1
3227,virtuali,1,1,0,1
3231,fattorizzazione,1,1,0,1
3232,vigili,1,1,0,1
3274,culla,1,1,0,1
3276,gatto,1,1,0,1
3277,frammentari,1,1,0,1
3280,censurare,1,1,0,1
3282,unisca,1,1,0,1
3283,umide,1,1,0,1
3284,caldi,1,1,0,1
3286,lontana,1,1,0,1
3288,alleanza,1,1,0,1
3290,sopravvivenza,1,1,0,1
3293,indonesia,1,1,0,1
3296,ambientata,1,1,0,1
3300,mirror—,1,1,0,1
3301,antielitaria,1,1,0,1
3302,organizzabili,1,1,0,1
3272,introdotte,1,1,0,1
3269,foscolo,1,1,0,1
3266,rinnovabile,1,1,0,1
3245,caratterizzò,1,1,0,1
3234,variegata,1,1,0,1
3236,determinazioni,1,1,0,1
3238,«uno,1,1,0,1
3239,restringere,1,1,0,1
3241,anatomia,1,1,0,1
3244,assunse,1,1,0,1
3246,dialettico,1,1,0,1
3265,colture,1,1,0,1
3248,illecito,1,1,0,1
3250,immettono,1,1,0,1
3251,percettibili,1,1,0,1
3254,ideologie,1,1,0,1
3259,allegorie,1,1,0,1
3264,pubblicarle»,1,1,0,1
3162,siberiano,1,1,0,1
3159,collocati,1,1,0,1
3708,culminare,1,1,0,1
3032,allevamento,1,1,0,1
3036,trascurare,1,1,0,1
3038,scherzo,1,1,0,1
3039,misurate,1,1,0,1
3041,platonico,1,1,0,1
3042,pool,1,1,0,1
3044,schierarsi,1,1,0,1
3048,affinché,1,1,0,1
3052,durano,1,1,0,1
3053,improvvisi,1,1,0,1
3058,istituti,1,1,0,1
3060,alimenta,1,1,0,1
3061,prerogative,1,1,0,1
3066,espongono,1,1,0,1
3068,assorbe,1,1,0,1
3069,vicenda,1,1,0,1
3033,rifiuto,1,1,0,1
3031,raggruppare,1,1,0,1
3154,idrologia,1,1,0,1
3025,contava,1,1,0,1
2992,teoriche,1,1,0,1
2993,cartella,1,1,0,1
2994,softwaresecondo,1,1,0,1
2996,crescerà,1,1,0,1
2997,varianti,1,1,0,1
2998,antivandalo,1,1,0,1
2999,sollecitazione,1,1,0,1
3001,provate,1,1,0,1
3002,priorità e,1,1,0,1
3006,geomagnetico,1,1,0,1
3007,assassinio,1,1,0,1
3014,volatile,1,1,0,1
3015,liberties,1,1,0,1
3016,automatiche,1,1,0,1
3020,«le,1,1,0,1
3072,attiva,1,1,0,1
3074,referee,1,1,0,1
3076,richiederanno,1,1,0,1
3078,gilda,1,1,0,1
3117,pornoattrici,1,1,0,1
3118,sfruttamento,1,1,0,1
3124,usavano,1,1,0,1
3125,istituto,1,1,0,1
3128,prevale,1,1,0,1
3129,letta,1,1,0,1
3131,colori,1,1,0,1
3134,chemioinformatica,1,1,0,1
3136,sbalzi,1,1,0,1
3137,romanticismo,1,1,0,1
3140,paradossalmente,1,1,0,1
3143,disambiguazione,1,1,0,1
3147,aumentata,1,1,0,1
3149,dimezzato,1,1,0,1
3151,rinunciato,1,1,0,1
3115,sollevare,1,1,0,1
3114,conseguentemente,1,1,0,1
3112,fattibili,1,1,0,1
3093,percorrono,1,1,0,1
3080,davanzali,1,1,0,1
3081,deduceva,1,1,0,1
3082,adeguati,1,1,0,1
3086,mancava,1,1,0,1
3090,newsweek,1,1,0,1
3092,deformate,1,1,0,1
3094,routinariamente,1,1,0,1
3111,intraprese,1,1,0,1
3097,mouse,1,1,0,1
3098,completi,1,1,0,1
3103,esperte,1,1,0,1
3104,stabilire,1,1,0,1
3108,avvieranno,1,1,0,1
3109,motorie,1,1,0,1
3304,ricchi,1,1,0,1
3306,esplicite,1,1,0,1
3308,comportarsi,1,1,0,1
3567,traduttore,1,1,0,1
3571,aggiornarsi,1,1,0,1
3575,indicano,1,1,0,1
3578,documentati,1,1,0,1
3581,implicare,1,1,0,1
3584,subspaziale,1,1,0,1
3593,appartenga,1,1,0,1
3594,unione,1,1,0,1
3601,manti,1,1,0,1
3605,almeno miliardi,1,1,0,1
3607,selezioni,1,1,0,1
3608,presunti,1,1,0,1
3611,generata,1,1,0,1
3615,panico,1,1,0,1
3617,discuterne,1,1,0,1
3620,osceni,1,1,0,1
3569,specificano,1,1,0,1
3563,prosegue,1,1,0,1
3312,grafie,1,1,0,1
3560,vichipedìa,1,1,0,1
3516,sforzarsi,1,1,0,1
3519,accadeva,1,1,0,1
3520,stagionali,1,1,0,1
3521,accusa,1,1,0,1
3525,calcolare,1,1,0,1
3529,modellati,1,1,0,1
3531,codificata,1,1,0,1
3536,successiva,1,1,0,1
3538,concezioni,1,1,0,1
3541,presentano,1,1,0,1
3545,necessarie,1,1,0,1
3547,fonemi,1,1,0,1
3550,promuove,1,1,0,1
3555,dicembre l,1,1,0,1
3558,aiutano,1,1,0,1
3625,incommensurabile,1,1,0,1
3626,incorporata,1,1,0,1
3634,soddisfacevano,1,1,0,1
3636,manciata,1,1,0,1
3677,espresse,1,1,0,1
3680,fisso,1,1,0,1
3682,ugo,1,1,0,1
3685,emblematica,1,1,0,1
3687,segnata,1,1,0,1
3694,renderizzate,1,1,0,1
3697,assegnano,1,1,0,1
3698,pretenzioso,1,1,0,1
3699,privatizzazione,1,1,0,1
3700,presocratici,1,1,0,1
3701,causando,1,1,0,1
3703,fermo,1,1,0,1
3704,rinata,1,1,0,1
3705,concentrarsi,1,1,0,1
3706,presentava,1,1,0,1
3672,donato,1,1,0,1
3670,elia,1,1,0,1
3669,acconsente,1,1,0,1
3649,eletto,1,1,0,1
3638,schizzi,1,1,0,1
3639,efficacia,1,1,0,1
3641,menzionate,1,1,0,1
3646,immagazzinano,1,1,0,1
3647,licenziante,1,1,0,1
3648,ricevute,1,1,0,1
3650,impiego,1,1,0,1
3668,codificati,1,1,0,1
3651,variante,1,1,0,1
3653,numerico,1,1,0,1
3656,concentrando,1,1,0,1
3660,fittizio,1,1,0,1
3661,provocato,1,1,0,1
3664,santificazione,1,1,0,1
3511,—tramite,1,1,0,1
3509,accogliere,1,1,0,1
3506,underfitting,1,1,0,1
3397,rettitudine,1,1,0,1
3351,vocabolari,1,1,0,1
3353,preistoria,1,1,0,1
3355,artificio,1,1,0,1
3357,volevamo,1,1,0,1
3358,nuda,1,1,0,1
3361,mutamento,1,1,0,1
3366,investiti,1,1,0,1
3369,consenta,1,1,0,1
3373,belgium,1,1,0,1
3379,mandarti,1,1,0,1
3382,addestra,1,1,0,1
3385,posizionamento,1,1,0,1
3386,testato,1,1,0,1
3393,colonizzazione,1,1,0,1
3394,chiarimento,1,1,0,1
3349,subtropicale,1,1,0,1
3342,impegnati,1,1,0,1
3340,recensiti,1,1,0,1
3326,cominciò,1,1,0,1
3313,confidenza,1,1,0,1
3315,menzione,1,1,0,1
3316,spagna,1,1,0,1
3317,ecologica,1,1,0,1
3318,discusso,1,1,0,1
3325,protestare,1,1,0,1
3327,generalizzabili,1,1,0,1
3339,stampabili,1,1,0,1
3331,boyd,1,1,0,1
3332,accorgano,1,1,0,1
3333,macinare,1,1,0,1
3336,presuppongono,1,1,0,1
3337,brainmachine,1,1,0,1
3338,barnstar,1,1,0,1
3395,progressi,1,1,0,1
3403,esecutiva,1,1,0,1
3504,banali,1,1,0,1
3405,decina,1,1,0,1
3462,giudiziarie,1,1,0,1
3464,ferocia,1,1,0,1
3466,manifestazioni,1,1,0,1
3467,pornografico,1,1,0,1
3468,presentazione,1,1,0,1
3475,trasportando,1,1,0,1
3476,avviando,1,1,0,1
3477,divenute,1,1,0,1
3478,spiegato,1,1,0,1
3479,zoo,1,1,0,1
3480,riposta,1,1,0,1
3482,eclipsing,1,1,0,1
3498,benefici,1,1,0,1
3499,relativa,1,1,0,1
3502,plausi,1,1,0,1
3459,viaggiano,1,1,0,1
3458,frega,1,1,0,1
3457,contesa,1,1,0,1
3416,proliferazione,1,1,0,1
3409,rideva,1,1,0,1
3411,dilettante,1,1,0,1
3412,qualitàh,1,1,0,1
3413,ionizzati,1,1,0,1
3414,cumulativamente,1,1,0,1
3415,delicati,1,1,0,1
3418,ruoli,1,1,0,1
3453,ripetuti,1,1,0,1
3424,diversificata,1,1,0,1
3425,batoliti,1,1,0,1
3435,romana,1,1,0,1
3439,girava,1,1,0,1
3440,preoccupato,1,1,0,1
3444,perdere,1,1,0,1
4427,pronunce,1,1,0,1
4435,wikinotizie,1,1,0,1
11137,construites,0,0,1,1
5468,teorizza,1,1,0,1
5472,editare,1,1,0,1
5473,faziose,1,1,0,1
5474,utilizzarlo,1,1,0,1
5476,cogitans,1,1,0,1
5477,«…rappresenta,1,1,0,1
5480,vaghezza,1,1,0,1
5481,approfondito,1,1,0,1
5484,pensate,1,1,0,1
5488,eterotrofi,1,1,0,1
5491,tecnologica,1,1,0,1
5493,collegare,1,1,0,1
5494,massimizzare,1,1,0,1
5495,"affidamento
pesantemente",1,1,0,1
5496,adeguatamente,1,1,0,1
5497,riprese,1,1,0,1
5470,maturi,1,1,0,1
5465,approvazione,1,1,0,1
5434,naturalistica,1,1,0,1
5463,discendenza,1,1,0,1
5436,intenzioni,1,1,0,1
5438,circuiti,1,1,0,1
5439,inventato,1,1,0,1
5440,colleghi,1,1,0,1
5441,identificati,1,1,0,1
5443,ricompense,1,1,0,1
5445,consultando,1,1,0,1
5446,importazione,1,1,0,1
5447,indicando,1,1,0,1
5452,umana”,1,1,0,1
5455,ricordato,1,1,0,1
5456,soffrono,1,1,0,1
5457,contestualizzazione,1,1,0,1
5458,potrà,1,1,0,1
5462,paesaggistiche,1,1,0,1
5499,collagene,1,1,0,1
5501,rimodellata,1,1,0,1
5503,essersi,1,1,0,1
5504,autoproduzione,1,1,0,1
5556,animazione,1,1,0,1
5557,reinvenzioni,1,1,0,1
5558,attiene,1,1,0,1
5560,consulente,1,1,0,1
5561,arcipelaghi,1,1,0,1
5564,compatibile,1,1,0,1
5565,rimaste,1,1,0,1
5568,sospettato,1,1,0,1
5570,selezionate,1,1,0,1
5574,rendendo,1,1,0,1
5575,gazzetta,1,1,0,1
5577,succedono,1,1,0,1
5579,designer,1,1,0,1
5582,caratterizzata,1,1,0,1
5584,appresi,1,1,0,1
5555,marciare,1,1,0,1
5554,giornaliero,1,1,0,1
5550,ripristinano,1,1,0,1
5520,sostenitori,1,1,0,1
5505,palmari,1,1,0,1
5507,evidente,1,1,0,1
5515,discretamente,1,1,0,1
5516,determinarne,1,1,0,1
5517,osservato,1,1,0,1
5519,condivise,1,1,0,1
5526,cipolle,1,1,0,1
5549,romani,1,1,0,1
5532,introduction,1,1,0,1
5533,valida,1,1,0,1
5534,parlamentari,1,1,0,1
5536,esservi,1,1,0,1
5543,grafemi,1,1,0,1
5544,vittoriano,1,1,0,1
5435,beard,1,1,0,1
5431,emiliano,1,1,0,1
5591,accontentarsi,1,1,0,1
5312,autopromozione​,1,1,0,1
5315,nihilo,1,1,0,1
5316,dimenticarti,1,1,0,1
5321,genotipi,1,1,0,1
5322,emerge,1,1,0,1
5323,​​da,1,1,0,1
5324,positivamente,1,1,0,1
5326,accumulato,1,1,0,1
5329,meravigliosa,1,1,0,1
5330,avvicinarsi,1,1,0,1
5331,peggiorativa,1,1,0,1
5333,esplicativo,1,1,0,1
5334,segnalano,1,1,0,1
5335,rilascia,1,1,0,1
5336,​​​​la,1,1,0,1
5342,voto»,1,1,0,1
5313,omonimi,1,1,0,1
5309,rigorosamente,1,1,0,1
5429,sostantivi,1,1,0,1
5304,sintetico,1,1,0,1
5267,suddiviso,1,1,0,1
5268,condotti,1,1,0,1
5269,quaderni,1,1,0,1
5271,assistito,1,1,0,1
5273,come milioni,1,1,0,1
5280,eccessiva,1,1,0,1
5284,esponenziale,1,1,0,1
5285,nominato,1,1,0,1
5287,inesperti,1,1,0,1
5289,elaborarlo,1,1,0,1
5291,cumulativa,1,1,0,1
5292,secondarie,1,1,0,1
5293,allagamento,1,1,0,1
5302,avidità,1,1,0,1
5303,specializzato,1,1,0,1
5349,operai,1,1,0,1
5350,applausi,1,1,0,1
5352,provenissero,1,1,0,1
5353,implicazioni,1,1,0,1
5394,semplificata,1,1,0,1
5395,aggiornamenti,1,1,0,1
5400,mitica,1,1,0,1
5403,tifare,1,1,0,1
5405,ereditano,1,1,0,1
5406,velocizzare,1,1,0,1
5409,supportate,1,1,0,1
5411,videogiochi,1,1,0,1
5412,dirompenti,1,1,0,1
5414,centuplicato,1,1,0,1
5415,detriti,1,1,0,1
5417,dominati,1,1,0,1
5418,biforcazione,1,1,0,1
5421,minuzie,1,1,0,1
5428,estrapolare,1,1,0,1
5392,contando,1,1,0,1
5391,rafforzando,1,1,0,1
5388,turbata,1,1,0,1
5373,terminali,1,1,0,1
5357,minaccioso,1,1,0,1
5359,riconciliazione,1,1,0,1
5362,notiamo,1,1,0,1
5363,crudi,1,1,0,1
5368,menzionarlo,1,1,0,1
5372,polacchi,1,1,0,1
5375,dinamici,1,1,0,1
5386,coesistevano,1,1,0,1
5376,rappresentassero,1,1,0,1
5377,paralleli,1,1,0,1
5380,immunitario,1,1,0,1
5381,thread,1,1,0,1
5382,frammentazione,1,1,0,1
5385,arrivati,1,1,0,1
5588,controtendenza,1,1,0,1
5593,«il,1,1,0,1
4440,cautele,1,1,0,1
5834,bucato,1,1,0,1
5839,usarli,1,1,0,1
5843,estrapolazione,1,1,0,1
5844,sessi,1,1,0,1
5845,insindacabile,1,1,0,1
5846,inanimati,1,1,0,1
5847,responsabili,1,1,0,1
5848,vandalizzano,1,1,0,1
5851,processori,1,1,0,1
5855,meteoriti,1,1,0,1
5858,apparse,1,1,0,1
5860,boccone,1,1,0,1
5862,contrastanti,1,1,0,1
5864,lanci,1,1,0,1
5865,sr,1,1,0,1
5866,settimanali,1,1,0,1
5838,usava,1,1,0,1
5833,compreso,1,1,0,1
5783,elencati,1,1,0,1
5832,riesci,1,1,0,1
5788,"
stiamo",1,1,0,1
5790,zamolli,1,1,0,1
5793,scrittrici,1,1,0,1
5796,iniziando,1,1,0,1
5806,temporali,1,1,0,1
5810,ripubblicati,1,1,0,1
5812,emisferi,1,1,0,1
5813,instaurazione,1,1,0,1
5814,sistematica,1,1,0,1
5817,pubblici,1,1,0,1
5819,indicherebbe,1,1,0,1
5820,distintivo,1,1,0,1
5824,sequestri,1,1,0,1
5825,redazionale,1,1,0,1
5829,scoperti,1,1,0,1
5867,brossura,1,1,0,1
5868,capisco,1,1,0,1
5870,finisse,1,1,0,1
5871,evitano,1,1,0,1
5915,consumare,1,1,0,1
5916,tossici,1,1,0,1
5921,stradale,1,1,0,1
5922,virtù,1,1,0,1
5923,aggiuntivo,1,1,0,1
5924,famosa,1,1,0,1
5926,sbilanciata,1,1,0,1
5930,vivono,1,1,0,1
5931,sopravvivere,1,1,0,1
5932,trascendentalisti,1,1,0,1
5934,professoressa,1,1,0,1
5938,citava,1,1,0,1
5944,bonifica,1,1,0,1
5945,borsa,1,1,0,1
5946,trionfa,1,1,0,1
5914,annullato,1,1,0,1
5910,viceversa,1,1,0,1
5908,schiantato,1,1,0,1
5884,—è,1,1,0,1
5872,invisibili,1,1,0,1
5873,implementando,1,1,0,1
5874,genico,1,1,0,1
5875,qualitativa,1,1,0,1
5879,gerarchico,1,1,0,1
5883,custode,1,1,0,1
5885,esercitano,1,1,0,1
5906,tokyo,1,1,0,1
5894,insegnare,1,1,0,1
5895,fumetti,1,1,0,1
5898,compilata,1,1,0,1
5901,interessano,1,1,0,1
5902,ripetuta,1,1,0,1
5905,induttivi,1,1,0,1
5785,partecipano,1,1,0,1
5782,interagiscono,1,1,0,1
5595,umanesimo,1,1,0,1
5635,ricercatrice,1,1,0,1
5641,etnie,1,1,0,1
5647,conferiscono,1,1,0,1
5648,wikipeˈdia,1,1,0,1
5649,supposta,1,1,0,1
5650,eseguito,1,1,0,1
5653,ittico,1,1,0,1
5655,jihadiste,1,1,0,1
5656,menzionata,1,1,0,1
5658,discreto,1,1,0,1
5659,tracciata,1,1,0,1
5660,cifra,1,1,0,1
5663,bloccavano,1,1,0,1
5666,molecolare,1,1,0,1
5670,vigilati,1,1,0,1
5674,biofisico,1,1,0,1
5640,magazinesenza fonte,1,1,0,1
5634,derivante,1,1,0,1
5780,immediata,1,1,0,1
5627,lavorava,1,1,0,1
5597,linearità,1,1,0,1
5599,gradevoli,1,1,0,1
5601,piazza,1,1,0,1
5603,e milioni,1,1,0,1
5604,testano,1,1,0,1
5605,premuto,1,1,0,1
5609,observatory,1,1,0,1
5611,letterarie,1,1,0,1
5615,realistico,1,1,0,1
5619,colonizzati,1,1,0,1
5620,semplicità,1,1,0,1
5621,notevolmente,1,1,0,1
5622,implementare,1,1,0,1
5623,desacralizzava,1,1,0,1
5626,ridotti,1,1,0,1
5676,circonda,1,1,0,1
5679,erosione,1,1,0,1
5680,chicago,1,1,0,1
5681,innato,1,1,0,1
5747,incrementato,1,1,0,1
5748,scienziato,1,1,0,1
5751,rapidità,1,1,0,1
5752,riuniti,1,1,0,1
5757,eccezionali,1,1,0,1
5762,preistorici,1,1,0,1
5763,divulgato,1,1,0,1
5764,divorare,1,1,0,1
5765,astratto,1,1,0,1
5769,mostrare,1,1,0,1
5771,ristampe,1,1,0,1
5773,permettimi,1,1,0,1
5774,avvio,1,1,0,1
5775,minimi,1,1,0,1
5779,comportare,1,1,0,1
5741,voragine,1,1,0,1
5738,contrarsi,1,1,0,1
5737,eliminate,1,1,0,1
5702,trattano,1,1,0,1
5687,permanenti,1,1,0,1
5688,forniscano,1,1,0,1
5689,comprendono,1,1,0,1
5693,professione,1,1,0,1
5697,inappropriata,1,1,0,1
5700,verranno,1,1,0,1
5704,afflitti,1,1,0,1
5735,anniversario,1,1,0,1
5709,disciplinate,1,1,0,1
5713,condensazione,1,1,0,1
5717,sottolineò,1,1,0,1
5724,visioni,1,1,0,1
5729,implementazioni,1,1,0,1
5732,divenuta,1,1,0,1
5266,abbattimento,1,1,0,1
5264,neanche,1,1,0,1
5260,presume,1,1,0,1
4715,acquatico,1,1,0,1
4720,smentita,1,1,0,1
4723,—numero,1,1,0,1
4724,legame,1,1,0,1
4725,sospettava,1,1,0,1
4726,naturalità,1,1,0,1
4727,rendersene,1,1,0,1
4730,legname,1,1,0,1
4731,modellizzare,1,1,0,1
4733,continente,1,1,0,1
4734,costruendo,1,1,0,1
4735,tentare,1,1,0,1
4737,indovinare,1,1,0,1
4738,tessuti,1,1,0,1
4741,demografia,1,1,0,1
4744,scolpita,1,1,0,1
4719,oscillando,1,1,0,1
4714,sottile,1,1,0,1
4675,stabilito,1,1,0,1
4712,sardo,1,1,0,1
4678,cartesiana,1,1,0,1
4681,autonomia,1,1,0,1
4688,soap,1,1,0,1
4689,vuote,1,1,0,1
4691,applicate,1,1,0,1
4692,denunciando,1,1,0,1
4694,autoreplicante,1,1,0,1
4696,negando,1,1,0,1
4697,slovacco,1,1,0,1
4700,televisiva,1,1,0,1
4702,darti,1,1,0,1
4704,inferenze,1,1,0,1
4705,religiosa,1,1,0,1
4708,invierò,1,1,0,1
4709,maggioritarie,1,1,0,1
4748,debole,1,1,0,1
4749,avvicinano,1,1,0,1
4760,arrivata,1,1,0,1
4762,incorporazione,1,1,0,1
4803,deformazione,1,1,0,1
4806,celebra,1,1,0,1
4809,quanrill,1,1,0,1
4810,abitanti,1,1,0,1
4812,occhiolino,1,1,0,1
4819,accolto,1,1,0,1
4820,aggressivo,1,1,0,1
4821,conseguente,1,1,0,1
4823,ristrette,1,1,0,1
4824,educativa,1,1,0,1
4829,galileiana,1,1,0,1
4830,aggiustamenti,1,1,0,1
4833,umanistici,1,1,0,1
4836,competere,1,1,0,1
4838,consentirgli,1,1,0,1
4801,"burger

",1,1,0,1
4798,mappa,1,1,0,1
4794,variato,1,1,0,1
4777,vendite,1,1,0,1
4766,ceca,1,1,0,1
4770,scaricano,1,1,0,1
4771,trilioni,1,1,0,1
4773,gpu,1,1,0,1
4774,svariati,1,1,0,1
4775,telefonia,1,1,0,1
4779,deismo,1,1,0,1
4792,linguaggi,1,1,0,1
4781,accusata,1,1,0,1
4783,semantiche,1,1,0,1
4784,continuando,1,1,0,1
4787,paralizzante,1,1,0,1
4788,​​o,1,1,0,1
4789,criticava,1,1,0,1
4676,rigorosi,1,1,0,1
4674,estremo,1,1,0,1
5258,ribasso,1,1,0,1
4519,applicata,1,1,0,1
4521,usò,1,1,0,1
4523,bianche,1,1,0,1
4530,eccitati,1,1,0,1
4531,asiatica,1,1,0,1
4535,diagramma,1,1,0,1
4536,andrai,1,1,0,1
4542,accreditato,1,1,0,1
4547,grezzo,1,1,0,1
4548,rivali,1,1,0,1
4550,carro,1,1,0,1
4552,supermercati,1,1,0,1
4553,genere—,1,1,0,1
4555,cooperativa,1,1,0,1
4562,residuo,1,1,0,1
4565,stadio,1,1,0,1
4520,pulito,1,1,0,1
4518,marxista,1,1,0,1
4671,istituzionale,1,1,0,1
4517,dettaglio,1,1,0,1
4444,insegniamo,1,1,0,1
4452,categorizzati,1,1,0,1
4456,distribuisce,1,1,0,1
4457,misurata,1,1,0,1
4465,imparando,1,1,0,1
4470,appiattindo,1,1,0,1
4471,necrologi,1,1,0,1
4472,appello,1,1,0,1
4483,decidibile,1,1,0,1
4485,eseguendo,1,1,0,1
4490,appassionati,1,1,0,1
4498,attivista,1,1,0,1
4504,secolare,1,1,0,1
4508,“un,1,1,0,1
4510,altruisticamente,1,1,0,1
4566,oltre milioni,1,1,0,1
4567,​in,1,1,0,1
4572,impraticabile,1,1,0,1
4576,vittime,1,1,0,1
4623,regolamentare,1,1,0,1
4624,mostrassero,1,1,0,1
4627,pangea,1,1,0,1
4634,militare,1,1,0,1
4637,appartengono,1,1,0,1
4640,defunta,1,1,0,1
4641,convenzionali,1,1,0,1
4643,sosta,1,1,0,1
4644,nucleare,1,1,0,1
4648,prevedeva,1,1,0,1
4653,itwiki,1,1,0,1
4656,rinnovabili,1,1,0,1
4658,teoretici,1,1,0,1
4666,persistenti,1,1,0,1
4670,amministrativa,1,1,0,1
4622,violi,1,1,0,1
4618,ramo,1,1,0,1
4609,«sebbene,1,1,0,1
4592,microscopici,1,1,0,1
4579,fuorviante,1,1,0,1
4580,sillabari,1,1,0,1
4581,multipli,1,1,0,1
4582,presocratica,1,1,0,1
4584,immaginaria,1,1,0,1
4585,descriverle,1,1,0,1
4594,approfondite,1,1,0,1
4608,giudiziaria,1,1,0,1
4600,termoalina,1,1,0,1
4601,ingiustamente,1,1,0,1
4603,comun,1,1,0,1
4604,denaro,1,1,0,1
4605,raccontarlo,1,1,0,1
4607,scandali,1,1,0,1
4841,aggiornando,1,1,0,1
4844,divieti,1,1,0,1
4848,sbaglia,1,1,0,1
5098,denominare,1,1,0,1
5101,quantitativo,1,1,0,1
5105,eurocentriche,1,1,0,1
5106,mensile,1,1,0,1
5110,ripetitive,1,1,0,1
5124,sentimento,1,1,0,1
5125,insufficienza,1,1,0,1
5129,preassegnate,1,1,0,1
5130,diagnosticare,1,1,0,1
5131,nominano,1,1,0,1
5136,ispirata,1,1,0,1
5137,immaginik,1,1,0,1
5138,neve,1,1,0,1
5144,qualificare,1,1,0,1
5149,segnalata,1,1,0,1
5150,raddoppiando,1,1,0,1
5100,ridotte,1,1,0,1
5091,ottico,1,1,0,1
4850,rosenblatt,1,1,0,1
5087,persiano,1,1,0,1
5053,unicellulari,1,1,0,1
5054,zoofilia,1,1,0,1
5055,miliardo,1,1,0,1
5059,impronta,1,1,0,1
5066,alphago,1,1,0,1
5067,divulgare,1,1,0,1
5068,altissimo,1,1,0,1
5069,frettolosamente,1,1,0,1
5074,prosciuga,1,1,0,1
5076,scaricati,1,1,0,1
5078,evidenzia,1,1,0,1
5079,statunitensi,1,1,0,1
5081,individuato,1,1,0,1
5083,sperare,1,1,0,1
5085,procrastinazione,1,1,0,1
5151,​​corpus,1,1,0,1
5155,nevosi,1,1,0,1
5157,investigativo,1,1,0,1
5162,intendono,1,1,0,1
5212,scopi»,1,1,0,1
5215,astratte,1,1,0,1
5219,tanti,1,1,0,1
5220,× chilogrammi,1,1,0,1
5221,promessa,1,1,0,1
5232,diresse,1,1,0,1
5233,leggono,1,1,0,1
5236,inviate,1,1,0,1
5239,incoraggiati,1,1,0,1
5241,astronomi,1,1,0,1
5244,privi,1,1,0,1
5248,fotorealistica,1,1,0,1
5249,neurofisiologo,1,1,0,1
5250,alimentato,1,1,0,1
5252,aereo,1,1,0,1
5211,mediano,1,1,0,1
5204,duraturo,1,1,0,1
5199,gravitazione,1,1,0,1
5174,ascolto,1,1,0,1
5164,conosceva,1,1,0,1
5166,diciassette,1,1,0,1
5168,connettersi,1,1,0,1
5171,efficienza,1,1,0,1
5172,asturiano,1,1,0,1
5173,curato,1,1,0,1
5177,detti,1,1,0,1
5198,riconoscendo,1,1,0,1
5178,spostarsi,1,1,0,1
5180,studiando,1,1,0,1
5181,acquisti,1,1,0,1
5183,diffondere,1,1,0,1
5190,ipertestuale,1,1,0,1
5194,richiedere,1,1,0,1
5052,agricola,1,1,0,1
5050,spettro,1,1,0,1
5038,avvertimento,1,1,0,1
4955,reiterato,1,1,0,1
4908,progettisti,1,1,0,1
4910,sessista,1,1,0,1
4912,assistenti,1,1,0,1
4915,ubiqua,1,1,0,1
4930,iniziarono,1,1,0,1
4931,daremo,1,1,0,1
4933,passante,1,1,0,1
4938,settentrionali,1,1,0,1
4940,vulcanico,1,1,0,1
4941,querelanti,1,1,0,1
4946,produttori,1,1,0,1
4949,emergente,1,1,0,1
4951,illeggibile,1,1,0,1
4952,contrastare,1,1,0,1
4953,ecosistemi,1,1,0,1
4904,visive,1,1,0,1
4899,siria,1,1,0,1
4896,incolti,1,1,0,1
4862,bancaria,1,1,0,1
4851,olocenica,1,1,0,1
4852,planetari,1,1,0,1
4854,salvare,1,1,0,1
4856,ficcanaso,1,1,0,1
4857,congiunto,1,1,0,1
4860,accettati,1,1,0,1
4863,tessere,1,1,0,1
4893,incertezza,1,1,0,1
4865,eucariotiche,1,1,0,1
4867,contemporanea,1,1,0,1
4870,fallire,1,1,0,1
4871,affermate,1,1,0,1
4880,cosmologici,1,1,0,1
4890,favoriscono,1,1,0,1
4954,grandezza,1,1,0,1
4957,aule,1,1,0,1
5035,annullate,1,1,0,1
4958,gassoso,1,1,0,1
5006,destra,1,1,0,1
5007,simbolica,1,1,0,1
5008,calcola,1,1,0,1
5012,pertinenti,1,1,0,1
5014,autorizzata,1,1,0,1
5015,torrente,1,1,0,1
5016,fondamentalmente,1,1,0,1
5019,trovarvi,1,1,0,1
5020,affermavano,1,1,0,1
5021,smeraldo,1,1,0,1
5027,bloccate,1,1,0,1
5029,venisse,1,1,0,1
5030,fungo,1,1,0,1
5032,rimodellarle,1,1,0,1
5033,oversight,1,1,0,1
5005,conseguono,1,1,0,1
5002,​ciò,1,1,0,1
5000,sessismo,1,1,0,1
4971,dammi,1,1,0,1
4959,attirano miliardi,1,1,0,1
4961,pensano,1,1,0,1
4963,spaziali,1,1,0,1
4964,riducibile,1,1,0,1
4966,ligure,1,1,0,1
4969,dimensionalità,1,1,0,1
4977,istruisce,1,1,0,1
4996,timida,1,1,0,1
4979,dessi,1,1,0,1
4983,rimasero,1,1,0,1
4987,nonlineari,1,1,0,1
4991,corrisponda,1,1,0,1
4992,privatizzato,1,1,0,1
4993,trasmesso,1,1,0,1
2991,isoleref,1,1,0,1
2990,audace,1,1,0,1
2988,gettato,1,1,0,1
969,menzionano,1,1,0,1
978,seymour,1,1,0,1
980,coinvolto,1,1,0,1
982,informare,1,1,0,1
983,esaminata,1,1,0,1
985,relatore,1,1,0,1
989,citabili,1,1,0,1
993,palesemente,1,1,0,1
999,fluviali,1,1,0,1
1001,tettonica,1,1,0,1
1002,spostato,1,1,0,1
1005,segnalibri,1,1,0,1
1006,inteso,1,1,0,1
1007,reinvenzione,1,1,0,1
1009,ritrovo,1,1,0,1
1011,«curare,1,1,0,1
976,impegni,1,1,0,1
968,remunerati,1,1,0,1
929,dattiloscritto,1,1,0,1
967,avventore,1,1,0,1
933,legittimi,1,1,0,1
935,stabiliscono,1,1,0,1
936,punizioni,1,1,0,1
940,attribuito,1,1,0,1
941,commentatori,1,1,0,1
943,scorpions—contiene,1,1,0,1
944,cancellato,1,1,0,1
946,migratrici,1,1,0,1
947,napoletano,1,1,0,1
952,legislazioni,1,1,0,1
953,linneo,1,1,0,1
954,pienamente,1,1,0,1
955,biotecnologie,1,1,0,1
963,evolutivo,1,1,0,1
965,etnocentrici,1,1,0,1
1012,restrittiva,1,1,0,1
1013,risarcimento,1,1,0,1
1014,resti,1,1,0,1
1015,superasse,1,1,0,1
1061,segnalati,1,1,0,1
1064,interconnesso,1,1,0,1
1070,atomici,1,1,0,1
1072,rintracciabili,1,1,0,1
1073,apporto,1,1,0,1
1077,problematico,1,1,0,1
1079,karcher,1,1,0,1
1081,fruizione,1,1,0,1
1082,concepire,1,1,0,1
1083,gratitudine,1,1,0,1
1084,rimanesse,1,1,0,1
1088,endemiche,1,1,0,1
1090,smesso,1,1,0,1
1093,pacifico,1,1,0,1
1095,discutibilmente,1,1,0,1
1059,denuncianti,1,1,0,1
1055,commenta,1,1,0,1
1051,vuoto,1,1,0,1
1033,verificatosi,1,1,0,1
1018,legislazione,1,1,0,1
1023,battimi,1,1,0,1
1026,rimosso,1,1,0,1
1027,facenti,1,1,0,1
1029,cullare,1,1,0,1
1032,inserimenti,1,1,0,1
1035,resisti,1,1,0,1
1050,supplementari,1,1,0,1
1036,scusandosi,1,1,0,1
1038,allena,1,1,0,1
1040,maschili,1,1,0,1
1045,convenienti,1,1,0,1
1046,eliminazioni,1,1,0,1
1047,alvinn,1,1,0,1
932,commessi,1,1,0,1
927,saturno,1,1,0,1
1102,configurazione,1,1,0,1
810,cerchiamo,1,1,0,1
813,intuizione,1,1,0,1
814,provocativo,1,1,0,1
815,campiona,1,1,0,1
817,disponibilità,1,1,0,1
818,sciocco,1,1,0,1
819,equamente,1,1,0,1
823,radiofonici,1,1,0,1
824,​​primo,1,1,0,1
825,programmato,1,1,0,1
827,ricevuti,1,1,0,1
829,paga,1,1,0,1
830,guadagno,1,1,0,1
833,botanici,1,1,0,1
834,tentato,1,1,0,1
835,imposto,1,1,0,1
812,previsto,1,1,0,1
808,benvenuta,1,1,0,1
925,carbonica,1,1,0,1
805,illustrativa,1,1,0,1
779,autocensurata,1,1,0,1
782,disegni,1,1,0,1
786,abitabile,1,1,0,1
787,violassero,1,1,0,1
788,acquistano,1,1,0,1
790,definiti,1,1,0,1
792,infinite,1,1,0,1
795,fondate,1,1,0,1
796,vacante,1,1,0,1
798,serverquando,1,1,0,1
799,percepiti,1,1,0,1
800,prettamente,1,1,0,1
801,aborrisce,1,1,0,1
803,legislatore,1,1,0,1
804,consentirebbe,1,1,0,1
843,associati,1,1,0,1
845,frustrazione,1,1,0,1
846,insistono,1,1,0,1
848,personalizzare,1,1,0,1
885,modulo,1,1,0,1
888,possedeva,1,1,0,1
893,violare,1,1,0,1
895,cristianesimo,1,1,0,1
896,privo,1,1,0,1
898,identificabili,1,1,0,1
900,goditi,1,1,0,1
902,ricercati,1,1,0,1
906,continuava,1,1,0,1
907,comprenda,1,1,0,1
908,popolarità—,1,1,0,1
913,sbagliato»,1,1,0,1
914,storica,1,1,0,1
915,etnologia,1,1,0,1
921,stagione,1,1,0,1
884,scorrimento,1,1,0,1
883,scolastici,1,1,0,1
881,depositano,1,1,0,1
861,frodi,1,1,0,1
849,luminosità,1,1,0,1
851,sorgere,1,1,0,1
853,chilometri,1,1,0,1
854,confrontati,1,1,0,1
855,onnicomprensivo,1,1,0,1
857,pornografiche,1,1,0,1
864,degassamento,1,1,0,1
880,respinta,1,1,0,1
866,sonore,1,1,0,1
872,piemontese,1,1,0,1
873,prefisso,1,1,0,1
874,matrimoni,1,1,0,1
877,comica,1,1,0,1
878,demografico,1,1,0,1
1096,cantonali,1,1,0,1
1105,pedone,1,1,0,1
2986,commosso,1,1,0,1
1390,biologiche,1,1,0,1
1399,diminuite,1,1,0,1
1400,diffuso,1,1,0,1
1401,trofei,1,1,0,1
1402,robuste,1,1,0,1
1403,destinata,1,1,0,1
1404,riserve,1,1,0,1
1407,sanitario,1,1,0,1
1412,accuratamente,1,1,0,1
1413,progettando,1,1,0,1
1422,concentrerebbero,1,1,0,1
1423,rappresentatività,1,1,0,1
1426,disordinato,1,1,0,1
1427,consistono,1,1,0,1
1428,jōichi,1,1,0,1
1429,coltivare,1,1,0,1
1393,costituita,1,1,0,1
1388,necessitava,1,1,0,1
1330,lasciati,1,1,0,1
1386,ricoperto,1,1,0,1
1335,spammer,1,1,0,1
1339,multidimensionali,1,1,0,1
1341,avverte,1,1,0,1
1343,artista,1,1,0,1
1348,mascotte,1,1,0,1
1349,campionamento,1,1,0,1
1351,bordi,1,1,0,1
1354,sofisticati,1,1,0,1
1355,volevi,1,1,0,1
1357,censimento,1,1,0,1
1361,celebrazioni,1,1,0,1
1364,stilistici,1,1,0,1
1371,diventerà,1,1,0,1
1377,innovatori,1,1,0,1
1382,mitigare,1,1,0,1
1432,​​nel,1,1,0,1
1434,tubo,1,1,0,1
1435,sospetta,1,1,0,1
1437,rispettabile,1,1,0,1
1476,confonde,1,1,0,1
1477,leggeva,1,1,0,1
1478,indagine,1,1,0,1
1479,autrice,1,1,0,1
1482,mancare,1,1,0,1
1483,scorrendo,1,1,0,1
1486,vecchi,1,1,0,1
1487,compensare,1,1,0,1
1490,arboreti,1,1,0,1
1491,scadente,1,1,0,1
1493,estetici,1,1,0,1
1496,giurisprudenza,1,1,0,1
1497,giocatore,1,1,0,1
1498,discreti,1,1,0,1
1499,nuovamente,1,1,0,1
1475,israeliano,1,1,0,1
1466,razziali,1,1,0,1
1465,saper,1,1,0,1
1447,empirismo,1,1,0,1
1438,africana,1,1,0,1
1439,robotiche,1,1,0,1
1442,evidenziazione,1,1,0,1
1443,coppia,1,1,0,1
1444,inesplorabile,1,1,0,1
1446,omissione,1,1,0,1
1450,mangiando,1,1,0,1
1463,lampante,1,1,0,1
1453,marcatura,1,1,0,1
1456,basava,1,1,0,1
1457,finalità,1,1,0,1
1458,aggiudica,1,1,0,1
1461,linguisticamente,1,1,0,1
1462,ragionato,1,1,0,1
1332,impari,1,1,0,1
1324,violento,1,1,0,1
1111,mappamondo,1,1,0,1
1165,reciproca,1,1,0,1
1171,razza,1,1,0,1
1173,aggiornabile,1,1,0,1
1179,riceveva,1,1,0,1
1180,correttori,1,1,0,1
1182,iniqua,1,1,0,1
1187,avvisare,1,1,0,1
1190,dissimili,1,1,0,1
1191,rivelarsi,1,1,0,1
1195,deformativi,1,1,0,1
1196,ordinare,1,1,0,1
1201,molta,1,1,0,1
1203,sedici,1,1,0,1
1204,provato,1,1,0,1
1206,orientamenti,1,1,0,1
1207,diagnostica,1,1,0,1
1166,installazione,1,1,0,1
1152,contestano,1,1,0,1
1320,collegati,1,1,0,1
1151,riconoscibili,1,1,0,1
1113,esplicito,1,1,0,1
1116,tempestivamente,1,1,0,1
1118,attenua,1,1,0,1
1121,dirompente,1,1,0,1
1124,nera,1,1,0,1
1127,connesso,1,1,0,1
1128,finanziari,1,1,0,1
1130,attribuiscono,1,1,0,1
1137,consegnano,1,1,0,1
1139,stregua,1,1,0,1
1140,prospettico,1,1,0,1
1141,laccoliti,1,1,0,1
1142,secondari,1,1,0,1
1143,sembrerà,1,1,0,1
1145,giornalieri,1,1,0,1
1208,distinguerlo,1,1,0,1
1210,applicavano,1,1,0,1
1211,provò,1,1,0,1
1213,omettendo,1,1,0,1
1274,boreale,1,1,0,1
1275,apparentemente,1,1,0,1
1276,affida,1,1,0,1
1278,coincidere,1,1,0,1
1282,sorgente,1,1,0,1
1286,primitivi,1,1,0,1
1289,amoralità,1,1,0,1
1291,sconvolgere,1,1,0,1
1296,entusiasmo,1,1,0,1
1298,democratico,1,1,0,1
1301,suntimes,1,1,0,1
1308,«chi,1,1,0,1
1311,consentissero,1,1,0,1
1312,invia,1,1,0,1
1317,desiderata,1,1,0,1
1272,parzialità,1,1,0,1
1270,mioglobina,1,1,0,1
1269,pietre,1,1,0,1
1239,cresciute,1,1,0,1
1218,finanzia,1,1,0,1
1220,cartesiano,1,1,0,1
1229,complicati,1,1,0,1
1230,vienimi,1,1,0,1
1233,purificata,1,1,0,1
1234,sovvenzione,1,1,0,1
1244,frequentazione,1,1,0,1
1268,cambiate,1,1,0,1
1252,inondare,1,1,0,1
1253,espansioni,1,1,0,1
1254,esclusività,1,1,0,1
1255,sconfiggere,1,1,0,1
1257,tdgammon,1,1,0,1
1263,interrelato,1,1,0,1
778,risolto,1,1,0,1
771,​e,1,1,0,1
770,enormi,1,1,0,1
244,anticamente,1,1,0,1
247,crescerli,1,1,0,1
249,palomar,1,1,0,1
250,vera,1,1,0,1
253,condanni,1,1,0,1
254,oscurantismo,1,1,0,1
256,irrilevanti,1,1,0,1
257,celebrata,1,1,0,1
261,agito,1,1,0,1
262,approfondimento,1,1,0,1
263,geomorfologia,1,1,0,1
266,manufatti,1,1,0,1
268,intervengono,1,1,0,1
270,uffici,1,1,0,1
272,successione,1,1,0,1
276,sicure,1,1,0,1
246,indicativo,1,1,0,1
237,porto,1,1,0,1
188,aderisce,1,1,0,1
235,golfi,1,1,0,1
198,ottenute,1,1,0,1
200,intitolata,1,1,0,1
202,inevitabile,1,1,0,1
204,francoprovenzale,1,1,0,1
205,​​​​ogni,1,1,0,1
208,caricarle,1,1,0,1
210,tra milioni,1,1,0,1
211,—robot,1,1,0,1
213,antropomorfismo,1,1,0,1
217,«dati,1,1,0,1
219,qualifica,1,1,0,1
222,convenzionalmente,1,1,0,1
225,trasformativo,1,1,0,1
232,impegnarsi,1,1,0,1
234,presiede,1,1,0,1
283,stampare,1,1,0,1
286,ridistribuirli,1,1,0,1
288,gole,1,1,0,1
290,avresti,1,1,0,1
339,cancellazionismo,1,1,0,1
346,utilizzatori,1,1,0,1
348,risalire,1,1,0,1
349,costruite,1,1,0,1
350,democrazia,1,1,0,1
355,costituzione,1,1,0,1
356,netto,1,1,0,1
357,architettura,1,1,0,1
360,giustapposizione,1,1,0,1
361,licenziatari,1,1,0,1
366,specialistico,1,1,0,1
367,scalpore,1,1,0,1
368,proteina,1,1,0,1
370,tridimensionale,1,1,0,1
371,mappe,1,1,0,1
338,fondazioni,1,1,0,1
336,netti,1,1,0,1
333,commercio,1,1,0,1
310,gigantesche,1,1,0,1
291,elettronici,1,1,0,1
295,compilazione,1,1,0,1
298,causate,1,1,0,1
303,occupò,1,1,0,1
305,dichiarava,1,1,0,1
308,rivisti,1,1,0,1
312,agostino,1,1,0,1
330,trasformato,1,1,0,1
315,meriti,1,1,0,1
317,proporzionalmente,1,1,0,1
319,mostrati,1,1,0,1
321,devastazione,1,1,0,1
326,telefonici,1,1,0,1
328,starebbero,1,1,0,1
189,ricordartelo,1,1,0,1
184,condiviso,1,1,0,1
766,attraversa,1,1,0,1
42,sradicare,1,1,0,1
47,sovrappone,1,1,0,1
48,antropica,1,1,0,1
51,motivazione,1,1,0,1
53,oscuri,1,1,0,1
57,edite,1,1,0,1
62,mani,1,1,0,1
64,planetario,1,1,0,1
66,dimostrato»,1,1,0,1
70,bavaglio,1,1,0,1
71,magari,1,1,0,1
72,coltivato,1,1,0,1
75,incirca,1,1,0,1
76,spettroscopia,1,1,0,1
83,giappone,1,1,0,1
87,archeani,1,1,0,1
45,interromperlo,1,1,0,1
39,matrici,1,1,0,1
177,cliente,1,1,0,1
38,risentirebbe,1,1,0,1
4,dito,1,1,0,1
6,copiato,1,1,0,1
7,colossi,1,1,0,1
10,supino,1,1,0,1
12,ricombinati,1,1,0,1
13,rimosse,1,1,0,1
15,fornitore,1,1,0,1
17,masturbazione,1,1,0,1
21,presentandole,1,1,0,1
27,sviluppatasi,1,1,0,1
31,introducono,1,1,0,1
32,iniziano,1,1,0,1
33,impostate,1,1,0,1
34,euristico,1,1,0,1
37,cancellate,1,1,0,1
89,latinizzato,1,1,0,1
91,attuò,1,1,0,1
102,messaggi,1,1,0,1
105,degne,1,1,0,1
142,proliferare,1,1,0,1
143,pensasse,1,1,0,1
150,debolmente,1,1,0,1
156,wikibook,1,1,0,1
157,migliorava,1,1,0,1
158,apertamente,1,1,0,1
160,aggregatore,1,1,0,1
162,orientata,1,1,0,1
165,garantirebbe,1,1,0,1
167,legittima,1,1,0,1
169,sostenuti,1,1,0,1
171,meteore,1,1,0,1
173,parteciparvi,1,1,0,1
174,lorde,1,1,0,1
175,nichel,1,1,0,1
141,controlla,1,1,0,1
135,ampiezza,1,1,0,1
133,frutti,1,1,0,1
113,tirare,1,1,0,1
107,uragani,1,1,0,1
108,confutato,1,1,0,1
109,distinguendo,1,1,0,1
110,mammifero,1,1,0,1
111,amministrativi,1,1,0,1
112,subnazionali,1,1,0,1
115,accreditati,1,1,0,1
131,affidata,1,1,0,1
118,ghiacciata,1,1,0,1
120,rivolta,1,1,0,1
122,lietissimo,1,1,0,1
125,quarantadue,1,1,0,1
128,derivanti,1,1,0,1
129,globopuzzle,1,1,0,1
372,allegorica,1,1,0,1
376,animata,1,1,0,1
377,vago,1,1,0,1
636,classismo,1,1,0,1
638,attivazione,1,1,0,1
639,parità,1,1,0,1
643,garantendo,1,1,0,1
644,protettive,1,1,0,1
645,conferitagli,1,1,0,1
652,impossibilità,1,1,0,1
656,visualizzato,1,1,0,1
659,spirituale,1,1,0,1
663,postazioni,1,1,0,1
666,sant,1,1,0,1
668,sembravi,1,1,0,1
670,superavano,1,1,0,1
671,considerandolo,1,1,0,1
672,montuose,1,1,0,1
675,raccontare,1,1,0,1
637,unitario,1,1,0,1
634,sviluppatosi,1,1,0,1
378,intensificare,1,1,0,1
633,digitalizzati,1,1,0,1
590,plugin,1,1,0,1
592,adeguatezza,1,1,0,1
593,management,1,1,0,1
594,unicorno,1,1,0,1
595,separatamente,1,1,0,1
599,dialogatore,1,1,0,1
600,qualora,1,1,0,1
606,svolgimento,1,1,0,1
607,mediate,1,1,0,1
608,emozioniamo,1,1,0,1
613,farneticante,1,1,0,1
618,profilo,1,1,0,1
625,intendeva,1,1,0,1
626,assoluta,1,1,0,1
631,dannosi,1,1,0,1
676,discreta,1,1,0,1
677,dannosa,1,1,0,1
679,produttivi,1,1,0,1
680,dedicate,1,1,0,1
717,discosta,1,1,0,1
725,giudaica,1,1,0,1
728,beneficiato,1,1,0,1
730,scazzottate,1,1,0,1
732,padrone,1,1,0,1
733,guidati,1,1,0,1
737,argentina,1,1,0,1
738,approssimativi,1,1,0,1
739,lievi,1,1,0,1
740,contattato,1,1,0,1
741,stila,1,1,0,1
744,presupposti,1,1,0,1
752,chiama,1,1,0,1
757,avversario,1,1,0,1
762,quasi milioni,1,1,0,1
716,microecosistema,1,1,0,1
714,elaborata,1,1,0,1
712,rilevano,1,1,0,1
699,mobilitano,1,1,0,1
683,salvati,1,1,0,1
686,ecosistemici,1,1,0,1
689,déencyclopédie,1,1,0,1
691,ribellione,1,1,0,1
692,personalizzati,1,1,0,1
697,cavallo,1,1,0,1
700,compattezza,1,1,0,1
710,macedonia,1,1,0,1
701,distorto,1,1,0,1
702,organiche,1,1,0,1
705,scrutato,1,1,0,1
707,conducendo,1,1,0,1
708,giunsero,1,1,0,1
709,illustrati,1,1,0,1
589,pazientemente,1,1,0,1
587,riprenditi,1,1,0,1
581,intercettare,1,1,0,1
484,grafiche,1,1,0,1
434,ovvio,1,1,0,1
438,esponendo,1,1,0,1
441,visivamente,1,1,0,1
443,religione,1,1,0,1
447,«…per,1,1,0,1
448,insigniti,1,1,0,1
449,contraddetta,1,1,0,1
450,meritavano,1,1,0,1
451,imitare,1,1,0,1
457,nascono,1,1,0,1
462,caccia,1,1,0,1
464,brevettabilità,1,1,0,1
465,discriminazione,1,1,0,1
477,animiste,1,1,0,1
481,esatta,1,1,0,1
433,organizzare,1,1,0,1
428,recuperare,1,1,0,1
426,polare,1,1,0,1
396,predittivo,1,1,0,1
385,determina,1,1,0,1
387,manifestazione,1,1,0,1
388,radicalmente,1,1,0,1
389,ossia,1,1,0,1
390,romantico,1,1,0,1
393,kilotonnellate,1,1,0,1
399,topologia,1,1,0,1
424,corridoi,1,1,0,1
402,sollevata,1,1,0,1
406,quattromila,1,1,0,1
410,arrabbiare,1,1,0,1
411,dannazione,1,1,0,1
416,empirici,1,1,0,1
417,barre,1,1,0,1
482,provino,1,1,0,1
485,appropriati,1,1,0,1
580,punizione,1,1,0,1
487,discernere,1,1,0,1
539,amplierebbe,1,1,0,1
540,riteneva,1,1,0,1
543,vocali,1,1,0,1
549,trascorrono,1,1,0,1
550,conquista,1,1,0,1
553,consegnati,1,1,0,1
557,perfette,1,1,0,1
559,adattato,1,1,0,1
560,detratto,1,1,0,1
564,binario,1,1,0,1
566,intromettono,1,1,0,1
569,allevamenti,1,1,0,1
573,gay,1,1,0,1
574,parodie,1,1,0,1
577,frammentati,1,1,0,1
535,dimostrare,1,1,0,1
534,tecnologici,1,1,0,1
532,comparativo,1,1,0,1
512,equa,1,1,0,1
489,pronunciato,1,1,0,1
493,donatori,1,1,0,1
496,latitudinale,1,1,0,1
502,coinvolte,1,1,0,1
506,consideravano,1,1,0,1
509,mecenati,1,1,0,1
517,simpatico,1,1,0,1
531,romagnolo,1,1,0,1
520,accuse,1,1,0,1
524,impiegassero,1,1,0,1
526,dirai,1,1,0,1
527,raggruppate,1,1,0,1
528,ricordano,1,1,0,1
530,scia,1,1,0,1
1500,inviati,1,1,0,1
1501,arricchirà,1,1,0,1
1502,riempiono,1,1,0,1
2465,divideva,1,1,0,1
2468,drenaggio,1,1,0,1
2470,incroci,1,1,0,1
2475,permettere,1,1,0,1
2478,affamato,1,1,0,1
2482,circolano,1,1,0,1
2490,dramata,1,1,0,1
2492,precauzione,1,1,0,1
2493,combinato,1,1,0,1
2499,gigabyte,1,1,0,1
2501,veniva,1,1,0,1
2503,provenire,1,1,0,1
2506,incrementale,1,1,0,1
2509,riletti,1,1,0,1
2513,raccolga,1,1,0,1
2518,proclamato,1,1,0,1
2467,endoreici,1,1,0,1
2464,riconoscono,1,1,0,1
2412,uichipedìa,1,1,0,1
2462,sofferma,1,1,0,1
2419,brevi,1,1,0,1
2420,triplice,1,1,0,1
2422,collegandoli,1,1,0,1
2423,difensori,1,1,0,1
2425,segnalazioni,1,1,0,1
2432,durabilità,1,1,0,1
2436,esaltano,1,1,0,1
2440,rotta,1,1,0,1
2443,strutturati,1,1,0,1
2445,offerti,1,1,0,1
2448,nati,1,1,0,1
2454,rivelano,1,1,0,1
2458,assunzioni,1,1,0,1
2459,correlate,1,1,0,1
2460,definibile,1,1,0,1
2520,misure,1,1,0,1
2532,combattono,1,1,0,1
2535,affrontate,1,1,0,1
2537,disgregati,1,1,0,1
2592,empirica,1,1,0,1
2597,incoerenze,1,1,0,1
2598,eoni,1,1,0,1
2600,osservatori,1,1,0,1
2601,canepari,1,1,0,1
2603,raccomandazioni,1,1,0,1
2605,protagonista,1,1,0,1
2611,leggessero,1,1,0,1
2613,parentela,1,1,0,1
2618,prescindere,1,1,0,1
2619,replicate,1,1,0,1
2621,lascio,1,1,0,1
2623,tibet,1,1,0,1
2625,swahili,1,1,0,1
2626,avanguardia,1,1,0,1
2589,rifiutato,1,1,0,1
2586,letterale,1,1,0,1
2584,veste,1,1,0,1
2554,sottoterra,1,1,0,1
2541,correlazione,1,1,0,1
2542,rintracciato,1,1,0,1
2543,brutti,1,1,0,1
2546,fornitura,1,1,0,1
2552,simboleggiare,1,1,0,1
2553,sostituiti,1,1,0,1
2556,prevalente,1,1,0,1
2583,wikiversità,1,1,0,1
2558,microfono,1,1,0,1
2564,sfruttare,1,1,0,1
2565,somalo,1,1,0,1
2568,sistemica,1,1,0,1
2570,controparte,1,1,0,1
2578,generi,1,1,0,1
2414,continuata,1,1,0,1
2406,indicizza,1,1,0,1
2255,adeguate,1,1,0,1
2294,divergenze,1,1,0,1
2296,fatta,1,1,0,1
2299,concentri,1,1,0,1
2301,oscene,1,1,0,1
2302,artistico,1,1,0,1
2306,sitoj,1,1,0,1
2307,evolvono,1,1,0,1
2308,teologicopolitica,1,1,0,1
2309,visualizzati,1,1,0,1
2310,vogliono,1,1,0,1
2312,mercurio,1,1,0,1
2313,operano,1,1,0,1
2316,maglie,1,1,0,1
2320,concesse,1,1,0,1
2322,librerie,1,1,0,1
2328,divieto,1,1,0,1
2295,illimitato,1,1,0,1
2292,solari,1,1,0,1
2404,compensi,1,1,0,1
2291,archivistica,1,1,0,1
2260,visitare,1,1,0,1
2262,accelerazione,1,1,0,1
2263,onda,1,1,0,1
2265,screening,1,1,0,1
2266,assurde,1,1,0,1
2274,geofisiologico,1,1,0,1
2275,rimarranno,1,1,0,1
2277,numerica,1,1,0,1
2279,disgregazione,1,1,0,1
2281,scattare,1,1,0,1
2284,riparate,1,1,0,1
2285,molecola,1,1,0,1
2286,illustrato,1,1,0,1
2287,adozione,1,1,0,1
2289,virgolette,1,1,0,1
2329,pacchetto,1,1,0,1
2332,carlo,1,1,0,1
2334,andrà,1,1,0,1
2335,imparentati,1,1,0,1
2370,premiano,1,1,0,1
2372,trascendentalista,1,1,0,1
2373,netizen,1,1,0,1
2375,regolato,1,1,0,1
2377,restando,1,1,0,1
2378,restituito,1,1,0,1
2381,armonia,1,1,0,1
2384,alterano,1,1,0,1
2387,vandalizzato,1,1,0,1
2391,contemporaneo,1,1,0,1
2392,campionata,1,1,0,1
2393,urbana,1,1,0,1
2397,banner,1,1,0,1
2401,invalidate,1,1,0,1
2402,causata,1,1,0,1
2364,sposati,1,1,0,1
2361,integrali,1,1,0,1
2358,sysop,1,1,0,1
2344,registrarsi,1,1,0,1
2336,condizionale,1,1,0,1
2337,blair»,1,1,0,1
2338,trasduzione,1,1,0,1
2340,sphinxsystem,1,1,0,1
2342,etichettato,1,1,0,1
2343,programmatore,1,1,0,1
2345,affogando,1,1,0,1
2356,poeta,1,1,0,1
2347,nasa,1,1,0,1
2349,reati,1,1,0,1
2351,carbonio,1,1,0,1
2353,reclami,1,1,0,1
2354,alterna,1,1,0,1
2355,nazionalità,1,1,0,1
2627,scrisse,1,1,0,1
2629,docenti,1,1,0,1
2630,invasi,1,1,0,1
2863,maremoto,1,1,0,1
2873,equivale,1,1,0,1
2874,perfettamente,1,1,0,1
2875,moderare,1,1,0,1
2879,basare,1,1,0,1
2880,assegnata,1,1,0,1
2881,segnalate,1,1,0,1
2882,trattata,1,1,0,1
2884,idrico,1,1,0,1
2885,metafisica,1,1,0,1
2888,liberarsene,1,1,0,1
2889,argini,1,1,0,1
2890,spicole,1,1,0,1
2892,londinese,1,1,0,1
2895,linz,1,1,0,1
2901,utilizzi,1,1,0,1
2871,azoto,1,1,0,1
2862,discutibili,1,1,0,1
2631,abbonamenti,1,1,0,1
2861,wafer,1,1,0,1
2821,ritirato,1,1,0,1
2826,legittimità,1,1,0,1
2827,esercitata,1,1,0,1
2828,cambiò,1,1,0,1
2831,personeai,1,1,0,1
2832,spedizioni,1,1,0,1
2836,stimata,1,1,0,1
2839,cattivo,1,1,0,1
2842,documentata,1,1,0,1
2844,semiprotetto,1,1,0,1
2850,affisso,1,1,0,1
2852,aristotelica,1,1,0,1
2855,generatrici,1,1,0,1
2857,supremo,1,1,0,1
2859,antidühring,1,1,0,1
2904,taggava,1,1,0,1
2908,curata,1,1,0,1
2910,musicale,1,1,0,1
2911,riutilizzarlo,1,1,0,1
2953,ringraziandovi,1,1,0,1
2954,ricreare,1,1,0,1
2957,effettive,1,1,0,1
2959,ecologi,1,1,0,1
2962,simboleggiando,1,1,0,1
2964,comprendente,1,1,0,1
2967,steward,1,1,0,1
2968,rimuoveremmo,1,1,0,1
2969,costituisca,1,1,0,1
2972,invita,1,1,0,1
2974,scaffale,1,1,0,1
2978,fatelo,1,1,0,1
2979,drammatico,1,1,0,1
2983,metano,1,1,0,1
2985,promettenti,1,1,0,1
2950,benedetto,1,1,0,1
2948,ripetute,1,1,0,1
2947,peˈdia,1,1,0,1
2934,battuto,1,1,0,1
2920,arrestata,1,1,0,1
2922,divergenti,1,1,0,1
2923,ammette,1,1,0,1
2925,versatile,1,1,0,1
2926,sorgono,1,1,0,1
2931,incazzato,1,1,0,1
2935,ladina,1,1,0,1
2946,modificassero,1,1,0,1
2937,favorisce,1,1,0,1
2939,thesaurus,1,1,0,1
2940,retribuita,1,1,0,1
2941,concretizzato,1,1,0,1
2943,apprezzati,1,1,0,1
2945,pareri,1,1,0,1
2819,sideriano,1,1,0,1
2816,ornamenti,1,1,0,1
2813,aprire,1,1,0,1
2724,loghi,1,1,0,1
2683,wikispecie,1,1,0,1
2684,fissavano,1,1,0,1
2685,correlata,1,1,0,1
2688,corea,1,1,0,1
2689,sovvenzioni,1,1,0,1
2691,morti,1,1,0,1
2694,discesa,1,1,0,1
2701,mo,1,1,0,1
2702,promozionali,1,1,0,1
2706,chakavian,1,1,0,1
2714,epidemica,1,1,0,1
2715,eccetto,1,1,0,1
2717,consolidati,1,1,0,1
2718,disporre,1,1,0,1
2719,sementiere,1,1,0,1
2681,lanciati,1,1,0,1
2680,centralizzato,1,1,0,1
2676,rimanda,1,1,0,1
2655,mirerà,1,1,0,1
2635,editathon,1,1,0,1
2638,trattare,1,1,0,1
2642,caotici,1,1,0,1
2645,ringraziamento,1,1,0,1
2650,abitato,1,1,0,1
2652,valutata,1,1,0,1
2659,annullata,1,1,0,1
2674,firma,1,1,0,1
2660,altoparlanti,1,1,0,1
2661,raccolgono,1,1,0,1
2667,conseguito,1,1,0,1
2668,verificabile,1,1,0,1
2669,permetteva,1,1,0,1
2671,sottosuolo,1,1,0,1
2721,satirico,1,1,0,1
2728,uscite,1,1,0,1
2812,diminuito,1,1,0,1
2730,rendiamo,1,1,0,1
2772,celebrate,1,1,0,1
2775,conquiste,1,1,0,1
2778,esistano,1,1,0,1
2780,significato»,1,1,0,1
2781,cambiano,1,1,0,1
2782,coesione,1,1,0,1
2785,consigliate,1,1,0,1
2791,duplica,1,1,0,1
2792,arbitrato,1,1,0,1
2793,includeva,1,1,0,1
2799,galiziano,1,1,0,1
2801,semiformale,1,1,0,1
2802,illustratore,1,1,0,1
2805,promuovono,1,1,0,1
2811,candidarsi,1,1,0,1
2771,annata,1,1,0,1
2765,digitare,1,1,0,1
2764,concedere,1,1,0,1
2744,sconcertante,1,1,0,1
2736,precondizione,1,1,0,1
2737,migrazione,1,1,0,1
2738,preparare,1,1,0,1
2740,musica,1,1,0,1
2741,conservato,1,1,0,1
2743,alti,1,1,0,1
2745,sottolineano,1,1,0,1
2763,confinato,1,1,0,1
2748,concorrente,1,1,0,1
2749,proprietaria,1,1,0,1
2750,rivestono,1,1,0,1
2752,palato,1,1,0,1
2759,—almeno—,1,1,0,1
2760,scaricate,1,1,0,1
2257,erasm,1,1,0,1
2250,blu,1,1,0,1
1504,muoviti,1,1,0,1
1724,fruitori,1,1,0,1
1728,suddivisione,1,1,0,1
1735,compact,1,1,0,1
1745,polonia,1,1,0,1
1747,depositate,1,1,0,1
1749,migliorato,1,1,0,1
1750,educatamente,1,1,0,1
1753,scherzi,1,1,0,1
1759,proveniva,1,1,0,1
1760,pronunciarsi,1,1,0,1
1761,estrazione,1,1,0,1
1762,collaboratori—,1,1,0,1
1763,obbedisce,1,1,0,1
1764,sospette,1,1,0,1
1766,irregolare»,1,1,0,1
1767,essenziale,1,1,0,1
1725,esaurimento,1,1,0,1
1723,idiota,1,1,0,1
1687,dava,1,1,0,1
1721,intellettuali,1,1,0,1
1692,riassuntiva,1,1,0,1
1694,interrotti,1,1,0,1
1695,riscontrabili,1,1,0,1
1696,definitivo,1,1,0,1
1698,sotterraneo,1,1,0,1
1700,privatizzazioni,1,1,0,1
1702,solitudine,1,1,0,1
1703,presidenziale,1,1,0,1
1709,consumo,1,1,0,1
1712,proteiche,1,1,0,1
1713,sapessero,1,1,0,1
1714,—come,1,1,0,1
1716,usino,1,1,0,1
1717,biologi,1,1,0,1
1718,genitori,1,1,0,1
1768,sospeso,1,1,0,1
1769,elenca,1,1,0,1
1770,ottanta,1,1,0,1
1772,gatti,1,1,0,1
1837,intenzionale era,1,1,0,1
1838,minoritaria,1,1,0,1
1839,insistendo,1,1,0,1
1841,prendersene,1,1,0,1
1845,tempestato,1,1,0,1
1846,maratone,1,1,0,1
1853,sostituendo,1,1,0,1
1854,libera—,1,1,0,1
1855,attesi,1,1,0,1
1860,teorico,1,1,0,1
1865,trasversale,1,1,0,1
1871,analitiche,1,1,0,1
1873,contribuirvi,1,1,0,1
1875,millimetroref,1,1,0,1
1876,inaffidabilità,1,1,0,1
1835,multe,1,1,0,1
1828,combinano,1,1,0,1
1823,stimava,1,1,0,1
1798,conservatore,1,1,0,1
1773,interpretati,1,1,0,1
1774,percentuali,1,1,0,1
1778,ossigenazione,1,1,0,1
1782,editoria,1,1,0,1
1791,ignee,1,1,0,1
1792,inventore,1,1,0,1
1802,domestiche,1,1,0,1
1822,eiaculazione,1,1,0,1
1806,equipaggio,1,1,0,1
1807,retropropagato,1,1,0,1
1812,ibridi,1,1,0,1
1814,divulgati,1,1,0,1
1816,finora,1,1,0,1
1820,soffrire,1,1,0,1
1691,divulgativi,1,1,0,1
1685,depositata,1,1,0,1
2247,​​rischio,1,1,0,1
1543,partecipante,1,1,0,1
1545,meraviglie,1,1,0,1
1547,canadesi,1,1,0,1
1548,visibilmente,1,1,0,1
1551,consultano,1,1,0,1
1552,terminale,1,1,0,1
1553,parlanti,1,1,0,1
1554,accorciamento,1,1,0,1
1561,amato,1,1,0,1
1563,consentirà,1,1,0,1
1567,telecomunicazioni,1,1,0,1
1575,applicativi,1,1,0,1
1578,mitologici,1,1,0,1
1579,connessa,1,1,0,1
1580,omogenei,1,1,0,1
1581,possiedono,1,1,0,1
1544,rompersi,1,1,0,1
1541,codificatori,1,1,0,1
1679,petizione,1,1,0,1
1538,consuma,1,1,0,1
1505,opportunista,1,1,0,1
1506,sottoadattato,1,1,0,1
1507,idrici,1,1,0,1
1508,unificati,1,1,0,1
1511,involucro,1,1,0,1
1512,nate,1,1,0,1
1515,confinate,1,1,0,1
1516,avvicinò,1,1,0,1
1518,circuito,1,1,0,1
1522,coperture,1,1,0,1
1529,raddoppiata,1,1,0,1
1530,subatomiche,1,1,0,1
1534,potenza,1,1,0,1
1535,rileggerlo,1,1,0,1
1536,mobilità,1,1,0,1
1582,consapevolmente,1,1,0,1
1583,osso,1,1,0,1
1587,eppure,1,1,0,1
1588,—utenti,1,1,0,1
1632,disturbarti,1,1,0,1
1636,sbagliata,1,1,0,1
1638,specializzazione,1,1,0,1
1639,specificatamente,1,1,0,1
1640,addotti,1,1,0,1
1650,notate,1,1,0,1
1655,strada,1,1,0,1
1657,immagazzinamento,1,1,0,1
1658,wikiwikiweb,1,1,0,1
1659,iscritti,1,1,0,1
1664,risparmiato,1,1,0,1
1666,dichiararono,1,1,0,1
1671,millimetro,1,1,0,1
1672,tensoriali,1,1,0,1
1674,salato,1,1,0,1
1625,sommersa,1,1,0,1
1621,romancio,1,1,0,1
1620,tolosa,1,1,0,1
1598,separabile,1,1,0,1
1590,ottengono,1,1,0,1
1593,correttiva,1,1,0,1
1594,subisce,1,1,0,1
1595,regolarizzazione,1,1,0,1
1596,condividono,1,1,0,1
1597,atmosfere,1,1,0,1
1605,evitato,1,1,0,1
1617,avvocato,1,1,0,1
1606,riscoperta,1,1,0,1
1608,crittologo,1,1,0,1
1610,intrinseche,1,1,0,1
1611,sviluppano,1,1,0,1
1613,pareti,1,1,0,1
1616,curva,1,1,0,1
1878,trasformarle,1,1,0,1
1885,distorte,1,1,0,1
1886,superficiali»,1,1,0,1
2120,parlante,1,1,0,1
2122,gofai,1,1,0,1
2124,anarchia,1,1,0,1
2127,integrati,1,1,0,1
2128,prendersi,1,1,0,1
2130,pubblicabili,1,1,0,1
2131,analizzare,1,1,0,1
2132,dimette,1,1,0,1
2135,gentilmente,1,1,0,1
2137,pura,1,1,0,1
2138,conclude,1,1,0,1
2143,obbligo,1,1,0,1
2144,blocchi,1,1,0,1
2145,scimmia,1,1,0,1
2148,scoprì,1,1,0,1
2150,ebraica,1,1,0,1
2121,fitness,1,1,0,1
2118,esito,1,1,0,1
1889,evolutivi,1,1,0,1
2115,innaturali,1,1,0,1
2089,dottorando,1,1,0,1
2090,adolescenti,1,1,0,1
2091,riconoscibile,1,1,0,1
2092,sistematicamente,1,1,0,1
2094,uniformi,1,1,0,1
2095,profitti,1,1,0,1
2097,sottolineiamo,1,1,0,1
2098,trascendenza,1,1,0,1
2099,alza,1,1,0,1
2102,croazia,1,1,0,1
2104,curare,1,1,0,1
2105,algoritmicamente,1,1,0,1
2107,l’apprendimento,1,1,0,1
2108,ere,1,1,0,1
2112,seguono,1,1,0,1
2151,elettrici,1,1,0,1
2152,limiterebbe,1,1,0,1
2157,simboliche,1,1,0,1
2159, miliardi,1,1,0,1
2198,giove,1,1,0,1
2202,sfruttano,1,1,0,1
2204,britanniche,1,1,0,1
2213,iterazione,1,1,0,1
2216,indicati,1,1,0,1
2217,novità,1,1,0,1
2218,raccomanda,1,1,0,1
2219,violati,1,1,0,1
2220,sfoggio»,1,1,0,1
2224,rifiutare,1,1,0,1
2228,specchi,1,1,0,1
2229,redistribuzione,1,1,0,1
2234,innescato,1,1,0,1
2241,preferibile,1,1,0,1
2246,inclusione,1,1,0,1
2197,tuttora,1,1,0,1
2196,amata,1,1,0,1
2191,intense,1,1,0,1
2172,analogismo,1,1,0,1
2162,ritardato,1,1,0,1
2164,avvisati,1,1,0,1
2167,autoreplicazione,1,1,0,1
2168,consultato,1,1,0,1
2169,speranza,1,1,0,1
2170,avanzato,1,1,0,1
2174,coniata,1,1,0,1
2190,impostazione,1,1,0,1
2176,elica,1,1,0,1
2177,ignorante,1,1,0,1
2178,futuri,1,1,0,1
2180,distorti,1,1,0,1
2182,incredibili,1,1,0,1
2183,prive,1,1,0,1
2088,frattura,1,1,0,1
2086,fratelli,1,1,0,1
2084,lighting,1,1,0,1
1990,riempiranno,1,1,0,1
1953,lungi,1,1,0,1
1954,fisicochimiche,1,1,0,1
1961,ecologicamente,1,1,0,1
1963,attribuendoli,1,1,0,1
1964,termici,1,1,0,1
1965,lacuna,1,1,0,1
1968,tagliato,1,1,0,1
1970,moderatori,1,1,0,1
1973,naturalisti,1,1,0,1
1974,irresponsabile,1,1,0,1
1975,rimasti,1,1,0,1
1979,buco,1,1,0,1
1980,medicinali,1,1,0,1
1984,partendo,1,1,0,1
1986,regolari,1,1,0,1
1948,proveniente,1,1,0,1
1946,testimoni,1,1,0,1
1940,baciare,1,1,0,1
1916,formata miliardi,1,1,0,1
1892,territori,1,1,0,1
1898,approssimativa,1,1,0,1
1906,invano,1,1,0,1
1909,lunare,1,1,0,1
1910,crosta,1,1,0,1
1915,applicano,1,1,0,1
1919,itwikipediaorg,1,1,0,1
1938,garantiscono,1,1,0,1
1922,giunto,1,1,0,1
1926,coniò,1,1,0,1
1928,operare,1,1,0,1
1929,applica,1,1,0,1
1936,spicco,1,1,0,1
1937,colmare,1,1,0,1
1989,perfetta,1,1,0,1
1994,tradotte,1,1,0,1
2083,suggerì,1,1,0,1
1995,credeva,1,1,0,1
2040,cresta,1,1,0,1
2041,combinati,1,1,0,1
2044,amando,1,1,0,1
2047,induttivamente,1,1,0,1
2052,costruiti,1,1,0,1
2056,rettili,1,1,0,1
2058,individuata,1,1,0,1
2060,oneri,1,1,0,1
2062,annunciano,1,1,0,1
2067,equo,1,1,0,1
2070,etnologi,1,1,0,1
2073,incerto,1,1,0,1
2075,consuete,1,1,0,1
2080,dissidenti,1,1,0,1
2082,spiccano,1,1,0,1
2039,informativo,1,1,0,1
2037,museo,1,1,0,1
2036,meccanici,1,1,0,1
2011,cablata,1,1,0,1
2000,testate,1,1,0,1
2001,dicotomico,1,1,0,1
2002,deliberata,1,1,0,1
2003,fornirebbe,1,1,0,1
2006,sottostanti,1,1,0,1
2009,limitazioni,1,1,0,1
2014,riguardante,1,1,0,1
2033,connessionismo,1,1,0,1
2017,musei,1,1,0,1
2019,ecoregione,1,1,0,1
2022,biblioteconomia,1,1,0,1
2025,quiete,1,1,0,1
2029,commentare,1,1,0,1
2031,ridimensionamento,1,1,0,1
5949,ricorrere,1,1,0,1
5951,combinava,1,1,0,1
5952,caratteristico,1,1,0,1
9872,जोड़ें,0,0,1,1
9877,science »,0,0,1,1
9878,பதிவுகள்,0,0,1,1
9881,«activas»,0,0,1,1
9883,மாற்றங்களைப்,0,0,1,1
9884,அருமையாக,0,0,1,1
9885,verricht,0,0,1,1
9886,gelenekleriyle,0,0,1,1
9887,annesinin,0,0,1,1
9888,വരുമെന്നും,0,0,1,1
9889,تغطية,0,0,1,1
9891,obscurantisme,0,0,1,1
9894,aborígenes,0,0,1,1
9895,நர்சிஸ்,0,0,1,1
9896,ತಬ್ಬಿಕೊಳ್ಳಲು,0,0,1,1
9898,dönmeme,0,0,1,1
9876,ändras,0,0,1,1
9871,aliments,0,0,1,1
9837,маленькой,0,0,1,1
9870,ontmoet,0,0,1,1
9843,connotation,0,0,1,1
9844,സൃഷ്ടിക്കും,0,0,1,1
9846,"
लुम्बार्ट",0,0,1,1
9848,скрестив,0,0,1,1
9851,забираете,0,0,1,1
9853,keşke,0,0,1,1
9854,دروسي,0,0,1,1
9856,"start
पारंपरिक",0,0,1,1
9859,δυνατής,0,0,1,1
9860,എന്നതു,0,0,1,1
9862,atribuir,0,0,1,1
9863,burayı,0,0,1,1
9865,confusas,0,0,1,1
9867,المعارض,0,0,1,1
9869,läsas,0,0,1,1
9900,høflig,0,0,1,1
9901,yazılmakta,0,0,1,1
9903,ಇತರರಿಗೆ,0,0,1,1
9904,surprend,0,0,1,1
9929,صرحت,0,0,1,1
9934,customs,0,0,1,1
9937,évaluer,0,0,1,1
9938,குதித்தால்,0,0,1,1
9942,hawaiianske,0,0,1,1
9944,هارفارد،,0,0,1,1
9945,langdurig,0,0,1,1
9946,desempeño,0,0,1,1
9949,ro •,0,0,1,1
9950,fourthlargest,0,0,1,1
9951,istekte,0,0,1,1
9958,warnings,0,0,1,1
9960,للبنك,0,0,1,1
9961,i̇çeriklerin,0,0,1,1
9963,ശരിയാക്കിയിട്ടുണ്ടോ,0,0,1,1
9928,sucesivos,0,0,1,1
9927,упрекать,0,0,1,1
9925,katıldığımdan,0,0,1,1
9912,insultantes,0,0,1,1
9905,जानकारीपूर्ण,0,0,1,1
9906,разнородными,0,0,1,1
9907,असमर्थ,0,0,1,1
9908,विकिट्रेवल,0,0,1,1
9909,публичное,0,0,1,1
9911,arrêter,0,0,1,1
9913,céus,0,0,1,1
9924,refrendados,0,0,1,1
9916,ഭൂമി,0,0,1,1
9917,англоцентризме,0,0,1,1
9920,vont,0,0,1,1
9921,ആശങ്കകളൊന്നുമില്ല,0,0,1,1
9922,अमान्य,0,0,1,1
9923,pensamiento,0,0,1,1
9842,aportaciones,0,0,1,1
9836,lækre,0,0,1,1
9965,ಗೊತ್ತಿಲ್ಲ,0,0,1,1
9750,llamado,0,0,1,1
9753,наибольшее,0,0,1,1
9754,ontsluiten,0,0,1,1
9755,veckan,0,0,1,1
9756,puzzled,0,0,1,1
9758,câmara,0,0,1,1
9759,इनकी,0,0,1,1
9760,orienté,0,0,1,1
9761,துரதிர்ஷ்டவசமாக,0,0,1,1
9762,humanidades,0,0,1,1
9768,humannature,0,0,1,1
9769,lättare,0,0,1,1
9771,«потрясающе,0,0,1,1
9775,music,0,0,1,1
9778,बच्चा,0,0,1,1
9780,uppringare,0,0,1,1
9752,dignos,0,0,1,1
9748,интернетэнциклопедия,0,0,1,1
9835,lägger,0,0,1,1
9747,بدون,0,0,1,1
9724,செய்வது,0,0,1,1
9725,sortuda,0,0,1,1
9727,bracket,0,0,1,1
9729,deslocar,0,0,1,1
9731,trokken,0,0,1,1
9732,небеса,0,0,1,1
9733,ಕೋನದಲ್ಲಿ,0,0,1,1
9734,exciting,0,0,1,1
9738,gerechtigd,0,0,1,1
9739,σκύλος,0,0,1,1
9740,दर्शाता,0,0,1,1
9741,“poor,0,0,1,1
9742,tränen,0,0,1,1
9743,ಪಡೆದುಕೊಂಡಿದ್ದೇನೆ,0,0,1,1
9744,proponía,0,0,1,1
9781,længe,0,0,1,1
9783,typique,0,0,1,1
9787,passing,0,0,1,1
9788,жаловался,0,0,1,1
9813,электронном,0,0,1,1
9814,hetgeen,0,0,1,1
9815,сумасшедшие»,0,0,1,1
9817,ameliorate,0,0,1,1
9818,பெரிதாக,0,0,1,1
9820,forskningsresultat,0,0,1,1
9822,रफ्तार,0,0,1,1
9824,बनायें,0,0,1,1
9825,yıkayacağım,0,0,1,1
9826,ಅನುಮತಿ,0,0,1,1
9827,overrasker,0,0,1,1
9828,வாருங்கள்,0,0,1,1
9829,méritos,0,0,1,1
9830,parametrar,0,0,1,1
9834,ensaísticos,0,0,1,1
9812,ಕೇಳುತ್ತೇನೆ,0,0,1,1
9809,അതോ,0,0,1,1
9808,ulteriores,0,0,1,1
9796,بغض,0,0,1,1
9789,complementary,0,0,1,1
9791,sağ,0,0,1,1
9792,dénotant,0,0,1,1
9793,parallèles,0,0,1,1
9794,வாரங்கள்,0,0,1,1
9795,العشاء,0,0,1,1
9797,кнопка,0,0,1,1
9806,мае,0,0,1,1
9798,الزمرد,0,0,1,1
9799,വീഡിയോയിലേക്ക്,0,0,1,1
9801,llevas,0,0,1,1
9802,ejército,0,0,1,1
9803,mirándola,0,0,1,1
9804,posts,0,0,1,1
9964,uitdrukking,0,0,1,1
9967,الانهيار,0,0,1,1
9041,criticano,1,1,0,1
10117,слове,0,0,1,1
10122,young,0,0,1,1
10123,sociobiologie,0,0,1,1
10125,cellular,0,0,1,1
10127,høj,0,0,1,1
10130,prediga,0,0,1,1
10131,bringe,0,0,1,1
10132,അറിയില്ലായിരുന്നു,0,0,1,1
10133,transclusion,0,0,1,1
10134,அனுபவத்தைப்,0,0,1,1
10137,المائة,0,0,1,1
10138,സ്പാനിഷ്,0,0,1,1
10139,ka •,0,0,1,1
10141,அறைக்குள்,0,0,1,1
10144,всеми,0,0,1,1
10147,pede,0,0,1,1
10121,blair,0,0,1,1
10116,namorado,0,0,1,1
10092,forstå,0,0,1,1
10115,regeln,0,0,1,1
10095,നോക്കാം,0,0,1,1
10096,விளைவைப்,0,0,1,1
10097,gebruikers,0,0,1,1
10099,frygtelige,0,0,1,1
10101,sécurisées,0,0,1,1
10102,loin,0,0,1,1
10103,ಅದರೊಂದಿಗೆ,0,0,1,1
10104,ಭ್ರಮನಿರಸನಗೊಂಡಿದ್ದೇನೆ,0,0,1,1
10105,प्रथम,0,0,1,1
10106,αποτυχίες,0,0,1,1
10107,biélorusse,0,0,1,1
10108,shared,0,0,1,1
10110,സ്യൂട്ടർമാർ,0,0,1,1
10111,conotação,0,0,1,1
10114,soup,0,0,1,1
10148,للتحرير،,0,0,1,1
10149,ಮಧ್ಯದಲ್ಲಿದ್ದೀರಿ,0,0,1,1
10151,verkeert,0,0,1,1
10152,मानक,0,0,1,1
10178,تشعر,0,0,1,1
10180,செய்துகொண்டிருந்தபோது,0,0,1,1
10182,detenerte,0,0,1,1
10184,авторских,0,0,1,1
10187,поймали,0,0,1,1
10189,konuşalım,0,0,1,1
10190,பயன்படுத்திக்,0,0,1,1
10191,telefonopkald,0,0,1,1
10192,ωραίο,0,0,1,1
10195,zoekresultaten,0,0,1,1
10196,قسم,0,0,1,1
10198,magtmisbrug,0,0,1,1
10199,miraban,0,0,1,1
10203,benämnda,0,0,1,1
10205,സംശയമില്ലാത്ത,0,0,1,1
10177,communauté »,0,0,1,1
10175,कॉफी,0,0,1,1
10174,ساعات,0,0,1,1
10161,quotidien,0,0,1,1
10153,uzaklaştılar,0,0,1,1
10156,കരയാൻ,0,0,1,1
10157,المربى,0,0,1,1
10158,presides,0,0,1,1
10159,aprieto,0,0,1,1
10160,abonnementsknappen,0,0,1,1
10162,périodes,0,0,1,1
10170,αγαπώ,0,0,1,1
10163,normalde,0,0,1,1
10164,نعود,0,0,1,1
10165,esszimmer,0,0,1,1
10166,какаято,0,0,1,1
10167,wikipediametadata,0,0,1,1
10168,ചെയ്യാനാവുന്ന,0,0,1,1
10094,دائم,0,0,1,1
10091,ഫിക്സ്,0,0,1,1
9968,ملاك,0,0,1,1
10001,ಮುಂದುವರಿಸಿ,0,0,1,1
10004,foregår,0,0,1,1
10005,üzerindeki,0,0,1,1
10006,contradictorias,0,0,1,1
10007,forumsnote,0,0,1,1
10008,sorprendida,0,0,1,1
10009,страну,0,0,1,1
10014,ಹುಡುಕುತ್ತಿದ್ದರೆ,0,0,1,1
10015,വാക്യങ്ങളെയും,0,0,1,1
10017,μάλλον,0,0,1,1
10018,സഹിക്കൂ,0,0,1,1
10022,brusca,0,0,1,1
10023,എന്തെങ്കിലുമൊക്കെ,0,0,1,1
10025,ഇഷ്ടമാണെന്ന്,0,0,1,1
10028,செருமானிய,0,0,1,1
10029,கேள்வி,0,0,1,1
10003,buildings,0,0,1,1
10000,വിവരിക്കുന്നതിനാലാണ്,0,0,1,1
10090,польского,0,0,1,1
9998,ağır,0,0,1,1
9969,hoes,0,0,1,1
9970,recovery,0,0,1,1
9972,ക്രിയേറ്റീവ്,0,0,1,1
9973,biologists,0,0,1,1
9975,приближается,0,0,1,1
9976,apontam,0,0,1,1
9977,sachez,0,0,1,1
9983,റഫറൻസ്,0,0,1,1
9987,армией,0,0,1,1
9988,صلة،,0,0,1,1
9989,funcionando,0,0,1,1
9991,വണ്ടി,0,0,1,1
9995,मेजबान,0,0,1,1
9996,süßen,0,0,1,1
9997,estágios,0,0,1,1
10030,lund,0,0,1,1
10032,आंकडे,0,0,1,1
10033,விஷயத்தைச்,0,0,1,1
10034,திருத்தல்,0,0,1,1
10067,atribuições,0,0,1,1
10068,स्थानीय,0,0,1,1
10070,mencionou,0,0,1,1
10071,finger,0,0,1,1
10073,bulsam,0,0,1,1
10074,ಬಿಟ್ಟಿದ್ದರೆ,0,0,1,1
10075,விஷயத்தில்,0,0,1,1
10076,comenta,0,0,1,1
10077,dilim,0,0,1,1
10078,ஓடினாள்,0,0,1,1
10081,besteden,0,0,1,1
10082,അമർത്തിക്കൊണ്ട്,0,0,1,1
10083,uppdatera,0,0,1,1
10085,النسبة,0,0,1,1
10087,αλάτι,0,0,1,1
10066,चूक,0,0,1,1
10065,oneetbaar,0,0,1,1
10064,personalized,0,0,1,1
10047,самоубийство,0,0,1,1
10035,arka,0,0,1,1
10036,laïque,0,0,1,1
10042,alweer,0,0,1,1
10043,बहुभाषी,0,0,1,1
10044,fueran,0,0,1,1
10045,محادثة؟,0,0,1,1
10048,determinación,0,0,1,1
10063,comblé,0,0,1,1
10049,vancouversystemet,0,0,1,1
10050,பெல்,0,0,1,1
10057,спрашивал,0,0,1,1
10060,руководством,0,0,1,1
10061,destinés,0,0,1,1
10062,webbvyn,0,0,1,1
9721,டிரைவ்வேயை,0,0,1,1
9720,barajaron,0,0,1,1
9719,köşedeki,0,0,1,1
9270,confinata,1,1,0,1
9275,posizionate,1,1,0,1
9276,costituirsi,1,1,0,1
9278,autopromozione,1,1,0,1
9283,salutarti,1,1,0,1
9284,dichiarati,1,1,0,1
9287,drastici,1,1,0,1
9288,assai,1,1,0,1
9292,raddoppiato,1,1,0,1
9294,classificandosi,1,1,0,1
9297,meccanicismo,1,1,0,1
9298,esposta,1,1,0,1
9300,mirava,1,1,0,1
9301,inizi,1,1,0,1
9308,elencate,1,1,0,1
9314,scaricabile,1,1,0,1
9273,finanziati,1,1,0,1
9268,faceva,1,1,0,1
9216,bilanciamento,1,1,0,1
9264,guardavano,1,1,0,1
9224,indispensabili,1,1,0,1
9225,idealismo,1,1,0,1
9228,strategicamente,1,1,0,1
9229,pubblicitariref,1,1,0,1
9232,democratici,1,1,0,1
9233,atmosferica,1,1,0,1
9234,domestici,1,1,0,1
9243,autoguidata,1,1,0,1
9249,tornerà,1,1,0,1
9250,trasparenza stiamo,1,1,0,1
9254,ottimistico,1,1,0,1
9255,scoraggiare,1,1,0,1
9259,nebulosa,1,1,0,1
9261,mediateca,1,1,0,1
9262,corollario,1,1,0,1
9315,licenziato,1,1,0,1
9318,prodotta,1,1,0,1
9320,linden,1,1,0,1
9321,probazioni,1,1,0,1
9355,riconosciuti,1,1,0,1
9356,decisi,1,1,0,1
9358,visitano,1,1,0,1
9361,sotterranea,1,1,0,1
9363,influenzando,1,1,0,1
9365,minuscolo,1,1,0,1
9369,verbosa,1,1,0,1
9370,pagate,1,1,0,1
9371,gelide,1,1,0,1
9372,chiusi,1,1,0,1
9374,guardiano,1,1,0,1
9378,wikipress,1,1,0,1
9380,comparato,1,1,0,1
9382,contrabbandata,1,1,0,1
9383,italiane,1,1,0,1
9353,chimici,1,1,0,1
9349,risponde,1,1,0,1
9347,razziste,1,1,0,1
9336,filiazioni,1,1,0,1
9322,familiari,1,1,0,1
9323,biforcati,1,1,0,1
9325,falde,1,1,0,1
9327,perquisizioni,1,1,0,1
9329,incentivo,1,1,0,1
9334,soprannominata,1,1,0,1
9338,richiamate,1,1,0,1
9346,impressioni,1,1,0,1
9339,esigenze,1,1,0,1
9341,autosufficiente,1,1,0,1
9342,compenso,1,1,0,1
9343,pericolo,1,1,0,1
9344,denominata,1,1,0,1
9345,scoppi,1,1,0,1
9218,qrpedia,1,1,0,1
9213,cognizione,1,1,0,1
9717,uppmärksammat,0,0,1,1
9088,pronte,1,1,0,1
9091,diagnostico,1,1,0,1
9092,placozoi,1,1,0,1
9093,mixozoi,1,1,0,1
9098,bibbia,1,1,0,1
9102,fallì,1,1,0,1
9103,nordest,1,1,0,1
9104,apparisse,1,1,0,1
9107,qualifichiamo,1,1,0,1
9108,ovvia,1,1,0,1
9109,vederlo,1,1,0,1
9110,attorno,1,1,0,1
9111,riservata,1,1,0,1
9112,migliorarlo,1,1,0,1
9113,innumerevoli,1,1,0,1
9116,ricavata,1,1,0,1
9089,imprecisione,1,1,0,1
9087,offrendo,1,1,0,1
9212,geotecnica,1,1,0,1
9084,diventasse,1,1,0,1
9051,preferendo,1,1,0,1
9058,detenne,1,1,0,1
9060,citino,1,1,0,1
9061,probabilistiche,1,1,0,1
9063,rumorose,1,1,0,1
9064,stupendi,1,1,0,1
9065,gemello,1,1,0,1
9068,creazionista,1,1,0,1
9070,provocano,1,1,0,1
9071,specialistici,1,1,0,1
9073,patogeni,1,1,0,1
9074,sollevate,1,1,0,1
9075,funzionando,1,1,0,1
9079,dorata,1,1,0,1
9080,uh,1,1,0,1
9117,integrate,1,1,0,1
9118,adottano,1,1,0,1
9123,interviene,1,1,0,1
9126,affermò,1,1,0,1
9166,wc,1,1,0,1
9167,abitualmente,1,1,0,1
9169,fastidio,1,1,0,1
9172,soddisfacente,1,1,0,1
9177,modificarne,1,1,0,1
9179,pongono,1,1,0,1
9181,tecnologicamente,1,1,0,1
9187,aggiornamento di,1,1,0,1
9189,wikivoyages,1,1,0,1
9192,ingegnere,1,1,0,1
9194,annunciare,1,1,0,1
9195,piatti,1,1,0,1
9197,fondato,1,1,0,1
9204,divertimento,1,1,0,1
9210,reperibile,1,1,0,1
9164,appelli,1,1,0,1
9163,predetto,1,1,0,1
9162,gratuitai,1,1,0,1
9142,governative,1,1,0,1
9127,innovazioni,1,1,0,1
9129,carriera»,1,1,0,1
9130,imprevisti,1,1,0,1
9133,installazioni,1,1,0,1
9134,dimostrazione,1,1,0,1
9139,stanziato,1,1,0,1
9143,convissuto,1,1,0,1
9157,estraggono,1,1,0,1
9148,extrasolari,1,1,0,1
9149,connessionisti,1,1,0,1
9150,asse,1,1,0,1
9151,trattazione,1,1,0,1
9153,animati,1,1,0,1
9154,—non,1,1,0,1
9384,supermercato,1,1,0,1
9385,incomprensibile,1,1,0,1
9386,direttive,1,1,0,1
9608,estesi,1,1,0,1
9610,costituivano,1,1,0,1
9611,banche,1,1,0,1
9612,cominciando,1,1,0,1
9616,cartoni,1,1,0,1
9621,implicite,1,1,0,1
9622,fittizia,1,1,0,1
9623,primato,1,1,0,1
9625,redazionali,1,1,0,1
9627,multistrato,1,1,0,1
9628,ingiunzione,1,1,0,1
9632,doncossack,1,1,0,1
9637,inflitte,1,1,0,1
9639,lanciare,1,1,0,1
9642,immunitari,1,1,0,1
9646,venire,1,1,0,1
9609,insegna,1,1,0,1
9605,vandaliche,1,1,0,1
9387,inesistente,1,1,0,1
9604,avventure,1,1,0,1
9569,ricoprono,1,1,0,1
9570,contare,1,1,0,1
9571,praticando,1,1,0,1
9575,sostituzioni,1,1,0,1
9582,esporre,1,1,0,1
9583,sofferto,1,1,0,1
9584,richiese,1,1,0,1
9586,raccogliessero,1,1,0,1
9587,fregatura,1,1,0,1
9588,attestata,1,1,0,1
9589,fuorilegge,1,1,0,1
9590,adattabili,1,1,0,1
9591,riparati,1,1,0,1
9601,maldonado,1,1,0,1
9602,biblica,1,1,0,1
9647,completare,1,1,0,1
9650,rifiutava,1,1,0,1
9655,ricevono,1,1,0,1
9658,miscuglio,1,1,0,1
9692,языковыми,0,0,1,1
9695,ستريت,0,0,1,1
9697,caption,0,0,1,1
9698,«энциклопедия»,0,0,1,1
9700,taskspecific,0,0,1,1
9701,vain »,0,0,1,1
9702,провести,0,0,1,1
9703,ссылку,0,0,1,1
9704,bilen,0,0,1,1
9708,ofensiva,0,0,1,1
9710,വിളിച്ചു,0,0,1,1
9711,டைம்,0,0,1,1
9713,artificiel ,0,0,1,1
9714,βοήθεια,0,0,1,1
9715,чихнул,0,0,1,1
9690,पर्यटन,0,0,1,1
9689,ويعتمد,0,0,1,1
9688,марка,0,0,1,1
9676,atlamamın,0,0,1,1
9664,facciano,1,1,0,1
9665,revisori,1,1,0,1
9669,diventeranno,1,1,0,1
9672,अद्यतन,0,0,1,1
9674,gepubliceerd,0,0,1,1
9675,viajaban,0,0,1,1
9677,എന്നൊക്കെ,0,0,1,1
9686,diagnose,0,0,1,1
9678,« encyclopédie »,0,0,1,1
9679,dørs,0,0,1,1
9680,φυλακισμένοι,0,0,1,1
9681,oldun,0,0,1,1
9684,மூழ்கிவிடுவார்கள்,0,0,1,1
9685,bekendmaken,0,0,1,1
9565,israele,1,1,0,1
9563,sinergie,1,1,0,1
9561,cailliau,1,1,0,1
9480,salmi,1,1,0,1
9430,giornale—,1,1,0,1
9433,concepita,1,1,0,1
9435,dotare,1,1,0,1
9438,civilizzato,1,1,0,1
9441,difenderci,1,1,0,1
9443,incaricato,1,1,0,1
9444,caotico,1,1,0,1
9454,inondazione,1,1,0,1
9455,optato,1,1,0,1
9457,aggiorna,1,1,0,1
9458,spugne,1,1,0,1
9464,incisa,1,1,0,1
9465,ottimizzare,1,1,0,1
9469,leggibili,1,1,0,1
9470,ribattendo,1,1,0,1
9429,faziosi,1,1,0,1
9428,marea,1,1,0,1
9427,pagato,1,1,0,1
9398,circostanze,1,1,0,1
9388,immutabili,1,1,0,1
9389,ricomincerai,1,1,0,1
9390,definisca,1,1,0,1
9393,islandese,1,1,0,1
9394,danneggiato,1,1,0,1
9397,rappresentante,1,1,0,1
9401,attualità»,1,1,0,1
9424,lamentandosi,1,1,0,1
9407,bacini,1,1,0,1
9408,rating,1,1,0,1
9416,trasformazioni,1,1,0,1
9418,tornado,1,1,0,1
9419,mappando,1,1,0,1
9421,manualmente,1,1,0,1
9475,continuità,1,1,0,1
9481,conterrà,1,1,0,1
9560,giapponesi,1,1,0,1
9482,analizza,1,1,0,1
9534,laboriosa,1,1,0,1
9536,​​un,1,1,0,1
9537,dighe,1,1,0,1
9541,preoccupante,1,1,0,1
9542,valuta,1,1,0,1
9544,dirigono,1,1,0,1
9546,sostituirà,1,1,0,1
9548,cattolici,1,1,0,1
9549,notare,1,1,0,1
9551,parodiano,1,1,0,1
9552,brace,1,1,0,1
9553,fioritura,1,1,0,1
9556,indesiderate,1,1,0,1
9558,infrastruttura,1,1,0,1
9559,giornalistici,1,1,0,1
9532,quanti,1,1,0,1
9531,dominavano,1,1,0,1
9529,sassonia,1,1,0,1
9502,moto,1,1,0,1
9485,sconvolta,1,1,0,1
9490,interrompere,1,1,0,1
9491,suggerimento,1,1,0,1
9494,vitali,1,1,0,1
9497,wikipediameta,1,1,0,1
9500,comunicato,1,1,0,1
9503,istruiti,1,1,0,1
9528,filippino,1,1,0,1
9506,gennaio aggiornamento,1,1,0,1
9511,genesi,1,1,0,1
9514,bersaglio,1,1,0,1
9518,istante,1,1,0,1
9521,ereditabili,1,1,0,1
9522,biomedica,1,1,0,1
10206,fund,0,0,1,1
10207,wurden,0,0,1,1
10208,بالإصدارات,0,0,1,1
10819,ഇഷ്ടമാണ്,0,0,1,1
10822,archive,0,0,1,1
10823,anzurufen,0,0,1,1
10825,rétribution,0,0,1,1
10826,laboratories,0,0,1,1
10827,الكلام,0,0,1,1
10828,λεξικού,0,0,1,1
10829,estranhos,0,0,1,1
10831,dorpje,0,0,1,1
10833,والسلوك,0,0,1,1
10834,partialité,0,0,1,1
10835,ലക്ഷക്കണക്കിന്,0,0,1,1
10836,genererat,0,0,1,1
10837,தகுதியானவள்,0,0,1,1
10838,അർ‌ത്ഥമാക്കുന്നു,0,0,1,1
10839,implicações,0,0,1,1
10821,représentant,0,0,1,1
10817,принца,0,0,1,1
10782,ulsfo,0,0,1,1
10812,equidad,0,0,1,1
10785,abriter,0,0,1,1
10786,ineffektivt,0,0,1,1
10790,самостоятельно,0,0,1,1
10792,engeller,0,0,1,1
10793,durak,0,0,1,1
10794,irishtimescom​​,0,0,1,1
10795,выходящие,0,0,1,1
10796,ഒച്ചയുടെ,0,0,1,1
10797,ಮುಖದ,0,0,1,1
10803,delstaten,0,0,1,1
10804,придерживаясь,0,0,1,1
10805,மாற்றினாள்,0,0,1,1
10806,يتعلق,0,0,1,1
10809,உள்ளுணர்வைக்,0,0,1,1
10811,وربما,0,0,1,1
10841,स्कोलरपीडिया,0,0,1,1
10842,النباتات,0,0,1,1
10844,познакомиться,0,0,1,1
10845,ದಾಟುತ್ತೀರಿ,0,0,1,1
10878,magnetic,0,0,1,1
10879,gern,0,0,1,1
10880,μεγαλύτερο,0,0,1,1
10883,"w
कैटलन",0,0,1,1
10884,иной,0,0,1,1
10885, €,0,0,1,1
10886,gale,0,0,1,1
10888,हित,0,0,1,1
10889,поставив,0,0,1,1
10890,تحلم,0,0,1,1
10891,صديقين,0,0,1,1
10892,sende,0,0,1,1
10895,വിവേകം,0,0,1,1
10896,ಉತ್ತಮವಾಗಿರುತ್ತದೆ,0,0,1,1
10897,autorisations,0,0,1,1
10877,privado,0,0,1,1
10876,തിരുത്തുകൾ,0,0,1,1
10875,rechazado,0,0,1,1
10858,ειλικρινά,0,0,1,1
10846,alterou,0,0,1,1
10850,उठाया,0,0,1,1
10851,ألف,0,0,1,1
10853,apporté,0,0,1,1
10854,خدمة,0,0,1,1
10857,glace,0,0,1,1
10859,സ്ഥാനമാണ്,0,0,1,1
10874,textbooks,0,0,1,1
10862,stuff,0,0,1,1
10863,പതാകവാഹക,0,0,1,1
10864,يتقاضون,0,0,1,1
10866,certainty,0,0,1,1
10870,ceden,0,0,1,1
10871,magnifikt,0,0,1,1
10784,يفوق,0,0,1,1
10776,donzelas,0,0,1,1
10675,запустил,0,0,1,1
10699,aiit’s,0,0,1,1
10703,إيجابيًا,0,0,1,1
10705,terk,0,0,1,1
10706,حفلة,0,0,1,1
10709,विद्वानों,0,0,1,1
10710,सुनाया,0,0,1,1
10711,multinacionales,0,0,1,1
10712,വിലയില്ല,0,0,1,1
10715,colaboran,0,0,1,1
10716,придумана,0,0,1,1
10717,modsatte,0,0,1,1
10718,alto،,0,0,1,1
10719,definen,0,0,1,1
10720,vidéos etc,0,0,1,1
10721,ನೋಡುತ್ತಿರುವಿರಿ,0,0,1,1
10724,interpretations,0,0,1,1
10700,persist,0,0,1,1
10698,தீவிரமாக,0,0,1,1
10774,വീഡിയോയുടെ,0,0,1,1
10697,स्थिर,0,0,1,1
10678,написание,0,0,1,1
10680,kaldırılmasının,0,0,1,1
10681,väluppfostrad,0,0,1,1
10683,ongeluk,0,0,1,1
10684,unverifiable,0,0,1,1
10685,kaydını,0,0,1,1
10686,परिचय,0,0,1,1
10687,कानूनों,0,0,1,1
10689,المستخدمة,0,0,1,1
10690,मीठा,0,0,1,1
10692,gl •,0,0,1,1
10693,invisibles »,0,0,1,1
10694,télévisé,0,0,1,1
10695,والعينات,0,0,1,1
10696,سكور,0,0,1,1
10725,greenhouse,0,0,1,1
10726,garantir,0,0,1,1
10727,compétitif,0,0,1,1
10728,compensations,0,0,1,1
10757,помогает,0,0,1,1
10758,concernées,0,0,1,1
10759,“death,0,0,1,1
10760,parentheses,0,0,1,1
10761,ഇഫക്റ്റ്,0,0,1,1
10762,ചെയ്യാനും,0,0,1,1
10763,prejudices,0,0,1,1
10764,mediawikiprogramvaran,0,0,1,1
10766,static,0,0,1,1
10767,يشعر,0,0,1,1
10768,acelerado,0,0,1,1
10770,مكالمة,0,0,1,1
10771,كونغرس,0,0,1,1
10772,எல்லாக்,0,0,1,1
10773,afectados,0,0,1,1
10755,en •,0,0,1,1
10754,convenient,0,0,1,1
10752,titlen,0,0,1,1
10741,gewonnen,0,0,1,1
10730,الصينية,0,0,1,1
10733,மூளைச்சலவை,0,0,1,1
10734,passages,0,0,1,1
10736,ickevetenskaplig,0,0,1,1
10738,desenhos,0,0,1,1
10740,கேட்கிறீர்களா,0,0,1,1
10742,deemed,0,0,1,1
10751,ತಿಳಿದಿದೆಯೇ,0,0,1,1
10743,debería,0,0,1,1
10744,رحلتك,0,0,1,1
10745,someten,0,0,1,1
10746,conversatie,0,0,1,1
10747,ലേഖനത്തിനും,0,0,1,1
10749,berörde,0,0,1,1
10898,conferencista,0,0,1,1
10899,رسم,0,0,1,1
10900,ಟೀಕಿಸಿ,0,0,1,1
11040,«астероид,0,0,1,1
11042,ಅಹಂಕಾರಿ,0,0,1,1
11044,opérationnellement,0,0,1,1
11046,"
ब्रिटन",0,0,1,1
11047,nelerdir,0,0,1,1
11048,بنظرة,0,0,1,1
11049,personagem,0,0,1,1
11050,bereit,0,0,1,1
11052,مرت,0,0,1,1
11053,adieux,0,0,1,1
11054,заметьте,0,0,1,1
11055,анонимными,0,0,1,1
11056,γεωμετρία,0,0,1,1
11058,avoided,0,0,1,1
11063,yakut,0,0,1,1
11064,göras,0,0,1,1
11041,simplifier,0,0,1,1
11038,конференциях,0,0,1,1
10901,воздействий,0,0,1,1
11037,representadas,0,0,1,1
11016,autorisés,0,0,1,1
11017,مختلفين,0,0,1,1
11019,критерии,0,0,1,1
11020,பதிப்பொன்றை,0,0,1,1
11021,kullandığında,0,0,1,1
11023,meşgulüm,0,0,1,1
11025,لمعرفة,0,0,1,1
11026,ودقتها,0,0,1,1
11027,presione,0,0,1,1
11029,பதிலளிக்குமுகமாக,0,0,1,1
11030,ಕೇಳಬಹುದಾದ,0,0,1,1
11032,മറ്റുള്ളവർക്ക്,0,0,1,1
11034,ищем,0,0,1,1
11035,частому,0,0,1,1
11036,حسنا,0,0,1,1
11065,செய்வதைத்,0,0,1,1
11068,ведомств,0,0,1,1
11070,mahoma,0,0,1,1
11071,ποτό,0,0,1,1
11107,"
क्या",0,0,1,1
11110,பார்ப்பது,0,0,1,1
11111,அடையச்,0,0,1,1
11113,fallecimiento,0,0,1,1
11114,bag,0,0,1,1
11115,tratamento,0,0,1,1
11117,سياسة,0,0,1,1
11118,информацию»,0,0,1,1
11119,yapmadan,0,0,1,1
11123,حالك,0,0,1,1
11124,எடுத்துக்காட்டில்,0,0,1,1
11130,पाठकों,0,0,1,1
11131,ಸೂಕ್ತವಾಗಿದೆ,0,0,1,1
11133,പ്രതിബിംബത്തിൽ,0,0,1,1
11135,γραφής,0,0,1,1
11106,capturar,0,0,1,1
11104,desktops,0,0,1,1
11102,dijeron,0,0,1,1
11084,flaws,0,0,1,1
11072,പഠന,0,0,1,1
11073,عيوب,0,0,1,1
11076,soffa,0,0,1,1
11077,threefold,0,0,1,1
11078,verschil,0,0,1,1
11081,стоило,0,0,1,1
11085,força,0,0,1,1
11101,¿sabrías,0,0,1,1
11088,sevdiğin,0,0,1,1
11089,ಹೇಳಬಹುದೇ,0,0,1,1
11094,glauben,0,0,1,1
11097,extensive,0,0,1,1
11099,отличный,0,0,1,1
11100,aktad,0,0,1,1
11015,paródia,0,0,1,1
11014,relegada,0,0,1,1
11013,விரைவு,0,0,1,1
10963,வார்த்தைகளில்,0,0,1,1
10935,collaboratifs,0,0,1,1
10937,episkt,0,0,1,1
10938,hitwise,0,0,1,1
10939,ಹೊಳಪುಳ್ಳವನಾಗಿದ್ದಾನೆ,0,0,1,1
10943,ഇരുപതിനായിരം,0,0,1,1
10944,углы»,0,0,1,1
10945,modereras,0,0,1,1
10948,datasets,0,0,1,1
10949,applicable,0,0,1,1
10950,அழாதபடி,0,0,1,1
10951,νύχτα,0,0,1,1
10952,ричарда,0,0,1,1
10953,relevé,0,0,1,1
10954,«bibliotecario»,0,0,1,1
10955,obscurs,0,0,1,1
10934,francepresse,0,0,1,1
10932,robot—,0,0,1,1
10931,كثيرين,0,0,1,1
10912,ಮೂಗು,0,0,1,1
10903,أسوأ,0,0,1,1
10904,afi ˌwɪkiˈpiːdiə,0,0,1,1
10907,ഉണ്ടായിരിക്കണമെന്ന്,0,0,1,1
10908,  cdrom,0,0,1,1
10909,peinture,0,0,1,1
10911,außergewöhnlich,0,0,1,1
10913,främställs,0,0,1,1
10925,spare,0,0,1,1
10914,مكتوبة,0,0,1,1
10917,uncultivated,0,0,1,1
10918,घोषणा,0,0,1,1
10919,escolas,0,0,1,1
10920,donnant,0,0,1,1
10921,മുഴുവനും,0,0,1,1
10962,épique,0,0,1,1
10966,drin,0,0,1,1
11012,എന്നതിൽ,0,0,1,1
10967,ക്യാൻസർ,0,0,1,1
10993,sansade,0,0,1,1
10994,أربع,0,0,1,1
10995,अंग्रेजीभाषा,0,0,1,1
10996,सौभाग्य।,0,0,1,1
10997,provocó,0,0,1,1
10998,tarihin,0,0,1,1
10999,riktiga,0,0,1,1
11000,molecule,0,0,1,1
11001,filled,0,0,1,1
11004,நகைச்சுவையைச்,0,0,1,1
11006,تعطلت,0,0,1,1
11007,allesomvattende,0,0,1,1
11008,رأيت,0,0,1,1
11009,grafías,0,0,1,1
11010,библиотеки»,0,0,1,1
10992,вернулась,0,0,1,1
10990,arkivera,0,0,1,1
10989,kapıdan,0,0,1,1
10975,والاستفادة,0,0,1,1
10968,അമ്മയ്‌ക്കായി,0,0,1,1
10969,narret,0,0,1,1
10970,கட்டுரையொன்றில்,0,0,1,1
10971,связывают,0,0,1,1
10973,അസ്വസ്ഥനാണ്,0,0,1,1
10974,gemeenschap,0,0,1,1
10976,മൂന്നുപേരും,0,0,1,1
10988,уроните,0,0,1,1
10977,правильной,0,0,1,1
10978,winkten,0,0,1,1
10979,ಹಾದುಹೋಗಬಹುದು,0,0,1,1
10982,гораздо,0,0,1,1
10985,மூன்றாம்,0,0,1,1
10987,बैठी,0,0,1,1
10676,erhvervserfaring,0,0,1,1
10671,प्रविष्टियाॅं,0,0,1,1
10209,வளர்ந்தது,0,0,1,1
10363,bokkapitlet,0,0,1,1
10369,espera,0,0,1,1
10370,aufzupassen,0,0,1,1
10371,citada,0,0,1,1
10374,universitários,0,0,1,1
10375,ansvarig,0,0,1,1
10377,أشغال,0,0,1,1
10378,استخراج,0,0,1,1
10379,практики,0,0,1,1
10381,высмеивают,0,0,1,1
10382,wapediatjänsten,0,0,1,1
10384,शाम,0,0,1,1
10388,antivandal,0,0,1,1
10394,"
तुर्कमैनी",0,0,1,1
10395,அளவுத்திட்டத்துக்கு,0,0,1,1
10396,desmentida,0,0,1,1
10365,ಬೃಹತ್,0,0,1,1
10362,modificables,0,0,1,1
10332,lenguaje,0,0,1,1
10361,включаемых,0,0,1,1
10337,സംസ്കാരത്തെപ്പറ്റിയുമൊക്കെയുള്ള,0,0,1,1
10339,tolerance,0,0,1,1
10341,песнях,0,0,1,1
10342,bekendste,0,0,1,1
10343,ஆண்டுகள்,0,0,1,1
10344,injokes,0,0,1,1
10345,freely,0,0,1,1
10347,geléias,0,0,1,1
10349,الأحوال,0,0,1,1
10351,saisie,0,0,1,1
10352,tryckt,0,0,1,1
10354,தேவதையைப்,0,0,1,1
10356,lacked,0,0,1,1
10357,inc —,0,0,1,1
10359,இன்றுவரை,0,0,1,1
10397,ediyorlarmış,0,0,1,1
10398,несогласия,0,0,1,1
10401,остановить»,0,0,1,1
10402,संगठित,0,0,1,1
10428,organisaties,0,0,1,1
10429,βικιθήκη,0,0,1,1
10431,fundado,0,0,1,1
10432,करूँगा,0,0,1,1
10433,nearperfect,0,0,1,1
10434,सिर,0,0,1,1
10435,christianisme,0,0,1,1
10436,пользователями,0,0,1,1
10439,എഴുതാവുന്ന,0,0,1,1
10440,важнее,0,0,1,1
10441,parsemé,0,0,1,1
10442,contradictory,0,0,1,1
10445,credentials,0,0,1,1
10446,расскажи,0,0,1,1
10448,risos,0,0,1,1
10426,pestaña,0,0,1,1
10425,killen,0,0,1,1
10423,tercümesi,0,0,1,1
10412,« jouer »,0,0,1,1
10403,afspreken,0,0,1,1
10406,souberem,0,0,1,1
10407,സ്വപ്നമാണെന്നും,0,0,1,1
10408,चांदी,0,0,1,1
10410,معروفًا,0,0,1,1
10411,svälter,0,0,1,1
10414,σύζυγος,0,0,1,1
10422,centrase,0,0,1,1
10415,эксперименты,0,0,1,1
10416,riktat,0,0,1,1
10418,discourages,0,0,1,1
10419,എല്ലാവർക്കും,0,0,1,1
10420,kültürde,0,0,1,1
10421,thoughts,0,0,1,1
10336,شهريًا,0,0,1,1
10328,മലയാളികളാണ്,0,0,1,1
10670,tyvärr,0,0,1,1
10237,adorerais,0,0,1,1
10240,kritische,0,0,1,1
10241,vagueness,0,0,1,1
10244,"
लिंगला",0,0,1,1
10245,пять,0,0,1,1
10248,العشوائي,0,0,1,1
10249,associada,0,0,1,1
10250,kopiëren,0,0,1,1
10252,நல்லவர்களாக,0,0,1,1
10253,विकिकोटे,0,0,1,1
10254,thermally,0,0,1,1
10256,борисом,0,0,1,1
10259,കഴിക്കൂ,0,0,1,1
10260,தூக்கத்தில்,0,0,1,1
10261,подчинённых,0,0,1,1
10262,നായ,0,0,1,1
10238,пойти,0,0,1,1
10236,главным,0,0,1,1
10327,trademark,0,0,1,1
10233,தாக்கத்தை,0,0,1,1
10210,സഞ്ചി,0,0,1,1
10211,എല്ലിക്കും,0,0,1,1
10212,принципе,0,0,1,1
10214,formeel,0,0,1,1
10215,ಕೂಡಿದೆ,0,0,1,1
10216,കാത്തിരിക്കാൻ,0,0,1,1
10218,disque,0,0,1,1
10219,الهوية,0,0,1,1
10222,tratava,0,0,1,1
10223,низкие,0,0,1,1
10225,മനസ്സിലായില്ല,0,0,1,1
10228,ഇല്ലഅവലംബം,0,0,1,1
10229,cumplimiento,0,0,1,1
10231,afuera,0,0,1,1
10232,ακόμα,0,0,1,1
10264,മനസ്സിലാക്കേണ്ടതെല്ലാം,0,0,1,1
10267,télévisée,0,0,1,1
10268,نسبيًا,0,0,1,1
10270,المتدلية,0,0,1,1
10303,требуется,0,0,1,1
10304,مدهش,0,0,1,1
10305,مساهمين,0,0,1,1
10306,wovon,0,0,1,1
10310,costume,0,0,1,1
10311,καλής,0,0,1,1
10312,desacordos,0,0,1,1
10313,وتحمل,0,0,1,1
10315,californien,0,0,1,1
10316,klædt,0,0,1,1
10318,ഉരുളക്കിഴങ്ങ്,0,0,1,1
10319,सी,0,0,1,1
10322,затопление,0,0,1,1
10323,tillåts,0,0,1,1
10324,σπασμένη,0,0,1,1
10300,вялыми,0,0,1,1
10299,balanced,0,0,1,1
10297,crazy,0,0,1,1
10283,hybrides,0,0,1,1
10273,bibliotekarien,0,0,1,1
10275,കണക്കാക്കാം,0,0,1,1
10278,உச்சரிக்கிறீர்கள்,0,0,1,1
10280,articles ,0,0,1,1
10281,hävdar,0,0,1,1
10282,திகைத்துப்,0,0,1,1
10284,ಮಾಡಿದ್ದರೆ,0,0,1,1
10294,eventuele,0,0,1,1
10285,absurd,0,0,1,1
10286,скрестите,0,0,1,1
10288,വിവരണ,0,0,1,1
10290,totalement,0,0,1,1
10291,برنامجه،,0,0,1,1
10293,minor,0,0,1,1
10450,ассоциации,0,0,1,1
10452,недостоверная,0,0,1,1
10454,കൂടെ,0,0,1,1
10595,blanding,0,0,1,1
10597,ender,0,0,1,1
10598,kararının,0,0,1,1
10599,campos,0,0,1,1
10600,hardnekkiger,0,0,1,1
10602,yaşamınızda,0,0,1,1
10603,dispyter,0,0,1,1
10604,ஆவண,0,0,1,1
10607,yaptıysanız,0,0,1,1
10608,introduite,0,0,1,1
10609,وتذكر,0,0,1,1
10610,ತಿಳಿದಿದೆಯೆ,0,0,1,1
10611,أضع,0,0,1,1
10612,complementos,0,0,1,1
10613,asian,0,0,1,1
10616,मिनटों,0,0,1,1
10596,"
अन्तरभाषिक",0,0,1,1
10594,arreglado,0,0,1,1
10455,ولاحقًا,0,0,1,1
10593,الزيارات,0,0,1,1
10569,etablerad,0,0,1,1
10570,yazılanın,0,0,1,1
10571,üretilen,0,0,1,1
10576,функционал,0,0,1,1
10577,leraar,0,0,1,1
10578,redigerat,0,0,1,1
10583,அம்மாவுக்குத்,0,0,1,1
10584,contribuído,0,0,1,1
10585,ನೋಡದಿದ್ದಾಗ,0,0,1,1
10586,التباطؤ,0,0,1,1
10588,escándalos,0,0,1,1
10589,φιλικό,0,0,1,1
10590,имеющей,0,0,1,1
10591,afrique,0,0,1,1
10592,δουλέψεις,0,0,1,1
10617,contrastes,0,0,1,1
10618,protegida,0,0,1,1
10619,ritter,0,0,1,1
10622,आयी,0,0,1,1
10649,städer,0,0,1,1
10650,انطلقت,0,0,1,1
10654,முயற்சிகள்,0,0,1,1
10655,интерфейсы,0,0,1,1
10656,സ്രോതസ്സ്,0,0,1,1
10657,латинский,0,0,1,1
10658,mystère,0,0,1,1
10659,aprobado,0,0,1,1
10662,ta •,0,0,1,1
10663,മാന്യമായി,0,0,1,1
10664,categorización,0,0,1,1
10665,adım,0,0,1,1
10667,അനുവദിക്കുന്നുണ്ട്,0,0,1,1
10668,വ്യക്തിപരമായി,0,0,1,1
10669,एडिटरइनचीफ,0,0,1,1
10648,samarbetar,0,0,1,1
10646,organismo,0,0,1,1
10645,συγχωρείς,0,0,1,1
10634,പ്രവർത്തകരെ,0,0,1,1
10623,spids,0,0,1,1
10624,inelegant,0,0,1,1
10625,धमकी,0,0,1,1
10626,प्रतियोगिता,0,0,1,1
10627,çaba,0,0,1,1
10631,visions,0,0,1,1
10635,homogeneizando,0,0,1,1
10644,pedestrian,0,0,1,1
10636,रैंक,0,0,1,1
10637,സ്ഥലത്തെ,0,0,1,1
10638,أخت,0,0,1,1
10639,motsvarar,0,0,1,1
10641,tepeden,0,0,1,1
10642,ആവശ്യമില്ലെങ്കിൽ,0,0,1,1
10567,ടെസ്റ്റിൽ‌,0,0,1,1
10566,craintes,0,0,1,1
10565,hazreti,0,0,1,1
10509,уходить,0,0,1,1
10484,مهلا,0,0,1,1
10488,تحولت,0,0,1,1
10489,wind,0,0,1,1
10491,എന്നതൊക്കെ,0,0,1,1
10492,identifiées,0,0,1,1
10495,independientes,0,0,1,1
10496,ഏക,0,0,1,1
10497,kafasına,0,0,1,1
10500,நுழைந்தால்,0,0,1,1
10501,listada,0,0,1,1
10503,prestigiosas,0,0,1,1
10504,tridimensional,0,0,1,1
10505,personnalité,0,0,1,1
10506,опубликовал,0,0,1,1
10507,ലേഖകരും,0,0,1,1
10483,υγρότοπου,0,0,1,1
10482,"
आयरिश",0,0,1,1
10481,നല്ലവനാണ്,0,0,1,1
10464,മെല്ലിയോടും,0,0,1,1
10456,türkiye’den,0,0,1,1
10457,правилам,0,0,1,1
10460,quería,0,0,1,1
10461,डाला,0,0,1,1
10462,unuturlar,0,0,1,1
10463,പുഞ്ചിരി,0,0,1,1
10466,गैरविकिपीडिया,0,0,1,1
10478,администрированию,0,0,1,1
10469,« good,0,0,1,1
10470,ലേഖകരുടെ,0,0,1,1
10471,«todo,0,0,1,1
10474,sobrecargas,0,0,1,1
10476,என்றும்,0,0,1,1
10477,يأتون,0,0,1,1
10508,ಪ್ರಯಾಣದ,0,0,1,1
10511,ودفعت,0,0,1,1
10564,rodríguez,0,0,1,1
10512,enforce,0,0,1,1
10540,നാർസിസയും,0,0,1,1
10541,ridende,0,0,1,1
10542,கண்ணியமான,0,0,1,1
10543,തർക്ക,0,0,1,1
10544,wikipédien,0,0,1,1
10546,gangen,0,0,1,1
10548,referenser,0,0,1,1
10549,принцип,0,0,1,1
10553,consistera,0,0,1,1
10554,planerar,0,0,1,1
10555,рубинов,0,0,1,1
10556,ağlamak,0,0,1,1
10558,bumped,0,0,1,1
10560,जानेमन,0,0,1,1
10562,بالو,0,0,1,1
10539,owners,0,0,1,1
10538,مقترحين,0,0,1,1
10536,சுதந்திரமாக,0,0,1,1
10525,μιλήσουμε,0,0,1,1
10514,ಲೈಕ್,0,0,1,1
10515,"
cantonês",0,0,1,1
10518,blockerar,0,0,1,1
10520,έπεσε,0,0,1,1
10522,personas​​,0,0,1,1
10523,lived,0,0,1,1
10526,uppfarten,0,0,1,1
10534,gisteravond,0,0,1,1
10527,выполнять,0,0,1,1
10528,للتخلص,0,0,1,1
10530,dikes,0,0,1,1
10531,assertions,0,0,1,1
10532,ഉണ്ടായിരുന്നുവെന്ന്,0,0,1,1
10533,رئيس,0,0,1,1
9047,indicarne,1,1,0,1
9040,insoliti,1,1,0,1
5953,faremmo,1,1,0,1
6929,concludendo,1,1,0,1
6932,tradizioni,1,1,0,1
6934,disegnato,1,1,0,1
6936,rivendicazione,1,1,0,1
6937,porterebbe,1,1,0,1
6940,censurata,1,1,0,1
6944,diffonde,1,1,0,1
6953,puntare,1,1,0,1
6957,tarda,1,1,0,1
6961,computazionalmente,1,1,0,1
6963,fabbricati,1,1,0,1
6968,sensazione,1,1,0,1
6970,ritorna,1,1,0,1
6971,evoluzioni,1,1,0,1
6978,biotica,1,1,0,1
6980,regimi,1,1,0,1
6931,immagazzinata,1,1,0,1
6922,nascano,1,1,0,1
6866,producono,1,1,0,1
6921,ingenuamente,1,1,0,1
6870,ridisegnato,1,1,0,1
6872,istantanea,1,1,0,1
6874,contribuzione,1,1,0,1
6875,storie,1,1,0,1
6884,inclusiref,1,1,0,1
6885,multilineare,1,1,0,1
6887,cifrato,1,1,0,1
6890,spensierata,1,1,0,1
6893,abbandonata,1,1,0,1
6897,climatica,1,1,0,1
6899,beneficiano,1,1,0,1
6900,noiosi,1,1,0,1
6902,cedette,1,1,0,1
6904,figurano,1,1,0,1
6910,apetta,1,1,0,1
6997,doveri,1,1,0,1
7000,coinvolgono,1,1,0,1
7003,connotazione,1,1,0,1
7005,guidare,1,1,0,1
7061,ampi,1,1,0,1
7064, sono,1,1,0,1
7065,facessimo,1,1,0,1
7067,spigoli,1,1,0,1
7068,decentralizzando,1,1,0,1
7075,riconducibili,1,1,0,1
7078,olocene,1,1,0,1
7082,vedono,1,1,0,1
7088,volumi—,1,1,0,1
7090,apposti,1,1,0,1
7099,responsabilità”,1,1,0,1
7100,qualificati,1,1,0,1
7101,scesa,1,1,0,1
7102,aborigene,1,1,0,1
7104,fiorire,1,1,0,1
7060,infinita,1,1,0,1
7056,sii,1,1,0,1
7055,capisci,1,1,0,1
7018,predittivi,1,1,0,1
7006,provocate,1,1,0,1
7009,telespettatori,1,1,0,1
7012,membro»,1,1,0,1
7013,sottogruppi,1,1,0,1
7014,falliranno,1,1,0,1
7015,mondo—,1,1,0,1
7028,resta,1,1,0,1
7054,campionato,1,1,0,1
7038,vìchi,1,1,0,1
7041,sprovvisti,1,1,0,1
7043,ucciso,1,1,0,1
7046,approvvigionamento,1,1,0,1
7049,segnaposto,1,1,0,1
7053,ha miliardi,1,1,0,1
6867,​​fatta,1,1,0,1
6864,effettuati,1,1,0,1
7107,paniere,1,1,0,1
6723,congratularti,1,1,0,1
6734,meraviglia,1,1,0,1
6735,rinvio,1,1,0,1
6741,condannata,1,1,0,1
6742,istituita,1,1,0,1
6743,positiva,1,1,0,1
6744,svegliata,1,1,0,1
6745,sintassi,1,1,0,1
6746,polvere,1,1,0,1
6749,collettivo,1,1,0,1
6750,vicinanze,1,1,0,1
6754,umorismo,1,1,0,1
6756,privatizzati,1,1,0,1
6758,suggeriscano,1,1,0,1
6760,dettagliate,1,1,0,1
6763,negoziare,1,1,0,1
6729,multiforme,1,1,0,1
6718,stabilita,1,1,0,1
6863,invenzione,1,1,0,1
6717,amerindie,1,1,0,1
6675,affrontati,1,1,0,1
6676,regolamentazione,1,1,0,1
6678,esaustivo,1,1,0,1
6680,signore,1,1,0,1
6684,similarità,1,1,0,1
6687,cominciarono,1,1,0,1
6688,accusato,1,1,0,1
6690,nahuatl,1,1,0,1
6692,anidride,1,1,0,1
6699,etnografico,1,1,0,1
6701,seme,1,1,0,1
6707,additandole,1,1,0,1
6709,presenziare,1,1,0,1
6711,autonomo,1,1,0,1
6714,naturalistico,1,1,0,1
6764,turno,1,1,0,1
6765,liberale,1,1,0,1
6767,sfuggite,1,1,0,1
6769,disastri,1,1,0,1
6816,reindirizzamento,1,1,0,1
6818,frazione,1,1,0,1
6823,mancano,1,1,0,1
6826,contenuta,1,1,0,1
6828,atteggiamenti,1,1,0,1
6832,apparizioni,1,1,0,1
6833,riusciti,1,1,0,1
6835,avanzamenti,1,1,0,1
6840,scontato,1,1,0,1
6847,dublino,1,1,0,1
6852,cancello,1,1,0,1
6855,sintattici,1,1,0,1
6858,immateriale,1,1,0,1
6861,condannato,1,1,0,1
6862,termicamente,1,1,0,1
6814,raffica,1,1,0,1
6813,polisemico,1,1,0,1
6812,scartate,1,1,0,1
6792,simboleggia,1,1,0,1
6771,fraintendimenti,1,1,0,1
6774,uragano,1,1,0,1
6778,allontanamento,1,1,0,1
6780,romantica,1,1,0,1
6781,cominciamo,1,1,0,1
6784,digestiva,1,1,0,1
6793,individuazione,1,1,0,1
6811,assicurato,1,1,0,1
6796,scambiarsi,1,1,0,1
6801,australiani,1,1,0,1
6804,feci,1,1,0,1
6808,introduzione,1,1,0,1
6809,vigilanza,1,1,0,1
6810,spostano,1,1,0,1
7106,appartenevano,1,1,0,1
7110,dure,1,1,0,1
9037,addestrando,1,1,0,1
7347,raddoppiate,1,1,0,1
7350,allettante,1,1,0,1
7351,finiscono,1,1,0,1
7353,primaria​,1,1,0,1
7357,mantenga,1,1,0,1
7362,interattive,1,1,0,1
7364,occasionali,1,1,0,1
7365,poveri,1,1,0,1
7368,notando,1,1,0,1
7373,fuoriusciranno,1,1,0,1
7375,letargiche,1,1,0,1
7376,rivedono,1,1,0,1
7377,autorizzazioni,1,1,0,1
7378,proponeva,1,1,0,1
7381,conserve,1,1,0,1
7382,interfacce,1,1,0,1
7348,incorporare,1,1,0,1
7346,condivisibile,1,1,0,1
7302,pasticci,1,1,0,1
7344,faithbased,1,1,0,1
7306,inaspettate,1,1,0,1
7309,esibirsi,1,1,0,1
7310,ripercussioni,1,1,0,1
7311,indichi,1,1,0,1
7313,reato,1,1,0,1
7316,coesistettero,1,1,0,1
7320,etano,1,1,0,1
7321,​​anticipo,1,1,0,1
7322,irishtimescom,1,1,0,1
7324,friulano,1,1,0,1
7327,porzioni,1,1,0,1
7335,«a,1,1,0,1
7338,glicoproteine,1,1,0,1
7342,personalizzata,1,1,0,1
7343,dirà,1,1,0,1
7383,mappamondopuzzle,1,1,0,1
7384,prevedono,1,1,0,1
7385,acquisì,1,1,0,1
7386,eseguiti,1,1,0,1
7442,gestiscono,1,1,0,1
7448,propositivi,1,1,0,1
7457,processa,1,1,0,1
7459,memoriam,1,1,0,1
7460,rafforzare,1,1,0,1
7461,irlandese,1,1,0,1
7463,accademia,1,1,0,1
7467,sfuggire,1,1,0,1
7468,rifiutano,1,1,0,1
7470,registri,1,1,0,1
7472,rafforzato,1,1,0,1
7473,semisupervisionate,1,1,0,1
7477,trasferito,1,1,0,1
7478,intenzionale,1,1,0,1
7484,mitologie,1,1,0,1
7434,destinato,1,1,0,1
7424,rilassato,1,1,0,1
7422,conduca,1,1,0,1
7396,​​una,1,1,0,1
7387,marginali,1,1,0,1
7389,false—,1,1,0,1
7390,agricole,1,1,0,1
7391,sequestrato,1,1,0,1
7392,libbre,1,1,0,1
7395,tolleranza,1,1,0,1
7397,sposato,1,1,0,1
7419,consigli,1,1,0,1
7398,eccessivamente,1,1,0,1
7407,interattività,1,1,0,1
7408,risparmiare,1,1,0,1
7411,conserva,1,1,0,1
7413,razionali,1,1,0,1
7416,studiare,1,1,0,1
7303,di milioni,1,1,0,1
7301,complicata,1,1,0,1
7113,democraticamente,1,1,0,1
7153,sportello,1,1,0,1
7157,contenga,1,1,0,1
7158,simbolico,1,1,0,1
7161,disturbarla,1,1,0,1
7162,scarso,1,1,0,1
7165,triplicate,1,1,0,1
7167,razzismo,1,1,0,1
7168,giocatori,1,1,0,1
7169,informali,1,1,0,1
7172,approssimazione,1,1,0,1
7173,spese,1,1,0,1
7176,microcorrenti,1,1,0,1
7180,formasse,1,1,0,1
7183,coprire,1,1,0,1
7184,coerenza,1,1,0,1
7187,educativi,1,1,0,1
7155,consisterà,1,1,0,1
7152,governativa,1,1,0,1
7297,estetiche,1,1,0,1
7146,stampato,1,1,0,1
7115,cronaca,1,1,0,1
7116,dominato,1,1,0,1
7118,tabulati,1,1,0,1
7120,tentate,1,1,0,1
7121,ospitata,1,1,0,1
7126,spallanzani,1,1,0,1
7129,indiani,1,1,0,1
7133,descritte,1,1,0,1
7135,susseguono,1,1,0,1
7136,sufficienza,1,1,0,1
7137,prelevarne,1,1,0,1
7140,statiche,1,1,0,1
7141,cessano,1,1,0,1
7143,verificarsi,1,1,0,1
7145,spadolini,1,1,0,1
7188,associano,1,1,0,1
7190,assemblata,1,1,0,1
7191,amica,1,1,0,1
7198,antepongono,1,1,0,1
7257,visibile,1,1,0,1
7261,ridistribuirla,1,1,0,1
7263,noiosa,1,1,0,1
7266,litosfera,1,1,0,1
7267,complementi,1,1,0,1
7270,invertiti,1,1,0,1
7273,conteggio,1,1,0,1
7274,trasferimento,1,1,0,1
7275,gerarchici,1,1,0,1
7277,inserita,1,1,0,1
7278,mancato,1,1,0,1
7280,situato,1,1,0,1
7283,ripristinando,1,1,0,1
7285,meridionali,1,1,0,1
7296,sbalorditivo,1,1,0,1
7253,nascere,1,1,0,1
7250,guaio,1,1,0,1
7247,eseguite,1,1,0,1
7222,riprogrammazione,1,1,0,1
7199,macroecosistema,1,1,0,1
7204,coinvolti,1,1,0,1
7209,xix,1,1,0,1
7215,significare,1,1,0,1
7218,indicizzazione,1,1,0,1
7219,migliorata,1,1,0,1
7223,ossessione,1,1,0,1
7246,difficilmente,1,1,0,1
7228,aggiunge,1,1,0,1
7229,integra,1,1,0,1
7232,temporaneamente,1,1,0,1
7235,tenta,1,1,0,1
7243,respinti,1,1,0,1
7244,sims,1,1,0,1
6674,aspiriamo,1,1,0,1
6673,compone,1,1,0,1
6666,sospetti,1,1,0,1
6175,notiziari,1,1,0,1
6179,provvidenza,1,1,0,1
6181,metrica,1,1,0,1
6183,adattano,1,1,0,1
6184,valutandone,1,1,0,1
6185,dc,1,1,0,1
6186,avvertimenti,1,1,0,1
6187,distribuiscono,1,1,0,1
6189,sollevano,1,1,0,1
6191,reagiscono,1,1,0,1
6195,animate,1,1,0,1
6196,marionette,1,1,0,1
6199,lucio,1,1,0,1
6200,concentrare,1,1,0,1
6202,divertirsi,1,1,0,1
6203,agenti,1,1,0,1
6176,intimidatori,1,1,0,1
6173,consentitex,1,1,0,1
6133,possedute,1,1,0,1
6169,promossa,1,1,0,1
6140,bilancio,1,1,0,1
6141,odierni,1,1,0,1
6142,lavorativo,1,1,0,1
6151,intimidatorie,1,1,0,1
6152,inadatte,1,1,0,1
6153,evitandone,1,1,0,1
6154,rilicenziare,1,1,0,1
6157,configurazioni,1,1,0,1
6160,limitano,1,1,0,1
6161,wikiˈpɛdja,1,1,0,1
6162,vederla,1,1,0,1
6164,automi,1,1,0,1
6165,massimizzano,1,1,0,1
6166,analfabeta,1,1,0,1
6167,formulazione,1,1,0,1
6205,dimensionale,1,1,0,1
6208,lasciata,1,1,0,1
6211,affronti,1,1,0,1
6212,nudi,1,1,0,1
6267,legislativo,1,1,0,1
6269,incentrata,1,1,0,1
6270,algoritmiche,1,1,0,1
6275,portabilità,1,1,0,1
6277,televisivi,1,1,0,1
6278,prevenuti,1,1,0,1
6281,frequenza,1,1,0,1
6283,finanziato,1,1,0,1
6285,oggettivamente,1,1,0,1
6286,calibratura,1,1,0,1
6287,default,1,1,0,1
6289,antichità,1,1,0,1
6290,collegano,1,1,0,1
6291,galleria,1,1,0,1
6292,affrontando,1,1,0,1
6258,saltare,1,1,0,1
6257,—un,1,1,0,1
6253,emulati,1,1,0,1
6233,classificano,1,1,0,1
6221,iniziava,1,1,0,1
6223,qualificatore,1,1,0,1
6225,offuscare,1,1,0,1
6228,ricorrenti,1,1,0,1
6230,superstizioni,1,1,0,1
6231,compaiono,1,1,0,1
6234,intrusi,1,1,0,1
6252,richiesti,1,1,0,1
6236,capace,1,1,0,1
6239,fattoria,1,1,0,1
6240,provarono,1,1,0,1
6242,ifelse,1,1,0,1
6243,indecente,1,1,0,1
6248,macachi,1,1,0,1
6134,primitivo,1,1,0,1
6131,follia,1,1,0,1
6664,vandalizza,1,1,0,1
5997,​​elastiche,1,1,0,1
5999,censori,1,1,0,1
6001,fuso,1,1,0,1
6007,uichipìdia,1,1,0,1
6008,sollevati,1,1,0,1
6009,piccardia,1,1,0,1
6011,femmine,1,1,0,1
6012,economica,1,1,0,1
6015,egoistico,1,1,0,1
6016,ritenuti,1,1,0,1
6017,escludeva,1,1,0,1
6020,riconsiderato,1,1,0,1
6021,riguardare,1,1,0,1
6022,favorendo,1,1,0,1
6023,raisonable,1,1,0,1
6027,consigliata,1,1,0,1
5998,baie,1,1,0,1
5993,utilizzava,1,1,0,1
6129,colonie,1,1,0,1
5991,guardi,1,1,0,1
5954,riapparse,1,1,0,1
5955,anticipare,1,1,0,1
5958,allegorico,1,1,0,1
5961,renda,1,1,0,1
5962,correzionisu,1,1,0,1
5965,denominatore,1,1,0,1
5968,rielaborata,1,1,0,1
5969,spaccatura,1,1,0,1
5970,inconsci,1,1,0,1
5977,serbia,1,1,0,1
5978,estreme,1,1,0,1
5982,utilizzarle,1,1,0,1
5983,bontà,1,1,0,1
5984,attrezzato,1,1,0,1
5989,espandersi,1,1,0,1
6028,sperimentato,1,1,0,1
6032,avanzati,1,1,0,1
6033,elevata,1,1,0,1
6035,glaciale,1,1,0,1
6079,nuvole,1,1,0,1
6090,integrazioni,1,1,0,1
6092,​​generale,1,1,0,1
6093,edicole,1,1,0,1
6095,elogi,1,1,0,1
6096,stella,1,1,0,1
6100,nero,1,1,0,1
6105,acquatici,1,1,0,1
6109,azionista,1,1,0,1
6110,accumulazione,1,1,0,1
6118,nascosto,1,1,0,1
6119,oltre miliardi,1,1,0,1
6120,connettività,1,1,0,1
6122,entusiasmanti,1,1,0,1
6123,manipolano,1,1,0,1
6078,millennio,1,1,0,1
6077,branche,1,1,0,1
6076,monaco,1,1,0,1
6050,predefinita,1,1,0,1
6036,tarantino,1,1,0,1
6038,violato,1,1,0,1
6039,zolle,1,1,0,1
6041,nacque,1,1,0,1
6047,convalidata,1,1,0,1
6049,dietista,1,1,0,1
6052,andamane,1,1,0,1
6074,riassunte,1,1,0,1
6055,decimi,1,1,0,1
6056,condividere,1,1,0,1
6060,avvicinando,1,1,0,1
6061,pesca,1,1,0,1
6068,telefoni,1,1,0,1
6070,acculturato…,1,1,0,1
6293,persistono,1,1,0,1
6295,ognuna,1,1,0,1
6298,lamenta,1,1,0,1
6527,progettia,1,1,0,1
6530,rientrano,1,1,0,1
6533,battere,1,1,0,1
6534,arazzi,1,1,0,1
6535,illuminato,1,1,0,1
6536,idrocarburi,1,1,0,1
6539,prestazione,1,1,0,1
6540,sottoutilizzata,1,1,0,1
6542,moralità,1,1,0,1
6545,iterativa,1,1,0,1
6547,sentenze,1,1,0,1
6548,nupediacom,1,1,0,1
6555,schianto,1,1,0,1
6561,workshop,1,1,0,1
6566,vitalistico,1,1,0,1
6569,trattengono,1,1,0,1
6528,immaginario,1,1,0,1
6523,—in,1,1,0,1
6299,sopraffatti,1,1,0,1
6521,soltanto,1,1,0,1
6479,speciali,1,1,0,1
6480,proseguire,1,1,0,1
6482,assimilato,1,1,0,1
6484,occupata,1,1,0,1
6485,pulita,1,1,0,1
6486,wikipediag,1,1,0,1
6493,selezionato,1,1,0,1
6495,avviati,1,1,0,1
6502,pianificare,1,1,0,1
6505,alvei,1,1,0,1
6507,dividendo,1,1,0,1
6509,trovati,1,1,0,1
6513,interpellati,1,1,0,1
6516,assumerci,1,1,0,1
6518,tardo,1,1,0,1
6574,sfruttato,1,1,0,1
6576,meritano,1,1,0,1
6577,estinzioni,1,1,0,1
6578,troverebbe,1,1,0,1
6628,disegnare,1,1,0,1
6631,zeri,1,1,0,1
6632,supervisore,1,1,0,1
6635,turco,1,1,0,1
6636,negativamente,1,1,0,1
6638,interagire,1,1,0,1
6640,denominate,1,1,0,1
6641,pubblicizzata,1,1,0,1
6642,privilegi,1,1,0,1
6643,bagno,1,1,0,1
6645,semantica,1,1,0,1
6653,venti,1,1,0,1
6660,appianati,1,1,0,1
6661,oggettivo,1,1,0,1
6663,sembrato,1,1,0,1
6624,costituire,1,1,0,1
6622,controproducenti,1,1,0,1
6621,decodificare,1,1,0,1
6593,facoltà,1,1,0,1
6579,stagionale,1,1,0,1
6583,paradossi,1,1,0,1
6584,geova,1,1,0,1
6589,disomogenea,1,1,0,1
6591,nudità,1,1,0,1
6592,avvertiti,1,1,0,1
6595,criminale,1,1,0,1
6611,vita»,1,1,0,1
6596,stagnante,1,1,0,1
6598,egiziano,1,1,0,1
6600,collar,1,1,0,1
6601,indiana,1,1,0,1
6602,virtualmente,1,1,0,1
6610,vento,1,1,0,1
6478,appartenere,1,1,0,1
6475,susan,1,1,0,1
6473,trasformazione,1,1,0,1
6378,pericoli,1,1,0,1
6347,differendo,1,1,0,1
6353,vissuta,1,1,0,1
6355,adeguato,1,1,0,1
6357,prepuberale,1,1,0,1
6358,giocava,1,1,0,1
6360,sovrascrittura,1,1,0,1
6361,pretendenti,1,1,0,1
6362,focalizzati,1,1,0,1
6367,script,1,1,0,1
6368,copiarlo,1,1,0,1
6369,partite,1,1,0,1
6370,ideografici,1,1,0,1
6372,governance,1,1,0,1
6373,trovate,1,1,0,1
6375,mero,1,1,0,1
6346,idrologico,1,1,0,1
6345,mestieri,1,1,0,1
6344,suggeriva,1,1,0,1
6324,arbitrario,1,1,0,1
6300,riutilizzare,1,1,0,1
6308,coautori,1,1,0,1
6317,violenti,1,1,0,1
6320,inappropriate,1,1,0,1
6321,garantisce,1,1,0,1
6323,spiritosi,1,1,0,1
6325,bozza,1,1,0,1
6343,integrare,1,1,0,1
6327,assegnare,1,1,0,1
6328,automatizzato,1,1,0,1
6331,sottili,1,1,0,1
6334,respingeva,1,1,0,1
6336,contrazione,1,1,0,1
6337,inappropriati,1,1,0,1
6377,digitalizzando,1,1,0,1
6386,pronunciarlo,1,1,0,1
6469,fluviale,1,1,0,1
6387,utilizzeremo,1,1,0,1
6426,dovessi,1,1,0,1
6430,divinità,1,1,0,1
6432,esemplificativo,1,1,0,1
6433,ministero,1,1,0,1
6435,reagisce,1,1,0,1
6437,riuscire,1,1,0,1
6439,sedimentaria,1,1,0,1
6440,concorrenti,1,1,0,1
6444,osservabili,1,1,0,1
6455,incompleto,1,1,0,1
6457,omesse,1,1,0,1
6461,raggiunti,1,1,0,1
6462,qualificato,1,1,0,1
6467,letterati,1,1,0,1
6468,revisionref,1,1,0,1
6424,totemismo,1,1,0,1
6423,fumetto,1,1,0,1
6422,danah,1,1,0,1
6402,perù,1,1,0,1
6389,rimanga,1,1,0,1
6390,nervoso,1,1,0,1
6392,compilativa,1,1,0,1
6396,topica,1,1,0,1
6397,localizzato,1,1,0,1
6401,—rivolte,1,1,0,1
6404,iwa,1,1,0,1
6420,fotografico,1,1,0,1
6407,posti,1,1,0,1
6410,trattate,1,1,0,1
6412,irregolarità,1,1,0,1
6414,propriamente,1,1,0,1
6416,«quando,1,1,0,1
6418,animismo,1,1,0,1
7486,fissando,1,1,0,1
7487,intrusione,1,1,0,1
7488,comete,1,1,0,1
8526,rivolte,1,1,0,1
8533,retribuzione,1,1,0,1
8539,governata,1,1,0,1
8540,vivere,1,1,0,1
8541,tolto,1,1,0,1
8542,serbo,1,1,0,1
8544,erroneamente,1,1,0,1
8547,esportare,1,1,0,1
8552,potente,1,1,0,1
8555,rispondono,1,1,0,1
8556,diminuendo,1,1,0,1
8560,sofisticazione,1,1,0,1
8563,biotopo,1,1,0,1
8564,apprezzamento,1,1,0,1
8568,mossi,1,1,0,1
8569,extracellulare,1,1,0,1
8532,consultava,1,1,0,1
8520,eliopausa,1,1,0,1
8474,elezione,1,1,0,1
8519,venduti,1,1,0,1
8477,sopravvive,1,1,0,1
8486,irrealizzabile,1,1,0,1
8490,rilegati,1,1,0,1
8492,lombardo,1,1,0,1
8500,quotidianamente,1,1,0,1
8505,stabilisca,1,1,0,1
8508,dimostrando,1,1,0,1
8509,costruito,1,1,0,1
8510,cameriera,1,1,0,1
8511,veterani—,1,1,0,1
8513,posizionamenti,1,1,0,1
8515,rivoluzioni,1,1,0,1
8516,"segue
siamo",1,1,0,1
8517,riepilogo,1,1,0,1
8518,trovo,1,1,0,1
8570,annotati,1,1,0,1
8572,spiegazioni,1,1,0,1
8573,cicloni,1,1,0,1
8574,assemblea,1,1,0,1
8632,cogliere,1,1,0,1
8633,tonnellate,1,1,0,1
8635,rifiorire,1,1,0,1
8636,indigene,1,1,0,1
8637,prestare,1,1,0,1
8639,ingressi,1,1,0,1
8640,luccichii,1,1,0,1
8643,conservavano,1,1,0,1
8644,mancanti,1,1,0,1
8649,cattedrale,1,1,0,1
8651,esplora,1,1,0,1
8653,menzioni,1,1,0,1
8654,chiavi,1,1,0,1
8655,districa,1,1,0,1
8656,fossili,1,1,0,1
8627,fukushima,1,1,0,1
8626,tirati,1,1,0,1
8622,incrociata,1,1,0,1
8600,ispirerà,1,1,0,1
8581,digeriscono,1,1,0,1
8584,avvolge,1,1,0,1
8586,parodiato,1,1,0,1
8588,garanzie,1,1,0,1
8594,egemonia,1,1,0,1
8596,scolastica,1,1,0,1
8605,monitor,1,1,0,1
8621,predeterminate,1,1,0,1
8610,stigmergica,1,1,0,1
8611,luciano,1,1,0,1
8612,volgare,1,1,0,1
8614,iniziata,1,1,0,1
8615,wikiquette,1,1,0,1
8618,cadavere,1,1,0,1
8475,sembrata,1,1,0,1
8473,chiuso,1,1,0,1
8276,cicli,1,1,0,1
8326,ristretto,1,1,0,1
8334,partecipata,1,1,0,1
8335,coinciso,1,1,0,1
8336,sopravvissute,1,1,0,1
8342,necessita,1,1,0,1
8343,vandalizzata,1,1,0,1
8346,etimologico,1,1,0,1
8350,dibattere,1,1,0,1
8351,incline,1,1,0,1
8352,dottrine,1,1,0,1
8355,controparti,1,1,0,1
8357,venere,1,1,0,1
8361,scusarsi,1,1,0,1
8365,ingegneri,1,1,0,1
8369,desiderabili,1,1,0,1
8372,settaria,1,1,0,1
8331,limitarsi,1,1,0,1
8325,incrocio,1,1,0,1
8470,lamentele,1,1,0,1
8323,contributiva,1,1,0,1
8278,abile,1,1,0,1
8280,sociotecnico,1,1,0,1
8284,dichiarando,1,1,0,1
8287,operative,1,1,0,1
8289,raggiunto milioni,1,1,0,1
8296,selforganization,1,1,0,1
8307,trentina,1,1,0,1
8308,inverte,1,1,0,1
8309,creazioni,1,1,0,1
8311,francesi,1,1,0,1
8314,moldavo,1,1,0,1
8315,dettagliare,1,1,0,1
8319,   articoli,1,1,0,1
8320,supportata,1,1,0,1
8322,quadre,1,1,0,1
8374,votato,1,1,0,1
8375,umoristiche,1,1,0,1
8376,generalizzati,1,1,0,1
8378,prestigioso,1,1,0,1
8427,—con,1,1,0,1
8437,donazione,1,1,0,1
8438,affermati,1,1,0,1
8443,appartenenti,1,1,0,1
8445,sudcoreano,1,1,0,1
8446,finalista,1,1,0,1
8447,preziose,1,1,0,1
8448,trattava,1,1,0,1
8449,extensa,1,1,0,1
8451,​nelle,1,1,0,1
8456,valutando,1,1,0,1
8460,deflusso,1,1,0,1
8463,wikiˈpidja,1,1,0,1
8464,copiarli,1,1,0,1
8468,pazzesco,1,1,0,1
8426,inammissibili,1,1,0,1
8423,scese,1,1,0,1
8411,suddivise,1,1,0,1
8389,provengano,1,1,0,1
8380,caratterizza,1,1,0,1
8381,verificabilità​,1,1,0,1
8382,dipenda,1,1,0,1
8383,glaciazione,1,1,0,1
8385,soppressori,1,1,0,1
8388,difettoso,1,1,0,1
8390,manipoli,1,1,0,1
8408,perpetuo,1,1,0,1
8393,dinosauri,1,1,0,1
8399,attributi,1,1,0,1
8403,integralmente,1,1,0,1
8404,tracciamento,1,1,0,1
8405,aiutata,1,1,0,1
8407,saggistica,1,1,0,1
8665,geologiche,1,1,0,1
8666,escludere,1,1,0,1
8667,formativo,1,1,0,1
8893,assunti,1,1,0,1
8901,flessibile,1,1,0,1
8902,apparve,1,1,0,1
8910,viaggiare,1,1,0,1
8911,fintanto,1,1,0,1
8912,migrata,1,1,0,1
8913,irragionevoli,1,1,0,1
8916,ripristini,1,1,0,1
8917,emergere,1,1,0,1
8919,sovraccarichi,1,1,0,1
8923,parassiti,1,1,0,1
8925,corridoio,1,1,0,1
8927,sommato,1,1,0,1
8936,amor,1,1,0,1
8939,riflessione,1,1,0,1
8941,assieme,1,1,0,1
8896,disastro,1,1,0,1
8891,strutturanti,1,1,0,1
8668,onorato,1,1,0,1
8890,referenziati,1,1,0,1
8850,revocato,1,1,0,1
8854,fattorie,1,1,0,1
8855,costituite,1,1,0,1
8859,simposio,1,1,0,1
8860,sostenne,1,1,0,1
8861,kaikavian,1,1,0,1
8863,anticipa,1,1,0,1
8864,approvato,1,1,0,1
8868,ottiene,1,1,0,1
8873,intensifica,1,1,0,1
8876,parco,1,1,0,1
8879,effettivo,1,1,0,1
8881,fiacco,1,1,0,1
8884,suolo,1,1,0,1
8885,inversioni,1,1,0,1
8943,prevalere,1,1,0,1
8944,apparente,1,1,0,1
8945,cifratura,1,1,0,1
8948,sottosviluppati,1,1,0,1
9005,guidano,1,1,0,1
9006,inglese –,1,1,0,1
9007,soggettive,1,1,0,1
9008,ragionevole,1,1,0,1
9009,giornata,1,1,0,1
9010,rifiuti,1,1,0,1
9011,comando,1,1,0,1
9015,filippine,1,1,0,1
9018,vertere,1,1,0,1
9024,conferita,1,1,0,1
9025,autonomi,1,1,0,1
9028,sconsigliata,1,1,0,1
9031,indifferenziazione,1,1,0,1
9033,congiunzioni,1,1,0,1
9036,deviate,1,1,0,1
9004,didattico,1,1,0,1
8999,sperimentano,1,1,0,1
8995,pamphlet,1,1,0,1
8972,sperimentazione,1,1,0,1
8955,scorrono,1,1,0,1
8956,assetato,1,1,0,1
8957,corrispondere,1,1,0,1
8958,aiutarlo,1,1,0,1
8967,decimo,1,1,0,1
8969,ricorrenze,1,1,0,1
8973,funzioni—,1,1,0,1
8993,accreditata,1,1,0,1
8974,attivitàref,1,1,0,1
8977,metterne,1,1,0,1
8978,narcisi,1,1,0,1
8979,giardini,1,1,0,1
8982,ricevuta,1,1,0,1
8992,preferenza,1,1,0,1
8848,uniformandosi,1,1,0,1
8847,comprensivo,1,1,0,1
8846,ateismo,1,1,0,1
8771,significherebbe,1,1,0,1
8717,esserci,1,1,0,1
8718,omogeneità,1,1,0,1
8719,innaturale,1,1,0,1
8720,operativo,1,1,0,1
8723,idrografico,1,1,0,1
8736,organi,1,1,0,1
8741,professionisti,1,1,0,1
8743,anglicizzanti,1,1,0,1
8744,dedita,1,1,0,1
8745,costituzionale,1,1,0,1
8747,ruscelli,1,1,0,1
8749,sbocco,1,1,0,1
8755,appositi,1,1,0,1
8757,condizionante,1,1,0,1
8758,scarseggiano,1,1,0,1
8713,autoconfermati,1,1,0,1
8711,elenchi,1,1,0,1
8705,rileva,1,1,0,1
8682,ebbe,1,1,0,1
8669,ceco,1,1,0,1
8672,accettabile,1,1,0,1
8676,albori,1,1,0,1
8677,energetiche,1,1,0,1
8679,aggregato,1,1,0,1
8680,tradurre,1,1,0,1
8683,sottoporsi,1,1,0,1
8704,sequenziamento,1,1,0,1
8686,almanacchi,1,1,0,1
8689,durata,1,1,0,1
8691,dolly,1,1,0,1
8694,cyberspazio,1,1,0,1
8696,svolgeva,1,1,0,1
8700,estone,1,1,0,1
8762,individualista,1,1,0,1
8772,collaboratori»,1,1,0,1
8845,«pochi,1,1,0,1
8773,statisticamente,1,1,0,1
8809,adaline,1,1,0,1
8810,ˌwiːkiˈpiːdiə,1,1,0,1
8813,laboratori,1,1,0,1
8814,backup,1,1,0,1
8816,riformati,1,1,0,1
8820,intere,1,1,0,1
8821,affine,1,1,0,1
8825,istituzionalizzazione,1,1,0,1
8827,raccoglie,1,1,0,1
8830,esecutivo,1,1,0,1
8831,palla,1,1,0,1
8839,epoche,1,1,0,1
8840,giovani,1,1,0,1
8843,entroterra,1,1,0,1
8844,soprannaturale,1,1,0,1
8807,riparato,1,1,0,1
8806,trasformare,1,1,0,1
8804,ottimizzano,1,1,0,1
8787,anglosassone,1,1,0,1
8775,difendere,1,1,0,1
8776,ortografie,1,1,0,1
8781,disperse,1,1,0,1
8782,netta,1,1,0,1
8783,fedele,1,1,0,1
8786,distorsione,1,1,0,1
8790,accessibilità,1,1,0,1
8803,rilascio,1,1,0,1
8794,semplifica,1,1,0,1
8795,colloca,1,1,0,1
8796,passività,1,1,0,1
8798,itō,1,1,0,1
8799,sinapsi,1,1,0,1
8801,confermati,1,1,0,1
8277,studiosi,1,1,0,1
8274,ricevi,1,1,0,1
7495,neutroni,1,1,0,1
7728,interdisciplinari,1,1,0,1
7731,informativi,1,1,0,1
7732,possessore,1,1,0,1
7733,climatico,1,1,0,1
7734,evidenziare,1,1,0,1
7735,periodicità,1,1,0,1
7738,redistribuiti,1,1,0,1
7739,tribunali,1,1,0,1
7740,prospettiva,1,1,0,1
7741,paziente,1,1,0,1
7744,—forks—,1,1,0,1
7746,vicedirettore,1,1,0,1
7747,equatoriali,1,1,0,1
7759,compongono,1,1,0,1
7760,incorporati,1,1,0,1
7769,caduto,1,1,0,1
7729,certezza,1,1,0,1
7725,mimesi,1,1,0,1
7680,pecora,1,1,0,1
7723,cancerosi,1,1,0,1
7682,influenzate,1,1,0,1
7684,vandalizzati,1,1,0,1
7688,epistemologia,1,1,0,1
7689,decentralizza,1,1,0,1
7690,coreana,1,1,0,1
7691,simulare,1,1,0,1
7694,costituirono,1,1,0,1
7695,sullo,1,1,0,1
7697,sintetiche,1,1,0,1
7703,riposo,1,1,0,1
7704,sorpreso,1,1,0,1
7712,ideologici,1,1,0,1
7714,facevano,1,1,0,1
7715,reddito,1,1,0,1
7720,condivisa,1,1,0,1
7770,affronta,1,1,0,1
7774,piattaforme,1,1,0,1
7775,precede,1,1,0,1
7776,consapevolezza,1,1,0,1
7828,inevitabilmente,1,1,0,1
7829,contorto,1,1,0,1
7830,testuali,1,1,0,1
7834,fasi,1,1,0,1
7836,assumendo,1,1,0,1
7837,idrogeno,1,1,0,1
7842,accumulavano,1,1,0,1
7845,slava,1,1,0,1
7848,costituiti,1,1,0,1
7849,spiegabilità,1,1,0,1
7852,temporanei,1,1,0,1
7860,accusano,1,1,0,1
7863,severe,1,1,0,1
7867,aggiungendovi,1,1,0,1
7868,scristianizzazione,1,1,0,1
7823,concludere,1,1,0,1
7818,proibito,1,1,0,1
7815,contraction—,1,1,0,1
7791,interplanetario,1,1,0,1
7778,raggiunga,1,1,0,1
7780,passi,1,1,0,1
7782,geografiche,1,1,0,1
7783,restituire,1,1,0,1
7789,dovette,1,1,0,1
7790,crescendo,1,1,0,1
7792,visuale,1,1,0,1
7813,predispone,1,1,0,1
7795,sensoriali,1,1,0,1
7798,regolata,1,1,0,1
7803,divergono,1,1,0,1
7804,coreano,1,1,0,1
7808,appiattito,1,1,0,1
7810,riempito,1,1,0,1
7681,rafforzata,1,1,0,1
7679,commercializzato,1,1,0,1
8273,didattici,1,1,0,1
7546,privilegiate,1,1,0,1
7551,importare,1,1,0,1
7556,comparabili,1,1,0,1
7563,editorialista,1,1,0,1
7567,celebrazione,1,1,0,1
7568,bandito,1,1,0,1
7569,tracciati,1,1,0,1
7570,estinsero,1,1,0,1
7572,guiquipedia,1,1,0,1
7573,addestrandolo,1,1,0,1
7574,tecnologico,1,1,0,1
7575,switzerlandah,1,1,0,1
7579,geomagneticoref,1,1,0,1
7582,distribuendo,1,1,0,1
7583,gusci,1,1,0,1
7585,risolve,1,1,0,1
7547,crescenti,1,1,0,1
7539,sbatté,1,1,0,1
7678,encyclopedia—,1,1,0,1
7538,motivazioni,1,1,0,1
7496,—wikipedia,1,1,0,1
7499,minerali,1,1,0,1
7503,mitigazione,1,1,0,1
7504,succinta,1,1,0,1
7506,individuali,1,1,0,1
7507,abbondante,1,1,0,1
7508,indebito,1,1,0,1
7510,indagini,1,1,0,1
7512,ignori,1,1,0,1
7515,blogger,1,1,0,1
7519,attendibili,1,1,0,1
7524,calcificato,1,1,0,1
7525,incentrato,1,1,0,1
7530,circa miliardi,1,1,0,1
7534,presuppone,1,1,0,1
7586,indesiderabili,1,1,0,1
7587,articolazione,1,1,0,1
7592,estende,1,1,0,1
7593,fecero,1,1,0,1
7649,lanciando,1,1,0,1
7650,commedia,1,1,0,1
7651,rispondendo,1,1,0,1
7653,diplomi,1,1,0,1
7654,catalana,1,1,0,1
7655,plagiato,1,1,0,1
7657,generalizzato,1,1,0,1
7658,aviari,1,1,0,1
7660,delegati,1,1,0,1
7661,controllarle,1,1,0,1
7662,dichiarò,1,1,0,1
7665,circondate,1,1,0,1
7669,vantaggi,1,1,0,1
7675,sovversivi,1,1,0,1
7676,divario,1,1,0,1
7648,aperte,1,1,0,1
7646,abusi,1,1,0,1
7644,indicatori,1,1,0,1
7612,scartare,1,1,0,1
7594,televisivo,1,1,0,1
7599,leggero,1,1,0,1
7604,frattempo,1,1,0,1
7606,stabilendo,1,1,0,1
7607,umida,1,1,0,1
7608,sociobiologia,1,1,0,1
7613,avremmo,1,1,0,1
7637,controllata,1,1,0,1
7616,microbi,1,1,0,1
7619,cassazione,1,1,0,1
7622,serra,1,1,0,1
7623,accento,1,1,0,1
7625,tradeoff,1,1,0,1
7632,constatazione,1,1,0,1
7869,umoristici,1,1,0,1
7872,scrub,1,1,0,1
7878,intervistati,1,1,0,1
8140,irregolare,1,1,0,1
8147,vincolanti,1,1,0,1
8151,colpevoli,1,1,0,1
8153,compilate,1,1,0,1
8154,sostituisce,1,1,0,1
8156,byte,1,1,0,1
8157,milionesima,1,1,0,1
8158,cumulativo,1,1,0,1
8159,inadeguatezza,1,1,0,1
8161,“riconoscere,1,1,0,1
8162,sbagliati,1,1,0,1
8163,rituali,1,1,0,1
8164,adattivi,1,1,0,1
8165,possibilmente,1,1,0,1
8166,labirintiche,1,1,0,1
8167,personalizzazione,1,1,0,1
8144,generò,1,1,0,1
8139,addestrarlo,1,1,0,1
7888,giovanni,1,1,0,1
8137,ristagna,1,1,0,1
8097,eccitiamo,1,1,0,1
8102,particolarità,1,1,0,1
8103,"regola





o
n
io
o
n
s

p
o
t
un
t
o
e
s


⇒


b
tu
r
g
e
r




displaystyle",1,1,0,1
8108,partecipando,1,1,0,1
8111,mappare,1,1,0,1
8112,casuali,1,1,0,1
8113,finto,1,1,0,1
8114,esporsi,1,1,0,1
8122,concordano,1,1,0,1
8125,berkeley,1,1,0,1
8129,chiusura,1,1,0,1
8130,togliere,1,1,0,1
8131,settecento,1,1,0,1
8132,migrati,1,1,0,1
8136,guidando,1,1,0,1
8168,apposita,1,1,0,1
8171,slogan,1,1,0,1
8174,"​
tuttavia",1,1,0,1
8175,generalità,1,1,0,1
8235,finì,1,1,0,1
8237,lingua»,1,1,0,1
8238,pesanti,1,1,0,1
8239,trarre,1,1,0,1
8240,mirati,1,1,0,1
8241,samaran,1,1,0,1
8246,catalogo,1,1,0,1
8252,anglofona,1,1,0,1
8254,individuati,1,1,0,1
8255,orgogliose,1,1,0,1
8256,coevolve,1,1,0,1
8259,muscoli,1,1,0,1
8260,autoapprendere,1,1,0,1
8265,autoorganizzata,1,1,0,1
8270,didascalia,1,1,0,1
8232,contrasti,1,1,0,1
8226,dovere,1,1,0,1
8221,transgender,1,1,0,1
8202,trattando,1,1,0,1
8181,evolutiva,1,1,0,1
8184,sentirai,1,1,0,1
8191,ingombranti,1,1,0,1
8193,scacchi,1,1,0,1
8199,guardiamo,1,1,0,1
8200,simile—,1,1,0,1
8203,possedere,1,1,0,1
8220,africani,1,1,0,1
8208,continuerà,1,1,0,1
8209,distinzioni,1,1,0,1
8211,utenti persone e,1,1,0,1
8213,taiwan,1,1,0,1
8216,nanotecnologie,1,1,0,1
8218,italianizzate,1,1,0,1
8095,tipografica,1,1,0,1
8094,designazione,1,1,0,1
8093,inclusismo,1,1,0,1
7992,immagine—,1,1,0,1
7944,compromette,1,1,0,1
7949,citiamo,1,1,0,1
7951,labbra,1,1,0,1
7957,pene,1,1,0,1
7961,collaboratrici,1,1,0,1
7966,estranea,1,1,0,1
7970,rendono,1,1,0,1
7972,proibiscono,1,1,0,1
7974,acquatica,1,1,0,1
7976,conferenza,1,1,0,1
7981,simulazione,1,1,0,1
7982,crusca,1,1,0,1
7984,qr,1,1,0,1
7985,widrow,1,1,0,1
7986,eraclito,1,1,0,1
7943,sparsi,1,1,0,1
7940,procede,1,1,0,1
7938,sopravvissuta»,1,1,0,1
7918,sassone,1,1,0,1
7889,rapida​,1,1,0,1
7890,necessaria—,1,1,0,1
7900,riutilizzo,1,1,0,1
7907,contrapposizione,1,1,0,1
7908,spostata,1,1,0,1
7912,distintiva,1,1,0,1
7919,“oggi,1,1,0,1
7937,rivisto,1,1,0,1
7929,fissa,1,1,0,1
7930,collaborato,1,1,0,1
7931,scambiano,1,1,0,1
7932,montaggio,1,1,0,1
7933,riconosce,1,1,0,1
7934,rilevanza,1,1,0,1
7987,discostati,1,1,0,1
7993,solido,1,1,0,1
8090,costituenti,1,1,0,1
7999,turistica,1,1,0,1
8063,generalizzazioni,1,1,0,1
8066,lotta,1,1,0,1
8068,afripedia,1,1,0,1
8069,sentenza,1,1,0,1
8070,tradizionali»,1,1,0,1
8073,anglo,1,1,0,1
8074,iv,1,1,0,1
8077,distintivi,1,1,0,1
8079,spostare,1,1,0,1
8080,protetta,1,1,0,1
8081,papert,1,1,0,1
8083,webmasters,1,1,0,1
8085,ungherese,1,1,0,1
8087,periodicamente,1,1,0,1
8088,imparziale,1,1,0,1
8055,risponda,1,1,0,1
8054,intentato,1,1,0,1
8053,definiscono,1,1,0,1
8015,crittografare,1,1,0,1
8001,affrontano,1,1,0,1
8002,misurare,1,1,0,1
8006,chiarire,1,1,0,1
8011,rivelando,1,1,0,1
8012,volutamente,1,1,0,1
8013,tromba,1,1,0,1
8017,eroe,1,1,0,1
8051,—su,1,1,0,1
8018,accessi,1,1,0,1
8025,estraneo,1,1,0,1
8033,orbitale,1,1,0,1
8035,avrebbero,1,1,0,1
8042,proporzioni,1,1,0,1
8045,formata,1,1,0,1
18565,കഴിക്കുന്നതിനെക്കുറിച്ച്,0,0,1,1
18566,πχ,0,0,1,1
18570,εργασία,0,0,1,1
28586,ചെയ്യുന്നതെന്തും,0,0,1,1
28592,കൂടുതലുള്ളതും,0,0,1,1
28593,हाइपरलिंक,0,0,1,1
28595,مشتقة,0,0,1,1
28596,تنحاز,0,0,1,1
28598,interessanter,0,0,1,1
28601,स्वीकृतियों,0,0,1,1
28602,цене,0,0,1,1
28603,persondatorer,0,0,1,1
28605,transformative,0,0,1,1
28608,кнр,0,0,1,1
28611,ഗൃഹപാഠം,0,0,1,1
28612,chegavam,0,0,1,1
28613,lita,0,0,1,1
28614,imaginables,0,0,1,1
28615,entsetzlich,0,0,1,1
28588,türetilmiştir,0,0,1,1
28582,مجهود,0,0,1,1
28553,toplamda,0,0,1,1
28581,arkadaşlarınıza,0,0,1,1
28555,എന്നിവയിൽ,0,0,1,1
28556,basan,0,0,1,1
28560,redaktionell,0,0,1,1
28563,असंगत,0,0,1,1
28566,ವಿಷಾದಿಸುತ್ತೇನೆ,0,0,1,1
28567,magiques,0,0,1,1
28568,فهل,0,0,1,1
28569,திரும்பப்,0,0,1,1
28570,ಸಿಕ್ಕಿದ್ದು,0,0,1,1
28571,ಇತ್ತು,0,0,1,1
28573,நைட்,0,0,1,1
28574,άκουσε,0,0,1,1
28575,ഉണ്ടായിരുന്നെങ്കിൽ,0,0,1,1
28576,salladerna,0,0,1,1
28580,सिफोलिली,0,0,1,1
28616,zorlandı,0,0,1,1
28617,familière,0,0,1,1
28621,википедияудализм,0,0,1,1
28622,naken,0,0,1,1
28660,doutrina,0,0,1,1
28661,سأغادر,0,0,1,1
28662,stumpfer,0,0,1,1
28664,அதிகரிப்பதன்,0,0,1,1
28665,loop,0,0,1,1
28666,выполнения,0,0,1,1
28669,അടിക്കുന്നു,0,0,1,1
28670,vittighed,0,0,1,1
28671,вашингтоне,0,0,1,1
28672,spelling,0,0,1,1
28674,أحمر,0,0,1,1
28676,بإجمالي,0,0,1,1
28677,incorporates,0,0,1,1
28679,inclusion,0,0,1,1
28680,அங்கேயே,0,0,1,1
28657,തരുന്നതതാണ്,0,0,1,1
28656,μητέρας,0,0,1,1
28655,cy •,0,0,1,1
28634,lokala,0,0,1,1
28625,இருந்ததுடன்,0,0,1,1
28626,users ,0,0,1,1
28627,اغتيال,0,0,1,1
28629,konuşmayı,0,0,1,1
28632,മെല്ലെയായിരുന്നു,0,0,1,1
28633,avoirw,0,0,1,1
28638,erbij,0,0,1,1
28654,compreensíveis,0,0,1,1
28642,பார்வை,0,0,1,1
28643,नंबर्स,0,0,1,1
28644,parálo,0,0,1,1
28647,ചിരിക്കാൻ,0,0,1,1
28650,royaumeuni,0,0,1,1
28651,полномочия,0,0,1,1
28554,capacity,0,0,1,1
28551,புத்தகமாகத்,0,0,1,1
28682,богат,0,0,1,1
28464,ஒப்புக்கொண்டால்,0,0,1,1
28467,स्नो,0,0,1,1
28469,signos,0,0,1,1
28472,sammanfattas,0,0,1,1
28474,தலைப்புச்,0,0,1,1
28475,émoussé,0,0,1,1
28476,наплевать,0,0,1,1
28478,வழங்குகின்றது,0,0,1,1
28479,ofrecen,0,0,1,1
28480,arıyorsun,0,0,1,1
28485,onderzoeksresultaten,0,0,1,1
28488,κάθεστε,0,0,1,1
28489,"
प्राचीन",0,0,1,1
28490,podrán,0,0,1,1
28495,مجلة أدبيات,0,0,1,1
28496,sınıfın,0,0,1,1
28466,பூட்டப்பட்டு,0,0,1,1
28463,വിലയിരുത്തി,0,0,1,1
28549,ಕೆಟ್ಟದಾಗಿದೆ,0,0,1,1
28462,содержала,0,0,1,1
28438,difundiendo,0,0,1,1
28440,kommunistiska,0,0,1,1
28441,സന്ദേശങ്ങളിൽ,0,0,1,1
28442,أصول,0,0,1,1
28443,قليلا,0,0,1,1
28444,istersiniz,0,0,1,1
28447,infantiles,0,0,1,1
28449,പോകുന്നതാണ്,0,0,1,1
28450,förutsättningar,0,0,1,1
28451,الأفلام,0,0,1,1
28453,nauwelijks,0,0,1,1
28458,версиями,0,0,1,1
28459,sonido,0,0,1,1
28460,मनोनीत,0,0,1,1
28461,courbes,0,0,1,1
28497,ಎಲ್ಲಿಗೆ,0,0,1,1
28498,connections,0,0,1,1
28499,introduzido,0,0,1,1
28500,id,0,0,1,1
28526,сшил,0,0,1,1
28527,питером,0,0,1,1
28529,موعدًا,0,0,1,1
28531,रॉक,0,0,1,1
28532,sphère,0,0,1,1
28533,juges,0,0,1,1
28534,randevusu,0,0,1,1
28535,рунета,0,0,1,1
28538,दिखाई,0,0,1,1
28539,नीतियां,0,0,1,1
28540,локьером,0,0,1,1
28541,энергией,0,0,1,1
28544,slette,0,0,1,1
28546,യൂട്യൂബിൽ,0,0,1,1
28547,الواضح,0,0,1,1
28525,videoya,0,0,1,1
28524,अपशब्द,0,0,1,1
28522,linnaeus,0,0,1,1
28509,затоплен,0,0,1,1
28501,"
वॉलून",0,0,1,1
28502,கற்றுக்கொள்ளப்,0,0,1,1
28503,υψηλό,0,0,1,1
28505,l’animisme,0,0,1,1
28507,qualité »ab,0,0,1,1
28508,астрономической,0,0,1,1
28510,contribuiu,0,0,1,1
28520,ψεύτικο,0,0,1,1
28512,المحايدة،,0,0,1,1
28513,"
suaíli",0,0,1,1
28514,knapp,0,0,1,1
28515,வலியுறுத்துவதைப்,0,0,1,1
28518,lección,0,0,1,1
28519,tolkningar,0,0,1,1
28681,suspendre,0,0,1,1
28683,gerir,0,0,1,1
28904,مينج,0,0,1,1
28830,επισκεφτούν,0,0,1,1
28832,sourced,0,0,1,1
28833,تشغلها,0,0,1,1
28834,διαχείρισης,0,0,1,1
28835,فأخبرني,0,0,1,1
28836,teklifini,0,0,1,1
28837,feit,0,0,1,1
28838,tillmätas,0,0,1,1
28839,يهتم,0,0,1,1
28840,chronicle,0,0,1,1
28841,vivantes,0,0,1,1
28844,еженедельник,0,0,1,1
28845,rules”,0,0,1,1
28846,целом,0,0,1,1
28847,интонацию,0,0,1,1
28848,бесплатного,0,0,1,1
28831,vergessen,0,0,1,1
28829,existé,0,0,1,1
28798,medido,0,0,1,1
28828,gustado,0,0,1,1
28801,कोर्ट,0,0,1,1
28803,except,0,0,1,1
28804,chamar,0,0,1,1
28805,andor,0,0,1,1
28806,путешествие,0,0,1,1
28809,duymuşsunuzdur,0,0,1,1
28811,tourne,0,0,1,1
28813,sange,0,0,1,1
28814,ağlamasın,0,0,1,1
28816,تشاركها,0,0,1,1
28819,കുറിപ്പുകളും,0,0,1,1
28820,καθοριστεί,0,0,1,1
28821,collègues,0,0,1,1
28823,talenversies,0,0,1,1
28826,esprits,0,0,1,1
28849,« moments,0,0,1,1
28850,فظة,0,0,1,1
28852,nätcommunities,0,0,1,1
28854,preservando,0,0,1,1
28882,لاتيني,0,0,1,1
28883,preferia,0,0,1,1
28884,gekopieerde,0,0,1,1
28885,i̇yiyim,0,0,1,1
28889,merken,0,0,1,1
28890,خاطئًا,0,0,1,1
28891,नीदरलैंड,0,0,1,1
28892,υπευθυνότητας,0,0,1,1
28894,கீழாகவும்,0,0,1,1
28897,resurser,0,0,1,1
28898,sides,0,0,1,1
28899,amostragem,0,0,1,1
28900,contenait,0,0,1,1
28901,arkadaş,0,0,1,1
28902,verbluft,0,0,1,1
28881,hayalleriyle,0,0,1,1
28880,ரிச்சர்ட்,0,0,1,1
28879,καταλαβαίνω,0,0,1,1
28865,καλοσύνης,0,0,1,1
28858,difficilement,0,0,1,1
28860,yazarlarından,0,0,1,1
28861,mess,0,0,1,1
28862,ettusen,0,0,1,1
28863,ère,0,0,1,1
28864,perigosos,0,0,1,1
28866,communiqué,0,0,1,1
28876,club,0,0,1,1
28867,weit,0,0,1,1
28868,അവർ‍,0,0,1,1
28869,beleidigend,0,0,1,1
28871,отмечая,0,0,1,1
28872,സങ്കീർണ്ണവും,0,0,1,1
28873,ಹೇಳೋಣ,0,0,1,1
28800,കൂട്ടായ,0,0,1,1
28796,зверский,0,0,1,1
28684,ജില്ലയെച്ചൊല്ലി,0,0,1,1
28710,causou,0,0,1,1
28712,μήπως,0,0,1,1
28713,лондоне,0,0,1,1
28716,allgemeine,0,0,1,1
28718,μαντέψουν,0,0,1,1
28720,—sobre,0,0,1,1
28721,доме,0,0,1,1
28722,"
उड़िया",0,0,1,1
28723,certas,0,0,1,1
28724,neutres,0,0,1,1
28725,scorpions—features,0,0,1,1
28726,unutma,0,0,1,1
28727,الشروع,0,0,1,1
28728,έκπληκτος,0,0,1,1
28729,liever,0,0,1,1
28731,προστεθούν,0,0,1,1
28711,சிறப்புக்கட்டுரைகளிடையே,0,0,1,1
28708,inférieure,0,0,1,1
28793,clásica,0,0,1,1
28707,فرنسية,0,0,1,1
28685,ತೊಂದರೆಗೊಳಿಸುವುದಕ್ಕೆ,0,0,1,1
28686,promise,0,0,1,1
28687,textbook,0,0,1,1
28688,arıyoruz,0,0,1,1
28689,podrías,0,0,1,1
28691,εκατομμύριο,0,0,1,1
28692,ja •,0,0,1,1
28694,fundamentais,0,0,1,1
28695,énergisante,0,0,1,1
28696,പറഞ്ഞുകഴിഞ്ഞാലുടൻ,0,0,1,1
28699,probabilísticas,0,0,1,1
28700,indiquait,0,0,1,1
28704,научным,0,0,1,1
28705,ಪ್ರಾರಂಭಿಸಲು,0,0,1,1
28706,norwegian,0,0,1,1
28732,വിജ്ഞാനപ്രദമായ,0,0,1,1
28733,அனுமதி,0,0,1,1
28734,நர்சிசாவும்,0,0,1,1
28735,bilderna,0,0,1,1
28769,juridiska,0,0,1,1
28770,conhecida,0,0,1,1
28771,ചെയ്യരുത്,0,0,1,1
28772,cayo,0,0,1,1
28773,ಗೆದ್ದಿದೆ,0,0,1,1
28774,اللغات،,0,0,1,1
28776,رمز,0,0,1,1
28778,aktuella,0,0,1,1
28780,ஆக்க,0,0,1,1
28784,лучших,0,0,1,1
28785,ಮುಳುಗಿಸುತ್ತದೆ,0,0,1,1
28788,genoegen,0,0,1,1
28790,टर्म्स,0,0,1,1
28791,milliers,0,0,1,1
28792,воздействия,0,0,1,1
28768,présenté,0,0,1,1
28767,brief,0,0,1,1
28763,роб,0,0,1,1
28747,குறைவாகக்,0,0,1,1
28736,öbekleri,0,0,1,1
28737,polémiques,0,0,1,1
28739,ನಿಲುಗಡೆ,0,0,1,1
28744,variances,0,0,1,1
28745,പദ്ധതികൾരൂപീകരിക്കുന്നു,0,0,1,1
28746,azul,0,0,1,1
28748,مهتمًا,0,0,1,1
28762,adamın,0,0,1,1
28754,ابق,0,0,1,1
28755,tjugonde,0,0,1,1
28756,guldbrödet,0,0,1,1
28757,envers,0,0,1,1
28758,trabajadas,0,0,1,1
28761,क्लिफ्फोर्ड,0,0,1,1
28436,repetición,0,0,1,1
28435,unterbreche,0,0,1,1
28432,എന്നാലും,0,0,1,1
28109,farväl,0,0,1,1
28112,भले,0,0,1,1
28116,σχέση,0,0,1,1
28117,electrónica,0,0,1,1
28118,எழுதப்பட்டது,0,0,1,1
28120,nongouvernementales,0,0,1,1
28122,artiste,0,0,1,1
28127,टेम्पलेट्स,0,0,1,1
28133,allégories,0,0,1,1
28135,yaşardı,0,0,1,1
28136,видов,0,0,1,1
28138,вредительское,0,0,1,1
28139,kolaydır,0,0,1,1
28140,भाषी,0,0,1,1
28141,asırlardır,0,0,1,1
28144,പിടിക്കുക,0,0,1,1
28111,фотографиями,0,0,1,1
28108,nämn,0,0,1,1
28076,हल्का,0,0,1,1
28106,verdadero,0,0,1,1
28078,മീ,0,0,1,1
28079,ചതുപ്പുനിലമായിട്ടുണ്ട്,0,0,1,1
28080,साइटने,0,0,1,1
28081,« vigilance,0,0,1,1
28082,села,0,0,1,1
28086,parameters,0,0,1,1
28089,बिस्तर,0,0,1,1
28090,anlamları,0,0,1,1
28091,خمس,0,0,1,1
28093,dirigeerden,0,0,1,1
28095,supervisory,0,0,1,1
28096,söylediğin,0,0,1,1
28099,abendessen,0,0,1,1
28102,ಸುಲಭವಾಗಿ,0,0,1,1
28104,отменить,0,0,1,1
28145,അറിവുള്ള,0,0,1,1
28146,bekijken,0,0,1,1
28147,leyó,0,0,1,1
28150,affiliated,0,0,1,1
28175,conocen,0,0,1,1
28176,constamment,0,0,1,1
28177,ущербной,0,0,1,1
28178,موظفين,0,0,1,1
28179,αποφθεγμάτων,0,0,1,1
28180,λεπτό,0,0,1,1
28181,சிறப்புக்கட்டுரைத்,0,0,1,1
28182,wijzigingen,0,0,1,1
28183,மறுநாள்,0,0,1,1
28184,webbrowsere,0,0,1,1
28185,ಫಿಕ್ಸ್‌ನಲ್ಲಿದೆ,0,0,1,1
28187,borrado,0,0,1,1
28188,utgåvorna,0,0,1,1
28190,auprès,0,0,1,1
28191,« dans,0,0,1,1
28174,അനുബദ്ധ,0,0,1,1
28173,ആഗ്രഹിക്കുകയും,0,0,1,1
28171,κήπο,0,0,1,1
28158,väljs,0,0,1,1
28151,അവയെല്ലാം,0,0,1,1
28152,başlatabilirler,0,0,1,1
28153,destaca,0,0,1,1
28154,şükür,0,0,1,1
28156,connaissances »,0,0,1,1
28157,kullanılmaz,0,0,1,1
28159,hábil,0,0,1,1
28169,¿dónde,0,0,1,1
28160,ενθαρρύνονται,0,0,1,1
28161,expresado,0,0,1,1
28162,крайних,0,0,1,1
28163,benaderen,0,0,1,1
28165,நம்,0,0,1,1
28167,driveway,0,0,1,1
28077, ,0,0,1,1
28075,لتخريب,0,0,1,1
28429,യോജിക്കുന്നു,0,0,1,1
27981,spanska,0,0,1,1
27983,plazo,0,0,1,1
27984,медиафайлы,0,0,1,1
27985,estén,0,0,1,1
27986,omitted,0,0,1,1
27987,والعربية,0,0,1,1
27989,verklaring,0,0,1,1
27990,ليسوا,0,0,1,1
27993,definiciones,0,0,1,1
27994,offering,0,0,1,1
27995,с англ,0,0,1,1
27996,hvert,0,0,1,1
27998,ನಾರ್ಸಿಸಿಸಮ್,0,0,1,1
28000,dialogueur,0,0,1,1
28001,contundente,0,0,1,1
28003,системную,0,0,1,1
27982,éditorial,0,0,1,1
27980,никаких,0,0,1,1
28074,depicted,0,0,1,1
27979,यूरोपीय,0,0,1,1
27953,derivative,0,0,1,1
27954,durée,0,0,1,1
27958,стиль,0,0,1,1
27959,væk,0,0,1,1
27961,hearing,0,0,1,1
27962,edilmiştir,0,0,1,1
27963,"
bhasa",0,0,1,1
27964,"
marata",0,0,1,1
27965,ഇപയോഗിക്കുന്നത്,0,0,1,1
27967,സംസാരിച്ചിരിക്കാം,0,0,1,1
27969,minutes »,0,0,1,1
27974,sur ,0,0,1,1
27976,feinste,0,0,1,1
27977,mestadels,0,0,1,1
27978,«лучшую,0,0,1,1
28004,десятке,0,0,1,1
28006,ചേർക്കണം,0,0,1,1
28008,صعد,0,0,1,1
28011,விக்கிப்பீடியாவாக,0,0,1,1
28044,løb,0,0,1,1
28046,என்சைக்ளோபீடியாவிலிருந்து,0,0,1,1
28047,أصدقاء,0,0,1,1
28048,പൊതുവായ,0,0,1,1
28049,сфера,0,0,1,1
28051,skrive,0,0,1,1
28052,filling,0,0,1,1
28053,interstellar,0,0,1,1
28054,ಅಸಾಧಾರಣವಾದ,0,0,1,1
28057,увеличения,0,0,1,1
28060,draaide,0,0,1,1
28061,الشقيقة،,0,0,1,1
28062,والدتهما,0,0,1,1
28064,harvardsystemet,0,0,1,1
28068,stattdessen,0,0,1,1
28042,непроверенной,0,0,1,1
28041,dictadores,0,0,1,1
28039,sparas,0,0,1,1
28024,сюда,0,0,1,1
28013,αυτοί,0,0,1,1
28015,ildelugtende,0,0,1,1
28016,കണക്കാക്കാറില്ല,0,0,1,1
28017,தரவரிசையில்,0,0,1,1
28021,suggesties,0,0,1,1
28022,πλούτη,0,0,1,1
28025,ecoregion,0,0,1,1
28038,അസാമാന്യമായ,0,0,1,1
28028,φρικιαστικά,0,0,1,1
28030,ಪ್ರೇರೇಪಿಸುತ್ತದೆ,0,0,1,1
28032,знаком,0,0,1,1
28034,aramada,0,0,1,1
28035,നുഴഞ്ഞുകയറിയിട്ടുണ്ടായേക്കാവുന്ന,0,0,1,1
28037,implementaciones,0,0,1,1
28192,മൃതമായി,0,0,1,1
28197,விக்கிப்பீடியாவை,0,0,1,1
28198,umursayamazdım,0,0,1,1
28346,وأصبحت,0,0,1,1
28348,ಯು,0,0,1,1
28351,வீடியோவை,0,0,1,1
28353,नगरीय,0,0,1,1
28354,смотрели,0,0,1,1
28355,überstrapaziertes,0,0,1,1
28358,имеешь,0,0,1,1
28361,meteen,0,0,1,1
28362,enkyklios,0,0,1,1
28363,wikipediaartiklars,0,0,1,1
28364,entails,0,0,1,1
28366,muestran,0,0,1,1
28367,areas—automatic,0,0,1,1
28368,இதற்கு,0,0,1,1
28373,encontramse,0,0,1,1
28374,pratiquer,0,0,1,1
28347,læringen,0,0,1,1
28343,ദിനമായി,0,0,1,1
28199,karşılaştığı,0,0,1,1
28342,kaynaklarıyla,0,0,1,1
28320,llevadas,0,0,1,1
28321,otroligt,0,0,1,1
28322,الرقم,0,0,1,1
28327,лишь,0,0,1,1
28329,இணையத்,0,0,1,1
28330,océaniques,0,0,1,1
28332,engagement,0,0,1,1
28333,ooit,0,0,1,1
28334,δώσετε,0,0,1,1
28335,прошу,0,0,1,1
28336,excitante,0,0,1,1
28338,ദേഷ്യമാണ്,0,0,1,1
28339,tidsskrifter,0,0,1,1
28340,"
मूल",0,0,1,1
28341,tomo,0,0,1,1
28375,sitesine,0,0,1,1
28376,påbegyndt,0,0,1,1
28377,intressant,0,0,1,1
28378,kredisine,0,0,1,1
28409,draaiende,0,0,1,1
28410,τελειώσουν,0,0,1,1
28411,ಹಿಡಿಯದಿದ್ದರೆ,0,0,1,1
28412,nysede,0,0,1,1
28413,النيكل؛,0,0,1,1
28414,abertas,0,0,1,1
28416,തുടക്കംകുറിച്ചത്‌,0,0,1,1
28419,للمساهمة,0,0,1,1
28420,إيقافك,0,0,1,1
28421,പതിവ്,0,0,1,1
28422,numérique »,0,0,1,1
28423,تباعدوا,0,0,1,1
28424,குழந்தைக்கோ,0,0,1,1
28425,koud,0,0,1,1
28428,الإعلام,0,0,1,1
28408,coordenados,0,0,1,1
28406,coloquialmente,0,0,1,1
28404,contributes,0,0,1,1
28389,சனிக்கிழமை,0,0,1,1
28379,κινείται,0,0,1,1
28383,interests,0,0,1,1
28384,klonen,0,0,1,1
28386,بالقلق,0,0,1,1
28387,dvdдиск,0,0,1,1
28388,χρησιμοποιούσατε,0,0,1,1
28390,préparée,0,0,1,1
28402,expertförfattad,0,0,1,1
28394,organizados,0,0,1,1
28395,definitief,0,0,1,1
28397,dialecten,0,0,1,1
28398,കാണുന്ന,0,0,1,1
28400,عينات,0,0,1,1
28401,ουρανός,0,0,1,1
28318,ಉದಾಹರಣೆಗಳಂತೆ,0,0,1,1
28316,fonge,0,0,1,1
28314,hormiga,0,0,1,1
28253,बाधित,0,0,1,1
28230,உதவுகிறது,0,0,1,1
28231,vb,0,0,1,1
28232,källhänvisning,0,0,1,1
28233,kruist,0,0,1,1
28234,derefter,0,0,1,1
28236,stück,0,0,1,1
28238,தொகுப்பாளர்களின்,0,0,1,1
28239,salarié,0,0,1,1
28240,provável,0,0,1,1
28241,зеландии,0,0,1,1
28242,språkliga,0,0,1,1
28246,rohde,0,0,1,1
28247,الجرس,0,0,1,1
28249,منهجية,0,0,1,1
28250,nämligen,0,0,1,1
28229,விக்கிப்பீடியாகாம்,0,0,1,1
28228,пользователям,0,0,1,1
28226,zoos,0,0,1,1
28206,ಶಾಲೆಯಿಂದ,0,0,1,1
28200,storbritannien,0,0,1,1
28201,article »aa,0,0,1,1
28202,சிலவேளைகளில்,0,0,1,1
28203,suivis,0,0,1,1
28204,eventueel,0,0,1,1
28205,προέλευση,0,0,1,1
28208,apresentar,0,0,1,1
28219,पुस्तकालय,0,0,1,1
28210,stansifer,0,0,1,1
28212,சொந்தமான,0,0,1,1
28213,prenumerera,0,0,1,1
28214,ಪ್ರವೇಶಿಸಿದರು,0,0,1,1
28217,വായനക്കാർക്കോ,0,0,1,1
28218,തീരുമാനമാണെന്നും,0,0,1,1
28251,acquire,0,0,1,1
28254,अधिकारिक,0,0,1,1
28311,குறிப்பிடவில்லை,0,0,1,1
28255,تحويها,0,0,1,1
28287,للغد؟,0,0,1,1
28291,repose,0,0,1,1
28292,«викимедиару»,0,0,1,1
28293,बैंड,0,0,1,1
28294,forståelige,0,0,1,1
28296,ನಡೆಯುತ್ತಿದ್ದರೆ,0,0,1,1
28297,suivre »,0,0,1,1
28299,erosion,0,0,1,1
28301,permit,0,0,1,1
28305,« marques »,0,0,1,1
28306,география,0,0,1,1
28307,buiten,0,0,1,1
28308,آخذك,0,0,1,1
28309,interrogation,0,0,1,1
28310,عدت,0,0,1,1
28283,ينشئا,0,0,1,1
28282,wherefrom,0,0,1,1
28281,குழப்பத்தில்,0,0,1,1
28263,«рандеву»,0,0,1,1
28256,ജനാധിപത്യ,0,0,1,1
28257,raison »,0,0,1,1
28258,apoyando,0,0,1,1
28259,genommen,0,0,1,1
28260,repetitiva,0,0,1,1
28261,revisar,0,0,1,1
28265,ακόλουθοι,0,0,1,1
28278,несколькими,0,0,1,1
28266,ചരിത്രത്തെപ്പറ്റിയും,0,0,1,1
28267,اليابانية،,0,0,1,1
28270,évaluations,0,0,1,1
28271,bevakar,0,0,1,1
28273,confiera,0,0,1,1
28276,performed,0,0,1,1
28903,سلاش,0,0,1,1
28905,jouant,0,0,1,1
18571,narzissmus,0,0,1,1
29505,τηλεγραφήματος,0,0,1,1
29507,neither,0,0,1,1
29509,licenciada,0,0,1,1
29512,edin,0,0,1,1
29516,നിയന്ത്രിക്കപ്പെട്ടിരിക്കുന്നു,0,0,1,1
29518,gereken,0,0,1,1
29521,censuráveis,0,0,1,1
29524,oxygenation,0,0,1,1
29525,hypertext,0,0,1,1
29526,toerist,0,0,1,1
29527,cero,0,0,1,1
29528,varierande,0,0,1,1
29529,ഉണ്ടാവും,0,0,1,1
29530,controversiales,0,0,1,1
29533,nessa,0,0,1,1
29534,nodige,0,0,1,1
29506,серьёзный,0,0,1,1
29504,εμφανίσεις,0,0,1,1
29478,λίγες,0,0,1,1
29503,recurre,0,0,1,1
29480,kaçınmak,0,0,1,1
29481,talar,0,0,1,1
29483,ಕಾಣಿಸುತ್ತಿದ್ದಳು,0,0,1,1
29484,முக்கியமான,0,0,1,1
29485,സ്വർണ്ണവണ്ടി,0,0,1,1
29486,wikipediaartikels,0,0,1,1
29487,förväntade,0,0,1,1
29489,يتفق,0,0,1,1
29494,şaşırttığında,0,0,1,1
29495,невероятно,0,0,1,1
29496,frontière,0,0,1,1
29497,வா,0,0,1,1
29498,yayımladığı,0,0,1,1
29499,plaques,0,0,1,1
29502,paniek,0,0,1,1
29536,meters,0,0,1,1
29537,अनुमानतः,0,0,1,1
29540,needing,0,0,1,1
29543,ಪಡೆಯುವವರೆಗೂ,0,0,1,1
29570,independente,0,0,1,1
29571,näsa,0,0,1,1
29572,أساسي,0,0,1,1
29573,aufregendes,0,0,1,1
29575,τρεις,0,0,1,1
29577,العشرة,0,0,1,1
29578,intelectualmente,0,0,1,1
29579,ആരെയോ,0,0,1,1
29581,بالشفرة,0,0,1,1
29582,തമാശയാണ്,0,0,1,1
29585,என்சிச்லோபெடியா,0,0,1,1
29587,buys,0,0,1,1
29589,refletem,0,0,1,1
29591,amacıyla,0,0,1,1
29592,मिशन,0,0,1,1
29568,incluían,0,0,1,1
29567,الخطأ,0,0,1,1
29566,التدمير,0,0,1,1
29555,officielt,0,0,1,1
29544,evlendikten,0,0,1,1
29545,séparation,0,0,1,1
29546,ευχαριστήσω,0,0,1,1
29547,contrer,0,0,1,1
29550,الوقت،,0,0,1,1
29552,ഇവ,0,0,1,1
29556,accepterer,0,0,1,1
29565,криминального,0,0,1,1
29557,centralizam,0,0,1,1
29558,इंटरविकी,0,0,1,1
29559,язык,0,0,1,1
29560,ಪುನರಾವರ್ತಿಸಬೇಕು,0,0,1,1
29561,വേറൊരു,0,0,1,1
29562,مجالهم,0,0,1,1
29479,текстового,0,0,1,1
29475,svmwikipediaorg,0,0,1,1
29598,редактируются,0,0,1,1
29383,അവളുമായി,0,0,1,1
29385,arkadaşlarınızdan,0,0,1,1
29390,omission,0,0,1,1
29391,ما،,0,0,1,1
29395,mei,0,0,1,1
29396,ತೊಂದರೆಯಿಲ್ಲ,0,0,1,1
29397,ಗಂಭೀರವಾಗಿ,0,0,1,1
29398,ಬೆರಳುಗಳು,0,0,1,1
29399,reversores,0,0,1,1
29400,progresser,0,0,1,1
29403,الكتاب,0,0,1,1
29405,எடுக்கலாமா,0,0,1,1
29406,പറഞ്ഞിട്ടുണ്ട്,0,0,1,1
29407,δουλεύεις,0,0,1,1
29409,désencyclopédie,0,0,1,1
29413,являясь,0,0,1,1
29384,ಹಣವನ್ನು,0,0,1,1
29382,irgendwo,0,0,1,1
29474,конфигурация,0,0,1,1
29381,handlade,0,0,1,1
29360,suscetibilidade,0,0,1,1
29361,κατανοητή,0,0,1,1
29365,ഉറപ്പുണ്ട്,0,0,1,1
29366,poliment,0,0,1,1
29367,நாளில்,0,0,1,1
29369,consultaient,0,0,1,1
29370,ಕ್ಯಾಲಿಫೋರ್ನಿಯಾದಲ್ಲಿ,0,0,1,1
29371,satisfactory,0,0,1,1
29372,ഉപയോഗിച്ചിരുന്നു,0,0,1,1
29374,കണ്ടെത്തും,0,0,1,1
29375,ശാഖയായ,0,0,1,1
29376,temor,0,0,1,1
29377,linéaire,0,0,1,1
29378,ಸಭೆಯ,0,0,1,1
29379,organisées,0,0,1,1
29415,repetition,0,0,1,1
29419,أوراق,0,0,1,1
29420,ejemplo—,0,0,1,1
29421,சாங்கரால்,0,0,1,1
29446,glimlachte,0,0,1,1
29449,gemenskapen,0,0,1,1
29451,मां,0,0,1,1
29453,உறுதிப்படுத்தப்படுகின்றன,0,0,1,1
29456,seront,0,0,1,1
29457,المسكينة,0,0,1,1
29458,oprettet,0,0,1,1
29459,сайта —,0,0,1,1
29460,البناء,0,0,1,1
29461,mobility,0,0,1,1
29465,ആദ്യവർഷത്തിൽ,0,0,1,1
29469,ഇമെയിലിൽ,0,0,1,1
29470,tolereras,0,0,1,1
29471,laccoliths,0,0,1,1
29473,prejuicios,0,0,1,1
29445,verjaardag,0,0,1,1
29444,skriverier,0,0,1,1
29442,कॉलेज,0,0,1,1
29429,الغيرالمسجليين،,0,0,1,1
29422,доставляют,0,0,1,1
29423,plagiering,0,0,1,1
29424,பார்ப்போம்,0,0,1,1
29425,traducidos,0,0,1,1
29426,показали,0,0,1,1
29428,financiero,0,0,1,1
29430,الهاتف,0,0,1,1
29439,приглашения,0,0,1,1
29431,планах,0,0,1,1
29432,действительные,0,0,1,1
29433,weltkriegs,0,0,1,1
29434,aufgewacht,0,0,1,1
29437,വളർത്താൻ,0,0,1,1
29438,spicules,0,0,1,1
29593,bite,0,0,1,1
29599,citam,0,0,1,1
28906,έσπασε,0,0,1,1
29748,bloquea,0,0,1,1
29753,eğlenceli,0,0,1,1
29754,пересматривают,0,0,1,1
29758,കരയരുതെന്ന്,0,0,1,1
29759,almaya,0,0,1,1
29761,извинения,0,0,1,1
29764,hayret,0,0,1,1
29767,சைர்,0,0,1,1
29768,справочного,0,0,1,1
29769,സന്തോഷകരമായ,0,0,1,1
29771,qualificavam,0,0,1,1
29772,بوت,0,0,1,1
29773,മാതൃവെബ്‌സൈറ്റിനെക്കാൾ,0,0,1,1
29775,dictionarystyle,0,0,1,1
29777,distinguir,0,0,1,1
29778,αναφέρετε,0,0,1,1
29752,ಚಂದಾದಾರರಾಗಲು,0,0,1,1
29747,sidst,0,0,1,1
29716,المحددة,0,0,1,1
29746,μαθητές,0,0,1,1
29718,αφήσει,0,0,1,1
29719,habitants,0,0,1,1
29720,transclusão,0,0,1,1
29722,oceanography,0,0,1,1
29723,vergissen,0,0,1,1
29724,влияние,0,0,1,1
29726,उज्ज्वल,0,0,1,1
29732,wikipediaskribenterna,0,0,1,1
29733,предлагаемой,0,0,1,1
29735,práticas,0,0,1,1
29737,unutulmamalıdır,0,0,1,1
29739,والمساهمين،,0,0,1,1
29740,stycken,0,0,1,1
29741,കഴിച്ചതിനുശേഷം,0,0,1,1
29745,opposing,0,0,1,1
29779,ക്ലിക്കുചെയ്യുന്നത്,0,0,1,1
29780,religieux,0,0,1,1
29781,criminosas,0,0,1,1
29784,βάλετε,0,0,1,1
29808,perpetrator,0,0,1,1
29809,unifiés ,0,0,1,1
29810,milletin,0,0,1,1
29811,intégralité,0,0,1,1
29812,intimidatorias,0,0,1,1
29813,تحياتي,0,0,1,1
29815,objektif,0,0,1,1
29816,ರಹಸ್ಯವಾಗಿ,0,0,1,1
29817,thematic,0,0,1,1
29818,معينة،,0,0,1,1
29820,tanışın,0,0,1,1
29821,fold,0,0,1,1
29822,epostamda,0,0,1,1
29823,euskera,0,0,1,1
29825,autocorregirse,0,0,1,1
29807,நிறுவனத்திற்குச்,0,0,1,1
29806,ವಾಸ್ತವವಾಗಿ,0,0,1,1
29805,ederler,0,0,1,1
29793,gebiet,0,0,1,1
29785,derinlemesine,0,0,1,1
29786,ನೋಡುವ,0,0,1,1
29787,انفتاحًا,0,0,1,1
29790,inappropriée,0,0,1,1
29791,венгерские,0,0,1,1
29792,منفرج,0,0,1,1
29794,интеллектуальной,0,0,1,1
29804,servisleri,0,0,1,1
29797,профессиональных,0,0,1,1
29798,رؤيتك,0,0,1,1
29800,ambiguïté,0,0,1,1
29801,mödan,0,0,1,1
29802,navegava,0,0,1,1
29803,ஒன்றுசேர்ந்து,0,0,1,1
29717,geluid,0,0,1,1
29713,രണ്ടോ,0,0,1,1
29600,சேர்ந்த,0,0,1,1
29629,ஆடைகளின்,0,0,1,1
29631,தொலைபேசி,0,0,1,1
29632,instrucciones,0,0,1,1
29633,الحاسوب,0,0,1,1
29638,samarbejde,0,0,1,1
29639,ನಕಾರಾತ್ಮಕ,0,0,1,1
29640,årsförbrukning,0,0,1,1
29642,மேற்பார்வையிடல்களுக்குப்,0,0,1,1
29643,unmögliche,0,0,1,1
29644,hoffentlich,0,0,1,1
29648,सकारात्मक,0,0,1,1
29651,uyurken,0,0,1,1
29653,lastly,0,0,1,1
29657,n’était,0,0,1,1
29658,énfasis,0,0,1,1
29659,такая,0,0,1,1
29630,déclaraient,0,0,1,1
29626,consola,0,0,1,1
29712,qualifie,0,0,1,1
29625,amacı,0,0,1,1
29603,filtrera,0,0,1,1
29604,vermelho,0,0,1,1
29605,atacadas,0,0,1,1
29606,சுற்றுலாப்,0,0,1,1
29607,hebrea—,0,0,1,1
29608,nachdenken,0,0,1,1
29609,يفي,0,0,1,1
29610,quartal,0,0,1,1
29611,foregik,0,0,1,1
29613,ведь,0,0,1,1
29614,traduire,0,0,1,1
29616,planlægger,0,0,1,1
29619,correções,0,0,1,1
29621,появилось,0,0,1,1
29624,utilisezvous,0,0,1,1
29660,construct,0,0,1,1
29661,wikipediaförfattarna,0,0,1,1
29662,ಕರೆ,0,0,1,1
29663,hulp,0,0,1,1
29691,improduktivt,0,0,1,1
29692,periodically,0,0,1,1
29693,ευγενική,0,0,1,1
29695,சாப்பிடும்,0,0,1,1
29696,regresión,0,0,1,1
29697,istediği,0,0,1,1
29699,dagbladet,0,0,1,1
29700,दोहराए।,0,0,1,1
29701,¿debería,0,0,1,1
29702,« facebook »,0,0,1,1
29704,മേശ,0,0,1,1
29705,ಕೋನ,0,0,1,1
29706,fördjupade,0,0,1,1
29709,അസാധാരണമായി,0,0,1,1
29711,hazırlanmış,0,0,1,1
29690,convenir,0,0,1,1
29689,uppslagsverksartikel,0,0,1,1
29688,للاهتمام,0,0,1,1
29673,विरोधाभास,0,0,1,1
29664,trycka,0,0,1,1
29665,aimant,0,0,1,1
29669,മേഖലകളുണ്ട്,0,0,1,1
29670,"
जनवरी",0,0,1,1
29671,прошедших,0,0,1,1
29672,quarry,0,0,1,1
29674,canales,0,0,1,1
29686,porções,0,0,1,1
29675,remunerado,0,0,1,1
29676,leger,0,0,1,1
29677,tomado,0,0,1,1
29679,verwendeten,0,0,1,1
29680,ചെയ്തു,0,0,1,1
29682,анонимы,0,0,1,1
29359,ತರಗತಿಯಲ್ಲಿ,0,0,1,1
29358,vandalisering,0,0,1,1
29357,ziehen,0,0,1,1
29048,مستويات,0,0,1,1
29052,"
वेब",0,0,1,1
29053,எனும்,0,0,1,1
29054,armée,0,0,1,1
29056,distributes,0,0,1,1
29057,выходных»,0,0,1,1
29058,ياهو,0,0,1,1
29061,initiaux,0,0,1,1
29062,saxão,0,0,1,1
29067,épaisse,0,0,1,1
29070,kanalıma,0,0,1,1
29071,التذكاري؛,0,0,1,1
29073,situé,0,0,1,1
29074,небольшие,0,0,1,1
29075,യോജിക്കാനാവുന്ന,0,0,1,1
29078,amatörernas,0,0,1,1
29049,paradigme,0,0,1,1
29045,أجل,0,0,1,1
29016,описано,0,0,1,1
29044,níveis,0,0,1,1
29020,befinner,0,0,1,1
29021,ಖಂಡಿತವಾಗಿಯೂ,0,0,1,1
29022,കിടക്കുകയാണ്,0,0,1,1
29024,radiophoniques,0,0,1,1
29025,sürükleyebilir,0,0,1,1
29027,seyahatlerini,0,0,1,1
29028,polido,0,0,1,1
29029,τρόποι,0,0,1,1
29032,നൽകുന്നു,0,0,1,1
29033,franska,0,0,1,1
29034,verwechseln,0,0,1,1
29035,stuur,0,0,1,1
29037,åkturen,0,0,1,1
29038,مغرورًا,0,0,1,1
29043,basisinstructies,0,0,1,1
29079,آرون,0,0,1,1
29080,« wikipédia,0,0,1,1
29081,ഉറപ്പുവരുത്തുവാൻ,0,0,1,1
29083,propuestos,0,0,1,1
29111,उम्मीद,0,0,1,1
29113,imaginar,0,0,1,1
29114,முடியாவிட்டால்,0,0,1,1
29115,ಕಲಿಯಲು,0,0,1,1
29118,destacado,0,0,1,1
29120,ارجو,0,0,1,1
29121,бедный,0,0,1,1
29122,bardak,0,0,1,1
29123,എന്നിങ്ങനെയുള്ള,0,0,1,1
29126,anarchy,0,0,1,1
29129,immatériel ,0,0,1,1
29131,boodschapper,0,0,1,1
29132,расчленяются,0,0,1,1
29133,agilizar,0,0,1,1
29134,ointelligent,0,0,1,1
29109,സമാനമായ,0,0,1,1
29107,olsaydı,0,0,1,1
29106,يد,0,0,1,1
29092,بالذكر,0,0,1,1
29084,സംബന്ധിച്ചിടത്തോളം,0,0,1,1
29085,lags,0,0,1,1
29088,tidsperiod,0,0,1,1
29089,लगाना,0,0,1,1
29090,ആചാരങ്ങളാൽ,0,0,1,1
29091,görüşler,0,0,1,1
29095,exnihilo,0,0,1,1
29105,ويكيمانيا,0,0,1,1
29096,olağan,0,0,1,1
29098,udtaler,0,0,1,1
29099,lichte,0,0,1,1
29101,—bifurcaciones—,0,0,1,1
29103,yapılması,0,0,1,1
29104,felicitar,0,0,1,1
29017,ಹೆದರುವುದಿಲ್ಲ,0,0,1,1
29015,ultimate,0,0,1,1
29356,разграничение,0,0,1,1
28933,பக்கக்,0,0,1,1
28935,многоязычная,0,0,1,1
28936,dessein,0,0,1,1
28937,rankad,0,0,1,1
28941,exclusivement,0,0,1,1
28942,المحررين،,0,0,1,1
28944,பிழைத்திருத்தத்திற்கு,0,0,1,1
28945,प्रोफेसर,0,0,1,1
28946,drückt,0,0,1,1
28948,ഒന്നിൽ,0,0,1,1
28952,« vous »,0,0,1,1
28953,regulation,0,0,1,1
28957,കേൾക്കുന്നില്ല,0,0,1,1
28959,permanently,0,0,1,1
28960,типизировать,0,0,1,1
28962,ചേർത്തുകൊള്ളണം,0,0,1,1
28934,интервью,0,0,1,1
28931,hy •,0,0,1,1
29012,ചൂടാണ്,0,0,1,1
28929,bijdrage,0,0,1,1
28908,gebeurd,0,0,1,1
28909,healing,0,0,1,1
28910,പരിശീലിപ്പിക്കുകയും,0,0,1,1
28911,находится,0,0,1,1
28915,പൂർവ്വസ്ഥിതിയിലായി,0,0,1,1
28916,அதிகமான,0,0,1,1
28917,பெயரில்,0,0,1,1
28918,العكس,0,0,1,1
28919,médicale,0,0,1,1
28920,prendstoi,0,0,1,1
28921,كفعل,0,0,1,1
28923,slower,0,0,1,1
28924,kritikere,0,0,1,1
28925,edelim,0,0,1,1
28928,ತರುತ್ತೇನೆ,0,0,1,1
28963,olvidan,0,0,1,1
28964,nivå,0,0,1,1
28966,βασικές,0,0,1,1
28967,உரையாடலையும்,0,0,1,1
28991,ಕ್ರಿಯಾಪದವಾಗಿ,0,0,1,1
28992,αδιάφοροt,0,0,1,1
28994,விக்கிப்பீடியாவிற்கு,0,0,1,1
28995,неоднократно,0,0,1,1
28996,spelen,0,0,1,1
28997,coévolue,0,0,1,1
28998,صاغ,0,0,1,1
29000,مجانية,0,0,1,1
29001,സ്പീക്കറിൽ,0,0,1,1
29003,വഷളായി,0,0,1,1
29004,വാക്കിന്,0,0,1,1
29006,уехала,0,0,1,1
29007,सेल,0,0,1,1
29008,jämförde,0,0,1,1
29010,продала,0,0,1,1
28990,vandalizmle,0,0,1,1
28989,unintelligent,0,0,1,1
28988,propriétaire,0,0,1,1
28977,உற்சாகப்படுத்த,0,0,1,1
28970,envelops,0,0,1,1
28971,exempelmeningar,0,0,1,1
28972,لتحديد,0,0,1,1
28973,complementar,0,0,1,1
28974,izleme,0,0,1,1
28976,hopelijk,0,0,1,1
28978,restoran,0,0,1,1
28986,सोचते,0,0,1,1
28980,aristotélicienne,0,0,1,1
28981,تصنيفها،,0,0,1,1
28982,വിചാരിച്ചു,0,0,1,1
28983,έλεγες,0,0,1,1
28984,exclusividade,0,0,1,1
28985,almanızı,0,0,1,1
29135,частично,0,0,1,1
29137,saline,0,0,1,1
29138,είδατε,0,0,1,1
29279,हंसना,0,0,1,1
29283,"
म्यान्मारी",0,0,1,1
29284,بالعودة,0,0,1,1
29285,पन्ना,0,0,1,1
29286,пытаются,0,0,1,1
29287,നിസ്സാരനായിരിക്കാം,0,0,1,1
29289,ಯೂಟ್ಯೂಬ್‌ನಲ್ಲಿ,0,0,1,1
29290,englische,0,0,1,1
29293,religies,0,0,1,1
29294, علمية,0,0,1,1
29295,behandlas,0,0,1,1
29296,பார்த்ததிலிருந்து,0,0,1,1
29297,annenin,0,0,1,1
29298,ए,0,0,1,1
29299,تبكي؟,0,0,1,1
29301,രഹസ്യമുണ്ടായിരുന്നു,0,0,1,1
29282,aktivitet,0,0,1,1
29278,जाऊँगा,0,0,1,1
29139,spannends,0,0,1,1
29277,आत्महत्या,0,0,1,1
29255,crédito,0,0,1,1
29256,gelächelt,0,0,1,1
29257,preocupaba,0,0,1,1
29258,seje,0,0,1,1
29259,இருக்கிறோம்,0,0,1,1
29260,ಭಾವಿಸುವ,0,0,1,1
29263,κομμάτι,0,0,1,1
29265,лицензируются,0,0,1,1
29268,يتمكن,0,0,1,1
29269,दर्जे,0,0,1,1
29270,നിങ്ങളെത്തന്നെ,0,0,1,1
29271,calcular,0,0,1,1
29272,« quelle,0,0,1,1
29273,സത്യവിരുദ്ധമായ,0,0,1,1
29276,связывания,0,0,1,1
29302,şeklinde,0,0,1,1
29303,നല്ലവരായിരുന്നു,0,0,1,1
29306,sulak,0,0,1,1
29308,разве,0,0,1,1
29336,vur,0,0,1,1
29337,desencorajada,0,0,1,1
29338,binary,0,0,1,1
29341,eliminado,0,0,1,1
29342,وضعك,0,0,1,1
29343,नियमों,0,0,1,1
29344,попадет,0,0,1,1
29345,wondering,0,0,1,1
29346,लूरी,0,0,1,1
29347,obterá,0,0,1,1
29348,തടസ്സപ്പെടുത്തുന്നു,0,0,1,1
29350,betona,0,0,1,1
29353,പ്രത്യേകം,0,0,1,1
29354,दबाया,0,0,1,1
29355,vitaliste,0,0,1,1
29335,vrolijken,0,0,1,1
29332,spiken,0,0,1,1
29330,hadean,0,0,1,1
29317,اعتمادها,0,0,1,1
29309,ταξίδεψε,0,0,1,1
29310,اختلاف,0,0,1,1
29311,والتنظيمات,0,0,1,1
29312,прилагающейся,0,0,1,1
29313,للقوانين,0,0,1,1
29315,هيا,0,0,1,1
29318,μπροστά,0,0,1,1
29328,ചേർക്കാവുന്നതാണ്,0,0,1,1
29319,студентов,0,0,1,1
29320,المزايا,0,0,1,1
29321,favoriser,0,0,1,1
29322,nominated,0,0,1,1
29323,ചിലത്,0,0,1,1
29324,εξέπληξε,0,0,1,1
29253,serieuze,0,0,1,1
29251,«истина,0,0,1,1
29249,सहन,0,0,1,1
29189,تنسيق,0,0,1,1
29169,ಧರಿಸಿದ್ದರು,0,0,1,1
29170,compactness,0,0,1,1
29171,вандалов,0,0,1,1
29176,ആഴ്ച,0,0,1,1
29177,uge,0,0,1,1
29178,implementación,0,0,1,1
29179,verse,0,0,1,1
29180,ensinadas,0,0,1,1
29181,اعتقاده,0,0,1,1
29182,ámbito,0,0,1,1
29183,gelmiş,0,0,1,1
29184,eisenberg,0,0,1,1
29185,टैब्स,0,0,1,1
29186,ಗೊಂದಲಕ್ಕೀಡಾಗಿದ್ದೇನೆ,0,0,1,1
29187,onionspotatoes,0,0,1,1
29168,സ്കോർ,0,0,1,1
29167,skepsis,0,0,1,1
29165,sahip,0,0,1,1
29151,മുഖത്തേക്ക്,0,0,1,1
29140,പത്രവാർത്തകളും,0,0,1,1
29141,deixar,0,0,1,1
29147,influenciado,0,0,1,1
29148,gesloten,0,0,1,1
29149,википедияинклюзионизм,0,0,1,1
29150,وسأكون,0,0,1,1
29152,காக்கப்படுகின்றன,0,0,1,1
29161,blunt,0,0,1,1
29153,freshwater,0,0,1,1
29154,apresentassem,0,0,1,1
29155,objets,0,0,1,1
29156,ingenting,0,0,1,1
29157,लायब्रेरी,0,0,1,1
29159,voyages,0,0,1,1
29188,цифрового,0,0,1,1
29190,ഭക്ഷണമായിരുന്നു,0,0,1,1
29248,എന്നിട്ട്,0,0,1,1
29192,chemistry,0,0,1,1
29224,microecosystem,0,0,1,1
29225,fleisch,0,0,1,1
29226,слышал,0,0,1,1
29227,بنحو,0,0,1,1
29228,—alrededor,0,0,1,1
29229,लंबे,0,0,1,1
29231,mordaza,0,0,1,1
29235,antigamente,0,0,1,1
29236,açıklama,0,0,1,1
29238,nombrar,0,0,1,1
29241,τονίσετε,0,0,1,1
29242,dîner,0,0,1,1
29243,convirtiéndose,0,0,1,1
29244,സലാഡുകളും,0,0,1,1
29246,بالإسبانية,0,0,1,1
29223,trädgård,0,0,1,1
29221,cumhurbaşkanı,0,0,1,1
29220,недели,0,0,1,1
29207,voelt,0,0,1,1
29193,reageren,0,0,1,1
29198,evaluates,0,0,1,1
29200,والصينية,0,0,1,1
29201,فلنفعل,0,0,1,1
29204,generalize,0,0,1,1
29205,"
गन",0,0,1,1
29208,ತಿಂಗಳುಗಳವರೆಗೆ,0,0,1,1
29219,retirer,0,0,1,1
29209,leave,0,0,1,1
29210,ಹೊಂದಿದ್ದರು,0,0,1,1
29213,άκρη,0,0,1,1
29215,løgne,0,0,1,1
29217,försiktighet,0,0,1,1
29218,orsaken,0,0,1,1
27952,تقارير,0,0,1,1
27951,പക്ഷിയുടെതുപോലെയുള്ള,0,0,1,1
27948,பார்த்ததில்லை,0,0,1,1
26724,värre,0,0,1,1
26726,مفتوحًا,0,0,1,1
26727,ജോലിയും,0,0,1,1
26728,مايو,0,0,1,1
26729,fortement,0,0,1,1
26730,artikelämnen,0,0,1,1
26731,langweilig,0,0,1,1
26732,population,0,0,1,1
26733,usamos,0,0,1,1
26734,माइक्रोसोफ्ट,0,0,1,1
26735,pixels,0,0,1,1
26737,levens,0,0,1,1
26739,тема,0,0,1,1
26740,колонке,0,0,1,1
26741,woche,0,0,1,1
26745,bios,0,0,1,1
26725,servrar,0,0,1,1
26723,அடைய,0,0,1,1
26700,mastersmagisterexamen,0,0,1,1
26722,acheter,0,0,1,1
26702,sustained,0,0,1,1
26703,lærer,0,0,1,1
26705,meanings,0,0,1,1
26706,الغسيل,0,0,1,1
26707,ayudaría,0,0,1,1
26710,преодолении,0,0,1,1
26711,высокий,0,0,1,1
26712,ελληνική,0,0,1,1
26713,φοβόμουν,0,0,1,1
26714,twenty,0,0,1,1
26715,नक़ल,0,0,1,1
26716,horen,0,0,1,1
26717,urban,0,0,1,1
26719,anzutreten,0,0,1,1
26721,تحسَن,0,0,1,1
26747,teknik,0,0,1,1
26749,concurrents,0,0,1,1
26750,الزواج,0,0,1,1
26752,ρουμπίνι,0,0,1,1
26778,narsizaya,0,0,1,1
26780,confined,0,0,1,1
26781,udviklet,0,0,1,1
26783,procedente,0,0,1,1
26784,ತಂಪಾಗಿದೆ,0,0,1,1
26785,redevenue,0,0,1,1
26787,φύσης,0,0,1,1
26790,atingiu,0,0,1,1
26792,"
बवारियाई",0,0,1,1
26794,மகிழ்ச்சியடைகிறேன்,0,0,1,1
26795,instans,0,0,1,1
26796,विकिसूक्ति,0,0,1,1
26797,باللغات,0,0,1,1
26799,resultaten,0,0,1,1
26803,நடத்தை,0,0,1,1
26777,methane,0,0,1,1
26776,participa,0,0,1,1
26774,avantajları,0,0,1,1
26761,ಪ್ರಶ್ನೆಗಳಿಗೆ,0,0,1,1
26753,zwinkerten,0,0,1,1
26755,appeared,0,0,1,1
26756,exactitud,0,0,1,1
26757,sulter,0,0,1,1
26758,multimídias,0,0,1,1
26760,الفستان,0,0,1,1
26762,postgresql,0,0,1,1
26772,olman,0,0,1,1
26763,viable,0,0,1,1
26765,atmosphériques,0,0,1,1
26767,கொண்டிருந்தார்கள்,0,0,1,1
26768,ಕಾರ್ಯನಿರ್ವಹಿಸುತ್ತಿದ್ದರೆ,0,0,1,1
26770,வெற்றியடையவில்லை,0,0,1,1
26771,ludique,0,0,1,1
26701,الحال؟,0,0,1,1
26699,critical,0,0,1,1
26806,இடத்தை,0,0,1,1
26611,konferanslarda,0,0,1,1
26613,وشرح,0,0,1,1
26614,يظنون,0,0,1,1
26615,பெறுகிறார்கள்,0,0,1,1
26616,veracidade,0,0,1,1
26618,perro,0,0,1,1
26622,papel,0,0,1,1
26624,வந்திருந்தார்,0,0,1,1
26625,التغطية,0,0,1,1
26628,कोल्बेर्ट,0,0,1,1
26629,ഗൗരവമായി,0,0,1,1
26631,മറ്റൊന്നും,0,0,1,1
26632,എന്നതുകൊണ്ട്,0,0,1,1
26636,secuencias,0,0,1,1
26637,débattre,0,0,1,1
26639,bewonderende,0,0,1,1
26612,caltechstudenten,0,0,1,1
26610,समझाता,0,0,1,1
26698,ædelstene,0,0,1,1
26608,நன்றாகச்,0,0,1,1
26581,aufnehmen,0,0,1,1
26582,മനുഷ്യനാണ്,0,0,1,1
26585,അതിശയകരമായിരിക്കും,0,0,1,1
26589,താമസിച്ചിരുന്നു,0,0,1,1
26592,ദിവസവും,0,0,1,1
26593,blocked,0,0,1,1
26594,tíbet,0,0,1,1
26595,veamos,0,0,1,1
26596,الإستراتيجية,0,0,1,1
26600,dengeli,0,0,1,1
26602,bajada,0,0,1,1
26603,تيمز,0,0,1,1
26604,ഒരുക്കിയ,0,0,1,1
26605,religious,0,0,1,1
26606,replace,0,0,1,1
26641,dekken,0,0,1,1
26642,медицины,0,0,1,1
26646,ക്ഷീണം,0,0,1,1
26647,besorgen,0,0,1,1
26675,അവനോട്‌,0,0,1,1
26676,receiver,0,0,1,1
26677,большую,0,0,1,1
26679,جزيلاً,0,0,1,1
26680,يحتاج,0,0,1,1
26681,توش،,0,0,1,1
26684,बर्क्मेन,0,0,1,1
26686,ഭൗതികപ്രപഞ്ചത്തെ,0,0,1,1
26687,drukken,0,0,1,1
26688,trovärdiga,0,0,1,1
26689,إنجليزية,0,0,1,1
26690,цитируется,0,0,1,1
26691,مستقرًا,0,0,1,1
26695,nützliche,0,0,1,1
26697,تخريبًا,0,0,1,1
26674,ஒபாமாவுக்கு,0,0,1,1
26672,gekümmert,0,0,1,1
26671,jardín,0,0,1,1
26655,भागों,0,0,1,1
26649,ктонибудь,0,0,1,1
26650,hakaretlere,0,0,1,1
26651,anlıyorum,0,0,1,1
26652,விக்கிப்பீடியாவும்,0,0,1,1
26653,ஒருங்கிணைந்து,0,0,1,1
26654,croyaitil,0,0,1,1
26657,обедом,0,0,1,1
26670,πηγαίνουμε,0,0,1,1
26658,elastic,0,0,1,1
26660,beş,0,0,1,1
26661,εγωιστική,0,0,1,1
26662,τείνει,0,0,1,1
26663,बढ़ावा,0,0,1,1
26665,கட்டுரைகளிலும்,0,0,1,1
26805,internetanvändare,0,0,1,1
26807,ವಿನಂತಿಗಳನ್ನು,0,0,1,1
27947,വിഷമകരമായ,0,0,1,1
26943,fatally,0,0,1,1
26946,ஹெல்லரால்,0,0,1,1
26948,utility,0,0,1,1
26949,​​enorme,0,0,1,1
26950,λογισμικό,0,0,1,1
26951,μεγάλη,0,0,1,1
26952,ಸಮಯದಿಂದ,0,0,1,1
26953,indepth,0,0,1,1
26954,consiguió,0,0,1,1
26955,översättningen,0,0,1,1
26956,cruzamiento,0,0,1,1
26958,ريفيو,0,0,1,1
26959,манеры,0,0,1,1
26963,normalden,0,0,1,1
26965,أم,0,0,1,1
26967,stieg,0,0,1,1
26945,cliquant,0,0,1,1
26942,الإلكترونية,0,0,1,1
26910,ഇല്ലെന്നല്ല,0,0,1,1
26941,മേഖലകളിൽ,0,0,1,1
26912,пар,0,0,1,1
26913,implementation,0,0,1,1
26914,أجرى,0,0,1,1
26915,അതിനടുത്തുള്ള,0,0,1,1
26916,участником,0,0,1,1
26918,باراك,0,0,1,1
26919,fará,0,0,1,1
26921,ವರ್ತಿಸಿದ,0,0,1,1
26922,voûte,0,0,1,1
26924,законах,0,0,1,1
26925,treffpunkt,0,0,1,1
26934,reward,0,0,1,1
26935,rudemente,0,0,1,1
26937,முதற்பக்கத்தில்,0,0,1,1
26939,σταθερά,0,0,1,1
26968,título,0,0,1,1
26971,இணையானது,0,0,1,1
26972,τερενς,0,0,1,1
26975,സജീവ,0,0,1,1
27000,дело,0,0,1,1
27001,sementes,0,0,1,1
27002,geistig,0,0,1,1
27003,suivante,0,0,1,1
27005,traummutter,0,0,1,1
27008,കൂടാതെ,0,0,1,1
27010,unrecognized,0,0,1,1
27011,"
सामोगितियाई",0,0,1,1
27012,klänningen,0,0,1,1
27013,anlatırken,0,0,1,1
27014,svenskt,0,0,1,1
27016,tryckfriheten,0,0,1,1
27017,greed,0,0,1,1
27018,appreciate,0,0,1,1
27019,skolarbete,0,0,1,1
26999,gerealiseerd,0,0,1,1
26998,പദങ്ങൾ‌,0,0,1,1
26996,எதிர்மறையாக,0,0,1,1
26986,frequent,0,0,1,1
26976,செய்யும்படி,0,0,1,1
26978,procurála,0,0,1,1
26979,eenmaal,0,0,1,1
26980,añadir,0,0,1,1
26983,curation,0,0,1,1
26985,vo •,0,0,1,1
26987,навестить,0,0,1,1
26995,ഉച്ചരിക്കുകയാണെന്ന്,0,0,1,1
26988,petrolífero,0,0,1,1
26989,"
माल्टी",0,0,1,1
26990,persona​,0,0,1,1
26992,payant,0,0,1,1
26993,umursayamam,0,0,1,1
26994,συνειδητοποιήσω,0,0,1,1
26911,publiquement,0,0,1,1
26909,danois,0,0,1,1
26808,استضافة,0,0,1,1
26830,woordgroepen,0,0,1,1
26832,classic,0,0,1,1
26836,മാതൃകയെ,0,0,1,1
26837,«введите,0,0,1,1
26839,εμείς,0,0,1,1
26840,эгоистичный,0,0,1,1
26842,அர்த்தங்கள்,0,0,1,1
26846,tiny,0,0,1,1
26848,παραδοσιακές,0,0,1,1
26849,മധുരമുള്ള,0,0,1,1
26850,cümlenin,0,0,1,1
26851,нах,0,0,1,1
26852,"
फ़ारसी",0,0,1,1
26854,താല്പര്യമുള്ള,0,0,1,1
26855,நுபீடியாவிலிருந்த,0,0,1,1
26857,bazıları,0,0,1,1
26831,сотен,0,0,1,1
26829,recourir,0,0,1,1
26908,ഉറങ്ങുമ്പോൾ,0,0,1,1
26828,ενθαρρύνεις,0,0,1,1
26811,delicioso,0,0,1,1
26812,personaje,0,0,1,1
26813,açıkla,0,0,1,1
26814,verificación,0,0,1,1
26815,ссылкой,0,0,1,1
26816,lus,0,0,1,1
26817,तीसरी,0,0,1,1
26818,aktivera,0,0,1,1
26820,vermeld,0,0,1,1
26821,industrializados,0,0,1,1
26822,mencionado,0,0,1,1
26823,alten,0,0,1,1
26825,experienced,0,0,1,1
26826,ആശയസംഘട്ടനങ്ങൾ,0,0,1,1
26827,conditionne,0,0,1,1
26859,أخبرتهم,0,0,1,1
26860,تدين,0,0,1,1
26863,weggestuurd,0,0,1,1
26864,историю,0,0,1,1
26888,figuras,0,0,1,1
26889,vérifiables,0,0,1,1
26893,γίνουμε,0,0,1,1
26894,onafhankelijk,0,0,1,1
26895,cenar,0,0,1,1
26896,كلاسيكية,0,0,1,1
26897,медлительный,0,0,1,1
26898,ದೂರುವುದು,0,0,1,1
26899,"
मलय",0,0,1,1
26900,οποιεσδήποτε,0,0,1,1
26901,periods,0,0,1,1
26903,पुस्क्तकों,0,0,1,1
26904,ejakulation,0,0,1,1
26905,मालूम।,0,0,1,1
26906,reputadas,0,0,1,1
26887,ملحمي,0,0,1,1
26886,primitif,0,0,1,1
26884,capítulos,0,0,1,1
26872,ptmwikipediaorg,0,0,1,1
26865,contestadas,0,0,1,1
26866,breit,0,0,1,1
26868,söylüyordun,0,0,1,1
26869,sleeping,0,0,1,1
26870,идет,0,0,1,1
26871,gülmeye,0,0,1,1
26873,تعاونياً,0,0,1,1
26883,hør,0,0,1,1
26874,reprendre,0,0,1,1
26875,будете,0,0,1,1
26876,बतलाता,0,0,1,1
26878,расходятся,0,0,1,1
26879,ψάχνετε,0,0,1,1
26880,ತೊಂದರೆಗೊಳಗಾಗಲು,0,0,1,1
26580,التنقيب,0,0,1,1
26579,adicionada,0,0,1,1
26578,വിവരത്തെ,0,0,1,1
26246,wordsense,0,0,1,1
26248,ethics,0,0,1,1
26253,attracts,0,0,1,1
26254,прямую,0,0,1,1
26255,शूरवीर,0,0,1,1
26256,മനസിലാക്കിയാൽ,0,0,1,1
26257,ألتو,0,0,1,1
26259,disclose,0,0,1,1
26260,continuant,0,0,1,1
26261,eigendom,0,0,1,1
26262,dawikipediaorg,0,0,1,1
26263,reappeared,0,0,1,1
26265,inverificáveis,0,0,1,1
26266,φανταστικά,0,0,1,1
26267,ಫಿಕ್ಸ್,0,0,1,1
26269,ಪ್ರೀತಿಸುತ್ತೀರಿ,0,0,1,1
26247,ಪ್ರಾರಂಭಿಸೋಣ,0,0,1,1
26245,stockholms,0,0,1,1
26216,ಸಂಭಾಷಣೆಯನ್ನು,0,0,1,1
26244,مديرو,0,0,1,1
26218,вопросы,0,0,1,1
26222,осуществляют,0,0,1,1
26224,بكم,0,0,1,1
26226,исследовательский,0,0,1,1
26228,vindos,0,0,1,1
26229,stalin,0,0,1,1
26230,wikiality​,0,0,1,1
26231,ഉദ്ധരിച്ചാണ്,0,0,1,1
26233,தொடங்கினாள்,0,0,1,1
26235,resumos,0,0,1,1
26238,salud​,0,0,1,1
26240,copyrights,0,0,1,1
26241,oprindelser,0,0,1,1
26242,поиска,0,0,1,1
26243,specifieke,0,0,1,1
26270,നീ,0,0,1,1
26271,telephone,0,0,1,1
26272,unfeasible,0,0,1,1
26273,bağımsız,0,0,1,1
26302,verrez,0,0,1,1
26303,thmostvisited,0,0,1,1
26304,overmatige,0,0,1,1
26305,d’évaluation,0,0,1,1
26306,eski,0,0,1,1
26307,zij,0,0,1,1
26308,discern,0,0,1,1
26309,ordagrant,0,0,1,1
26310,bâtir,0,0,1,1
26311,prospectivement,0,0,1,1
26312,stormachtig,0,0,1,1
26313,aner,0,0,1,1
26314,अभिधान,0,0,1,1
26318,lessem,0,0,1,1
26319,независимо,0,0,1,1
26301,ideias,0,0,1,1
26298,പുലർത്തുക,0,0,1,1
26297,சாதனையாக,0,0,1,1
26283,الجاني,0,0,1,1
26274,fdims,0,0,1,1
26275,ಹುಚ್ಚನಂತೆ,0,0,1,1
26278,ലേഖനമെഴുതാനുദ്ദേശിക്കുന്ന,0,0,1,1
26280,allmänbildning,0,0,1,1
26281,diversiteit,0,0,1,1
26282,нейросетях,0,0,1,1
26284,benötigen,0,0,1,1
26294,antissocial,0,0,1,1
26285,nationell,0,0,1,1
26287,responsabilités,0,0,1,1
26288,artículos»,0,0,1,1
26290,isteğinde,0,0,1,1
26291,لطيف,0,0,1,1
26293,بلا,0,0,1,1
26217,പ്രശ്‌നമില്ല,0,0,1,1
26215,nævnt,0,0,1,1
26576,dioxide,0,0,1,1
26121,dr,0,0,1,1
26123,çıkarmanız,0,0,1,1
26127,intéressantes,0,0,1,1
26128,sanırım,0,0,1,1
26129,المتناقضة,0,0,1,1
26131,δάχτυλά,0,0,1,1
26135,mirando,0,0,1,1
26136,découvrir,0,0,1,1
26138,έρχονται,0,0,1,1
26139,förespråkare,0,0,1,1
26140,aufgeregt,0,0,1,1
26141,existía,0,0,1,1
26142,sostuvo,0,0,1,1
26143,பாதுகாப்பு,0,0,1,1
26144,ಕೇಳುವುದು,0,0,1,1
26146,suffisante,0,0,1,1
26122,değiştirmektedir,0,0,1,1
26118,differing,0,0,1,1
26214,уэйлса,0,0,1,1
26117,закрыть,0,0,1,1
26091,ämnesorienterade,0,0,1,1
26095,company,0,0,1,1
26097,gebruikelijke,0,0,1,1
26098,चलना,0,0,1,1
26100,ಖಚಿತವಾಗಿದೆಯೆ,0,0,1,1
26103,тегами,0,0,1,1
26104,sorarsa,0,0,1,1
26107,gülümsemesini,0,0,1,1
26108,واضحة,0,0,1,1
26109,patiemment,0,0,1,1
26111,contemplados,0,0,1,1
26112,suddas,0,0,1,1
26113,அதற்கான,0,0,1,1
26115,sel,0,0,1,1
26116,लटकाओ।,0,0,1,1
26147,manuais,0,0,1,1
26148,داخل,0,0,1,1
26152,सहायक,0,0,1,1
26154,எடுத்துக்காட்டுகளைப்,0,0,1,1
26189,logowedstrijd,0,0,1,1
26190,gibiler,0,0,1,1
26191,bordmanerer,0,0,1,1
26194,acreditada,0,0,1,1
26198,slight,0,0,1,1
26199,identifiquen,0,0,1,1
26202,количество,0,0,1,1
26204,தயாரித்தேன்,0,0,1,1
26205,"
थाई",0,0,1,1
26206,mentionnent,0,0,1,1
26207,construcción»,0,0,1,1
26208,batholiths,0,0,1,1
26209,плачущий,0,0,1,1
26210,புரிந்துகொள்வதில்,0,0,1,1
26212,refleja,0,0,1,1
26188,stance,0,0,1,1
26185,rendezvoussmartwort,0,0,1,1
26184,medewerkers,0,0,1,1
26169,gardens,0,0,1,1
26157,basicamente,0,0,1,1
26158,revisados,0,0,1,1
26159,പറ്റില്ല,0,0,1,1
26160,dilemas,0,0,1,1
26163,χαζή,0,0,1,1
26165,столь,0,0,1,1
26171,एटरीब्यूशनशेयर,0,0,1,1
26183,caída,0,0,1,1
26173,فأحب,0,0,1,1
26174,ഫ്ലംമോക്സായി,0,0,1,1
26175,relus,0,0,1,1
26176,மென்பொருளில்,0,0,1,1
26178,दोंनों,0,0,1,1
26181,agência,0,0,1,1
26320,kütüphanenin,0,0,1,1
26321,versionshantering,0,0,1,1
26322,ഭാഷകളും,0,0,1,1
26474,തെറ്റെഴുതിയാൽ,0,0,1,1
26479,σωστή,0,0,1,1
26480,debates,0,0,1,1
26481,llegar,0,0,1,1
26483,digitizing,0,0,1,1
26484,ممكنة,0,0,1,1
26486,मैली,0,0,1,1
26488,चाहें,0,0,1,1
26490,നാട്ടറിവുകൾ,0,0,1,1
26491,deputy,0,0,1,1
26494,düzeltilmesini,0,0,1,1
26495,എവിടെയായിരുന്നു,0,0,1,1
26496,चाहेंगे,0,0,1,1
26498,agreement,0,0,1,1
26499,olduğuydu,0,0,1,1
26502,ചായ്‌വ്,0,0,1,1
26477,ಟಕ್ಕೆ,0,0,1,1
26473,pieds,0,0,1,1
26323,tokens,0,0,1,1
26471,वित्तपोषण,0,0,1,1
26445,уловки,0,0,1,1
26447,علمت,0,0,1,1
26448,computerprogrammeur,0,0,1,1
26449,लगता।,0,0,1,1
26451,uitgehongerd,0,0,1,1
26452,цифрах,0,0,1,1
26453,മനസിലാക്കുകയും,0,0,1,1
26454,izliyordu,0,0,1,1
26455,financement,0,0,1,1
26460,ரகசியமான,0,0,1,1
26461,предоставляется,0,0,1,1
26462,déclarer,0,0,1,1
26464,மாலில்,0,0,1,1
26465,spaces,0,0,1,1
26466,ലിപിയിൽ,0,0,1,1
26503,onjuist,0,0,1,1
26504,ഐ,0,0,1,1
26505,ബാങ്ക്‌,0,0,1,1
26507,işin,0,0,1,1
26544,инструмент,0,0,1,1
26547,categorização,0,0,1,1
26548,مقابل,0,0,1,1
26551,ಅವರಲ್ಲಿ,0,0,1,1
26552,άνθρωπος,0,0,1,1
26556,функция,0,0,1,1
26559,düşürürseniz,0,0,1,1
26560,konstaterar,0,0,1,1
26561,дополнение,0,0,1,1
26563,yokmuş,0,0,1,1
26566,stond,0,0,1,1
26568,യൂണികോഡ്,0,0,1,1
26572,expliquez,0,0,1,1
26573,ಬಡ್ತಿ,0,0,1,1
26574,ஆதாயம்,0,0,1,1
26543,ചിലപ്പോഴെല്ലാം,0,0,1,1
26541,слез,0,0,1,1
26538,διαμαρτύρεται,0,0,1,1
26520,yolculuktan,0,0,1,1
26511,chegando,0,0,1,1
26513,ನಿಷ್ಠುರ,0,0,1,1
26514,ഹിക്കുന്നതുപോലെ,0,0,1,1
26515,bottar,0,0,1,1
26516,ಕೊಡುಗೆಗಳನ್ನು,0,0,1,1
26519,monday,0,0,1,1
26521,harías,0,0,1,1
26536,சூப்பில்,0,0,1,1
26522,grundaren,0,0,1,1
26526,rangeringsystem,0,0,1,1
26528,princípio,0,0,1,1
26533,microbes,0,0,1,1
26534,destin ,0,0,1,1
26535,നിർജീവമാണ്,0,0,1,1
26443,yazılmaktadır,0,0,1,1
26441,ടെറിയോടും,0,0,1,1
26440,издавался,0,0,1,1
26385,mediawiki —,0,0,1,1
26355,koppla,0,0,1,1
26360,إنترنت,0,0,1,1
26361,derseniz,0,0,1,1
26364,encuentra,0,0,1,1
26366,പങ്കിടാൻ,0,0,1,1
26367,verreweg,0,0,1,1
26368,डिस्क्स,0,0,1,1
26370,ikinci,0,0,1,1
26373,broadcast,0,0,1,1
26376,lanzó,0,0,1,1
26377,لتشجيع,0,0,1,1
26378,regrouper,0,0,1,1
26379,بالمشاريع,0,0,1,1
26381,ಒಳ್ಳೆಯವನಾಗಿದ್ದೆ,0,0,1,1
26382,unmanned,0,0,1,1
26354,startades,0,0,1,1
26350,έλα,0,0,1,1
26347,اسمحوا,0,0,1,1
26332,நினைக்கலாம்,0,0,1,1
26324,morimos,0,0,1,1
26326,fulllength,0,0,1,1
26327,grootte,0,0,1,1
26328,sanger​,0,0,1,1
26329,amuse,0,0,1,1
26331,வேர்கள்,0,0,1,1
26333,أفادت,0,0,1,1
26346,"
गैलिसियाई",0,0,1,1
26336,excuse,0,0,1,1
26339,participante,0,0,1,1
26340,വായനക്കാരുടേയും,0,0,1,1
26341,جنو,0,0,1,1
26342,الطاقة,0,0,1,1
26345,kaçınılır,0,0,1,1
26383,proibições,0,0,1,1
26386,सुझाव।,0,0,1,1
26438,ಓದುತ್ತಿದ್ದೇನೆ,0,0,1,1
26387,stoppe,0,0,1,1
26413,للتسجيل,0,0,1,1
26416,использована,0,0,1,1
26418,البذاءة,0,0,1,1
26419,repairing,0,0,1,1
26420,västerländska,0,0,1,1
26422,trophic,0,0,1,1
26423,whereas,0,0,1,1
26425,വിചാരിക്കുന്നില്ല,0,0,1,1
26426,unter,0,0,1,1
26427,yazılarına,0,0,1,1
26428,enhancements,0,0,1,1
26429,incredible,0,0,1,1
26431,प्रोटेस्टर,0,0,1,1
26432,ركضت,0,0,1,1
26437,wikipediaresurser,0,0,1,1
26411,ರೋಮಾಂಚನಕಾರಿ,0,0,1,1
26410,materializó,0,0,1,1
26408,маркой,0,0,1,1
26394,coût,0,0,1,1
26388,ஆதாரம்,0,0,1,1
26389,bagunçado,0,0,1,1
26390,mismo​,0,0,1,1
26391,sounds,0,0,1,1
26392,टूटा,0,0,1,1
26393,cocacola,0,0,1,1
26395,duyun,0,0,1,1
26405,लाइक,0,0,1,1
26396,uğramasını,0,0,1,1
26398,συγχαρώ,0,0,1,1
26399,zalimce,0,0,1,1
26400,மந்தமாகிவிட்டது,0,0,1,1
26401,stoppa,0,0,1,1
26402,émergeant,0,0,1,1
27022,tallerken,0,0,1,1
27023,वेर्कस्टाट,0,0,1,1
27027,preferring,0,0,1,1
27641,vaso,0,0,1,1
27645,വസ്ത്രത്തിൽ,0,0,1,1
27646,ಕೇಳಿ,0,0,1,1
27649,iddia,0,0,1,1
27651,febrero,0,0,1,1
27652,எதையும்,0,0,1,1
27653,சுயாதீனமாக,0,0,1,1
27655,വിക്കിപീഡിയരേയും,0,0,1,1
27656,beweegt,0,0,1,1
27657,establecidos,0,0,1,1
27658,منسوبة,0,0,1,1
27662,hap,0,0,1,1
27663,seslendirilmiş,0,0,1,1
27664,ertrinke,0,0,1,1
27665,hole,0,0,1,1
27667,vraagteken,0,0,1,1
27643,bezoek,0,0,1,1
27640,infört,0,0,1,1
27616,parçasıdır,0,0,1,1
27639,المتطوعين،,0,0,1,1
27619,பொதுவில்,0,0,1,1
27620,प्रविष्टियाँ,0,0,1,1
27621,utseendet,0,0,1,1
27623,bırakılmış,0,0,1,1
27624,ഇബ്സൻ,0,0,1,1
27626,administratör,0,0,1,1
27627,rce,0,0,1,1
27629,hatan,0,0,1,1
27631,حركة,0,0,1,1
27632,mfl,0,0,1,1
27633,செய்யக்கூடாது,0,0,1,1
27634,begegnete,0,0,1,1
27635,കൂട്ടിച്ചേർത്തെന്നുവരും,0,0,1,1
27636,kullanılıyordu,0,0,1,1
27637,ಅರ್ಥವಾಗಿದೆ,0,0,1,1
27668,നോക്കിയിരുന്നു,0,0,1,1
27675,ಆಡುಮಾತಿನಂತಿದೆ,0,0,1,1
27676,പാവയും,0,0,1,1
27677,الرئيس,0,0,1,1
27704,indonesië,0,0,1,1
27706,استشهدت,0,0,1,1
27707,കുഴപ്പത്തിലാണ്,0,0,1,1
27708,tillförlitlig,0,0,1,1
27710,посвящённые,0,0,1,1
27711,derecho,0,0,1,1
27712,aggregate,0,0,1,1
27714,ലഭിക്കണമെങ്കിൽ,0,0,1,1
27715,столкнулся,0,0,1,1
27716,نكتة,0,0,1,1
27717,thermohaline,0,0,1,1
27720,ಹೇಳಲಾರೆ,0,0,1,1
27721,வேகமாக,0,0,1,1
27722,перелицензировать,0,0,1,1
27723,рой,0,0,1,1
27701,αναφέρει,0,0,1,1
27700,basins,0,0,1,1
27698,vogels,0,0,1,1
27686,dificuldade,0,0,1,1
27678,इंटरफ़ेस,0,0,1,1
27681,traducciones,0,0,1,1
27682,partenariats,0,0,1,1
27683,personnage,0,0,1,1
27684,«объект,0,0,1,1
27685,zus,0,0,1,1
27687,yakutların,0,0,1,1
27696,snapte,0,0,1,1
27689,auktoritetsbristen,0,0,1,1
27690,നല്കുന്നതുമായ,0,0,1,1
27692,وبهذا,0,0,1,1
27693,colocar,0,0,1,1
27694,étudiés,0,0,1,1
27695,abouti,0,0,1,1
27618,contraignants,0,0,1,1
27614,employee,0,0,1,1
27501,സംസ്കാരവും,0,0,1,1
27527,باحثون,0,0,1,1
27530,envoyé,0,0,1,1
27535,corretos,0,0,1,1
27536,finance,0,0,1,1
27537,fehlern,0,0,1,1
27541,ψυχικά,0,0,1,1
27542,bg •,0,0,1,1
27545,الخيارات,0,0,1,1
27546,sire,0,0,1,1
27547,de ,0,0,1,1
27548,relativas,0,0,1,1
27550,குறியீட்டு,0,0,1,1
27551,مثلا،,0,0,1,1
27553,vele,0,0,1,1
27554,independiente,0,0,1,1
27555,ഔട്ട്പുട്ടിലേക്കുള്ള,0,0,1,1
27528,coke,0,0,1,1
27524,ഉപയോക്താക്കളുടെ,0,0,1,1
27613,prinz,0,0,1,1
27523,acadêmico,0,0,1,1
27503,toleransen,0,0,1,1
27504,βρώσιμο,0,0,1,1
27508,الفارسية,0,0,1,1
27510,करूँगी,0,0,1,1
27511,തനതുവ്യക്തിത്വമുള്ള,0,0,1,1
27512,upwards,0,0,1,1
27513,evolucionando,0,0,1,1
27514,perjuicio,0,0,1,1
27515,afirmación,0,0,1,1
27516,проявляется,0,0,1,1
27518,количества,0,0,1,1
27519,siffran,0,0,1,1
27520,ഇതര,0,0,1,1
27521,غرفة,0,0,1,1
27522,ലഭിക്കേണ്ടതാണ്,0,0,1,1
27557,ಹೇಗಿದ್ದೀರಿ,0,0,1,1
27558,linked,0,0,1,1
27559,«квадрига»,0,0,1,1
27560,உறுதிப்படுத்தப்படாத,0,0,1,1
27586,başarılı,0,0,1,1
27588,restaurar,0,0,1,1
27589,veas,0,0,1,1
27590,inattendues,0,0,1,1
27591,ಕೇಳದಿದ್ದಾಗ,0,0,1,1
27596,സൃഷ്ടിക്കപ്പെട്ടിരിക്കുന്ന,0,0,1,1
27597,உண்மையான,0,0,1,1
27600,colocó,0,0,1,1
27601,уволены,0,0,1,1
27605,വ്യാപകമായി,0,0,1,1
27606,حيوان,0,0,1,1
27608,appareils,0,0,1,1
27609,बनाम,0,0,1,1
27610,marche ,0,0,1,1
27611,பங்களிப்புகளைப்,0,0,1,1
27585,dupla,0,0,1,1
27584,probablemente,0,0,1,1
27583,abschied,0,0,1,1
27569,പോകാനുള്ള,0,0,1,1
27561,semibeskyttet,0,0,1,1
27562,تعاونية,0,0,1,1
27563,контринтуитивную,0,0,1,1
27564,yapabilirler,0,0,1,1
27565,σύνταξη,0,0,1,1
27566,hohe,0,0,1,1
27570,uppenbart,0,0,1,1
27578,unevenness,0,0,1,1
27571,"
कोमी",0,0,1,1
27572,ஸ்டால்மன்,0,0,1,1
27574,calidad​,0,0,1,1
27575,സ്വപ്‌നം,0,0,1,1
27576,ನೋಡುತ್ತಿದ್ದಾರೆ,0,0,1,1
27577,volumen,0,0,1,1
27724,describió,0,0,1,1
27725,företagens,0,0,1,1
27726,μέχρι,0,0,1,1
27869,предсказывать,0,0,1,1
27872,afkomstig,0,0,1,1
27874,syriska,0,0,1,1
27875,loadbalancing,0,0,1,1
27876,എഴുതപ്പെടുന്ന,0,0,1,1
27877,свойственна,0,0,1,1
27878,പ്രവേശിച്ചുവെങ്കിൽ,0,0,1,1
27880,നാളത്തേക്ക്,0,0,1,1
27881,κούκλα,0,0,1,1
27883,συστηματική,0,0,1,1
27885,കണ്ണാടിയിലോ,0,0,1,1
27887,пообещал,0,0,1,1
27892,momentos,0,0,1,1
27893,stirrede,0,0,1,1
27894,aangetroffen,0,0,1,1
27895,காதலன்,0,0,1,1
27871,dynamics,0,0,1,1
27868,auxiliar,0,0,1,1
27727,संघ,0,0,1,1
27862,мировым,0,0,1,1
27833,കൂടുതലും,0,0,1,1
27837,poursuivre,0,0,1,1
27840,vendría,0,0,1,1
27842,अवसर,0,0,1,1
27843,கூடுவன,0,0,1,1
27847,grammaire,0,0,1,1
27848,interwikis,0,0,1,1
27849,использовался,0,0,1,1
27850,« fin,0,0,1,1
27853,сводятся,0,0,1,1
27854,ചെയ്താണ്,0,0,1,1
27855,ഒന്നോ,0,0,1,1
27856,diras,0,0,1,1
27860,समीक्षाओं,0,0,1,1
27861,satan,0,0,1,1
27896,مقدما,0,0,1,1
27897,importants,0,0,1,1
27899,professionella,0,0,1,1
27900,predesignated,0,0,1,1
27926,administrativa,0,0,1,1
27927,directmedia,0,0,1,1
27929,hızlandı,0,0,1,1
27930,öğrenelim,0,0,1,1
27931,இலகுவில்,0,0,1,1
27934,gevonden,0,0,1,1
27935,länkning,0,0,1,1
27936,വരാം,0,0,1,1
27937,feraisje,0,0,1,1
27940,pocas,0,0,1,1
27941,ಅಸಭ್ಯವಾಗಿ,0,0,1,1
27942,शिक्षाविदों,0,0,1,1
27943,νωρίτερα,0,0,1,1
27944,двойных,0,0,1,1
27946,ಬಂದ,0,0,1,1
27922,بالك؟,0,0,1,1
27921,несъедобным,0,0,1,1
27919,derslerimi,0,0,1,1
27908,இணையத்தில்,0,0,1,1
27901,alleged,0,0,1,1
27902,verbose,0,0,1,1
27903,அறிமுகப்படுத்தியது,0,0,1,1
27904,clasificarse,0,0,1,1
27905,ссылаясь,0,0,1,1
27906,cs •,0,0,1,1
27909,séquences,0,0,1,1
27918,ಇದ್ದಕ್ಕಿದ್ದಂತೆ,0,0,1,1
27910,دانيال,0,0,1,1
27911,annotated,0,0,1,1
27913,offrir,0,0,1,1
27915,സൃഷ്ടിച്ചു,0,0,1,1
27916,tente,0,0,1,1
27917,existido,0,0,1,1
27832,лучшую,0,0,1,1
27831,zaken,0,0,1,1
27830,valioso,0,0,1,1
27777,أتلانتيك,0,0,1,1
27758,τύχης,0,0,1,1
27759,instrumento,0,0,1,1
27760,anlat,0,0,1,1
27761,பரிந்துரை,0,0,1,1
27762,remonte,0,0,1,1
27764,critère,0,0,1,1
27766,kapot,0,0,1,1
27768,свободным,0,0,1,1
27769,கண்டது,0,0,1,1
27770,tendría,0,0,1,1
27771,galardonada,0,0,1,1
27772,bedömas,0,0,1,1
27773,redaktionella,0,0,1,1
27774,capacidade,0,0,1,1
27775,overhand,0,0,1,1
27757,аспирантом,0,0,1,1
27754,leaving,0,0,1,1
27753,இறுதிகளிலும்,0,0,1,1
27739,உணவுகளையும்,0,0,1,1
27730,abordan,0,0,1,1
27731,admiten,0,0,1,1
27732,inclut,0,0,1,1
27733,предпочтения,0,0,1,1
27737,periodista,0,0,1,1
27738,जाकर,0,0,1,1
27740,ederken,0,0,1,1
27751,φυλακές,0,0,1,1
27741,ലഭ്യമായതിനാൽ,0,0,1,1
27742,академик,0,0,1,1
27744,ಪ್ರಶ್ನಾರ್ಥಕ,0,0,1,1
27746,великой,0,0,1,1
27747,ഇൻപുട്ടിൽ,0,0,1,1
27749,methodology,0,0,1,1
27776,opgewonden,0,0,1,1
27778,apparent,0,0,1,1
27827,vía,0,0,1,1
27780,récapitulant,0,0,1,1
27810,indecent,0,0,1,1
27811,чувствуете,0,0,1,1
27813,огромного,0,0,1,1
27814,roches,0,0,1,1
27816,deveríamos,0,0,1,1
27817,basados,0,0,1,1
27818,συνειδητοποιήσετε,0,0,1,1
27819,ஃபேஸ்புக்,0,0,1,1
27820,திட்டங்களைச்,0,0,1,1
27821,yiyecek,0,0,1,1
27822,красивых,0,0,1,1
27823,eliminaria,0,0,1,1
27824,« repose,0,0,1,1
27825,masculine,0,0,1,1
27826,хороший,0,0,1,1
27806,متاحًا,0,0,1,1
27805,vikisözlük,0,0,1,1
27803,эпизодах,0,0,1,1
27791,frivilliga,0,0,1,1
27781,beskrive,0,0,1,1
27782,suceden,0,0,1,1
27783,читателям,0,0,1,1
27786,honderden,0,0,1,1
27787,væsener,0,0,1,1
27788,görülebilir,0,0,1,1
27794,ημιτελής,0,0,1,1
27802,protests,0,0,1,1
27795,मूलभूत,0,0,1,1
27796,குழப்பிவிட்டேன்,0,0,1,1
27797,paso,0,0,1,1
27799,सम्मानित,0,0,1,1
27800,alfabetos,0,0,1,1
27801,نشرها,0,0,1,1
27502,вирджиния,0,0,1,1
27500,مخطئ,0,0,1,1
27028,ഇടാൻ,0,0,1,1
27171,"
टाटर",0,0,1,1
27174,raccorder,0,0,1,1
27175,പ്രൊജക്റ്റിനു,0,0,1,1
27176,ಉಡುಪಿನಲ್ಲಿದ್ದಾಗ,0,0,1,1
27177,​​till,0,0,1,1
27178,almuerzo,0,0,1,1
27179,संदेह,0,0,1,1
27180,माध्यमिक,0,0,1,1
27182,existência,0,0,1,1
27189,اختلافات,0,0,1,1
27190,passé,0,0,1,1
27191,olanak,0,0,1,1
27192,severler,0,0,1,1
27193,يقارب,0,0,1,1
27194,bn •,0,0,1,1
27195,nutteloos,0,0,1,1
27173,city,0,0,1,1
27170,immangeable,0,0,1,1
27142,comprobar,0,0,1,1
27168,casualidad,0,0,1,1
27146,വകതിരിക്കാൻ,0,0,1,1
27147,equivalent,0,0,1,1
27150,അമർത്തി,0,0,1,1
27151,ضغطت,0,0,1,1
27152,механизма,0,0,1,1
27153,caparazón,0,0,1,1
27154,ressembles,0,0,1,1
27155,profunda,0,0,1,1
27157,грандиозная,0,0,1,1
27158,​​ontmoetingsplaats,0,0,1,1
27160,वैज्ञानिक,0,0,1,1
27161,tritt,0,0,1,1
27162,producto,0,0,1,1
27163,فامنحه,0,0,1,1
27167,കടന്നുപോകാൻ,0,0,1,1
27197,reduce,0,0,1,1
27198,تغرق,0,0,1,1
27199,vivent,0,0,1,1
27200,factorization,0,0,1,1
27233,tempérées,0,0,1,1
27234,modernere,0,0,1,1
27235,högtalaren,0,0,1,1
27236,néanmoins,0,0,1,1
27239,أنف,0,0,1,1
27240,filosóficas,0,0,1,1
27241,изумрудов,0,0,1,1
27243,eqiad,0,0,1,1
27244,våra,0,0,1,1
27245,acerta,0,0,1,1
27246,wikilibros,0,0,1,1
27247,olayları,0,0,1,1
27248,getroffen,0,0,1,1
27249,corchetes,0,0,1,1
27251,கற்பழிப்பு,0,0,1,1
27232,الاصطناعي,0,0,1,1
27231,äldsta,0,0,1,1
27228,décourager,0,0,1,1
27211,सिविल,0,0,1,1
27201,σκέφτεται,0,0,1,1
27203,effectuées,0,0,1,1
27204,ആശയക്കുഴപ്പത്തിലാക്കുക,0,0,1,1
27205,बहुस्तरीय,0,0,1,1
27206,påbörja,0,0,1,1
27208,zorundasın,0,0,1,1
27214,ചെറുതും,0,0,1,1
27227,വിക്കിപീഡിയർക്കായുള്ള,0,0,1,1
27217,शाब्दिक,0,0,1,1
27219,limités,0,0,1,1
27223,ಸುಂದರವಾಗಿದ್ದನು,0,0,1,1
27224,"
इण्डोनेशियाई",0,0,1,1
27225,disiez,0,0,1,1
27226,seçkin,0,0,1,1
27145,минутный,0,0,1,1
27141,inclusionism,0,0,1,1
27499,gravedad,0,0,1,1
27059,escolhas,0,0,1,1
27061,subkultur,0,0,1,1
27063,تحت,0,0,1,1
27064,नही।,0,0,1,1
27065,delivered,0,0,1,1
27067,konular,0,0,1,1
27068,marchó,0,0,1,1
27069,ontworpen,0,0,1,1
27070,निकाल,0,0,1,1
27071,sentar,0,0,1,1
27072,ಪರಸ್ಪರ,0,0,1,1
27073,falsedades,0,0,1,1
27074,χαμόγελα,0,0,1,1
27075,comum,0,0,1,1
27076,ಗೊಂದಲಕ್ಕೊಳಗಾದವು,0,0,1,1
27077,lebensmitteln,0,0,1,1
27060,предназначенная,0,0,1,1
27058,ತಿಳಿದಿರುವುದರಿಂದ,0,0,1,1
27140,अनियन,0,0,1,1
27057,sophistiqués,0,0,1,1
27029,अरबी,0,0,1,1
27030,avisam,0,0,1,1
27032,அதோடு,0,0,1,1
27035,grönvall,0,0,1,1
27037,tarif,0,0,1,1
27039,преданная,0,0,1,1
27041,spawned,0,0,1,1
27046,unrelated,0,0,1,1
27047,evlenme,0,0,1,1
27050,juxtaposition,0,0,1,1
27052,катализатор,0,0,1,1
27053,doutoranda,0,0,1,1
27054,संसद,0,0,1,1
27055,canadá,0,0,1,1
27056,olmasıdır,0,0,1,1
27081,ശ്രമിക്കുന്നു,0,0,1,1
27082,இருந்தனர்,0,0,1,1
27083,वास्तुकला,0,0,1,1
27084,салаты,0,0,1,1
27120,toman,0,0,1,1
27121,systematisk,0,0,1,1
27122,sevk,0,0,1,1
27126,കണ്ടെത്താം,0,0,1,1
27127,प्रसारित,0,0,1,1
27128,intelectual,0,0,1,1
27129,கண்காணிப்பு,0,0,1,1
27130,learning‏,0,0,1,1
27132,असाधारण,0,0,1,1
27134,कॉपी,0,0,1,1
27135,parcialmente,0,0,1,1
27136,paciencia,0,0,1,1
27137,ícono,0,0,1,1
27138,spisestuen,0,0,1,1
27139,पात्रों,0,0,1,1
27116,opened,0,0,1,1
27115,usaria,0,0,1,1
27114,erwähnt,0,0,1,1
27094,japonés,0,0,1,1
27085,ಇಂಗ್ಲಿಷ್‌ನಲ್ಲಿ,0,0,1,1
27086,تعيشها,0,0,1,1
27088,основателя,0,0,1,1
27089,oluşturma,0,0,1,1
27091,ತೀಕ್ಷ್ಣವಾದ,0,0,1,1
27093,custo,0,0,1,1
27096,réalisait,0,0,1,1
27110,sl •,0,0,1,1
27097,மோசமான,0,0,1,1
27098,ಫ್ರೆಂಚ್,0,0,1,1
27100,मजेदार,0,0,1,1
27101,extérieures,0,0,1,1
27105,mamãe,0,0,1,1
27109,rattachés,0,0,1,1
27252,व्यवधान,0,0,1,1
27253,запросу,0,0,1,1
27255,വസ്ത്രം,0,0,1,1
27418,человеческой,0,0,1,1
27420,upphovspersonerna,0,0,1,1
27423,بوجود,0,0,1,1
27424,أراه,0,0,1,1
27425,لتهنئة,0,0,1,1
27427,sinkt,0,0,1,1
27429,caducar,0,0,1,1
27430,dibujada,0,0,1,1
27433,techniciens,0,0,1,1
27434,ചെയ്യാനോ,0,0,1,1
27435,चीयर्स,0,0,1,1
27436,schönsten,0,0,1,1
27442,गड़बड़,0,0,1,1
27444,dijera,0,0,1,1
27446,تتسكع,0,0,1,1
27447,تستطع,0,0,1,1
27419,sömnen,0,0,1,1
27415,supervise,0,0,1,1
27256,написанный,0,0,1,1
27411,فلماذا,0,0,1,1
27385,കോമൺസ്,0,0,1,1
27386,മന്ദത,0,0,1,1
27387,discutiu,0,0,1,1
27389,внесённые,0,0,1,1
27390,kommentieren,0,0,1,1
27392,γνωστή,0,0,1,1
27394,averió,0,0,1,1
27396,ಅಂತಹ,0,0,1,1
27398,характерной,0,0,1,1
27400,суд,0,0,1,1
27401,इकलौती,0,0,1,1
27406,സംസാരിക്കുന്നത്,0,0,1,1
27407,diversidad,0,0,1,1
27408,aparecem,0,0,1,1
27410,kultiviert,0,0,1,1
27448,दान,0,0,1,1
27449,rosário,0,0,1,1
27452,लिखता,0,0,1,1
27453,nose,0,0,1,1
27479,dirección,0,0,1,1
27480,powerful,0,0,1,1
27482,गुस्से,0,0,1,1
27483,покупать,0,0,1,1
27484,inmensa,0,0,1,1
27485,mevcut,0,0,1,1
27486,верификации,0,0,1,1
27489,secretamente,0,0,1,1
27491,involving,0,0,1,1
27492,erzählte,0,0,1,1
27493,അറിയാവുന്ന,0,0,1,1
27494,എന്നതിൻറെ,0,0,1,1
27495,प्लेटफोर्म,0,0,1,1
27496,hizmetlileri,0,0,1,1
27497,طرقها,0,0,1,1
27477,n’oppose,0,0,1,1
27475,τάση,0,0,1,1
27474,ഇവരേയും,0,0,1,1
27461,विभाजन,0,0,1,1
27454,ನಿಧಾನವಾಗಿದ್ದೇನೆ,0,0,1,1
27455,embrasser,0,0,1,1
27456,ووجهات,0,0,1,1
27458,pantalla,0,0,1,1
27459,veteraner,0,0,1,1
27460,فرنسا,0,0,1,1
27462,ночь,0,0,1,1
27473,സമ്പൂർണവുമായ,0,0,1,1
27466,ജീവിതത്തിലെ,0,0,1,1
27467,podrias,0,0,1,1
27468,konferensartikeln,0,0,1,1
27470,நோக்கம்,0,0,1,1
27471,aanbiedingen,0,0,1,1
27472,exprimée,0,0,1,1
27384,என்பவர்,0,0,1,1
27382,häftigt,0,0,1,1
27381,вопросам,0,0,1,1
27312,достичь,0,0,1,1
27284,viens,0,0,1,1
27285,делаются,0,0,1,1
27287,ಫ್ಲಮ್ಮೋಕ್ಸ್ಡ್,0,0,1,1
27291,evolvement,0,0,1,1
27292,составляла,0,0,1,1
27294,roter,0,0,1,1
27299,краткое,0,0,1,1
27300,للتطوير,0,0,1,1
27303,भड़काने,0,0,1,1
27304,significativos,0,0,1,1
27305,وعمل,0,0,1,1
27306,تستخدم,0,0,1,1
27307,سيمونس,0,0,1,1
27308,росту,0,0,1,1
27309,verktygs,0,0,1,1
27279,глагол,0,0,1,1
27278,уроков,0,0,1,1
27277,стандартном,0,0,1,1
27267,ورفع,0,0,1,1
27259,treatment,0,0,1,1
27260,​​ham,0,0,1,1
27262,distribuer,0,0,1,1
27264,δείξει,0,0,1,1
27265,kökenleri,0,0,1,1
27266,evolutionary,0,0,1,1
27268,lograr,0,0,1,1
27275,scoren,0,0,1,1
27269,явный,0,0,1,1
27270,كارلوس,0,0,1,1
27271,സന്തോഷമായിരിക്കാനും,0,0,1,1
27272,कैलिफोर्निया,0,0,1,1
27273,நண்பனைப்,0,0,1,1
27274,विकिकोट,0,0,1,1
27310,अध्याय,0,0,1,1
27314,yaptıysa,0,0,1,1
27379,أيضا،,0,0,1,1
27317,devese,0,0,1,1
27358,açıda,0,0,1,1
27360,adn ,0,0,1,1
27361,الحقيقة،,0,0,1,1
27362,réservée,0,0,1,1
27363,എന്നിവ,0,0,1,1
27364,comply,0,0,1,1
27365,மற்றவர்,0,0,1,1
27366,поставьте,0,0,1,1
27367,africâner,0,0,1,1
27369,vandalizing,0,0,1,1
27372,skapats,0,0,1,1
27373,ಪ್ರಕಾಶಮಾನವಾದ,0,0,1,1
27374,preference,0,0,1,1
27377,rationnelles,0,0,1,1
27378,автоматизация,0,0,1,1
27357,descendente,0,0,1,1
27356,acumulado,0,0,1,1
27354,рассказывалось,0,0,1,1
27332,discrimination,0,0,1,1
27318,ബ്രെഡിൽ,0,0,1,1
27319,istiyor,0,0,1,1
27321,kafanız,0,0,1,1
27323,stürmisches,0,0,1,1
27325,ही।,0,0,1,1
27328,ødelagt,0,0,1,1
27335,महत्त्व,0,0,1,1
27352,behind,0,0,1,1
27338,وتغيرت,0,0,1,1
27340,informan,0,0,1,1
27343,വിവരിക്കാൻ,0,0,1,1
27345,γλυκό,0,0,1,1
27347,protège,0,0,1,1
27351,cevaplamak,0,0,1,1
29827,author,0,0,1,1
29830,ദ്യോഗിക,0,0,1,1
29831,markant,0,0,1,1
32309,riddare,0,0,1,1
32313,இற்றைப்படுத்தப்படுவதேயாகும்,0,0,1,1
32314,rough,0,0,1,1
32315,вторичный,0,0,1,1
32316,ശ്രമിക്കുകയായിരുന്നു,0,0,1,1
32317,ನೋಡಿದಾಗಿನಿಂದ,0,0,1,1
32319,executiva,0,0,1,1
32320,написанном,0,0,1,1
32324,kaliforniya,0,0,1,1
32326,новую,0,0,1,1
32328,geheimen,0,0,1,1
32329,ആരംഭിക്കുന്നതിനുള്ള,0,0,1,1
32330,വ്യാകരണം,0,0,1,1
32331,கேளுங்கள்,0,0,1,1
32332,«обсуждение»,0,0,1,1
32333,നല്ലതാണെങ്കിൽ,0,0,1,1
32312,creditadas,0,0,1,1
32308,περιγράφεται,0,0,1,1
32276,phrased,0,0,1,1
32306,നിർത്തിയെന്നത്,0,0,1,1
32279,मज़ाक,0,0,1,1
32280,तुलनात्मक,0,0,1,1
32281,திறமூல,0,0,1,1
32283,ಹೋಗುತ್ತದೆ,0,0,1,1
32284,γαλλία,0,0,1,1
32285,അപ്പപ്പോഴത്തെ,0,0,1,1
32286,"
ज़ीलैण्डी",0,0,1,1
32287,ألذ,0,0,1,1
32289,physics,0,0,1,1
32293,ചേർന്നൊരു,0,0,1,1
32300,möjliggör,0,0,1,1
32301,ನಿಮ್ಮಲ್ಲಿ,0,0,1,1
32302,ആശ്ചര്യകരമായ,0,0,1,1
32303,geliyordu,0,0,1,1
32305,angesehen,0,0,1,1
32335,spirituel,0,0,1,1
32336,elders,0,0,1,1
32337,ærligt,0,0,1,1
32338,ünlü,0,0,1,1
32366,നൽ‌കും,0,0,1,1
32367,ko •,0,0,1,1
32368,adaptado,0,0,1,1
32369,specialområden,0,0,1,1
32370,distinguen​,0,0,1,1
32373,omitiendo,0,0,1,1
32374,nonhumains,0,0,1,1
32375,последнюю,0,0,1,1
32377,tegnsætning,0,0,1,1
32378,ഉണ്ടായത്,0,0,1,1
32379,merdé,0,0,1,1
32380,değmediğini,0,0,1,1
32384,بتشجيع,0,0,1,1
32387,πιστέψω,0,0,1,1
32388,öğretmen,0,0,1,1
32365,métiers,0,0,1,1
32363,funções,0,0,1,1
32361,suède,0,0,1,1
32347,εβδομάδα,0,0,1,1
32339,anfang,0,0,1,1
32340,أستمر,0,0,1,1
32341,sınavda,0,0,1,1
32342,olduğunda,0,0,1,1
32344,—se,0,0,1,1
32345,suspender,0,0,1,1
32348,πολύπλοκος,0,0,1,1
32360,apologies,0,0,1,1
32349,"
véneto",0,0,1,1
32350,prochain,0,0,1,1
32352,посмотрим,0,0,1,1
32353,ലിപികളും,0,0,1,1
32354,ओबामा,0,0,1,1
32358,لمجادلتهم,0,0,1,1
32278,പുറത്താക്കിയത്,0,0,1,1
32275,тюрьмах,0,0,1,1
32391,frappant,0,0,1,1
32183,французский,0,0,1,1
32187,സ്ഥാനത്ത്,0,0,1,1
32188,títeres,0,0,1,1
32189,pounds,0,0,1,1
32190,അർത്ഥമാണ്,0,0,1,1
32191,بعنوان,0,0,1,1
32194,ക്ഷമാപണം,0,0,1,1
32195,फर्स्ट,0,0,1,1
32196,وسائل,0,0,1,1
32198,secondaires,0,0,1,1
32199,défunte,0,0,1,1
32202,പണികളിലേതെങ്കിലും,0,0,1,1
32208,derrière,0,0,1,1
32210,şaşırdım,0,0,1,1
32214,வருத்தப்படுகிறார்,0,0,1,1
32215,اقتراحات,0,0,1,1
32186,racistas,0,0,1,1
32182,ಗೋಲ್ಡನ್,0,0,1,1
32274,தொகுப்பாளர்களால்,0,0,1,1
32181,எனக்குப்,0,0,1,1
32156,meistens,0,0,1,1
32159,engouement,0,0,1,1
32161,जेल,0,0,1,1
32162,إفراغ,0,0,1,1
32164,serão,0,0,1,1
32165,sechs,0,0,1,1
32166,μπορούσαν,0,0,1,1
32167,mümkün,0,0,1,1
32168,அதிகப்,0,0,1,1
32169,πλανήτη,0,0,1,1
32171,физиком,0,0,1,1
32172,തേടുകയാണ്,0,0,1,1
32173,материала,0,0,1,1
32177,محظوظًا,0,0,1,1
32180,sökning,0,0,1,1
32216,informe,0,0,1,1
32217,ulykkelig,0,0,1,1
32218,തീരുമാനിക്കേണ്ടതുണ്ട്,0,0,1,1
32221,யாரும்,0,0,1,1
32251,parody,0,0,1,1
32252,بالمحادثة,0,0,1,1
32254,assiette,0,0,1,1
32255,passionnés,0,0,1,1
32256,rectitud,0,0,1,1
32257,ചങ്ങാതിമാർ‌ക്ക്,0,0,1,1
32260,நடந்த,0,0,1,1
32262,yolculuğunuza,0,0,1,1
32263,ತೆಗೆದುಕೊಂಡಿದ್ದೇನೆ,0,0,1,1
32264,പുനർജീവിച്ചു,0,0,1,1
32265,financeiros,0,0,1,1
32266,yiyeceğe,0,0,1,1
32268,ആവാറുണ്ട്,0,0,1,1
32270,kvartal,0,0,1,1
32273,स्कॉट,0,0,1,1
32249,فتتلقى,0,0,1,1
32248,σούπα,0,0,1,1
32247,ifaktor,0,0,1,1
32230,antag,0,0,1,1
32222,متكررة,0,0,1,1
32224,duur,0,0,1,1
32225,milyon,0,0,1,1
32226,كلمتك,0,0,1,1
32227,möchtest,0,0,1,1
32229,automatiquement,0,0,1,1
32232,ಬೇರೇನಾದರೂ,0,0,1,1
32243,पत्र,0,0,1,1
32236,منهجي،,0,0,1,1
32237,soe,0,0,1,1
32238,onaylanmamış,0,0,1,1
32240,പോർട്ടൽ,0,0,1,1
32241,നോക്കാറുണ്ട്,0,0,1,1
32242,ложные,0,0,1,1
32389,нарушения,0,0,1,1
32392,неспособность,0,0,1,1
31685,பீடியா,0,0,1,1
32531,irréductibles,0,0,1,1
32533,researcher,0,0,1,1
32535,förstår,0,0,1,1
32536,primária,0,0,1,1
32537,„википедию“»,0,0,1,1
32541,местности,0,0,1,1
32543,колберт,0,0,1,1
32544,cooperation,0,0,1,1
32545,плачет,0,0,1,1
32547,постоянные,0,0,1,1
32548,வாழ்த்துவதற்கான,0,0,1,1
32552,முடிந்துவிடும்,0,0,1,1
32553,ജീവനുള്ളവളായിരുന്നുവെന്ന്,0,0,1,1
32554,सेवानिवृत्त,0,0,1,1
32555,تكونا,0,0,1,1
32556,பலவிதமான,0,0,1,1
32532,enbomis,0,0,1,1
32529,gradual,0,0,1,1
32502,periodicidad,0,0,1,1
32527,ταξίδευαν,0,0,1,1
32505,descrevendoo,0,0,1,1
32506,kahvenizi,0,0,1,1
32507,നല്ലൊരു,0,0,1,1
32511,സഹായിക്കൂ,0,0,1,1
32513,ಸುಂದರರು,0,0,1,1
32515,самая,0,0,1,1
32516,aussieht,0,0,1,1
32517,people”,0,0,1,1
32519,influenced,0,0,1,1
32520,практику»,0,0,1,1
32521,пиццы,0,0,1,1
32523,facing,0,0,1,1
32524,jamás,0,0,1,1
32525,الأوربية,0,0,1,1
32526,finest,0,0,1,1
32557,публикуется,0,0,1,1
32558,blijf,0,0,1,1
32560,памятник,0,0,1,1
32561,edersen,0,0,1,1
32600,efforcer,0,0,1,1
32601,subsanadas,0,0,1,1
32603,கேள்வியைக்,0,0,1,1
32604,geautomatiseerde,0,0,1,1
32606,ಬೆರಗುಗೊಳಿಸುತ್ತದೆ,0,0,1,1
32608,participer »,0,0,1,1
32609,المخربون,0,0,1,1
32610,αστεροειδής,0,0,1,1
32612,variadíssimos,0,0,1,1
32613,snelle,0,0,1,1
32615,സാധിക്കണമെങ്കിൽ,0,0,1,1
32616,hypothesized,0,0,1,1
32617,representantes,0,0,1,1
32618,endemic,0,0,1,1
32619,нормальный,0,0,1,1
32598,आवाज़,0,0,1,1
32594,pressure,0,0,1,1
32593,желающим,0,0,1,1
32574,"
स्लोवेनियाई",0,0,1,1
32564,récit,0,0,1,1
32565,trabajó,0,0,1,1
32567,понравится,0,0,1,1
32569,naamwoord,0,0,1,1
32571,வளர்ந்த,0,0,1,1
32573,ലഭിച്ചാൽ,0,0,1,1
32578,ಆಯ್ಕೆಗಳ,0,0,1,1
32592,credenciales,0,0,1,1
32579,connaissezvous,0,0,1,1
32580,"
macedónio",0,0,1,1
32581,suriname,0,0,1,1
32583,”smaklöst”,0,0,1,1
32590,instruments,0,0,1,1
32591,യന്ത്രപഠനത്തിൽ,0,0,1,1
32503,मिलनी,0,0,1,1
32501,engelinin,0,0,1,1
32396,probablement,0,0,1,1
32427,എടുത്തുക്കൊള്ളാം,0,0,1,1
32429,камнями,0,0,1,1
32430,ಸರಿಪಡಿಸಲು,0,0,1,1
32432,granskar,0,0,1,1
32434,عالية,0,0,1,1
32435,لاحقة،,0,0,1,1
32436,പരസ്യപ്രചരണമോ,0,0,1,1
32437,volken,0,0,1,1
32438,вялости,0,0,1,1
32439,"
टारण्टीनो",0,0,1,1
32441,результатах,0,0,1,1
32442,graphique,0,0,1,1
32443,oradaki,0,0,1,1
32444,cahiers,0,0,1,1
32446,കാര്യങ്ങൾക്കെല്ലാം,0,0,1,1
32447,സങ്കീർണ്ണമായ,0,0,1,1
32428,nuit,0,0,1,1
32426,ведущих,0,0,1,1
32500,நிதி,0,0,1,1
32424,написанных,0,0,1,1
32397,gymnasieexamen,0,0,1,1
32398,ringa,0,0,1,1
32399,helaas,0,0,1,1
32402,användarens,0,0,1,1
32404,overhovedet,0,0,1,1
32405,gouvernance,0,0,1,1
32406,« wikimedia »,0,0,1,1
32407,energieksempel,0,0,1,1
32411,lecture,0,0,1,1
32412,empreinte,0,0,1,1
32416,deformation,0,0,1,1
32417,வழங்கிக்,0,0,1,1
32418,வாங்கிய,0,0,1,1
32420,framträdande,0,0,1,1
32421,தவறாக,0,0,1,1
32448,chartes,0,0,1,1
32449,dame,0,0,1,1
32450,सुनना,0,0,1,1
32451,regroupées,0,0,1,1
32481,يرتدي,0,0,1,1
32483,ατρόμητο,0,0,1,1
32485,ಆರಂಭದ,0,0,1,1
32486,parliamentary,0,0,1,1
32487,deltar,0,0,1,1
32488,الضخمة,0,0,1,1
32489,основным,0,0,1,1
32490,ಬಳಸುವುದು,0,0,1,1
32492,sakinleşin,0,0,1,1
32494,prácticas,0,0,1,1
32495,değişti,0,0,1,1
32496,ಕಾಣುತ್ತಿದ್ದರು,0,0,1,1
32497,yaparak,0,0,1,1
32498,faithful,0,0,1,1
32499,«творческого,0,0,1,1
32479,recommenceras,0,0,1,1
32478,കാണപ്പെടും,0,0,1,1
32477,blijkt,0,0,1,1
32463,felsefe,0,0,1,1
32455,പ്രതിനിധാനം,0,0,1,1
32456,центральным,0,0,1,1
32457,döndü,0,0,1,1
32458,tuyau,0,0,1,1
32460,plataforma,0,0,1,1
32462,плюрипотентности,0,0,1,1
32464,حيادية,0,0,1,1
32473,overzichtsartikelen,0,0,1,1
32465,المضي,0,0,1,1
32466,diyorsunuz,0,0,1,1
32469,المسجليين,0,0,1,1
32470,l’écriture,0,0,1,1
32471,arbres,0,0,1,1
32472,philosophiques,0,0,1,1
32154,प्रसंग,0,0,1,1
32153,നല്ലതാണെന്ന,0,0,1,1
32151,adquiridos,0,0,1,1
31828,இதற்குப்,0,0,1,1
31831,പരീക്ഷണം,0,0,1,1
31833,foretrukne,0,0,1,1
31835,betjänar,0,0,1,1
31837,achar,0,0,1,1
31839,فلنطعمك,0,0,1,1
31841,आमेरिकेन,0,0,1,1
31842,наблюдения»,0,0,1,1
31844,защиту,0,0,1,1
31847,نطقك,0,0,1,1
31848,दूंगा,0,0,1,1
31849,tragt,0,0,1,1
31851,privilege,0,0,1,1
31852,instancia,0,0,1,1
31853,"
आयमार",0,0,1,1
31857,køre,0,0,1,1
31830,erholt,0,0,1,1
31824,"
eslovaco",0,0,1,1
31802,amerikalının,0,0,1,1
31822,subatomic,0,0,1,1
31805,متوازن,0,0,1,1
31806,καρφί,0,0,1,1
31807,المجاور,0,0,1,1
31809,comedic,0,0,1,1
31810,pétrole,0,0,1,1
31811,zh •,0,0,1,1
31812,प्राधिकृत,0,0,1,1
31813,suponha,0,0,1,1
31814,fraud,0,0,1,1
31815,tillåter,0,0,1,1
31816,désignant,0,0,1,1
31818,सुवे,0,0,1,1
31819,موضعاً,0,0,1,1
31820,ஏழை,0,0,1,1
31821,perigosas,0,0,1,1
31861,ड्रिंक,0,0,1,1
31862,jonger,0,0,1,1
31863,aesthetics,0,0,1,1
31864,സൂക്ഷ്മത,0,0,1,1
31892,paced,0,0,1,1
31894,liknande,0,0,1,1
31895,தாழ்மையானவர்,0,0,1,1
31896,viam,0,0,1,1
31897,emprega,0,0,1,1
31898,polegar,0,0,1,1
31899,сэром,0,0,1,1
31900,بتصميم,0,0,1,1
31901,bağlantı,0,0,1,1
31902,उर्दू,0,0,1,1
31903,passwort,0,0,1,1
31905,लाल,0,0,1,1
31906,экспертной,0,0,1,1
31908,högsta,0,0,1,1
31909,മാറ്റിനിർത്തി,0,0,1,1
31891,threatening,0,0,1,1
31890,неуклонно,0,0,1,1
31889,κινητό,0,0,1,1
31876,ജനനം,0,0,1,1
31865,groseramente,0,0,1,1
31868,commençons,0,0,1,1
31869,обновлённый,0,0,1,1
31872,outlining,0,0,1,1
31873,ಬಗ್ಗೆಯೂ,0,0,1,1
31874,rebuttal,0,0,1,1
31877,fluid,0,0,1,1
31887,hence,0,0,1,1
31878,الاغتصاب,0,0,1,1
31880,وجدوا,0,0,1,1
31881,drømmemor,0,0,1,1
31883,unterbrechen,0,0,1,1
31885,உதவுவீர்கள்,0,0,1,1
31886,имела,0,0,1,1
31804,introduisit,0,0,1,1
31801,وكنت,0,0,1,1
32150,zusterproject,0,0,1,1
31716,தோல்விகளுக்குப்,0,0,1,1
31721,kostsamt,0,0,1,1
31722,दिखता,0,0,1,1
31723,tillhör,0,0,1,1
31724,representerats,0,0,1,1
31725,तकनीक,0,0,1,1
31726,власти,0,0,1,1
31727,indonesian,0,0,1,1
31728,disproportionately,0,0,1,1
31732,aradan,0,0,1,1
31733,critiquée,0,0,1,1
31734,മാനദണ്ഡങ്ങളെ,0,0,1,1
31735,சந்திப்புக்கு,0,0,1,1
31736,básico,0,0,1,1
31738,incapacidade,0,0,1,1
31740,சோர்வாகவும்,0,0,1,1
31720,directrice,0,0,1,1
31715,kleding,0,0,1,1
31800,birisidir,0,0,1,1
31714,உணர,0,0,1,1
31688,wunderbar,0,0,1,1
31689,accesses,0,0,1,1
31691,calmezvous,0,0,1,1
31694,предоставлен,0,0,1,1
31695,политике,0,0,1,1
31696,учебник,0,0,1,1
31700,comunistas,0,0,1,1
31701,வேல்ஸையே,0,0,1,1
31702,αμερόληπτη,0,0,1,1
31703,अमीर,0,0,1,1
31704,juiste,0,0,1,1
31708,старых,0,0,1,1
31709,profits,0,0,1,1
31711,plena,0,0,1,1
31713,onwards,0,0,1,1
31741,superstitions,0,0,1,1
31745,marcher,0,0,1,1
31746,சிகிச்சை,0,0,1,1
31748,piscaram,0,0,1,1
31775,udvalgt,0,0,1,1
31777,எச்சரிப்பதற்காகவும்,0,0,1,1
31778,decidir,0,0,1,1
31779,டிப்,0,0,1,1
31780,छोटी,0,0,1,1
31781,s’est,0,0,1,1
31784,مناقشتهم،,0,0,1,1
31785,creator,0,0,1,1
31786,promouvoir,0,0,1,1
31787,faixa,0,0,1,1
31790,consommation,0,0,1,1
31793,അതിലെ,0,0,1,1
31795,recreate,0,0,1,1
31796,हमारी,0,0,1,1
31799,curtir,0,0,1,1
31774,güiquipedia,0,0,1,1
31772,osaklig,0,0,1,1
31769,çelişkili,0,0,1,1
31757,masiva,0,0,1,1
31749,zamandan,0,0,1,1
31752,« nature,0,0,1,1
31753,formuleringsarbetet,0,0,1,1
31754,necrológicas,0,0,1,1
31755,имеющих,0,0,1,1
31756,பயன்படுத்தினால்,0,0,1,1
31758,മര്യാദയുള്ള,0,0,1,1
31768,voeten,0,0,1,1
31759,മാസങ്ങളോ,0,0,1,1
31761,ru •,0,0,1,1
31762,رفضتهم,0,0,1,1
31764,செயலதிகாரியான,0,0,1,1
31765,utvecklat,0,0,1,1
31767,correto,0,0,1,1
31910,"
स्वाहिली",0,0,1,1
31911,உலகெங்கிலுமுள்ள,0,0,1,1
31912,perguntoulhe,0,0,1,1
32071,internet »,0,0,1,1
32074,ஒப்புக்கொள்வது,0,0,1,1
32075,வேண்டத்தகாத,0,0,1,1
32076,முரண்பாடு,0,0,1,1
32077,lösenord,0,0,1,1
32081,ആശയക്കുഴപ്പത്തിലാക്കി,0,0,1,1
32085,intervient,0,0,1,1
32086,उतना,0,0,1,1
32087,получение,0,0,1,1
32091,aboutir,0,0,1,1
32094,çalışmayı,0,0,1,1
32096,σκληροί,0,0,1,1
32097,paleis,0,0,1,1
32099,ನೋಡುತ್ತಿದ್ದರು,0,0,1,1
32100,ஆச்சரியமான,0,0,1,1
32101,указан,0,0,1,1
32072,tecnológico,0,0,1,1
32070,stupid,0,0,1,1
31913,vorbereitet,0,0,1,1
32069,matematikbog,0,0,1,1
32039,tadım,0,0,1,1
32042,cirka,0,0,1,1
32043,الـ,0,0,1,1
32044,antwoorden,0,0,1,1
32047,promoção,0,0,1,1
32049,والمناقشة,0,0,1,1
32050,medya,0,0,1,1
32052,totalité,0,0,1,1
32054,haydi,0,0,1,1
32056,സ്വീകരിക്കാം,0,0,1,1
32057,கட்டுரை”யொன்று,0,0,1,1
32059,യന്ത്രപഠനത്തിലാകട്ടെ,0,0,1,1
32060,skat,0,0,1,1
32061,sunumlar,0,0,1,1
32066,உணர்த்தியுள்ளது,0,0,1,1
32103,folkrepubliken,0,0,1,1
32105,eis,0,0,1,1
32106,реальных,0,0,1,1
32107,honored,0,0,1,1
32132,στρατεύματα,0,0,1,1
32133,assuming,0,0,1,1
32134,uncommon,0,0,1,1
32135,ampliada,0,0,1,1
32136,arrojó,0,0,1,1
32137,कक्षा,0,0,1,1
32138,codfw,0,0,1,1
32139,questionou,0,0,1,1
32140,ആകുവാൻ,0,0,1,1
32141,l’intégralité,0,0,1,1
32142,condicionales,0,0,1,1
32145,ಮುಂದುವರಿಯಲು,0,0,1,1
32146,testen,0,0,1,1
32147,hazineni,0,0,1,1
32148,çamaşır,0,0,1,1
32131,вежливо,0,0,1,1
32129,hoparlöre,0,0,1,1
32128,японскими,0,0,1,1
32118,verborreica,0,0,1,1
32108,geométricos,0,0,1,1
32109,மேஜையில்,0,0,1,1
32110,കണക്ക്,0,0,1,1
32111,масштабах,0,0,1,1
32113,översvämning,0,0,1,1
32116,ironfilled,0,0,1,1
32119,humanidad»,0,0,1,1
32127,रायटर्स,0,0,1,1
32120,undersöker,0,0,1,1
32122,आगंतुक,0,0,1,1
32123,σωστός,0,0,1,1
32124,الفترة,0,0,1,1
32125,മുൻപുള്ള,0,0,1,1
32126,ആരംഭിക്കാൻ,0,0,1,1
32038,vandalizados,0,0,1,1
32036,uygulanmak,0,0,1,1
32033,strikta,0,0,1,1
31965,ಇದರ,0,0,1,1
31943,izlediyseniz,0,0,1,1
31944,enheter,0,0,1,1
31948,للإعجاب,0,0,1,1
31949,разрешает,0,0,1,1
31950,énergétique,0,0,1,1
31952,πανεπιστήμιο,0,0,1,1
31954,صرح,0,0,1,1
31955,constaté,0,0,1,1
31956,посещений,0,0,1,1
31957,instructs,0,0,1,1
31958,வளர்ச்சிக்கு,0,0,1,1
31959,äktenskapet,0,0,1,1
31961,handful,0,0,1,1
31962,رأته,0,0,1,1
31963,பெறுவாள்,0,0,1,1
31942,« réconciliation »,0,0,1,1
31940,മലയാള,0,0,1,1
31938,déchristianisation,0,0,1,1
31925,gekleidet,0,0,1,1
31915,« seuls,0,0,1,1
31917,நாய்,0,0,1,1
31918,вперемешку,0,0,1,1
31919,करेगी।,0,0,1,1
31920,compositor,0,0,1,1
31921,kontrollerar,0,0,1,1
31927,സമയങ്ങളിൽ,0,0,1,1
31936,aclamados,0,0,1,1
31929,φέτος,0,0,1,1
31931,ontwikkelen,0,0,1,1
31932,ερωτηματικό,0,0,1,1
31933,يو,0,0,1,1
31934,stormy,0,0,1,1
31935,ടെലിഫോൺ,0,0,1,1
31964,حلقة,0,0,1,1
31967,ശക്തി,0,0,1,1
32030,ಪದಗಳಿವೆ,0,0,1,1
31969,malı,0,0,1,1
31999,peuplements,0,0,1,1
32001,klassen,0,0,1,1
32005,производстве,0,0,1,1
32009,sizden,0,0,1,1
32010,സ്വപ്നങ്ങളിൽ,0,0,1,1
32011,llamaron,0,0,1,1
32013,ಕಾಣುತ್ತದೆ,0,0,1,1
32015,invalidado,0,0,1,1
32017,कमजोर,0,0,1,1
32018,consigo,0,0,1,1
32019,होनी,0,0,1,1
32024,обсуждения,0,0,1,1
32027,खुलापन,0,0,1,1
32028,επιτυχής,0,0,1,1
32029,склонны,0,0,1,1
31998,நிறுவனத்தின்,0,0,1,1
31995,tournent,0,0,1,1
31994,وwikipediaorg,0,0,1,1
31979,classes,0,0,1,1
31970,mestre,0,0,1,1
31971,എടുത്ത,0,0,1,1
31972,تهدئة,0,0,1,1
31973,പതിപ്പുകളുണ്ട്‌,0,0,1,1
31975,வந்ததும்,0,0,1,1
31976,nueva,0,0,1,1
31983,использовано,0,0,1,1
31993,процесс,0,0,1,1
31984,miré,0,0,1,1
31986,limitamse,0,0,1,1
31988,«непредубеждения»,0,0,1,1
31989,træder,0,0,1,1
31990,documentada,0,0,1,1
31991,лицензирования,0,0,1,1
32620,kaynaklarını,0,0,1,1
32621,منع,0,0,1,1
32623,இப்பக்கத்தைப்,0,0,1,1
33225,allèrent,0,0,1,1
33228,скорее,0,0,1,1
33229,managers,0,0,1,1
33230,yapılmaktadır,0,0,1,1
33231,मनोरंजक,0,0,1,1
33232,transcendance,0,0,1,1
33233,—wikipedia—,0,0,1,1
33234,købte,0,0,1,1
33236,விளம்பர,0,0,1,1
33237,vergisst,0,0,1,1
33238,ಕ್ರೀಮ್,0,0,1,1
33239,anlam,0,0,1,1
33242,बताओ,0,0,1,1
33243,independencias,0,0,1,1
33244,undersökts,0,0,1,1
33247,saberia,0,0,1,1
33226,normales,0,0,1,1
33224,pourriezvous,0,0,1,1
33192,problemáticas,0,0,1,1
33223,சம்பவங்கள்,0,0,1,1
33195,मुख,0,0,1,1
33196,അപ്പ്,0,0,1,1
33197,lijkt,0,0,1,1
33198,αφοσιωμένη,0,0,1,1
33202,olmadan,0,0,1,1
33204,προσπαθούσε,0,0,1,1
33205,sarılmak,0,0,1,1
33206,postlisterne,0,0,1,1
33207,nisan,0,0,1,1
33208,перевода,0,0,1,1
33210,ತಿಳುವಳಿಕೆಯಿದ್ದರೆ,0,0,1,1
33211,göremezsiniz,0,0,1,1
33216,förekomsten,0,0,1,1
33217,actualité,0,0,1,1
33218,والمحطة,0,0,1,1
33249,تطلق,0,0,1,1
33251,സങ്കീർണ്ണത,0,0,1,1
33252,വിക്കിപീഡിയരായി,0,0,1,1
33253,règle,0,0,1,1
33279,நெரிசல்கள்,0,0,1,1
33280,மீளமைக்கவோ,0,0,1,1
33281,kvartalet,0,0,1,1
33284,дэвидом,0,0,1,1
33285,unreadable,0,0,1,1
33286,установлено,0,0,1,1
33287,تحديث،,0,0,1,1
33288,habitual,0,0,1,1
33289,toenemen,0,0,1,1
33290,contribuyentes»,0,0,1,1
33292,sûre,0,0,1,1
33293,despedirse,0,0,1,1
33295,kanalen,0,0,1,1
33296,regardé,0,0,1,1
33299,ரொட்டியில்,0,0,1,1
33276,опубликованными,0,0,1,1
33275,ಧನಾತ್ಮಕ,0,0,1,1
33274,பொருத்தமானதாக,0,0,1,1
33263,observada,0,0,1,1
33254,التعديل,0,0,1,1
33257,शिक्षक,0,0,1,1
33258,توقفنا,0,0,1,1
33259,consecuentemente,0,0,1,1
33260,koyamadığım,0,0,1,1
33262,kevin,0,0,1,1
33265,يقترح,0,0,1,1
33273,публикацию,0,0,1,1
33267,commentators,0,0,1,1
33268,unavailability,0,0,1,1
33269,തിരയുന്നുവെങ്കിൽ,0,0,1,1
33270,retirados,0,0,1,1
33271,منطقي,0,0,1,1
33272,വിക്കിഎഴുതുന്നതെല്ലാം,0,0,1,1
33194,ur •,0,0,1,1
33189,beyazdır,0,0,1,1
33071,vanmorgen,0,0,1,1
33098,αδιάφορος,0,0,1,1
33101,yasalara,0,0,1,1
33102,μαριάν,0,0,1,1
33104,வடிவமைக்கப்,0,0,1,1
33107,منطقة,0,0,1,1
33111,hvornår,0,0,1,1
33112,panel,0,0,1,1
33114,slö,0,0,1,1
33116,அதேபோல்,0,0,1,1
33118,تسجيل,0,0,1,1
33120,एकार्ट,0,0,1,1
33121,காத்திருக்கச்,0,0,1,1
33123,bureaukrater,0,0,1,1
33124,يوميًا,0,0,1,1
33125,കിട്ടി,0,0,1,1
33126,eo •,0,0,1,1
33100,utgivaren,0,0,1,1
33097,स्वामित्व,0,0,1,1
33188,വെള്ളിയാഴ്ചയാണെങ്കിൽ,0,0,1,1
33096,പിടിക്കാത്തതിനാൽ,0,0,1,1
33073,номинациях,0,0,1,1
33075,சந்திக்கிறீர்கள்,0,0,1,1
33077,dåsedansk,0,0,1,1
33079,ögonblicket,0,0,1,1
33080,separación,0,0,1,1
33081,إيكونوميك,0,0,1,1
33082,ಶಾಸ್ತ್ರೀಯ,0,0,1,1
33083,«подобное,0,0,1,1
33084,trataste,0,0,1,1
33086,petición,0,0,1,1
33087,बँधा,0,0,1,1
33088,skrevs,0,0,1,1
33093, بريتانيكا,0,0,1,1
33094,outnumbered,0,0,1,1
33095,വാരാന്ത്യ,0,0,1,1
33127,против,0,0,1,1
33129,plata,0,0,1,1
33131,подъехала,0,0,1,1
33132,başlıklı,0,0,1,1
33165,adn,0,0,1,1
33166,diminishing,0,0,1,1
33169,escuches,0,0,1,1
33170,poussée,0,0,1,1
33174,zullen,0,0,1,1
33175,castelo,0,0,1,1
33176,मार्मिक,0,0,1,1
33177,وشخص,0,0,1,1
33178,meramente,0,0,1,1
33180,agerade,0,0,1,1
33181,മന്ദഗതിയിലാകുന്നു,0,0,1,1
33182,இழந்துவிட்டேன்,0,0,1,1
33183,άρεσαν,0,0,1,1
33186,വിലയിരുത്തപ്പെട്ട,0,0,1,1
33187,பொதுவாக,0,0,1,1
33164,parmakları,0,0,1,1
33162,несбалансированность,0,0,1,1
33161,administrateur,0,0,1,1
33144,रेडियो,0,0,1,1
33135,webbtjänsten,0,0,1,1
33138,ಆಶ್ಚರ್ಯ,0,0,1,1
33139,wealthy,0,0,1,1
33140,fiesta,0,0,1,1
33142,लेखेजोखे,0,0,1,1
33143,कैदियों,0,0,1,1
33145,çocuğum,0,0,1,1
33157,сравнить,0,0,1,1
33147,börjat,0,0,1,1
33148,sens »,0,0,1,1
33149,தொழில்நுட்பத்தை,0,0,1,1
33152,слизняк,0,0,1,1
33155,σαλιγκαριών,0,0,1,1
33156,acessar,0,0,1,1
33301,sakligt,0,0,1,1
33302,projetados,0,0,1,1
33303,адамсом,0,0,1,1
33458,έρχεστε,0,0,1,1
33460,distribuable,0,0,1,1
33463,mammals,0,0,1,1
33464,épurée,0,0,1,1
33466,والتعليمات,0,0,1,1
33468,estompe,0,0,1,1
33469,fechamento,0,0,1,1
33470,questão,0,0,1,1
33474,promueven,0,0,1,1
33475,преувеличить,0,0,1,1
33477,fotosafari,0,0,1,1
33479,வந்தார்கள்,0,0,1,1
33480,falto,0,0,1,1
33481,инструкции,0,0,1,1
33482,öğrenciler,0,0,1,1
33483,شائعة,0,0,1,1
33459,இருந்திருந்தால்,0,0,1,1
33457,brett,0,0,1,1
33304,blijken,0,0,1,1
33455,terminal,0,0,1,1
33428,"
esperanto",0,0,1,1
33429,dichotomiquement,0,0,1,1
33430,ρυθμός,0,0,1,1
33432,encyclopédien,0,0,1,1
33434,വാരാന്ത്യത്തിലും,0,0,1,1
33435,причинам,0,0,1,1
33436,qualities,0,0,1,1
33437,rad,0,0,1,1
33439,skrivit,0,0,1,1
33441,millimètreréf,0,0,1,1
33444,ಪಠ್ಯಕ್ಕೆ,0,0,1,1
33445,slot,0,0,1,1
33446,sousbranches ,0,0,1,1
33448,γεύση,0,0,1,1
33454,åldersgruppen,0,0,1,1
33487,ран,0,0,1,1
33488,randomly,0,0,1,1
33489,anneme,0,0,1,1
33490,adil,0,0,1,1
33524,ನಿರ್ಧಾರವಾಗಿದೆ,0,0,1,1
33526,semanario,0,0,1,1
33528,фламмокс,0,0,1,1
33529,وسماع,0,0,1,1
33530,टर्म,0,0,1,1
33531,verängstigt,0,0,1,1
33532,திரும்புவார்,0,0,1,1
33534,« naissance »,0,0,1,1
33536,പ്രശസ്തമായ,0,0,1,1
33539,harmonie,0,0,1,1
33540,أسابيع,0,0,1,1
33541,habillé,0,0,1,1
33542,betrat,0,0,1,1
33546,creates,0,0,1,1
33547,σκληρή,0,0,1,1
33522,இதுவரை,0,0,1,1
33521,मई,0,0,1,1
33519,திருமணத்திற்கு,0,0,1,1
33501,doubt,0,0,1,1
33491,ಪ್ರಯಾಣಿಸಿತು,0,0,1,1
33494,ಎನರ್ಜಿ,0,0,1,1
33495,değilseniz,0,0,1,1
33496,تميل,0,0,1,1
33498,hypertekst,0,0,1,1
33500,fehlverhalten,0,0,1,1
33502,राय।,0,0,1,1
33518,оперативно,0,0,1,1
33503,விடைபெற்று,0,0,1,1
33507,bage,0,0,1,1
33508,determining,0,0,1,1
33510,இன்பம்,0,0,1,1
33511,ഉണ്ടായില്ല,0,0,1,1
33516,поанглийски,0,0,1,1
33427,fato,0,0,1,1
33424,krävas,0,0,1,1
33423,கொண்டு,0,0,1,1
33363,kalitede,0,0,1,1
33340,услуга,0,0,1,1
33341,chat,0,0,1,1
33343,التقدير,0,0,1,1
33346,comunicação,0,0,1,1
33348,புளூமாக்ஸிற்குப்,0,0,1,1
33351,voortbestaan,0,0,1,1
33352,ஆரம்பிக்கலாம்,0,0,1,1
33353,எடுத்தால்,0,0,1,1
33354,groepsverstand,0,0,1,1
33355,научному,0,0,1,1
33356,placeret,0,0,1,1
33357,βοηθήσεις,0,0,1,1
33358,выдал,0,0,1,1
33359,allmänt,0,0,1,1
33360,نارسيسا,0,0,1,1
33337,குழந்தை,0,0,1,1
33335,والتحرير,0,0,1,1
33334,വിവരസ്രോതസ്സുകളും,0,0,1,1
33316,ನೋಡುತ್ತಿದ್ದರೆ,0,0,1,1
33305,"
कज़ाख़",0,0,1,1
33306,agréable,0,0,1,1
33308,reparera,0,0,1,1
33309,energidryck,0,0,1,1
33310,للمناقشة,0,0,1,1
33313,അശ്ലീല,0,0,1,1
33317,philips,0,0,1,1
33333,الصباح,0,0,1,1
33318,assess,0,0,1,1
33319,ತಿನ್ನಲಾಗದ,0,0,1,1
33320,souvenezvous,0,0,1,1
33321,måneden,0,0,1,1
33327,வேலையைப்,0,0,1,1
33330,fdl,0,0,1,1
33361,وبعد,0,0,1,1
33364,എന്തുചെയ്യണമെന്ന്,0,0,1,1
33421,omröstningar,0,0,1,1
33368,célèbre,0,0,1,1
33393,وسيمه,0,0,1,1
33398,"
इन",0,0,1,1
33400,βάζω,0,0,1,1
33402,നടത്തുന്നതിനാണ്,0,0,1,1
33403,निरन्तर,0,0,1,1
33404,refuses,0,0,1,1
33407,некоего,0,0,1,1
33409,solicitada,0,0,1,1
33412,cümleleri,0,0,1,1
33414,അലസമോ,0,0,1,1
33415,belge,0,0,1,1
33416,يفسر,0,0,1,1
33418,возникающие,0,0,1,1
33419,confirmer,0,0,1,1
33420,venezuela,0,0,1,1
33392,neurophysiologiste,0,0,1,1
33391,sitesini,0,0,1,1
33390,விட்டு,0,0,1,1
33375,survival,0,0,1,1
33369,مهتم,0,0,1,1
33370,poderosa,0,0,1,1
33371,поле,0,0,1,1
33372,зрелыми,0,0,1,1
33373,magasiner,0,0,1,1
33374,отсутствующим,0,0,1,1
33377,கோடல்கள்,0,0,1,1
33388,упростить,0,0,1,1
33378,കുട്ടികൾ,0,0,1,1
33379,ശ്രദ്ധപുലർത്തുക,0,0,1,1
33380,серверные,0,0,1,1
33382,decisionmaking,0,0,1,1
33383,essayait,0,0,1,1
33386,sammanhållande,0,0,1,1
33072,årlig,0,0,1,1
33069,kurucularından,0,0,1,1
32624,சாலடுகள்,0,0,1,1
32750,secondclass,0,0,1,1
32754,நடவு,0,0,1,1
32755,recogida,0,0,1,1
32758,sætningsnummer,0,0,1,1
32760,recep,0,0,1,1
32763,excellent,0,0,1,1
32764,различному,0,0,1,1
32765,வழிகளை,0,0,1,1
32767,slice,0,0,1,1
32768,natten,0,0,1,1
32769,orígenes,0,0,1,1
32770,கணிப்பிடும்,0,0,1,1
32771,räknas,0,0,1,1
32772,mentally,0,0,1,1
32775,obtain,0,0,1,1
32776,ah,0,0,1,1
32753,governing,0,0,1,1
32749,medication,0,0,1,1
32723,serveursquand ,0,0,1,1
32748,संगीत,0,0,1,1
32725,ಕರೆಯಬಹುದು,0,0,1,1
32728,colegial,0,0,1,1
32729,bought,0,0,1,1
32731,ഒട്ടുമിക്ക,0,0,1,1
32732,¿me,0,0,1,1
32735,പുനരാരംഭിക്കുകയും,0,0,1,1
32736,rijk,0,0,1,1
32737,déplace,0,0,1,1
32738,സഹിഷ്ണുക്കൾ,0,0,1,1
32739,إيه,0,0,1,1
32741,σέρνουν,0,0,1,1
32742,मोडल,0,0,1,1
32745,anns,0,0,1,1
32746,противоречивые,0,0,1,1
32747,dezenas,0,0,1,1
32777,جوزيف,0,0,1,1
32778,возможного,0,0,1,1
32779,мнений,0,0,1,1
32780,мессенджер,0,0,1,1
32812,kvantitativ,0,0,1,1
32816,prémio,0,0,1,1
32818,provoqué,0,0,1,1
32819,arbetsdelning,0,0,1,1
32820,rapazes,0,0,1,1
32821,disseram,0,0,1,1
32823,основной,0,0,1,1
32824,eficientes,0,0,1,1
32825,ಚಿಹ್ನೆಯೊಂದಿಗೆ,0,0,1,1
32826,confusions,0,0,1,1
32829,geduld,0,0,1,1
32830,προτιμούσα,0,0,1,1
32831,stannar,0,0,1,1
32832,vakfı,0,0,1,1
32833,inexactitudes,0,0,1,1
32811,τηλέφωνο,0,0,1,1
32809,lächelten,0,0,1,1
32808,granskat,0,0,1,1
32796,गुज़री,0,0,1,1
32785,puppets,0,0,1,1
32787,विज्ञापनों,0,0,1,1
32788,المنفرج,0,0,1,1
32790,zamanı,0,0,1,1
32791,множества,0,0,1,1
32792,finsk,0,0,1,1
32799,മാസത്തെ,0,0,1,1
32807,voudrait,0,0,1,1
32800,hattest,0,0,1,1
32802,demandantes,0,0,1,1
32803,recombined,0,0,1,1
32804,खूबसूरती,0,0,1,1
32805,ഭാഗ്യത്തിന്റെ,0,0,1,1
32806,കോണാണ്,0,0,1,1
32724,скучно,0,0,1,1
32722,തീരുമാനങ്ങളിലെത്താൻ,0,0,1,1
33068,pænt,0,0,1,1
32650,harvested,0,0,1,1
32652,الموسوعتين,0,0,1,1
32653,സ്കൂളിനെ,0,0,1,1
32654,ಹೊಂದಿರುವ,0,0,1,1
32655,gigaoctets,0,0,1,1
32656,retirar,0,0,1,1
32657,போன்றவர்,0,0,1,1
32658,новостей,0,0,1,1
32659,inblick,0,0,1,1
32660,statistiskt,0,0,1,1
32661,patruljerer,0,0,1,1
32663,تثار,0,0,1,1
32664,felter,0,0,1,1
32665,majeur ,0,0,1,1
32666,طبيعة,0,0,1,1
32667,tomber,0,0,1,1
32651,egoist,0,0,1,1
32648,öğrenebilirsiniz,0,0,1,1
32719,atarsa,0,0,1,1
32646,fitting,0,0,1,1
32625,"
डीलीट",0,0,1,1
32626,άποψης,0,0,1,1
32628,സ്വീകരിക്കുക,0,0,1,1
32629,உணர்ந்தால்,0,0,1,1
32630,сердится,0,0,1,1
32631,yalnızca,0,0,1,1
32633,editorial​​,0,0,1,1
32634,kıkırdıyordu,0,0,1,1
32636,പ്രശ്‌നമായിരുന്നു,0,0,1,1
32637,veinte,0,0,1,1
32639,işaretiyle,0,0,1,1
32640,വസ്തുതകളും,0,0,1,1
32642,étiquetées,0,0,1,1
32643,alsjeblieft,0,0,1,1
32644,klädkänsla,0,0,1,1
32669,majorité,0,0,1,1
32671,conséquent,0,0,1,1
32672,politely,0,0,1,1
32673,ευγενικός,0,0,1,1
32699,restaurangen,0,0,1,1
32700,சார்,0,0,1,1
32701,أهتم,0,0,1,1
32702,لجعل,0,0,1,1
32703,സുന്ദരിയായിരുന്നതിനാൽ,0,0,1,1
32704,अभिनय,0,0,1,1
32706,wikipediarelated,0,0,1,1
32709,الالتقاط,0,0,1,1
32710,متواضعة,0,0,1,1
32711,towns,0,0,1,1
32712,bright,0,0,1,1
32713,devoir,0,0,1,1
32714,opdagelse,0,0,1,1
32715,mattebok,0,0,1,1
32718,കണ്ട,0,0,1,1
32698,gagner,0,0,1,1
32697,penny,0,0,1,1
32696,constat,0,0,1,1
32683,принял,0,0,1,1
32675,получили,0,0,1,1
32676,τράπεζα,0,0,1,1
32678,обучению,0,0,1,1
32679,kanun,0,0,1,1
32680,അവയുടെ,0,0,1,1
32681,compañía,0,0,1,1
32685,censuur,0,0,1,1
32695,blikken,0,0,1,1
32686,وdutch,0,0,1,1
32687,"
दूसरे",0,0,1,1
32688,செய்திகளில்,0,0,1,1
32691,എടുക്കുന്നതുപോലെ,0,0,1,1
32693,coreia,0,0,1,1
32694,സാക്ഷാത്കരിക്കപ്പെട്ടാൽ,0,0,1,1
32834,sujeito,0,0,1,1
32835,ρωτάω,0,0,1,1
32837,usaría,0,0,1,1
32981,базы,0,0,1,1
32983,αντίχειρες,0,0,1,1
32985,октября,0,0,1,1
32987,säkert,0,0,1,1
32988,политикам,0,0,1,1
32990,എടുത്തുമാറ്റുക,0,0,1,1
32991,பாடல்களில்,0,0,1,1
32992,определенно,0,0,1,1
32995,തുടങ്ങുവാനോ,0,0,1,1
32996,documented,0,0,1,1
32997,الاطلاق,0,0,1,1
32998,συλλογή,0,0,1,1
32999,χειρότερα,0,0,1,1
33004,പഞ്ചാബി,0,0,1,1
33005,लिखूंगा,0,0,1,1
33007,ionized,0,0,1,1
32982,provoquant,0,0,1,1
32980,desbloqueada,0,0,1,1
32838,عقليًا,0,0,1,1
32978,വിവരങ്ങളെ,0,0,1,1
32959,verdere,0,0,1,1
32960,зеркале,0,0,1,1
32964,ಅತ್ಯುತ್ತಮವಾದದ್ದು,0,0,1,1
32966,சொல்கிறாரோ,0,0,1,1
32967,बनाते,0,0,1,1
32968,dimwitted,0,0,1,1
32969,тяжелый,0,0,1,1
32970,تعليمية,0,0,1,1
32971,وأحيانًا,0,0,1,1
32972,ocasionais,0,0,1,1
32973,skylldes,0,0,1,1
32974,പൂരകസംവിധാനമായാണ്‌,0,0,1,1
32975,billions,0,0,1,1
32976,дорожки,0,0,1,1
32977,غداء,0,0,1,1
33009,красотой,0,0,1,1
33010,arıyorsanız,0,0,1,1
33011,ಯೋಜಿಸುತ್ತಿದ್ದೇನೆ,0,0,1,1
33012,கட்டுரையை,0,0,1,1
33045,disregard,0,0,1,1
33046,لسلوك,0,0,1,1
33048,एईजेसब्रांड,0,0,1,1
33049,ಸಂಗತಿಗಳು,0,0,1,1
33050,verilen,0,0,1,1
33051,split,0,0,1,1
33053,хранения,0,0,1,1
33054,voorzien,0,0,1,1
33055,न्यायाधीशों,0,0,1,1
33057,verenigd,0,0,1,1
33060,citerade,0,0,1,1
33061,പ്രമുഖരുടെ,0,0,1,1
33063,operado,0,0,1,1
33064,низкокачественной,0,0,1,1
33065,neoproterozoic,0,0,1,1
33043,adoro,0,0,1,1
33042,incorrectes,0,0,1,1
33041,الزوار,0,0,1,1
33027,serbian,0,0,1,1
33014,ewigkeiten,0,0,1,1
33015,slowing,0,0,1,1
33017,lanzamiento,0,0,1,1
33018,dieciséis,0,0,1,1
33019,enfade,0,0,1,1
33025,supresores,0,0,1,1
33028,riguroso,0,0,1,1
33040,düşündü,0,0,1,1
33030,tıklayarak,0,0,1,1
33031,அண்மைய,0,0,1,1
33033,fnissar,0,0,1,1
33035,oturuyor,0,0,1,1
33036,بجد,0,0,1,1
33038,doradas,0,0,1,1
32958,मीटिंग,0,0,1,1
32955,പുറകേ,0,0,1,1
32950,bırakmamı,0,0,1,1
32894,ειδήμονες,0,0,1,1
32863,intragável,0,0,1,1
32868,теорий,0,0,1,1
32870,أخطط,0,0,1,1
32872,konuşmayla,0,0,1,1
32873,أغسطس،,0,0,1,1
32874,translator,0,0,1,1
32875,infoga,0,0,1,1
32877,encendido,0,0,1,1
32879,connaît,0,0,1,1
32880,авторов,0,0,1,1
32881,adamları,0,0,1,1
32882,acusamna,0,0,1,1
32885,interesaron,0,0,1,1
32887,நர்சிசாவின்,0,0,1,1
32888,بتأثيره،,0,0,1,1
32862,utilizando,0,0,1,1
32860,vienen,0,0,1,1
32859,corporativas,0,0,1,1
32847,incrémentale,0,0,1,1
32840,ജൂലൈ,0,0,1,1
32841,ausgefallene,0,0,1,1
32842,déconcertée,0,0,1,1
32844,éternué,0,0,1,1
32845,wikipediaspecific,0,0,1,1
32846,tasting,0,0,1,1
32848,منتديات,0,0,1,1
32857,сомнительными,0,0,1,1
32849,ಸಂತೋಷವಾಗಿರಲು,0,0,1,1
32850,opmuntring,0,0,1,1
32851,quienes,0,0,1,1
32852,narcissemamma,0,0,1,1
32853,estates,0,0,1,1
32855,سيتم,0,0,1,1
32891,liant,0,0,1,1
32895,opcional,0,0,1,1
32949,उसमें,0,0,1,1
32899,изложение,0,0,1,1
32922,पकड़ते,0,0,1,1
32923,forskningsciteringar,0,0,1,1
32924,അർത്ഥങ്ങൾ,0,0,1,1
32925,पूछता,0,0,1,1
32926,suffisant,0,0,1,1
32929,கற்றல்,0,0,1,1
32933,tenu,0,0,1,1
32934,كاتب,0,0,1,1
32935,கேள்விகளால்,0,0,1,1
32936,cloche,0,0,1,1
32938,stagne,0,0,1,1
32940,downloading,0,0,1,1
32944,ഐക്കൺ,0,0,1,1
32945,tisch,0,0,1,1
32947,общественным,0,0,1,1
32921,machte,0,0,1,1
32920,authority,0,0,1,1
32919,allvarliga,0,0,1,1
32908,jenna,0,0,1,1
32902,يصدق,0,0,1,1
32903,تستأنف,0,0,1,1
32904,"ജീവശാസ്ത്രം ·
രസതന്ത്രം ·
environmental",0,0,1,1
32905,юнеско,0,0,1,1
32906,multilingües,0,0,1,1
32907,നിർമ്മാണം,0,0,1,1
32910,خوان,0,0,1,1
32918,உதவியாக,0,0,1,1
32911,énormes,0,0,1,1
32912,erger,0,0,1,1
32913,αγώνας,0,0,1,1
32914,espagnol,0,0,1,1
32915,специалистами,0,0,1,1
32916,griffith,0,0,1,1
31687,altos,0,0,1,1
31684,контента,0,0,1,1
29832,ಸಾರ್ವಕಾಲಿಕ,0,0,1,1
30455,articles »,0,0,1,1
30458,refere,0,0,1,1
30459,parecía,0,0,1,1
30460,indrømmer,0,0,1,1
30463,muhtemelen,0,0,1,1
30464,وجودنا,0,0,1,1
30466,صرف,0,0,1,1
30467,ತೆಗೆದುಕೊಳ್ಳುತ್ತೇನೆ,0,0,1,1
30468,культу»,0,0,1,1
30470,ಪಡೆಯುತ್ತಾರೆ,0,0,1,1
30471,நுபீடியாவிற்கான,0,0,1,1
30472,ആഗ്രഹിച്ചില്ല,0,0,1,1
30474,पांच,0,0,1,1
30475,оценкам,0,0,1,1
30476,canciones,0,0,1,1
30478,ثالث,0,0,1,1
30456,tradutores,0,0,1,1
30454,doldurma,0,0,1,1
30428,experimente,0,0,1,1
30453,विकिअलिटी,0,0,1,1
30430,ತನ್ನದೇ,0,0,1,1
30432,قدمت,0,0,1,1
30435,συνεχίσουμε,0,0,1,1
30436,токио,0,0,1,1
30437,употребить,0,0,1,1
30438,κλασικές,0,0,1,1
30439,valresultaten,0,0,1,1
30441,محق,0,0,1,1
30444,അറിയാമോ,0,0,1,1
30445,выпущено,0,0,1,1
30446,وسيول,0,0,1,1
30447,arrangeras,0,0,1,1
30448,encontró,0,0,1,1
30449,famoso»,0,0,1,1
30452,своё,0,0,1,1
30480,إعجابًا,0,0,1,1
30481,مركبة,0,0,1,1
30482,الحظر,0,0,1,1
30483,للمخربين,0,0,1,1
30514,comprometido,0,0,1,1
30518,അല്പം,0,0,1,1
30520,mature,0,0,1,1
30521,обнаружено,0,0,1,1
30522,بإمكانك,0,0,1,1
30523,nederig,0,0,1,1
30524,faller,0,0,1,1
30525,"
इतालवी",0,0,1,1
30526,முடிவிலும்,0,0,1,1
30527,பயன்பாட்டுக்கு,0,0,1,1
30528,सूचित,0,0,1,1
30533,leyes,0,0,1,1
30535,إخطاره,0,0,1,1
30536,dispensem,0,0,1,1
30537,റൂമിലേക്ക്,0,0,1,1
30511,للطريقة,0,0,1,1
30510,интересных,0,0,1,1
30509,स्थायी,0,0,1,1
30494,desarrollamos,0,0,1,1
30486,गईं।,0,0,1,1
30487,பிரிவில்,0,0,1,1
30489,entendez,0,0,1,1
30491,réussir,0,0,1,1
30492,വെക്കുന്നുണ്ട്,0,0,1,1
30493,slecht,0,0,1,1
30495,rubriker,0,0,1,1
30508,gesproken,0,0,1,1
30497,deixe,0,0,1,1
30499,പരിഹാരത്തിലും,0,0,1,1
30500,sürekli,0,0,1,1
30503,अंगूठे,0,0,1,1
30504,база,0,0,1,1
30506,habría,0,0,1,1
30429,tartışmanın,0,0,1,1
30427,questionado,0,0,1,1
30539,السعيد,0,0,1,1
30324,प्रतिनिधि,0,0,1,1
30329,പതാകവാഹക‍,0,0,1,1
30330,jämförelse,0,0,1,1
30331,വെളിപ്പെടുത്തുന്നു,0,0,1,1
30332,ljusa,0,0,1,1
30333,suspects,0,0,1,1
30336,വരുമ്പൊൾ,0,0,1,1
30338,princess,0,0,1,1
30339,blik,0,0,1,1
30341,തിരയിലിലൂടെ,0,0,1,1
30343,தாக்குதல்,0,0,1,1
30346,വിശ്വസിക്കുന്നവരിപ്പോൾ,0,0,1,1
30347,ويتم,0,0,1,1
30348,ಹೇಳಿದ್ದೇನೆ,0,0,1,1
30349,വിക്കിസമൂഹത്തിന്റെ,0,0,1,1
30350,grundtanken,0,0,1,1
30328,पीड़ित,0,0,1,1
30323,humana,0,0,1,1
30424,विक्षनरी,0,0,1,1
30321,والانتقادات,0,0,1,1
30299,مكثفة،,0,0,1,1
30302,मुद्रित,0,0,1,1
30303,preferência,0,0,1,1
30304,làdessus,0,0,1,1
30305,aanleidinggevende,0,0,1,1
30306,நோக்கமாகும்,0,0,1,1
30307,சொல்லிக்,0,0,1,1
30308,arcade,0,0,1,1
30310,assustados,0,0,1,1
30312,érasme,0,0,1,1
30313,बड़ी,0,0,1,1
30314,нужным,0,0,1,1
30315,उपहार,0,0,1,1
30316,участия,0,0,1,1
30320,programación,0,0,1,1
30351,dernière,0,0,1,1
30357,—clusters—,0,0,1,1
30359,लेटेस्ट,0,0,1,1
30362,اتصالاً,0,0,1,1
30394,"
نحن",0,0,1,1
30397,പരിഹരിക്കുന്നു,0,0,1,1
30398,readability,0,0,1,1
30399,ಮಾಡಲಿಲ್ಲ,0,0,1,1
30403,κοινά,0,0,1,1
30406,enregistrés,0,0,1,1
30407,intención,0,0,1,1
30408,بينهم،,0,0,1,1
30413,gericht,0,0,1,1
30414,حدث,0,0,1,1
30415,náhuatl,0,0,1,1
30417,droite,0,0,1,1
30419,confianza,0,0,1,1
30420,موقعا,0,0,1,1
30422,अनुभवहीन,0,0,1,1
30392,colocando,0,0,1,1
30390,confundi,0,0,1,1
30388,തോന്നാത്ത,0,0,1,1
30371,പ്രവർത്തിക്കുന്നത്,0,0,1,1
30363,विकिसोर्स,0,0,1,1
30365,مربع,0,0,1,1
30366,പുരുഷന്മാരെ,0,0,1,1
30367,μακριά,0,0,1,1
30369,ಕೇಳಬಹುದು,0,0,1,1
30370,описывал,0,0,1,1
30374,consultent,0,0,1,1
30387,مجلدًا,0,0,1,1
30375,highend,0,0,1,1
30376,மாற்றங்களையும்,0,0,1,1
30380,ശൂന്യമായ,0,0,1,1
30381,officiella,0,0,1,1
30382,animées,0,0,1,1
30386,αγωνίστηκε,0,0,1,1
30538,aardiger,0,0,1,1
30542,solide,0,0,1,1
31683,அழைக்கப்படும்,0,0,1,1
30685,കാഴ്ച,0,0,1,1
30687,meines,0,0,1,1
30689,வரலாற்றைக்,0,0,1,1
30690,சந்திப்பைப்,0,0,1,1
30691,വിശേഷിപ്പിക്കുന്നുഅഭിപ്രായസ്വാതന്ത്ര്യം,0,0,1,1
30692,πληρώσει,0,0,1,1
30695,animada,0,0,1,1
30696,african,0,0,1,1
30698,modificam,0,0,1,1
30699,ಅವಳೊಂದಿಗೆ,0,0,1,1
30700,επιμεληθεί,0,0,1,1
30703,fundamentalt,0,0,1,1
30704,crean,0,0,1,1
30707,америке,0,0,1,1
30708,bağımsızdır,0,0,1,1
30709,sudamérica,0,0,1,1
30686,dépositaire,0,0,1,1
30683,തുടക്കത്തിൽ,0,0,1,1
30659,warst,0,0,1,1
30682,offensant,0,0,1,1
30663,இணையத்தள,0,0,1,1
30664,ತಲುಪಿದಾಗ,0,0,1,1
30665,limitada,0,0,1,1
30667,имея,0,0,1,1
30668,birçoğunu,0,0,1,1
30669,galerie,0,0,1,1
30671,جامعيًا,0,0,1,1
30672,தொடர்பில்,0,0,1,1
30673,पहुंचते,0,0,1,1
30674,skrivstuga,0,0,1,1
30676,lucir,0,0,1,1
30678,„википедию“ —,0,0,1,1
30679,разумность,0,0,1,1
30680,prévaloir,0,0,1,1
30681,sağladı,0,0,1,1
30711,riktig,0,0,1,1
30713,especifica,0,0,1,1
30714,klassificerat,0,0,1,1
30717,αυξήθηκε,0,0,1,1
30742,drink,0,0,1,1
30743,condensing,0,0,1,1
30744,exploratory,0,0,1,1
30745,impossibilitadas,0,0,1,1
30746,clicks,0,0,1,1
30747,παγωτό,0,0,1,1
30748,geçerli,0,0,1,1
30749,ಅವಳನ್ನು,0,0,1,1
30751,डिग,0,0,1,1
30754,överraskar,0,0,1,1
30755,تملي,0,0,1,1
30756,فماذا,0,0,1,1
30758,anlaman,0,0,1,1
30759,பார்த்தார்,0,0,1,1
30760,стимулом англ,0,0,1,1
30741,sıcak,0,0,1,1
30740,çeyrekte,0,0,1,1
30739,dorées,0,0,1,1
30725,صديقتك,0,0,1,1
30718,منفرجًا,0,0,1,1
30719,ആദ്യതാളിൽ,0,0,1,1
30720,മാതൃകയുടെ,0,0,1,1
30721,χαρακτηριστικά,0,0,1,1
30722,дискриминантный,0,0,1,1
30724,خاصية,0,0,1,1
30727,guarantees,0,0,1,1
30738,ದೊಡ್ಡದಾದ,0,0,1,1
30729,റഫർ,0,0,1,1
30731,gleichnamigen,0,0,1,1
30733,முன்னேறியது,0,0,1,1
30734,соответствующую,0,0,1,1
30735,wapsidor,0,0,1,1
30737,versionshistorik,0,0,1,1
30661,incômodo,0,0,1,1
30658,हाउ,0,0,1,1
30543,architecture,0,0,1,1
30568,"
मैसिडोनियाई",0,0,1,1
30571,deveriam,0,0,1,1
30572,aspecto,0,0,1,1
30573,traído,0,0,1,1
30575,kanıtlamazsanız,0,0,1,1
30576,மூல,0,0,1,1
30578,записей,0,0,1,1
30579,servrarb,0,0,1,1
30580,guy,0,0,1,1
30584,inexpertos,0,0,1,1
30591,காணலாம்,0,0,1,1
30592,conquest,0,0,1,1
30593,عروض,0,0,1,1
30596,ரூபி,0,0,1,1
30598,deshecho,0,0,1,1
30599,والنقاشات,0,0,1,1
30569,activité,0,0,1,1
30567,ನೋಡಿಲ್ಲ,0,0,1,1
30657,ടി,0,0,1,1
30566,decidió,0,0,1,1
30544,ಕಂಡಿದ್ದೀರಿ,0,0,1,1
30545,ubiquiste,0,0,1,1
30547,προβλήματα,0,0,1,1
30548,traerte,0,0,1,1
30550,utestängas,0,0,1,1
30551,лайк,0,0,1,1
30552,வந்து,0,0,1,1
30554,الاعتذار,0,0,1,1
30555,произносите,0,0,1,1
30556,எடுத்துக்கொண்டது,0,0,1,1
30558,عديم,0,0,1,1
30559,lagförslag,0,0,1,1
30560,fünf,0,0,1,1
30564,"
पूर्वी",0,0,1,1
30565,классификаторы,0,0,1,1
30601,asemejan,0,0,1,1
30604,greatly,0,0,1,1
30606,emerged,0,0,1,1
30607,présentées,0,0,1,1
30634,പിടിച്ചില്ലെങ്കിൽ‌,0,0,1,1
30637,condamné,0,0,1,1
30638,ضمان,0,0,1,1
30640,désormais,0,0,1,1
30642,ممكن,0,0,1,1
30645,maomé,0,0,1,1
30646,ಮಾಣಿಕ್ಯ,0,0,1,1
30647,ಮಾತನಾಡುತ್ತಾ,0,0,1,1
30648,nankín,0,0,1,1
30651,പിടിച്ചില്ല,0,0,1,1
30652,сведений,0,0,1,1
30653,bilden,0,0,1,1
30654,блокировкой,0,0,1,1
30655,bronnen,0,0,1,1
30656,syrien,0,0,1,1
30633,expansions,0,0,1,1
30630,внешних,0,0,1,1
30629,indsætte,0,0,1,1
30616,agências,0,0,1,1
30608,гарвардской,0,0,1,1
30609,முயற்சிக்கும்போது,0,0,1,1
30610,"
पोलिश",0,0,1,1
30612,कारणों,0,0,1,1
30613,индуктивного,0,0,1,1
30614,proposer,0,0,1,1
30617,vérifiabilité,0,0,1,1
30628,cubierto,0,0,1,1
30619,foulée,0,0,1,1
30621,trabajadora,0,0,1,1
30622,получилось,0,0,1,1
30624,википроекты,0,0,1,1
30625,ಟೋಫ್ಲ್,0,0,1,1
30626,hemel,0,0,1,1
30298,ηχείο,0,0,1,1
30297,trajet,0,0,1,1
30296,portant,0,0,1,1
29982,सलाद,0,0,1,1
29986,шекман,0,0,1,1
29987,إمتاعًا,0,0,1,1
29988,waardeer,0,0,1,1
29989,കഴിക്കുന്നു,0,0,1,1
29990,«научнообразовательный,0,0,1,1
29991,لتربيهم,0,0,1,1
29994,أقدر,0,0,1,1
29995,arbetat,0,0,1,1
29996,الماكرو،,0,0,1,1
29997,идея,0,0,1,1
29999,goût,0,0,1,1
30000,ಟ್,0,0,1,1
30001,ನೋಡಿದಾಗ,0,0,1,1
30002,الطحين,0,0,1,1
30003,डिजीटल,0,0,1,1
29984,ಸುತ್ತುವ,0,0,1,1
29980,موسوعي,0,0,1,1
29941,culturas,0,0,1,1
29979,verrait,0,0,1,1
29947,வாசிக்கும்,0,0,1,1
29948,huvudet,0,0,1,1
29951,докажете,0,0,1,1
29953,isterdim,0,0,1,1
29956,മേഖല,0,0,1,1
29959,poignée,0,0,1,1
29960,uafhængig,0,0,1,1
29961,الطبعة،,0,0,1,1
29962,أسباب,0,0,1,1
29966,tax”,0,0,1,1
29968,ಹೆಚ್ಚಿಸುವುದು,0,0,1,1
29973,algoritmische,0,0,1,1
29974,rubinmarmelade,0,0,1,1
29976,عادة,0,0,1,1
29977,ಬೈಟ್,0,0,1,1
30006,ஸ்பீக்கர்,0,0,1,1
30007,والزميل,0,0,1,1
30008,open—anyone,0,0,1,1
30010,conjuntos,0,0,1,1
30037,différence,0,0,1,1
30038,masivo,0,0,1,1
30039,лицензирован,0,0,1,1
30042,législateur,0,0,1,1
30046,الأحرف,0,0,1,1
30047,ciddi,0,0,1,1
30049,assumer,0,0,1,1
30050,indique,0,0,1,1
30052,بالأحجار,0,0,1,1
30053,സംസാരിക്കുന്ന,0,0,1,1
30054,versionerna,0,0,1,1
30055,arbcom,0,0,1,1
30058,ബാൽക്കണിയിൽ,0,0,1,1
30061,பணியாற்றியவர்,0,0,1,1
30062,വിവരിക്കുമ്പോൾ,0,0,1,1
30036,மறந்துவிடுவார்,0,0,1,1
30031,вайнбергером,0,0,1,1
30030,ombads,0,0,1,1
30017,எண்ணை,0,0,1,1
30011,இயக்கத்துக்கு,0,0,1,1
30012,emne,0,0,1,1
30013,மனிதனுக்கு,0,0,1,1
30014,paciência,0,0,1,1
30015,verkade,0,0,1,1
30016,வலைப்பக்க,0,0,1,1
30018,susceptibility,0,0,1,1
30029,forecasting,0,0,1,1
30019,качаешься,0,0,1,1
30021,زمن,0,0,1,1
30022,supervivencia,0,0,1,1
30023,quente,0,0,1,1
30024,മാതൃകകളിൽ,0,0,1,1
30027,feces,0,0,1,1
29944,βρείτε,0,0,1,1
29940,массовое,0,0,1,1
30295,многочисленных,0,0,1,1
29853,retórico,0,0,1,1
29855,வெளியேற,0,0,1,1
29856,تنس,0,0,1,1
29857,மகத்தான,0,0,1,1
29858,emphase,0,0,1,1
29859,ecosystems,0,0,1,1
29861,ومراجعة,0,0,1,1
29863,«wikipedian,0,0,1,1
29864,surgir,0,0,1,1
29867,تفهمًا,0,0,1,1
29870,hero,0,0,1,1
29871,ವೈಯಕ್ತಿಕವಾಗಿ,0,0,1,1
29872,litígios,0,0,1,1
29873,opfundet,0,0,1,1
29875,banimento,0,0,1,1
29876,conclusion,0,0,1,1
29854,വന്ന,0,0,1,1
29852,datanamnrymd,0,0,1,1
29939,அட்டவணை,0,0,1,1
29851,hoşgeldin,0,0,1,1
29834,specifiek,0,0,1,1
29835,geldim,0,0,1,1
29837,сасаи,0,0,1,1
29838,drown,0,0,1,1
29839,تقليدًا,0,0,1,1
29840,verschiedene,0,0,1,1
29841,வந்தான்,0,0,1,1
29842,السبب,0,0,1,1
29844,العلاجات,0,0,1,1
29845,overused,0,0,1,1
29846,विकिपीडिया।,0,0,1,1
29847,seriøs,0,0,1,1
29848,αναρωτιόμουν,0,0,1,1
29849,μιλήσει,0,0,1,1
29850,parenté,0,0,1,1
29877,compleet,0,0,1,1
29879,verblüffend,0,0,1,1
29881,pratik,0,0,1,1
29883,எதிர்மாறாக,0,0,1,1
29916,locaux,0,0,1,1
29918,endehors,0,0,1,1
29919,συνάντησης,0,0,1,1
29920,counterparts,0,0,1,1
29921,indican,0,0,1,1
29923,फोरम,0,0,1,1
29924,παλιό,0,0,1,1
29927,sidvisningar,0,0,1,1
29928,στατιστικές,0,0,1,1
29931,léthargiques,0,0,1,1
29932,φτωχή,0,0,1,1
29934,ദുരുദ്ദേശ്യത്തോടുകൂടി,0,0,1,1
29936,الوحيدة,0,0,1,1
29937,arrastrar,0,0,1,1
29938,fécond,0,0,1,1
29915,categorias,0,0,1,1
29910,மொழிகள்,0,0,1,1
29908,выпустил,0,0,1,1
29893,interromper,0,0,1,1
29885,electrónico,0,0,1,1
29886,житомирской,0,0,1,1
29888,ambiguidade,0,0,1,1
29889,தரங்கள்,0,0,1,1
29890,സാവധാനത്തിൽ,0,0,1,1
29891,cnet,0,0,1,1
29895,επισκευή,0,0,1,1
29907,പറയുന്നതും,0,0,1,1
29896,connectionist,0,0,1,1
29897,perçues,0,0,1,1
29899,مهما,0,0,1,1
29902,भगवान,0,0,1,1
29903,wurzelwörter,0,0,1,1
29905,multicamadas,0,0,1,1
30063,geçmişinde,0,0,1,1
30064,granska,0,0,1,1
30065,répétition,0,0,1,1
30216,alamaz,0,0,1,1
30218,diagrams,0,0,1,1
30219,सोचने,0,0,1,1
30220,gränsen,0,0,1,1
30221,beskrivelsesboksen,0,0,1,1
30222,இடம்பெறலாம்,0,0,1,1
30224,الإداريون،,0,0,1,1
30225,നൈട്രജൻ,0,0,1,1
30226,intercepter,0,0,1,1
30229,persian,0,0,1,1
30230,இதழ்,0,0,1,1
30232,സമയമാണ്,0,0,1,1
30233,പ്രിന്റ്,0,0,1,1
30234,தகவல்,0,0,1,1
30236,signo,0,0,1,1
30237,искусства,0,0,1,1
30217,kalt,0,0,1,1
30215,meningsmotståndare,0,0,1,1
30066,subtiele,0,0,1,1
30214,خذ,0,0,1,1
30189,blijft,0,0,1,1
30191,लगेगा,0,0,1,1
30192,recherches,0,0,1,1
30193,dönüyor,0,0,1,1
30194,சிக்கல்களையும்,0,0,1,1
30196,évaluation,0,0,1,1
30197,citizens,0,0,1,1
30199,ലേഖനങ്ങളായി,0,0,1,1
30201,multidisciplinært,0,0,1,1
30205,connus,0,0,1,1
30208,தன்னார்வலர்களால்,0,0,1,1
30209,знаку,0,0,1,1
30210,الخصوص،,0,0,1,1
30211,ethane,0,0,1,1
30213,phpвикидвижке,0,0,1,1
30239,νυφικό,0,0,1,1
30240,खुफिया,0,0,1,1
30241,maruz,0,0,1,1
30244,ಆರು,0,0,1,1
30272,alcanzase,0,0,1,1
30273,dakikalar,0,0,1,1
30275,επικό,0,0,1,1
30276,रेटिंग,0,0,1,1
30282,भेजूंगा,0,0,1,1
30283,உயர்த்தலாம்,0,0,1,1
30284,विन्यास,0,0,1,1
30286,forklare,0,0,1,1
30287,præcision,0,0,1,1
30288,hémisphère,0,0,1,1
30289,σύγκριση,0,0,1,1
30291,കോടതിയോ,0,0,1,1
30292,മുങ്ങുന്നു,0,0,1,1
30293,reproducción,0,0,1,1
30294,πηγή,0,0,1,1
30271,skarpaste,0,0,1,1
30270,ущерб,0,0,1,1
30267,sustainable,0,0,1,1
30255,நாட்களாக,0,0,1,1
30247,"
कापमपंगन",0,0,1,1
30248,primair,0,0,1,1
30249,isteyebilirim,0,0,1,1
30250,الأمير,0,0,1,1
30251,commencer,0,0,1,1
30254,ಭಾಗವು,0,0,1,1
30256,aptitudes,0,0,1,1
30265,evliliği,0,0,1,1
30257,transforme,0,0,1,1
30260,prazo,0,0,1,1
30261,ജ്യാമിതി,0,0,1,1
30262,bærende,0,0,1,1
30263,resultatet,0,0,1,1
30264,segos,0,0,1,1
30188,spécifique,0,0,1,1
30186,kritiker,0,0,1,1
30185,remarquez,0,0,1,1
30115,kina,0,0,1,1
30093,  euros,0,0,1,1
30094,privilégios,0,0,1,1
30095,juiz,0,0,1,1
30097,введена,0,0,1,1
30098,حساء,0,0,1,1
30099,«wikileaks»​,0,0,1,1
30100,contenus,0,0,1,1
30101,mariée,0,0,1,1
30102,пределы,0,0,1,1
30104,zulke,0,0,1,1
30106,conseguirá,0,0,1,1
30108,мороженого,0,0,1,1
30110,encontrarás,0,0,1,1
30111,unutuyor,0,0,1,1
30112,لمشروع,0,0,1,1
30092,« valeur »,0,0,1,1
30091,solely,0,0,1,1
30090,hoşçakal,0,0,1,1
30076,എങ്ങനെയെങ്കിലും,0,0,1,1
30067,تعقب,0,0,1,1
30068,situaban,0,0,1,1
30070,ചെയ്യാതെ,0,0,1,1
30072,préparer,0,0,1,1
30073,universellement,0,0,1,1
30074,अनगिनत,0,0,1,1
30078,sustainability,0,0,1,1
30088,hoppar,0,0,1,1
30080,yazar,0,0,1,1
30081,çalışmıyorsa,0,0,1,1
30082,“tax,0,0,1,1
30083,മാണിക്യത്തിന്റെ,0,0,1,1
30084,nintendo,0,0,1,1
30086,έτοιμοι,0,0,1,1
30114,foran,0,0,1,1
30117,má,0,0,1,1
30182,இலக்கணம்,0,0,1,1
30119,unexpected,0,0,1,1
30154,попросите,0,0,1,1
30156,noticed,0,0,1,1
30157,vriendelijke,0,0,1,1
30158,ഉണ്ടാവുക,0,0,1,1
30159,γρήγορους,0,0,1,1
30161,അഞ്ചുമിനിറ്റിനുള്ളിൽ,0,0,1,1
30162,rápido»​,0,0,1,1
30163,llamar,0,0,1,1
30169,precedes,0,0,1,1
30172,சாப்பிடமுடியாத,0,0,1,1
30173,trubbiga,0,0,1,1
30174,preciosas,0,0,1,1
30177,mme,0,0,1,1
30178,surveillants,0,0,1,1
30181,يستخدمون,0,0,1,1
30148,ergs,0,0,1,1
30146,неопытных,0,0,1,1
30145,rappeler,0,0,1,1
30131,രോഗികളുടെ,0,0,1,1
30120,launches,0,0,1,1
30121,utforma,0,0,1,1
30123,innehållsstyrande,0,0,1,1
30125,நண்பர்களிடம்,0,0,1,1
30127,interesan,0,0,1,1
30128,editörler,0,0,1,1
30132,négliger,0,0,1,1
30144,radera,0,0,1,1
30133,disculpas,0,0,1,1
30134,utländska,0,0,1,1
30138,ഇതി,0,0,1,1
30140,schommelt,0,0,1,1
30141,ബെൽഗാം,0,0,1,1
30143,enten,0,0,1,1
30764,ευχηθείτε,0,0,1,1
30766,—administrador—,0,0,1,1
30767,samengewerkt,0,0,1,1
31370,تستطيع,0,0,1,1
31373,âme,0,0,1,1
31374,reputação,0,0,1,1
31375,നിലനിൽപ്പുണ്ടാവൂ,0,0,1,1
31376,besonders,0,0,1,1
31379,boyunca,0,0,1,1
31383,protective,0,0,1,1
31384,ನೋಡುತ್ತಿದ್ದಾಗ,0,0,1,1
31385,πάρεις,0,0,1,1
31386,regardant,0,0,1,1
31388,engelsktalende,0,0,1,1
31389,documentação,0,0,1,1
31390,saknar,0,0,1,1
31391,protester»,0,0,1,1
31392,établit,0,0,1,1
31393,கேள்விக்குறியுடன்,0,0,1,1
31372,yiyeceklerden,0,0,1,1
31368,amont,0,0,1,1
31343,попрощавшись,0,0,1,1
31367,مؤكدة،,0,0,1,1
31347,успешно,0,0,1,1
31348,ರತ್ನಗಳು,0,0,1,1
31349,планете,0,0,1,1
31351,adequadamente,0,0,1,1
31352,являющейся,0,0,1,1
31354,μερικοί,0,0,1,1
31355,kommentarfältet,0,0,1,1
31357,shortly,0,0,1,1
31358,зайдите,0,0,1,1
31359,bedrijven,0,0,1,1
31360,homogénéité,0,0,1,1
31362,interactividad,0,0,1,1
31363,seyahatleri,0,0,1,1
31364,статей»,0,0,1,1
31365,परियोजनाएंजैसे,0,0,1,1
31394,самоорганизацией,0,0,1,1
31395,limitée,0,0,1,1
31396,ruwe,0,0,1,1
31400,assumant,0,0,1,1
31431,nonlinearity,0,0,1,1
31432,रत्नों,0,0,1,1
31434,ചെറുപെട്ടികളിൽ,0,0,1,1
31435,consultable,0,0,1,1
31438,الأمريكيين,0,0,1,1
31439,αχνό,0,0,1,1
31441,refus,0,0,1,1
31442,beats,0,0,1,1
31444,verre,0,0,1,1
31445,probabilístico,0,0,1,1
31446,accessdatum,0,0,1,1
31448,piensas,0,0,1,1
31451,متطورًا,0,0,1,1
31452,anlatabilir,0,0,1,1
31453,polícia,0,0,1,1
31427,wikipédianota,0,0,1,1
31426,conselho,0,0,1,1
31425,അതിശയകരമാംവിധം,0,0,1,1
31414,вышедших,0,0,1,1
31402,خادم,0,0,1,1
31405,schlägt,0,0,1,1
31407,പലരുണ്ടാവുംഅവരുടെ,0,0,1,1
31410,jedes,0,0,1,1
31411,ഇറ്റാലിയൻ,0,0,1,1
31413,améliorezle,0,0,1,1
31415,വിക്കിസമൂഹമെന്നും,0,0,1,1
31424,ഉയർത്തുകയും,0,0,1,1
31416,smiles,0,0,1,1
31417,clasificados,0,0,1,1
31418,entscheidungen,0,0,1,1
31420,تتطلب,0,0,1,1
31422,revertidas,0,0,1,1
31423,خرج,0,0,1,1
31344,"ethics ·
environmental",0,0,1,1
31342,победил,0,0,1,1
31229,kennenzulernen,0,0,1,1
31263,operan,0,0,1,1
31266,apreço,0,0,1,1
31267,सर्व,0,0,1,1
31268,neerlandesa,0,0,1,1
31272,فموسوعة,0,0,1,1
31274,"
चैचन",0,0,1,1
31275,بالقرب,0,0,1,1
31276,சிந்திக்க,0,0,1,1
31277,texts,0,0,1,1
31280,« aujourd,0,0,1,1
31281,ചോദ്യത്തിന്,0,0,1,1
31283,kalkylark,0,0,1,1
31284,விளைவிக்கும்,0,0,1,1
31290,الروبوت,0,0,1,1
31291,سرعان,0,0,1,1
31292,dominerande,0,0,1,1
31264,otimizam,0,0,1,1
31261,प्रकाशन,0,0,1,1
31341,croît,0,0,1,1
31259,textual,0,0,1,1
31231,webbpubliceringssystem,0,0,1,1
31233,interventions,0,0,1,1
31234,संयुक्त,0,0,1,1
31235,latinske,0,0,1,1
31239,governamental,0,0,1,1
31242,മെഷീൻ,0,0,1,1
31243,ದೂರ,0,0,1,1
31246,കരയുന്നത്,0,0,1,1
31249,ಸ್ಟುಪೆಂಡಸ್,0,0,1,1
31251,प्रभाविकता,0,0,1,1
31252,eettafel,0,0,1,1
31253,فصاعدًا,0,0,1,1
31254,oyununuzu,0,0,1,1
31256,effectués,0,0,1,1
31257,صحتك,0,0,1,1
31294,ücretsiz,0,0,1,1
31295,வெளியிடப்படும்,0,0,1,1
31296,teniendo,0,0,1,1
31297,μέσων,0,0,1,1
31321,آداب,0,0,1,1
31322,mezcla,0,0,1,1
31323,αλήθεια,0,0,1,1
31324,informeel,0,0,1,1
31325,υποστηρίζει,0,0,1,1
31329,ಚಲನಚಿತ್ರಗಳನ್ನು,0,0,1,1
31330,ஒலி,0,0,1,1
31331,hablantes,0,0,1,1
31333,herói,0,0,1,1
31334,ದೇವದೂತನಾಗಿದ್ದೇನೆ,0,0,1,1
31335,driver,0,0,1,1
31336,அந்தக்,0,0,1,1
31337,ಸಾಬೀತುಪಡಿಸದ,0,0,1,1
31339,platz,0,0,1,1
31340,probabilities,0,0,1,1
31320,incité,0,0,1,1
31319,சகோதரத்,0,0,1,1
31318,personificação,0,0,1,1
31306,yorumlar,0,0,1,1
31298,публикация,0,0,1,1
31299,uğraşısı,0,0,1,1
31300,ಮಂಚದ,0,0,1,1
31302,auffordert,0,0,1,1
31304,synergies,0,0,1,1
31305,зачастую,0,0,1,1
31307,släktforskare,0,0,1,1
31317,wikipediagemeenschap,0,0,1,1
31308,apprendra,0,0,1,1
31310,सियोल,0,0,1,1
31312,arduamente,0,0,1,1
31314,regards,0,0,1,1
31315,hemisphere,0,0,1,1
31316,viaf,0,0,1,1
31454,—usuarios,0,0,1,1
31455,هنري,0,0,1,1
31456,chariot,0,0,1,1
31595,вела,0,0,1,1
31597,आंतरिक,0,0,1,1
31598,mercury,0,0,1,1
31599,sällan,0,0,1,1
31600,എന്താണെന്ന്,0,0,1,1
31603,шесть,0,0,1,1
31605,främsta,0,0,1,1
31606,الملح،,0,0,1,1
31608,ಹೊಂದಿಲ್ಲದಿದ್ದರೆ,0,0,1,1
31610,génèrent,0,0,1,1
31611,adapter,0,0,1,1
31612,åtanke,0,0,1,1
31614,executados,0,0,1,1
31617,gerçekleşmez,0,0,1,1
31619,"
नॉर्मन",0,0,1,1
31621,virtuellement,0,0,1,1
31596,vandalizadoras,0,0,1,1
31594,οκτώ,0,0,1,1
31457,பொறி,0,0,1,1
31593,τέρι,0,0,1,1
31566,líderes,0,0,1,1
31568,seferinde,0,0,1,1
31569,fuertes,0,0,1,1
31571,письме,0,0,1,1
31572,бриллиантами,0,0,1,1
31576,gegenteil,0,0,1,1
31578,congress—the,0,0,1,1
31580,கிளிக்,0,0,1,1
31581,поверить,0,0,1,1
31585,விக்கித்,0,0,1,1
31586,representaban,0,0,1,1
31587,casser,0,0,1,1
31588,triggered,0,0,1,1
31589,"
बश्किर",0,0,1,1
31592,icono,0,0,1,1
31622,mütevazı,0,0,1,1
31624,islandés,0,0,1,1
31625,രണ്ടെണ്ണം,0,0,1,1
31627,vuil,0,0,1,1
31656,பயன்படுத்தப்படலாம்,0,0,1,1
31658,ಅರ್ಥವೇನೆಂದು,0,0,1,1
31659,favoring,0,0,1,1
31664,dilema,0,0,1,1
31665,telefonunu,0,0,1,1
31666,ಫೋನ್‌ನಲ್ಲಿ,0,0,1,1
31667,ಹೇಳಿದಾಗ,0,0,1,1
31669,generelle,0,0,1,1
31670,обобщённой,0,0,1,1
31671,åbne,0,0,1,1
31672,handlinger,0,0,1,1
31675,കണ്ടെത്തിയ,0,0,1,1
31676,pålitlighet,0,0,1,1
31677,gestão,0,0,1,1
31681,വെക്കാനുള്ള,0,0,1,1
31655,त्रुटियां,0,0,1,1
31654,скрыты,0,0,1,1
31652,hiérarchisation,0,0,1,1
31640,किस्मत,0,0,1,1
31630,sınava,0,0,1,1
31631,التحذيرات,0,0,1,1
31633,göreceksiniz,0,0,1,1
31637,चारों,0,0,1,1
31638,desculpando,0,0,1,1
31639,kilomètre,0,0,1,1
31641,شريحة,0,0,1,1
31651,مبني,0,0,1,1
31643,sk •,0,0,1,1
31644,வாக்கியங்களை,0,0,1,1
31645,modificación,0,0,1,1
31647,strukturerat,0,0,1,1
31648,ثابتة,0,0,1,1
31649,sigues,0,0,1,1
31565,sencillez,0,0,1,1
31561,تشابك,0,0,1,1
31560,basisconcept,0,0,1,1
31507,கூட்டாக்க,0,0,1,1
31484,bleiben,0,0,1,1
31485,ಹತ್ತಿದಳು,0,0,1,1
31486,bewildered,0,0,1,1
31487,aldeia,0,0,1,1
31488,saludos,0,0,1,1
31489,ഉപയോഗിക്കുന്നത്,0,0,1,1
31490,வாசகரும்,0,0,1,1
31491,разговаривали,0,0,1,1
31494,vaters,0,0,1,1
31496,चले,0,0,1,1
31498,gradientes,0,0,1,1
31499,"
जर्मन",0,0,1,1
31501,करेंगी,0,0,1,1
31502,descobertas,0,0,1,1
31504,d’adaptation,0,0,1,1
31483,физикохимических,0,0,1,1
31482,чём,0,0,1,1
31481,vogvimageoptionsin,0,0,1,1
31467,°w﻿,0,0,1,1
31458,avísame,0,0,1,1
31459,religions,0,0,1,1
31461,schéma,0,0,1,1
31462,مستحيلًا,0,0,1,1
31465,primarias,0,0,1,1
31466,അന്ധാളിച്ച്,0,0,1,1
31469,மணமான,0,0,1,1
31480,gebruiksvriendelijk,0,0,1,1
31470,ಹೊಂದಿದ್ದಾನೆ,0,0,1,1
31472,fundó,0,0,1,1
31474,ornamentation,0,0,1,1
31476,சொல்லிலிருந்து,0,0,1,1
31477,построить,0,0,1,1
31478,forment,0,0,1,1
31506,தொடங்கப்,0,0,1,1
31508,şişman,0,0,1,1
31557,robes,0,0,1,1
31510,magnétique,0,0,1,1
31535,information ,0,0,1,1
31537,दुखी,0,0,1,1
31539,vidas,0,0,1,1
31542,ем,0,0,1,1
31543,alınmış,0,0,1,1
31544,"
वू",0,0,1,1
31545,econômicas,0,0,1,1
31546,wiskundeboek,0,0,1,1
31547,wetlands,0,0,1,1
31548,தேடலில்,0,0,1,1
31550,فيرجينيا,0,0,1,1
31551,gratitude,0,0,1,1
31552,தகவல்களை,0,0,1,1
31553,высшая,0,0,1,1
31556,തർക്കം,0,0,1,1
31533,تفسرها,0,0,1,1
31532,محل,0,0,1,1
31531,отвечающие,0,0,1,1
31520,करमुक्त,0,0,1,1
31511,uitzicht,0,0,1,1
31512,tomó,0,0,1,1
31513,ಬೆಳಗಬಹುದು,0,0,1,1
31515,efectuada,0,0,1,1
31517,​​kolayca,0,0,1,1
31518,arrays,0,0,1,1
31521,necesitamos,0,0,1,1
31530,சகோதரியாகவோ,0,0,1,1
31522,lignendeknappen,0,0,1,1
31523,hazard,0,0,1,1
31525,föreställ,0,0,1,1
31526,مذهلاً,0,0,1,1
31528,totalités,0,0,1,1
31529,vecteur,0,0,1,1
31230,approprié,0,0,1,1
31228,ഗ്രഹങ്ങളിൽ,0,0,1,1
30768,വസ്തുതകൾ,0,0,1,1
30916,добивается,0,0,1,1
30918,hansson,0,0,1,1
30920,forsøger,0,0,1,1
30922,reclama,0,0,1,1
30924,собака,0,0,1,1
30926,minutiae,0,0,1,1
30927,vejret,0,0,1,1
30933,protracted,0,0,1,1
30934,thème ,0,0,1,1
30936,أهلا,0,0,1,1
30938,ondervertegenwoordigd,0,0,1,1
30939,ಮನೋರಂಜನಾ,0,0,1,1
30942,compete,0,0,1,1
30944,организатор,0,0,1,1
30945,soppa,0,0,1,1
30947,dondurmaya,0,0,1,1
30917,дампа,0,0,1,1
30915,διαμάντια,0,0,1,1
30891,geçtiğini,0,0,1,1
30914,yapıyorum,0,0,1,1
30893,pornoactrices,0,0,1,1
30895,ശൈലികളെയും,0,0,1,1
30896,reçue,0,0,1,1
30898,viktig,0,0,1,1
30900,رفض,0,0,1,1
30901,франко,0,0,1,1
30902,şehirdeki,0,0,1,1
30903,ethnocentrique,0,0,1,1
30904,запросов,0,0,1,1
30906,തമ്മിലുള്ള,0,0,1,1
30907,организации,0,0,1,1
30908,മെച്ചപ്പെടുത്തുന്നുണ്ട്,0,0,1,1
30909,financés,0,0,1,1
30911,seraitce,0,0,1,1
30912,kanılara,0,0,1,1
30948,prohibieron,0,0,1,1
30949,ಫಿಕ್ಸ್‌ನ,0,0,1,1
30951,vacant,0,0,1,1
30953,തന്നെയാണ്,0,0,1,1
30976,xanadu,0,0,1,1
30978,robôs,0,0,1,1
30979,enrichir,0,0,1,1
30982,luminosity,0,0,1,1
30983,lieblingssmartwort,0,0,1,1
30984,hardly,0,0,1,1
30985,باحث,0,0,1,1
30986,alcanzaron,0,0,1,1
30987,anlatsaydı,0,0,1,1
30988,hakkını,0,0,1,1
30989,رجل,0,0,1,1
30990,pegue,0,0,1,1
30991,та,0,0,1,1
30993,результата,0,0,1,1
30995,apavorante,0,0,1,1
30975,necesito,0,0,1,1
30974,infelizmente,0,0,1,1
30973,kullanabileceğinizi,0,0,1,1
30961,herhaling,0,0,1,1
30955,கணக்கொன்று,0,0,1,1
30956,ಟ್ರಿಕಿ,0,0,1,1
30957,efeito,0,0,1,1
30958,نسخ,0,0,1,1
30959,sugestões,0,0,1,1
30960,principlenote,0,0,1,1
30963,ongelooflijk,0,0,1,1
30972,التفاصيل,0,0,1,1
30964,أبعد,0,0,1,1
30965,т н,0,0,1,1
30966,supermarkets,0,0,1,1
30969,ಬಳಿ,0,0,1,1
30970,உடன்படுகிறேன்,0,0,1,1
30971,கொடுக்கும்,0,0,1,1
30892,vietnamese,0,0,1,1
30890,അസ്വസ്ഥമാകരുത്,0,0,1,1
31226,faltas,0,0,1,1
30796,redigido,0,0,1,1
30798,одед,0,0,1,1
30799,söyledi,0,0,1,1
30800,amplo,0,0,1,1
30804,vardag,0,0,1,1
30805,niks,0,0,1,1
30806,"
विष्णुप्रिया",0,0,1,1
30812,ഗൂഗിളിലേക്ക്,0,0,1,1
30814,ഓഫറുകൾ,0,0,1,1
30815,femenino,0,0,1,1
30816,androidbased,0,0,1,1
30817,новейший,0,0,1,1
30821,bioinformatique,0,0,1,1
30822,распространению,0,0,1,1
30823,nachricht,0,0,1,1
30824,ಜಾಮ್‌ಗಳನ್ನು,0,0,1,1
30797,notice,0,0,1,1
30795,udøver,0,0,1,1
30889,εσυ,0,0,1,1
30794,koldt,0,0,1,1
30771,tårer,0,0,1,1
30772,traversa,0,0,1,1
30775,suivie,0,0,1,1
30776,ertrage,0,0,1,1
30778,onderwerpen,0,0,1,1
30780,आधिकारिक,0,0,1,1
30781,σαλάτες,0,0,1,1
30783,போரின்போது,0,0,1,1
30784,preocupação,0,0,1,1
30785,philosophical,0,0,1,1
30786,fizera,0,0,1,1
30788,செய்திகள்,0,0,1,1
30790,drømmen,0,0,1,1
30792,ಎಳೆಯಬಹುದು,0,0,1,1
30793,ठोक,0,0,1,1
30827,meteors,0,0,1,1
30830,നടുങ്ങിപ്പോയി,0,0,1,1
30831,fonctionnement ,0,0,1,1
30832,antalet,0,0,1,1
30868,टाइम,0,0,1,1
30872,ಸಹೋದರಿ,0,0,1,1
30873,حان,0,0,1,1
30875,ಎಂಟು,0,0,1,1
30876,அதிகாரத்,0,0,1,1
30877,தந்திரமான,0,0,1,1
30878,fonctionne,0,0,1,1
30879,aturdido,0,0,1,1
30881,etmez,0,0,1,1
30883,mjölstädarna,0,0,1,1
30884,തളർന്നില്ലെന്ന്,0,0,1,1
30885,сетевая,0,0,1,1
30886,"
servocroata",0,0,1,1
30887,författares,0,0,1,1
30888,amüsanteste,0,0,1,1
30867,london,0,0,1,1
30864,taler,0,0,1,1
30863,പൂർണ്ണമായ,0,0,1,1
30848,प्रयास।,0,0,1,1
30834,preguntaba,0,0,1,1
30836,கலைக்களஞ்சிய,0,0,1,1
30837,ഭാഗ്യവാൻ,0,0,1,1
30843,обобщением,0,0,1,1
30844,tamamlanmayacağı,0,0,1,1
30847,hemlighet,0,0,1,1
30849,ആയിരുന്നെങ്കിൽ,0,0,1,1
30861,täckte,0,0,1,1
30851,upptäckt,0,0,1,1
30852,kritisk,0,0,1,1
30853,تشتكي,0,0,1,1
30856,مثالية,0,0,1,1
30857,иракскую,0,0,1,1
30859,afundar,0,0,1,1
30996,estúpido,0,0,1,1
30998,sodass,0,0,1,1
31000,"
फ़ैरोई",0,0,1,1
31151,sills,0,0,1,1
31154,robots ,0,0,1,1
31156,quién,0,0,1,1
31158,revolución,0,0,1,1
31161,популярным,0,0,1,1
31162,« nécessaire »,0,0,1,1
31163,slumpmässigt,0,0,1,1
31164,actualización,0,0,1,1
31165,güvenilebilirliği,0,0,1,1
31166,prettiest,0,0,1,1
31167,voies,0,0,1,1
31168,تتمتع,0,0,1,1
31169,sentiment,0,0,1,1
31170,богатство,0,0,1,1
31171,എഴുതാവുന്നതുകൊണ്ട്,0,0,1,1
31172,fournies,0,0,1,1
31152,ഇല്ലെങ്കിൽ,0,0,1,1
31150,ενδιαφέρουσα,0,0,1,1
31001,подошел,0,0,1,1
31148,تتحدث,0,0,1,1
31123,δώστε,0,0,1,1
31125,അസ്സാമീസ്,0,0,1,1
31127,historiquement,0,0,1,1
31128,altı,0,0,1,1
31130,комиксе,0,0,1,1
31131,некоторыми,0,0,1,1
31135,മിനിറ്റുകൾക്കുള്ളിൽ,0,0,1,1
31136,μπαράκ,0,0,1,1
31138,girdilerin,0,0,1,1
31139,المميزات,0,0,1,1
31140,കണ്ടെത്താൻ,0,0,1,1
31142,ряд,0,0,1,1
31143,ييل,0,0,1,1
31144,ce •,0,0,1,1
31147,l’« homme,0,0,1,1
31173,ಸುಂದರವಾದ,0,0,1,1
31174,inferred,0,0,1,1
31175,للتحدث,0,0,1,1
31176,решающее,0,0,1,1
31203,intelligence »,0,0,1,1
31204,تحاول,0,0,1,1
31205,γάμο,0,0,1,1
31206,confunde,0,0,1,1
31209,ಎಲ್ಲ,0,0,1,1
31212,पोस्टिंग,0,0,1,1
31215,actuele,0,0,1,1
31216,demás,0,0,1,1
31217,pathogenic,0,0,1,1
31218,स्टैनफोर्ड,0,0,1,1
31219,personligen,0,0,1,1
31220,económicos,0,0,1,1
31221,humanlike,0,0,1,1
31223,εκπλήσσει,0,0,1,1
31224,ചിന്തിച്ചേക്കാം,0,0,1,1
31202,شديدة,0,0,1,1
31200,lyngfelt,0,0,1,1
31199,couru,0,0,1,1
31185,बराक,0,0,1,1
31177,ആരംഭിക്കാനുള്ള,0,0,1,1
31178,gorilas,0,0,1,1
31179,сверху,0,0,1,1
31180,assistant,0,0,1,1
31182,oriente,0,0,1,1
31183,å,0,0,1,1
31186,besorgt,0,0,1,1
31197,nature‏,0,0,1,1
31187,inteiro,0,0,1,1
31191,redaktion,0,0,1,1
31192,organisationer,0,0,1,1
31193,помедленнее,0,0,1,1
31194,проживет,0,0,1,1
31196,dénuées,0,0,1,1
31120,غدًا,0,0,1,1
31119,шутишь,0,0,1,1
31113,настоянию,0,0,1,1
31054,മറന്നതിനാൽ,0,0,1,1
31032,"
लिम्बुर्गियाई",0,0,1,1
31034,"
hebraico",0,0,1,1
31035,образовано,0,0,1,1
31036,injunction,0,0,1,1
31037,alcançado,0,0,1,1
31038,connexion,0,0,1,1
31039,टक्कर,0,0,1,1
31041,αρέσει,0,0,1,1
31042,الاحتفاظ,0,0,1,1
31043,اعمده,0,0,1,1
31044,"
स्लोवाक",0,0,1,1
31047,വലിച്ചിടുന്നതോ,0,0,1,1
31048,personnels,0,0,1,1
31050,ಮಾಡುತ್ತದೆ,0,0,1,1
31051,contraire ,0,0,1,1
31026,للمستخدمين,0,0,1,1
31025,файлы,0,0,1,1
31023,aumenten,0,0,1,1
31009,avsedda,0,0,1,1
31002,والثاني,0,0,1,1
31003,abnormal,0,0,1,1
31004,géographie,0,0,1,1
31005,censurer,0,0,1,1
31006,телефон,0,0,1,1
31008,моим,0,0,1,1
31015,jolie,0,0,1,1
31022,категории,0,0,1,1
31016,разделения,0,0,1,1
31017,förhållanden,0,0,1,1
31018,intervalos,0,0,1,1
31019,korean,0,0,1,1
31020,சேர்க்கப்பட்டதும்,0,0,1,1
31021,entendre,0,0,1,1
31053,धैर्य,0,0,1,1
31055,വാങ്ങില്ല,0,0,1,1
31111,franskspråkiga,0,0,1,1
31056,allemagne,0,0,1,1
31085,ಆಟದ,0,0,1,1
31086,einzigen,0,0,1,1
31089,placeholder,0,0,1,1
31090,publicité,0,0,1,1
31092,പ്രേരിപ്പിക്കുന്നതെന്താണ്,0,0,1,1
31093,βιδώσω,0,0,1,1
31094,κάθονται,0,0,1,1
31097,पूछें।,0,0,1,1
31098,பரிசீலித்து,0,0,1,1
31099,conscientes,0,0,1,1
31100,البطاطس,0,0,1,1
31103,முன்னால்,0,0,1,1
31104,élevés,0,0,1,1
31109,télégramme,0,0,1,1
31110,« apprendre »,0,0,1,1
31084,модель,0,0,1,1
31082,होस्टिंग,0,0,1,1
31081,παντρευτεί,0,0,1,1
31069,apologizing,0,0,1,1
31058,открытое,0,0,1,1
31059,appelant,0,0,1,1
31061,утопление,0,0,1,1
31062,வாழ்ந்தார்,0,0,1,1
31065,എല്ലാവരും,0,0,1,1
31068,knams,0,0,1,1
31070,kaputt,0,0,1,1
31080,légitime,0,0,1,1
31072,topten,0,0,1,1
31074,μέρους,0,0,1,1
31075,ಖರೀದಿಸಿದ,0,0,1,1
31077,എഴുതിയ,0,0,1,1
31078,подход,0,0,1,1
31079,ومشتق,0,0,1,1
26089,габриэлем,0,0,1,1
26086,τρομερό,0,0,1,1
26085,наблюдаемой,0,0,1,1
21105,nyskapade,0,0,1,1
21110,iluminado,0,0,1,1
21111,ماي,0,0,1,1
21112,الموقف,0,0,1,1
21113,καλύτερος,0,0,1,1
21117,latitudinal,0,0,1,1
21118,önünde,0,0,1,1
21122,recolección,0,0,1,1
21123,таинственное,0,0,1,1
21124,"
यिद्दी",0,0,1,1
21126,കാര്യത്തിനിടയിലാണെങ്കിൽ,0,0,1,1
21127,родном,0,0,1,1
21128,schrok,0,0,1,1
21129,твоих,0,0,1,1
21130,diyorlarsa,0,0,1,1
21131,filme,0,0,1,1
21106,imaginez,0,0,1,1
21104,chef,0,0,1,1
21076,سجلت,0,0,1,1
21103,كثير,0,0,1,1
21079,insult,0,0,1,1
21080,storlek,0,0,1,1
21083,palavrasraiz,0,0,1,1
21084,duyarım,0,0,1,1
21086,hopefully,0,0,1,1
21088,അതിർത്തി,0,0,1,1
21090,afbalancerede,0,0,1,1
21092,ಹೇಳು,0,0,1,1
21094,diretivo,0,0,1,1
21096,correspondante,0,0,1,1
21097,valorizado,0,0,1,1
21098,yazılmalıdır,0,0,1,1
21099,ಮೂಲವೆಂದರೆ,0,0,1,1
21100,ಅಮ್ಮನಾಗಿ,0,0,1,1
21102,खींच,0,0,1,1
21132,देखकर,0,0,1,1
21133,garaj,0,0,1,1
21134,geprägt,0,0,1,1
21135,estornudó,0,0,1,1
21160,múltiplos,0,0,1,1
21162,attendre,0,0,1,1
21163,ವ್ಯಾಕರಣ,0,0,1,1
21166,αναβαθμίστε,0,0,1,1
21170,വിവര,0,0,1,1
21172,renforcée,0,0,1,1
21173,стран,0,0,1,1
21175,المضللة,0,0,1,1
21176,ζητήσουν,0,0,1,1
21177,ഗുണമേന്മയുള്ള,0,0,1,1
21178,ira,0,0,1,1
21180,magique,0,0,1,1
21181,ملابس,0,0,1,1
21182,gevangenen,0,0,1,1
21183,yakalamadığını,0,0,1,1
21159,ഡ്രിങ്ക്,0,0,1,1
21158,الضابطة,0,0,1,1
21157,ದಿನದಿಂದ,0,0,1,1
21144,carry,0,0,1,1
21137,захватывающее,0,0,1,1
21139,bays,0,0,1,1
21140,ഇക്കാര്യത്തിലും,0,0,1,1
21141,ഇതിനെക്കുറിച്ച്,0,0,1,1
21142,integrity,0,0,1,1
21143,स्कॉलरपीडिया,0,0,1,1
21145,verändert,0,0,1,1
21155,वॉन,0,0,1,1
21147,чаще,0,0,1,1
21148,يخبرني,0,0,1,1
21149,αλλάξουν,0,0,1,1
21151,മാതൃകയിൽപ്പോലും,0,0,1,1
21152,backgrounds,0,0,1,1
21153,étonné,0,0,1,1
21078,internetcensur,0,0,1,1
21075,stelde,0,0,1,1
21186,приходили,0,0,1,1
20983,أليكسا,0,0,1,1
20986,രചയിതാവില്ല,0,0,1,1
20987,يغرق,0,0,1,1
20988,ഒരിക്കൽ,0,0,1,1
20990,அமைந்திருந்தது,0,0,1,1
20993,rattraper,0,0,1,1
20994,സമൂഹത്തിൽ,0,0,1,1
20995,lov,0,0,1,1
20996,عالمية،,0,0,1,1
20997,இயங்கத்,0,0,1,1
20999,exigidos,0,0,1,1
21000,خاص,0,0,1,1
21003,copo,0,0,1,1
21005,slutade,0,0,1,1
21006,μεγαλύτερη,0,0,1,1
21007,энциклопедий,0,0,1,1
20984,زعم,0,0,1,1
20981,செய்நிரல்கள்’,0,0,1,1
21073,ತಿಳಿದಿರಬೇಕು,0,0,1,1
20978,انتحال,0,0,1,1
20958,ലഭിക്കുന്നതിന്,0,0,1,1
20959,giriş,0,0,1,1
20960,orbital,0,0,1,1
20961,मानचित्र,0,0,1,1
20962,commercialisé,0,0,1,1
20963,emeğiniz,0,0,1,1
20965,influencé,0,0,1,1
20967,редактирование,0,0,1,1
20968,abstraite,0,0,1,1
20969,kontrollera,0,0,1,1
20971,preserving,0,0,1,1
20972,दिनों,0,0,1,1
20974,एकत्रित,0,0,1,1
20976,alıştırması,0,0,1,1
20977,elever,0,0,1,1
21008,planları,0,0,1,1
21010,जावा,0,0,1,1
21011,സാമാന്യവത്കരണത്തെയും,0,0,1,1
21014,interglaciaires,0,0,1,1
21046,வித்தியாசமாகக்,0,0,1,1
21047,smilede,0,0,1,1
21048,ಪುನರಾವರ್ತನೆ,0,0,1,1
21050,variedad,0,0,1,1
21053,தாய்க்கு,0,0,1,1
21056,στάση,0,0,1,1
21057,തയ്യാറാണ്,0,0,1,1
21059,preconceitos,0,0,1,1
21060,etmesini,0,0,1,1
21061,وإنشاء,0,0,1,1
21063,singulière,0,0,1,1
21066,забывает,0,0,1,1
21068,காட்டப்படும்,0,0,1,1
21070,لاتينية,0,0,1,1
21071,समझाएं,0,0,1,1
21045,— «природа» —,0,0,1,1
21043,ترقية,0,0,1,1
21042,rill,0,0,1,1
21031,formler,0,0,1,1
21015,smsar,0,0,1,1
21016,الكفاية,0,0,1,1
21017,முயற்சிக்கு,0,0,1,1
21018,infrecuentes,0,0,1,1
21020,وجمل,0,0,1,1
21030,"
स्वीडिश",0,0,1,1
21032,olursun,0,0,1,1
21039,قال,0,0,1,1
21033,гарантирует,0,0,1,1
21034,programadores,0,0,1,1
21035,വരുത്തുന്നു,0,0,1,1
21036,கண்காணிக்கப்படுகின்றன,0,0,1,1
21037,συνεχίσει,0,0,1,1
21038,redigerade,0,0,1,1
21185,"
नाम",0,0,1,1
21187,हफ्तों,0,0,1,1
20490,πλυντήριο,0,0,1,1
21336,ky •,0,0,1,1
21338,πηγαίνει,0,0,1,1
21339,unnatural,0,0,1,1
21340,английская —,0,0,1,1
21342,स्तरों,0,0,1,1
21343,открытие,0,0,1,1
21344,примеров,0,0,1,1
21346,probeerde,0,0,1,1
21349,يتزوجني,0,0,1,1
21350,astronomers,0,0,1,1
21351,പഠിക്കും,0,0,1,1
21352,وراء,0,0,1,1
21353,ಮಾರ್ಗ,0,0,1,1
21355,expose,0,0,1,1
21356,kelimeyle,0,0,1,1
21357,കഷ്ണം,0,0,1,1
21337,ஸ்லக்,0,0,1,1
21335,സുന്ദരിയും,0,0,1,1
21303,anlamadınız,0,0,1,1
21334,வளர்ப்பதற்கு,0,0,1,1
21311,നേരത്തെ,0,0,1,1
21312,obtenida,0,0,1,1
21313,централизованного,0,0,1,1
21314,informationen,0,0,1,1
21318,selfguided,0,0,1,1
21319,bahsetmişken,0,0,1,1
21321,depicting,0,0,1,1
21322,αγγλόφωνη,0,0,1,1
21323,«человеком,0,0,1,1
21324,iluminação,0,0,1,1
21327,നേരിട്ടുള്ള,0,0,1,1
21329,المتحدثون,0,0,1,1
21330,निगमों,0,0,1,1
21331,artikelversion,0,0,1,1
21332,cárceles,0,0,1,1
21358,അമ്മയായിരുന്നു,0,0,1,1
21361,cream,0,0,1,1
21362,διάρκεια,0,0,1,1
21363,pensées,0,0,1,1
21392,pensez,0,0,1,1
21393,однополых,0,0,1,1
21394,السائح,0,0,1,1
21397,overschreden,0,0,1,1
21400,undersøgelse,0,0,1,1
21401,البذور,0,0,1,1
21402,ನೀನೇನು,0,0,1,1
21403,lasst,0,0,1,1
21404,perceber,0,0,1,1
21405,underbart,0,0,1,1
21406,amável,0,0,1,1
21407,கவலைப்படாதீர்கள்,0,0,1,1
21408,utilisées,0,0,1,1
21410,மணி,0,0,1,1
21411,annoncée,0,0,1,1
21391,"
urdu",0,0,1,1
21390,competitor,0,0,1,1
21389,kända,0,0,1,1
21374,व्यतीत,0,0,1,1
21364,adequadas,0,0,1,1
21365,veckotidskrifterna,0,0,1,1
21367,tat,0,0,1,1
21368,кемто,0,0,1,1
21369,seriös,0,0,1,1
21371,inédite,0,0,1,1
21375,താഴേയ്‌ക്ക്,0,0,1,1
21386,позицию,0,0,1,1
21376,അതുകൊണ്ടൊക്കെ,0,0,1,1
21378,planteamiento,0,0,1,1
21380,aniversario,0,0,1,1
21381,والدينية,0,0,1,1
21383,സൂചിപ്പിക്കാൻ,0,0,1,1
21384,أقرأ,0,0,1,1
21307,ارتكب,0,0,1,1
21301,nossos,0,0,1,1
21189,ഘട്ടത്തിൽ,0,0,1,1
21222,realización,0,0,1,1
21224,أريده,0,0,1,1
21226,melhoram,0,0,1,1
21227,liegst,0,0,1,1
21228,பெரிதுபடுத்த,0,0,1,1
21229,εκείνο,0,0,1,1
21232,παραδέχεστε,0,0,1,1
21234,полезных,0,0,1,1
21236,இருங்கள்,0,0,1,1
21237,popularidad—,0,0,1,1
21239,തന്നെയില്ല,0,0,1,1
21240,الاسم,0,0,1,1
21241,wikipedia»​​​​,0,0,1,1
21243,сохраняют,0,0,1,1
21244,insinuer,0,0,1,1
21246,stavefejl,0,0,1,1
21223,ideográmicos,0,0,1,1
21221,انقر,0,0,1,1
21299,bulacağınız,0,0,1,1
21219,decimale,0,0,1,1
21190,தெரிந்த,0,0,1,1
21194,monitorados,0,0,1,1
21196,centuple,0,0,1,1
21197,australie,0,0,1,1
21199,oud,0,0,1,1
21201,dividir,0,0,1,1
21202,لإصلاحها,0,0,1,1
21203,isn,0,0,1,1
21204,ficamos,0,0,1,1
21206,собрания,0,0,1,1
21211,múnich,0,0,1,1
21212,ελα,0,0,1,1
21213,benedicto,0,0,1,1
21215,ಖಚಿತವಾಗಿದೆಯೇ,0,0,1,1
21216,അതിനുപുറമേ,0,0,1,1
21247,يسير؟,0,0,1,1
21248,gmatı,0,0,1,1
21249,gewogen,0,0,1,1
21250,وطعمه,0,0,1,1
21280,افعل,0,0,1,1
21281,തകർന്നു,0,0,1,1
21283,déposé,0,0,1,1
21286,there’s,0,0,1,1
21287,спросили,0,0,1,1
21288,nesta,0,0,1,1
21289,japanse,0,0,1,1
21290,renovar,0,0,1,1
21291,divulgadas,0,0,1,1
21292,vérification,0,0,1,1
21293,réagir,0,0,1,1
21294,genotipo,0,0,1,1
21295,eenvoudige,0,0,1,1
21296,വരുന്നവർ,0,0,1,1
21297,सईनपोस्ट,0,0,1,1
21278,fru,0,0,1,1
21275,кого,0,0,1,1
21274,مذهلة,0,0,1,1
21263,gemakkelijk,0,0,1,1
21251,данному,0,0,1,1
21253,вид,0,0,1,1
21254,bars,0,0,1,1
21258,acabou,0,0,1,1
21260,ആഗ്രഹിക്കുന്ന,0,0,1,1
21262,விரல்கள்,0,0,1,1
21264,outgassing,0,0,1,1
21273,revelado,0,0,1,1
21266,بأمان,0,0,1,1
21267,haiti,0,0,1,1
21268,drivs,0,0,1,1
21269,nutzlos,0,0,1,1
21271,iniciais,0,0,1,1
21272,चयनित,0,0,1,1
20957,anklagats,0,0,1,1
20956,initiéec,0,0,1,1
20955,beleidigung,0,0,1,1
20623,north,0,0,1,1
20626,ஏற்கிறது,0,0,1,1
20629,ഭൗതികപ്രതിഭാസങ്ങളും,0,0,1,1
20630,matbordet,0,0,1,1
20631,بدت,0,0,1,1
20634,nourrir,0,0,1,1
20635,fastnar,0,0,1,1
20636,மூலமே,0,0,1,1
20637,القائمون,0,0,1,1
20638,chémoinformatique ,0,0,1,1
20641,logoları,0,0,1,1
20643,upphov,0,0,1,1
20644,பார்த்தால்,0,0,1,1
20645,userinterface,0,0,1,1
20646,العلوم،,0,0,1,1
20647,agricultural,0,0,1,1
20625,оценка,0,0,1,1
20621,வழியாகப்,0,0,1,1
20598,ஒழுங்கமைவுப்,0,0,1,1
20620,للولايات,0,0,1,1
20601,ansvarlige,0,0,1,1
20602,самого,0,0,1,1
20603,processamento,0,0,1,1
20605,അറിഞ്ഞിരിക്കണം,0,0,1,1
20606,انعكاسه,0,0,1,1
20608,годы,0,0,1,1
20609,എല്ലാവരോടും,0,0,1,1
20610,σύνθημα,0,0,1,1
20611,entornos,0,0,1,1
20612,μορφή,0,0,1,1
20613,gekregen,0,0,1,1
20614,ಕಾಣಿಸುತ್ತಾಳೆ,0,0,1,1
20616,αναφορές,0,0,1,1
20618,قدمي,0,0,1,1
20619,varlıklardı,0,0,1,1
20648,крупнейшей,0,0,1,1
20650,ödeviniz,0,0,1,1
20651,والإيطالية,0,0,1,1
20652,viajes,0,0,1,1
20683,ουρανούς,0,0,1,1
20684,permitiria,0,0,1,1
20685,combiné,0,0,1,1
20686,استيقظت,0,0,1,1
20687,अज़रबैजानी,0,0,1,1
20689,خطيرة،,0,0,1,1
20691,existían,0,0,1,1
20692,dedicaba,0,0,1,1
20694,голоса,0,0,1,1
20695,استمع,0,0,1,1
20696,statens,0,0,1,1
20697,paradoxalement,0,0,1,1
20701,iyiler,0,0,1,1
20703,maids,0,0,1,1
20704,dvdwikimediaorg,0,0,1,1
20681,explicitement,0,0,1,1
20680,paradigmático,0,0,1,1
20679,estabilizado,0,0,1,1
20665,¿eh,0,0,1,1
20653,udtalen,0,0,1,1
20655,dvds,0,0,1,1
20657,talip,0,0,1,1
20659,éclairé,0,0,1,1
20661,recommendations,0,0,1,1
20664,autoclavagem,0,0,1,1
20666,മറയ്ക്കാൻ,0,0,1,1
20678,lèvres,0,0,1,1
20670,exploitent,0,0,1,1
20671,والواراي,0,0,1,1
20672,rappelle,0,0,1,1
20675,afastase,0,0,1,1
20676,ağladığın,0,0,1,1
20677,புவியியல்,0,0,1,1
20600,τραπεζαρία,0,0,1,1
20597,وتحصل,0,0,1,1
20954,ltd,0,0,1,1
20520,онлайнобращение,0,0,1,1
20522,أزمة,0,0,1,1
20524,suggéré,0,0,1,1
20525,girişi,0,0,1,1
20526,έξυπνων,0,0,1,1
20527,stewardship,0,0,1,1
20529,الرائحة,0,0,1,1
20530,त्रुटियों,0,0,1,1
20531,philosophicalcontent,0,0,1,1
20532,mueves,0,0,1,1
20533,prédictive,0,0,1,1
20536,ಗೊಂದಲಕ್ಕೊಳಗಾದ,0,0,1,1
20537,ലഭ്യമായാൽ,0,0,1,1
20539,சாப்பிடுவது,0,0,1,1
20541,கிகில்ஸ்,0,0,1,1
20543,قادرا,0,0,1,1
20521,skapar,0,0,1,1
20519,subcampo,0,0,1,1
20595,جودة,0,0,1,1
20518,procure,0,0,1,1
20495,favorablemente,0,0,1,1
20496,فاندربيلت،,0,0,1,1
20497,وأحكام,0,0,1,1
20498,ഉത്സാഹം,0,0,1,1
20499,tratar,0,0,1,1
20501,сомнений,0,0,1,1
20502,«η,0,0,1,1
20503,programmering,0,0,1,1
20504,henvender,0,0,1,1
20506,അമ്മേ,0,0,1,1
20507,असफल,0,0,1,1
20509,hände,0,0,1,1
20512,algorithmiques,0,0,1,1
20513,täcker,0,0,1,1
20517,யூ,0,0,1,1
20545,ανόητο,0,0,1,1
20546,vaknade,0,0,1,1
20549,സന്തോഷമുണ്ട്,0,0,1,1
20550,പരാമർശിക്കരുത്,0,0,1,1
20577,आंद्रे,0,0,1,1
20578,வருகின்றது,0,0,1,1
20579,ವಹಿಸುತ್ತೇನೆ,0,0,1,1
20580,deportes,0,0,1,1
20581,ιστοχώρο,0,0,1,1
20583,expressar,0,0,1,1
20584,клиффордом,0,0,1,1
20585,ಮಾಡಿದ್ದೀರಿ,0,0,1,1
20586,inundación,0,0,1,1
20587,förblir,0,0,1,1
20588,അമിതപ്രാധാന്യമാവാം,0,0,1,1
20589,ರವಾನಿಸಬಹುದೇ,0,0,1,1
20590,постановка,0,0,1,1
20591,الأسبوع؟,0,0,1,1
20593,parlement,0,0,1,1
20576,diseñar,0,0,1,1
20573,tornou,0,0,1,1
20570,essentielles,0,0,1,1
20558,censeurs,0,0,1,1
20551,πεινάτε,0,0,1,1
20552,arbetssättet,0,0,1,1
20553,ಆಲಸ್ಯ,0,0,1,1
20554,ümmete,0,0,1,1
20556,λειτουργίας,0,0,1,1
20557,ख़बरों,0,0,1,1
20559,учётной,0,0,1,1
20569,കണക്കാക്കപ്പെടുന്നുവിക്കിസോഫ്‌റ്റ്‌വെയർ,0,0,1,1
20560,sendte,0,0,1,1
20561,favorece,0,0,1,1
20562,المتعمدة,0,0,1,1
20564,மொழிப்பதிப்பும்,0,0,1,1
20566,பணக்காரர்,0,0,1,1
20567,tercera,0,0,1,1
20705,yapılır,0,0,1,1
20707,dorf,0,0,1,1
20713,κατάλληλο,0,0,1,1
20873,abogaba,0,0,1,1
20875,weiteren,0,0,1,1
20877,pleures,0,0,1,1
20878,वार्षिक,0,0,1,1
20879,engaging,0,0,1,1
20880,மாதம்,0,0,1,1
20881,wikipediaversioner,0,0,1,1
20882,मिश्रित,0,0,1,1
20884,représentent,0,0,1,1
20885,حادثة,0,0,1,1
20886,« liberal »,0,0,1,1
20888,αναστατωθείς,0,0,1,1
20890,нанесён,0,0,1,1
20891,referenciados,0,0,1,1
20892,ಕಾರ್ಯನಿರತರಾಗಿದ್ದಾರೆ,0,0,1,1
20893,traduzido,0,0,1,1
20874,κρέας,0,0,1,1
20872,ಗೊಂದಲಗೊಳಿಸುವುದು,0,0,1,1
20714,huvudsakliga,0,0,1,1
20871,വസ്തുക്കളെ,0,0,1,1
20841,souhaitez,0,0,1,1
20842,ಹುಡುಕಾಟದಲ್ಲಿ,0,0,1,1
20843,beviste,0,0,1,1
20845,തോന്നണമെങ്കിൽ,0,0,1,1
20846,provavelmente,0,0,1,1
20848,"
मलयालम",0,0,1,1
20851,derive,0,0,1,1
20853,ಕಾಯಲು,0,0,1,1
20854,sahne,0,0,1,1
20858,disk,0,0,1,1
20859,boon,0,0,1,1
20860,الدراسات,0,0,1,1
20866,передаётся,0,0,1,1
20867,развитие,0,0,1,1
20869,taraflarına,0,0,1,1
20894,புத்தகத்தைப்,0,0,1,1
20895,याचना,0,0,1,1
20896,fi,0,0,1,1
20897,devastation,0,0,1,1
20922,dummer,0,0,1,1
20923,യാത്രയെക്കുറിച്ചോ,0,0,1,1
20927,ശക്തമായി,0,0,1,1
20930,participative »,0,0,1,1
20934,novel,0,0,1,1
20935,correcciones,0,0,1,1
20937,article—have,0,0,1,1
20939,açlıktan,0,0,1,1
20940,ಬಿರುಗಾಳಿಯ,0,0,1,1
20942,forskaren,0,0,1,1
20945,वेंडरबिल्ट,0,0,1,1
20949,gelse,0,0,1,1
20950,proprietär,0,0,1,1
20952,predicted,0,0,1,1
20953,годах,0,0,1,1
20921,survive,0,0,1,1
20920,savunmaktadır,0,0,1,1
20919,இழுத்து,0,0,1,1
20905,eliminadores,0,0,1,1
20898,beneficial,0,0,1,1
20899,ഭാഷകൾ,0,0,1,1
20900,ലഭിച്ചില്ല,0,0,1,1
20901,adres,0,0,1,1
20902,மீளமைக்கப்படக்,0,0,1,1
20903,स्वचालित,0,0,1,1
20906,στιλβωμένος,0,0,1,1
20918,декабрь,0,0,1,1
20907,lissés,0,0,1,1
20908,kokulu,0,0,1,1
20909,unconscious,0,0,1,1
20910,‘பேச்சுப்பக்கம்’,0,0,1,1
20915,vast,0,0,1,1
20916,folder,0,0,1,1
20840,"
इसी",0,0,1,1
20838,and—most,0,0,1,1
20837,factuais,0,0,1,1
20774,meldde,0,0,1,1
20739,تراقبها,0,0,1,1
20741,consultant,0,0,1,1
20748,كشف,0,0,1,1
20751,νερό,0,0,1,1
20752,lua,0,0,1,1
20754,கேட்கவும்,0,0,1,1
20756,страницах,0,0,1,1
20757,κέντρο,0,0,1,1
20761,डालना।,0,0,1,1
20762,renouvelables,0,0,1,1
20763,vonden,0,0,1,1
20765,φροντίστε,0,0,1,1
20766,zögernd,0,0,1,1
20769,arrastar,0,0,1,1
20770,википедией —,0,0,1,1
20738,verheiratet,0,0,1,1
20737,codificada,0,0,1,1
20736,einzige,0,0,1,1
20723,ape,0,0,1,1
20715,stødende,0,0,1,1
20718,ദശലക്ഷം,0,0,1,1
20719,يسمح,0,0,1,1
20720,ನಾಯಿ,0,0,1,1
20721,ومستدامًا,0,0,1,1
20722,كم,0,0,1,1
20724,dejlige,0,0,1,1
20735,wachtwoord,0,0,1,1
20725,മെലിസയും,0,0,1,1
20726,وإصلاحه,0,0,1,1
20729,школы,0,0,1,1
20730,കാശ്മീർ,0,0,1,1
20731,राजस्व,0,0,1,1
20734,എൻട്രോപ്പി,0,0,1,1
20773,തലച്ചോറിനെ,0,0,1,1
20775,owing,0,0,1,1
20836,editores»,0,0,1,1
20776,малым,0,0,1,1
20810,impresiones,0,0,1,1
20815,فريد,0,0,1,1
20816,synen,0,0,1,1
20817,abarcar,0,0,1,1
20818,diseñada,0,0,1,1
20819,cümlede,0,0,1,1
20823,gérant,0,0,1,1
20825,நேசித்தாள்,0,0,1,1
20826,voted,0,0,1,1
20829,inanamıyorum,0,0,1,1
20831,categoría,0,0,1,1
20832,നടത്തുന്നുമുണ്ട്,0,0,1,1
20833,लम्बे,0,0,1,1
20834,ಪಾರ್ಟಿಯಲ್ಲಿರುವಾಗ,0,0,1,1
20835,ಅಳುತ್ತಿದ್ದರೆ,0,0,1,1
20807,convaincre,0,0,1,1
20806,verwirren,0,0,1,1
20805,இரண்டாம்,0,0,1,1
20791,خورازميات,0,0,1,1
20777,வெளிப்படையான,0,0,1,1
20782,rouge,0,0,1,1
20784,ಮುಂದುವರಿಸಲು,0,0,1,1
20786,ಮಾಡೋಣ,0,0,1,1
20788,sorrindo,0,0,1,1
20790,hr •,0,0,1,1
20792,குறுக்கிடுகிறது,0,0,1,1
20802,changing,0,0,1,1
20794,lifeforms,0,0,1,1
20795,“illegal,0,0,1,1
20797,desinformação,0,0,1,1
20798,ഗുണാങ്ക,0,0,1,1
20799,siri,0,0,1,1
20800,sıktığım,0,0,1,1
21412,ഭാഷകളിലും,0,0,1,1
21413,സന്തോഷവാനാണ്,0,0,1,1
21414,cuire,0,0,1,1
22055,volatil,0,0,1,1
22058,mimesis,0,0,1,1
22059,viagem,0,0,1,1
22062,ickeadministratörer,0,0,1,1
22065,எழுதப்பட்ட,0,0,1,1
22066,editó,0,0,1,1
22067,seemed,0,0,1,1
22068,манске,0,0,1,1
22069,egentligen,0,0,1,1
22070,സ്രോതസ്സുകളുടെ,0,0,1,1
22071,positiv,0,0,1,1
22072,noktadayım,0,0,1,1
22078,ലോക,0,0,1,1
22079,verschiedenen,0,0,1,1
22080,paranız,0,0,1,1
22081,correos,0,0,1,1
22057,ترميز,0,0,1,1
22054,"
वियतनामी",0,0,1,1
22023,താക്കീതുകൾ,0,0,1,1
22053,قارئ،,0,0,1,1
22030,предметов,0,0,1,1
22031,separado,0,0,1,1
22032,concurreert,0,0,1,1
22033,gestern,0,0,1,1
22034,единственной,0,0,1,1
22036,gefangen,0,0,1,1
22041,कोटेशन्स,0,0,1,1
22042,حرفيًا,0,0,1,1
22043,κάπου,0,0,1,1
22044,anlatırsa,0,0,1,1
22045,أسقطت,0,0,1,1
22048,trillion,0,0,1,1
22049,semillas,0,0,1,1
22050,вверх,0,0,1,1
22052,interfaces,0,0,1,1
22082,نوعا,0,0,1,1
22083,dileme,0,0,1,1
22084,überfluten,0,0,1,1
22085,anweisungen,0,0,1,1
22116,"
एस्टोनीयाई",0,0,1,1
22118,esquina,0,0,1,1
22119,tilbyde,0,0,1,1
22122,krets,0,0,1,1
22123,оболочки,0,0,1,1
22124,edilir,0,0,1,1
22126,d’attribuer,0,0,1,1
22127,whose,0,0,1,1
22128,propianota,0,0,1,1
22129,الوصمي,0,0,1,1
22130,kant,0,0,1,1
22131,ഇപ്പോൾ,0,0,1,1
22132,chefe,0,0,1,1
22133,വിഷയങ്ങളിലെ,0,0,1,1
22134,–principalmente,0,0,1,1
22115,алгоритмы,0,0,1,1
22114,ровно,0,0,1,1
22113,ನೀರಸವಾಗಿದೆ,0,0,1,1
22096,grant,0,0,1,1
22086,general—,0,0,1,1
22087,സാമൂഹ്യവിരുദ്ധർ,0,0,1,1
22089,yapıyorsun,0,0,1,1
22093,dirigée,0,0,1,1
22094,داعى,0,0,1,1
22095,നിങ്ങൾക്കാവശ്യമുണ്ടെങ്കിൽ,0,0,1,1
22097,τρομακτική,0,0,1,1
22111,धारणा,0,0,1,1
22103,опыта,0,0,1,1
22104,onlardan,0,0,1,1
22105,giacomo,0,0,1,1
22106,accepté,0,0,1,1
22108,rêvais,0,0,1,1
22109,koştu,0,0,1,1
22026,பக்கச்,0,0,1,1
22021,اعتبار,0,0,1,1
21896,ತ್ರೈಮಾಸಿಕದಲ್ಲಿ,0,0,1,1
21921,flour,0,0,1,1
21925,reflejarse,0,0,1,1
21926,kluge,0,0,1,1
21930,كلها,0,0,1,1
21933,vec •,0,0,1,1
21934,tactics,0,0,1,1
21936,പ്രമുഖ,0,0,1,1
21937,possua,0,0,1,1
21939,विकिइन्फो,0,0,1,1
21940,предпочли,0,0,1,1
21943,ಸೂಚನೆಗಳನ್ನು,0,0,1,1
21946,கேட்கக்கூடிய,0,0,1,1
21947,källkritik,0,0,1,1
21948,feuchtgebiet,0,0,1,1
21949,racional,0,0,1,1
21953,maneiras,0,0,1,1
21922,transformer,0,0,1,1
21920,nauw,0,0,1,1
22019,macaque,0,0,1,1
21919,asombrada,0,0,1,1
21899,twijfel,0,0,1,1
21900,zamandı,0,0,1,1
21901,particulier ,0,0,1,1
21903,ξαναδώ,0,0,1,1
21904,deneyin,0,0,1,1
21905,ಎಚ್ಚರವಾಯಿತು,0,0,1,1
21906,நாளும்,0,0,1,1
21908,définitivement,0,0,1,1
21911,പോലെ,0,0,1,1
21912,gerektirir,0,0,1,1
21913,سنة,0,0,1,1
21914,erkläre,0,0,1,1
21916,आइए,0,0,1,1
21917,pressas,0,0,1,1
21918,suprême,0,0,1,1
21956,tartışmalı,0,0,1,1
21957,താൽ‌പ്പര്യമുണ്ടെങ്കിൽ‌,0,0,1,1
21958,riesgos,0,0,1,1
21960,devant,0,0,1,1
21990,layout,0,0,1,1
21991,ಪ್ರಯತ್ನಿಸುತ್ತಿದೆ,0,0,1,1
21994,achevé,0,0,1,1
21995,ödül,0,0,1,1
21997,различна,0,0,1,1
22000,iyisin,0,0,1,1
22002,læring,0,0,1,1
22003,periodísticos,0,0,1,1
22005,appréhender,0,0,1,1
22007,daring,0,0,1,1
22008,l’épistémologie,0,0,1,1
22009,ends,0,0,1,1
22014,учреждений,0,0,1,1
22016,സംഭാഷണമാണ്,0,0,1,1
22017,دارتموث,0,0,1,1
21987,ಬಂದಾಗ,0,0,1,1
21986,ಹಿಂತಿರುಗಿಸುತ್ತೇನೆ,0,0,1,1
21984,​​persoon,0,0,1,1
21973,foros,0,0,1,1
21961,interact,0,0,1,1
21964,dormía,0,0,1,1
21966,parvint,0,0,1,1
21969,träume,0,0,1,1
21970,ಹಲವಾರು,0,0,1,1
21971,casarse,0,0,1,1
21974,பயன்படுத்துகிறோம்,0,0,1,1
21983,hjemmeside,0,0,1,1
21975,ستجده,0,0,1,1
21976,röportajda,0,0,1,1
21977,clou,0,0,1,1
21979,högskolekurser,0,0,1,1
21981,പരീക്ഷ,0,0,1,1
21982,тайно,0,0,1,1
22135,перебил,0,0,1,1
22136,للباحثين,0,0,1,1
22137,عيون,0,0,1,1
22276,ആരംഭിച്ചത്‌,0,0,1,1
22278,soplo,0,0,1,1
22279,fr •,0,0,1,1
22281,interglacial,0,0,1,1
22282,остальная,0,0,1,1
22283,يسجلون,0,0,1,1
22285,i̇skeletor,0,0,1,1
22286,ஊக்கத்துடன்,0,0,1,1
22289,accompagné,0,0,1,1
22290,मापदंडों,0,0,1,1
22291,ಇಬ್ಬರೂ,0,0,1,1
22294,викисклада,0,0,1,1
22296,romantisme,0,0,1,1
22297,procuran,0,0,1,1
22298,"
साधारण",0,0,1,1
22299,acento,0,0,1,1
22277,செயற்பட,0,0,1,1
22275,دقة,0,0,1,1
22138,cair,0,0,1,1
22274,являвшаяся,0,0,1,1
22255,ಸುಂದರವಾಗಿದ್ದನ್ನು,0,0,1,1
22256,डॉलर,0,0,1,1
22257,ensaladas,0,0,1,1
22259,произносится,0,0,1,1
22260,datamining,0,0,1,1
22261,englen,0,0,1,1
22263,للعينة,0,0,1,1
22264,kostte,0,0,1,1
22265,നൽകുകയും,0,0,1,1
22266,نبرة,0,0,1,1
22267,प्रक्टिसस,0,0,1,1
22268,"
कोरियाई",0,0,1,1
22269,kodlu,0,0,1,1
22271,онлайнэнциклопедии,0,0,1,1
22273,вручена,0,0,1,1
22300,boursier ,0,0,1,1
22301,ಹೋದರೆ,0,0,1,1
22302,varier,0,0,1,1
22303,gnupedia,0,0,1,1
22335,lanceret,0,0,1,1
22336,yapmamanı,0,0,1,1
22337,entraram,0,0,1,1
22338,समाविष्टि,0,0,1,1
22339,survives,0,0,1,1
22341,αμβλείος,0,0,1,1
22342,لاستخدامها,0,0,1,1
22344,industrielle,0,0,1,1
22346,ஆனது,0,0,1,1
22347,шумиха,0,0,1,1
22351,realizaram,0,0,1,1
22352,møder,0,0,1,1
22353,يمثل,0,0,1,1
22354,உடைந்துவிட்டது,0,0,1,1
22355,ലഭിക്കാത്ത,0,0,1,1
22334,التعتيم,0,0,1,1
22333,latinisé,0,0,1,1
22332,الإحصائية,0,0,1,1
22315,interativas,0,0,1,1
22304,сериала,0,0,1,1
22307,expérimentation,0,0,1,1
22308,اصبروا,0,0,1,1
22309,испугался,0,0,1,1
22311,करेगा।,0,0,1,1
22312,demecinde,0,0,1,1
22316,приводят,0,0,1,1
22331,toppositie,0,0,1,1
22317,befordrad,0,0,1,1
22320,நடைமுறைப்படுத்தி,0,0,1,1
22321,والمصرية,0,0,1,1
22323,تهمه,0,0,1,1
22327,நர்சிசாவைப்,0,0,1,1
22329,ಇನ್ನೊಂದಕ್ಕೆ,0,0,1,1
22254,souple,0,0,1,1
22253,ضد,0,0,1,1
22252,असहमत,0,0,1,1
22192,διατήρηση,0,0,1,1
22166,auxquels,0,0,1,1
22168,تنتشر,0,0,1,1
22169,ثاني,0,0,1,1
22171,independentemente,0,0,1,1
22173,sokpopaccounts,0,0,1,1
22175,hushålls,0,0,1,1
22176,ഞങ്ങളോട്,0,0,1,1
22177, —,0,0,1,1
22178,ಒಮ್ಮೆ,0,0,1,1
22180,отполированный,0,0,1,1
22182,taste,0,0,1,1
22183,வைக்கும்,0,0,1,1
22185,francophone,0,0,1,1
22188,inser,0,0,1,1
22189,teoría,0,0,1,1
22164,കേൾക്കാതെ,0,0,1,1
22161,शास्त्रीय,0,0,1,1
22160,breathe,0,0,1,1
22147,umgegangen,0,0,1,1
22139,cumulant,0,0,1,1
22140,soldats,0,0,1,1
22141,गुणधर्मों,0,0,1,1
22143,различают,0,0,1,1
22145,hotter,0,0,1,1
22146,उबुन्टु,0,0,1,1
22149,leeft,0,0,1,1
22159,antiélitisme,0,0,1,1
22150,возможных,0,0,1,1
22151,statistiek,0,0,1,1
22154,ಸಂತೋಷ,0,0,1,1
22155,viva,0,0,1,1
22156,معرفي,0,0,1,1
22157,എന്തിന്,0,0,1,1
22191,öncesi,0,0,1,1
22193,अमेरिकन्स,0,0,1,1
22250,visera,0,0,1,1
22196,άχρηστο,0,0,1,1
22228,διστάζω,0,0,1,1
22230,ಬ್ಯಾಂಕ್‌ಗೆ,0,0,1,1
22231,ಪ್ರೀತಿಯ,0,0,1,1
22235,richer,0,0,1,1
22236,السبب،,0,0,1,1
22237,eksamen,0,0,1,1
22239,άκουσα,0,0,1,1
22240,hydrological,0,0,1,1
22241,زالوا,0,0,1,1
22242,ചോദ്യങ്ങളിൽ,0,0,1,1
22243,klänningarna,0,0,1,1
22245,documentering,0,0,1,1
22246,patentlerle,0,0,1,1
22247,ಇರಲು,0,0,1,1
22248,undskylder,0,0,1,1
22225,communitywide,0,0,1,1
22224,കൊണ്ടിരിക്കുന്നു,0,0,1,1
22223,கூட்டுப்,0,0,1,1
22206,continuent,0,0,1,1
22198,bridle,0,0,1,1
22199,присутствовать,0,0,1,1
22201,öğreniyorum,0,0,1,1
22202,καθόταν,0,0,1,1
22204,​​wat,0,0,1,1
22205,eklenmesi,0,0,1,1
22207,ಇದಕ್ಕಾಗಿ,0,0,1,1
22222,трое,0,0,1,1
22211,جنوني,0,0,1,1
22212,diego,0,0,1,1
22213,التوالي،,0,0,1,1
22216,doktoranders,0,0,1,1
22217,மாலை,0,0,1,1
22218,wikcionario,0,0,1,1
21898,क्वाडि्ृगा,0,0,1,1
21894,φτωχοί,0,0,1,1
21415,guldbrødet,0,0,1,1
21573,móviles,0,0,1,1
21576,ವಿರೋಧಾತ್ಮಕ,0,0,1,1
21577,வெளித்தொகுப்புக்களை,0,0,1,1
21578,ആദ്യശ്രമം,0,0,1,1
21580,ഉണ്ടെന്നും,0,0,1,1
21584,προσβολή,0,0,1,1
21585,اليومي,0,0,1,1
21587,இணையதளம்,0,0,1,1
21588,gratulera,0,0,1,1
21589,présents,0,0,1,1
21593,identificação,0,0,1,1
21594,sumaban,0,0,1,1
21597,या।,0,0,1,1
21598,trykket,0,0,1,1
21599,अत्याचारपूर्ण,0,0,1,1
21600,strunta,0,0,1,1
21575,chinois,0,0,1,1
21571,இல்லாமலேயே,0,0,1,1
21538,принимаю,0,0,1,1
21569,использовалось,0,0,1,1
21540,ರೀತಿಗೆ,0,0,1,1
21541,குறிப்பிட்டுள்ளது,0,0,1,1
21545,الأغاني,0,0,1,1
21546,வெளிப்படுத்தினேன்,0,0,1,1
21549,wish,0,0,1,1
21550,ಪ್ರಕಾರಕ್ಕಿಂತ,0,0,1,1
21552,disons,0,0,1,1
21556,பெற்றுக்,0,0,1,1
21557,denunciado,0,0,1,1
21559,आता,0,0,1,1
21560,एनसिक्लोपेडिया,0,0,1,1
21561,nervous,0,0,1,1
21564,புகழ்பெற்றதுமாகும்,0,0,1,1
21565,ಸಹಿಸಿಕೊಳ್ಳಿ,0,0,1,1
21568,recognizable,0,0,1,1
21602,ಉತ್ತಮವಾಗಿದೆ,0,0,1,1
21604,ஆண்டுகளாக,0,0,1,1
21606,ജോലികൾ,0,0,1,1
21607,ಸ್ನೇಹಿತರೆಲ್ಲರೂ,0,0,1,1
21641,inscrever,0,0,1,1
21643,telaffuzu,0,0,1,1
21644,مدة,0,0,1,1
21645,nätgemenskap,0,0,1,1
21646,υψηλότερης,0,0,1,1
21647,"
रोमानियाई",0,0,1,1
21649,معنى,0,0,1,1
21651,spammers,0,0,1,1
21653,वर्चुअल,0,0,1,1
21655,wijd,0,0,1,1
21656,жена,0,0,1,1
21657,matchen,0,0,1,1
21658,ಸಿಗದಿದ್ದಾಗ,0,0,1,1
21662,commentaires,0,0,1,1
21664,trevligare,0,0,1,1
21640,poängterar,0,0,1,1
21639,naturalistes,0,0,1,1
21638,forsinkelse,0,0,1,1
21620,சோகமாகவோ,0,0,1,1
21608,चीनी,0,0,1,1
21609,சொற்களின்,0,0,1,1
21611,lyse,0,0,1,1
21613,idiomáticas,0,0,1,1
21614,உரையாடலின்,0,0,1,1
21617,σύνδεσμο,0,0,1,1
21622,കണ്ടതെന്ന്,0,0,1,1
21635,असफलता,0,0,1,1
21623,attributable,0,0,1,1
21624,ഉപയോക്താവിന്,0,0,1,1
21625,പ്രവൃത്തിയെക്കുറിച്ച്,0,0,1,1
21628,spared,0,0,1,1
21629,ಡೆಲ್ಹಿಯಲ್ಲಿ,0,0,1,1
21630,earliest,0,0,1,1
21539,violações,0,0,1,1
21537,ಗ್ಮಾಟ್,0,0,1,1
21893,விரும்ப,0,0,1,1
21440,ക്ലാസിക്കൽ,0,0,1,1
21443,распространение,0,0,1,1
21444,wikikoden,0,0,1,1
21447,ذكي,0,0,1,1
21448,शैलीगत,0,0,1,1
21450,देन,0,0,1,1
21451,غاضب,0,0,1,1
21453,almorzar,0,0,1,1
21454,சார்பற்றது,0,0,1,1
21455,وswedish،,0,0,1,1
21456,sayfasını,0,0,1,1
21457,ಕಳೆದುಕೊಂಡಿದ್ದೇನೆ,0,0,1,1
21458,ಕಾಲದಲ್ಲಿ,0,0,1,1
21460,نزاع,0,0,1,1
21463,модным,0,0,1,1
21464,inconsistências,0,0,1,1
21442,visualizar,0,0,1,1
21439,massornas,0,0,1,1
21536,breeding,0,0,1,1
21438,قدمًا,0,0,1,1
21416,hadn,0,0,1,1
21417,pointofview,0,0,1,1
21418,gekeken,0,0,1,1
21419,البيروقراطيون،,0,0,1,1
21421,raisonnable,0,0,1,1
21424,ranting,0,0,1,1
21425,ഡിഗ്രിവിദ്യാർത്ഥി,0,0,1,1
21426,våldtäktsincidenterna,0,0,1,1
21428,സൗകര്യമുണ്ട്,0,0,1,1
21431,startet,0,0,1,1
21432,inapropiadas,0,0,1,1
21433,பிரச்சினையை,0,0,1,1
21434,துல்லியமின்மை,0,0,1,1
21435,ಪ್ರಸಿದ್ಧ,0,0,1,1
21436,ಖಚಿತವಿಲ್ಲ,0,0,1,1
21466,restored,0,0,1,1
21468,моменткогда,0,0,1,1
21470,söyledim,0,0,1,1
21471,masturbação,0,0,1,1
21510,нашем,0,0,1,1
21511,редакции,0,0,1,1
21515,nine,0,0,1,1
21516,gülümsüyor,0,0,1,1
21519,sanningsenlig,0,0,1,1
21520,incohérences,0,0,1,1
21521,نسخة,0,0,1,1
21523,ಬಯಸದಿದ್ದರೆ,0,0,1,1
21524,caught,0,0,1,1
21525,hoeveelheden,0,0,1,1
21528,ಕಾಮೆಂಟ್‌ಗಳ,0,0,1,1
21530,exam,0,0,1,1
21532,erfahrung,0,0,1,1
21533,magiske,0,0,1,1
21535,حقوق,0,0,1,1
21509,fracos,0,0,1,1
21508,crosses,0,0,1,1
21506,manifestations,0,0,1,1
21488,تقل,0,0,1,1
21473,bilmediği,0,0,1,1
21475,ತಿನ್ನುವ,0,0,1,1
21476,atentos,0,0,1,1
21479,ദേഷ്യപ്പെടുന്നുവെന്നത്,0,0,1,1
21481,« a,0,0,1,1
21486,parcial,0,0,1,1
21489,tænk,0,0,1,1
21505,rart,0,0,1,1
21495,sainte,0,0,1,1
21496,أندرو,0,0,1,1
21498,cuestiones,0,0,1,1
21502,colonisation,0,0,1,1
21503,mediaservices,0,0,1,1
21504,δελχί,0,0,1,1
21665,വരുത്താൻ,0,0,1,1
21666,internacionalmente,0,0,1,1
21668,registradas,0,0,1,1
21820,நாசீஸின்,0,0,1,1
21823,любому,0,0,1,1
21824,അഭിനന്ദിക്കുന്നു,0,0,1,1
21825,surpreendentemente,0,0,1,1
21826,persistencia,0,0,1,1
21827,eminim,0,0,1,1
21829,रचना,0,0,1,1
21831,воспроизводимость,0,0,1,1
21832,βοηθούσες,0,0,1,1
21833,no •,0,0,1,1
21834,ಪ್ರಯತ್ನಕ್ಕೆ,0,0,1,1
21835,acusações,0,0,1,1
21836,данными,0,0,1,1
21837,вставкам,0,0,1,1
21838,разницы,0,0,1,1
21839,ಆಬ್ಟ್ಯೂಸ್,0,0,1,1
21821,ಸಲಾಡ್,0,0,1,1
21818,medley,0,0,1,1
21670,الحرب,0,0,1,1
21817,erronée,0,0,1,1
21791,"सका।
usa",0,0,1,1
21792,roupa,0,0,1,1
21794,salée,0,0,1,1
21795,экспертами,0,0,1,1
21796,இவை,0,0,1,1
21797,ಖರೀದಿಸುವುದಿಲ್ಲ,0,0,1,1
21798,corrió,0,0,1,1
21802,يستحوذ,0,0,1,1
21804,¿perdóneme,0,0,1,1
21805,ipadresser,0,0,1,1
21809,പരിശീലനങ്ങളെക്കുറിച്ചും,0,0,1,1
21811,कृत्य,0,0,1,1
21812,functie,0,0,1,1
21813,enriquecedor,0,0,1,1
21815,«быстро»,0,0,1,1
21840,challenging,0,0,1,1
21842,социальной,0,0,1,1
21843,pedirle,0,0,1,1
21844,ന്യൂപീഡിയയെ,0,0,1,1
21871,வருக,0,0,1,1
21872,atualizam,0,0,1,1
21875,mostrar,0,0,1,1
21876,masturbation,0,0,1,1
21877,écritures,0,0,1,1
21878,infobox,0,0,1,1
21879,домашнее,0,0,1,1
21881,anglófono,0,0,1,1
21882,aangeboden,0,0,1,1
21884,لقاء,0,0,1,1
21886,εγκωμιάζουν,0,0,1,1
21887,conocer,0,0,1,1
21889,neuesten,0,0,1,1
21890,φτιάξετε,0,0,1,1
21892,"
finlandês",0,0,1,1
21869,wahrscheinlich,0,0,1,1
21868,entidades,0,0,1,1
21867,небесам»,0,0,1,1
21853,diskussionen,0,0,1,1
21846,double,0,0,1,1
21847,tårar,0,0,1,1
21849,sonsuza,0,0,1,1
21850,gewijzigde,0,0,1,1
21851,calunioso,0,0,1,1
21852,റെയിൽ‌വേ,0,0,1,1
21854,حسناً,0,0,1,1
21866,journalists,0,0,1,1
21855,ходим,0,0,1,1
21856,வெள்ளம்,0,0,1,1
21857,शुभकामना,0,0,1,1
21859,garantizar,0,0,1,1
21860,πιάτο,0,0,1,1
21865,consideradas,0,0,1,1
21789,produzida,0,0,1,1
21786,перемещён,0,0,1,1
21785,பெண்,0,0,1,1
21725,profuse,0,0,1,1
21703,சொற்றொடரையும்,0,0,1,1
21705,proposé,0,0,1,1
21706,использовании,0,0,1,1
21707,விடைபெற,0,0,1,1
21708,heyecan,0,0,1,1
21710,prouver,0,0,1,1
21712,querría,0,0,1,1
21713,dags,0,0,1,1
21714,uintelligent,0,0,1,1
21716,återge,0,0,1,1
21718,ഇടമില്ലെന്ന്,0,0,1,1
21719,thema,0,0,1,1
21720,عمومًا,0,0,1,1
21721,paresseux,0,0,1,1
21723,emitidos,0,0,1,1
21700,implementeringen,0,0,1,1
21699,загрузки,0,0,1,1
21698,αδερφή,0,0,1,1
21683,അതിനു,0,0,1,1
21671,tillfällig,0,0,1,1
21672,inocência,0,0,1,1
21673,तोड़,0,0,1,1
21675,गैलिक,0,0,1,1
21676,للاستخدام,0,0,1,1
21680,humanities,0,0,1,1
21685,развития»,0,0,1,1
21697,generiek,0,0,1,1
21687,ശരിയാക്കുന്നു,0,0,1,1
21689,poupée,0,0,1,1
21690,والتعليق,0,0,1,1
21691,telefoniert,0,0,1,1
21692,உருவாக்குகிறது,0,0,1,1
21693,هذا؟,0,0,1,1
21724,escolhidos,0,0,1,1
21727,«психбольницу,0,0,1,1
21784,ஆரம்பிக்கப்படும்,0,0,1,1
21728,हूवरिंग,0,0,1,1
21759,extensions,0,0,1,1
21760,وأقول,0,0,1,1
21764,उत्पादों,0,0,1,1
21766,ಆಸಕ್ತಿಯಿಲ್ಲ,0,0,1,1
21767,posse,0,0,1,1
21769,ಧ್ವನಿಯನ್ನು,0,0,1,1
21771,"
latim",0,0,1,1
21772,успокойся,0,0,1,1
21774,الروابط,0,0,1,1
21777,تفضيل,0,0,1,1
21778,ആചരിക്കുന്നു,0,0,1,1
21779,воздействию,0,0,1,1
21780,germany,0,0,1,1
21781,opendoor,0,0,1,1
21782,സമ്മാനം,0,0,1,1
21758,ikisinin,0,0,1,1
21756,voulais,0,0,1,1
21755,bloqué,0,0,1,1
21741,anônima,0,0,1,1
21732,traced,0,0,1,1
21733,overalt,0,0,1,1
21736,consorcio,0,0,1,1
21737,соответствующий,0,0,1,1
21739,посвящённой,0,0,1,1
21740,الأمريكية,0,0,1,1
21744,വിക്കിപീഡിയക്ക്,0,0,1,1
21753,inspira,0,0,1,1
21745,mascotas,0,0,1,1
21746,bredvid,0,0,1,1
21748,yapılmıştır,0,0,1,1
21749,ومفتقدًا,0,0,1,1
21750,αγγλική,0,0,1,1
21751,испечь,0,0,1,1
20492,सहसंस्थापक,0,0,1,1
20489,desigualdades,0,0,1,1
22357,വിഷയത്തെപ്പറ്റി,0,0,1,1
19196,αγαπημένη,0,0,1,1
19200,concluyó,0,0,1,1
19201,snarare,0,0,1,1
19202,πνιγεί,0,0,1,1
19204,ال,0,0,1,1
19205,अग्रणी,0,0,1,1
19206,niettemin,0,0,1,1
19207,prinzen,0,0,1,1
19208,voetnoten,0,0,1,1
19209,anexadas,0,0,1,1
19215,geomagnetic,0,0,1,1
19217,corrélation,0,0,1,1
19218,വിക്കിയിലെ,0,0,1,1
19219,balcón,0,0,1,1
19222,заботиться,0,0,1,1
19224,عدداً,0,0,1,1
19198,таково,0,0,1,1
19195,ನಿಖರವಾಗಿ,0,0,1,1
19166,ഇപ്രകാരം,0,0,1,1
19194,δείπνο,0,0,1,1
19168,hæren,0,0,1,1
19171,пытался,0,0,1,1
19172,spurgt,0,0,1,1
19173,δημοτικότητα,0,0,1,1
19175,teveel,0,0,1,1
19176,எல்லி,0,0,1,1
19177,bout,0,0,1,1
19180,lyckligt,0,0,1,1
19182,ಇಷ್ಟಪಡುತ್ತೇನೆ,0,0,1,1
19184,गंभीरता,0,0,1,1
19185,yielded,0,0,1,1
19187,விரும்புகிறாள்,0,0,1,1
19188,ಹಣ,0,0,1,1
19190,للإجماع,0,0,1,1
19193,déterminations,0,0,1,1
19225,ತಿಳಿದಿದ್ದರಿಂದ,0,0,1,1
19226,slutgiltig,0,0,1,1
19227,expression »,0,0,1,1
19230,sammanslagning,0,0,1,1
19267,belief,0,0,1,1
19269,जोसेफ,0,0,1,1
19270,avaliado,0,0,1,1
19272,الإنجليزي,0,0,1,1
19273,flooding,0,0,1,1
19274,deseo,0,0,1,1
19275,ಇಷ್ಟಪಡುವ,0,0,1,1
19276,çoğu,0,0,1,1
19277,запутаться,0,0,1,1
19278,ನಿಜವಾದ,0,0,1,1
19279,ಹಿಟ್ಟು,0,0,1,1
19282,ಹಿಸಿದಂತೆ,0,0,1,1
19283,إجماع,0,0,1,1
19285,याहू,0,0,1,1
19288,волочить,0,0,1,1
19266,opmerking,0,0,1,1
19265,atribuição,0,0,1,1
19264,അതിനർ‌ത്ഥം,0,0,1,1
19240,competitive,0,0,1,1
19231,politicamente,0,0,1,1
19232,спроса,0,0,1,1
19233,وإيلي,0,0,1,1
19234,digital»,0,0,1,1
19235,ಸಿನೆಮಾಗಳಿಗಾಗಿ,0,0,1,1
19238,contribuye,0,0,1,1
19241,théorique,0,0,1,1
19262,constitutionnelle,0,0,1,1
19242,прекрасных,0,0,1,1
19243,dönüştürme,0,0,1,1
19245,cooled,0,0,1,1
19250,instrui,0,0,1,1
19255,reflect,0,0,1,1
19258,leckeren,0,0,1,1
19167,sheets,0,0,1,1
19161,spiegelsites,0,0,1,1
19290,организациями,0,0,1,1
19070,федеральный,0,0,1,1
19072,виргиния,0,0,1,1
19074,добавление,0,0,1,1
19076,högskolebibliotekarien,0,0,1,1
19077,нажали,0,0,1,1
19078,हटाने,0,0,1,1
19079,تصرفت,0,0,1,1
19080,"
गुजराती",0,0,1,1
19081,kallt,0,0,1,1
19085,régions,0,0,1,1
19086,écrasements,0,0,1,1
19087,निर्भर,0,0,1,1
19089,forskningsgrene,0,0,1,1
19092,pares​,0,0,1,1
19093,குறிப்பிடப்படுகிறது,0,0,1,1
19098,രഥം,0,0,1,1
19071,yazının,0,0,1,1
19068,motkultur,0,0,1,1
19160,mühe,0,0,1,1
19067,yesterday,0,0,1,1
19038,conservé,0,0,1,1
19039,individer,0,0,1,1
19040,agent,0,0,1,1
19043,gerçekleşirse,0,0,1,1
19044,одиноко»,0,0,1,1
19046,"
अरागोनियाई",0,0,1,1
19048,पात्र,0,0,1,1
19050,заниматься,0,0,1,1
19055,வாட்ஸ்அப்,0,0,1,1
19056,കോഫി,0,0,1,1
19057,quantify,0,0,1,1
19058,செல்கிறேன்,0,0,1,1
19061,despercebida,0,0,1,1
19064,countless,0,0,1,1
19065,tanımlamaktadır,0,0,1,1
19099,skiljer,0,0,1,1
19100,« communauté »,0,0,1,1
19102,confondre,0,0,1,1
19104,realizados,0,0,1,1
19137,llegada,0,0,1,1
19139,beskrivande,0,0,1,1
19140,попал,0,0,1,1
19141,κάντε,0,0,1,1
19143,battre,0,0,1,1
19144,μιλώντας,0,0,1,1
19145,“பிஎச்பி”,0,0,1,1
19146,fréquentés,0,0,1,1
19147,partidos,0,0,1,1
19152,réalisation,0,0,1,1
19153,verificación​,0,0,1,1
19155,форматах,0,0,1,1
19157,मेलिस्सा,0,0,1,1
19158,offrent,0,0,1,1
19159,kanunlarına,0,0,1,1
19135,ಮುಂದುವರಿಸುವ,0,0,1,1
19133,προσωπικά,0,0,1,1
19132,decades,0,0,1,1
19117,mathehausaufgaben,0,0,1,1
19107,inéluctablement,0,0,1,1
19110,учителем,0,0,1,1
19111,matarna,0,0,1,1
19113,wikipediawatchorg,0,0,1,1
19114,ministère,0,0,1,1
19115,स्ट्रिप,0,0,1,1
19118,adopte,0,0,1,1
19131,seneste,0,0,1,1
19121,പിറക്കുകയായി,0,0,1,1
19122,sonuca,0,0,1,1
19124,ಸ್ಮೈಲ್ಸ್,0,0,1,1
19125,சமயங்களில்,0,0,1,1
19126,préparé,0,0,1,1
19129,നൽകുന്നതിന്,0,0,1,1
19289,utilizados,0,0,1,1
19292,посмотрели,0,0,1,1
20487,ಪದದಿಂದ,0,0,1,1
19444,demasia,0,0,1,1
19446,pc,0,0,1,1
19447,υπερβολικά,0,0,1,1
19450,destiné,0,0,1,1
19451,d’aller,0,0,1,1
19452,χρησιμοποιεί,0,0,1,1
19453,கூட்டு,0,0,1,1
19455,foncière,0,0,1,1
19456,alojado,0,0,1,1
19457,തയ്യാറാക്കികൊണ്ടിരിക്കുന്നു,0,0,1,1
19459,तार्किक,0,0,1,1
19460,récuse,0,0,1,1
19461,പൂർവ്വസ്ഥിതിയിലെത്തുവാൻ,0,0,1,1
19463,டாலர்களை,0,0,1,1
19464,spetsig,0,0,1,1
19465,έλλη,0,0,1,1
19445,പെടുന്ന,0,0,1,1
19443,подписки,0,0,1,1
19412,большому,0,0,1,1
19442,ഇവിടെയെത്തി,0,0,1,1
19415,schrecklichen,0,0,1,1
19416,ನೀನು,0,0,1,1
19420,adicción»,0,0,1,1
19421,സ്വതന്ത്രവിജ്ഞാനകോശമായി,0,0,1,1
19422,stykker,0,0,1,1
19423,inondation,0,0,1,1
19424,झटके,0,0,1,1
19428,descrito,0,0,1,1
19429,officiels,0,0,1,1
19430,دعونا,0,0,1,1
19433,உருவாக்கப்பட்டு,0,0,1,1
19434,cartésienne,0,0,1,1
19436,lider,0,0,1,1
19440,malheureux,0,0,1,1
19441,functional,0,0,1,1
19466,ஆச்சரியம்,0,0,1,1
19468,യുദ്ധത്തിൽ,0,0,1,1
19469,genoptager,0,0,1,1
19471,phrasen,0,0,1,1
19494,χρήσιμες,0,0,1,1
19496,മനസിലാക്കരുത്,0,0,1,1
19497,intresseområden,0,0,1,1
19498,triplicado,0,0,1,1
19500,ഇരിക്കുന്നതുപോലെയാണ്,0,0,1,1
19501,uppsatsens,0,0,1,1
19502,"
असमिया",0,0,1,1
19503,ஆறு,0,0,1,1
19504,«verificabilidad»​,0,0,1,1
19506,provider,0,0,1,1
19509,bıraktıysanız,0,0,1,1
19512,лучшее,0,0,1,1
19513,سارت,0,0,1,1
19515,habilidad,0,0,1,1
19516,truthfulness,0,0,1,1
19493,pacific,0,0,1,1
19491,bristerna,0,0,1,1
19490,tanımlamalardan,0,0,1,1
19478,ഇന്നലെ,0,0,1,1
19472,сожалению,0,0,1,1
19473,nicholson,0,0,1,1
19474,ചിന്തിക്കട്ടെ,0,0,1,1
19475,radicalement,0,0,1,1
19476,kuşunki,0,0,1,1
19477,samkör,0,0,1,1
19479,ವ್ಯಕ್ತಿಯ,0,0,1,1
19489,المائدة,0,0,1,1
19480,grades,0,0,1,1
19483,αμερόληπτα,0,0,1,1
19484,yaptım,0,0,1,1
19485,censorship,0,0,1,1
19486,présentait,0,0,1,1
19488,पूछे,0,0,1,1
19413,kommunikation,0,0,1,1
19411,сэнгеру,0,0,1,1
19293,imputáveis,0,0,1,1
19323,общество,0,0,1,1
19325,sönder,0,0,1,1
19330,søvnen,0,0,1,1
19331,caps,0,0,1,1
19332,माग्नस,0,0,1,1
19334,nase,0,0,1,1
19335,ecke,0,0,1,1
19336,ομαλής,0,0,1,1
19339,mermeladas,0,0,1,1
19341,തയ്യാറാക്കിയിട്ടുണ്ട്,0,0,1,1
19343,highquality,0,0,1,1
19344,hävdade,0,0,1,1
19345,ar •,0,0,1,1
19346,baseadas,0,0,1,1
19347,entendement,0,0,1,1
19348,gestopt,0,0,1,1
19324,« italie »,0,0,1,1
19322,पक्षपातहीन,0,0,1,1
19409,χρησιμοποιήθηκε,0,0,1,1
19321,incorporation,0,0,1,1
19296,результатом,0,0,1,1
19297,slightly,0,0,1,1
19299,போன்றவற்றிலிருந்து,0,0,1,1
19300,testing,0,0,1,1
19301,единственном,0,0,1,1
19304,страницей,0,0,1,1
19305,olduğun,0,0,1,1
19306,ನಾಳೆಗಾಗಿ,0,0,1,1
19307,വേരുകളുണ്ട്,0,0,1,1
19308,எனக்,0,0,1,1
19311,boyfriend,0,0,1,1
19315,kırptı,0,0,1,1
19316,بهذه,0,0,1,1
19318,visiblement,0,0,1,1
19319,cherchez,0,0,1,1
19349,πήγε,0,0,1,1
19350,हेल्लो,0,0,1,1
19351,«сообщество…,0,0,1,1
19352,pl •,0,0,1,1
19384,शायरियां,0,0,1,1
19385,تكاليف,0,0,1,1
19388,tardive,0,0,1,1
19389,الظهيرة,0,0,1,1
19390,காலாண்டில்,0,0,1,1
19392,സുന്ദരിയാണെന്ന്,0,0,1,1
19393,حيال,0,0,1,1
19394,waarvan,0,0,1,1
19397,military,0,0,1,1
19398,попрощаться,0,0,1,1
19400,gestart,0,0,1,1
19402,pair,0,0,1,1
19405,wherein,0,0,1,1
19407,recouverte,0,0,1,1
19408,amaba,0,0,1,1
19383,вонючая,0,0,1,1
19379,repetição,0,0,1,1
19377,ayudarlo,0,0,1,1
19363,കർത്തവ്യമാണ്,0,0,1,1
19356,கொண்டது,0,0,1,1
19357,ekonomi,0,0,1,1
19358,ettiler,0,0,1,1
19359,تحتفظ,0,0,1,1
19360,ಯಾವಾಗ,0,0,1,1
19361,schrijfsters,0,0,1,1
19364,tätt,0,0,1,1
19376,അത്ഭുതപ്പെട്ടു,0,0,1,1
19366,traditionally,0,0,1,1
19368,авторского,0,0,1,1
19371,arrêtait,0,0,1,1
19372,takımın,0,0,1,1
19374,убедитесь,0,0,1,1
19375,يشتبه,0,0,1,1
19036,vrijwel,0,0,1,1
19034,ಕೇಳುತ್ತಿದ್ದರೆ,0,0,1,1
19033,staarde,0,0,1,1
18710,promu,0,0,1,1
18714,überhäuft,0,0,1,1
18716,ചർച്ചകളും,0,0,1,1
18717,காரணமாக,0,0,1,1
18720,amar,0,0,1,1
18721,sammanfatta,0,0,1,1
18722,ഭയന്ന്,0,0,1,1
18725,مستقل,0,0,1,1
18727,taxonomía,0,0,1,1
18728,aún,0,0,1,1
18729,जापान,0,0,1,1
18730,trust,0,0,1,1
18731,esthétiques,0,0,1,1
18734,слышите,0,0,1,1
18736,ಹೇಳುವದನ್ನು,0,0,1,1
18737,lt •,0,0,1,1
18712,بنسخ,0,0,1,1
18709,தயாரிக்கப்படுகின்றன,0,0,1,1
18684,നല്ലവനാണോ,0,0,1,1
18708,وما,0,0,1,1
18687,пришло,0,0,1,1
18688,നിങ്ങളോടൊപ്പം,0,0,1,1
18689,φτάσω,0,0,1,1
18690,റാണിയില്ലാത്ത,0,0,1,1
18691,früher,0,0,1,1
18692,വളരെക്കാലമായിരിക്കുന്നു,0,0,1,1
18694,encyclopedia»,0,0,1,1
18695,കാണിക്കുന്ന,0,0,1,1
18696,oiseaux,0,0,1,1
18699,masasına,0,0,1,1
18701,cyclones,0,0,1,1
18702,directrices,0,0,1,1
18703,propostas,0,0,1,1
18706,श्रृंखला,0,0,1,1
18707,примере,0,0,1,1
18738,ಅರ್ಥಮಾಡಿಕೊಳ್ಳದಿದ್ದರೆ,0,0,1,1
18739,välmenande,0,0,1,1
18741,planeo,0,0,1,1
18743,finalité,0,0,1,1
18771,avancerade,0,0,1,1
18773,bénéficient,0,0,1,1
18774,goalseeking,0,0,1,1
18776,തൽപരരായ,0,0,1,1
18777,"
vietnamita",0,0,1,1
18778,தாக்குதலுக்குள்ளாகும்,0,0,1,1
18779,   articles,0,0,1,1
18780,компании,0,0,1,1
18782,зверски,0,0,1,1
18783,ಹೊಡೆದಿದ್ದೀರಿ,0,0,1,1
18784,optique,0,0,1,1
18786,occur,0,0,1,1
18788,പ്രവചിക്കുകയാകാം,0,0,1,1
18789,okuyorum,0,0,1,1
18790,referenssystem,0,0,1,1
18770,ordenadas,0,0,1,1
18769,ರವಾನಿಸಬಹುದು,0,0,1,1
18768,പ്രശ്നങ്ങളൊന്നും,0,0,1,1
18753,نشر,0,0,1,1
18744,ಗೊಂದಲಕ್ಕೊಳಗಾಗಿದ್ದರೆ,0,0,1,1
18745,नमक,0,0,1,1
18748,έχουν,0,0,1,1
18749,astounding,0,0,1,1
18750,इयर्स,0,0,1,1
18751,ചാലക്കുടി,0,0,1,1
18754,dublinés,0,0,1,1
18767,pertenecientes,0,0,1,1
18757,nuitlà,0,0,1,1
18758,சலவை,0,0,1,1
18759,हटाया,0,0,1,1
18763,"
फ़िजी",0,0,1,1
18765,மாற்றம்,0,0,1,1
18766,неточностей —,0,0,1,1
18685,uppgifterna,0,0,1,1
18680,ryssland,0,0,1,1
19032,comediante,0,0,1,1
18595,aplicables,0,0,1,1
18598,herum,0,0,1,1
18600,administratörsval,0,0,1,1
18601,வழிமுறைகளைப்,0,0,1,1
18602,امتحان,0,0,1,1
18605,जोड़ा,0,0,1,1
18606,apropriadas,0,0,1,1
18607,grafia,0,0,1,1
18609,permitting,0,0,1,1
18610,officielles,0,0,1,1
18616,targeted,0,0,1,1
18618,யூகித்தாலும்,0,0,1,1
18619,trettonde,0,0,1,1
18620,onaylamadıkları,0,0,1,1
18621,initialement,0,0,1,1
18622,карролтон,0,0,1,1
18597,चिह्न,0,0,1,1
18594,überwältigt,0,0,1,1
18679,внешностью,0,0,1,1
18593,وترى,0,0,1,1
18573,элли,0,0,1,1
18574,voluntariamente,0,0,1,1
18576,പരാതിപ്പെടുകയും,0,0,1,1
18577,участник,0,0,1,1
18579,ஏதோ,0,0,1,1
18580,கொள்கை,0,0,1,1
18581,توزيع,0,0,1,1
18582,confusión,0,0,1,1
18584,день»,0,0,1,1
18585,uncovered,0,0,1,1
18586,റൊട്ടിയുമായി,0,0,1,1
18587,befindet,0,0,1,1
18588,ediciones​,0,0,1,1
18589,സാധ്യമാക്കിയത്,0,0,1,1
18592,плюрипотентное,0,0,1,1
18624,принес,0,0,1,1
18625,pedanteri,0,0,1,1
18626,تقنية,0,0,1,1
18629,karıştırmak,0,0,1,1
18656,മൂർച്ചയുള്ള,0,0,1,1
18660,chronométrez,0,0,1,1
18661,людям,0,0,1,1
18662,forbløffet,0,0,1,1
18663,ಬೆಳ್ಳಿಯನ್ನು,0,0,1,1
18664,react,0,0,1,1
18666,immense,0,0,1,1
18668,പാഠത്തിൽ,0,0,1,1
18669,والغالبية,0,0,1,1
18671,staan,0,0,1,1
18672,дедуктивное,0,0,1,1
18673,houvesse,0,0,1,1
18676,connotations,0,0,1,1
18677,फ्लुमोक्स,0,0,1,1
18678,умно,0,0,1,1
18655,prestarme,0,0,1,1
18654,referese,0,0,1,1
18652,هبوط,0,0,1,1
18639,vaincre,0,0,1,1
18630,förhindra,0,0,1,1
18631,игру,0,0,1,1
18634,karıştırdım,0,0,1,1
18635,ستنجح,0,0,1,1
18636,τρομερός,0,0,1,1
18638,acordados,0,0,1,1
18640,comentarios,0,0,1,1
18649,federais,0,0,1,1
18642,στρατό,0,0,1,1
18643,consultores,0,0,1,1
18644,مباشرة,0,0,1,1
18645,программные,0,0,1,1
18646,വിവരങ്ങൾtest,0,0,1,1
18647,ഭാഷയിലുള്ള,0,0,1,1
18795,ستساعدني,0,0,1,1
18797,cadaver,0,0,1,1
18801,सातवीं,0,0,1,1
18942,incompréhensions,0,0,1,1
18946,atmen,0,0,1,1
18949,sonriendo,0,0,1,1
18950,övergav,0,0,1,1
18951,connotaciones,0,0,1,1
18952,mencionan,0,0,1,1
18954,newly,0,0,1,1
18955,"
जॉर्जियाई",0,0,1,1
18956,vatikanen,0,0,1,1
18957,objectivité,0,0,1,1
18958,رد,0,0,1,1
18960,التي،,0,0,1,1
18961,metric,0,0,1,1
18962,guldbrød,0,0,1,1
18963,escribe,0,0,1,1
18964,jedoch,0,0,1,1
18944,téléphonique,0,0,1,1
18941,substituída,0,0,1,1
18802,переживает,0,0,1,1
18940,reçeli,0,0,1,1
18914,barbe,0,0,1,1
18917,repente,0,0,1,1
18918,بيزنس,0,0,1,1
18919,telaşa,0,0,1,1
18920,convertir,0,0,1,1
18921,ലഭിച്ചുവെന്ന്,0,0,1,1
18923,kitabınızı,0,0,1,1
18924,التاريخ,0,0,1,1
18925,elinde,0,0,1,1
18928,تجمع,0,0,1,1
18935,авторитетные,0,0,1,1
18936,விக்கிப்பீடியாஓர்க்,0,0,1,1
18937,празднует,0,0,1,1
18938,gemas,0,0,1,1
18939,estabeleceu,0,0,1,1
18966,verenigde,0,0,1,1
18969,zor,0,0,1,1
18975,ಆರ್ಥಿಕತೆಯು,0,0,1,1
18976,toestemming,0,0,1,1
19006,സമയമില്ല,0,0,1,1
19010,dagligdags,0,0,1,1
19012,ನಮಸ್ಕಾರ,0,0,1,1
19014,التوثيق,0,0,1,1
19015,"ഒരു
വീട്ടമ്മ",0,0,1,1
19016,ಭಾಗವೆಂದರೆ,0,0,1,1
19017,durduğunda,0,0,1,1
19019,നോക്കിയപ്പോൾ,0,0,1,1
19020,portugueselanguage,0,0,1,1
19022,ಕೋಣೆಗೆ,0,0,1,1
19024,afrika,0,0,1,1
19025,سنوات,0,0,1,1
19027,intervenant,0,0,1,1
19030,imkansız,0,0,1,1
19031,указывают,0,0,1,1
19005,جننت,0,0,1,1
19004,تخبر,0,0,1,1
19003,decentralized,0,0,1,1
18988,الوثائقي,0,0,1,1
18979,наличию,0,0,1,1
18980,ಕೆಟ್ಟದು,0,0,1,1
18981,термины,0,0,1,1
18982,особенности,0,0,1,1
18984,ரொட்டியால்,0,0,1,1
18985,وقدم,0,0,1,1
18991,ഉണ്ടാവാം,0,0,1,1
19002,occasionnée,0,0,1,1
18992,ανόητος,0,0,1,1
18994,diretora,0,0,1,1
18995,oprindelse,0,0,1,1
18996,removed,0,0,1,1
18997,sprake,0,0,1,1
18999,tills,0,0,1,1
18912,ആയിരിക്കുമെന്ന്,0,0,1,1
18910,destacan,0,0,1,1
18909,फ्राई,0,0,1,1
18850,تشكر,0,0,1,1
18829,upptäcktes,0,0,1,1
18831,«открытие,0,0,1,1
18832,procedures,0,0,1,1
18834,högre,0,0,1,1
18835,riesgo,0,0,1,1
18836,steigern,0,0,1,1
18837,мгновенно,0,0,1,1
18838,vermuten,0,0,1,1
18840,несчастный,0,0,1,1
18841,ಮಾತನಾಡುವ,0,0,1,1
18842,правил,0,0,1,1
18843,சந்திக்கப்,0,0,1,1
18844,opensourcesoftware,0,0,1,1
18845,congrès,0,0,1,1
18846,excluded,0,0,1,1
18828,intitulada,0,0,1,1
18826,informationskälla,0,0,1,1
18824,pixelgrootte,0,0,1,1
18810,geest,0,0,1,1
18803,"
बुल्गारियाई",0,0,1,1
18805,يركزون,0,0,1,1
18806,aprendan,0,0,1,1
18807,قانونين,0,0,1,1
18808,anciens,0,0,1,1
18809,vas,0,0,1,1
18811,controversas,0,0,1,1
18823,ಕುಳಿತುಕೊಳ್ಳುವ,0,0,1,1
18815,manifestes,0,0,1,1
18816,immuables ,0,0,1,1
18817,يصنع,0,0,1,1
18819,உணர்வு,0,0,1,1
18820,வீடியோவைப்,0,0,1,1
18822,olvides,0,0,1,1
18849,avvisade,0,0,1,1
18851,أعضاء,0,0,1,1
18907,sw •,0,0,1,1
18856,सिस्टम,0,0,1,1
18883,നടുവിലാണ്,0,0,1,1
18885,verkrachtingsincidenten,0,0,1,1
18890,πρακτική,0,0,1,1
18892,अभिनेता,0,0,1,1
18893,wanted,0,0,1,1
18894,ukrainian,0,0,1,1
18897,reunir,0,0,1,1
18898,japanska,0,0,1,1
18899,aangeslagen,0,0,1,1
18900,réciproque,0,0,1,1
18902,كاسم,0,0,1,1
18903,سلبي,0,0,1,1
18904,интернетсайт,0,0,1,1
18905,κοινού,0,0,1,1
18906,banks,0,0,1,1
18881,جالسة,0,0,1,1
18880,girl,0,0,1,1
18879,ಸೂಪ್‌ನಲ್ಲಿದ್ದೇನೆ,0,0,1,1
18867,обоим,0,0,1,1
18857,indicarles,0,0,1,1
18859,uteslutande,0,0,1,1
18861,തോന്നാൻ,0,0,1,1
18862,درس,0,0,1,1
18864,avbryter,0,0,1,1
18866,baka,0,0,1,1
18868,décernés,0,0,1,1
18877,sürümünde,0,0,1,1
18869,اجتازت,0,0,1,1
18871,märkspråken,0,0,1,1
18872,അമ്മയ്ക്ക്,0,0,1,1
18874,администраторы,0,0,1,1
18875,indesejável,0,0,1,1
18876,ಅವಕಾಶವಿಲ್ಲ,0,0,1,1
19518,بالغ,0,0,1,1
19520,undskyldning,0,0,1,1
19521,بلغته,0,0,1,1
20136,அழகும்,0,0,1,1
20138,débuts,0,0,1,1
20140,ವಿಷಯದಲ್ಲಿ,0,0,1,1
20141,vivía,0,0,1,1
20142,അത്യാധുനികമാണ്,0,0,1,1
20145,conducta,0,0,1,1
20146,இரண்டிலும்,0,0,1,1
20147,retourner,0,0,1,1
20148,கடக்கிறீர்கள்,0,0,1,1
20149,genus,0,0,1,1
20150,efetivada,0,0,1,1
20151,repetitive,0,0,1,1
20152,skills,0,0,1,1
20154,kategoriserades,0,0,1,1
20155,morality,0,0,1,1
20157,betydelsen,0,0,1,1
20137,enviada,0,0,1,1
20133,filters,0,0,1,1
20104,handy,0,0,1,1
20127,ಬೆರಳುಗಳ,0,0,1,1
20106,प्रिक्स,0,0,1,1
20107,ropa,0,0,1,1
20108,intresseväckande,0,0,1,1
20109,förberedde,0,0,1,1
20110,upptäckts,0,0,1,1
20112,सीखना,0,0,1,1
20113,внимания,0,0,1,1
20115,alemanha,0,0,1,1
20116,ചെയ്തിട്ടില്ല,0,0,1,1
20117,ಜ್ಯಾಮಿತಿ,0,0,1,1
20118,vieil,0,0,1,1
20119,дорабатывали,0,0,1,1
20120,allée,0,0,1,1
20122,tastiest,0,0,1,1
20123,αυξηθεί,0,0,1,1
20158,سمعته,0,0,1,1
20159,fließende,0,0,1,1
20161,δίλημμα,0,0,1,1
20162,neuf,0,0,1,1
20193,certos,0,0,1,1
20195,नींद,0,0,1,1
20197,bitirmeme,0,0,1,1
20199,regrouper ,0,0,1,1
20200,telefonumu,0,0,1,1
20202,объектом,0,0,1,1
20204,إخبارهم,0,0,1,1
20206,précédents,0,0,1,1
20208,animistes,0,0,1,1
20209,telespectadores,0,0,1,1
20210,मंत्री,0,0,1,1
20215,المتوافقة,0,0,1,1
20216,подумайте,0,0,1,1
20218,υποθέστε,0,0,1,1
20219,حديثًا,0,0,1,1
20192,входные,0,0,1,1
20191,variáveis,0,0,1,1
20190,закончить,0,0,1,1
20176,stakes,0,0,1,1
20165,stunningly,0,0,1,1
20166,tes,0,0,1,1
20168,rettigheder,0,0,1,1
20169,editassem,0,0,1,1
20174,പാകിസ്താൻ,0,0,1,1
20175,دعا,0,0,1,1
20177,disminuyendo,0,0,1,1
20189,பயனரின்,0,0,1,1
20178,fameux,0,0,1,1
20180,σχέδιο,0,0,1,1
20183,characterizing,0,0,1,1
20185,haklıydın,0,0,1,1
20187,projectwide,0,0,1,1
20188,ശ്രദ്ധിക്കാനാകില്ലെന്ന്,0,0,1,1
20105,funcionalidade,0,0,1,1
20103,iie siècle,0,0,1,1
19984,неверными,0,0,1,1
20013,ζαμάνια,0,0,1,1
20017,നല്ലവരായിരിക്കുക,0,0,1,1
20019,porção,0,0,1,1
20021,എത്തി,0,0,1,1
20023,aarzelend,0,0,1,1
20024,blanking,0,0,1,1
20026,italie »m,0,0,1,1
20027,frokost,0,0,1,1
20028,واجمع,0,0,1,1
20030,fundamentally,0,0,1,1
20031,ನೋಡುತ್ತದೆ,0,0,1,1
20032,يخضع,0,0,1,1
20033,adquirimos,0,0,1,1
20037,affirmé,0,0,1,1
20038,sousdomaine,0,0,1,1
20039,touristique,0,0,1,1
20015,والجزء,0,0,1,1
20009,вопросительным,0,0,1,1
20101,بالخارج,0,0,1,1
20008,equipped,0,0,1,1
19988,apresentarei,0,0,1,1
19991,வழங்கி,0,0,1,1
19993,catalogue,0,0,1,1
19994,حق,0,0,1,1
19995,farm,0,0,1,1
19997,comprobase,0,0,1,1
19998,ημερομηνία,0,0,1,1
19999,tilladelse,0,0,1,1
20000,quinta,0,0,1,1
20001,witty,0,0,1,1
20002,अनुभाग,0,0,1,1
20004,γενικά,0,0,1,1
20005,noemt,0,0,1,1
20006,لتزايد,0,0,1,1
20007,multilíngue,0,0,1,1
20041,സൈർ,0,0,1,1
20042,percatara,0,0,1,1
20043,കീഴ്‌വഴക്കവും,0,0,1,1
20044,tvekande,0,0,1,1
20073,progressive,0,0,1,1
20074,жила,0,0,1,1
20075,gehirn,0,0,1,1
20076,admiração,0,0,1,1
20079,attachées,0,0,1,1
20080,especificando,0,0,1,1
20082,ordu,0,0,1,1
20083,الفائدة,0,0,1,1
20084,ഗണത്തിൽപ്പെടുന്നു,0,0,1,1
20086,financial,0,0,1,1
20087,gulches,0,0,1,1
20092,revolves,0,0,1,1
20093,സമതുലിതമായ,0,0,1,1
20095,ಕಷ್ಟವಾಯಿತು,0,0,1,1
20100,udc,0,0,1,1
20072,அறியப்பட்டிருந்தாலும்,0,0,1,1
20071,güzelce,0,0,1,1
20070,ബുദ്ധിയുടെ,0,0,1,1
20056,rediseñó,0,0,1,1
20046,constitute,0,0,1,1
20048,изданы,0,0,1,1
20051,ωθεί,0,0,1,1
20052,sıkıcı,0,0,1,1
20053,अवधारणा,0,0,1,1
20055,расстроен,0,0,1,1
20058,språkversionen,0,0,1,1
20069,മറുപടി,0,0,1,1
20059,persistent,0,0,1,1
20060,scolastique ,0,0,1,1
20062,betrouwbaar,0,0,1,1
20063,guldguldbröd,0,0,1,1
20064,criativa,0,0,1,1
20068,администраторов,0,0,1,1
20221,concreta,0,0,1,1
20222,nacemos,0,0,1,1
20223,verzoeken,0,0,1,1
20384,പങ്കുവയ്ക്കുന്നു,0,0,1,1
20387,ടെലിഗ്രാം,0,0,1,1
20388,croire,0,0,1,1
20389,kochten,0,0,1,1
20391,avoiding,0,0,1,1
20393,pestañas,0,0,1,1
20394,språkversion,0,0,1,1
20395,sexuada,0,0,1,1
20397,لأقول,0,0,1,1
20399,pleasant,0,0,1,1
20400,ആർതർ,0,0,1,1
20401,இணையத்தொடர்பையும்,0,0,1,1
20407,φτιαγμένες,0,0,1,1
20410,analytics,0,0,1,1
20411,objectives,0,0,1,1
20414,عامية,0,0,1,1
20385,dokument,0,0,1,1
20383,ειδικά,0,0,1,1
20225,lebte,0,0,1,1
20382,أظهر,0,0,1,1
20355,неизвестна,0,0,1,1
20356,impulso,0,0,1,1
20358,conférences,0,0,1,1
20359,погружение,0,0,1,1
20362,poser,0,0,1,1
20364,قمت,0,0,1,1
20365,retorting,0,0,1,1
20366,ಹ್ಯಾಂಗ್,0,0,1,1
20369,يخطئ,0,0,1,1
20370,கனவைப்,0,0,1,1
20374,souciait,0,0,1,1
20376,दूरदूर,0,0,1,1
20379,bildbank,0,0,1,1
20380,பரிந்துரைகள்,0,0,1,1
20381,instantaneamente,0,0,1,1
20416,ഉണ്ടാകും,0,0,1,1
20418,العالمية,0,0,1,1
20420,"
नेपाल",0,0,1,1
20421,reutilizar,0,0,1,1
20453,നടത്തുവാനും,0,0,1,1
20455,فريق,0,0,1,1
20459,വലിയൊരാത്മവിശ്വാസം,0,0,1,1
20460,टाइप,0,0,1,1
20465,فجأة,0,0,1,1
20466,യാത്ര,0,0,1,1
20467,möjlig,0,0,1,1
20469,testées,0,0,1,1
20470,കാര്യങ്ങൾക്ക്,0,0,1,1
20471,vulgariser,0,0,1,1
20476,അവൾക്കറിയാമോ,0,0,1,1
20477,فهذا,0,0,1,1
20479,അവളെ,0,0,1,1
20480,dreng,0,0,1,1
20483,taşlarından,0,0,1,1
20451,ஒருவகை,0,0,1,1
20449,गणना,0,0,1,1
20448,സന്ദേശങ്ങളെ,0,0,1,1
20432,ഉപയോഗിക്കാം,0,0,1,1
20422,gevolg,0,0,1,1
20424,dækker,0,0,1,1
20428,nyttigt,0,0,1,1
20429,μιλούσατε,0,0,1,1
20430,вводится,0,0,1,1
20431,bibliothek,0,0,1,1
20434,ಶಾಂತಗೊಳಿಸಿ,0,0,1,1
20447,lenguajes,0,0,1,1
20437,situer,0,0,1,1
20438,jeu ,0,0,1,1
20439,يشبه,0,0,1,1
20440,zümrüt,0,0,1,1
20442,डरा,0,0,1,1
20446,बोलिये।,0,0,1,1
20354,traditionellt,0,0,1,1
20353,விடைபெறாமல்,0,0,1,1
20349,inzamelen,0,0,1,1
20285,olabilirdim,0,0,1,1
20255,guided,0,0,1,1
20256,erstaunliches,0,0,1,1
20257,majeurs,0,0,1,1
20258,λατρεύω,0,0,1,1
20261,பயனர்களும்,0,0,1,1
20262,расположенных,0,0,1,1
20264,സ്വതന്ത്രമായി,0,0,1,1
20265,विकिपुस्तक,0,0,1,1
20266,مبنية,0,0,1,1
20267,dissimilar,0,0,1,1
20268,geschehen,0,0,1,1
20269,विशेषकर,0,0,1,1
20275,इंटरेक्टिव,0,0,1,1
20276,passende,0,0,1,1
20277,grossièrement,0,0,1,1
20254,proteção,0,0,1,1
20251,heliopause,0,0,1,1
20249,гипотетическую,0,0,1,1
20237,читателей,0,0,1,1
20227,विकटियोनरी,0,0,1,1
20230,seks,0,0,1,1
20231,ಪ್ರಪಂಚದಾದ್ಯಂತ,0,0,1,1
20232,പെരുമാറിയ,0,0,1,1
20233,бесполезен,0,0,1,1
20234,källan,0,0,1,1
20238,συνεργατικά,0,0,1,1
20248,disponível,0,0,1,1
20240,extensively,0,0,1,1
20241,ಕ್ಯಾಸಲ್,0,0,1,1
20242,« pays,0,0,1,1
20243,அனுபவம்,0,0,1,1
20245,экзамену,0,0,1,1
20246,ചതുപ്പുനിലമാക്കി,0,0,1,1
20279,likhet,0,0,1,1
20286,himmel,0,0,1,1
20347,desconcierto,0,0,1,1
20289,применения,0,0,1,1
20318,chanceux,0,0,1,1
20319,rédigées,0,0,1,1
20322,alloué,0,0,1,1
20323,sacralisation,0,0,1,1
20326,«циркуляре,0,0,1,1
20327,المساهمة,0,0,1,1
20329,desconsolada,0,0,1,1
20330,विद्यार्थी,0,0,1,1
20333,கடி,0,0,1,1
20334,பயணத்தை,0,0,1,1
20335,பயணத்தின்போது,0,0,1,1
20336,खातों,0,0,1,1
20337,yapmamıştım,0,0,1,1
20343,перевод,0,0,1,1
20344,üniversiteye,0,0,1,1
20317,сообщества —,0,0,1,1
20316,"

विकिपीडिया",0,0,1,1
20314,reescrevem,0,0,1,1
20299,upprepning,0,0,1,1
20290,incorrectas,0,0,1,1
20291,comentar,0,0,1,1
20292,rendered,0,0,1,1
20293,monate,0,0,1,1
20297,meeste,0,0,1,1
20298,удивит,0,0,1,1
20300,χρυσές,0,0,1,1
20311,värden,0,0,1,1
20301,eliminando,0,0,1,1
20302, года,0,0,1,1
20304,impressa,0,0,1,1
20305,parvenant,0,0,1,1
20306,المربيات,0,0,1,1
20307,المساء,0,0,1,1
19987,varient,0,0,1,1
19983,diferenciar,0,0,1,1
19523,ಸಾಮಾನ್ಯವಾಗಿ,0,0,1,1
19672,കൈമുതലായുണ്ടാവും,0,0,1,1
19675,frappez,0,0,1,1
19677,önska,0,0,1,1
19678,remaniée,0,0,1,1
19680,captar,0,0,1,1
19681,അവസ്ഥകളെ,0,0,1,1
19682,ajuda,0,0,1,1
19684,таков,0,0,1,1
19686,γλώσσα,0,0,1,1
19687,leeftijd,0,0,1,1
19690,cirkelen,0,0,1,1
19691,முடிக்கிறேன்,0,0,1,1
19692,fransk,0,0,1,1
19693,மெதுவாகவும்,0,0,1,1
19694,disagree,0,0,1,1
19696,güzellerdi,0,0,1,1
19674,acordei,0,0,1,1
19669,отправлять,0,0,1,1
19643,сосуществовали,0,0,1,1
19668,விக்கிப்பீடியாவினது,0,0,1,1
19645,england,0,0,1,1
19647,identifying,0,0,1,1
19649,المستقلة,0,0,1,1
19650,mulher,0,0,1,1
19651,выучить,0,0,1,1
19654,इनकार,0,0,1,1
19655,sabrosa,0,0,1,1
19657,مقالًا,0,0,1,1
19658,وأنتم,0,0,1,1
19659,данное,0,0,1,1
19661,الاختلافات,0,0,1,1
19662,ಸಂಪರ್ಕದಲ್ಲಿರಿ,0,0,1,1
19664,prémunir,0,0,1,1
19665,планирую,0,0,1,1
19667,ನಡೆಯುತ್ತಿಲ್ಲ,0,0,1,1
19697,onderverdeeld,0,0,1,1
19699,courants,0,0,1,1
19702,overlap,0,0,1,1
19703,sweetheart,0,0,1,1
19737,мешают,0,0,1,1
19740,биологических,0,0,1,1
19741,indkøbscentret,0,0,1,1
19743,ലൈക്ക്,0,0,1,1
19744,compromises,0,0,1,1
19746,connecting,0,0,1,1
19749,δημιουργηθεί,0,0,1,1
19750,ejercen,0,0,1,1
19751,όνειρά,0,0,1,1
19752,reputado,0,0,1,1
19753,piloté,0,0,1,1
19754,اقتراحك,0,0,1,1
19757,dimensionality,0,0,1,1
19758,leerproblemen,0,0,1,1
19759,genel,0,0,1,1
19736,கொள்கைக்கு,0,0,1,1
19735,இருந்தபோதிலும்,0,0,1,1
19733,formål,0,0,1,1
19716,gags,0,0,1,1
19707,எஸ்எம்எஸ்,0,0,1,1
19709,finnish,0,0,1,1
19710,ajude,0,0,1,1
19711,данного,0,0,1,1
19712,ತೆಗೆದುಕೊಳ್ಳಬೇಕೆಂದು,0,0,1,1
19713,handicapant,0,0,1,1
19720,stumpfen,0,0,1,1
19732,некоторого,0,0,1,1
19721,открыт,0,0,1,1
19722,expend,0,0,1,1
19724,கால்களை,0,0,1,1
19725,beneficie,0,0,1,1
19727,يسافرون,0,0,1,1
19730,upptäckas,0,0,1,1
19644,sonst,0,0,1,1
19640,ثقافة,0,0,1,1
19982,vida»,0,0,1,1
19546,incrementa,0,0,1,1
19548,सत्ता,0,0,1,1
19549,மென்மையானது,0,0,1,1
19550,اللحم,0,0,1,1
19552,ഉത്ഭവം,0,0,1,1
19554,നീങ്ങുക,0,0,1,1
19555,abordé,0,0,1,1
19556,lutté,0,0,1,1
19559,sache,0,0,1,1
19561,технологии,0,0,1,1
19562,accomplish,0,0,1,1
19563,உணவுக்கு,0,0,1,1
19564,ഇംഗ്ലീഷ്‌,0,0,1,1
19567,primaria»​,0,0,1,1
19568,ecologists,0,0,1,1
19569,lyfter,0,0,1,1
19547,décerné,0,0,1,1
19545,singapur,0,0,1,1
19639,établissements,0,0,1,1
19544,espantoso,0,0,1,1
19524,sürdürmeye,0,0,1,1
19525,permitió,0,0,1,1
19526,«быть,0,0,1,1
19527,estonien,0,0,1,1
19529,الكبرى,0,0,1,1
19530,stimulustriggered,0,0,1,1
19531,displaced,0,0,1,1
19532,വച്ചിരുന്നു,0,0,1,1
19533,накоплению,0,0,1,1
19534,اصطناعي,0,0,1,1
19535,kingdom,0,0,1,1
19537,ஆராய,0,0,1,1
19538,exceptionnellement,0,0,1,1
19541,frustration,0,0,1,1
19542,herzlich,0,0,1,1
19570,சாப்பிடக்கூடிய,0,0,1,1
19571,banned,0,0,1,1
19572,ഉണ്ടാവില്ലെന്നർത്ഥം,0,0,1,1
19573,domaine ,0,0,1,1
19609,счастливым,0,0,1,1
19610,az •,0,0,1,1
19614,கொண்டன,0,0,1,1
19615,ιππότης,0,0,1,1
19616,ναρκισσισμός,0,0,1,1
19617,ತಾಯಿಯಲ್ಲ,0,0,1,1
19618,ಮೂರನೆಯ,0,0,1,1
19619,أذكرك,0,0,1,1
19620,tentativa,0,0,1,1
19622,speak,0,0,1,1
19623,نفسها،,0,0,1,1
19626,fångar,0,0,1,1
19633,autres ,0,0,1,1
19635,அடுத்ததாக,0,0,1,1
19636,प्रचार,0,0,1,1
19606,nimmst,0,0,1,1
19605,reader,0,0,1,1
19603,højttalerikon,0,0,1,1
19588,laid,0,0,1,1
19576,analistas,0,0,1,1
19577,critiquent,0,0,1,1
19578,represalias,0,0,1,1
19579,بعمق,0,0,1,1
19581,serais,0,0,1,1
19586,gelsin,0,0,1,1
19589,albert,0,0,1,1
19599,proliferation,0,0,1,1
19590,demokrater,0,0,1,1
19591,"
स्कॉटिश",0,0,1,1
19595,fouilles,0,0,1,1
19596,misbruik,0,0,1,1
19597,распределённую,0,0,1,1
19598,принесет,0,0,1,1
19761,وأكثر,0,0,1,1
19764,schmieden,0,0,1,1
19766,отношения,0,0,1,1
19913,veteranos—,0,0,1,1
19916,rapidly,0,0,1,1
19918,bemeducado,0,0,1,1
19919,uitspreekt,0,0,1,1
19920,инициировал,0,0,1,1
19921,wreed,0,0,1,1
19922,പതിപ്പുകളുണ്ട്,0,0,1,1
19924,  km,0,0,1,1
19925,öyleyse,0,0,1,1
19926,lett,0,0,1,1
19927,растерянной,0,0,1,1
19929,slarvar,0,0,1,1
19930,الأمريكية،,0,0,1,1
19931,apresentada,0,0,1,1
19932,aanstelling,0,0,1,1
19934,búsquedas,0,0,1,1
19915,நிரல்,0,0,1,1
19912,«votaciones»,0,0,1,1
19767,«usuarios»,0,0,1,1
19910,accordait,0,0,1,1
19889,sänkte,0,0,1,1
19892,innehöll,0,0,1,1
19893,continuam,0,0,1,1
19895,вошёл,0,0,1,1
19896,inbördeskriget,0,0,1,1
19897,ಲಿಂಕ್,0,0,1,1
19898,പ്രയത്നത്തിന്,0,0,1,1
19899,droit ,0,0,1,1
19900,அப்பட்டமான,0,0,1,1
19901,هاتفي,0,0,1,1
19902,എത്രത്തോളമാവണം,0,0,1,1
19903,அவரிடம்,0,0,1,1
19905,भयावह,0,0,1,1
19906,gedrukt,0,0,1,1
19907,improbable,0,0,1,1
19935,ποιότητας,0,0,1,1
19936,yazdıkları,0,0,1,1
19937,allmänhetens,0,0,1,1
19938,ಕ್ರಿಯಾಪದವು,0,0,1,1
19965,قصري,0,0,1,1
19966,ಸಾಗುವುದು,0,0,1,1
19967,condemned,0,0,1,1
19968,determinar,0,0,1,1
19969,διακόψαμε,0,0,1,1
19970,écologique »,0,0,1,1
19971,επιβάλλουν,0,0,1,1
19972,encargó,0,0,1,1
19973,объёму,0,0,1,1
19974,ಮುಕ್ತರಾಗಿದ್ದೀರಾ,0,0,1,1
19975,кукла,0,0,1,1
19976,marcadas,0,0,1,1
19978,വിലാസത്തിന്റെ,0,0,1,1
19980,εχεις,0,0,1,1
19981,eurocentric,0,0,1,1
19963,emploie,0,0,1,1
19961,conexão,0,0,1,1
19959,نزاعات,0,0,1,1
19950,ശ്രമങ്ങൾ‍,0,0,1,1
19941,skarpa,0,0,1,1
19942,عنها,0,0,1,1
19943,vandals,0,0,1,1
19946,ασημένιο,0,0,1,1
19947,yiyebileceğim,0,0,1,1
19949,ελληνόφωνη,0,0,1,1
19951,databasdumpar,0,0,1,1
19958,ആവർത്തിക്കണം,0,0,1,1
19952,proporción,0,0,1,1
19953,trägen,0,0,1,1
19954,veranderde,0,0,1,1
19955,далее»,0,0,1,1
19956,усердной,0,0,1,1
19957,naturligtvis,0,0,1,1
19888,കൊടുങ്കാറ്റ്,0,0,1,1
19886,والـ,0,0,1,1
19885,φρικάρω,0,0,1,1
19827,целиком,0,0,1,1
19797,копиями,0,0,1,1
19803,डगलस,0,0,1,1
19805,d’identification »,0,0,1,1
19806,فالزوجة,0,0,1,1
19808,kwartaal,0,0,1,1
19809,പകർത്താൻ,0,0,1,1
19811,wendt,0,0,1,1
19812,கிடைக்கும்படியான,0,0,1,1
19813,അഭിപ്രായമില്ല,0,0,1,1
19815,apagados,0,0,1,1
19816,anlayışı,0,0,1,1
19818,பிரிட்டானிக்காவின்,0,0,1,1
19819,schweres,0,0,1,1
19821,desencorajam,0,0,1,1
19823,geldiniz,0,0,1,1
19796,índice,0,0,1,1
19795,discount,0,0,1,1
19794,प्रतिपादित,0,0,1,1
19777,جوجل,0,0,1,1
19769,скрещенные,0,0,1,1
19770,ശ്രമിക്കുമ്പോൾ,0,0,1,1
19772,mond,0,0,1,1
19773,clin,0,0,1,1
19774,amène,0,0,1,1
19775,يحدق,0,0,1,1
19778,"
turco",0,0,1,1
19793,भत्ते,0,0,1,1
19785,hoaxen,0,0,1,1
19786,പലതുള്ളി,0,0,1,1
19787,مصطلح,0,0,1,1
19789,replaces,0,0,1,1
19790,grundas,0,0,1,1
19792,χρησιμοποιούμε,0,0,1,1
19824,oopsla,0,0,1,1
19831,பைத்தியம்,0,0,1,1
19884,பதிவுசெய்த,0,0,1,1
19834,تضع,0,0,1,1
19862,meninger,0,0,1,1
19864,προσφορά,0,0,1,1
19865,redunda,0,0,1,1
19867,"
मालागासे",0,0,1,1
19869,soportes,0,0,1,1
19870,attributionsharealike,0,0,1,1
19872,प्रणालीगत,0,0,1,1
19873,librement,0,0,1,1
19874,adı,0,0,1,1
19875,ಬುದ್ಧಿಹೀನ,0,0,1,1
19876,தொலைபேசியை,0,0,1,1
19877,enciclopédicos,0,0,1,1
19880,lägstanivå,0,0,1,1
19881,stinkt,0,0,1,1
19883,blandad,0,0,1,1
19861,будущая,0,0,1,1
19860,ومقاومته,0,0,1,1
19859,dukke,0,0,1,1
19844,crenças,0,0,1,1
19835,alacak,0,0,1,1
19837,ബാധകമായ,0,0,1,1
19840,வந்த,0,0,1,1
19841,bibliotekariens,0,0,1,1
19842,العمومية,0,0,1,1
19843,greenwich,0,0,1,1
19845,கருத்தைத்,0,0,1,1
19857,consacré,0,0,1,1
19846,മകളുടെ,0,0,1,1
19847,ಕೆಲಸವಿದೆ,0,0,1,1
19849,censar,0,0,1,1
19852,κρυφά,0,0,1,1
19853,ಅಡ್ಡಿಪಡಿಸಲು,0,0,1,1
19856,vermeniz,0,0,1,1
22356,широко,0,0,1,1
22359,sh •,0,0,1,1
26082,motsvarigheter,0,0,1,1
24795,mandarei,0,0,1,1
24800,तीसरे,0,0,1,1
24802,बने,0,0,1,1
24803,γραμμένη,0,0,1,1
24804,بعدي,0,0,1,1
24805,"
दक्षिण",0,0,1,1
24806,مقالاتها،,0,0,1,1
24808,parçasını,0,0,1,1
24811,μπόρεσα,0,0,1,1
24813,heldere,0,0,1,1
24814,suppression,0,0,1,1
24815,модифицировано,0,0,1,1
24816,πόλη,0,0,1,1
24817,franchi,0,0,1,1
24820,pesos,0,0,1,1
24823,mathematically,0,0,1,1
24799,intellectuelles,0,0,1,1
24793,castigos,0,0,1,1
24767,ಮತ್ತೊಮ್ಮೆ,0,0,1,1
24792,meşhur,0,0,1,1
24770,« utilisateur »l,0,0,1,1
24771,vidsträckt,0,0,1,1
24773,échéance,0,0,1,1
24774,जाएगा।,0,0,1,1
24778,stupéfait,0,0,1,1
24779,ಮಾಡಲಿದೆ,0,0,1,1
24780,அடைந்தார்,0,0,1,1
24782,rituals,0,0,1,1
24783,വീഡിയോയിൽ‌,0,0,1,1
24784,пересадки,0,0,1,1
24787,языке»,0,0,1,1
24788,طردت,0,0,1,1
24789,obtienen,0,0,1,1
24790,samhället,0,0,1,1
24791,tirou,0,0,1,1
24826,मॉल,0,0,1,1
24827,practicar,0,0,1,1
24828,valg,0,0,1,1
24830,stapt,0,0,1,1
24862,للتعبير,0,0,1,1
24863,almalıyız,0,0,1,1
24864,varav,0,0,1,1
24865,voltam,0,0,1,1
24866,وأبل,0,0,1,1
24867,gitmek,0,0,1,1
24868,happens,0,0,1,1
24871,“davutoğlu’nun,0,0,1,1
24872,causaba,0,0,1,1
24874,estompée,0,0,1,1
24875,بنصيب,0,0,1,1
24876,മോശമായിത്തീർന്നത്,0,0,1,1
24877,கூறினார்,0,0,1,1
24883,divertidas,0,0,1,1
24884,அங்கீகரிக்கப்படல்,0,0,1,1
24861,doktorerat,0,0,1,1
24859,கொடுமை,0,0,1,1
24854,столовую,0,0,1,1
24838,boring,0,0,1,1
24831,காணமுடியும்,0,0,1,1
24832,skillnad,0,0,1,1
24833,relatado,0,0,1,1
24834,polish,0,0,1,1
24835,gördüğünüzü,0,0,1,1
24837,esenciales,0,0,1,1
24841,ശ്രദ്ധിക്കുന്നവർ,0,0,1,1
24853,updating,0,0,1,1
24845,bloquer,0,0,1,1
24846,विज्ञापनदाता,0,0,1,1
24848,حزن,0,0,1,1
24849,wikipediaskribenter,0,0,1,1
24850,conquistado,0,0,1,1
24851,ഇടയില്ലാത്ത,0,0,1,1
24768,yapılabilir,0,0,1,1
24766,omissions,0,0,1,1
24886,voulezvous,0,0,1,1
24672,मार्च,0,0,1,1
24674,«отделения,0,0,1,1
24675,لتصنيف,0,0,1,1
24679,مروع,0,0,1,1
24681,δάκρυά,0,0,1,1
24682,sahibi,0,0,1,1
24683,estimate,0,0,1,1
24689,δηλώσει,0,0,1,1
24691,consigue,0,0,1,1
24692,cidade,0,0,1,1
24694,komende,0,0,1,1
24695,ошибку,0,0,1,1
24696,propiamente,0,0,1,1
24697,ಬಯಸುತ್ತಾಳೆ,0,0,1,1
24698,माफी,0,0,1,1
24699,ஹேங்கவுட்,0,0,1,1
24673,clouds,0,0,1,1
24668,verificáveis,0,0,1,1
24765,roda,0,0,1,1
24667,സിനിമകളിലേക്ക്,0,0,1,1
24646,consulté »,0,0,1,1
24647,തിരുത്തലുകളും,0,0,1,1
24648,industrialisés,0,0,1,1
24649,servicio,0,0,1,1
24650,marco,0,0,1,1
24654,tl •,0,0,1,1
24656,iyiydim,0,0,1,1
24657,transactions,0,0,1,1
24659,новости,0,0,1,1
24660,ρωτώ,0,0,1,1
24661,ışıltılı,0,0,1,1
24662,أخبرني,0,0,1,1
24663,руководителя,0,0,1,1
24664,വിവരിക്കുന്നുള്ളൂ,0,0,1,1
24665,झांका।,0,0,1,1
24700,censored,0,0,1,1
24701,viewing,0,0,1,1
24704,placerade,0,0,1,1
24710,குறைவாகவும்,0,0,1,1
24741,membre,0,0,1,1
24743,påbörjade,0,0,1,1
24744,редактор,0,0,1,1
24747,helion,0,0,1,1
24749,குற்ற,0,0,1,1
24750,exhaustivité,0,0,1,1
24751,érudition,0,0,1,1
24753,undue,0,0,1,1
24755,ambas,0,0,1,1
24759,polaires,0,0,1,1
24760,комик,0,0,1,1
24761,ജോസഫ്,0,0,1,1
24762,exceptional,0,0,1,1
24763,вносимые,0,0,1,1
24764,ухожу,0,0,1,1
24738,क्रम,0,0,1,1
24736,conditional,0,0,1,1
24734,armén,0,0,1,1
24720,founding,0,0,1,1
24712,wikiespecies,0,0,1,1
24713,"നിഷ്പക്ഷത
ഉറപ്പാക്കുന്നു",0,0,1,1
24715,polémicos,0,0,1,1
24717,inserir,0,0,1,1
24718,modifié,0,0,1,1
24719,источников,0,0,1,1
24723,compraram,0,0,1,1
24733,brion,0,0,1,1
24724,tilbageværende,0,0,1,1
24728,«sensibles»,0,0,1,1
24729,أثبتت,0,0,1,1
24730,vagn,0,0,1,1
24731,fresco»,0,0,1,1
24732,കൊടുത്തുകൊണ്ടുള്ള,0,0,1,1
24885,ಶಬ್ದವನ್ನು,0,0,1,1
24887,माइक्रो,0,0,1,1
24194,ആവർത്തിക്കണമെന്ന്,0,0,1,1
25037,குழுவொன்று,0,0,1,1
25043,ನೇಮಿಸಿಕೊಳ್ಳಬೇಕು,0,0,1,1
25046,historic,0,0,1,1
25047,конечная,0,0,1,1
25048,ಧ್ವನಿಸುವ,0,0,1,1
25049,tercer,0,0,1,1
25050,ಭಾವಿಸಿದ್ದೇನೆ,0,0,1,1
25055,дорогой,0,0,1,1
25057,classés,0,0,1,1
25058,aufschreiben,0,0,1,1
25059,işte,0,0,1,1
25061,бизнес,0,0,1,1
25062,accéder,0,0,1,1
25063,œil,0,0,1,1
25065,fiaskoer,0,0,1,1
25068,മറികടന്നു,0,0,1,1
25042,നോട്ടത്തിൽ,0,0,1,1
25036,nynorsk,0,0,1,1
25010,stavningen,0,0,1,1
25035,viejo,0,0,1,1
25014,καλλιέργεια,0,0,1,1
25015,arboretums,0,0,1,1
25016,habitable,0,0,1,1
25017,conferências,0,0,1,1
25018,عهد,0,0,1,1
25020,दिसंबर,0,0,1,1
25026,disallowed,0,0,1,1
25027,plagiarism,0,0,1,1
25028,partager,0,0,1,1
25029,legitimiteten,0,0,1,1
25030,intègrent,0,0,1,1
25031,pessoalmente,0,0,1,1
25032,нейтральной,0,0,1,1
25033,yöntemleri,0,0,1,1
25034,അനുവദിക്കുക,0,0,1,1
25069,ca •,0,0,1,1
25072,blacking,0,0,1,1
25073,பட்டினி,0,0,1,1
25075,ansiklopedilerden,0,0,1,1
25110,incita,0,0,1,1
25111,الآيس,0,0,1,1
25112,pay,0,0,1,1
25113,arrivée,0,0,1,1
25114,automatiserade,0,0,1,1
25115,قريبا,0,0,1,1
25116,متفاجئة,0,0,1,1
25117,सिटीजेंडियम,0,0,1,1
25118,sänkts,0,0,1,1
25119,épouse,0,0,1,1
25124,enviarei,0,0,1,1
25126,échappé,0,0,1,1
25128,للأبحاث,0,0,1,1
25130,വർദ്ധിക്കുമ്പോൾ,0,0,1,1
25131,bulunmamaktadır,0,0,1,1
25108,games,0,0,1,1
25107,versuche,0,0,1,1
25104,தேடுகிறீர்கள்,0,0,1,1
25088,واحدًا,0,0,1,1
25076,kontroversiell,0,0,1,1
25078,ciudad,0,0,1,1
25079,"
चीनी",0,0,1,1
25083,hervat,0,0,1,1
25084,değiştirilebilir,0,0,1,1
25087,frankrig,0,0,1,1
25090,ആയതുകൊണ്ട്,0,0,1,1
25101,сенсация,0,0,1,1
25091,السيبوانية,0,0,1,1
25092,ابنتك,0,0,1,1
25097,விட்டால்,0,0,1,1
25098,விலங்கு,0,0,1,1
25099,പുഞ്ചിരിക്കാനും,0,0,1,1
25100,பகுதியில்,0,0,1,1
25013,വിരസമാണ്,0,0,1,1
25009,chiques,0,0,1,1
24889,affecting,0,0,1,1
24922,സാമാന്യവത്കരണം,0,0,1,1
24926,"
checheno",0,0,1,1
24927,internautas,0,0,1,1
24928,¿tienes,0,0,1,1
24929,предотвращения,0,0,1,1
24930,tidligere,0,0,1,1
24934,existed,0,0,1,1
24935,divisão,0,0,1,1
24937,possibilités,0,0,1,1
24940,κύρος,0,0,1,1
24941,يعانون,0,0,1,1
24942,تجنب,0,0,1,1
24943,freier,0,0,1,1
24946,पहुँचने,0,0,1,1
24947,चाहे,0,0,1,1
24948,visant,0,0,1,1
24923,punt,0,0,1,1
24920,bristen,0,0,1,1
25008,répondant,0,0,1,1
24916,ഇന്ത്യാ,0,0,1,1
24890,പുതുമുഖങ്ങൾക്ക്,0,0,1,1
24891,مدريد,0,0,1,1
24892,metin,0,0,1,1
24895,maddenin,0,0,1,1
24897,resultantes,0,0,1,1
24898,التنبيهات,0,0,1,1
24899,oproportionerligt,0,0,1,1
24902,உரிமை,0,0,1,1
24903,değiştirmiştir,0,0,1,1
24904,स्वाद।,0,0,1,1
24905,المقابلة,0,0,1,1
24906,الأكاديمية,0,0,1,1
24910,fazem,0,0,1,1
24912,« comme,0,0,1,1
24915,lighthearted,0,0,1,1
24949,damen,0,0,1,1
24950,coin,0,0,1,1
24951,ആർക്കെങ്കിലും,0,0,1,1
24952,grubu,0,0,1,1
24987,എടുക്കാൻ,0,0,1,1
24989,perfection,0,0,1,1
24990,одноименной,0,0,1,1
24991,சொல்லவும்,0,0,1,1
24992,नौकरानियों।,0,0,1,1
24993,lektier,0,0,1,1
24997,inútiles,0,0,1,1
24998,मरम्मत,0,0,1,1
25001,abrange,0,0,1,1
25002,lv •,0,0,1,1
25003,συμβεί,0,0,1,1
25004,എന്താണെന്ന,0,0,1,1
25005,географических,0,0,1,1
25006,japonês,0,0,1,1
25007,கேள்வியைத்,0,0,1,1
24985,directement,0,0,1,1
24984,موثوقة,0,0,1,1
24982,certainly,0,0,1,1
24969,« aide »,0,0,1,1
24953,linguistics,0,0,1,1
24956,മാതൃകകളെ,0,0,1,1
24960,പ്രപഞ്ചത്തിലെ,0,0,1,1
24964,operadores,0,0,1,1
24965,nds •,0,0,1,1
24967,σκοπεύω,0,0,1,1
24970,escudo,0,0,1,1
24979,médiatisées,0,0,1,1
24971,annesine,0,0,1,1
24973,continuité,0,0,1,1
24974,والنرويجية,0,0,1,1
24975,такое,0,0,1,1
24977,"
búlgaro",0,0,1,1
24978,migrated,0,0,1,1
24645,celestial,0,0,1,1
24643,mobilanpassade,0,0,1,1
24641,mejore,0,0,1,1
24339,μμ,0,0,1,1
24341,प्रोग्राम,0,0,1,1
24342,praticar,0,0,1,1
24344,válida,0,0,1,1
24348,எழுத்துப்பிழைகளைத்,0,0,1,1
24351,revenues,0,0,1,1
24352,législatives »,0,0,1,1
24353,pushing,0,0,1,1
24356,بدونك,0,0,1,1
24357,viande,0,0,1,1
24361,تفكير,0,0,1,1
24362,sencillo,0,0,1,1
24363,തടയുവാനായി,0,0,1,1
24364,научного,0,0,1,1
24367,nepbeller,0,0,1,1
24368,generalizations,0,0,1,1
24340,zurückkommen,0,0,1,1
24338,സുഹൃത്തിനെ,0,0,1,1
24307,വിക്കിപീഡിയയിലുണ്ടാകാറുണ്ട്,0,0,1,1
24336,isolées,0,0,1,1
24311,romains,0,0,1,1
24312,unternehmen,0,0,1,1
24313,representante,0,0,1,1
24317,आइसक्रीम,0,0,1,1
24319,അമ്മയല്ലേ,0,0,1,1
24320,exata,0,0,1,1
24322,قيمة,0,0,1,1
24324,समझाते,0,0,1,1
24325,تسأل,0,0,1,1
24327,extraheren,0,0,1,1
24328,poids,0,0,1,1
24329,படுக்கை,0,0,1,1
24331,naïvement,0,0,1,1
24332,följt,0,0,1,1
24334,clearance,0,0,1,1
24371,καταλάβει,0,0,1,1
24373,βεβαιωθείτε,0,0,1,1
24374,العلوي,0,0,1,1
24377,usagers,0,0,1,1
24400,готовности,0,0,1,1
24402,الأكبر،,0,0,1,1
24403,diversité,0,0,1,1
24404,പേജില്,0,0,1,1
24405,لله,0,0,1,1
24406,مقابلة,0,0,1,1
24407,tummarna,0,0,1,1
24409,عنوان,0,0,1,1
24410,referente,0,0,1,1
24411,inadéquation,0,0,1,1
24412,traditioner,0,0,1,1
24414,விரும்புவதாகக்,0,0,1,1
24415,generallyvague,0,0,1,1
24417,popüler,0,0,1,1
24418,çiviyi,0,0,1,1
24398,kvalitetssäkrade,0,0,1,1
24397,tillämpa,0,0,1,1
24396,fotografering,0,0,1,1
24386,dressed,0,0,1,1
24378,версию,0,0,1,1
24379,buradan,0,0,1,1
24380,الميزات,0,0,1,1
24382,quinlan,0,0,1,1
24383,bevisa,0,0,1,1
24385,assimilable,0,0,1,1
24387,kaïkavien,0,0,1,1
24395,gennembrud,0,0,1,1
24389,അവനോടൊപ്പം,0,0,1,1
24390,क्रियोल,0,0,1,1
24391,πάρει,0,0,1,1
24392,stormfuldt,0,0,1,1
24393,αυτού,0,0,1,1
24394,submergée,0,0,1,1
24309,உலகப்,0,0,1,1
24306,koruyabilir,0,0,1,1
24640,ангелом,0,0,1,1
24222,επιχείρηση,0,0,1,1
24226,lavar,0,0,1,1
24228,மூவரும்,0,0,1,1
24230,eerlijk,0,0,1,1
24233,ഇരുവർക്കും,0,0,1,1
24234,caractérise »,0,0,1,1
24235,कीजिय,0,0,1,1
24237,hagamos,0,0,1,1
24238,filarkivet,0,0,1,1
24240,hacían,0,0,1,1
24241,செல்வேன்,0,0,1,1
24242,കാലെടുത്തുവച്ചാൽ,0,0,1,1
24243,sommeil,0,0,1,1
24244,algemene,0,0,1,1
24245,കണ്ടിട്ടുള്ളതിൽ,0,0,1,1
24246,enciende,0,0,1,1
24223,beruhige,0,0,1,1
24221,первых,0,0,1,1
24305,وجبة,0,0,1,1
24220,"
चुवाश",0,0,1,1
24199,indenfor,0,0,1,1
24201,paródias,0,0,1,1
24204,ಒಬ್ಬ,0,0,1,1
24205,освободить,0,0,1,1
24206,mínimo,0,0,1,1
24207,tvivel,0,0,1,1
24208,separar,0,0,1,1
24209,கடந்துவிட்டீர்கள்,0,0,1,1
24211,inhoudelijke,0,0,1,1
24212,« portail »réf,0,0,1,1
24213,verifiable,0,0,1,1
24215,മെച്ചപ്പെടുത്തുവാനും,0,0,1,1
24217,आपजानते,0,0,1,1
24218,soulevée,0,0,1,1
24219,ശരിയാണ്,0,0,1,1
24247,featuring,0,0,1,1
24248,"
लिगुरियाई",0,0,1,1
24249,திட்டவடிவம்,0,0,1,1
24250,iphoneenheter,0,0,1,1
24283,şeyden,0,0,1,1
24284,arbitraje,0,0,1,1
24285,deformed,0,0,1,1
24286,замечательно,0,0,1,1
24287,நினைக்கிறாய்,0,0,1,1
24294,"
इलोकानो",0,0,1,1
24295,falsidades,0,0,1,1
24296,semiprotegidas,0,0,1,1
24297,τεράστιου,0,0,1,1
24298,acredito,0,0,1,1
24299,الخلوي؟,0,0,1,1
24300,einstellen,0,0,1,1
24302,amador,0,0,1,1
24303,مزحة,0,0,1,1
24304,« reconnaître,0,0,1,1
24282,കൃത്യതയെ,0,0,1,1
24279,للناس,0,0,1,1
24278,செல்போனைப்,0,0,1,1
24262,controlled,0,0,1,1
24254,pretende,0,0,1,1
24255,नवम्बर,0,0,1,1
24256,супе,0,0,1,1
24257,പ്രതിപാദനത്തെയും,0,0,1,1
24259,lejos,0,0,1,1
24260,возражаешь,0,0,1,1
24263,مصداقيتها,0,0,1,1
24277,أطلقت,0,0,1,1
24265,çabası,0,0,1,1
24266,zil,0,0,1,1
24269,peaked,0,0,1,1
24270,некоторое,0,0,1,1
24272,wwe,0,0,1,1
24273,possibility,0,0,1,1
24419,tryckta,0,0,1,1
24420,என்பதே,0,0,1,1
24421,முன்,0,0,1,1
24557,нарцисе,0,0,1,1
24559,colaboradores—,0,0,1,1
24561,സങ്കേതത്തിൽ,0,0,1,1
24562,वक्ताओं,0,0,1,1
24563,юнлэ,0,0,1,1
24564,αναφοράς,0,0,1,1
24565,وغمز,0,0,1,1
24566,pérennité,0,0,1,1
24567,умный,0,0,1,1
24568,şans,0,0,1,1
24570,रोका,0,0,1,1
24572,îlesréf,0,0,1,1
24573,dammit,0,0,1,1
24575,χρησιμοποιημένη,0,0,1,1
24576,मददगार,0,0,1,1
24577,landsby,0,0,1,1
24558,पिज्जा,0,0,1,1
24556,resten,0,0,1,1
24423,behaviour,0,0,1,1
24555,обозначен,0,0,1,1
24529,ಅಳಲು,0,0,1,1
24531,fjortonde,0,0,1,1
24536,പഠിച്ചു,0,0,1,1
24537,angive,0,0,1,1
24538,arena,0,0,1,1
24540,ಯೋಚಿಸೋಣ,0,0,1,1
24541,oyla,0,0,1,1
24543,acımasızca,0,0,1,1
24544,inexperientes,0,0,1,1
24545,посадить,0,0,1,1
24546,മകൾ,0,0,1,1
24547,previsões,0,0,1,1
24548,raisonnement,0,0,1,1
24549,bénéfice,0,0,1,1
24551,anadili,0,0,1,1
24578,zenginlik,0,0,1,1
24580,يتجاوز,0,0,1,1
24581,rendimiento,0,0,1,1
24582,autorisé,0,0,1,1
24619,സാമ്യതയുള്ളവയെ,0,0,1,1
24620,goudbrood,0,0,1,1
24621,discussieforum,0,0,1,1
24624,चिंतित,0,0,1,1
24625,bercezvous,0,0,1,1
24628,keen,0,0,1,1
24629,sveriges,0,0,1,1
24630,bahsetmediniz,0,0,1,1
24632,"
यूक्रेनी",0,0,1,1
24633,ദേഷ്യപ്പെട്ടതുപോലെയാണെന്ന്,0,0,1,1
24634,kvalitestsbrister,0,0,1,1
24636,carbonandwaterbased,0,0,1,1
24637,currency,0,0,1,1
24638,cliquer,0,0,1,1
24639,deixou,0,0,1,1
24618,столлмана,0,0,1,1
24616,सर्चिंग,0,0,1,1
24610,историография,0,0,1,1
24594,απαντήσω,0,0,1,1
24583,जानता,0,0,1,1
24585,вошло,0,0,1,1
24586,متاحة,0,0,1,1
24590,والتنسيق,0,0,1,1
24592,cybersécurité,0,0,1,1
24593,regelmatig,0,0,1,1
24598,multiagent,0,0,1,1
24609,difíciles,0,0,1,1
24599,överanvändt,0,0,1,1
24601,battleground,0,0,1,1
24603,opslagcapaciteit,0,0,1,1
24604,utrolige,0,0,1,1
24605,herbert,0,0,1,1
24607,bry,0,0,1,1
24528,λεκτικό,0,0,1,1
24526,inducción,0,0,1,1
24525,உதவிக்கு,0,0,1,1
24470,timen,0,0,1,1
24450,للإنجليزية,0,0,1,1
24451,licenciado,0,0,1,1
24452,aanzet,0,0,1,1
24454,பயனுள்ள,0,0,1,1
24455,κωδικό,0,0,1,1
24456,كبد,0,0,1,1
24459,adaptée,0,0,1,1
24460,வென்றது,0,0,1,1
24461,ഭക്ഷണവും,0,0,1,1
24462,ht •,0,0,1,1
24463,gerçekleşir,0,0,1,1
24464,يتحرك,0,0,1,1
24465,sunulması,0,0,1,1
24467,αναγράφεται,0,0,1,1
24468,الكلمة؟,0,0,1,1
24449,потерпи,0,0,1,1
24448,regardèrent,0,0,1,1
24447,nere,0,0,1,1
24434,बताएंगे,0,0,1,1
24424,uiterlijk,0,0,1,1
24425,sociólogos,0,0,1,1
24427,العلماء،,0,0,1,1
24428,fixa,0,0,1,1
24430,marquées,0,0,1,1
24431,förhandsgranskning,0,0,1,1
24436,relationer,0,0,1,1
24446,marcando,0,0,1,1
24437,οικουμενικής,0,0,1,1
24440,améliorait,0,0,1,1
24442,gehouden,0,0,1,1
24443,yakın,0,0,1,1
24444,നിസാര,0,0,1,1
24445,haberlerde,0,0,1,1
24469,mapean,0,0,1,1
24472,documentário,0,0,1,1
24524,plåga,0,0,1,1
24473,роду,0,0,1,1
24501,soleil ,0,0,1,1
24502,तस्वीरें,0,0,1,1
24503,riding,0,0,1,1
24507,ತಪ್ಪಿಸುವುದು,0,0,1,1
24509,избегая,0,0,1,1
24510,min •,0,0,1,1
24511,المساعد,0,0,1,1
24515,bloggers,0,0,1,1
24516,ನಲ್ಲಿದ್ದೇನೆ,0,0,1,1
24517,ആരംഭിക്കുന്നത്,0,0,1,1
24518,negativos,0,0,1,1
24519,"
बोस्नियाई",0,0,1,1
24521,hurricanes,0,0,1,1
24522,قرّر,0,0,1,1
24523,ತಯಾರಿಸಲಾಗುತ್ತದೆ,0,0,1,1
24500,ಮನೆಕೆಲಸವನ್ನು,0,0,1,1
24498,ಹೇಳಿದ್ದು,0,0,1,1
24497,infeliz,0,0,1,1
24482,предварительной,0,0,1,1
24474,грубо,0,0,1,1
24475,taal,0,0,1,1
24476,считала,0,0,1,1
24479,பாராட்டுகிறேன்,0,0,1,1
24480,केस,0,0,1,1
24481,publier,0,0,1,1
24483,hjørnet,0,0,1,1
24496,சூழலில்,0,0,1,1
24489,लीजिए,0,0,1,1
24490,സിനിമ,0,0,1,1
24491,excités,0,0,1,1
24493,दोष,0,0,1,1
24494,ஆசிரியர்,0,0,1,1
24495,banqueiro,0,0,1,1
25132,hurtigt,0,0,1,1
25133,kelimedir,0,0,1,1
25134,yönergesi,0,0,1,1
25747,finden,0,0,1,1
25750,polysémie,0,0,1,1
25752,politikalarından,0,0,1,1
25753,direta,0,0,1,1
25754,لعقد,0,0,1,1
25755,ഉപയോഗപ്രദവുമായ,0,0,1,1
25756,‘அண்மைய,0,0,1,1
25758,gelassen,0,0,1,1
25759,restées,0,0,1,1
25761,मशीनों,0,0,1,1
25763,уровне,0,0,1,1
25764,baffling,0,0,1,1
25767,spécificité,0,0,1,1
25768,заносят,0,0,1,1
25769,dk,0,0,1,1
25770,இழக்கப்பட்ட,0,0,1,1
25749,misterioso,0,0,1,1
25746,ميلًا,0,0,1,1
25715,ആണിക്കല്ലായി,0,0,1,1
25742,dije,0,0,1,1
25718,tatlım,0,0,1,1
25719,अडिग,0,0,1,1
25720,والصينية،,0,0,1,1
25721,தமது,0,0,1,1
25722,collaboratively,0,0,1,1
25724,consulting,0,0,1,1
25729,другого,0,0,1,1
25730,rubíes,0,0,1,1
25731,ഉപയോഗിക്കാത്തതെന്താണ്,0,0,1,1
25733,योजनायें,0,0,1,1
25737,والنزاعات,0,0,1,1
25738,расстроены,0,0,1,1
25739,"w
अज़रबैजानी",0,0,1,1
25740,धोने,0,0,1,1
25741,മറക്കുന്നു,0,0,1,1
25772,permaneció,0,0,1,1
25775,relations,0,0,1,1
25776,lendo,0,0,1,1
25778,améliorations,0,0,1,1
25809,émergente,0,0,1,1
25810,perú,0,0,1,1
25811,βρωμιά,0,0,1,1
25812,കൈവരിക്കാൻ,0,0,1,1
25813,otte,0,0,1,1
25814,troepen,0,0,1,1
25816,ξεκίνησε,0,0,1,1
25817,multitudinaria,0,0,1,1
25818,fill,0,0,1,1
25820,आलोचना,0,0,1,1
25821,разрушительных,0,0,1,1
25822,merged,0,0,1,1
25824,« dépassé,0,0,1,1
25825,தெரிவிப்பதன்,0,0,1,1
25826,adolescents,0,0,1,1
25807,demanda,0,0,1,1
25806,والخوادم,0,0,1,1
25805,rapportés,0,0,1,1
25787,leída,0,0,1,1
25779,يعد,0,0,1,1
25780,memcached,0,0,1,1
25781,redactado,0,0,1,1
25782,feks,0,0,1,1
25783,känna,0,0,1,1
25786,visuel,0,0,1,1
25789,بمقابلتك,0,0,1,1
25799,préadolescente,0,0,1,1
25790,സിനിമകൾക്കായി,0,0,1,1
25792,eneste,0,0,1,1
25793,afgewezen,0,0,1,1
25794,தொகுக்கக்கூடியவாறு,0,0,1,1
25796,noticeable,0,0,1,1
25798,yemeye,0,0,1,1
25717,அழுகிறார்கள்,0,0,1,1
25713,देशी,0,0,1,1
25592,laureada,0,0,1,1
25622,recusado,0,0,1,1
25626,« significative,0,0,1,1
25627,предложил,0,0,1,1
25628,وتمت,0,0,1,1
25629,للكتب,0,0,1,1
25631, الويكيبيديا,0,0,1,1
25632,ahnung,0,0,1,1
25633,ποιες,0,0,1,1
25636,solicitan,0,0,1,1
25637,أريكتك,0,0,1,1
25638,πλημμύρα,0,0,1,1
25639,denkt,0,0,1,1
25640,أربكتك,0,0,1,1
25641,யோங்களே,0,0,1,1
25643,"
luxemburguês",0,0,1,1
25644,здравоохранении,0,0,1,1
25624,réciproquement,0,0,1,1
25621,generality,0,0,1,1
25710,شخصية,0,0,1,1
25619,marié,0,0,1,1
25595,diversified,0,0,1,1
25597,miraron,0,0,1,1
25598,заданиями,0,0,1,1
25601,fotorrealista,0,0,1,1
25602,prisonniers,0,0,1,1
25603,söyleyen,0,0,1,1
25605,talere,0,0,1,1
25608,الجنود,0,0,1,1
25609,l’intervention,0,0,1,1
25610,chevrontexaco,0,0,1,1
25611,spaarnestad,0,0,1,1
25613,interpretações,0,0,1,1
25614,zeros,0,0,1,1
25615,بالعرض,0,0,1,1
25616,விக்கிப்பீடியாவிற்கும்,0,0,1,1
25645,допустим,0,0,1,1
25647,ಎನ್,0,0,1,1
25648,ಅರಿತುಕೊಳ್ಳಬೇಕಾದ,0,0,1,1
25650,எங்களுடன்,0,0,1,1
25684,enciclopédicamente,0,0,1,1
25685,अनुदान,0,0,1,1
25687,poderá,0,0,1,1
25690,buluşmaya,0,0,1,1
25691,barnskyddslagstiftning,0,0,1,1
25693,выглядишь,0,0,1,1
25694,coffee,0,0,1,1
25696,vermek,0,0,1,1
25697,избранных,0,0,1,1
25698,ಮೊಂಡಾದದ್ದನ್ನು,0,0,1,1
25699,kasteel,0,0,1,1
25701,оценено,0,0,1,1
25703,évoluent,0,0,1,1
25705,  lecteurs,0,0,1,1
25708,നല്ലതെന്ന്,0,0,1,1
25683,preassigned,0,0,1,1
25681,നമ്മുടെ,0,0,1,1
25680,кластеров,0,0,1,1
25664,नान,0,0,1,1
25651,testigos,0,0,1,1
25656,lentes,0,0,1,1
25657,μόνιμα,0,0,1,1
25659,tocante,0,0,1,1
25661,theorists,0,0,1,1
25663,αιώνες,0,0,1,1
25665,siyasi,0,0,1,1
25677,مسؤولة,0,0,1,1
25667,ಅವ್ಯವಸ್ಥೆಯಲ್ಲಿದ್ದೇನೆ,0,0,1,1
25668,பயனர்களை,0,0,1,1
25669,importarme,0,0,1,1
25672,globala,0,0,1,1
25674,controvertidos,0,0,1,1
25676,вижу,0,0,1,1
25827,caísse,0,0,1,1
25828,சரிசெய்தல்,0,0,1,1
25833,snabb,0,0,1,1
26006,अन्डू,0,0,1,1
26008,المعرفة,0,0,1,1
26010,obteniez,0,0,1,1
26011,considerarla,0,0,1,1
26012,വെച്ച്,0,0,1,1
26013,görüşme,0,0,1,1
26014,sorrisos,0,0,1,1
26015,تحقق,0,0,1,1
26016,എഴുതപ്പെടുന്നത്,0,0,1,1
26017,والأفضل,0,0,1,1
26018,arkiverade,0,0,1,1
26020,നന്നായിരിക്കും,0,0,1,1
26021,مجتمعية,0,0,1,1
26022,fineste,0,0,1,1
26023,annesiyle,0,0,1,1
26024,siderian,0,0,1,1
26007,värdelöst,0,0,1,1
26004,ήρθα,0,0,1,1
25834,شرح,0,0,1,1
26003,स्पार्कली,0,0,1,1
25981,передаёт,0,0,1,1
25982,تكرار,0,0,1,1
25983,çalışıyordu,0,0,1,1
25986,sensibles,0,0,1,1
25987,दबाकर,0,0,1,1
25989,levé,0,0,1,1
25991,συναρπαστικό,0,0,1,1
25992,تجربتهم,0,0,1,1
25993,maind,0,0,1,1
25994,omfattas,0,0,1,1
25995,necessidade,0,0,1,1
25996,felaktiga,0,0,1,1
25998,arasında,0,0,1,1
25999,αναζήτηση,0,0,1,1
26000,indépendant,0,0,1,1
26025,possuindo,0,0,1,1
26026,ключевыми,0,0,1,1
26028,движок,0,0,1,1
26029,equation,0,0,1,1
26064,издателями,0,0,1,1
26065,inclining,0,0,1,1
26066,placozoans—animals,0,0,1,1
26067,латинские,0,0,1,1
26068,laundry,0,0,1,1
26069,redigerare,0,0,1,1
26070,أعطت,0,0,1,1
26071,súper,0,0,1,1
26072,sujeitas,0,0,1,1
26073,tentant,0,0,1,1
26074,بالنسخة,0,0,1,1
26077,stoten,0,0,1,1
26078,παζλ,0,0,1,1
26079,عقولنا,0,0,1,1
26080,accumulation,0,0,1,1
26061,« bots »,0,0,1,1
26060,pratiquezla,0,0,1,1
26058,yaptığınızı,0,0,1,1
26041,улиток,0,0,1,1
26032,metoderna,0,0,1,1
26033,ಆಟವನ್ನು,0,0,1,1
26034,encontre,0,0,1,1
26035,हटा,0,0,1,1
26036,baserade,0,0,1,1
26038,εξετάσεις,0,0,1,1
26044,"

",0,0,1,1
26057,licenciés,0,0,1,1
26045,realizou,0,0,1,1
26046,källförteckningens,0,0,1,1
26050,εθνικοτήτων,0,0,1,1
26052,പലപ്പൊഴും,0,0,1,1
26053,δυσκολία,0,0,1,1
26054,ஜோசப்,0,0,1,1
25979,മടുപ്പില്ല,0,0,1,1
25978,fixés,0,0,1,1
25977,spridning,0,0,1,1
25910,துவக்கல்,0,0,1,1
25876,जोर,0,0,1,1
25877,ಅದರಿಂದ,0,0,1,1
25880,फीचर्ड,0,0,1,1
25881,vivas,0,0,1,1
25884,émeraudes,0,0,1,1
25889,गरीब,0,0,1,1
25890,pisa,0,0,1,1
25891,ಮಾಲ್‌ನಲ್ಲಿ,0,0,1,1
25894,الملكية,0,0,1,1
25896,ನನ್ನೊಂದಿಗೆ,0,0,1,1
25898,تحتل,0,0,1,1
25901,சென்றார்கள்,0,0,1,1
25904,retención,0,0,1,1
25905,гибкая,0,0,1,1
25906,wikiversidad,0,0,1,1
25873,дитя,0,0,1,1
25868,uitsluitend,0,0,1,1
25867,കുറവല്ല,0,0,1,1
25845,piadas,0,0,1,1
25835,высокого,0,0,1,1
25836,intimate,0,0,1,1
25839,الممر,0,0,1,1
25840,secondes,0,0,1,1
25841,ഏറെയുണ്ടാകുന്നതുകൊണ്ടുള്ള,0,0,1,1
25844,kanada,0,0,1,1
25849,verbum,0,0,1,1
25866,வாழ்வாள்,0,0,1,1
25850,unhappy,0,0,1,1
25853,لوفلاند,0,0,1,1
25854,какимто,0,0,1,1
25857,ಶುಕ್ರವಾರ,0,0,1,1
25862,representatividad,0,0,1,1
25863,പത്തുവാചകം,0,0,1,1
25909,tissues,0,0,1,1
25912,snabbheten,0,0,1,1
25975,تقدمها,0,0,1,1
25913,rundad,0,0,1,1
25943,remind,0,0,1,1
25945,सिटिज़नडियम,0,0,1,1
25946,تكريم,0,0,1,1
25950,ഡച്ച്,0,0,1,1
25956,നിയന്ത്രിക്കുന്നത്,0,0,1,1
25957,устаю,0,0,1,1
25958,ولو,0,0,1,1
25962,¿tiene,0,0,1,1
25963,വിക്കിപീഡിയർക്ക്,0,0,1,1
25964,yarayacağını,0,0,1,1
25967,"sciences ·
പരിതഃസ്ഥിതിക",0,0,1,1
25968,различия,0,0,1,1
25969,verme,0,0,1,1
25971,pratiques »,0,0,1,1
25974,forestation,0,0,1,1
25941,tí,0,0,1,1
25940,लागत,0,0,1,1
25939,eenieder,0,0,1,1
25921,ιδεολογιών,0,0,1,1
25915,ಮರೆತುಹೋಗುತ್ತಾನೆ,0,0,1,1
25916,exactitude,0,0,1,1
25917,transformée,0,0,1,1
25918,الإداريين,0,0,1,1
25919,planerat,0,0,1,1
25920,intersidéral,0,0,1,1
25922,भूतपूर्व,0,0,1,1
25938,нашу,0,0,1,1
25924,görüşleriniz,0,0,1,1
25925,മെലിസ,0,0,1,1
25928,konuşuyordu,0,0,1,1
25931,விக்கிப்பீடியாவுக்கு,0,0,1,1
25932,பாதுகாக்கப்படுகின்றன,0,0,1,1
25933,drömde,0,0,1,1
25594,internet ,0,0,1,1
25591,inhuren,0,0,1,1
25135,cassation,0,0,1,1
25271,"
यूनानी",0,0,1,1
25274,kanala,0,0,1,1
25276,ಡ್ರಿಂಕ್‌ನೊಂದಿಗೆ,0,0,1,1
25277,pierres,0,0,1,1
25278,antérieurs,0,0,1,1
25280,tillit,0,0,1,1
25281,समितियां,0,0,1,1
25282,συγκεντρώνονται,0,0,1,1
25285,الخطط,0,0,1,1
25286,thorough,0,0,1,1
25287,applikationer,0,0,1,1
25289,പ്രണേതാവായ,0,0,1,1
25290,hawaïen,0,0,1,1
25293,парламентский,0,0,1,1
25294,الخاطئة,0,0,1,1
25296,altan,0,0,1,1
25273,uniform,0,0,1,1
25267,wetenschappers,0,0,1,1
25243,जाएगा,0,0,1,1
25266,ഇന്റർനെറ്റിലും,0,0,1,1
25245,trompez,0,0,1,1
25246,اجمع,0,0,1,1
25247,प्रश्नों,0,0,1,1
25248,വൃത്തികെട്ട,0,0,1,1
25249,تفكر,0,0,1,1
25252,fågel,0,0,1,1
25253,சேனலான,0,0,1,1
25254,nouns,0,0,1,1
25255,convención,0,0,1,1
25257,വലുതുമായ,0,0,1,1
25259,சிறைச்சாலைகளில்,0,0,1,1
25260,இயங்குகிறது,0,0,1,1
25261,உற்சாகப்படுத்துங்கள்,0,0,1,1
25262,censureringar,0,0,1,1
25263,специального,0,0,1,1
25298,engagé,0,0,1,1
25299,försök,0,0,1,1
25300,​​te,0,0,1,1
25301,மாதங்கள்,0,0,1,1
25330,ಅತ್ಯಾಚಾರ,0,0,1,1
25332,cheers,0,0,1,1
25333,mensageiro,0,0,1,1
25334,சாங்கரையேச்,0,0,1,1
25336,relatar,0,0,1,1
25337,просьбу,0,0,1,1
25338,tremendously,0,0,1,1
25339,कठिन,0,0,1,1
25340,studerar,0,0,1,1
25341,ഗേറ്റ്സിന്റെ,0,0,1,1
25342,proportions,0,0,1,1
25344,encombrants,0,0,1,1
25346,கவலைப்படாதே,0,0,1,1
25348,നിർമ്മിച്ചിരിക്കുന്നത്,0,0,1,1
25349,anonymes,0,0,1,1
25329,süslü,0,0,1,1
25327,voluntarily,0,0,1,1
25324,اشتروه,0,0,1,1
25313,والتشخيص,0,0,1,1
25303,संदर्भित,0,0,1,1
25305,smagseksempel,0,0,1,1
25306,nontrivial,0,0,1,1
25308,experiences,0,0,1,1
25309,enkätundersökningen,0,0,1,1
25311,பிரித்தானிக்கா,0,0,1,1
25314,varsin,0,0,1,1
25322,jours »,0,0,1,1
25315,வழிமுறையாகும்,0,0,1,1
25316,നഗരത്തിലെ,0,0,1,1
25317,വിറ്റതായി,0,0,1,1
25319,adding,0,0,1,1
25320,செய்யப்பட்டன,0,0,1,1
25321,kutsche,0,0,1,1
25244,ದಿನನಿತ್ಯದ,0,0,1,1
25241,exibição,0,0,1,1
25590,complicada,0,0,1,1
25159,grekiskans,0,0,1,1
25161,archean,0,0,1,1
25162,ആർട്ടിഫിഷ്യൽ,0,0,1,1
25163,الحلوة,0,0,1,1
25165,നാർസിസയുടെ,0,0,1,1
25166,تفعله,0,0,1,1
25167,"
प्रत्येक",0,0,1,1
25168,ಒನ್,0,0,1,1
25169,சீரான,0,0,1,1
25171,बचना।,0,0,1,1
25174,संभालते,0,0,1,1
25175,gewesen,0,0,1,1
25178,അതുമായി,0,0,1,1
25179,passetil,0,0,1,1
25181,aboutit,0,0,1,1
25182,«символом,0,0,1,1
25160,conduct,0,0,1,1
25158,mıyım,0,0,1,1
25239,സൗന്ദര്യവും,0,0,1,1
25157,réglé,0,0,1,1
25137,sowieso,0,0,1,1
25138,beschreef,0,0,1,1
25141,ക്ലാസ്സിൽ,0,0,1,1
25142,introducen,0,0,1,1
25143,outliers,0,0,1,1
25144,ಪಿಜ್ಜಾ,0,0,1,1
25145,doy,0,0,1,1
25146,silberbrot,0,0,1,1
25147,escuchaste,0,0,1,1
25148,complet,0,0,1,1
25149,dehors,0,0,1,1
25150,traversing,0,0,1,1
25151,утверждают,0,0,1,1
25154,merit,0,0,1,1
25156,свободного,0,0,1,1
25184,anatomy,0,0,1,1
25186,autónoma,0,0,1,1
25187,حيرة,0,0,1,1
25190,betraktades,0,0,1,1
25219,uitlegde,0,0,1,1
25220,perfectionnement,0,0,1,1
25221,ترفض,0,0,1,1
25222,bebek,0,0,1,1
25223,ಹಿಸಿದ್ದೇನೆ,0,0,1,1
25224,മുതലുള്ള,0,0,1,1
25226,haphazard,0,0,1,1
25227,vapeur,0,0,1,1
25228,"
irlandês",0,0,1,1
25230,കാമുകനോ,0,0,1,1
25233,പറഞ്ഞുകൊണ്ട്,0,0,1,1
25234,relicenciar,0,0,1,1
25235,بالمقارنة،,0,0,1,1
25237,opdateringen,0,0,1,1
25238,പരിഗണനയും,0,0,1,1
25218,demektir,0,0,1,1
25217,ловушки,0,0,1,1
25215,derude,0,0,1,1
25205,fallstudie,0,0,1,1
25192,konuşuyordun,0,0,1,1
25193,бесплатно,0,0,1,1
25194,ಕೊಳಕು,0,0,1,1
25197,ബഹുപദമായിരിക്കണോ,0,0,1,1
25198,accepter,0,0,1,1
25200,blogs,0,0,1,1
25206,എഴുതിവെക്കുന്നതും,0,0,1,1
25214,பதிலாகத்,0,0,1,1
25207,ತಿನ್ನಬೇಕು,0,0,1,1
25208,decorum,0,0,1,1
25209,propensas,0,0,1,1
25211,рост,0,0,1,1
25212,надёжности,0,0,1,1
25213,plausible,0,0,1,1
25350,интересуют,0,0,1,1
25351,analogisme,0,0,1,1
25352,زفافي,0,0,1,1
25505,restringidas,0,0,1,1
25508,hänt,0,0,1,1
25509,nonfiction,0,0,1,1
25511,صعبًا,0,0,1,1
25512,"है।
कुछ",0,0,1,1
25513,رقيقة,0,0,1,1
25516,വിശേഷം,0,0,1,1
25517,sedento,0,0,1,1
25518,обсерватории»,0,0,1,1
25519,decía,0,0,1,1
25520,автоматизированный,0,0,1,1
25521,ज़रा,0,0,1,1
25522,ब्रेकेट,0,0,1,1
25523,signpost,0,0,1,1
25524,reklamsız,0,0,1,1
25525,correcta,0,0,1,1
25507,ilimitado,0,0,1,1
25502,начаты,0,0,1,1
25353,ദൂതനോടും,0,0,1,1
25500,sixthmostused,0,0,1,1
25474,personnellement,0,0,1,1
25477,caters,0,0,1,1
25480,played,0,0,1,1
25481,ತನ್ನನ್ನು,0,0,1,1
25482,الإعلامية,0,0,1,1
25483,circuler,0,0,1,1
25485,посвящён,0,0,1,1
25487,yunan,0,0,1,1
25488,« éducation »,0,0,1,1
25490,controvertidos​,0,0,1,1
25491,lieblich,0,0,1,1
25493,antigas,0,0,1,1
25494,hatam,0,0,1,1
25495,chien,0,0,1,1
25496,samlas,0,0,1,1
25527,deductieve,0,0,1,1
25529,oğlum,0,0,1,1
25531,¿pueden,0,0,1,1
25532,simgesi,0,0,1,1
25559,ஒன்றாகும்,0,0,1,1
25560,vindo,0,0,1,1
25562,jämnt,0,0,1,1
25563,détection,0,0,1,1
25564,llega,0,0,1,1
25565,редакторы,0,0,1,1
25567,blockeringar,0,0,1,1
25572,ankam,0,0,1,1
25574,mehlmädchen,0,0,1,1
25575,fusion,0,0,1,1
25577,நுழைந்தார்கள்,0,0,1,1
25579,cenas,0,0,1,1
25580,sentado,0,0,1,1
25582,« exemple,0,0,1,1
25586,yapıldığı,0,0,1,1
25558,spiegel,0,0,1,1
25556,وحتى,0,0,1,1
25555,सच्चाई,0,0,1,1
25541,تنافسية,0,0,1,1
25534,batırdım,0,0,1,1
25535,vlees,0,0,1,1
25537,faça,0,0,1,1
25538,elevate,0,0,1,1
25539,endereço,0,0,1,1
25540,contenha,0,0,1,1
25542,интеллекта,0,0,1,1
25553,concierto,0,0,1,1
25545,அப்பால்,0,0,1,1
25546,söylüyorsun,0,0,1,1
25547,améliorer »,0,0,1,1
25550,താരതമ്യേന,0,0,1,1
25551,മനസാണ്,0,0,1,1
25552,respectueux,0,0,1,1
25473,leert,0,0,1,1
25471,ويبكي,0,0,1,1
25468,ίσχυαν,0,0,1,1
25417,journalistiques,0,0,1,1
25391,الآخرين،,0,0,1,1
25392,hilfe,0,0,1,1
25393,സംരംഭം,0,0,1,1
25394,തിരഞ്ഞെടുപ്പുകളെക്കുറിച്ച്,0,0,1,1
25395,شكر,0,0,1,1
25398,ajuster,0,0,1,1
25399,δευτερόλεπτο,0,0,1,1
25400,поддельному,0,0,1,1
25402,görünecek,0,0,1,1
25403,ತೀಕ್ಷ್ಣವಾಗಿ,0,0,1,1
25404,lowquality,0,0,1,1
25408,жёстких,0,0,1,1
25409,طبيعية,0,0,1,1
25411,tendo,0,0,1,1
25412,പഠിക്കാൻ,0,0,1,1
25390,medium,0,0,1,1
25388,"
tâmil",0,0,1,1
25385,க்குச்,0,0,1,1
25364,തുടരുകയാണെങ്കിൽ,0,0,1,1
25356,horrific,0,0,1,1
25357,klottraren,0,0,1,1
25358,accélération,0,0,1,1
25359,kızmışım,0,0,1,1
25360,medewerker,0,0,1,1
25362,prompts,0,0,1,1
25366,retrata,0,0,1,1
25383,تجاوزت,0,0,1,1
25367,حدد,0,0,1,1
25369,описываются,0,0,1,1
25371,ದೇವದೂತನಂತೆ,0,0,1,1
25373,أستطع,0,0,1,1
25375,ഇന്റർപീഡിയ,0,0,1,1
25381,употребляемое,0,0,1,1
25415,cto,0,0,1,1
25421,usergenerated,0,0,1,1
25467,تشاهدون,0,0,1,1
25425,телефоном,0,0,1,1
25446,корни,0,0,1,1
25447,विरोधाभासी,0,0,1,1
25448,സൗകര്യപ്രദമാണ്,0,0,1,1
25451,ಹೋಗುತ್ತೇವೆ,0,0,1,1
25452,struggled,0,0,1,1
25454,കൂട്ടങ്ങളായി,0,0,1,1
25455,रहो।,0,0,1,1
25456,evaluate,0,0,1,1
25457,придумал,0,0,1,1
25459,vue »,0,0,1,1
25460,cierta,0,0,1,1
25462,afficher,0,0,1,1
25464,ಕೆಟ್ಟ,0,0,1,1
25465,menina,0,0,1,1
25466,யூகிக்கிறீர்கள்,0,0,1,1
25445,ಉಡುಗೆ,0,0,1,1
25444,ejecutarían,0,0,1,1
25443,उठाने,0,0,1,1
25432,gidemezsiniz,0,0,1,1
25426,ehrlich,0,0,1,1
25427,десяти,0,0,1,1
25428,protestar,0,0,1,1
25429,contribué,0,0,1,1
25430,perdi,0,0,1,1
25431,வருகிறது,0,0,1,1
25433,dull,0,0,1,1
25442,yapabilirim,0,0,1,1
25434,μήνες,0,0,1,1
25435,"വാൻഡലിസം
വരുന്നത്",0,0,1,1
25436,—deliberadamente,0,0,1,1
25437,मानने,0,0,1,1
25439,വിക്കിപീഡിയർക്കോ,0,0,1,1
25441,genaamd,0,0,1,1
24195,приложенийисточник,0,0,1,1
24192,സമസ്ത,0,0,1,1
22360,frankreich,0,0,1,1
22966,உள்ளடக்கங்களும்,0,0,1,1
22968,للبرنامج,0,0,1,1
22969,intelligentie,0,0,1,1
22970,mg •,0,0,1,1
22972,поиске,0,0,1,1
22973,adoptó,0,0,1,1
22975,ступит,0,0,1,1
22977,fåtal,0,0,1,1
22978,nonwhite,0,0,1,1
22979,بالخوف,0,0,1,1
22980,revertingreverted,0,0,1,1
22981,concentrerait,0,0,1,1
22982,उठा,0,0,1,1
22983,wedstrijd,0,0,1,1
22984,cine,0,0,1,1
22985,എന്തുപറയുന്നു,0,0,1,1
22967,بمقدار,0,0,1,1
22965,காவியத்தைப்,0,0,1,1
22934,إنشاؤها,0,0,1,1
22963,ramen,0,0,1,1
22938,samesex,0,0,1,1
22939,दावे,0,0,1,1
22941,относился,0,0,1,1
22942,ಶುಕ್ರವಾರವಾಗಿದ್ದರೆ,0,0,1,1
22945,reinvention,0,0,1,1
22946,programspråket,0,0,1,1
22947,locura,0,0,1,1
22948,jugée,0,0,1,1
22950,inrikesdepartementets,0,0,1,1
22954,способный,0,0,1,1
22956,haberleri,0,0,1,1
22957,capitalistas,0,0,1,1
22958,பேசும்,0,0,1,1
22959,പങ്ക്,0,0,1,1
22962,«очень,0,0,1,1
22987,klasik,0,0,1,1
22988,നൽകാം,0,0,1,1
22989,regarda,0,0,1,1
22990,существами,0,0,1,1
23023,வேண்டியதெல்லாம்,0,0,1,1
23027,खींचें।,0,0,1,1
23028,aprendi,0,0,1,1
23029,статуса»,0,0,1,1
23030,tilfældigvis,0,0,1,1
23031,bok,0,0,1,1
23032,ചോദ്യങ്ങൾക്ക്,0,0,1,1
23034,schneckenbeispiel,0,0,1,1
23036,динамику,0,0,1,1
23037,hoşgörü,0,0,1,1
23038,அமைந்துள்ளது,0,0,1,1
23041,سعيدا,0,0,1,1
23043,leicht,0,0,1,1
23044,مسح,0,0,1,1
23046,approved,0,0,1,1
23022,وفَر,0,0,1,1
23021,yemelisin,0,0,1,1
23020,gagné,0,0,1,1
23003,dormindo,0,0,1,1
22993,hissediyorum,0,0,1,1
22994,süslenmişti,0,0,1,1
22995,"
अप्रैल",0,0,1,1
22996,persons,0,0,1,1
22999,продвижения,0,0,1,1
23000,செப்டம்பர்,0,0,1,1
23004,perfecte,0,0,1,1
23018,பெயர்ச்சொல்லாக,0,0,1,1
23005,ülkenin,0,0,1,1
23009,разрешён,0,0,1,1
23010,ചുറ്റും,0,0,1,1
23014,مجتمعة,0,0,1,1
23015,भागीदारी,0,0,1,1
23017,saturn,0,0,1,1
22935,وقتًا,0,0,1,1
22933,कार्यालय,0,0,1,1
23048,equivocadas,0,0,1,1
22843,डच,0,0,1,1
22845,kommentarfeltet,0,0,1,1
22847,givet,0,0,1,1
22850,காரணமாகும்,0,0,1,1
22851,أشارت,0,0,1,1
22852,авторства,0,0,1,1
22853,otimização,0,0,1,1
22855,backen,0,0,1,1
22856,дайтека,0,0,1,1
22857,கிளாஸ்,0,0,1,1
22858,authorities,0,0,1,1
22859,maratones,0,0,1,1
22861,الطعن,0,0,1,1
22862,ಹಾಯಿಸಿದರು,0,0,1,1
22863,απαραίτητοι,0,0,1,1
22864,счастлив,0,0,1,1
22844,истории,0,0,1,1
22841,automobile,0,0,1,1
22931,വെയിൽ‌സ്,0,0,1,1
22839,усилие,0,0,1,1
22816,والإسبانية,0,0,1,1
22817,മാർഗ്ഗമാണ്,0,0,1,1
22818,സന്നദ്ധനാണ്,0,0,1,1
22823,अवार्ड,0,0,1,1
22824,പറയാനാകുമോ,0,0,1,1
22825,ധർമ്മസങ്കടമുള്ള,0,0,1,1
22826,olhares,0,0,1,1
22827,несвободные,0,0,1,1
22829,vitória,0,0,1,1
22831,absurdas,0,0,1,1
22832,aprèsmidi,0,0,1,1
22834,ஆச்சரியப்படுகிறீர்கள்,0,0,1,1
22835,விளம்பரங்களைக்,0,0,1,1
22836,consistência,0,0,1,1
22837,ಮಾಡಿಲ್ಲ,0,0,1,1
22866,источниками,0,0,1,1
22869,مجموع,0,0,1,1
22870,geloven,0,0,1,1
22871,गुजर,0,0,1,1
22910,النوع,0,0,1,1
22911,patates,0,0,1,1
22912,способность,0,0,1,1
22914,suivantes ,0,0,1,1
22915,êtesvous,0,0,1,1
22919,слушайте,0,0,1,1
22920,photographique,0,0,1,1
22921,قضمة,0,0,1,1
22922,typologie,0,0,1,1
22925,pressionou,0,0,1,1
22926,ಸಂಪತ್ತಿಗೆ,0,0,1,1
22927,снится,0,0,1,1
22928,போகிறோம்,0,0,1,1
22929,மூழ்குவதைக்,0,0,1,1
22930,ووضوحًا,0,0,1,1
22908,highdimensional,0,0,1,1
22905, kilotonne,0,0,1,1
22902,வரைவிலக்கணம்,0,0,1,1
22884,termes ,0,0,1,1
22873,уравновешенный,0,0,1,1
22875,निका,0,0,1,1
22878,ciberespaço,0,0,1,1
22880,customarily,0,0,1,1
22882,hataları,0,0,1,1
22883,glæde,0,0,1,1
22885,jihadistes,0,0,1,1
22901,dwaze,0,0,1,1
22886,"
इमिलियाईरोमग्नोल",0,0,1,1
22887,followed,0,0,1,1
22888,contrasting,0,0,1,1
22891,ευχάριστο,0,0,1,1
22893,ഇരിക്കുന്ന,0,0,1,1
22900,നൈറ്റിനെയോ,0,0,1,1
23047,ಅಭಿನಂದನೆಗಳು,0,0,1,1
23049,योंगल,0,0,1,1
24190,irregular​,0,0,1,1
23198,duydunuz,0,0,1,1
23200,asemejen,0,0,1,1
23201,singular,0,0,1,1
23203,colaboraciones,0,0,1,1
23205,ईमानदार,0,0,1,1
23206,وسأل,0,0,1,1
23207,bestäms,0,0,1,1
23208,reacción,0,0,1,1
23209,مصحح,0,0,1,1
23210,nude,0,0,1,1
23213,grau,0,0,1,1
23214,haciéndolo,0,0,1,1
23216,ഉൾ‍ക്കൊള്ളുന്നു,0,0,1,1
23217,представлена,0,0,1,1
23218,экзамене,0,0,1,1
23219,सके।,0,0,1,1
23199,votações,0,0,1,1
23197,कील,0,0,1,1
23170,minut,0,0,1,1
23195,صراحة,0,0,1,1
23172,descenso,0,0,1,1
23173,kleidern,0,0,1,1
23175,réparées,0,0,1,1
23179,comparar,0,0,1,1
23180,замка,0,0,1,1
23181,generosamente,0,0,1,1
23182,sucediendo,0,0,1,1
23184,perguntaram,0,0,1,1
23185,ஈரநிலத்தின்,0,0,1,1
23186,ليلة,0,0,1,1
23188,tilfældig,0,0,1,1
23189,arkadaşımı,0,0,1,1
23190,شكرك,0,0,1,1
23192,bob,0,0,1,1
23193,"
इतिहासकार",0,0,1,1
23220,ορίζουν,0,0,1,1
23221,لنفترض,0,0,1,1
23222,ऊपरी,0,0,1,1
23223,जटिल,0,0,1,1
23248,acrecentando,0,0,1,1
23249,شاكرا,0,0,1,1
23250,funcionalidades,0,0,1,1
23251,മികച്ചതുമാണ്,0,0,1,1
23253,honnêtement,0,0,1,1
23254,τέλειο,0,0,1,1
23256,demenin,0,0,1,1
23257,जीने,0,0,1,1
23258,கேள்விகளில்,0,0,1,1
23259,πάνε,0,0,1,1
23260,aprendizado,0,0,1,1
23261,gini,0,0,1,1
23262,eliminó,0,0,1,1
23263,وكل,0,0,1,1
23265,hábitos,0,0,1,1
23247,плохое,0,0,1,1
23246,б,0,0,1,1
23245,அவனுடைய,0,0,1,1
23234,desacordo,0,0,1,1
23224,αργού,0,0,1,1
23228,alianza,0,0,1,1
23229,пометка,0,0,1,1
23230,двумя,0,0,1,1
23231,mødested,0,0,1,1
23232,വ്യക്തിയുടെ,0,0,1,1
23235,imprimée,0,0,1,1
23244,создала,0,0,1,1
23236,ഉണ്ടായേക്കാവുന്ന,0,0,1,1
23237,değiştirilmeye,0,0,1,1
23238,generando,0,0,1,1
23240,aseguraría,0,0,1,1
23241,سأحضر,0,0,1,1
23243,secundárias,0,0,1,1
23171,ocasionales,0,0,1,1
23168,styrkor,0,0,1,1
23050,arbre,0,0,1,1
23082,கலிஃபோர்னியாவில்,0,0,1,1
23084,nl,0,0,1,1
23086,laissemoi,0,0,1,1
23088,agradáveis,0,0,1,1
23090,കാര്യനിർവ്വാഹകരുടെ,0,0,1,1
23091,തുടരുന്നതിന്,0,0,1,1
23092,isst,0,0,1,1
23093,recrutar,0,0,1,1
23094,coordonner,0,0,1,1
23095,φτιαγμένο,0,0,1,1
23096,terörist,0,0,1,1
23097,fond ,0,0,1,1
23099,οικονομία,0,0,1,1
23100,hjemmesider,0,0,1,1
23102,détermine,0,0,1,1
23106,« sibérien »,0,0,1,1
23083,प्रिंट,0,0,1,1
23080,ಹಸಿದಿಲ್ಲ,0,0,1,1
23167,winkelcentrum,0,0,1,1
23079,acabó,0,0,1,1
23053,സഹായകരമാണോ,0,0,1,1
23057,nyt,0,0,1,1
23058,ನಿನ್ನೆ,0,0,1,1
23060,खपत,0,0,1,1
23061,utformat,0,0,1,1
23062,சொற்றொடரின்,0,0,1,1
23064,محرك,0,0,1,1
23065,ஊடகமாகவும்,0,0,1,1
23067,connexions,0,0,1,1
23069,хуже,0,0,1,1
23070,تجاهل,0,0,1,1
23071,lagrar,0,0,1,1
23073,wikipediaartikelen,0,0,1,1
23074,ويكيبيديين,0,0,1,1
23076,functioning,0,0,1,1
23107,belpictogram,0,0,1,1
23109,exceeding,0,0,1,1
23110,пользователя,0,0,1,1
23113,تيمز،,0,0,1,1
23142,"
नेपाली",0,0,1,1
23144,அதற்குப்,0,0,1,1
23146,जाऊंगा।,0,0,1,1
23147,zamanın,0,0,1,1
23149,paralelo»,0,0,1,1
23152,الإسبانية،,0,0,1,1
23154,എന്നിലുടനീളം,0,0,1,1
23155,inception,0,0,1,1
23158,nutricionista,0,0,1,1
23159,verificadas,0,0,1,1
23160,ungenießbar,0,0,1,1
23161,озаглавленное,0,0,1,1
23164,أسأل,0,0,1,1
23165,hugely,0,0,1,1
23166,भरा,0,0,1,1
23141,entendo,0,0,1,1
23140,которому,0,0,1,1
23138,engineers,0,0,1,1
23122,ಕೆಳಗಿನ,0,0,1,1
23114,владимир,0,0,1,1
23115,κυριολεκτικά,0,0,1,1
23116,happened,0,0,1,1
23119,ஃப்ளூமாக்ஸைப்,0,0,1,1
23120,—contracción,0,0,1,1
23121,cites,0,0,1,1
23124,பல்கலைக்கழகத்தில்,0,0,1,1
23137,starta,0,0,1,1
23129,ಸೂಚಿಸುತ್ತದೆ,0,0,1,1
23130,sorters,0,0,1,1
23132,напомнить,0,0,1,1
23133,دون,0,0,1,1
23134,kelimesinden,0,0,1,1
23136,tjek,0,0,1,1
22813,roten,0,0,1,1
22808,acusan,0,0,1,1
22806,വൃത്തികെട്ടതും,0,0,1,1
22495,frío,0,0,1,1
22498,அவற்றை,0,0,1,1
22499,расслышал,0,0,1,1
22500,ಚಲಿಸುವ,0,0,1,1
22501,ответ»,0,0,1,1
22502,κατασκευασμένη,0,0,1,1
22503,மீதான,0,0,1,1
22504,புழுக்கமாகப்,0,0,1,1
22506,éclosion,0,0,1,1
22507,φοβισμένος,0,0,1,1
22508,hemmelighedsfuldt,0,0,1,1
22509,போவதே,0,0,1,1
22510,triumphing,0,0,1,1
22511,обработка,0,0,1,1
22513,abandonaban,0,0,1,1
22514,способа,0,0,1,1
22497,samband,0,0,1,1
22492,«periodista,0,0,1,1
22469,ficticia,0,0,1,1
22489,llamadas,0,0,1,1
22471,interrumpiendo,0,0,1,1
22472,മടിക്കുന്നു,0,0,1,1
22473,schlaf,0,0,1,1
22475,ಮೂಲಭೂತ,0,0,1,1
22476,пожелать,0,0,1,1
22477,плохо,0,0,1,1
22478,وهما,0,0,1,1
22480,γνώμη,0,0,1,1
22481,publicadas,0,0,1,1
22482,employée,0,0,1,1
22483,rigen,0,0,1,1
22484,выражается,0,0,1,1
22486,nãoficção,0,0,1,1
22487,ಉಗುರು,0,0,1,1
22488,valorize,0,0,1,1
22515,உணவை,0,0,1,1
22517,ബന്ധപ്പെട്ടിരിക്കുന്നു,0,0,1,1
22518,casuais,0,0,1,1
22522,segundos,0,0,1,1
22561,أحببت,0,0,1,1
22564,förre,0,0,1,1
22565,وتوقيت,0,0,1,1
22568,understrege,0,0,1,1
22569,músicas,0,0,1,1
22570,minoritetsuppfattningar,0,0,1,1
22572,ಬದಲಿಗೆ,0,0,1,1
22573,проступках,0,0,1,1
22575,staring,0,0,1,1
22576,cessé,0,0,1,1
22578,pekat,0,0,1,1
22579,potentiellement,0,0,1,1
22580,proppen,0,0,1,1
22581,مساءً,0,0,1,1
22582,resumo,0,0,1,1
22556,tevoorschijn,0,0,1,1
22555,dão,0,0,1,1
22552,favoriete,0,0,1,1
22538,« gauchiste » »,0,0,1,1
22523,broma,0,0,1,1
22524,complaining,0,0,1,1
22525,vandallamalarına,0,0,1,1
22526,parecerem,0,0,1,1
22530,maastricht,0,0,1,1
22536,hospedada,0,0,1,1
22539,gezocht,0,0,1,1
22550,കേൾക്കാൻ,0,0,1,1
22540,dresses,0,0,1,1
22543,തടവുകാരെ,0,0,1,1
22545,antingen,0,0,1,1
22547,ആന,0,0,1,1
22548,ओमेगाविकि,0,0,1,1
22549,الخامسة,0,0,1,1
22470,أوصلك,0,0,1,1
22468,onderbreken,0,0,1,1
22805,negatieve,0,0,1,1
22382,معالجة,0,0,1,1
22385,hierover,0,0,1,1
22386,biodiésel,0,0,1,1
22388,ridge,0,0,1,1
22389,grego,0,0,1,1
22390,അടുത്തത്‌,0,0,1,1
22392,अध्यायों,0,0,1,1
22393,oiseau,0,0,1,1
22394,ഒരാൾ,0,0,1,1
22397,जानना,0,0,1,1
22398,μαζικής,0,0,1,1
22401,ലേഖനങ്ങളാണ്,0,0,1,1
22402,divertido,0,0,1,1
22403,διασκεδαστικό,0,0,1,1
22405,ವಾಕ್ಯವನ್ನು,0,0,1,1
22407,efetivamente,0,0,1,1
22384,acusála,0,0,1,1
22381,extralimitan,0,0,1,1
22467,постепенно,0,0,1,1
22380,klingon,0,0,1,1
22362,لمقابلة,0,0,1,1
22363,paralela,0,0,1,1
22364,unikke,0,0,1,1
22365,இலவச,0,0,1,1
22366,överens,0,0,1,1
22367,sofrem,0,0,1,1
22368,speakers,0,0,1,1
22369,алгоритм,0,0,1,1
22371,себе,0,0,1,1
22372,anerkendt,0,0,1,1
22373,вялого,0,0,1,1
22374,musea,0,0,1,1
22375,குழப்புவது,0,0,1,1
22376,ജർമ്മൻ,0,0,1,1
22378,num,0,0,1,1
22408,टायलर,0,0,1,1
22409,sou,0,0,1,1
22410,المسؤولين,0,0,1,1
22411,εστιατόριο,0,0,1,1
22441,ಆಘಾತಕ್ಕೊಳಗಾಗಿದ್ದಳು,0,0,1,1
22443,конкурсе,0,0,1,1
22444,ಗೆಳತಿ,0,0,1,1
22446,generar,0,0,1,1
22448,തുടർന്നുള്ള,0,0,1,1
22449,ориентирован,0,0,1,1
22451,viajou,0,0,1,1
22453,περισσότερα,0,0,1,1
22455,olursa,0,0,1,1
22457,processadas,0,0,1,1
22458,aussi ,0,0,1,1
22461,நீங்களே,0,0,1,1
22462,détournées,0,0,1,1
22463,വഴിയല്ലാതെ,0,0,1,1
22464,vakgebied,0,0,1,1
22439,மக்களுக்கு,0,0,1,1
22435,മലയാളത്തിലാണ്,0,0,1,1
22434,infiniment,0,0,1,1
22420,സെപ്റ്റംബർ,0,0,1,1
22412,இணையத்தளங்களின்,0,0,1,1
22413,gülümseyerek,0,0,1,1
22414,другая,0,0,1,1
22415,ಅದೃಷ್ಟವನ್ನು,0,0,1,1
22417,ಮಾಡಬಹುದೇ,0,0,1,1
22419,количеством,0,0,1,1
22423,caracterización,0,0,1,1
22433,sabedoria,0,0,1,1
22425,മനുഷ്യനിർമിതമായ,0,0,1,1
22426,skiva,0,0,1,1
22427,rempli,0,0,1,1
22428,प्रशंसात्मक,0,0,1,1
22431,γέλια,0,0,1,1
22432,испанской,0,0,1,1
22583,ಉಡುಪಿನಲ್ಲಿ,0,0,1,1
22584,கடுமையாக,0,0,1,1
22585,luchó,0,0,1,1
22715,initié,0,0,1,1
22720,photosynthesis,0,0,1,1
22721,"
inglês",0,0,1,1
22722,awareness,0,0,1,1
22723,identificaba,0,0,1,1
22724,ووسيم,0,0,1,1
22726,شهورًا,0,0,1,1
22728,auteursrechtelijke,0,0,1,1
22729,weken,0,0,1,1
22730,ordered,0,0,1,1
22731,"
bretão",0,0,1,1
22732,mimics,0,0,1,1
22733,visualización,0,0,1,1
22734,éventuelles,0,0,1,1
22738,stalled,0,0,1,1
22740,кассовые,0,0,1,1
22716,ആഗ്രഹിക്കുന്നിടത്തോളം,0,0,1,1
22713,"
malaiala",0,0,1,1
22586,номинирована,0,0,1,1
22712,പരാമർശിച്ചിട്ടില്ല,0,0,1,1
22692,ಒಬ್ಬರ,0,0,1,1
22693,challenge,0,0,1,1
22696,பராக்,0,0,1,1
22698,ζητώ,0,0,1,1
22699,microclusters,0,0,1,1
22700,desconcertaron,0,0,1,1
22701,téléphoniques,0,0,1,1
22702,bevorderd,0,0,1,1
22703,நடந்துகொண்டது,0,0,1,1
22705,boğulma,0,0,1,1
22706,frihet,0,0,1,1
22708,realizó,0,0,1,1
22709,ವಸ್ತುಗಳು,0,0,1,1
22710,possesseur,0,0,1,1
22711,പ്രശസ്തി,0,0,1,1
22741,تخيل,0,0,1,1
22742,подъездной,0,0,1,1
22743,ولكنه,0,0,1,1
22744,extending,0,0,1,1
22781,réveillé,0,0,1,1
22782,phenomenon,0,0,1,1
22783,ഭാഗ്യമെന്ന്,0,0,1,1
22784,تعديله,0,0,1,1
22785,jerga,0,0,1,1
22788,يكرر,0,0,1,1
22791,exploration,0,0,1,1
22794,проделал,0,0,1,1
22795,തെറ്റിദ്ധരിച്ചതായി,0,0,1,1
22798,ചിന്തിക്കാൻ,0,0,1,1
22799,limitó,0,0,1,1
22801,ಪಕ್ಷಿಗಳಂತೆ,0,0,1,1
22802,വാങ്ങിയ,0,0,1,1
22803,άρα,0,0,1,1
22804,computes,0,0,1,1
22780,വരുത്തി,0,0,1,1
22778,düşünüyorsun,0,0,1,1
22777,بإنشاء,0,0,1,1
22762,muertas,0,0,1,1
22749,ذروته,0,0,1,1
22750,skeletor,0,0,1,1
22752,c’est,0,0,1,1
22753,لثلاثة,0,0,1,1
22756,процент,0,0,1,1
22758,begejstrede,0,0,1,1
22763,écoute,0,0,1,1
22776,ώστε,0,0,1,1
22764,användes,0,0,1,1
22769,runs,0,0,1,1
22771,октябрь,0,0,1,1
22772,الويكيبيديون,0,0,1,1
22773,piedade,0,0,1,1
22774,arkadaşla,0,0,1,1
22691,guter,0,0,1,1
22690,"
हैतियाई",0,0,1,1
22689,ரியோக்காசு,0,0,1,1
22630,называемые,0,0,1,1
22610,athéisme,0,0,1,1
22611,förutsätts,0,0,1,1
22612,помогать,0,0,1,1
22613,commander,0,0,1,1
22615,ട്ട്,0,0,1,1
22616,ಮಂದ,0,0,1,1
22617,оценки,0,0,1,1
22618,slott,0,0,1,1
22619,புன்னகைத்தனர்,0,0,1,1
22620,ಹೋಗುತ್ತೀರಿ,0,0,1,1
22621,задумывалась,0,0,1,1
22622,авторитетность,0,0,1,1
22623,തിരുത്താൻ,0,0,1,1
22624,automatiques,0,0,1,1
22626,английские,0,0,1,1
22609,δοκιμή,0,0,1,1
22608,βοήθησέ,0,0,1,1
22607,combinação,0,0,1,1
22595,സൃഷ്ടിക്കാറുണ്ടെങ്കിലും,0,0,1,1
22587,வழிகளைத்,0,0,1,1
22588,externe,0,0,1,1
22589,ccbysanl,0,0,1,1
22590,ಸಂಖ್ಯೆಯನ್ನು,0,0,1,1
22591,amerikalılar,0,0,1,1
22593,നിയമിക്കുന്നത്,0,0,1,1
22598,eleitoral,0,0,1,1
22606,ställer,0,0,1,1
22599,estupro,0,0,1,1
22600,ممثلون,0,0,1,1
22601,creaciones,0,0,1,1
22602,изменение,0,0,1,1
22604,सुव्यवस्थित,0,0,1,1
22605,decade,0,0,1,1
22629,കേരളത്തിലുള്ളവർക്ക്,0,0,1,1
22631,retaining,0,0,1,1
22687,pregunto,0,0,1,1
22632,aussicht,0,0,1,1
22665,سعيدًا,0,0,1,1
22666,vigilant,0,0,1,1
22668,vécue,0,0,1,1
22669,concludeerde,0,0,1,1
22670,chegar,0,0,1,1
22672,"
क्राइमियाई",0,0,1,1
22674,ദിനപത്രങ്ങളാണ്,0,0,1,1
22675,والوسائط,0,0,1,1
22676,وشك,0,0,1,1
22677,høre,0,0,1,1
22680,gain,0,0,1,1
22681,accusation,0,0,1,1
22682,σταματήσω,0,0,1,1
22683,добьетесь,0,0,1,1
22685,adapted,0,0,1,1
22663,വിവരങ്ങളിലൂടെ,0,0,1,1
22659,knipogen,0,0,1,1
22658,olmadığı,0,0,1,1
22644,reeditado,0,0,1,1
22634,pipa—by,0,0,1,1
22635,ஆங்கிலப்,0,0,1,1
22636,mesela,0,0,1,1
22637,"
फ़्रियुलियाई",0,0,1,1
22642,ocorrem,0,0,1,1
22643,pensait,0,0,1,1
22645,abla,0,0,1,1
22657,verlaat,0,0,1,1
22649,занимает,0,0,1,1
22650,berufserfahrung,0,0,1,1
22651,غدا؟,0,0,1,1
22652,profiel,0,0,1,1
22653,consideró,0,0,1,1
22654,الجلوس,0,0,1,1
23267,rusa—,0,0,1,1
23268,ಒಪ್ಪಿಕೊಳ್ಳುತ್ತೇನೆ,0,0,1,1
23269,cohérence,0,0,1,1
23871,pleurs,0,0,1,1
23874,costumes,0,0,1,1
23875,സ്വാധീനമുള്ള,0,0,1,1
23878,återgavs,0,0,1,1
23879,mooiste,0,0,1,1
23883,prohibit,0,0,1,1
23884,कब,0,0,1,1
23885,bevæger,0,0,1,1
23886,salienta,0,0,1,1
23887,लड़का,0,0,1,1
23888,prioridad,0,0,1,1
23890,समानता,0,0,1,1
23891,bord,0,0,1,1
23892,jemals,0,0,1,1
23898,ಪರಿಸ್ಥಿತಿಯಲ್ಲಿರುವುದು,0,0,1,1
23901,положение,0,0,1,1
23872,கருத்துகள்,0,0,1,1
23870,تزايد,0,0,1,1
23841,père,0,0,1,1
23869,ഒന്നുമില്ല,0,0,1,1
23845,acompanhar,0,0,1,1
23846,китайских,0,0,1,1
23848,représentativité,0,0,1,1
23850,downward,0,0,1,1
23851,workload,0,0,1,1
23852,porcentaje,0,0,1,1
23853,praising,0,0,1,1
23854,மொழிகளைக்,0,0,1,1
23855,разослано,0,0,1,1
23856,مرتبكًا,0,0,1,1
23857,infallsvinklar,0,0,1,1
23861,répréhensibles,0,0,1,1
23864,syntaxe,0,0,1,1
23865,narsizaydı,0,0,1,1
23866,सर्विस,0,0,1,1
23902,kullanacağım,0,0,1,1
23903,الثروات,0,0,1,1
23907,skarpe,0,0,1,1
23909,छह,0,0,1,1
23934,tracking,0,0,1,1
23938,corrijan,0,0,1,1
23939,vivre,0,0,1,1
23941,ಮಾಡಬೇಕು,0,0,1,1
23942,interrupting,0,0,1,1
23943,element,0,0,1,1
23944,répète,0,0,1,1
23945,πρόσβασής,0,0,1,1
23946,поставлена,0,0,1,1
23948,contratálo,0,0,1,1
23949,культурных,0,0,1,1
23950,departure,0,0,1,1
23951,stanfordbased,0,0,1,1
23953,ഡാറ്റാ,0,0,1,1
23954,kött,0,0,1,1
23932,общем,0,0,1,1
23931,invocadas,0,0,1,1
23930,kleid,0,0,1,1
23919,நேசிக்கிறேன்,0,0,1,1
23910,الفاخرة,0,0,1,1
23912,ifadeyi,0,0,1,1
23914,properly,0,0,1,1
23915,tillsvidare,0,0,1,1
23916,alimentador,0,0,1,1
23918,ಲೈಬ್ರರಿ,0,0,1,1
23920,കാര്യങ്ങളിലും,0,0,1,1
23929,возможную,0,0,1,1
23922,zuerst,0,0,1,1
23923,വാക്കുകൾക്കപ്പുറത്ത്,0,0,1,1
23924,stap,0,0,1,1
23925,geschäft,0,0,1,1
23927,değildi,0,0,1,1
23928,secciones,0,0,1,1
23843,كذباً,0,0,1,1
23839,planten,0,0,1,1
23726,gusto,0,0,1,1
23753,dropping,0,0,1,1
23757,ലേഖനങ്ങളുടേയും,0,0,1,1
23758,δροσερές,0,0,1,1
23760,colder,0,0,1,1
23761,टूट,0,0,1,1
23763,لاحق,0,0,1,1
23766,conscientious,0,0,1,1
23767,partenariat,0,0,1,1
23769,captured,0,0,1,1
23773,मुद्दे,0,0,1,1
23774,« créées,0,0,1,1
23775,halsizlik,0,0,1,1
23776,“சிஎசுஎசு”,0,0,1,1
23777,demeliyim,0,0,1,1
23779,لويكيبيديا،,0,0,1,1
23782,traités,0,0,1,1
23754,ಹುಡುಗರನ್ನು,0,0,1,1
23752,kötüsü,0,0,1,1
23837,branden,0,0,1,1
23751,afslutte,0,0,1,1
23729,springe,0,0,1,1
23730,ஆக்கப்பட்டு,0,0,1,1
23731,økonomien,0,0,1,1
23732,pluripotency,0,0,1,1
23733,εργασίας,0,0,1,1
23734,अभियान,0,0,1,1
23737,yönleriyle,0,0,1,1
23738,kino,0,0,1,1
23739,rewards,0,0,1,1
23744,codified,0,0,1,1
23745,ജീവിതം,0,0,1,1
23746,मिस्सा,0,0,1,1
23747,தடுக்கப்படுவதோடு,0,0,1,1
23748,представительств,0,0,1,1
23749,«ты»,0,0,1,1
23783,ಇಂಗ್ಲಿಷ್ನಲ್ಲಿ,0,0,1,1
23784,выборки,0,0,1,1
23786,моём,0,0,1,1
23787,sekunde,0,0,1,1
23814,желаем,0,0,1,1
23815,платьев,0,0,1,1
23816,carbon,0,0,1,1
23817,judiciaire…,0,0,1,1
23818,redden,0,0,1,1
23819,reparere,0,0,1,1
23820,noun,0,0,1,1
23822,ನಾವೆಲ್ಲರೂ,0,0,1,1
23827,идут,0,0,1,1
23829,domme,0,0,1,1
23830,söylüyor,0,0,1,1
23831,المعروفين,0,0,1,1
23832,έλλειψη,0,0,1,1
23834,duydum,0,0,1,1
23836,സൃഷ്ടിക്കണമെന്ന്,0,0,1,1
23812,edelsteinen,0,0,1,1
23811,handle,0,0,1,1
23810,depth,0,0,1,1
23797,തലയിൽ,0,0,1,1
23788,azar,0,0,1,1
23790,gilla,0,0,1,1
23791,d’avoir,0,0,1,1
23792,ಹತ್ತಿರ,0,0,1,1
23793,решившегося,0,0,1,1
23794,"
croata",0,0,1,1
23799,bulunan,0,0,1,1
23809,hire,0,0,1,1
23800,contratado,0,0,1,1
23801,لطيفين,0,0,1,1
23803,उलझन,0,0,1,1
23804,regelmæssigt,0,0,1,1
23806,gedachten,0,0,1,1
23808,класс,0,0,1,1
23955,ജീവിതരേഖ,0,0,1,1
23956,दुबारा,0,0,1,1
23958,إنك,0,0,1,1
24107,طفيف،,0,0,1,1
24110,மூழ்கடிப்பது,0,0,1,1
24111,beschikbare,0,0,1,1
24112,साथसाथ,0,0,1,1
24115,berühmten,0,0,1,1
24116,இருந்ததைப்,0,0,1,1
24117,mammalian,0,0,1,1
24118,использованием,0,0,1,1
24119,फंसेंगे,0,0,1,1
24120,оперирующий,0,0,1,1
24122,melpiger,0,0,1,1
24125,annoncer,0,0,1,1
24126,veré,0,0,1,1
24127,മകളെക്കുറിച്ചും,0,0,1,1
24129,animaux ,0,0,1,1
24132,flippede,0,0,1,1
24108,ventes,0,0,1,1
24104,besökarna,0,0,1,1
23959,qualificatif,0,0,1,1
24100,интеллект,0,0,1,1
24078,infeasible,0,0,1,1
24080,träffas,0,0,1,1
24082,ceb,0,0,1,1
24083,"jpdk
",0,0,1,1
24085,περιβάλλουν,0,0,1,1
24086,spaß,0,0,1,1
24087,wikipediaförfattare,0,0,1,1
24090,медейко,0,0,1,1
24091,respectiva,0,0,1,1
24092,आज़माएँ,0,0,1,1
24095,lowhanging,0,0,1,1
24096,غالبية,0,0,1,1
24097,вебсайтов,0,0,1,1
24098,ವಿಭಾಗದಲ್ಲಿ,0,0,1,1
24099,القراء،,0,0,1,1
24133,unfortunately,0,0,1,1
24137,reter,0,0,1,1
24140,suportada,0,0,1,1
24142,brengt,0,0,1,1
24172,തരത്തിലാണുള്ളത്,0,0,1,1
24173,freuen,0,0,1,1
24175,étroites,0,0,1,1
24176,affiliation,0,0,1,1
24177,mucha,0,0,1,1
24178,отношении,0,0,1,1
24179,buluyorum,0,0,1,1
24180,παγκόσμιο,0,0,1,1
24182,ഭക്ഷണങ്ങൾ,0,0,1,1
24183,ಉದ್ಯೋಗವನ್ನು,0,0,1,1
24184,damerna,0,0,1,1
24185,manifold,0,0,1,1
24186,define,0,0,1,1
24187,സഹായിക്കാമോ,0,0,1,1
24188,wichtig,0,0,1,1
24171,لكني,0,0,1,1
24170,dinosaurs,0,0,1,1
24167,användarnas,0,0,1,1
24154,accusent,0,0,1,1
24144,ومختلفة,0,0,1,1
24145,ചെയ്യുകയും,0,0,1,1
24146,mécènes,0,0,1,1
24150,முகவரிகளினால்,0,0,1,1
24152,insanlar,0,0,1,1
24153,référant,0,0,1,1
24155,learning”,0,0,1,1
24165,φταρνίστηκε,0,0,1,1
24156,புத்தகத்தை,0,0,1,1
24157,kafanı,0,0,1,1
24159,março,0,0,1,1
24161,irmos,0,0,1,1
24162,doulhe,0,0,1,1
24163,förväntas,0,0,1,1
24077,நேர்காணலில்,0,0,1,1
24076,zusätzlichen,0,0,1,1
24075,τρίμηνο,0,0,1,1
24020,الرائعة,0,0,1,1
23991,coola,0,0,1,1
23992,pasaran,0,0,1,1
23994,«офис»,0,0,1,1
23998,routière,0,0,1,1
23999,قرية,0,0,1,1
24000,मुस्कुराते,0,0,1,1
24001,digitais,0,0,1,1
24004,بقي,0,0,1,1
24005,censurerar,0,0,1,1
24008,doorheeft,0,0,1,1
24009,ജീവനക്കാരൻ,0,0,1,1
24011,ಅಭಿಪ್ರಾಯವೇನು,0,0,1,1
24012,correcteurs,0,0,1,1
24013,söyler,0,0,1,1
24014,ljuset,0,0,1,1
23988,φόβος,0,0,1,1
23987,la •,0,0,1,1
23985,जाएं,0,0,1,1
23971,activist,0,0,1,1
23960,περιθώριο,0,0,1,1
23961,üzgünsün,0,0,1,1
23963,nyheterna,0,0,1,1
23964,जाऊं,0,0,1,1
23967,കൊടുക്കാൻ,0,0,1,1
23968,е д свердлов,0,0,1,1
23972,اثنا,0,0,1,1
23984,لكلمتين,0,0,1,1
23974,düşünün,0,0,1,1
23975,περάσεις,0,0,1,1
23976,óbvio,0,0,1,1
23977,وعندما,0,0,1,1
23980,erinnern,0,0,1,1
23981,hospedagem,0,0,1,1
24017,άλλον,0,0,1,1
24022,données ,0,0,1,1
24072,deelname,0,0,1,1
24023,oldum,0,0,1,1
24052,lågkvalitetsändringar,0,0,1,1
24055,vagonla,0,0,1,1
24056,espelho,0,0,1,1
24057,உபயோகிக்கப்படுகின்றது,0,0,1,1
24058,raconte,0,0,1,1
24059,olvida,0,0,1,1
24060,skrevet,0,0,1,1
24061,ശൈലിയും,0,0,1,1
24062,японском,0,0,1,1
24063,प्रति,0,0,1,1
24064,μαριόν,0,0,1,1
24066,അതിന്,0,0,1,1
24068,comic,0,0,1,1
24069,großartiger,0,0,1,1
24071,लोडबेलेंसिंग,0,0,1,1
24050,tido,0,0,1,1
24046,запись,0,0,1,1
24045,diacrítico,0,0,1,1
24031,utgivare,0,0,1,1
24025,précis,0,0,1,1
24026,devrionsnous,0,0,1,1
24027,reportedly,0,0,1,1
24028,novatos,0,0,1,1
24029,മനസ്സിലായില്ലെങ്കിൽ‌,0,0,1,1
24030,ekonomin,0,0,1,1
24032,coluna,0,0,1,1
24044,edifícios,0,0,1,1
24034,adabı,0,0,1,1
24038,вкусных,0,0,1,1
24039,اعتمادًا,0,0,1,1
24040,بذلك؟,0,0,1,1
24041,tøver,0,0,1,1
24042,δική,0,0,1,1
23727,ಸಾಧ್ಯವಾಗದಿದ್ದರೆ,0,0,1,1
23725,للأكل,0,0,1,1
23270,änderte,0,0,1,1
23410,അഭിമുഖത്തിലോ,0,0,1,1
23415,пользоваться,0,0,1,1
23416,instaure,0,0,1,1
23418,ergebnis,0,0,1,1
23422,skrivaredigera,0,0,1,1
23424,сервере,0,0,1,1
23425,ಹೆಬ್ಬೆರಳು,0,0,1,1
23426,sentouse,0,0,1,1
23428,vastzit,0,0,1,1
23430,दूसरों,0,0,1,1
23432,пытаетесь,0,0,1,1
23433,combinatoire,0,0,1,1
23434,« neutralité,0,0,1,1
23435,ഭാഗ്യം,0,0,1,1
23436,ನೀಡಿದ,0,0,1,1
23439,exigir,0,0,1,1
23411,tillåtet,0,0,1,1
23409,കണ്ടതുമുതൽ,0,0,1,1
23377,mènent,0,0,1,1
23408,носители,0,0,1,1
23379,utilisons,0,0,1,1
23383,failing,0,0,1,1
23384,équivaut,0,0,1,1
23385,мужчине,0,0,1,1
23386,latín,0,0,1,1
23389,γραμματοσειρά,0,0,1,1
23390,reflejo,0,0,1,1
23392,kompakt,0,0,1,1
23394,दिशानिर्देश,0,0,1,1
23395,gönderdin,0,0,1,1
23397,ಪಕ್ಕದಲ್ಲಿರುವ,0,0,1,1
23399,estelle,0,0,1,1
23400,செய்கிறேன்,0,0,1,1
23402,beispielsweise,0,0,1,1
23405,έρθει,0,0,1,1
23441,dilinde,0,0,1,1
23442,иметься,0,0,1,1
23443,öfkeliydi,0,0,1,1
23444,baisser,0,0,1,1
23470,şövalye,0,0,1,1
23471,titres,0,0,1,1
23472,tembelleştiriyor,0,0,1,1
23473,secuencia,0,0,1,1
23477,meritstatus,0,0,1,1
23478,ஒரே,0,0,1,1
23481,ast •,0,0,1,1
23482,بدوا,0,0,1,1
23483,அன்றிரவு,0,0,1,1
23484,غدا,0,0,1,1
23487,statesman,0,0,1,1
23488,kommen,0,0,1,1
23489,rit,0,0,1,1
23491,पदोन्नति,0,0,1,1
23492,gibt,0,0,1,1
23469,undeveloped,0,0,1,1
23468,சொற்களைத்,0,0,1,1
23467,persa,0,0,1,1
23454,мозгу,0,0,1,1
23445,subdesarrollados,0,0,1,1
23446,ستصل,0,0,1,1
23447,tardaba,0,0,1,1
23451,criterion,0,0,1,1
23452,tchakavien,0,0,1,1
23453,hogere,0,0,1,1
23455,bestond,0,0,1,1
23466,تفسيراتهم,0,0,1,1
23456,zukünftige,0,0,1,1
23457,sekiz,0,0,1,1
23458,وحذف,0,0,1,1
23459,ತಾಳ್ಮೆಯಿಂದ,0,0,1,1
23461,atravesó,0,0,1,1
23465,поколение,0,0,1,1
23378,названный,0,0,1,1
23375,« diderot,0,0,1,1
23723,“vikipedi,0,0,1,1
23298,മകളും,0,0,1,1
23300,nationales,0,0,1,1
23304,பால்கனியில்,0,0,1,1
23306,شخصياً,0,0,1,1
23307,rediffuser,0,0,1,1
23308,detalles,0,0,1,1
23310,lindos,0,0,1,1
23311,توش,0,0,1,1
23312,instituciones,0,0,1,1
23314,തിരുത്തുവാനും,0,0,1,1
23315,المتكررين,0,0,1,1
23316,صخرة,0,0,1,1
23317,характер,0,0,1,1
23319,ನಾರುವ,0,0,1,1
23321,शुक्रिया।,0,0,1,1
23323,participam,0,0,1,1
23299,άφησέ,0,0,1,1
23296,zamanlar,0,0,1,1
23374,créationniste,0,0,1,1
23294,волшебный,0,0,1,1
23272,brödbröd,0,0,1,1
23273,coincided,0,0,1,1
23274,некоторая,0,0,1,1
23276,विकिस्केनर,0,0,1,1
23279,ναρκίσσας,0,0,1,1
23280,révèlent,0,0,1,1
23281,அனைத்தும்,0,0,1,1
23282,считает,0,0,1,1
23283,gedik,0,0,1,1
23284,tendríamos,0,0,1,1
23285,​​for,0,0,1,1
23287,projektredigeringar,0,0,1,1
23288,entré,0,0,1,1
23289,ädelstenar,0,0,1,1
23293,assign,0,0,1,1
23324,سبتمبر,0,0,1,1
23325,vandalizando,0,0,1,1
23327,പോകുമെന്ന്,0,0,1,1
23328,collégiale,0,0,1,1
23353,അന്തരീക്ഷത്തിന്,0,0,1,1
23354,μάθετε,0,0,1,1
23355,éducation,0,0,1,1
23356,omstridte,0,0,1,1
23357,مفتوح,0,0,1,1
23361,പോകാമെന്ന്,0,0,1,1
23364,incríveis,0,0,1,1
23365,улучшайте,0,0,1,1
23367,velho,0,0,1,1
23368,actuar,0,0,1,1
23369,dosyalarının,0,0,1,1
23370,nedenini,0,0,1,1
23371,ugly,0,0,1,1
23372,чьих,0,0,1,1
23373,beschreibungsfeld,0,0,1,1
23352,aparecían,0,0,1,1
23350,telefonat,0,0,1,1
23349,यूजमोडविकी,0,0,1,1
23337,uitgeroepen,0,0,1,1
23329,malheureusement,0,0,1,1
23330,χαμογελάσει,0,0,1,1
23331,التأكيد,0,0,1,1
23332,прослушайте,0,0,1,1
23334,أليكسا،,0,0,1,1
23336,ഉദാ‍ഹരണത്തിന്,0,0,1,1
23338,kapitalismen,0,0,1,1
23348,സംരക്ഷിക്കേണ്ട,0,0,1,1
23340,censur,0,0,1,1
23341,दिलचस्पी,0,0,1,1
23343,മലയാളത്തിനു,0,0,1,1
23344,rubí,0,0,1,1
23345,مقارنة,0,0,1,1
23346,сославшись,0,0,1,1
23496,воды,0,0,1,1
23497,صعوبة,0,0,1,1
23498,uk •,0,0,1,1
23634,olsam,0,0,1,1
23636,loved,0,0,1,1
23637,grootser,0,0,1,1
23638,mundo—​​,0,0,1,1
23640,பொதேரி’,0,0,1,1
23642,forfremmet,0,0,1,1
23643,compton,0,0,1,1
23644,démarche,0,0,1,1
23645,मैरियन,0,0,1,1
23651,തെലുഗ്,0,0,1,1
23652,ex ,0,0,1,1
23655,zugeritten,0,0,1,1
23658,يجيب,0,0,1,1
23660,вчера,0,0,1,1
23661,daardoor,0,0,1,1
23662,théorise,0,0,1,1
23635,വിദ്യാർത്ഥികൾക്കായുള്ള,0,0,1,1
23633,itentreprenören,0,0,1,1
23499,انتقاد,0,0,1,1
23632,уровней,0,0,1,1
23611,elva,0,0,1,1
23613,മലയാളഭാഷയിൽ,0,0,1,1
23616,exhibit,0,0,1,1
23617,ника,0,0,1,1
23618,ചുവടെ,0,0,1,1
23619,அருமையான,0,0,1,1
23621,വ്യാജ,0,0,1,1
23622,استطلاع,0,0,1,1
23623,centrados,0,0,1,1
23625,تسميتها,0,0,1,1
23626,ചിത്രീകരണവും,0,0,1,1
23627,πανηγυρίζεις,0,0,1,1
23629,आरम्भ,0,0,1,1
23630,olmaktan,0,0,1,1
23631,ಕೆಂಪು,0,0,1,1
23663,guldbröd,0,0,1,1
23664,بالملابس,0,0,1,1
23665,وجود,0,0,1,1
23668,മണിക്കൂറിലും,0,0,1,1
23697,வழங்கப்பட்டது,0,0,1,1
23699,visités,0,0,1,1
23700,klikken,0,0,1,1
23701,ранних,0,0,1,1
23702,assaulting,0,0,1,1
23704,едва,0,0,1,1
23706,amongst,0,0,1,1
23709,italianos,0,0,1,1
23713,μπερδευτείτε,0,0,1,1
23714,parlons,0,0,1,1
23715,wending,0,0,1,1
23716,خارجية,0,0,1,1
23718,newsletters,0,0,1,1
23719,inexacta,0,0,1,1
23722,ಲೋಟ,0,0,1,1
23695,kontrolleras,0,0,1,1
23694,التراكم,0,0,1,1
23693,ಬಯಸುವ,0,0,1,1
23680,croissante,0,0,1,1
23669,കാര്യമോ,0,0,1,1
23670,فمثلا,0,0,1,1
23674,referencias,0,0,1,1
23675,பகுதியை,0,0,1,1
23677,temsil,0,0,1,1
23678,идей,0,0,1,1
23681,للدلالة,0,0,1,1
23692,fizesse,0,0,1,1
23682,pai,0,0,1,1
23683,सामान्य।,0,0,1,1
23686,decentralizes,0,0,1,1
23688,одному,0,0,1,1
23689,நாசீஸை,0,0,1,1
23691,متوسط,0,0,1,1
23604,وضع,0,0,1,1
23603,activitésréf,0,0,1,1
23602,—cada,0,0,1,1
23551,admit,0,0,1,1
23525,указанные,0,0,1,1
23527,arrêté,0,0,1,1
23528,அழைத்துச்,0,0,1,1
23530,पड़े,0,0,1,1
23533,«abrió,0,0,1,1
23534,സഞ്ചരിച്ചു,0,0,1,1
23535,etki,0,0,1,1
23537,balanserade,0,0,1,1
23538,incorporés,0,0,1,1
23539,находящихся,0,0,1,1
23540,positief,0,0,1,1
23543,traditions,0,0,1,1
23545,disposer,0,0,1,1
23547,فهم,0,0,1,1
23549,igneous,0,0,1,1
23524,kwijt,0,0,1,1
23523,internetgemenskap,0,0,1,1
23522,verkeerde,0,0,1,1
23510,தயாராகிவிட்டேன்,0,0,1,1
23502,статью»,0,0,1,1
23503,вошли,0,0,1,1
23504,adjusts,0,0,1,1
23505,merendeels,0,0,1,1
23506,وأنواعًا,0,0,1,1
23509,lícita,0,0,1,1
23512,ಕನ್ನಡಿಯಲ್ಲಿ,0,0,1,1
23521,​​geräusch,0,0,1,1
23514,வேலையைச்,0,0,1,1
23515,cinéaste,0,0,1,1
23516,exemplares,0,0,1,1
23517,ವಿವರಿಸುವಾಗ,0,0,1,1
23519,éviter,0,0,1,1
23520,hulpmiddelen,0,0,1,1
23550,returns,0,0,1,1
23552,divisé,0,0,1,1
23600,gleich,0,0,1,1
23553,ofensivos,0,0,1,1
23582,പറ്റുന്നതിൽ,0,0,1,1
23583,honestly,0,0,1,1
23584,മാന്ത്രികജീവികളായിരുന്നു,0,0,1,1
23585,ενήργησα,0,0,1,1
23586,kafaları,0,0,1,1
23588,सटीक,0,0,1,1
23590,лицензия,0,0,1,1
23591,schmeckendes,0,0,1,1
23592,والدتك,0,0,1,1
23593,kleines,0,0,1,1
23594,ತಿನ್ನಬಹುದಾದ,0,0,1,1
23596,plagued,0,0,1,1
23597,കാണരുത്,0,0,1,1
23598,découverte,0,0,1,1
23599,deeper,0,0,1,1
23581,ασημί,0,0,1,1
23579,geroepen,0,0,1,1
23576,вызывают,0,0,1,1
23565,ಬಹಳಷ್ಟು,0,0,1,1
23554,pesadamente,0,0,1,1
23555,большинстве,0,0,1,1
23557,vendus,0,0,1,1
23558,anglosakson,0,0,1,1
23563,ακαδημαϊκό,0,0,1,1
23564,достоверной,0,0,1,1
23566,مزيف,0,0,1,1
23575,فعله,0,0,1,1
23568,voldtægtshændelser,0,0,1,1
23569,improvements,0,0,1,1
23570,elite,0,0,1,1
23571,attesté,0,0,1,1
23572,prego,0,0,1,1
23573,रखा।,0,0,1,1
52703,успеха,0,0,1,1
